stationid,startTime,inNums,outNums,flow,allflow
21,2022/7/15 5:00,1,1,0,0
21,2022/7/15 5:10,3,1,2,2
21,2022/7/15 5:20,8,1,7,7
21,2022/7/15 5:30,8,1,7,7
21,2022/7/15 5:40,8,1,7,7
21,2022/7/15 5:50,9,1,8,8
21,2022/7/15 6:00,23,1,22,22
21,2022/7/15 6:10,23,1,22,22
21,2022/7/15 6:20,26,11,15,15
21,2022/7/15 6:30,32,25,7,7
21,2022/7/15 6:40,64,29,35,35
21,2022/7/15 6:50,68,32,36,36
21,2022/7/15 7:00,88,46,42,42
21,2022/7/15 7:10,196,37,159,159
21,2022/7/15 7:20,267,38,229,229
21,2022/7/15 7:30,278,50,228,228
21,2022/7/15 7:40,382,51,331,331
21,2022/7/15 7:50,597,48,549,549
21,2022/7/15 8:00,442,53,389,389
21,2022/7/15 8:10,332,71,261,261
21,2022/7/15 8:20,280,67,213,213
21,2022/7/15 8:30,233,70,163,163
21,2022/7/15 8:40,169,70,99,99
21,2022/7/15 8:50,127,51,76,76
21,2022/7/15 9:00,48,45,3,3
21,2022/7/15 9:10,42,51,-9,-9
21,2022/7/15 9:20,41,45,-4,-4
21,2022/7/15 9:30,37,45,-8,-8
21,2022/7/15 9:40,32,40,-8,-8
21,2022/7/15 9:50,28,38,-10,-10
21,2022/7/15 10:00,25,40,-15,-15
21,2022/7/15 10:10,20,38,-18,-18
21,2022/7/15 10:20,23,37,-14,-14
21,2022/7/15 10:30,19,37,-18,-18
21,2022/7/15 10:40,20,37,-17,-17
21,2022/7/15 10:50,17,42,-25,-25
21,2022/7/15 11:00,16,39,-23,-23
21,2022/7/15 11:10,18,41,-23,-23
21,2022/7/15 11:20,20,39,-19,-19
21,2022/7/15 11:30,17,39,-22,-22
21,2022/7/15 11:40,20,37,-17,-17
21,2022/7/15 11:50,23,37,-14,-14
21,2022/7/15 12:00,27,37,-10,-10
21,2022/7/15 12:10,23,42,-19,-19
21,2022/7/15 12:20,21,39,-18,-18
21,2022/7/15 12:30,23,46,-23,-23
21,2022/7/15 12:40,23,45,-22,-22
21,2022/7/15 12:50,21,46,-25,-25
21,2022/7/15 13:00,17,47,-30,-30
21,2022/7/15 13:10,17,49,-32,-32
21,2022/7/15 13:20,20,50,-30,-30
21,2022/7/15 13:30,19,47,-28,-28
21,2022/7/15 13:40,17,41,-24,-24
21,2022/7/15 13:50,17,45,-28,-28
21,2022/7/15 14:00,19,50,-31,-31
21,2022/7/15 14:10,16,50,-34,-34
21,2022/7/15 14:20,18,50,-32,-32
21,2022/7/15 14:30,17,46,-29,-29
21,2022/7/15 14:40,16,50,-34,-34
21,2022/7/15 14:50,14,49,-35,-35
21,2022/7/15 15:00,19,49,-30,-30
21,2022/7/15 15:10,19,50,-31,-31
21,2022/7/15 15:20,23,61,-38,-38
21,2022/7/15 15:30,23,70,-47,-47
21,2022/7/15 15:40,20,66,-46,-46
21,2022/7/15 15:50,17,70,-53,-53
21,2022/7/15 16:00,24,72,-48,-48
21,2022/7/15 16:10,23,69,-46,-46
21,2022/7/15 16:20,26,70,-44,-44
21,2022/7/15 16:30,24,69,-45,-45
21,2022/7/15 16:40,22,65,-43,-43
21,2022/7/15 16:50,26,76,-50,-50
21,2022/7/15 17:00,33,77,-44,-44
21,2022/7/15 17:10,35,97,-62,-62
21,2022/7/15 17:20,30,102,-72,-72
21,2022/7/15 17:30,26,127,-101,-101
21,2022/7/15 17:40,30,122,-92,-92
21,2022/7/15 17:50,25,108,-83,-83
21,2022/7/15 18:00,27,119,-92,-92
21,2022/7/15 18:10,26,111,-85,-85
21,2022/7/15 18:20,24,109,-85,-85
21,2022/7/15 18:30,22,117,-95,-95
21,2022/7/15 18:40,23,111,-88,-88
21,2022/7/15 18:50,16,119,-103,-103
21,2022/7/15 19:00,15,110,-95,-95
21,2022/7/15 19:10,13,123,-110,-110
21,2022/7/15 19:20,12,110,-98,-98
21,2022/7/15 19:30,10,108,-98,-98
21,2022/7/15 19:40,9,99,-90,-90
21,2022/7/15 19:50,9,83,-74,-74
21,2022/7/15 20:00,11,81,-70,-70
21,2022/7/15 20:10,10,87,-77,-77
21,2022/7/15 20:20,7,77,-70,-70
21,2022/7/15 20:30,10,66,-56,-56
21,2022/7/15 20:40,8,79,-71,-71
21,2022/7/15 20:50,9,61,-52,-52
21,2022/7/15 21:00,8,88,-80,-80
21,2022/7/15 21:10,7,66,-59,-59
21,2022/7/15 21:20,8,78,-70,-70
21,2022/7/15 21:30,7,67,-60,-60
21,2022/7/15 21:40,6,52,-46,-46
21,2022/7/15 21:50,4,72,-68,-68
21,2022/7/15 22:00,1,46,-45,-45
21,2022/7/15 22:10,0,70,-70,-70
21,2022/7/15 22:20,0,34,-34,-34
21,2022/7/15 22:30,0,49,-49,-49
21,2022/7/15 22:40,0,39,-39,-39
21,2022/7/15 22:50,0,25,-25,-25
24,2022/7/15 5:00,0,1,-1,-1
24,2022/7/15 5:10,0,1,-1,1
24,2022/7/15 5:20,0,1,-1,6
24,2022/7/15 5:30,0,1,-1,6
24,2022/7/15 5:40,2,1,1,8
24,2022/7/15 5:50,2,1,1,9
24,2022/7/15 6:00,3,1,2,24
24,2022/7/15 6:10,7,1,6,28
24,2022/7/15 6:20,6,11,-5,10
24,2022/7/15 6:30,6,6,0,7
24,2022/7/15 6:40,14,8,6,41
24,2022/7/15 6:50,22,6,16,52
24,2022/7/15 7:00,25,11,14,56
24,2022/7/15 7:10,36,16,20,179
24,2022/7/15 7:20,36,23,13,242
24,2022/7/15 7:30,56,22,34,262
24,2022/7/15 7:40,46,31,15,346
24,2022/7/15 7:50,53,38,15,564
24,2022/7/15 8:00,56,21,35,424
24,2022/7/15 8:10,47,29,18,279
24,2022/7/15 8:20,36,14,22,235
24,2022/7/15 8:30,31,48,-17,146
24,2022/7/15 8:40,24,61,-37,62
24,2022/7/15 8:50,21,47,-26,50
24,2022/7/15 9:00,14,32,-18,-15
24,2022/7/15 9:10,12,30,-18,-27
24,2022/7/15 9:20,13,29,-16,-20
24,2022/7/15 9:30,10,21,-11,-19
24,2022/7/15 9:40,8,21,-13,-21
24,2022/7/15 9:50,3,19,-16,-26
24,2022/7/15 10:00,7,19,-12,-27
24,2022/7/15 10:10,4,19,-15,-33
24,2022/7/15 10:20,4,19,-15,-29
24,2022/7/15 10:30,4,18,-14,-32
24,2022/7/15 10:40,7,16,-9,-26
24,2022/7/15 10:50,7,12,-5,-30
24,2022/7/15 11:00,4,19,-15,-38
24,2022/7/15 11:10,6,19,-13,-36
24,2022/7/15 11:20,5,12,-7,-26
24,2022/7/15 11:30,6,12,-6,-28
24,2022/7/15 11:40,6,12,-6,-23
24,2022/7/15 11:50,6,8,-2,-16
24,2022/7/15 12:00,7,19,-12,-22
24,2022/7/15 12:10,5,8,-3,-22
24,2022/7/15 12:20,6,15,-9,-27
24,2022/7/15 12:30,5,14,-9,-32
24,2022/7/15 12:40,6,21,-15,-37
24,2022/7/15 12:50,5,19,-14,-39
24,2022/7/15 13:00,5,14,-9,-39
24,2022/7/15 13:10,4,18,-14,-46
24,2022/7/15 13:20,6,16,-10,-40
24,2022/7/15 13:30,6,19,-13,-41
24,2022/7/15 13:40,4,16,-12,-36
24,2022/7/15 13:50,5,15,-10,-38
24,2022/7/15 14:00,5,16,-11,-42
24,2022/7/15 14:10,5,16,-11,-45
24,2022/7/15 14:20,5,15,-10,-42
24,2022/7/15 14:30,4,14,-10,-39
24,2022/7/15 14:40,5,18,-13,-47
24,2022/7/15 14:50,6,14,-8,-43
24,2022/7/15 15:00,8,19,-11,-41
24,2022/7/15 15:10,8,18,-10,-41
24,2022/7/15 15:20,7,16,-9,-47
24,2022/7/15 15:30,8,21,-13,-60
24,2022/7/15 15:40,9,21,-12,-58
24,2022/7/15 15:50,8,19,-11,-64
24,2022/7/15 16:00,9,19,-10,-58
24,2022/7/15 16:10,8,23,-15,-61
24,2022/7/15 16:20,10,23,-13,-57
24,2022/7/15 16:30,8,23,-15,-60
24,2022/7/15 16:40,11,23,-12,-55
24,2022/7/15 16:50,10,38,-28,-78
24,2022/7/15 17:00,12,30,-18,-62
24,2022/7/15 17:10,17,35,-18,-80
24,2022/7/15 17:20,13,38,-25,-97
24,2022/7/15 17:30,14,46,-32,-133
24,2022/7/15 17:40,14,40,-26,-118
24,2022/7/15 17:50,12,45,-33,-116
24,2022/7/15 18:00,10,51,-41,-133
24,2022/7/15 18:10,8,53,-45,-130
24,2022/7/15 18:20,6,49,-43,-128
24,2022/7/15 18:30,6,55,-49,-144
24,2022/7/15 18:40,6,46,-40,-128
24,2022/7/15 18:50,4,40,-36,-139
24,2022/7/15 19:00,4,40,-36,-131
24,2022/7/15 19:10,3,36,-33,-143
24,2022/7/15 19:20,1,26,-25,-123
24,2022/7/15 19:30,4,25,-21,-119
24,2022/7/15 19:40,4,23,-19,-109
24,2022/7/15 19:50,2,18,-16,-90
24,2022/7/15 20:00,3,25,-22,-92
24,2022/7/15 20:10,2,21,-19,-96
24,2022/7/15 20:20,2,10,-8,-78
24,2022/7/15 20:30,2,25,-23,-79
24,2022/7/15 20:40,2,10,-8,-79
24,2022/7/15 20:50,2,25,-23,-75
24,2022/7/15 21:00,1,18,-17,-97
24,2022/7/15 21:10,1,21,-20,-79
24,2022/7/15 21:20,2,16,-14,-84
24,2022/7/15 21:30,1,22,-21,-81
24,2022/7/15 21:40,1,21,-20,-66
24,2022/7/15 21:50,1,13,-12,-80
24,2022/7/15 22:00,0,19,-19,-64
24,2022/7/15 22:10,0,10,-10,-80
24,2022/7/15 22:20,0,18,-18,-52
24,2022/7/15 22:30,0,8,-8,-57
24,2022/7/15 22:40,0,15,-15,-54
24,2022/7/15 22:50,0,10,-10,-35
11,2022/7/15 5:00,0,1,-1,-2
11,2022/7/15 5:10,2,1,1,2
11,2022/7/15 5:20,5,1,4,10
11,2022/7/15 5:30,6,1,5,11
11,2022/7/15 5:40,6,1,5,13
11,2022/7/15 5:50,11,1,10,19
11,2022/7/15 6:00,9,1,8,32
11,2022/7/15 6:10,16,1,15,43
11,2022/7/15 6:20,18,16,2,12
11,2022/7/15 6:30,21,16,5,12
11,2022/7/15 6:40,33,14,19,60
11,2022/7/15 6:50,36,14,22,74
11,2022/7/15 7:00,46,13,33,89
11,2022/7/15 7:10,60,23,37,216
11,2022/7/15 7:20,88,38,50,292
11,2022/7/15 7:30,189,46,143,405
11,2022/7/15 7:40,192,57,135,481
11,2022/7/15 7:50,185,65,120,684
11,2022/7/15 8:00,173,82,91,515
11,2022/7/15 8:10,169,84,85,364
11,2022/7/15 8:20,108,67,41,276
11,2022/7/15 8:30,76,109,-33,113
11,2022/7/15 8:40,58,110,-52,10
11,2022/7/15 8:50,56,102,-46,4
11,2022/7/15 9:00,27,107,-80,-95
11,2022/7/15 9:10,27,122,-95,-122
11,2022/7/15 9:20,26,104,-78,-98
11,2022/7/15 9:30,22,93,-71,-90
11,2022/7/15 9:40,20,75,-55,-76
11,2022/7/15 9:50,19,72,-53,-79
11,2022/7/15 10:00,19,66,-47,-74
11,2022/7/15 10:10,17,47,-30,-63
11,2022/7/15 10:20,11,38,-27,-56
11,2022/7/15 10:30,16,45,-29,-61
11,2022/7/15 10:40,14,38,-24,-50
11,2022/7/15 10:50,15,38,-23,-53
11,2022/7/15 11:00,16,35,-19,-57
11,2022/7/15 11:10,11,32,-21,-57
11,2022/7/15 11:20,15,38,-23,-49
11,2022/7/15 11:30,16,31,-15,-43
11,2022/7/15 11:40,15,28,-13,-36
11,2022/7/15 11:50,15,32,-17,-33
11,2022/7/15 12:00,16,32,-16,-38
11,2022/7/15 12:10,16,33,-17,-39
11,2022/7/15 12:20,16,37,-21,-48
11,2022/7/15 12:30,16,38,-22,-54
11,2022/7/15 12:40,15,38,-23,-60
11,2022/7/15 12:50,15,38,-23,-62
11,2022/7/15 13:00,14,39,-25,-64
11,2022/7/15 13:10,17,44,-27,-73
11,2022/7/15 13:20,15,36,-21,-61
11,2022/7/15 13:30,14,38,-24,-65
11,2022/7/15 13:40,14,39,-25,-61
11,2022/7/15 13:50,15,40,-25,-63
11,2022/7/15 14:00,13,38,-25,-67
11,2022/7/15 14:10,14,38,-24,-69
11,2022/7/15 14:20,12,38,-26,-68
11,2022/7/15 14:30,13,38,-25,-64
11,2022/7/15 14:40,17,41,-24,-71
11,2022/7/15 14:50,15,40,-25,-68
11,2022/7/15 15:00,15,47,-32,-73
11,2022/7/15 15:10,12,38,-26,-67
11,2022/7/15 15:20,15,34,-19,-66
11,2022/7/15 15:30,17,46,-29,-89
11,2022/7/15 15:40,18,42,-24,-82
11,2022/7/15 15:50,15,45,-30,-94
11,2022/7/15 16:00,13,41,-28,-86
11,2022/7/15 16:10,18,44,-26,-87
11,2022/7/15 16:20,14,50,-36,-93
11,2022/7/15 16:30,22,49,-27,-87
11,2022/7/15 16:40,26,55,-29,-84
11,2022/7/15 16:50,26,51,-25,-103
11,2022/7/15 17:00,29,50,-21,-83
11,2022/7/15 17:10,24,64,-40,-120
11,2022/7/15 17:20,26,72,-46,-143
11,2022/7/15 17:30,36,76,-40,-173
11,2022/7/15 17:40,47,77,-30,-148
11,2022/7/15 17:50,46,90,-44,-160
11,2022/7/15 18:00,44,110,-66,-199
11,2022/7/15 18:10,63,110,-47,-177
11,2022/7/15 18:20,45,114,-69,-197
11,2022/7/15 18:30,34,103,-69,-213
11,2022/7/15 18:40,28,95,-67,-195
11,2022/7/15 18:50,24,101,-77,-216
11,2022/7/15 19:00,26,95,-69,-200
11,2022/7/15 19:10,25,76,-51,-194
11,2022/7/15 19:20,20,75,-55,-178
11,2022/7/15 19:30,18,71,-53,-172
11,2022/7/15 19:40,16,56,-40,-149
11,2022/7/15 19:50,14,51,-37,-127
11,2022/7/15 20:00,16,54,-38,-130
11,2022/7/15 20:10,17,48,-31,-127
11,2022/7/15 20:20,16,34,-18,-96
11,2022/7/15 20:30,13,53,-40,-119
11,2022/7/15 20:40,11,37,-26,-105
11,2022/7/15 20:50,13,51,-38,-113
11,2022/7/15 21:00,12,40,-28,-125
11,2022/7/15 21:10,9,50,-41,-120
11,2022/7/15 21:20,6,52,-46,-130
11,2022/7/15 21:30,7,34,-27,-108
11,2022/7/15 21:40,10,48,-38,-104
11,2022/7/15 21:50,3,30,-27,-107
11,2022/7/15 22:00,1,49,-48,-112
11,2022/7/15 22:10,0,24,-24,-104
11,2022/7/15 22:20,0,41,-41,-93
11,2022/7/15 22:30,0,43,-43,-100
11,2022/7/15 22:40,0,34,-34,-88
11,2022/7/15 22:50,0,23,-23,-58
6,2022/7/15 5:00,0,1,-1,-3
6,2022/7/15 5:10,7,1,6,8
6,2022/7/15 5:20,13,1,12,22
6,2022/7/15 5:30,14,1,13,24
6,2022/7/15 5:40,16,1,15,28
6,2022/7/15 5:50,23,1,22,41
6,2022/7/15 6:00,25,1,24,56
6,2022/7/15 6:10,32,11,21,64
6,2022/7/15 6:20,37,23,14,26
6,2022/7/15 6:30,46,32,14,26
6,2022/7/15 6:40,65,40,25,85
6,2022/7/15 6:50,94,54,40,114
6,2022/7/15 7:00,151,63,88,177
6,2022/7/15 7:10,200,69,131,347
6,2022/7/15 7:20,253,76,177,469
6,2022/7/15 7:30,317,93,224,629
6,2022/7/15 7:40,324,108,216,697
6,2022/7/15 7:50,474,127,347,1031
6,2022/7/15 8:00,632,105,527,1042
6,2022/7/15 8:10,583,177,406,770
6,2022/7/15 8:20,474,151,323,599
6,2022/7/15 8:30,349,233,116,229
6,2022/7/15 8:40,282,513,-231,-221
6,2022/7/15 8:50,239,321,-82,-78
6,2022/7/15 9:00,199,296,-97,-192
6,2022/7/15 9:10,145,326,-181,-303
6,2022/7/15 9:20,79,298,-219,-317
6,2022/7/15 9:30,65,221,-156,-246
6,2022/7/15 9:40,62,197,-135,-211
6,2022/7/15 9:50,43,154,-111,-190
6,2022/7/15 10:00,48,133,-85,-159
6,2022/7/15 10:10,44,122,-78,-141
6,2022/7/15 10:20,44,98,-54,-110
6,2022/7/15 10:30,41,109,-68,-129
6,2022/7/15 10:40,41,112,-71,-121
6,2022/7/15 10:50,41,112,-71,-124
6,2022/7/15 11:00,43,105,-62,-119
6,2022/7/15 11:10,37,106,-69,-126
6,2022/7/15 11:20,44,102,-58,-107
6,2022/7/15 11:30,44,105,-61,-104
6,2022/7/15 11:40,50,114,-64,-100
6,2022/7/15 11:50,57,108,-51,-84
6,2022/7/15 12:00,66,102,-36,-74
6,2022/7/15 12:10,74,106,-32,-71
6,2022/7/15 12:20,66,105,-39,-87
6,2022/7/15 12:30,75,108,-33,-87
6,2022/7/15 12:40,71,111,-40,-100
6,2022/7/15 12:50,77,107,-30,-92
6,2022/7/15 13:00,70,109,-39,-103
6,2022/7/15 13:10,72,107,-35,-108
6,2022/7/15 13:20,72,106,-34,-95
6,2022/7/15 13:30,63,105,-42,-107
6,2022/7/15 13:40,56,107,-51,-112
6,2022/7/15 13:50,70,107,-37,-100
6,2022/7/15 14:00,53,109,-56,-123
6,2022/7/15 14:10,60,105,-45,-114
6,2022/7/15 14:20,60,103,-43,-111
6,2022/7/15 14:30,73,103,-30,-94
6,2022/7/15 14:40,57,106,-49,-120
6,2022/7/15 14:50,53,101,-48,-116
6,2022/7/15 15:00,58,106,-48,-121
6,2022/7/15 15:10,72,117,-45,-112
6,2022/7/15 15:20,66,122,-56,-122
6,2022/7/15 15:30,74,124,-50,-139
6,2022/7/15 15:40,65,124,-59,-141
6,2022/7/15 15:50,70,105,-35,-129
6,2022/7/15 16:00,74,111,-37,-123
6,2022/7/15 16:10,73,124,-51,-138
6,2022/7/15 16:20,73,109,-36,-129
6,2022/7/15 16:30,85,111,-26,-113
6,2022/7/15 16:40,162,119,43,-41
6,2022/7/15 16:50,130,126,4,-99
6,2022/7/15 17:00,175,148,27,-56
6,2022/7/15 17:10,217,189,28,-92
6,2022/7/15 17:20,199,223,-24,-167
6,2022/7/15 17:30,236,253,-17,-190
6,2022/7/15 17:40,309,330,-21,-169
6,2022/7/15 17:50,265,372,-107,-267
6,2022/7/15 18:00,265,507,-242,-441
6,2022/7/15 18:10,576,495,81,-96
6,2022/7/15 18:20,310,503,-193,-390
6,2022/7/15 18:30,271,508,-237,-450
6,2022/7/15 18:40,235,505,-270,-465
6,2022/7/15 18:50,205,506,-301,-517
6,2022/7/15 19:00,179,382,-203,-403
6,2022/7/15 19:10,172,327,-155,-349
6,2022/7/15 19:20,150,216,-66,-244
6,2022/7/15 19:30,101,191,-90,-262
6,2022/7/15 19:40,93,137,-44,-193
6,2022/7/15 19:50,85,123,-38,-165
6,2022/7/15 20:00,80,115,-35,-165
6,2022/7/15 20:10,76,127,-51,-178
6,2022/7/15 20:20,92,104,-12,-108
6,2022/7/15 20:30,91,98,-7,-126
6,2022/7/15 20:40,104,116,-12,-117
6,2022/7/15 20:50,130,92,38,-75
6,2022/7/15 21:00,150,126,24,-101
6,2022/7/15 21:10,132,100,32,-88
6,2022/7/15 21:20,76,117,-41,-171
6,2022/7/15 21:30,86,105,-19,-127
6,2022/7/15 21:40,105,92,13,-91
6,2022/7/15 21:50,67,104,-37,-144
6,2022/7/15 22:00,30,77,-47,-159
6,2022/7/15 22:10,3,106,-103,-207
6,2022/7/15 22:20,2,85,-83,-176
6,2022/7/15 22:30,0,110,-110,-210
6,2022/7/15 22:40,1,75,-74,-162
6,2022/7/15 22:50,0,64,-64,-122
20,2022/7/15 5:00,0,1,-1,-4
20,2022/7/15 5:10,3,1,2,10
20,2022/7/15 5:20,6,1,5,27
20,2022/7/15 5:30,10,1,9,33
20,2022/7/15 5:40,10,1,9,37
20,2022/7/15 5:50,13,2,11,52
20,2022/7/15 6:00,20,1,19,75
20,2022/7/15 6:10,27,21,6,70
20,2022/7/15 6:20,28,32,-4,22
20,2022/7/15 6:30,35,37,-2,24
20,2022/7/15 6:40,40,47,-7,78
20,2022/7/15 6:50,59,51,8,122
20,2022/7/15 7:00,64,58,6,183
20,2022/7/15 7:10,75,72,3,350
20,2022/7/15 7:20,157,75,82,551
20,2022/7/15 7:30,217,96,121,750
20,2022/7/15 7:40,282,124,158,855
20,2022/7/15 7:50,280,108,172,1203
20,2022/7/15 8:00,345,189,156,1198
20,2022/7/15 8:10,359,178,181,951
20,2022/7/15 8:20,318,501,-183,416
20,2022/7/15 8:30,245,298,-53,176
20,2022/7/15 8:40,227,496,-269,-490
20,2022/7/15 8:50,163,381,-218,-296
20,2022/7/15 9:00,90,299,-209,-401
20,2022/7/15 9:10,74,325,-251,-554
20,2022/7/15 9:20,70,181,-111,-428
20,2022/7/15 9:30,52,122,-70,-316
20,2022/7/15 9:40,43,150,-107,-318
20,2022/7/15 9:50,42,114,-72,-262
20,2022/7/15 10:00,37,124,-87,-246
20,2022/7/15 10:10,43,100,-57,-198
20,2022/7/15 10:20,35,106,-71,-181
20,2022/7/15 10:30,33,110,-77,-206
20,2022/7/15 10:40,37,102,-65,-186
20,2022/7/15 10:50,38,101,-63,-187
20,2022/7/15 11:00,39,107,-68,-187
20,2022/7/15 11:10,38,101,-63,-189
20,2022/7/15 11:20,37,110,-73,-180
20,2022/7/15 11:30,36,102,-66,-170
20,2022/7/15 11:40,43,103,-60,-160
20,2022/7/15 11:50,41,99,-58,-142
20,2022/7/15 12:00,41,110,-69,-143
20,2022/7/15 12:10,43,108,-65,-136
20,2022/7/15 12:20,52,104,-52,-139
20,2022/7/15 12:30,43,108,-65,-152
20,2022/7/15 12:40,46,106,-60,-160
20,2022/7/15 12:50,54,102,-48,-140
20,2022/7/15 13:00,54,104,-50,-153
20,2022/7/15 13:10,60,111,-51,-159
20,2022/7/15 13:20,53,122,-69,-164
20,2022/7/15 13:30,41,105,-64,-171
20,2022/7/15 13:40,57,120,-63,-175
20,2022/7/15 13:50,47,110,-63,-163
20,2022/7/15 14:00,47,103,-56,-179
20,2022/7/15 14:10,55,106,-51,-165
20,2022/7/15 14:20,46,109,-63,-174
20,2022/7/15 14:30,49,86,-37,-131
20,2022/7/15 14:40,55,99,-44,-164
20,2022/7/15 14:50,62,108,-46,-162
20,2022/7/15 15:00,58,103,-45,-166
20,2022/7/15 15:10,56,104,-48,-160
20,2022/7/15 15:20,58,100,-42,-164
20,2022/7/15 15:30,55,117,-62,-201
20,2022/7/15 15:40,53,116,-63,-204
20,2022/7/15 15:50,65,105,-40,-169
20,2022/7/15 16:00,64,123,-59,-182
20,2022/7/15 16:10,77,100,-23,-161
20,2022/7/15 16:20,75,119,-44,-173
20,2022/7/15 16:30,75,115,-40,-153
20,2022/7/15 16:40,76,110,-34,-75
20,2022/7/15 16:50,70,150,-80,-179
20,2022/7/15 17:00,139,108,31,-25
20,2022/7/15 17:10,202,149,53,-39
20,2022/7/15 17:20,216,178,38,-129
20,2022/7/15 17:30,214,196,18,-172
20,2022/7/15 17:40,334,232,102,-67
20,2022/7/15 17:50,268,323,-55,-322
20,2022/7/15 18:00,204,329,-125,-566
20,2022/7/15 18:10,269,327,-58,-154
20,2022/7/15 18:20,316,326,-10,-400
20,2022/7/15 18:30,257,328,-71,-521
20,2022/7/15 18:40,244,321,-77,-542
20,2022/7/15 18:50,243,285,-42,-559
20,2022/7/15 19:00,177,209,-32,-435
20,2022/7/15 19:10,143,145,-2,-351
20,2022/7/15 19:20,129,107,22,-222
20,2022/7/15 19:30,73,111,-38,-300
20,2022/7/15 19:40,74,120,-46,-239
20,2022/7/15 19:50,65,109,-44,-209
20,2022/7/15 20:00,63,104,-41,-206
20,2022/7/15 20:10,75,87,-12,-190
20,2022/7/15 20:20,76,98,-22,-130
20,2022/7/15 20:30,72,106,-34,-160
20,2022/7/15 20:40,68,89,-21,-138
20,2022/7/15 20:50,64,113,-49,-124
20,2022/7/15 21:00,83,72,11,-90
20,2022/7/15 21:10,89,112,-23,-111
20,2022/7/15 21:20,70,72,-2,-173
20,2022/7/15 21:30,74,89,-15,-142
20,2022/7/15 21:40,66,72,-6,-97
20,2022/7/15 21:50,63,103,-40,-184
20,2022/7/15 22:00,42,78,-36,-195
20,2022/7/15 22:10,6,73,-67,-274
20,2022/7/15 22:20,1,94,-93,-269
20,2022/7/15 22:30,0,62,-62,-272
20,2022/7/15 22:40,0,62,-62,-224
20,2022/7/15 22:50,1,38,-37,-159
1,2022/7/15 5:00,0,1,-1,-5
1,2022/7/15 5:10,2,1,1,11
1,2022/7/15 5:20,9,1,8,35
1,2022/7/15 5:30,15,1,14,47
1,2022/7/15 5:40,20,1,19,56
1,2022/7/15 5:50,17,1,16,68
1,2022/7/15 6:00,25,1,24,99
1,2022/7/15 6:10,31,13,18,88
1,2022/7/15 6:20,45,17,28,50
1,2022/7/15 6:30,57,21,36,60
1,2022/7/15 6:40,69,32,37,115
1,2022/7/15 6:50,105,50,55,177
1,2022/7/15 7:00,181,67,114,297
1,2022/7/15 7:10,215,73,142,492
1,2022/7/15 7:20,252,75,177,728
1,2022/7/15 7:30,323,97,226,976
1,2022/7/15 7:40,590,106,484,1339
1,2022/7/15 7:50,639,110,529,1732
1,2022/7/15 8:00,723,123,600,1798
1,2022/7/15 8:10,687,226,461,1412
1,2022/7/15 8:20,653,171,482,898
1,2022/7/15 8:30,573,234,339,515
1,2022/7/15 8:40,358,222,136,-354
1,2022/7/15 8:50,278,180,98,-198
1,2022/7/15 9:00,232,152,80,-321
1,2022/7/15 9:10,174,121,53,-501
1,2022/7/15 9:20,106,123,-17,-445
1,2022/7/15 9:30,68,107,-39,-355
1,2022/7/15 9:40,55,108,-53,-371
1,2022/7/15 9:50,50,97,-47,-309
1,2022/7/15 10:00,44,76,-32,-278
1,2022/7/15 10:10,42,81,-39,-237
1,2022/7/15 10:20,36,77,-41,-222
1,2022/7/15 10:30,31,72,-41,-247
1,2022/7/15 10:40,32,75,-43,-229
1,2022/7/15 10:50,35,72,-37,-224
1,2022/7/15 11:00,33,65,-32,-219
1,2022/7/15 11:10,26,66,-40,-229
1,2022/7/15 11:20,36,61,-25,-205
1,2022/7/15 11:30,33,82,-49,-219
1,2022/7/15 11:40,36,70,-34,-194
1,2022/7/15 11:50,35,76,-41,-183
1,2022/7/15 12:00,39,75,-36,-179
1,2022/7/15 12:10,41,77,-36,-172
1,2022/7/15 12:20,45,70,-25,-164
1,2022/7/15 12:30,43,84,-41,-193
1,2022/7/15 12:40,43,81,-38,-198
1,2022/7/15 12:50,44,75,-31,-171
1,2022/7/15 13:00,38,92,-54,-207
1,2022/7/15 13:10,38,76,-38,-197
1,2022/7/15 13:20,34,91,-57,-221
1,2022/7/15 13:30,37,76,-39,-210
1,2022/7/15 13:40,34,77,-43,-218
1,2022/7/15 13:50,36,76,-40,-203
1,2022/7/15 14:00,30,74,-44,-223
1,2022/7/15 14:10,35,77,-42,-207
1,2022/7/15 14:20,31,84,-53,-227
1,2022/7/15 14:30,30,76,-46,-177
1,2022/7/15 14:40,28,76,-48,-212
1,2022/7/15 14:50,27,81,-54,-216
1,2022/7/15 15:00,34,91,-57,-223
1,2022/7/15 15:10,39,76,-37,-197
1,2022/7/15 15:20,40,92,-52,-216
1,2022/7/15 15:30,42,87,-45,-246
1,2022/7/15 15:40,39,96,-57,-261
1,2022/7/15 15:50,36,97,-61,-230
1,2022/7/15 16:00,45,97,-52,-234
1,2022/7/15 16:10,53,109,-56,-217
1,2022/7/15 16:20,56,103,-47,-220
1,2022/7/15 16:30,52,102,-50,-203
1,2022/7/15 16:40,73,110,-37,-112
1,2022/7/15 16:50,68,111,-43,-222
1,2022/7/15 17:00,125,103,22,-3
1,2022/7/15 17:10,208,110,98,59
1,2022/7/15 17:20,174,151,23,-106
1,2022/7/15 17:30,163,191,-28,-200
1,2022/7/15 17:40,221,233,-12,-79
1,2022/7/15 17:50,183,217,-34,-356
1,2022/7/15 18:00,149,300,-151,-717
1,2022/7/15 18:10,203,327,-124,-278
1,2022/7/15 18:20,163,334,-171,-571
1,2022/7/15 18:30,74,319,-245,-766
1,2022/7/15 18:40,56,301,-245,-787
1,2022/7/15 18:50,46,256,-210,-769
1,2022/7/15 19:00,43,197,-154,-589
1,2022/7/15 19:10,40,147,-107,-458
1,2022/7/15 19:20,40,144,-104,-326
1,2022/7/15 19:30,37,110,-73,-373
1,2022/7/15 19:40,35,125,-90,-329
1,2022/7/15 19:50,28,125,-97,-306
1,2022/7/15 20:00,33,105,-72,-278
1,2022/7/15 20:10,38,108,-70,-260
1,2022/7/15 20:20,41,81,-40,-170
1,2022/7/15 20:30,40,122,-82,-242
1,2022/7/15 20:40,44,83,-39,-177
1,2022/7/15 20:50,32,107,-75,-199
1,2022/7/15 21:00,28,78,-50,-140
1,2022/7/15 21:10,27,127,-100,-211
1,2022/7/15 21:20,25,108,-83,-256
1,2022/7/15 21:30,29,99,-70,-212
1,2022/7/15 21:40,25,102,-77,-174
1,2022/7/15 21:50,23,78,-55,-239
1,2022/7/15 22:00,15,106,-91,-286
1,2022/7/15 22:10,2,73,-71,-345
1,2022/7/15 22:20,0,108,-108,-377
1,2022/7/15 22:30,0,79,-79,-351
1,2022/7/15 22:40,1,75,-74,-298
1,2022/7/15 22:50,0,34,-34,-193
19,2022/7/15 5:00,0,1,-1,-6
19,2022/7/15 5:10,2,1,1,12
19,2022/7/15 5:20,5,1,4,39
19,2022/7/15 5:30,16,1,15,62
19,2022/7/15 5:40,18,1,17,73
19,2022/7/15 5:50,16,1,15,83
19,2022/7/15 6:00,25,1,24,123
19,2022/7/15 6:10,27,19,8,96
19,2022/7/15 6:20,32,14,18,68
19,2022/7/15 6:30,36,23,13,73
19,2022/7/15 6:40,57,34,23,138
19,2022/7/15 6:50,70,25,45,222
19,2022/7/15 7:00,76,54,22,319
19,2022/7/15 7:10,109,72,37,529
19,2022/7/15 7:20,187,78,109,837
19,2022/7/15 7:30,255,105,150,1126
19,2022/7/15 7:40,361,184,177,1516
19,2022/7/15 7:50,376,133,243,1975
19,2022/7/15 8:00,572,298,274,2072
19,2022/7/15 8:10,591,212,379,1791
19,2022/7/15 8:20,436,232,204,1102
19,2022/7/15 8:30,392,268,124,639
19,2022/7/15 8:40,277,326,-49,-403
19,2022/7/15 8:50,254,323,-69,-267
19,2022/7/15 9:00,197,268,-71,-392
19,2022/7/15 9:10,162,208,-46,-547
19,2022/7/15 9:20,93,184,-91,-536
19,2022/7/15 9:30,67,119,-52,-407
19,2022/7/15 9:40,64,114,-50,-421
19,2022/7/15 9:50,52,114,-62,-371
19,2022/7/15 10:00,44,105,-61,-339
19,2022/7/15 10:10,45,99,-54,-291
19,2022/7/15 10:20,43,94,-51,-273
19,2022/7/15 10:30,36,97,-61,-308
19,2022/7/15 10:40,40,89,-49,-278
19,2022/7/15 10:50,30,75,-45,-269
19,2022/7/15 11:00,37,87,-50,-269
19,2022/7/15 11:10,43,76,-33,-262
19,2022/7/15 11:20,40,75,-35,-240
19,2022/7/15 11:30,52,78,-26,-245
19,2022/7/15 11:40,66,87,-21,-215
19,2022/7/15 11:50,85,87,-2,-185
19,2022/7/15 12:00,72,76,-4,-183
19,2022/7/15 12:10,62,92,-30,-202
19,2022/7/15 12:20,62,92,-30,-194
19,2022/7/15 12:30,67,95,-28,-221
19,2022/7/15 12:40,63,98,-35,-233
19,2022/7/15 12:50,57,106,-49,-220
19,2022/7/15 13:00,60,105,-45,-252
19,2022/7/15 13:10,60,105,-45,-242
19,2022/7/15 13:20,60,102,-42,-263
19,2022/7/15 13:30,54,110,-56,-266
19,2022/7/15 13:40,43,110,-67,-285
19,2022/7/15 13:50,41,99,-58,-261
19,2022/7/15 14:00,44,94,-50,-273
19,2022/7/15 14:10,50,96,-46,-253
19,2022/7/15 14:20,44,93,-49,-276
19,2022/7/15 14:30,44,106,-62,-239
19,2022/7/15 14:40,40,97,-57,-269
19,2022/7/15 14:50,41,101,-60,-276
19,2022/7/15 15:00,45,104,-59,-282
19,2022/7/15 15:10,95,97,-2,-199
19,2022/7/15 15:20,64,103,-39,-255
19,2022/7/15 15:30,53,101,-48,-294
19,2022/7/15 15:40,49,111,-62,-323
19,2022/7/15 15:50,61,101,-40,-270
19,2022/7/15 16:00,61,103,-42,-276
19,2022/7/15 16:10,62,110,-48,-265
19,2022/7/15 16:20,69,109,-40,-260
19,2022/7/15 16:30,93,104,-11,-214
19,2022/7/15 16:40,138,102,36,-76
19,2022/7/15 16:50,174,109,65,-157
19,2022/7/15 17:00,267,123,144,141
19,2022/7/15 17:10,310,124,186,245
19,2022/7/15 17:20,283,118,165,59
19,2022/7/15 17:30,298,110,188,-12
19,2022/7/15 17:40,367,183,184,105
19,2022/7/15 17:50,334,177,157,-199
19,2022/7/15 18:00,266,208,58,-659
19,2022/7/15 18:10,265,223,42,-236
19,2022/7/15 18:20,256,236,20,-551
19,2022/7/15 18:30,183,224,-41,-807
19,2022/7/15 18:40,150,220,-70,-857
19,2022/7/15 18:50,96,178,-82,-851
19,2022/7/15 19:00,68,226,-158,-747
19,2022/7/15 19:10,70,139,-69,-527
19,2022/7/15 19:20,53,120,-67,-393
19,2022/7/15 19:30,44,109,-65,-438
19,2022/7/15 19:40,41,127,-86,-415
19,2022/7/15 19:50,41,113,-72,-378
19,2022/7/15 20:00,45,120,-75,-353
19,2022/7/15 20:10,45,110,-65,-325
19,2022/7/15 20:20,43,99,-56,-226
19,2022/7/15 20:30,44,106,-62,-304
19,2022/7/15 20:40,47,105,-58,-235
19,2022/7/15 20:50,45,106,-61,-260
19,2022/7/15 21:00,44,122,-78,-218
19,2022/7/15 21:10,37,93,-56,-267
19,2022/7/15 21:20,37,114,-77,-333
19,2022/7/15 21:30,35,105,-70,-282
19,2022/7/15 21:40,30,112,-82,-256
19,2022/7/15 21:50,33,121,-88,-327
19,2022/7/15 22:00,25,96,-71,-357
19,2022/7/15 22:10,12,105,-93,-438
19,2022/7/15 22:20,3,71,-68,-445
19,2022/7/15 22:30,2,96,-94,-445
19,2022/7/15 22:40,2,71,-69,-367
19,2022/7/15 22:50,0,39,-39,-232
25,2022/7/15 5:00,0,1,-1,-7
25,2022/7/15 5:10,1,1,0,12
25,2022/7/15 5:20,6,1,5,44
25,2022/7/15 5:30,11,1,10,72
25,2022/7/15 5:40,20,1,19,92
25,2022/7/15 5:50,20,5,15,98
25,2022/7/15 6:00,26,1,25,148
25,2022/7/15 6:10,34,16,18,114
25,2022/7/15 6:20,40,19,21,89
25,2022/7/15 6:30,55,23,32,105
25,2022/7/15 6:40,60,25,35,173
25,2022/7/15 6:50,79,23,56,278
25,2022/7/15 7:00,186,46,140,459
25,2022/7/15 7:10,192,64,128,657
25,2022/7/15 7:20,227,62,165,1002
25,2022/7/15 7:30,254,68,186,1312
25,2022/7/15 7:40,350,75,275,1791
25,2022/7/15 7:50,368,74,294,2269
25,2022/7/15 8:00,478,110,368,2440
25,2022/7/15 8:10,571,123,448,2239
25,2022/7/15 8:20,573,139,434,1536
25,2022/7/15 8:30,368,152,216,855
25,2022/7/15 8:40,278,222,56,-347
25,2022/7/15 8:50,247,110,137,-130
25,2022/7/15 9:00,212,110,102,-290
25,2022/7/15 9:10,181,105,76,-471
25,2022/7/15 9:20,122,108,14,-522
25,2022/7/15 9:30,75,98,-23,-430
25,2022/7/15 9:40,60,84,-24,-445
25,2022/7/15 9:50,48,76,-28,-399
25,2022/7/15 10:00,43,73,-30,-369
25,2022/7/15 10:10,38,70,-32,-323
25,2022/7/15 10:20,37,70,-33,-306
25,2022/7/15 10:30,29,71,-42,-350
25,2022/7/15 10:40,32,72,-40,-318
25,2022/7/15 10:50,31,62,-31,-300
25,2022/7/15 11:00,31,62,-31,-300
25,2022/7/15 11:10,32,67,-35,-297
25,2022/7/15 11:20,29,64,-35,-275
25,2022/7/15 11:30,32,66,-34,-279
25,2022/7/15 11:40,27,61,-34,-249
25,2022/7/15 11:50,33,70,-37,-222
25,2022/7/15 12:00,31,67,-36,-219
25,2022/7/15 12:10,31,66,-35,-237
25,2022/7/15 12:20,32,66,-34,-228
25,2022/7/15 12:30,31,70,-39,-260
25,2022/7/15 12:40,29,73,-44,-277
25,2022/7/15 12:50,31,71,-40,-260
25,2022/7/15 13:00,34,62,-28,-280
25,2022/7/15 13:10,33,71,-38,-280
25,2022/7/15 13:20,31,69,-38,-301
25,2022/7/15 13:30,33,70,-37,-303
25,2022/7/15 13:40,28,69,-41,-326
25,2022/7/15 13:50,29,87,-58,-319
25,2022/7/15 14:00,33,64,-31,-304
25,2022/7/15 14:10,31,77,-46,-299
25,2022/7/15 14:20,25,77,-52,-328
25,2022/7/15 14:30,34,66,-32,-271
25,2022/7/15 14:40,29,76,-47,-316
25,2022/7/15 14:50,31,85,-54,-330
25,2022/7/15 15:00,33,74,-41,-323
25,2022/7/15 15:10,30,83,-53,-252
25,2022/7/15 15:20,35,76,-41,-296
25,2022/7/15 15:30,35,97,-62,-356
25,2022/7/15 15:40,29,90,-61,-384
25,2022/7/15 15:50,36,93,-57,-327
25,2022/7/15 16:00,38,91,-53,-329
25,2022/7/15 16:10,34,101,-67,-332
25,2022/7/15 16:20,36,108,-72,-332
25,2022/7/15 16:30,37,106,-69,-283
25,2022/7/15 16:40,43,112,-69,-145
25,2022/7/15 16:50,43,106,-63,-220
25,2022/7/15 17:00,91,116,-25,116
25,2022/7/15 17:10,133,123,10,255
25,2022/7/15 17:20,61,118,-57,2
25,2022/7/15 17:30,80,151,-71,-83
25,2022/7/15 17:40,185,183,2,107
25,2022/7/15 17:50,83,178,-95,-294
25,2022/7/15 18:00,72,226,-154,-813
25,2022/7/15 18:10,130,226,-96,-332
25,2022/7/15 18:20,74,223,-149,-700
25,2022/7/15 18:30,46,226,-180,-987
25,2022/7/15 18:40,44,198,-154,-1011
25,2022/7/15 18:50,43,184,-141,-992
25,2022/7/15 19:00,37,152,-115,-862
25,2022/7/15 19:10,38,110,-72,-599
25,2022/7/15 19:20,33,109,-76,-469
25,2022/7/15 19:30,29,118,-89,-527
25,2022/7/15 19:40,27,104,-77,-492
25,2022/7/15 19:50,27,106,-79,-457
25,2022/7/15 20:00,28,108,-80,-433
25,2022/7/15 20:10,28,110,-82,-407
25,2022/7/15 20:20,28,79,-51,-277
25,2022/7/15 20:30,23,107,-84,-388
25,2022/7/15 20:40,29,78,-49,-284
25,2022/7/15 20:50,25,106,-81,-341
25,2022/7/15 21:00,24,94,-70,-288
25,2022/7/15 21:10,23,106,-83,-350
25,2022/7/15 21:20,22,99,-77,-410
25,2022/7/15 21:30,16,100,-84,-366
25,2022/7/15 21:40,13,105,-92,-348
25,2022/7/15 21:50,14,87,-73,-400
25,2022/7/15 22:00,16,107,-91,-448
25,2022/7/15 22:10,6,73,-67,-505
25,2022/7/15 22:20,4,99,-95,-540
25,2022/7/15 22:30,1,73,-72,-517
25,2022/7/15 22:40,0,59,-59,-426
25,2022/7/15 22:50,0,3,-3,-235
2,2022/7/15 5:00,0,1,-1,-8
2,2022/7/15 5:10,1,1,0,12
2,2022/7/15 5:20,3,1,2,46
2,2022/7/15 5:30,8,1,7,79
2,2022/7/15 5:40,18,1,17,109
2,2022/7/15 5:50,21,6,15,113
2,2022/7/15 6:00,23,21,2,150
2,2022/7/15 6:10,30,21,9,123
2,2022/7/15 6:20,33,23,10,99
2,2022/7/15 6:30,41,38,3,108
2,2022/7/15 6:40,44,33,11,184
2,2022/7/15 6:50,63,52,11,289
2,2022/7/15 7:00,76,67,9,468
2,2022/7/15 7:10,91,68,23,680
2,2022/7/15 7:20,101,75,26,1028
2,2022/7/15 7:30,162,105,57,1369
2,2022/7/15 7:40,226,122,104,1895
2,2022/7/15 7:50,274,185,89,2358
2,2022/7/15 8:00,300,281,19,2459
2,2022/7/15 8:10,318,507,-189,2050
2,2022/7/15 8:20,337,535,-198,1338
2,2022/7/15 8:30,303,434,-131,724
2,2022/7/15 8:40,269,1126,-857,-1204
2,2022/7/15 8:50,224,429,-205,-335
2,2022/7/15 9:00,182,317,-135,-425
2,2022/7/15 9:10,145,217,-72,-543
2,2022/7/15 9:20,83,181,-98,-620
2,2022/7/15 9:30,65,133,-68,-498
2,2022/7/15 9:40,51,121,-70,-515
2,2022/7/15 9:50,48,109,-61,-460
2,2022/7/15 10:00,45,105,-60,-429
2,2022/7/15 10:10,44,98,-54,-377
2,2022/7/15 10:20,42,90,-48,-354
2,2022/7/15 10:30,37,90,-53,-403
2,2022/7/15 10:40,36,93,-57,-375
2,2022/7/15 10:50,36,76,-40,-340
2,2022/7/15 11:00,37,70,-33,-333
2,2022/7/15 11:10,36,85,-49,-346
2,2022/7/15 11:20,37,81,-44,-319
2,2022/7/15 11:30,38,74,-36,-315
2,2022/7/15 11:40,34,76,-42,-291
2,2022/7/15 11:50,34,70,-36,-258
2,2022/7/15 12:00,38,76,-38,-257
2,2022/7/15 12:10,45,69,-24,-261
2,2022/7/15 12:20,44,76,-32,-260
2,2022/7/15 12:30,41,73,-32,-292
2,2022/7/15 12:40,46,76,-30,-307
2,2022/7/15 12:50,41,90,-49,-309
2,2022/7/15 13:00,41,73,-32,-312
2,2022/7/15 13:10,38,104,-66,-346
2,2022/7/15 13:20,41,76,-35,-336
2,2022/7/15 13:30,38,93,-55,-358
2,2022/7/15 13:40,44,82,-38,-364
2,2022/7/15 13:50,41,87,-46,-365
2,2022/7/15 14:00,41,93,-52,-356
2,2022/7/15 14:10,44,82,-38,-337
2,2022/7/15 14:20,36,94,-58,-386
2,2022/7/15 14:30,35,81,-46,-317
2,2022/7/15 14:40,40,79,-39,-355
2,2022/7/15 14:50,37,79,-42,-372
2,2022/7/15 15:00,43,77,-34,-357
2,2022/7/15 15:10,41,93,-52,-304
2,2022/7/15 15:20,42,83,-41,-337
2,2022/7/15 15:30,45,105,-60,-416
2,2022/7/15 15:40,43,87,-44,-428
2,2022/7/15 15:50,46,104,-58,-385
2,2022/7/15 16:00,50,92,-42,-371
2,2022/7/15 16:10,53,97,-44,-376
2,2022/7/15 16:20,47,100,-53,-385
2,2022/7/15 16:30,68,99,-31,-314
2,2022/7/15 16:40,94,112,-18,-163
2,2022/7/15 16:50,85,105,-20,-240
2,2022/7/15 17:00,277,108,169,285
2,2022/7/15 17:10,310,125,185,440
2,2022/7/15 17:20,275,110,165,167
2,2022/7/15 17:30,327,108,219,136
2,2022/7/15 17:40,710,142,568,675
2,2022/7/15 17:50,462,181,281,-13
2,2022/7/15 18:00,326,184,142,-671
2,2022/7/15 18:10,577,192,385,53
2,2022/7/15 18:20,272,159,113,-587
2,2022/7/15 18:30,205,185,20,-967
2,2022/7/15 18:40,176,152,24,-987
2,2022/7/15 18:50,89,117,-28,-1020
2,2022/7/15 19:00,76,110,-34,-896
2,2022/7/15 19:10,65,124,-59,-658
2,2022/7/15 19:20,52,103,-51,-520
2,2022/7/15 19:30,45,111,-66,-593
2,2022/7/15 19:40,39,105,-66,-558
2,2022/7/15 19:50,40,95,-55,-512
2,2022/7/15 20:00,39,82,-43,-476
2,2022/7/15 20:10,40,95,-55,-462
2,2022/7/15 20:20,36,93,-57,-334
2,2022/7/15 20:30,32,79,-47,-435
2,2022/7/15 20:40,37,92,-55,-339
2,2022/7/15 20:50,36,78,-42,-383
2,2022/7/15 21:00,30,77,-47,-335
2,2022/7/15 21:10,29,82,-53,-403
2,2022/7/15 21:20,30,97,-67,-477
2,2022/7/15 21:30,29,76,-47,-413
2,2022/7/15 21:40,26,80,-54,-402
2,2022/7/15 21:50,28,79,-51,-451
2,2022/7/15 22:00,23,86,-63,-511
2,2022/7/15 22:10,28,79,-51,-556
2,2022/7/15 22:20,15,78,-63,-603
2,2022/7/15 22:30,11,77,-66,-583
2,2022/7/15 22:40,5,52,-47,-473
2,2022/7/15 22:50,0,3,-3,-238
16,2022/7/15 5:00,0,1,-1,-9
16,2022/7/15 5:10,0,1,-1,11
16,2022/7/15 5:20,2,1,1,47
16,2022/7/15 5:30,6,1,5,84
16,2022/7/15 5:40,13,1,12,121
16,2022/7/15 5:50,13,5,8,121
16,2022/7/15 6:00,17,8,9,159
16,2022/7/15 6:10,22,23,-1,122
16,2022/7/15 6:20,22,30,-8,91
16,2022/7/15 6:30,30,37,-7,101
16,2022/7/15 6:40,32,63,-31,153
16,2022/7/15 6:50,31,93,-62,227
16,2022/7/15 7:00,42,123,-81,387
16,2022/7/15 7:10,52,109,-57,623
16,2022/7/15 7:20,56,126,-70,958
16,2022/7/15 7:30,67,124,-57,1312
16,2022/7/15 7:40,94,139,-45,1850
16,2022/7/15 7:50,145,197,-52,2306
16,2022/7/15 8:00,180,506,-326,2133
16,2022/7/15 8:10,189,565,-376,1674
16,2022/7/15 8:20,224,1597,-1373,-35
16,2022/7/15 8:30,221,1522,-1301,-577
16,2022/7/15 8:40,176,1981,-1805,-3009
16,2022/7/15 8:50,150,1521,-1371,-1706
16,2022/7/15 9:00,84,429,-345,-770
16,2022/7/15 9:10,74,508,-434,-977
16,2022/7/15 9:20,68,317,-249,-869
16,2022/7/15 9:30,58,190,-132,-630
16,2022/7/15 9:40,53,169,-116,-631
16,2022/7/15 9:50,49,142,-93,-553
16,2022/7/15 10:00,45,129,-84,-513
16,2022/7/15 10:10,43,102,-59,-436
16,2022/7/15 10:20,49,114,-65,-419
16,2022/7/15 10:30,47,104,-57,-460
16,2022/7/15 10:40,45,113,-68,-443
16,2022/7/15 10:50,42,112,-70,-410
16,2022/7/15 11:00,44,111,-67,-400
16,2022/7/15 11:10,48,106,-58,-404
16,2022/7/15 11:20,45,101,-56,-375
16,2022/7/15 11:30,49,111,-62,-377
16,2022/7/15 11:40,49,104,-55,-346
16,2022/7/15 11:50,47,110,-63,-321
16,2022/7/15 12:00,56,100,-44,-301
16,2022/7/15 12:10,59,105,-46,-307
16,2022/7/15 12:20,45,108,-63,-323
16,2022/7/15 12:30,58,108,-50,-342
16,2022/7/15 12:40,50,109,-59,-366
16,2022/7/15 12:50,58,108,-50,-359
16,2022/7/15 13:00,54,105,-51,-363
16,2022/7/15 13:10,67,107,-40,-386
16,2022/7/15 13:20,62,105,-43,-379
16,2022/7/15 13:30,60,109,-49,-407
16,2022/7/15 13:40,58,108,-50,-414
16,2022/7/15 13:50,60,105,-45,-410
16,2022/7/15 14:00,56,112,-56,-412
16,2022/7/15 14:10,55,111,-56,-393
16,2022/7/15 14:20,58,106,-48,-434
16,2022/7/15 14:30,56,106,-50,-367
16,2022/7/15 14:40,52,112,-60,-415
16,2022/7/15 14:50,57,112,-55,-427
16,2022/7/15 15:00,56,105,-49,-406
16,2022/7/15 15:10,71,109,-38,-342
16,2022/7/15 15:20,77,104,-27,-364
16,2022/7/15 15:30,67,104,-37,-453
16,2022/7/15 15:40,83,108,-25,-453
16,2022/7/15 15:50,68,103,-35,-420
16,2022/7/15 16:00,85,109,-24,-395
16,2022/7/15 16:10,79,105,-26,-402
16,2022/7/15 16:20,92,106,-14,-399
16,2022/7/15 16:30,167,105,62,-252
16,2022/7/15 16:40,178,105,73,-90
16,2022/7/15 16:50,206,106,100,-140
16,2022/7/15 17:00,342,109,233,518
16,2022/7/15 17:10,461,97,364,804
16,2022/7/15 17:20,312,120,192,359
16,2022/7/15 17:30,657,109,548,684
16,2022/7/15 17:40,1045,132,913,1588
16,2022/7/15 17:50,710,181,529,516
16,2022/7/15 18:00,835,152,683,12
16,2022/7/15 18:10,1149,153,996,1049
16,2022/7/15 18:20,679,153,526,-61
16,2022/7/15 18:30,576,150,426,-541
16,2022/7/15 18:40,311,144,167,-820
16,2022/7/15 18:50,274,116,158,-862
16,2022/7/15 19:00,216,111,105,-791
16,2022/7/15 19:10,222,112,110,-548
16,2022/7/15 19:20,178,115,63,-457
16,2022/7/15 19:30,175,97,78,-515
16,2022/7/15 19:40,139,95,44,-514
16,2022/7/15 19:50,130,83,47,-465
16,2022/7/15 20:00,102,99,3,-473
16,2022/7/15 20:10,84,71,13,-449
16,2022/7/15 20:20,70,79,-9,-343
16,2022/7/15 20:30,67,63,4,-431
16,2022/7/15 20:40,67,87,-20,-359
16,2022/7/15 20:50,76,67,9,-374
16,2022/7/15 21:00,64,85,-21,-356
16,2022/7/15 21:10,59,69,-10,-413
16,2022/7/15 21:20,43,75,-32,-509
16,2022/7/15 21:30,39,79,-40,-453
16,2022/7/15 21:40,38,67,-29,-431
16,2022/7/15 21:50,30,77,-47,-498
16,2022/7/15 22:00,39,61,-22,-533
16,2022/7/15 22:10,26,76,-50,-606
16,2022/7/15 22:20,12,74,-62,-665
16,2022/7/15 22:30,5,67,-62,-645
16,2022/7/15 22:40,0,24,-24,-497
16,2022/7/15 22:50,0,3,-3,-241
18,2022/7/15 5:00,0,1,-1,-10
18,2022/7/15 5:10,0,1,-1,10
18,2022/7/15 5:20,1,1,0,47
18,2022/7/15 5:30,5,1,4,88
18,2022/7/15 5:40,10,8,2,123
18,2022/7/15 5:50,15,23,-8,113
18,2022/7/15 6:00,16,57,-41,118
18,2022/7/15 6:10,19,59,-40,82
18,2022/7/15 6:20,27,68,-41,50
18,2022/7/15 6:30,24,93,-69,32
18,2022/7/15 6:40,33,106,-73,80
18,2022/7/15 6:50,32,105,-73,154
18,2022/7/15 7:00,37,123,-86,301
18,2022/7/15 7:10,31,123,-92,531
18,2022/7/15 7:20,44,128,-84,874
18,2022/7/15 7:30,52,152,-100,1212
18,2022/7/15 7:40,57,152,-95,1755
18,2022/7/15 7:50,61,269,-208,2098
18,2022/7/15 8:00,70,325,-255,1878
18,2022/7/15 8:10,75,421,-346,1328
18,2022/7/15 8:20,69,491,-422,-457
18,2022/7/15 8:30,68,589,-521,-1098
18,2022/7/15 8:40,54,574,-520,-3529
18,2022/7/15 8:50,53,505,-452,-2158
18,2022/7/15 9:00,49,333,-284,-1054
18,2022/7/15 9:10,45,298,-253,-1230
18,2022/7/15 9:20,43,196,-153,-1022
18,2022/7/15 9:30,42,225,-183,-813
18,2022/7/15 9:40,46,232,-186,-817
18,2022/7/15 9:50,47,221,-174,-727
18,2022/7/15 10:00,41,179,-138,-651
18,2022/7/15 10:10,44,192,-148,-584
18,2022/7/15 10:20,40,192,-152,-571
18,2022/7/15 10:30,44,180,-136,-596
18,2022/7/15 10:40,48,146,-98,-541
18,2022/7/15 10:50,51,146,-95,-505
18,2022/7/15 11:00,62,169,-107,-507
18,2022/7/15 11:10,60,153,-93,-497
18,2022/7/15 11:20,66,138,-72,-447
18,2022/7/15 11:30,70,181,-111,-488
18,2022/7/15 11:40,73,151,-78,-424
18,2022/7/15 11:50,75,142,-67,-388
18,2022/7/15 12:00,82,137,-55,-356
18,2022/7/15 12:10,108,151,-43,-350
18,2022/7/15 12:20,124,110,14,-309
18,2022/7/15 12:30,124,170,-46,-388
18,2022/7/15 12:40,132,138,-6,-372
18,2022/7/15 12:50,156,153,3,-356
18,2022/7/15 13:00,175,152,23,-340
18,2022/7/15 13:10,174,146,28,-358
18,2022/7/15 13:20,173,182,-9,-388
18,2022/7/15 13:30,198,170,28,-379
18,2022/7/15 13:40,204,192,12,-402
18,2022/7/15 13:50,191,154,37,-373
18,2022/7/15 14:00,203,170,33,-379
18,2022/7/15 14:10,206,139,67,-326
18,2022/7/15 14:20,207,119,88,-346
18,2022/7/15 14:30,201,138,63,-304
18,2022/7/15 14:40,217,105,112,-303
18,2022/7/15 14:50,242,105,137,-290
18,2022/7/15 15:00,243,109,134,-272
18,2022/7/15 15:10,268,110,158,-184
18,2022/7/15 15:20,272,122,150,-214
18,2022/7/15 15:30,267,119,148,-305
18,2022/7/15 15:40,270,116,154,-299
18,2022/7/15 15:50,261,88,173,-247
18,2022/7/15 16:00,265,102,163,-232
18,2022/7/15 16:10,287,108,179,-223
18,2022/7/15 16:20,293,102,191,-208
18,2022/7/15 16:30,331,105,226,-26
18,2022/7/15 16:40,350,96,254,164
18,2022/7/15 16:50,368,96,272,132
18,2022/7/15 17:00,695,99,596,1114
18,2022/7/15 17:10,654,90,564,1368
18,2022/7/15 17:20,598,99,499,858
18,2022/7/15 17:30,618,98,520,1204
18,2022/7/15 17:40,706,93,613,2201
18,2022/7/15 17:50,698,104,594,1110
18,2022/7/15 18:00,575,108,467,479
18,2022/7/15 18:10,639,92,547,1596
18,2022/7/15 18:20,368,99,269,208
18,2022/7/15 18:30,273,112,161,-380
18,2022/7/15 18:40,218,92,126,-694
18,2022/7/15 18:50,174,93,81,-781
18,2022/7/15 19:00,127,68,59,-732
18,2022/7/15 19:10,73,69,4,-544
18,2022/7/15 19:20,42,67,-25,-482
18,2022/7/15 19:30,36,67,-31,-546
18,2022/7/15 19:40,30,59,-29,-543
18,2022/7/15 19:50,29,51,-22,-487
18,2022/7/15 20:00,31,47,-16,-489
18,2022/7/15 20:10,31,56,-25,-474
18,2022/7/15 20:20,26,49,-23,-366
18,2022/7/15 20:30,24,67,-43,-474
18,2022/7/15 20:40,25,47,-22,-381
18,2022/7/15 20:50,23,63,-40,-414
18,2022/7/15 21:00,29,47,-18,-374
18,2022/7/15 21:10,27,53,-26,-439
18,2022/7/15 21:20,23,49,-26,-535
18,2022/7/15 21:30,20,60,-40,-493
18,2022/7/15 21:40,22,54,-32,-463
18,2022/7/15 21:50,15,51,-36,-534
18,2022/7/15 22:00,20,56,-36,-569
18,2022/7/15 22:10,11,40,-29,-635
18,2022/7/15 22:20,6,71,-65,-730
18,2022/7/15 22:30,2,55,-53,-698
18,2022/7/15 22:40,0,25,-25,-522
18,2022/7/15 22:50,0,3,-3,-244
10,2022/7/15 5:00,0,1,-1,-11
10,2022/7/15 5:10,2,1,1,11
10,2022/7/15 5:20,7,1,6,53
10,2022/7/15 5:30,10,11,-1,87
10,2022/7/15 5:40,15,6,9,132
10,2022/7/15 5:50,23,13,10,123
10,2022/7/15 6:00,22,46,-24,94
10,2022/7/15 6:10,26,58,-32,50
10,2022/7/15 6:20,29,60,-31,19
10,2022/7/15 6:30,34,73,-39,-7
10,2022/7/15 6:40,38,77,-39,41
10,2022/7/15 6:50,34,106,-72,82
10,2022/7/15 7:00,42,113,-71,230
10,2022/7/15 7:10,46,117,-71,460
10,2022/7/15 7:20,52,190,-138,736
10,2022/7/15 7:30,58,325,-267,945
10,2022/7/15 7:40,68,443,-375,1380
10,2022/7/15 7:50,83,440,-357,1741
10,2022/7/15 8:00,113,1189,-1076,802
10,2022/7/15 8:10,154,2156,-2002,-674
10,2022/7/15 8:20,155,3168,-3013,-3470
10,2022/7/15 8:30,128,3266,-3138,-4236
10,2022/7/15 8:40,83,2848,-2765,-6294
10,2022/7/15 8:50,78,3164,-3086,-5244
10,2022/7/15 9:00,69,1627,-1558,-2612
10,2022/7/15 9:10,66,1565,-1499,-2729
10,2022/7/15 9:20,70,1120,-1050,-2072
10,2022/7/15 9:30,71,478,-407,-1220
10,2022/7/15 9:40,65,427,-362,-1179
10,2022/7/15 9:50,67,438,-371,-1098
10,2022/7/15 10:00,66,323,-257,-908
10,2022/7/15 10:10,72,326,-254,-838
10,2022/7/15 10:20,73,232,-159,-730
10,2022/7/15 10:30,69,207,-138,-734
10,2022/7/15 10:40,82,179,-97,-638
10,2022/7/15 10:50,74,178,-104,-609
10,2022/7/15 11:00,91,171,-80,-587
10,2022/7/15 11:10,100,117,-17,-514
10,2022/7/15 11:20,100,152,-52,-499
10,2022/7/15 11:30,127,128,-1,-489
10,2022/7/15 11:40,114,139,-25,-449
10,2022/7/15 11:50,132,152,-20,-408
10,2022/7/15 12:00,128,120,8,-348
10,2022/7/15 12:10,113,105,8,-342
10,2022/7/15 12:20,141,150,-9,-318
10,2022/7/15 12:30,131,112,19,-369
10,2022/7/15 12:40,135,160,-25,-397
10,2022/7/15 12:50,131,154,-23,-379
10,2022/7/15 13:00,154,192,-38,-378
10,2022/7/15 13:10,169,185,-16,-374
10,2022/7/15 13:20,175,192,-17,-405
10,2022/7/15 13:30,175,185,-10,-389
10,2022/7/15 13:40,200,179,21,-381
10,2022/7/15 13:50,196,171,25,-348
10,2022/7/15 14:00,213,183,30,-349
10,2022/7/15 14:10,214,144,70,-256
10,2022/7/15 14:20,195,170,25,-321
10,2022/7/15 14:30,210,139,71,-233
10,2022/7/15 14:40,207,154,53,-250
10,2022/7/15 14:50,216,139,77,-213
10,2022/7/15 15:00,236,117,119,-153
10,2022/7/15 15:10,270,111,159,-25
10,2022/7/15 15:20,270,117,153,-61
10,2022/7/15 15:30,263,117,146,-159
10,2022/7/15 15:40,271,117,154,-145
10,2022/7/15 15:50,272,119,153,-94
10,2022/7/15 16:00,319,115,204,-28
10,2022/7/15 16:10,344,109,235,12
10,2022/7/15 16:20,342,119,223,15
10,2022/7/15 16:30,552,129,423,397
10,2022/7/15 16:40,576,129,447,611
10,2022/7/15 16:50,552,128,424,556
10,2022/7/15 17:00,1160,123,1037,2151
10,2022/7/15 17:10,1357,106,1251,2619
10,2022/7/15 17:20,1025,157,868,1726
10,2022/7/15 17:30,1357,179,1178,2382
10,2022/7/15 17:40,1587,178,1409,3610
10,2022/7/15 17:50,1030,213,817,1927
10,2022/7/15 18:00,1209,223,986,1465
10,2022/7/15 18:10,1357,235,1122,2718
10,2022/7/15 18:20,1037,234,803,1011
10,2022/7/15 18:30,705,200,505,125
10,2022/7/15 18:40,654,236,418,-276
10,2022/7/15 18:50,568,179,389,-392
10,2022/7/15 19:00,552,180,372,-360
10,2022/7/15 19:10,422,114,308,-236
10,2022/7/15 19:20,327,109,218,-264
10,2022/7/15 19:30,306,114,192,-354
10,2022/7/15 19:40,289,100,189,-354
10,2022/7/15 19:50,295,99,196,-291
10,2022/7/15 20:00,575,108,467,-22
10,2022/7/15 20:10,576,111,465,-9
10,2022/7/15 20:20,332,107,225,-141
10,2022/7/15 20:30,264,105,159,-315
10,2022/7/15 20:40,271,92,179,-202
10,2022/7/15 20:50,270,94,176,-238
10,2022/7/15 21:00,265,88,177,-197
10,2022/7/15 21:10,268,81,187,-252
10,2022/7/15 21:20,214,99,115,-420
10,2022/7/15 21:30,261,69,192,-301
10,2022/7/15 21:40,213,78,135,-328
10,2022/7/15 21:50,191,64,127,-407
10,2022/7/15 22:00,216,78,138,-431
10,2022/7/15 22:10,168,78,90,-545
10,2022/7/15 22:20,46,85,-39,-769
10,2022/7/15 22:30,35,70,-35,-733
10,2022/7/15 22:40,24,64,-40,-562
10,2022/7/15 22:50,16,50,-34,-278
26,2022/7/15 5:00,0,1,-1,-12
26,2022/7/15 5:10,0,1,-1,10
26,2022/7/15 5:20,1,1,0,53
26,2022/7/15 5:30,3,1,2,89
26,2022/7/15 5:40,12,1,11,143
26,2022/7/15 5:50,20,6,14,137
26,2022/7/15 6:00,19,23,-4,90
26,2022/7/15 6:10,21,41,-20,30
26,2022/7/15 6:20,30,51,-21,-2
26,2022/7/15 6:30,32,62,-30,-37
26,2022/7/15 6:40,31,77,-46,-5
26,2022/7/15 6:50,34,76,-42,40
26,2022/7/15 7:00,38,93,-55,175
26,2022/7/15 7:10,44,111,-67,393
26,2022/7/15 7:20,57,119,-62,674
26,2022/7/15 7:30,60,139,-79,866
26,2022/7/15 7:40,76,180,-104,1276
26,2022/7/15 7:50,148,335,-187,1554
26,2022/7/15 8:00,144,497,-353,449
26,2022/7/15 8:10,153,565,-412,-1086
26,2022/7/15 8:20,173,1095,-922,-4392
26,2022/7/15 8:30,150,1094,-944,-5180
26,2022/7/15 8:40,121,2051,-1930,-8224
26,2022/7/15 8:50,81,1104,-1023,-6267
26,2022/7/15 9:00,77,433,-356,-2968
26,2022/7/15 9:10,69,417,-348,-3077
26,2022/7/15 9:20,66,378,-312,-2384
26,2022/7/15 9:30,59,379,-320,-1540
26,2022/7/15 9:40,62,334,-272,-1451
26,2022/7/15 9:50,63,332,-269,-1367
26,2022/7/15 10:00,62,269,-207,-1115
26,2022/7/15 10:10,64,219,-155,-993
26,2022/7/15 10:20,63,214,-151,-881
26,2022/7/15 10:30,70,209,-139,-873
26,2022/7/15 10:40,65,198,-133,-771
26,2022/7/15 10:50,75,192,-117,-726
26,2022/7/15 11:00,75,153,-78,-665
26,2022/7/15 11:10,92,186,-94,-608
26,2022/7/15 11:20,87,151,-64,-563
26,2022/7/15 11:30,91,170,-79,-568
26,2022/7/15 11:40,131,109,22,-427
26,2022/7/15 11:50,133,120,13,-395
26,2022/7/15 12:00,139,110,29,-319
26,2022/7/15 12:10,176,120,56,-286
26,2022/7/15 12:20,172,105,67,-251
26,2022/7/15 12:30,156,111,45,-324
26,2022/7/15 12:40,186,170,16,-381
26,2022/7/15 12:50,179,152,27,-352
26,2022/7/15 13:00,177,138,39,-339
26,2022/7/15 13:10,204,159,45,-329
26,2022/7/15 13:20,213,152,61,-344
26,2022/7/15 13:30,207,156,51,-338
26,2022/7/15 13:40,201,181,20,-361
26,2022/7/15 13:50,202,146,56,-292
26,2022/7/15 14:00,225,169,56,-293
26,2022/7/15 14:10,218,171,47,-209
26,2022/7/15 14:20,218,127,91,-230
26,2022/7/15 14:30,210,111,99,-134
26,2022/7/15 14:40,237,119,118,-132
26,2022/7/15 14:50,216,128,88,-125
26,2022/7/15 15:00,273,112,161,8
26,2022/7/15 15:10,272,117,155,130
26,2022/7/15 15:20,266,108,158,97
26,2022/7/15 15:30,310,125,185,26
26,2022/7/15 15:40,268,109,159,14
26,2022/7/15 15:50,254,110,144,50
26,2022/7/15 16:00,272,104,168,140
26,2022/7/15 16:10,262,120,142,154
26,2022/7/15 16:20,268,123,145,160
26,2022/7/15 16:30,338,119,219,616
26,2022/7/15 16:40,334,123,211,822
26,2022/7/15 16:50,328,126,202,758
26,2022/7/15 17:00,636,121,515,2666
26,2022/7/15 17:10,657,114,543,3162
26,2022/7/15 17:20,674,103,571,2297
26,2022/7/15 17:30,710,120,590,2972
26,2022/7/15 17:40,1362,111,1251,4861
26,2022/7/15 17:50,730,110,620,2547
26,2022/7/15 18:00,697,121,576,2041
26,2022/7/15 18:10,1043,120,923,3641
26,2022/7/15 18:20,697,107,590,1601
26,2022/7/15 18:30,360,110,250,375
26,2022/7/15 18:40,315,110,205,-71
26,2022/7/15 18:50,247,126,121,-271
26,2022/7/15 19:00,205,124,81,-279
26,2022/7/15 19:10,198,110,88,-148
26,2022/7/15 19:20,138,97,41,-223
26,2022/7/15 19:30,138,88,50,-304
26,2022/7/15 19:40,113,77,36,-318
26,2022/7/15 19:50,80,79,1,-290
26,2022/7/15 20:00,102,79,23,1
26,2022/7/15 20:10,76,67,9,0
26,2022/7/15 20:20,67,87,-20,-161
26,2022/7/15 20:30,64,72,-8,-323
26,2022/7/15 20:40,71,72,-1,-203
26,2022/7/15 20:50,88,68,20,-218
26,2022/7/15 21:00,174,74,100,-97
26,2022/7/15 21:10,85,78,7,-245
26,2022/7/15 21:20,47,73,-26,-446
26,2022/7/15 21:30,40,71,-31,-332
26,2022/7/15 21:40,35,72,-37,-365
26,2022/7/15 21:50,28,65,-37,-444
26,2022/7/15 22:00,32,74,-42,-473
26,2022/7/15 22:10,28,74,-46,-591
26,2022/7/15 22:20,21,84,-63,-832
26,2022/7/15 22:30,1,46,-45,-778
26,2022/7/15 22:40,0,3,-3,-565
26,2022/7/15 22:50,0,3,-3,-281
22,2022/7/15 5:00,0,1,-1,-13
22,2022/7/15 5:10,0,1,-1,9
22,2022/7/15 5:20,0,1,-1,52
22,2022/7/15 5:30,2,1,1,90
22,2022/7/15 5:40,8,1,7,150
22,2022/7/15 5:50,13,6,7,144
22,2022/7/15 6:00,15,16,-1,89
22,2022/7/15 6:10,16,21,-5,25
22,2022/7/15 6:20,22,23,-1,-3
22,2022/7/15 6:30,29,35,-6,-43
22,2022/7/15 6:40,32,54,-22,-27
22,2022/7/15 6:50,36,55,-19,21
22,2022/7/15 7:00,40,68,-28,147
22,2022/7/15 7:10,42,75,-33,360
22,2022/7/15 7:20,44,92,-48,626
22,2022/7/15 7:30,55,114,-59,807
22,2022/7/15 7:40,58,120,-62,1214
22,2022/7/15 7:50,85,117,-32,1522
22,2022/7/15 8:00,85,159,-74,375
22,2022/7/15 8:10,127,324,-197,-1283
22,2022/7/15 8:20,146,297,-151,-4543
22,2022/7/15 8:30,149,298,-149,-5329
22,2022/7/15 8:40,85,432,-347,-8571
22,2022/7/15 8:50,73,341,-268,-6535
22,2022/7/15 9:00,49,384,-335,-3303
22,2022/7/15 9:10,51,323,-272,-3349
22,2022/7/15 9:20,48,255,-207,-2591
22,2022/7/15 9:30,43,213,-170,-1710
22,2022/7/15 9:40,40,196,-156,-1607
22,2022/7/15 9:50,32,145,-113,-1480
22,2022/7/15 10:00,37,108,-71,-1186
22,2022/7/15 10:10,31,107,-76,-1069
22,2022/7/15 10:20,36,118,-82,-963
22,2022/7/15 10:30,39,112,-73,-946
22,2022/7/15 10:40,36,112,-76,-847
22,2022/7/15 10:50,33,104,-71,-797
22,2022/7/15 11:00,33,92,-59,-724
22,2022/7/15 11:10,33,93,-60,-668
22,2022/7/15 11:20,37,91,-54,-617
22,2022/7/15 11:30,39,114,-75,-643
22,2022/7/15 11:40,37,101,-64,-491
22,2022/7/15 11:50,38,97,-59,-454
22,2022/7/15 12:00,39,96,-57,-376
22,2022/7/15 12:10,35,106,-71,-357
22,2022/7/15 12:20,36,98,-62,-313
22,2022/7/15 12:30,42,105,-63,-387
22,2022/7/15 12:40,37,106,-69,-450
22,2022/7/15 12:50,41,108,-67,-419
22,2022/7/15 13:00,37,109,-72,-411
22,2022/7/15 13:10,40,119,-79,-408
22,2022/7/15 13:20,41,107,-66,-410
22,2022/7/15 13:30,44,88,-44,-382
22,2022/7/15 13:40,43,107,-64,-425
22,2022/7/15 13:50,43,100,-57,-349
22,2022/7/15 14:00,42,106,-64,-357
22,2022/7/15 14:10,42,112,-70,-279
22,2022/7/15 14:20,44,105,-61,-291
22,2022/7/15 14:30,52,103,-51,-185
22,2022/7/15 14:40,46,103,-57,-189
22,2022/7/15 14:50,46,107,-61,-186
22,2022/7/15 15:00,51,109,-58,-50
22,2022/7/15 15:10,63,109,-46,84
22,2022/7/15 15:20,59,106,-47,50
22,2022/7/15 15:30,53,105,-52,-26
22,2022/7/15 15:40,61,105,-44,-30
22,2022/7/15 15:50,69,108,-39,11
22,2022/7/15 16:00,73,101,-28,112
22,2022/7/15 16:10,76,112,-36,118
22,2022/7/15 16:20,77,108,-31,129
22,2022/7/15 16:30,74,102,-28,588
22,2022/7/15 16:40,80,105,-25,797
22,2022/7/15 16:50,85,108,-23,735
22,2022/7/15 17:00,232,102,130,2796
22,2022/7/15 17:10,216,103,113,3275
22,2022/7/15 17:20,186,102,84,2381
22,2022/7/15 17:30,272,103,169,3141
22,2022/7/15 17:40,347,123,224,5085
22,2022/7/15 17:50,247,116,131,2678
22,2022/7/15 18:00,293,111,182,2223
22,2022/7/15 18:10,552,116,436,4077
22,2022/7/15 18:20,325,138,187,1788
22,2022/7/15 18:30,272,152,120,495
22,2022/7/15 18:40,241,119,122,51
22,2022/7/15 18:50,213,112,101,-170
22,2022/7/15 19:00,163,122,41,-238
22,2022/7/15 19:10,141,123,18,-130
22,2022/7/15 19:20,92,102,-10,-233
22,2022/7/15 19:30,78,100,-22,-326
22,2022/7/15 19:40,73,95,-22,-340
22,2022/7/15 19:50,65,95,-30,-320
22,2022/7/15 20:00,71,75,-4,-3
22,2022/7/15 20:10,63,82,-19,-19
22,2022/7/15 20:20,53,70,-17,-178
22,2022/7/15 20:30,55,78,-23,-346
22,2022/7/15 20:40,71,82,-11,-214
22,2022/7/15 20:50,66,79,-13,-231
22,2022/7/15 21:00,66,75,-9,-106
22,2022/7/15 21:10,76,62,14,-231
22,2022/7/15 21:20,56,77,-21,-467
22,2022/7/15 21:30,62,63,-1,-333
22,2022/7/15 21:40,73,78,-5,-370
22,2022/7/15 21:50,65,67,-2,-446
22,2022/7/15 22:00,92,63,29,-444
22,2022/7/15 22:10,53,70,-17,-608
22,2022/7/15 22:20,25,58,-33,-865
22,2022/7/15 22:30,4,45,-41,-819
22,2022/7/15 22:40,0,3,-3,-568
22,2022/7/15 22:50,0,3,-3,-284
12,2022/7/15 5:00,0,1,-1,-14
12,2022/7/15 5:10,0,1,-1,8
12,2022/7/15 5:20,1,1,0,52
12,2022/7/15 5:30,2,1,1,91
12,2022/7/15 5:40,11,1,10,160
12,2022/7/15 5:50,19,39,-20,124
12,2022/7/15 6:00,25,25,0,89
12,2022/7/15 6:10,32,50,-18,7
12,2022/7/15 6:20,33,53,-20,-23
12,2022/7/15 6:30,39,93,-54,-97
12,2022/7/15 6:40,50,102,-52,-79
12,2022/7/15 6:50,57,110,-53,-32
12,2022/7/15 7:00,75,110,-35,112
12,2022/7/15 7:10,88,117,-29,331
12,2022/7/15 7:20,181,180,1,627
12,2022/7/15 7:30,215,233,-18,789
12,2022/7/15 7:40,280,326,-46,1168
12,2022/7/15 7:50,344,320,24,1546
12,2022/7/15 8:00,597,447,150,525
12,2022/7/15 8:10,628,425,203,-1080
12,2022/7/15 8:20,719,486,233,-4310
12,2022/7/15 8:30,628,1570,-942,-6271
12,2022/7/15 8:40,442,1578,-1136,-9707
12,2022/7/15 8:50,330,1623,-1293,-7828
12,2022/7/15 9:00,274,603,-329,-3632
12,2022/7/15 9:10,277,603,-326,-3675
12,2022/7/15 9:20,233,570,-337,-2928
12,2022/7/15 9:30,219,438,-219,-1929
12,2022/7/15 9:40,188,381,-193,-1800
12,2022/7/15 9:50,175,281,-106,-1586
12,2022/7/15 10:00,145,208,-63,-1249
12,2022/7/15 10:10,149,192,-43,-1112
12,2022/7/15 10:20,134,185,-51,-1014
12,2022/7/15 10:30,141,193,-52,-998
12,2022/7/15 10:40,146,155,-9,-856
12,2022/7/15 10:50,134,152,-18,-815
12,2022/7/15 11:00,128,128,0,-724
12,2022/7/15 11:10,139,133,6,-662
12,2022/7/15 11:20,130,112,18,-599
12,2022/7/15 11:30,149,128,21,-622
12,2022/7/15 11:40,128,112,16,-475
12,2022/7/15 11:50,135,128,7,-447
12,2022/7/15 12:00,141,109,32,-344
12,2022/7/15 12:10,150,128,22,-335
12,2022/7/15 12:20,167,117,50,-263
12,2022/7/15 12:30,179,152,27,-360
12,2022/7/15 12:40,174,152,22,-428
12,2022/7/15 12:50,178,152,26,-393
12,2022/7/15 13:00,176,181,-5,-416
12,2022/7/15 13:10,184,170,14,-394
12,2022/7/15 13:20,196,150,46,-364
12,2022/7/15 13:30,181,181,0,-382
12,2022/7/15 13:40,173,154,19,-406
12,2022/7/15 13:50,195,151,44,-305
12,2022/7/15 14:00,169,151,18,-339
12,2022/7/15 14:10,188,139,49,-230
12,2022/7/15 14:20,181,128,53,-238
12,2022/7/15 14:30,170,154,16,-169
12,2022/7/15 14:40,166,146,20,-169
12,2022/7/15 14:50,173,151,22,-164
12,2022/7/15 15:00,183,181,2,-48
12,2022/7/15 15:10,202,152,50,134
12,2022/7/15 15:20,203,150,53,103
12,2022/7/15 15:30,227,154,73,47
12,2022/7/15 15:40,214,169,45,15
12,2022/7/15 15:50,230,169,61,72
12,2022/7/15 16:00,234,181,53,165
12,2022/7/15 16:10,244,184,60,178
12,2022/7/15 16:20,226,192,34,163
12,2022/7/15 16:30,258,192,66,654
12,2022/7/15 16:40,264,179,85,882
12,2022/7/15 16:50,270,198,72,807
12,2022/7/15 17:00,354,204,150,2946
12,2022/7/15 17:10,577,280,297,3572
12,2022/7/15 17:20,553,376,177,2558
12,2022/7/15 17:30,610,372,238,3379
12,2022/7/15 17:40,711,318,393,5478
12,2022/7/15 17:50,697,435,262,2940
12,2022/7/15 18:00,705,423,282,2505
12,2022/7/15 18:10,1217,419,798,4875
12,2022/7/15 18:20,839,435,404,2192
12,2022/7/15 18:30,678,419,259,754
12,2022/7/15 18:40,657,530,127,178
12,2022/7/15 18:50,571,329,242,72
12,2022/7/15 19:00,351,258,93,-145
12,2022/7/15 19:10,332,199,133,3
12,2022/7/15 19:20,267,193,74,-159
12,2022/7/15 19:30,238,126,112,-214
12,2022/7/15 19:40,234,111,123,-217
12,2022/7/15 19:50,210,125,85,-235
12,2022/7/15 20:00,234,118,116,113
12,2022/7/15 20:10,244,107,137,118
12,2022/7/15 20:20,206,124,82,-96
12,2022/7/15 20:30,223,107,116,-230
12,2022/7/15 20:40,210,123,87,-127
12,2022/7/15 20:50,210,103,107,-124
12,2022/7/15 21:00,226,99,127,21
12,2022/7/15 21:10,262,116,146,-85
12,2022/7/15 21:20,210,78,132,-335
12,2022/7/15 21:30,242,115,127,-206
12,2022/7/15 21:40,201,100,101,-269
12,2022/7/15 21:50,171,103,68,-378
12,2022/7/15 22:00,263,99,164,-280
12,2022/7/15 22:10,225,83,142,-466
12,2022/7/15 22:20,55,78,-23,-888
12,2022/7/15 22:30,20,65,-45,-864
12,2022/7/15 22:40,0,3,-3,-571
12,2022/7/15 22:50,0,3,-3,-287
14,2022/7/15 5:00,0,1,-1,-15
14,2022/7/15 5:10,0,1,-1,7
14,2022/7/15 5:20,0,1,-1,51
14,2022/7/15 5:30,1,1,0,91
14,2022/7/15 5:40,2,1,1,161
14,2022/7/15 5:50,6,5,1,125
14,2022/7/15 6:00,8,11,-3,86
14,2022/7/15 6:10,14,23,-9,-2
14,2022/7/15 6:20,14,29,-15,-38
14,2022/7/15 6:30,21,38,-17,-114
14,2022/7/15 6:40,19,40,-21,-100
14,2022/7/15 6:50,24,66,-42,-74
14,2022/7/15 7:00,30,66,-36,76
14,2022/7/15 7:10,31,90,-59,272
14,2022/7/15 7:20,33,104,-71,556
14,2022/7/15 7:30,40,107,-67,722
14,2022/7/15 7:40,46,104,-58,1110
14,2022/7/15 7:50,56,122,-66,1480
14,2022/7/15 8:00,64,117,-53,472
14,2022/7/15 8:10,67,226,-159,-1239
14,2022/7/15 8:20,69,233,-164,-4474
14,2022/7/15 8:30,56,180,-124,-6395
14,2022/7/15 8:40,56,320,-264,-9971
14,2022/7/15 8:50,43,186,-143,-7971
14,2022/7/15 9:00,41,139,-98,-3730
14,2022/7/15 9:10,39,119,-80,-3755
14,2022/7/15 9:20,31,116,-85,-3013
14,2022/7/15 9:30,31,102,-71,-2000
14,2022/7/15 9:40,32,101,-69,-1869
14,2022/7/15 9:50,29,104,-75,-1661
14,2022/7/15 10:00,29,100,-71,-1320
14,2022/7/15 10:10,28,93,-65,-1177
14,2022/7/15 10:20,28,97,-69,-1083
14,2022/7/15 10:30,28,93,-65,-1063
14,2022/7/15 10:40,26,75,-49,-905
14,2022/7/15 10:50,27,77,-50,-865
14,2022/7/15 11:00,26,81,-55,-779
14,2022/7/15 11:10,32,73,-41,-703
14,2022/7/15 11:20,31,62,-31,-630
14,2022/7/15 11:30,37,74,-37,-659
14,2022/7/15 11:40,27,64,-37,-512
14,2022/7/15 11:50,33,62,-29,-476
14,2022/7/15 12:00,27,68,-41,-385
14,2022/7/15 12:10,27,80,-53,-388
14,2022/7/15 12:20,32,77,-45,-308
14,2022/7/15 12:30,33,83,-50,-410
14,2022/7/15 12:40,30,97,-67,-495
14,2022/7/15 12:50,26,91,-65,-458
14,2022/7/15 13:00,31,86,-55,-471
14,2022/7/15 13:10,30,90,-60,-454
14,2022/7/15 13:20,32,93,-61,-425
14,2022/7/15 13:30,31,90,-59,-441
14,2022/7/15 13:40,31,92,-61,-467
14,2022/7/15 13:50,36,77,-41,-346
14,2022/7/15 14:00,31,84,-53,-392
14,2022/7/15 14:10,31,69,-38,-268
14,2022/7/15 14:20,31,83,-52,-290
14,2022/7/15 14:30,39,80,-41,-210
14,2022/7/15 14:40,35,68,-33,-202
14,2022/7/15 14:50,36,81,-45,-209
14,2022/7/15 15:00,34,82,-48,-96
14,2022/7/15 15:10,40,68,-28,106
14,2022/7/15 15:20,41,74,-33,70
14,2022/7/15 15:30,42,84,-42,5
14,2022/7/15 15:40,40,76,-36,-21
14,2022/7/15 15:50,47,84,-37,35
14,2022/7/15 16:00,65,69,-4,161
14,2022/7/15 16:10,53,79,-26,152
14,2022/7/15 16:20,52,70,-18,145
14,2022/7/15 16:30,104,60,44,698
14,2022/7/15 16:40,97,68,29,911
14,2022/7/15 16:50,162,83,79,886
14,2022/7/15 17:00,271,73,198,3144
14,2022/7/15 17:10,225,74,151,3723
14,2022/7/15 17:20,194,94,100,2658
14,2022/7/15 17:30,175,103,72,3451
14,2022/7/15 17:40,170,108,62,5540
14,2022/7/15 17:50,98,105,-7,2933
14,2022/7/15 18:00,130,103,27,2532
14,2022/7/15 18:10,179,109,70,4945
14,2022/7/15 18:20,132,110,22,2214
14,2022/7/15 18:30,77,106,-29,725
14,2022/7/15 18:40,64,101,-37,141
14,2022/7/15 18:50,50,106,-56,16
14,2022/7/15 19:00,45,93,-48,-193
14,2022/7/15 19:10,46,82,-36,-33
14,2022/7/15 19:20,36,79,-43,-202
14,2022/7/15 19:30,31,62,-31,-245
14,2022/7/15 19:40,31,70,-39,-256
14,2022/7/15 19:50,34,67,-33,-268
14,2022/7/15 20:00,32,51,-19,94
14,2022/7/15 20:10,28,63,-35,83
14,2022/7/15 20:20,43,52,-9,-105
14,2022/7/15 20:30,30,60,-30,-260
14,2022/7/15 20:40,22,46,-24,-151
14,2022/7/15 20:50,23,47,-24,-148
14,2022/7/15 21:00,25,58,-33,-12
14,2022/7/15 21:10,27,41,-14,-99
14,2022/7/15 21:20,28,67,-39,-374
14,2022/7/15 21:30,24,46,-22,-228
14,2022/7/15 21:40,23,46,-23,-292
14,2022/7/15 21:50,29,51,-22,-400
14,2022/7/15 22:00,21,38,-17,-297
14,2022/7/15 22:10,23,48,-25,-491
14,2022/7/15 22:20,11,34,-23,-911
14,2022/7/15 22:30,1,31,-30,-894
14,2022/7/15 22:40,0,10,-10,-581
14,2022/7/15 22:50,0,3,-3,-290
7,2022/7/15 5:00,0,1,-1,-16
7,2022/7/15 5:10,0,1,-1,6
7,2022/7/15 5:20,0,1,-1,50
7,2022/7/15 5:30,3,1,2,93
7,2022/7/15 5:40,8,5,3,164
7,2022/7/15 5:50,18,1,17,142
7,2022/7/15 6:00,22,29,-7,79
7,2022/7/15 6:10,30,30,0,-2
7,2022/7/15 6:20,34,54,-20,-58
7,2022/7/15 6:30,44,71,-27,-141
7,2022/7/15 6:40,57,106,-49,-149
7,2022/7/15 6:50,75,123,-48,-122
7,2022/7/15 7:00,89,224,-135,-59
7,2022/7/15 7:10,150,318,-168,104
7,2022/7/15 7:20,163,190,-27,529
7,2022/7/15 7:30,227,232,-5,717
7,2022/7/15 7:40,269,254,15,1125
7,2022/7/15 7:50,301,255,46,1526
7,2022/7/15 8:00,359,384,-25,447
7,2022/7/15 8:10,366,429,-63,-1302
7,2022/7/15 8:20,392,432,-40,-4514
7,2022/7/15 8:30,338,575,-237,-6632
7,2022/7/15 8:40,318,1133,-815,-10786
7,2022/7/15 8:50,274,1138,-864,-8835
7,2022/7/15 9:00,233,429,-196,-3926
7,2022/7/15 9:10,221,531,-310,-4065
7,2022/7/15 9:20,179,502,-323,-3336
7,2022/7/15 9:30,149,332,-183,-2183
7,2022/7/15 9:40,120,254,-134,-2003
7,2022/7/15 9:50,76,190,-114,-1775
7,2022/7/15 10:00,64,192,-128,-1448
7,2022/7/15 10:10,65,108,-43,-1220
7,2022/7/15 10:20,61,124,-63,-1146
7,2022/7/15 10:30,56,122,-66,-1129
7,2022/7/15 10:40,49,102,-53,-958
7,2022/7/15 10:50,55,107,-52,-917
7,2022/7/15 11:00,49,106,-57,-836
7,2022/7/15 11:10,52,103,-51,-754
7,2022/7/15 11:20,57,106,-49,-679
7,2022/7/15 11:30,57,112,-55,-714
7,2022/7/15 11:40,76,110,-34,-546
7,2022/7/15 11:50,80,109,-29,-505
7,2022/7/15 12:00,75,105,-30,-415
7,2022/7/15 12:10,75,105,-30,-418
7,2022/7/15 12:20,71,106,-35,-343
7,2022/7/15 12:30,76,108,-32,-442
7,2022/7/15 12:40,71,97,-26,-521
7,2022/7/15 12:50,65,105,-40,-498
7,2022/7/15 13:00,65,127,-62,-533
7,2022/7/15 13:10,68,102,-34,-488
7,2022/7/15 13:20,66,125,-59,-484
7,2022/7/15 13:30,63,116,-53,-494
7,2022/7/15 13:40,70,127,-57,-524
7,2022/7/15 13:50,62,121,-59,-405
7,2022/7/15 14:00,71,107,-36,-428
7,2022/7/15 14:10,62,103,-41,-309
7,2022/7/15 14:20,71,122,-51,-341
7,2022/7/15 14:30,70,100,-30,-240
7,2022/7/15 14:40,82,105,-23,-225
7,2022/7/15 14:50,77,111,-34,-243
7,2022/7/15 15:00,83,103,-20,-116
7,2022/7/15 15:10,85,103,-18,88
7,2022/7/15 15:20,82,108,-26,44
7,2022/7/15 15:30,119,100,19,24
7,2022/7/15 15:40,109,119,-10,-31
7,2022/7/15 15:50,137,125,12,47
7,2022/7/15 16:00,158,107,51,212
7,2022/7/15 16:10,189,118,71,223
7,2022/7/15 16:20,202,106,96,241
7,2022/7/15 16:30,264,120,144,842
7,2022/7/15 16:40,273,105,168,1079
7,2022/7/15 16:50,265,110,155,1041
7,2022/7/15 17:00,576,111,465,3609
7,2022/7/15 17:10,672,108,564,4287
7,2022/7/15 17:20,637,158,479,3137
7,2022/7/15 17:30,653,196,457,3908
7,2022/7/15 17:40,846,197,649,6189
7,2022/7/15 17:50,698,207,491,3424
7,2022/7/15 18:00,697,301,396,2928
7,2022/7/15 18:10,717,270,447,5392
7,2022/7/15 18:20,639,298,341,2555
7,2022/7/15 18:30,429,284,145,870
7,2022/7/15 18:40,343,218,125,266
7,2022/7/15 18:50,268,179,89,105
7,2022/7/15 19:00,237,186,51,-142
7,2022/7/15 19:10,230,132,98,65
7,2022/7/15 19:20,198,116,82,-120
7,2022/7/15 19:30,143,117,26,-219
7,2022/7/15 19:40,101,122,-21,-277
7,2022/7/15 19:50,79,126,-47,-315
7,2022/7/15 20:00,83,111,-28,66
7,2022/7/15 20:10,77,112,-35,48
7,2022/7/15 20:20,70,107,-37,-142
7,2022/7/15 20:30,64,108,-44,-304
7,2022/7/15 20:40,67,114,-47,-198
7,2022/7/15 20:50,57,111,-54,-202
7,2022/7/15 21:00,60,107,-47,-59
7,2022/7/15 21:10,73,104,-31,-130
7,2022/7/15 21:20,66,104,-38,-412
7,2022/7/15 21:30,59,115,-56,-284
7,2022/7/15 21:40,73,107,-34,-326
7,2022/7/15 21:50,47,98,-51,-451
7,2022/7/15 22:00,45,110,-65,-362
7,2022/7/15 22:10,44,80,-36,-527
7,2022/7/15 22:20,22,104,-82,-993
7,2022/7/15 22:30,12,86,-74,-968
7,2022/7/15 22:40,4,41,-37,-618
7,2022/7/15 22:50,2,21,-19,-309
5,2022/7/15 5:00,0,1,-1,-17
5,2022/7/15 5:10,0,1,-1,5
5,2022/7/15 5:20,2,1,1,51
5,2022/7/15 5:30,5,1,4,97
5,2022/7/15 5:40,7,2,5,169
5,2022/7/15 5:50,12,1,11,153
5,2022/7/15 6:00,20,13,7,86
5,2022/7/15 6:10,19,22,-3,-5
5,2022/7/15 6:20,28,40,-12,-70
5,2022/7/15 6:30,32,63,-31,-172
5,2022/7/15 6:40,36,73,-37,-186
5,2022/7/15 6:50,45,76,-31,-153
5,2022/7/15 7:00,54,123,-69,-128
5,2022/7/15 7:10,57,123,-66,38
5,2022/7/15 7:20,59,106,-47,482
5,2022/7/15 7:30,83,112,-29,688
5,2022/7/15 7:40,147,171,-24,1101
5,2022/7/15 7:50,162,181,-19,1507
5,2022/7/15 8:00,194,281,-87,360
5,2022/7/15 8:10,232,322,-90,-1392
5,2022/7/15 8:20,232,325,-93,-4607
5,2022/7/15 8:30,221,387,-166,-6798
5,2022/7/15 8:40,184,438,-254,-11040
5,2022/7/15 8:50,148,504,-356,-9191
5,2022/7/15 9:00,94,335,-241,-4167
5,2022/7/15 9:10,76,283,-207,-4272
5,2022/7/15 9:20,66,233,-167,-3503
5,2022/7/15 9:30,55,192,-137,-2320
5,2022/7/15 9:40,45,139,-94,-2097
5,2022/7/15 9:50,49,133,-84,-1859
5,2022/7/15 10:00,43,117,-74,-1522
5,2022/7/15 10:10,46,105,-59,-1279
5,2022/7/15 10:20,39,103,-64,-1210
5,2022/7/15 10:30,47,110,-63,-1192
5,2022/7/15 10:40,38,93,-55,-1013
5,2022/7/15 10:50,38,99,-61,-978
5,2022/7/15 11:00,36,93,-57,-893
5,2022/7/15 11:10,43,79,-36,-790
5,2022/7/15 11:20,41,77,-36,-715
5,2022/7/15 11:30,42,75,-33,-747
5,2022/7/15 11:40,42,76,-34,-580
5,2022/7/15 11:50,37,76,-39,-544
5,2022/7/15 12:00,46,92,-46,-461
5,2022/7/15 12:10,42,88,-46,-464
5,2022/7/15 12:20,43,82,-39,-382
5,2022/7/15 12:30,44,92,-48,-490
5,2022/7/15 12:40,41,93,-52,-573
5,2022/7/15 12:50,41,109,-68,-566
5,2022/7/15 13:00,41,93,-52,-585
5,2022/7/15 13:10,44,108,-64,-552
5,2022/7/15 13:20,37,99,-62,-546
5,2022/7/15 13:30,40,93,-53,-547
5,2022/7/15 13:40,44,111,-67,-591
5,2022/7/15 13:50,45,91,-46,-451
5,2022/7/15 14:00,45,91,-46,-474
5,2022/7/15 14:10,45,90,-45,-354
5,2022/7/15 14:20,48,90,-42,-383
5,2022/7/15 14:30,49,92,-43,-283
5,2022/7/15 14:40,46,92,-46,-271
5,2022/7/15 14:50,50,80,-30,-273
5,2022/7/15 15:00,55,90,-35,-151
5,2022/7/15 15:10,69,92,-23,65
5,2022/7/15 15:20,48,91,-43,1
5,2022/7/15 15:30,56,87,-31,-7
5,2022/7/15 15:40,47,93,-46,-77
5,2022/7/15 15:50,48,77,-29,18
5,2022/7/15 16:00,61,104,-43,169
5,2022/7/15 16:10,76,92,-16,207
5,2022/7/15 16:20,64,93,-29,212
5,2022/7/15 16:30,71,93,-22,820
5,2022/7/15 16:40,93,93,0,1079
5,2022/7/15 16:50,131,110,21,1062
5,2022/7/15 17:00,202,111,91,3700
5,2022/7/15 17:10,244,105,139,4426
5,2022/7/15 17:20,199,124,75,3212
5,2022/7/15 17:30,265,102,163,4071
5,2022/7/15 17:40,421,105,316,6505
5,2022/7/15 17:50,268,110,158,3582
5,2022/7/15 18:00,271,133,138,3066
5,2022/7/15 18:10,580,133,447,5839
5,2022/7/15 18:20,290,119,171,2726
5,2022/7/15 18:30,223,107,116,986
5,2022/7/15 18:40,207,110,97,363
5,2022/7/15 18:50,137,126,11,116
5,2022/7/15 19:00,83,126,-43,-185
5,2022/7/15 19:10,85,110,-25,40
5,2022/7/15 19:20,66,115,-49,-169
5,2022/7/15 19:30,43,100,-57,-276
5,2022/7/15 19:40,39,83,-44,-321
5,2022/7/15 19:50,37,86,-49,-364
5,2022/7/15 20:00,47,85,-38,28
5,2022/7/15 20:10,47,74,-27,21
5,2022/7/15 20:20,39,75,-36,-178
5,2022/7/15 20:30,39,80,-41,-345
5,2022/7/15 20:40,37,88,-51,-249
5,2022/7/15 20:50,29,71,-42,-244
5,2022/7/15 21:00,40,63,-23,-82
5,2022/7/15 21:10,37,75,-38,-168
5,2022/7/15 21:20,33,62,-29,-441
5,2022/7/15 21:30,32,75,-43,-327
5,2022/7/15 21:40,27,63,-36,-362
5,2022/7/15 21:50,24,70,-46,-497
5,2022/7/15 22:00,26,74,-48,-410
5,2022/7/15 22:10,25,52,-27,-554
5,2022/7/15 22:20,13,65,-52,-1045
5,2022/7/15 22:30,6,48,-42,-1010
5,2022/7/15 22:40,2,33,-31,-649
5,2022/7/15 22:50,0,3,-3,-312
17,2022/7/15 5:00,0,1,-1,-18
17,2022/7/15 5:10,0,1,-1,4
17,2022/7/15 5:20,1,1,0,51
17,2022/7/15 5:30,6,1,5,102
17,2022/7/15 5:40,6,2,4,173
17,2022/7/15 5:50,15,1,14,167
17,2022/7/15 6:00,20,5,15,101
17,2022/7/15 6:10,29,19,10,5
17,2022/7/15 6:20,33,29,4,-66
17,2022/7/15 6:30,43,30,13,-159
17,2022/7/15 6:40,48,42,6,-180
17,2022/7/15 6:50,60,68,-8,-161
17,2022/7/15 7:00,94,83,11,-117
17,2022/7/15 7:10,108,72,36,74
17,2022/7/15 7:20,108,96,12,494
17,2022/7/15 7:30,224,127,97,785
17,2022/7/15 7:40,246,109,137,1238
17,2022/7/15 7:50,275,139,136,1643
17,2022/7/15 8:00,302,206,96,456
17,2022/7/15 8:10,280,296,-16,-1408
17,2022/7/15 8:20,279,344,-65,-4672
17,2022/7/15 8:30,266,380,-114,-6912
17,2022/7/15 8:40,217,495,-278,-11318
17,2022/7/15 8:50,168,246,-78,-9269
17,2022/7/15 9:00,115,192,-77,-4244
17,2022/7/15 9:10,74,128,-54,-4326
17,2022/7/15 9:20,61,121,-60,-3563
17,2022/7/15 9:30,52,102,-50,-2370
17,2022/7/15 9:40,46,115,-69,-2166
17,2022/7/15 9:50,39,93,-54,-1913
17,2022/7/15 10:00,38,77,-39,-1561
17,2022/7/15 10:10,40,73,-33,-1312
17,2022/7/15 10:20,38,73,-35,-1245
17,2022/7/15 10:30,35,62,-27,-1219
17,2022/7/15 10:40,31,71,-40,-1053
17,2022/7/15 10:50,29,66,-37,-1015
17,2022/7/15 11:00,37,62,-25,-918
17,2022/7/15 11:10,35,65,-30,-820
17,2022/7/15 11:20,29,68,-39,-754
17,2022/7/15 11:30,32,61,-29,-776
17,2022/7/15 11:40,28,65,-37,-617
17,2022/7/15 11:50,27,71,-44,-588
17,2022/7/15 12:00,29,66,-37,-498
17,2022/7/15 12:10,31,74,-43,-507
17,2022/7/15 12:20,34,75,-41,-423
17,2022/7/15 12:30,28,73,-45,-535
17,2022/7/15 12:40,33,69,-36,-609
17,2022/7/15 12:50,34,82,-48,-614
17,2022/7/15 13:00,29,71,-42,-627
17,2022/7/15 13:10,31,83,-52,-604
17,2022/7/15 13:20,32,78,-46,-592
17,2022/7/15 13:30,29,84,-55,-602
17,2022/7/15 13:40,28,85,-57,-648
17,2022/7/15 13:50,32,76,-44,-495
17,2022/7/15 14:00,32,77,-45,-519
17,2022/7/15 14:10,26,67,-41,-395
17,2022/7/15 14:20,36,71,-35,-418
17,2022/7/15 14:30,27,77,-50,-333
17,2022/7/15 14:40,34,87,-53,-324
17,2022/7/15 14:50,36,78,-42,-315
17,2022/7/15 15:00,35,72,-37,-188
17,2022/7/15 15:10,44,77,-33,32
17,2022/7/15 15:20,41,77,-36,-35
17,2022/7/15 15:30,35,73,-38,-45
17,2022/7/15 15:40,41,80,-39,-116
17,2022/7/15 15:50,30,93,-63,-45
17,2022/7/15 16:00,50,78,-28,141
17,2022/7/15 16:10,66,90,-24,183
17,2022/7/15 16:20,44,93,-49,163
17,2022/7/15 16:30,69,98,-29,791
17,2022/7/15 16:40,70,104,-34,1045
17,2022/7/15 16:50,75,108,-33,1029
17,2022/7/15 17:00,197,104,93,3793
17,2022/7/15 17:10,262,112,150,4576
17,2022/7/15 17:20,238,126,112,3324
17,2022/7/15 17:30,222,123,99,4170
17,2022/7/15 17:40,326,124,202,6707
17,2022/7/15 17:50,278,108,170,3752
17,2022/7/15 18:00,217,109,108,3174
17,2022/7/15 18:10,340,117,223,6062
17,2022/7/15 18:20,256,144,112,2838
17,2022/7/15 18:30,171,111,60,1046
17,2022/7/15 18:40,93,109,-16,347
17,2022/7/15 18:50,64,112,-48,68
17,2022/7/15 19:00,47,121,-74,-259
17,2022/7/15 19:10,46,122,-76,-36
17,2022/7/15 19:20,35,104,-69,-238
17,2022/7/15 19:30,38,101,-63,-339
17,2022/7/15 19:40,35,81,-46,-367
17,2022/7/15 19:50,28,92,-64,-428
17,2022/7/15 20:00,29,78,-49,-21
17,2022/7/15 20:10,31,76,-45,-24
17,2022/7/15 20:20,29,64,-35,-213
17,2022/7/15 20:30,29,94,-65,-410
17,2022/7/15 20:40,26,72,-46,-295
17,2022/7/15 20:50,28,79,-51,-295
17,2022/7/15 21:00,26,81,-55,-137
17,2022/7/15 21:10,26,62,-36,-204
17,2022/7/15 21:20,25,91,-66,-507
17,2022/7/15 21:30,21,74,-53,-380
17,2022/7/15 21:40,24,92,-68,-430
17,2022/7/15 21:50,20,83,-63,-560
17,2022/7/15 22:00,18,62,-44,-454
17,2022/7/15 22:10,12,77,-65,-619
17,2022/7/15 22:20,2,55,-53,-1098
17,2022/7/15 22:30,2,64,-62,-1072
17,2022/7/15 22:40,1,40,-39,-688
17,2022/7/15 22:50,0,3,-3,-315
23,2022/7/15 5:00,0,1,-1,-19
23,2022/7/15 5:10,0,1,-1,3
23,2022/7/15 5:20,0,1,-1,50
23,2022/7/15 5:30,3,1,2,104
23,2022/7/15 5:40,2,1,1,174
23,2022/7/15 5:50,5,1,4,171
23,2022/7/15 6:00,5,8,-3,98
23,2022/7/15 6:10,12,21,-9,-4
23,2022/7/15 6:20,11,19,-8,-74
23,2022/7/15 6:30,19,38,-19,-178
23,2022/7/15 6:40,22,66,-44,-224
23,2022/7/15 6:50,22,65,-43,-204
23,2022/7/15 7:00,26,53,-27,-144
23,2022/7/15 7:10,31,75,-44,30
23,2022/7/15 7:20,35,104,-69,425
23,2022/7/15 7:30,43,125,-82,703
23,2022/7/15 7:40,59,226,-167,1071
23,2022/7/15 7:50,57,330,-273,1370
23,2022/7/15 8:00,70,642,-572,-116
23,2022/7/15 8:10,85,1583,-1498,-2906
23,2022/7/15 8:20,67,2019,-1952,-6624
23,2022/7/15 8:30,64,3158,-3094,-10006
23,2022/7/15 8:40,68,2825,-2757,-14075
23,2022/7/15 8:50,53,2967,-2914,-12183
23,2022/7/15 9:00,39,493,-454,-4698
23,2022/7/15 9:10,36,582,-546,-4872
23,2022/7/15 9:20,39,532,-493,-4056
23,2022/7/15 9:30,33,267,-234,-2604
23,2022/7/15 9:40,29,178,-149,-2315
23,2022/7/15 9:50,29,115,-86,-1999
23,2022/7/15 10:00,33,120,-87,-1648
23,2022/7/15 10:10,29,114,-85,-1397
23,2022/7/15 10:20,34,106,-72,-1317
23,2022/7/15 10:30,35,105,-70,-1289
23,2022/7/15 10:40,28,114,-86,-1139
23,2022/7/15 10:50,37,96,-59,-1074
23,2022/7/15 11:00,37,93,-56,-974
23,2022/7/15 11:10,39,90,-51,-871
23,2022/7/15 11:20,39,93,-54,-808
23,2022/7/15 11:30,37,98,-61,-837
23,2022/7/15 11:40,43,98,-55,-672
23,2022/7/15 11:50,43,90,-47,-635
23,2022/7/15 12:00,38,81,-43,-541
23,2022/7/15 12:10,45,81,-36,-543
23,2022/7/15 12:20,42,92,-50,-473
23,2022/7/15 12:30,40,92,-52,-587
23,2022/7/15 12:40,37,101,-64,-673
23,2022/7/15 12:50,41,90,-49,-663
23,2022/7/15 13:00,40,93,-53,-680
23,2022/7/15 13:10,45,99,-54,-658
23,2022/7/15 13:20,42,104,-62,-654
23,2022/7/15 13:30,39,101,-62,-664
23,2022/7/15 13:40,42,97,-55,-703
23,2022/7/15 13:50,46,110,-64,-559
23,2022/7/15 14:00,44,93,-49,-568
23,2022/7/15 14:10,44,93,-49,-444
23,2022/7/15 14:20,43,93,-50,-468
23,2022/7/15 14:30,44,90,-46,-379
23,2022/7/15 14:40,44,96,-52,-376
23,2022/7/15 14:50,44,90,-46,-361
23,2022/7/15 15:00,45,87,-42,-230
23,2022/7/15 15:10,44,87,-43,-11
23,2022/7/15 15:20,46,80,-34,-69
23,2022/7/15 15:30,51,90,-39,-84
23,2022/7/15 15:40,52,93,-41,-157
23,2022/7/15 15:50,64,93,-29,-74
23,2022/7/15 16:00,66,92,-26,115
23,2022/7/15 16:10,80,82,-2,181
23,2022/7/15 16:20,67,90,-23,140
23,2022/7/15 16:30,137,90,47,838
23,2022/7/15 16:40,174,99,75,1120
23,2022/7/15 16:50,156,88,68,1097
23,2022/7/15 17:00,277,90,187,3980
23,2022/7/15 17:10,576,96,480,5056
23,2022/7/15 17:20,369,105,264,3588
23,2022/7/15 17:30,675,105,570,4740
23,2022/7/15 17:40,1977,103,1874,8581
23,2022/7/15 17:50,1368,112,1256,5008
23,2022/7/15 18:00,1167,109,1058,4232
23,2022/7/15 18:10,1983,113,1870,7932
23,2022/7/15 18:20,1208,107,1101,3939
23,2022/7/15 18:30,636,110,526,1572
23,2022/7/15 18:40,336,110,226,573
23,2022/7/15 18:50,279,108,171,239
23,2022/7/15 19:00,226,95,131,-128
23,2022/7/15 19:10,187,99,88,52
23,2022/7/15 19:20,129,77,52,-186
23,2022/7/15 19:30,77,69,8,-331
23,2022/7/15 19:40,73,62,11,-356
23,2022/7/15 19:50,49,68,-19,-447
23,2022/7/15 20:00,55,61,-6,-27
23,2022/7/15 20:10,62,58,4,-20
23,2022/7/15 20:20,45,51,-6,-219
23,2022/7/15 20:30,47,52,-5,-415
23,2022/7/15 20:40,43,50,-7,-302
23,2022/7/15 20:50,41,54,-13,-308
23,2022/7/15 21:00,50,48,2,-135
23,2022/7/15 21:10,66,39,27,-177
23,2022/7/15 21:20,64,53,11,-496
23,2022/7/15 21:30,137,34,103,-277
23,2022/7/15 21:40,149,52,97,-333
23,2022/7/15 21:50,41,40,1,-559
23,2022/7/15 22:00,29,39,-10,-464
23,2022/7/15 22:10,21,40,-19,-638
23,2022/7/15 22:20,6,36,-30,-1128
23,2022/7/15 22:30,2,40,-38,-1110
23,2022/7/15 22:40,1,25,-24,-712
23,2022/7/15 22:50,0,3,-3,-318
15,2022/7/15 5:00,0,1,-1,-20
15,2022/7/15 5:10,0,1,-1,2
15,2022/7/15 5:20,3,1,2,52
15,2022/7/15 5:30,5,1,4,108
15,2022/7/15 5:40,7,1,6,180
15,2022/7/15 5:50,9,1,8,179
15,2022/7/15 6:00,16,2,14,112
15,2022/7/15 6:10,21,22,-1,-5
15,2022/7/15 6:20,33,33,0,-74
15,2022/7/15 6:30,34,49,-15,-193
15,2022/7/15 6:40,44,58,-14,-238
15,2022/7/15 6:50,54,50,4,-200
15,2022/7/15 7:00,57,77,-20,-164
15,2022/7/15 7:10,73,95,-22,8
15,2022/7/15 7:20,85,105,-20,405
15,2022/7/15 7:30,149,104,45,748
15,2022/7/15 7:40,186,108,78,1149
15,2022/7/15 7:50,232,120,112,1482
15,2022/7/15 8:00,256,178,78,-38
15,2022/7/15 8:10,283,212,71,-2835
15,2022/7/15 8:20,254,221,33,-6591
15,2022/7/15 8:30,234,283,-49,-10055
15,2022/7/15 8:40,184,326,-142,-14217
15,2022/7/15 8:50,112,197,-85,-12268
15,2022/7/15 9:00,88,110,-22,-4720
15,2022/7/15 9:10,60,121,-61,-4933
15,2022/7/15 9:20,52,117,-65,-4121
15,2022/7/15 9:30,44,120,-76,-2680
15,2022/7/15 9:40,39,104,-65,-2380
15,2022/7/15 9:50,38,105,-67,-2066
15,2022/7/15 10:00,35,98,-63,-1711
15,2022/7/15 10:10,38,65,-27,-1424
15,2022/7/15 10:20,32,77,-45,-1362
15,2022/7/15 10:30,35,74,-39,-1328
15,2022/7/15 10:40,33,84,-51,-1190
15,2022/7/15 10:50,32,76,-44,-1118
15,2022/7/15 11:00,32,77,-45,-1019
15,2022/7/15 11:10,31,62,-31,-902
15,2022/7/15 11:20,31,69,-38,-846
15,2022/7/15 11:30,35,85,-50,-887
15,2022/7/15 11:40,33,73,-40,-712
15,2022/7/15 11:50,33,79,-46,-681
15,2022/7/15 12:00,34,71,-37,-578
15,2022/7/15 12:10,38,76,-38,-581
15,2022/7/15 12:20,38,74,-36,-509
15,2022/7/15 12:30,36,74,-38,-625
15,2022/7/15 12:40,38,93,-55,-728
15,2022/7/15 12:50,37,92,-55,-718
15,2022/7/15 13:00,35,76,-41,-721
15,2022/7/15 13:10,36,77,-41,-699
15,2022/7/15 13:20,33,77,-44,-698
15,2022/7/15 13:30,33,82,-49,-713
15,2022/7/15 13:40,37,91,-54,-757
15,2022/7/15 13:50,35,87,-52,-611
15,2022/7/15 14:00,34,78,-44,-612
15,2022/7/15 14:10,40,81,-41,-485
15,2022/7/15 14:20,37,83,-46,-514
15,2022/7/15 14:30,29,78,-49,-428
15,2022/7/15 14:40,31,76,-45,-421
15,2022/7/15 14:50,31,91,-60,-421
15,2022/7/15 15:00,40,79,-39,-269
15,2022/7/15 15:10,35,93,-58,-69
15,2022/7/15 15:20,42,83,-41,-110
15,2022/7/15 15:30,47,90,-43,-127
15,2022/7/15 15:40,45,90,-45,-202
15,2022/7/15 15:50,46,90,-44,-118
15,2022/7/15 16:00,47,87,-40,75
15,2022/7/15 16:10,47,93,-46,135
15,2022/7/15 16:20,54,105,-51,89
15,2022/7/15 16:30,64,101,-37,801
15,2022/7/15 16:40,77,103,-26,1094
15,2022/7/15 16:50,70,103,-33,1064
15,2022/7/15 17:00,137,112,25,4005
15,2022/7/15 17:10,207,98,109,5165
15,2022/7/15 17:20,150,111,39,3627
15,2022/7/15 17:30,164,104,60,4800
15,2022/7/15 17:40,228,178,50,8631
15,2022/7/15 17:50,224,132,92,5100
15,2022/7/15 18:00,230,116,114,4346
15,2022/7/15 18:10,272,142,130,8062
15,2022/7/15 18:20,215,111,104,4043
15,2022/7/15 18:30,138,152,-14,1558
15,2022/7/15 18:40,96,151,-55,518
15,2022/7/15 18:50,70,109,-39,200
15,2022/7/15 19:00,60,124,-64,-192
15,2022/7/15 19:10,44,125,-81,-29
15,2022/7/15 19:20,45,103,-58,-244
15,2022/7/15 19:30,41,102,-61,-392
15,2022/7/15 19:40,34,95,-61,-417
15,2022/7/15 19:50,35,77,-42,-489
15,2022/7/15 20:00,37,94,-57,-84
15,2022/7/15 20:10,40,85,-45,-65
15,2022/7/15 20:20,40,77,-37,-256
15,2022/7/15 20:30,28,71,-43,-458
15,2022/7/15 20:40,36,86,-50,-352
15,2022/7/15 20:50,36,75,-39,-347
15,2022/7/15 21:00,34,59,-25,-160
15,2022/7/15 21:10,37,78,-41,-218
15,2022/7/15 21:20,30,63,-33,-529
15,2022/7/15 21:30,26,89,-63,-340
15,2022/7/15 21:40,28,77,-49,-382
15,2022/7/15 21:50,27,62,-35,-594
15,2022/7/15 22:00,25,73,-48,-512
15,2022/7/15 22:10,13,55,-42,-680
15,2022/7/15 22:20,2,87,-85,-1213
15,2022/7/15 22:30,2,53,-51,-1161
15,2022/7/15 22:40,1,50,-49,-761
15,2022/7/15 22:50,0,18,-18,-336
9,2022/7/15 5:00,0,1,-1,-21
9,2022/7/15 5:10,0,1,-1,1
9,2022/7/15 5:20,2,1,1,53
9,2022/7/15 5:30,5,1,4,112
9,2022/7/15 5:40,8,1,7,187
9,2022/7/15 5:50,12,1,11,190
9,2022/7/15 6:00,20,2,18,130
9,2022/7/15 6:10,26,11,15,10
9,2022/7/15 6:20,32,16,16,-58
9,2022/7/15 6:30,37,32,5,-188
9,2022/7/15 6:40,49,41,8,-230
9,2022/7/15 6:50,53,70,-17,-217
9,2022/7/15 7:00,57,77,-20,-184
9,2022/7/15 7:10,62,72,-10,-2
9,2022/7/15 7:20,80,95,-15,390
9,2022/7/15 7:30,150,100,50,798
9,2022/7/15 7:40,152,105,47,1196
9,2022/7/15 7:50,216,122,94,1576
9,2022/7/15 8:00,224,109,115,77
9,2022/7/15 8:10,222,112,110,-2725
9,2022/7/15 8:20,209,117,92,-6499
9,2022/7/15 8:30,194,185,9,-10046
9,2022/7/15 8:40,149,191,-42,-14259
9,2022/7/15 8:50,100,191,-91,-12359
9,2022/7/15 9:00,65,111,-46,-4766
9,2022/7/15 9:10,54,123,-69,-5002
9,2022/7/15 9:20,48,113,-65,-4186
9,2022/7/15 9:30,38,112,-74,-2754
9,2022/7/15 9:40,30,90,-60,-2440
9,2022/7/15 9:50,34,76,-42,-2108
9,2022/7/15 10:00,34,71,-37,-1748
9,2022/7/15 10:10,29,63,-34,-1458
9,2022/7/15 10:20,25,61,-36,-1398
9,2022/7/15 10:30,28,61,-33,-1361
9,2022/7/15 10:40,29,60,-31,-1221
9,2022/7/15 10:50,28,65,-37,-1155
9,2022/7/15 11:00,27,65,-38,-1057
9,2022/7/15 11:10,27,55,-28,-930
9,2022/7/15 11:20,28,59,-31,-877
9,2022/7/15 11:30,28,61,-33,-920
9,2022/7/15 11:40,29,55,-26,-738
9,2022/7/15 11:50,28,60,-32,-713
9,2022/7/15 12:00,29,63,-34,-612
9,2022/7/15 12:10,28,66,-38,-619
9,2022/7/15 12:20,29,60,-31,-540
9,2022/7/15 12:30,28,57,-29,-654
9,2022/7/15 12:40,27,62,-35,-763
9,2022/7/15 12:50,25,61,-36,-754
9,2022/7/15 13:00,25,69,-44,-765
9,2022/7/15 13:10,28,62,-34,-733
9,2022/7/15 13:20,30,67,-37,-735
9,2022/7/15 13:30,29,67,-38,-751
9,2022/7/15 13:40,28,70,-42,-799
9,2022/7/15 13:50,26,69,-43,-654
9,2022/7/15 14:00,30,61,-31,-643
9,2022/7/15 14:10,30,70,-40,-525
9,2022/7/15 14:20,28,72,-44,-558
9,2022/7/15 14:30,23,72,-49,-477
9,2022/7/15 14:40,21,72,-51,-472
9,2022/7/15 14:50,25,67,-42,-463
9,2022/7/15 15:00,26,71,-45,-314
9,2022/7/15 15:10,32,65,-33,-102
9,2022/7/15 15:20,29,71,-42,-152
9,2022/7/15 15:30,32,81,-49,-176
9,2022/7/15 15:40,32,83,-51,-253
9,2022/7/15 15:50,25,69,-44,-162
9,2022/7/15 16:00,31,73,-42,33
9,2022/7/15 16:10,36,84,-48,87
9,2022/7/15 16:20,44,76,-32,57
9,2022/7/15 16:30,45,76,-31,770
9,2022/7/15 16:40,43,76,-33,1061
9,2022/7/15 16:50,47,82,-35,1029
9,2022/7/15 17:00,85,93,-8,3997
9,2022/7/15 17:10,207,99,108,5273
9,2022/7/15 17:20,136,109,27,3654
9,2022/7/15 17:30,149,116,33,4833
9,2022/7/15 17:40,144,121,23,8654
9,2022/7/15 17:50,154,124,30,5130
9,2022/7/15 18:00,88,126,-38,4308
9,2022/7/15 18:10,198,112,86,8148
9,2022/7/15 18:20,133,125,8,4051
9,2022/7/15 18:30,66,106,-40,1518
9,2022/7/15 18:40,48,111,-63,455
9,2022/7/15 18:50,48,126,-78,122
9,2022/7/15 19:00,36,110,-74,-266
9,2022/7/15 19:10,35,114,-79,-108
9,2022/7/15 19:20,29,106,-77,-321
9,2022/7/15 19:30,26,92,-66,-458
9,2022/7/15 19:40,28,78,-50,-467
9,2022/7/15 19:50,25,77,-52,-541
9,2022/7/15 20:00,26,74,-48,-132
9,2022/7/15 20:10,26,68,-42,-107
9,2022/7/15 20:20,27,73,-46,-302
9,2022/7/15 20:30,24,72,-48,-506
9,2022/7/15 20:40,24,67,-43,-395
9,2022/7/15 20:50,27,69,-42,-389
9,2022/7/15 21:00,27,73,-46,-206
9,2022/7/15 21:10,25,59,-34,-252
9,2022/7/15 21:20,22,81,-59,-588
9,2022/7/15 21:30,19,65,-46,-386
9,2022/7/15 21:40,17,73,-56,-438
9,2022/7/15 21:50,20,75,-55,-649
9,2022/7/15 22:00,13,56,-43,-555
9,2022/7/15 22:10,7,73,-66,-746
9,2022/7/15 22:20,4,44,-40,-1253
9,2022/7/15 22:30,1,71,-70,-1231
9,2022/7/15 22:40,2,49,-47,-808
9,2022/7/15 22:50,0,18,-18,-354
13,2022/7/15 5:00,0,1,-1,-22
13,2022/7/15 5:10,0,1,-1,0
13,2022/7/15 5:20,0,1,-1,52
13,2022/7/15 5:30,1,1,0,112
13,2022/7/15 5:40,5,1,4,191
13,2022/7/15 5:50,14,1,13,203
13,2022/7/15 6:00,16,2,14,144
13,2022/7/15 6:10,25,11,14,24
13,2022/7/15 6:20,31,30,1,-57
13,2022/7/15 6:30,35,32,3,-185
13,2022/7/15 6:40,53,29,24,-206
13,2022/7/15 6:50,60,6,54,-163
13,2022/7/15 7:00,75,41,34,-150
13,2022/7/15 7:10,76,65,11,9
13,2022/7/15 7:20,102,70,32,422
13,2022/7/15 7:30,176,79,97,895
13,2022/7/15 7:40,205,73,132,1328
13,2022/7/15 7:50,235,88,147,1723
13,2022/7/15 8:00,276,103,173,250
13,2022/7/15 8:10,278,103,175,-2550
13,2022/7/15 8:20,234,105,129,-6370
13,2022/7/15 8:30,223,124,99,-9947
13,2022/7/15 8:40,180,102,78,-14181
13,2022/7/15 8:50,104,102,2,-12357
13,2022/7/15 9:00,78,79,-1,-4767
13,2022/7/15 9:10,50,97,-47,-5049
13,2022/7/15 9:20,46,67,-21,-4207
13,2022/7/15 9:30,40,85,-45,-2799
13,2022/7/15 9:40,33,75,-42,-2482
13,2022/7/15 9:50,26,76,-50,-2158
13,2022/7/15 10:00,35,72,-37,-1785
13,2022/7/15 10:10,30,83,-53,-1511
13,2022/7/15 10:20,28,74,-46,-1444
13,2022/7/15 10:30,23,76,-53,-1414
13,2022/7/15 10:40,29,68,-39,-1260
13,2022/7/15 10:50,27,82,-55,-1210
13,2022/7/15 11:00,28,68,-40,-1097
13,2022/7/15 11:10,30,73,-43,-973
13,2022/7/15 11:20,28,71,-43,-920
13,2022/7/15 11:30,27,67,-40,-960
13,2022/7/15 11:40,29,67,-38,-776
13,2022/7/15 11:50,28,67,-39,-752
13,2022/7/15 12:00,28,68,-40,-652
13,2022/7/15 12:10,28,65,-37,-656
13,2022/7/15 12:20,31,69,-38,-578
13,2022/7/15 12:30,26,72,-46,-700
13,2022/7/15 12:40,32,69,-37,-800
13,2022/7/15 12:50,28,66,-38,-792
13,2022/7/15 13:00,26,74,-48,-813
13,2022/7/15 13:10,31,68,-37,-770
13,2022/7/15 13:20,29,62,-33,-768
13,2022/7/15 13:30,25,71,-46,-797
13,2022/7/15 13:40,29,72,-43,-842
13,2022/7/15 13:50,26,74,-48,-702
13,2022/7/15 14:00,30,70,-40,-683
13,2022/7/15 14:10,28,73,-45,-570
13,2022/7/15 14:20,27,72,-45,-603
13,2022/7/15 14:30,27,63,-36,-513
13,2022/7/15 14:40,27,64,-37,-509
13,2022/7/15 14:50,30,71,-41,-504
13,2022/7/15 15:00,29,69,-40,-354
13,2022/7/15 15:10,31,68,-37,-139
13,2022/7/15 15:20,26,74,-48,-200
13,2022/7/15 15:30,33,69,-36,-212
13,2022/7/15 15:40,31,78,-47,-300
13,2022/7/15 15:50,27,77,-50,-212
13,2022/7/15 16:00,30,73,-43,-10
13,2022/7/15 16:10,28,85,-57,30
13,2022/7/15 16:20,33,73,-40,17
13,2022/7/15 16:30,35,87,-52,718
13,2022/7/15 16:40,37,76,-39,1022
13,2022/7/15 16:50,40,90,-50,979
13,2022/7/15 17:00,45,90,-45,3952
13,2022/7/15 17:10,43,111,-68,5205
13,2022/7/15 17:20,41,89,-48,3606
13,2022/7/15 17:30,47,123,-76,4757
13,2022/7/15 17:40,42,106,-64,8590
13,2022/7/15 17:50,35,126,-91,5039
13,2022/7/15 18:00,35,125,-90,4218
13,2022/7/15 18:10,39,104,-65,8083
13,2022/7/15 18:20,37,104,-67,3984
13,2022/7/15 18:30,28,128,-100,1418
13,2022/7/15 18:40,30,117,-87,368
13,2022/7/15 18:50,28,110,-82,40
13,2022/7/15 19:00,28,121,-93,-359
13,2022/7/15 19:10,27,111,-84,-192
13,2022/7/15 19:20,18,110,-92,-413
13,2022/7/15 19:30,20,105,-85,-543
13,2022/7/15 19:40,20,95,-75,-542
13,2022/7/15 19:50,17,93,-76,-617
13,2022/7/15 20:00,14,76,-62,-194
13,2022/7/15 20:10,14,83,-69,-176
13,2022/7/15 20:20,16,74,-58,-360
13,2022/7/15 20:30,16,76,-60,-566
13,2022/7/15 20:40,14,77,-63,-458
13,2022/7/15 20:50,14,69,-55,-444
13,2022/7/15 21:00,12,77,-65,-271
13,2022/7/15 21:10,15,79,-64,-316
13,2022/7/15 21:20,14,76,-62,-650
13,2022/7/15 21:30,13,21,-8,-394
13,2022/7/15 21:40,10,75,-65,-503
13,2022/7/15 21:50,11,78,-67,-716
13,2022/7/15 22:00,6,78,-72,-627
13,2022/7/15 22:10,2,66,-64,-810
13,2022/7/15 22:20,1,41,-40,-1293
13,2022/7/15 22:30,2,65,-63,-1294
13,2022/7/15 22:40,1,59,-58,-866
13,2022/7/15 22:50,0,32,-32,-386
4,2022/7/15 5:00,0,1,-1,-23
4,2022/7/15 5:10,0,1,-1,-1
4,2022/7/15 5:20,0,1,-1,51
4,2022/7/15 5:30,5,1,4,116
4,2022/7/15 5:40,9,1,8,199
4,2022/7/15 5:50,10,21,-11,192
4,2022/7/15 6:00,7,5,2,146
4,2022/7/15 6:10,9,34,-25,-1
4,2022/7/15 6:20,17,49,-32,-89
4,2022/7/15 6:30,15,33,-18,-203
4,2022/7/15 6:40,17,42,-25,-231
4,2022/7/15 6:50,16,62,-46,-209
4,2022/7/15 7:00,20,75,-55,-205
4,2022/7/15 7:10,23,87,-64,-55
4,2022/7/15 7:20,25,93,-68,354
4,2022/7/15 7:30,28,109,-81,814
4,2022/7/15 7:40,31,108,-77,1251
4,2022/7/15 7:50,39,213,-174,1549
4,2022/7/15 8:00,47,319,-272,-22
4,2022/7/15 8:10,58,346,-288,-2838
4,2022/7/15 8:20,44,208,-164,-6534
4,2022/7/15 8:30,34,178,-144,-10091
4,2022/7/15 8:40,30,152,-122,-14303
4,2022/7/15 8:50,28,123,-95,-12452
4,2022/7/15 9:00,27,76,-49,-4816
4,2022/7/15 9:10,26,82,-56,-5105
4,2022/7/15 9:20,23,71,-48,-4255
4,2022/7/15 9:30,21,74,-53,-2852
4,2022/7/15 9:40,23,64,-41,-2523
4,2022/7/15 9:50,22,65,-43,-2201
4,2022/7/15 10:00,24,64,-40,-1825
4,2022/7/15 10:10,25,58,-33,-1544
4,2022/7/15 10:20,24,65,-41,-1485
4,2022/7/15 10:30,20,54,-34,-1448
4,2022/7/15 10:40,21,62,-41,-1301
4,2022/7/15 10:50,25,55,-30,-1240
4,2022/7/15 11:00,26,59,-33,-1130
4,2022/7/15 11:10,26,59,-33,-1006
4,2022/7/15 11:20,26,60,-34,-954
4,2022/7/15 11:30,32,59,-27,-987
4,2022/7/15 11:40,25,65,-40,-816
4,2022/7/15 11:50,24,51,-27,-779
4,2022/7/15 12:00,28,54,-26,-678
4,2022/7/15 12:10,29,55,-26,-682
4,2022/7/15 12:20,25,61,-36,-614
4,2022/7/15 12:30,27,62,-35,-735
4,2022/7/15 12:40,28,67,-39,-839
4,2022/7/15 12:50,25,60,-35,-827
4,2022/7/15 13:00,29,58,-29,-842
4,2022/7/15 13:10,26,61,-35,-805
4,2022/7/15 13:20,26,53,-27,-795
4,2022/7/15 13:30,28,55,-27,-824
4,2022/7/15 13:40,26,52,-26,-868
4,2022/7/15 13:50,25,48,-23,-725
4,2022/7/15 14:00,28,50,-22,-705
4,2022/7/15 14:10,27,42,-15,-585
4,2022/7/15 14:20,29,45,-16,-619
4,2022/7/15 14:30,27,44,-17,-530
4,2022/7/15 14:40,29,44,-15,-524
4,2022/7/15 14:50,28,46,-18,-522
4,2022/7/15 15:00,24,45,-21,-375
4,2022/7/15 15:10,28,42,-14,-153
4,2022/7/15 15:20,29,41,-12,-212
4,2022/7/15 15:30,26,49,-23,-235
4,2022/7/15 15:40,30,45,-15,-315
4,2022/7/15 15:50,33,45,-12,-224
4,2022/7/15 16:00,36,46,-10,-20
4,2022/7/15 16:10,48,46,2,32
4,2022/7/15 16:20,41,59,-18,-1
4,2022/7/15 16:30,97,46,51,769
4,2022/7/15 16:40,93,50,43,1065
4,2022/7/15 16:50,157,47,110,1089
4,2022/7/15 17:00,322,48,274,4226
4,2022/7/15 17:10,348,53,295,5500
4,2022/7/15 17:20,180,51,129,3735
4,2022/7/15 17:30,137,54,83,4840
4,2022/7/15 17:40,177,55,122,8712
4,2022/7/15 17:50,76,52,24,5063
4,2022/7/15 18:00,65,55,10,4228
4,2022/7/15 18:10,56,55,1,8084
4,2022/7/15 18:20,41,54,-13,3971
4,2022/7/15 18:30,43,58,-15,1403
4,2022/7/15 18:40,32,50,-18,350
4,2022/7/15 18:50,29,52,-23,17
4,2022/7/15 19:00,24,56,-32,-391
4,2022/7/15 19:10,29,54,-25,-217
4,2022/7/15 19:20,32,48,-16,-429
4,2022/7/15 19:30,25,27,-2,-545
4,2022/7/15 19:40,22,42,-20,-562
4,2022/7/15 19:50,24,44,-20,-637
4,2022/7/15 20:00,28,38,-10,-204
4,2022/7/15 20:10,30,25,5,-171
4,2022/7/15 20:20,23,40,-17,-377
4,2022/7/15 20:30,25,34,-9,-575
4,2022/7/15 20:40,17,39,-22,-480
4,2022/7/15 20:50,22,30,-8,-452
4,2022/7/15 21:00,22,25,-3,-274
4,2022/7/15 21:10,20,33,-13,-329
4,2022/7/15 21:20,17,15,2,-648
4,2022/7/15 21:30,11,31,-20,-414
4,2022/7/15 21:40,12,30,-18,-521
4,2022/7/15 21:50,11,29,-18,-734
4,2022/7/15 22:00,7,27,-20,-647
4,2022/7/15 22:10,8,7,1,-809
4,2022/7/15 22:20,3,25,-22,-1315
4,2022/7/15 22:30,0,24,-24,-1318
4,2022/7/15 22:40,1,23,-22,-888
4,2022/7/15 22:50,1,13,-12,-398
8,2022/7/15 5:00,0,1,-1,-22
8,2022/7/15 5:10,2,1,1,2
8,2022/7/15 5:20,10,1,9,62
8,2022/7/15 5:30,15,1,14,126
8,2022/7/15 5:40,17,1,16,203
8,2022/7/15 5:50,19,1,18,208
8,2022/7/15 6:00,26,1,25,155
8,2022/7/15 6:10,33,1,32,42
8,2022/7/15 6:20,36,19,17,-41
8,2022/7/15 6:30,55,29,26,-162
8,2022/7/15 6:40,67,46,21,-209
8,2022/7/15 6:50,69,53,16,-201
8,2022/7/15 7:00,109,57,52,-132
8,2022/7/15 7:10,155,68,87,85
8,2022/7/15 7:20,231,45,186,576
8,2022/7/15 7:30,280,51,229,1027
8,2022/7/15 7:40,358,86,272,1468
8,2022/7/15 7:50,468,105,363,1939
8,2022/7/15 8:00,467,110,357,434
8,2022/7/15 8:10,474,191,283,-2442
8,2022/7/15 8:20,375,222,153,-6346
8,2022/7/15 8:30,345,159,186,-9860
8,2022/7/15 8:40,253,381,-128,-14387
8,2022/7/15 8:50,196,91,105,-12254
8,2022/7/15 9:00,177,218,-41,-4807
8,2022/7/15 9:10,98,32,66,-4936
8,2022/7/15 9:20,74,115,-41,-4227
8,2022/7/15 9:30,53,103,-50,-2804
8,2022/7/15 9:40,51,112,-61,-2501
8,2022/7/15 9:50,45,114,-69,-2177
8,2022/7/15 10:00,43,93,-50,-1798
8,2022/7/15 10:10,41,80,-39,-1497
8,2022/7/15 10:20,37,76,-39,-1437
8,2022/7/15 10:30,38,78,-40,-1401
8,2022/7/15 10:40,30,76,-46,-1267
8,2022/7/15 10:50,32,68,-36,-1191
8,2022/7/15 11:00,31,85,-54,-1111
8,2022/7/15 11:10,31,83,-52,-982
8,2022/7/15 11:20,28,74,-46,-923
8,2022/7/15 11:30,31,74,-43,-963
8,2022/7/15 11:40,30,77,-47,-785
8,2022/7/15 11:50,35,77,-42,-755
8,2022/7/15 12:00,35,80,-45,-657
8,2022/7/15 12:10,39,75,-36,-655
8,2022/7/15 12:20,38,77,-39,-579
8,2022/7/15 12:30,38,81,-43,-697
8,2022/7/15 12:40,37,79,-42,-805
8,2022/7/15 12:50,43,75,-32,-786
8,2022/7/15 13:00,39,79,-40,-805
8,2022/7/15 13:10,38,76,-38,-771
8,2022/7/15 13:20,35,76,-41,-776
8,2022/7/15 13:30,40,77,-37,-788
8,2022/7/15 13:40,37,82,-45,-844
8,2022/7/15 13:50,34,76,-42,-696
8,2022/7/15 14:00,37,81,-44,-687
8,2022/7/15 14:10,33,77,-44,-569
8,2022/7/15 14:20,35,75,-40,-598
8,2022/7/15 14:30,37,83,-46,-523
8,2022/7/15 14:40,32,92,-60,-532
8,2022/7/15 14:50,29,93,-64,-527
8,2022/7/15 15:00,39,91,-52,-366
8,2022/7/15 15:10,32,93,-61,-163
8,2022/7/15 15:20,36,93,-57,-209
8,2022/7/15 15:30,33,98,-65,-241
8,2022/7/15 15:40,32,111,-79,-332
8,2022/7/15 15:50,36,105,-69,-231
8,2022/7/15 16:00,38,111,-73,-40
8,2022/7/15 16:10,38,105,-67,20
8,2022/7/15 16:20,38,111,-73,-16
8,2022/7/15 16:30,44,119,-75,695
8,2022/7/15 16:40,45,107,-62,999
8,2022/7/15 16:50,48,117,-69,960
8,2022/7/15 17:00,73,121,-48,3949
8,2022/7/15 17:10,176,109,67,5340
8,2022/7/15 17:20,74,119,-45,3609
8,2022/7/15 17:30,132,153,-21,4812
8,2022/7/15 17:40,239,190,49,8703
8,2022/7/15 17:50,186,433,-247,4883
8,2022/7/15 18:00,169,282,-113,4195
8,2022/7/15 18:10,249,267,-18,8130
8,2022/7/15 18:20,176,313,-137,3914
8,2022/7/15 18:30,103,328,-225,1293
8,2022/7/15 18:40,71,283,-212,243
8,2022/7/15 18:50,60,293,-233,-111
8,2022/7/15 19:00,48,180,-132,-398
8,2022/7/15 19:10,41,192,-151,-259
8,2022/7/15 19:20,35,119,-84,-405
8,2022/7/15 19:30,35,109,-74,-532
8,2022/7/15 19:40,39,124,-85,-552
8,2022/7/15 19:50,31,106,-75,-616
8,2022/7/15 20:00,43,105,-62,-194
8,2022/7/15 20:10,44,113,-69,-176
8,2022/7/15 20:20,30,98,-68,-370
8,2022/7/15 20:30,31,102,-71,-577
8,2022/7/15 20:40,37,102,-65,-460
8,2022/7/15 20:50,25,99,-74,-463
8,2022/7/15 21:00,31,10,21,-185
8,2022/7/15 21:10,30,102,-72,-324
8,2022/7/15 21:20,35,105,-70,-658
8,2022/7/15 21:30,28,114,-86,-472
8,2022/7/15 21:40,29,61,-32,-470
8,2022/7/15 21:50,23,75,-52,-701
8,2022/7/15 22:00,9,99,-90,-645
8,2022/7/15 22:10,2,98,-96,-842
8,2022/7/15 22:20,2,97,-95,-1348
8,2022/7/15 22:30,1,7,-6,-1237
8,2022/7/15 22:40,1,78,-77,-885
8,2022/7/15 22:50,1,64,-63,-417
27,2022/7/15 5:00,0,1,-1,-23
27,2022/7/15 5:10,1,1,0,2
27,2022/7/15 5:20,7,1,6,68
27,2022/7/15 5:30,1,1,0,126
27,2022/7/15 5:40,1,1,0,203
27,2022/7/15 5:50,9,1,8,216
27,2022/7/15 6:00,8,1,7,162
27,2022/7/15 6:10,8,1,7,49
27,2022/7/15 6:20,17,1,16,-25
27,2022/7/15 6:30,22,16,6,-156
27,2022/7/15 6:40,22,16,6,-203
27,2022/7/15 6:50,27,23,4,-197
27,2022/7/15 7:00,31,37,-6,-138
27,2022/7/15 7:10,32,8,24,109
27,2022/7/15 7:20,36,29,7,583
27,2022/7/15 7:30,38,23,15,1042
27,2022/7/15 7:40,54,29,25,1493
27,2022/7/15 7:50,52,40,12,1951
27,2022/7/15 8:00,50,47,3,437
27,2022/7/15 8:10,50,51,-1,-2443
27,2022/7/15 8:20,44,51,-7,-6353
27,2022/7/15 8:30,36,51,-15,-9875
27,2022/7/15 8:40,33,62,-29,-14416
27,2022/7/15 8:50,30,59,-29,-12283
27,2022/7/15 9:00,25,47,-22,-4829
27,2022/7/15 9:10,23,33,-10,-4946
27,2022/7/15 9:20,18,38,-20,-4247
27,2022/7/15 9:30,17,25,-8,-2812
27,2022/7/15 9:40,15,25,-10,-2511
27,2022/7/15 9:50,14,24,-10,-2187
27,2022/7/15 10:00,12,23,-11,-1809
27,2022/7/15 10:10,12,21,-9,-1506
27,2022/7/15 10:20,11,23,-12,-1449
27,2022/7/15 10:30,11,21,-10,-1411
27,2022/7/15 10:40,9,23,-14,-1281
27,2022/7/15 10:50,8,19,-11,-1202
27,2022/7/15 11:00,9,19,-10,-1121
27,2022/7/15 11:10,10,21,-11,-993
27,2022/7/15 11:20,10,25,-15,-938
27,2022/7/15 11:30,9,23,-14,-977
27,2022/7/15 11:40,11,23,-12,-797
27,2022/7/15 11:50,11,21,-10,-765
27,2022/7/15 12:00,11,19,-8,-665
27,2022/7/15 12:10,11,21,-10,-665
27,2022/7/15 12:20,11,23,-12,-591
27,2022/7/15 12:30,11,23,-12,-709
27,2022/7/15 12:40,12,23,-11,-816
27,2022/7/15 12:50,9,22,-13,-799
27,2022/7/15 13:00,10,23,-13,-818
27,2022/7/15 13:10,11,25,-14,-785
27,2022/7/15 13:20,11,23,-12,-788
27,2022/7/15 13:30,9,23,-14,-802
27,2022/7/15 13:40,8,23,-15,-859
27,2022/7/15 13:50,11,23,-12,-708
27,2022/7/15 14:00,10,23,-13,-700
27,2022/7/15 14:10,12,23,-11,-580
27,2022/7/15 14:20,11,23,-12,-610
27,2022/7/15 14:30,11,23,-12,-535
27,2022/7/15 14:40,8,23,-15,-547
27,2022/7/15 14:50,10,23,-13,-540
27,2022/7/15 15:00,11,23,-12,-378
27,2022/7/15 15:10,10,31,-21,-184
27,2022/7/15 15:20,11,28,-17,-226
27,2022/7/15 15:30,10,25,-15,-256
27,2022/7/15 15:40,10,32,-22,-354
27,2022/7/15 15:50,9,38,-29,-260
27,2022/7/15 16:00,14,31,-17,-57
27,2022/7/15 16:10,12,32,-20,0
27,2022/7/15 16:20,14,34,-20,-36
27,2022/7/15 16:30,18,38,-20,675
27,2022/7/15 16:40,15,37,-22,977
27,2022/7/15 16:50,17,41,-24,936
27,2022/7/15 17:00,26,46,-20,3929
27,2022/7/15 17:10,29,49,-20,5320
27,2022/7/15 17:20,22,50,-28,3581
27,2022/7/15 17:30,16,70,-54,4758
27,2022/7/15 17:40,17,62,-45,8658
27,2022/7/15 17:50,15,66,-51,4832
27,2022/7/15 18:00,21,72,-51,4144
27,2022/7/15 18:10,21,77,-56,8074
27,2022/7/15 18:20,19,78,-59,3855
27,2022/7/15 18:30,16,83,-67,1226
27,2022/7/15 18:40,14,77,-63,180
27,2022/7/15 18:50,15,79,-64,-175
27,2022/7/15 19:00,12,76,-64,-462
27,2022/7/15 19:10,12,75,-63,-322
27,2022/7/15 19:20,11,65,-54,-459
27,2022/7/15 19:30,10,55,-45,-577
27,2022/7/15 19:40,9,51,-42,-594
27,2022/7/15 19:50,9,43,-34,-650
27,2022/7/15 20:00,10,48,-38,-232
27,2022/7/15 20:10,10,41,-31,-207
27,2022/7/15 20:20,7,37,-30,-400
27,2022/7/15 20:30,10,34,-24,-601
27,2022/7/15 20:40,10,27,-17,-477
27,2022/7/15 20:50,6,40,-34,-497
27,2022/7/15 21:00,6,38,-32,-217
27,2022/7/15 21:10,6,34,-28,-352
27,2022/7/15 21:20,7,41,-34,-692
27,2022/7/15 21:30,6,37,-31,-503
27,2022/7/15 21:40,6,4,2,-468
27,2022/7/15 21:50,6,40,-34,-735
27,2022/7/15 22:00,0,40,-40,-685
27,2022/7/15 22:10,1,34,-33,-875
27,2022/7/15 22:20,0,25,-25,-1373
27,2022/7/15 22:30,0,8,-8,-1245
27,2022/7/15 22:40,0,24,-24,-909
27,2022/7/15 22:50,0,13,-13,-430
3,2022/7/15 5:00,0,1,-1,-24
3,2022/7/15 5:10,4,1,3,5
3,2022/7/15 5:20,13,1,12,80
3,2022/7/15 5:30,9,1,8,134
3,2022/7/15 5:40,16,1,15,218
3,2022/7/15 5:50,23,1,22,238
3,2022/7/15 6:00,27,1,26,188
3,2022/7/15 6:10,31,1,30,79
3,2022/7/15 6:20,47,19,28,3
3,2022/7/15 6:30,57,16,41,-115
3,2022/7/15 6:40,68,23,45,-158
3,2022/7/15 6:50,88,23,65,-132
3,2022/7/15 7:00,144,11,133,-5
3,2022/7/15 7:10,222,25,197,306
3,2022/7/15 7:20,274,40,234,817
3,2022/7/15 7:30,325,50,275,1317
3,2022/7/15 7:40,593,38,555,2048
3,2022/7/15 7:50,684,49,635,2586
3,2022/7/15 8:00,699,54,645,1082
3,2022/7/15 8:10,707,61,646,-1797
3,2022/7/15 8:20,629,62,567,-5786
3,2022/7/15 8:30,367,72,295,-9580
3,2022/7/15 8:40,282,71,211,-14205
3,2022/7/15 8:50,234,62,172,-12111
3,2022/7/15 9:00,169,64,105,-4724
3,2022/7/15 9:10,116,46,70,-4876
3,2022/7/15 9:20,65,52,13,-4234
3,2022/7/15 9:30,49,42,7,-2805
3,2022/7/15 9:40,41,51,-10,-2521
3,2022/7/15 9:50,40,47,-7,-2194
3,2022/7/15 10:00,33,49,-16,-1825
3,2022/7/15 10:10,34,42,-8,-1514
3,2022/7/15 10:20,30,48,-18,-1467
3,2022/7/15 10:30,25,50,-25,-1436
3,2022/7/15 10:40,28,47,-19,-1300
3,2022/7/15 10:50,26,48,-22,-1224
3,2022/7/15 11:00,26,50,-24,-1145
3,2022/7/15 11:10,25,50,-25,-1018
3,2022/7/15 11:20,26,51,-25,-963
3,2022/7/15 11:30,25,49,-24,-1001
3,2022/7/15 11:40,25,51,-26,-823
3,2022/7/15 11:50,26,50,-24,-789
3,2022/7/15 12:00,28,52,-24,-689
3,2022/7/15 12:10,27,50,-23,-688
3,2022/7/15 12:20,27,51,-24,-615
3,2022/7/15 12:30,27,52,-25,-734
3,2022/7/15 12:40,29,52,-23,-839
3,2022/7/15 12:50,25,54,-29,-828
3,2022/7/15 13:00,27,55,-28,-846
3,2022/7/15 13:10,28,58,-30,-815
3,2022/7/15 13:20,28,53,-25,-813
3,2022/7/15 13:30,28,54,-26,-828
3,2022/7/15 13:40,28,63,-35,-894
3,2022/7/15 13:50,23,63,-40,-748
3,2022/7/15 14:00,25,67,-42,-742
3,2022/7/15 14:10,22,66,-44,-624
3,2022/7/15 14:20,24,65,-41,-651
3,2022/7/15 14:30,22,59,-37,-572
3,2022/7/15 14:40,20,61,-41,-588
3,2022/7/15 14:50,23,70,-47,-587
3,2022/7/15 15:00,21,65,-44,-422
3,2022/7/15 15:10,20,67,-47,-231
3,2022/7/15 15:20,21,73,-52,-278
3,2022/7/15 15:30,22,81,-59,-315
3,2022/7/15 15:40,19,73,-54,-408
3,2022/7/15 15:50,21,76,-55,-315
3,2022/7/15 16:00,21,76,-55,-112
3,2022/7/15 16:10,20,74,-54,-54
3,2022/7/15 16:20,22,79,-57,-93
3,2022/7/15 16:30,26,93,-67,608
3,2022/7/15 16:40,29,97,-68,909
3,2022/7/15 16:50,26,103,-77,859
3,2022/7/15 17:00,24,104,-80,3849
3,2022/7/15 17:10,29,111,-82,5238
3,2022/7/15 17:20,31,101,-70,3511
3,2022/7/15 17:30,29,115,-86,4672
3,2022/7/15 17:40,29,109,-80,8578
3,2022/7/15 17:50,29,181,-152,4680
3,2022/7/15 18:00,26,128,-102,4042
3,2022/7/15 18:10,30,179,-149,7925
3,2022/7/15 18:20,27,226,-199,3656
3,2022/7/15 18:30,29,234,-205,1021
3,2022/7/15 18:40,23,220,-197,-17
3,2022/7/15 18:50,22,223,-201,-376
3,2022/7/15 19:00,19,145,-126,-588
3,2022/7/15 19:10,17,139,-122,-444
3,2022/7/15 19:20,18,111,-93,-552
3,2022/7/15 19:30,16,119,-103,-680
3,2022/7/15 19:40,15,100,-85,-679
3,2022/7/15 19:50,16,112,-96,-746
3,2022/7/15 20:00,15,101,-86,-318
3,2022/7/15 20:10,15,95,-80,-287
3,2022/7/15 20:20,17,97,-80,-480
3,2022/7/15 20:30,14,78,-64,-665
3,2022/7/15 20:40,14,92,-78,-555
3,2022/7/15 20:50,12,85,-73,-570
3,2022/7/15 21:00,13,94,-81,-298
3,2022/7/15 21:10,16,95,-79,-431
3,2022/7/15 21:20,12,60,-48,-740
3,2022/7/15 21:30,11,86,-75,-578
3,2022/7/15 21:40,10,102,-92,-560
3,2022/7/15 21:50,5,114,-109,-844
3,2022/7/15 22:00,1,94,-93,-778
3,2022/7/15 22:10,0,77,-77,-952
3,2022/7/15 22:20,0,25,-25,-1398
3,2022/7/15 22:30,0,86,-86,-1331
3,2022/7/15 22:40,1,77,-76,-985
3,2022/7/15 22:50,0,54,-54,-484
43,2022/7/15 5:00,0,1,-1,-1
43,2022/7/15 5:10,1,1,0,0
43,2022/7/15 5:20,10,1,9,9
43,2022/7/15 5:30,7,1,6,6
43,2022/7/15 5:40,14,1,13,13
43,2022/7/15 5:50,16,1,15,15
43,2022/7/15 6:00,20,1,19,19
43,2022/7/15 6:10,29,1,28,28
43,2022/7/15 6:20,34,1,33,33
43,2022/7/15 6:30,30,21,9,9
43,2022/7/15 6:40,33,21,12,12
43,2022/7/15 6:50,53,64,-11,-11
43,2022/7/15 7:00,58,68,-10,-10
43,2022/7/15 7:10,91,60,31,31
43,2022/7/15 7:20,151,100,51,51
43,2022/7/15 7:30,148,91,57,57
43,2022/7/15 7:40,161,93,68,68
43,2022/7/15 7:50,184,118,66,66
43,2022/7/15 8:00,173,109,64,64
43,2022/7/15 8:10,92,110,-18,-18
43,2022/7/15 8:20,79,144,-65,-65
43,2022/7/15 8:30,53,121,-68,-68
43,2022/7/15 8:40,44,112,-68,-68
43,2022/7/15 8:50,39,87,-48,-48
43,2022/7/15 9:00,34,126,-92,-92
43,2022/7/15 9:10,28,93,-65,-65
43,2022/7/15 9:20,27,81,-54,-54
43,2022/7/15 9:30,22,77,-55,-55
43,2022/7/15 9:40,22,87,-65,-65
43,2022/7/15 9:50,23,67,-44,-44
43,2022/7/15 10:00,25,52,-27,-27
43,2022/7/15 10:10,25,51,-26,-26
43,2022/7/15 10:20,25,50,-25,-25
43,2022/7/15 10:30,24,41,-17,-17
43,2022/7/15 10:40,23,44,-21,-21
43,2022/7/15 10:50,25,49,-24,-24
43,2022/7/15 11:00,23,51,-28,-28
43,2022/7/15 11:10,25,50,-25,-25
43,2022/7/15 11:20,21,50,-29,-29
43,2022/7/15 11:30,36,25,11,11
43,2022/7/15 11:40,23,49,-26,-26
43,2022/7/15 11:50,21,52,-31,-31
43,2022/7/15 12:00,23,52,-29,-29
43,2022/7/15 12:10,23,50,-27,-27
43,2022/7/15 12:20,23,66,-43,-43
43,2022/7/15 12:30,19,37,-18,-18
43,2022/7/15 12:40,25,59,-34,-34
43,2022/7/15 12:50,25,62,-37,-37
43,2022/7/15 13:00,22,65,-43,-43
43,2022/7/15 13:10,26,66,-40,-40
43,2022/7/15 13:20,25,47,-22,-22
43,2022/7/15 13:30,22,25,-3,-3
43,2022/7/15 13:40,24,49,-25,-25
43,2022/7/15 13:50,22,55,-33,-33
43,2022/7/15 14:00,24,55,-31,-31
43,2022/7/15 14:10,24,50,-26,-26
43,2022/7/15 14:20,22,51,-29,-29
43,2022/7/15 14:30,22,23,-1,-1
43,2022/7/15 14:40,34,54,-20,-20
43,2022/7/15 14:50,19,54,-35,-35
43,2022/7/15 15:00,19,54,-35,-35
43,2022/7/15 15:10,23,65,-42,-42
43,2022/7/15 15:20,21,53,-32,-32
43,2022/7/15 15:30,22,32,-10,-10
43,2022/7/15 15:40,22,64,-42,-42
43,2022/7/15 15:50,25,60,-35,-35
43,2022/7/15 16:00,21,70,-49,-49
43,2022/7/15 16:10,29,63,-34,-34
43,2022/7/15 16:20,29,71,-42,-42
43,2022/7/15 16:30,32,45,-13,-13
43,2022/7/15 16:40,33,73,-40,-40
43,2022/7/15 16:50,39,71,-32,-32
43,2022/7/15 17:00,42,67,-25,-25
43,2022/7/15 17:10,204,75,129,129
43,2022/7/15 17:20,137,74,63,63
43,2022/7/15 17:30,73,69,4,4
43,2022/7/15 17:40,69,86,-17,-17
43,2022/7/15 17:50,63,76,-13,-13
43,2022/7/15 18:00,59,104,-45,-45
43,2022/7/15 18:10,48,92,-44,-44
43,2022/7/15 18:20,63,115,-52,-52
43,2022/7/15 18:30,38,101,-63,-63
43,2022/7/15 18:40,34,111,-77,-77
43,2022/7/15 18:50,26,97,-71,-71
43,2022/7/15 19:00,25,92,-67,-67
43,2022/7/15 19:10,37,106,-69,-69
43,2022/7/15 19:20,17,105,-88,-88
43,2022/7/15 19:30,17,79,-62,-62
43,2022/7/15 19:40,16,76,-60,-60
43,2022/7/15 19:50,14,71,-57,-57
43,2022/7/15 20:00,19,82,-63,-63
43,2022/7/15 20:10,22,52,-30,-30
43,2022/7/15 20:20,14,56,-42,-42
43,2022/7/15 20:30,14,69,-55,-55
43,2022/7/15 20:40,18,70,-52,-52
43,2022/7/15 20:50,11,54,-43,-43
43,2022/7/15 21:00,11,56,-45,-45
43,2022/7/15 21:10,11,55,-44,-44
43,2022/7/15 21:20,14,59,-45,-45
43,2022/7/15 21:30,9,53,-44,-44
43,2022/7/15 21:40,7,60,-53,-53
43,2022/7/15 21:50,5,62,-57,-57
43,2022/7/15 22:00,6,48,-42,-42
43,2022/7/15 22:10,3,57,-54,-54
43,2022/7/15 22:20,1,50,-49,-49
43,2022/7/15 22:30,2,50,-48,-48
43,2022/7/15 22:40,0,43,-43,-43
43,2022/7/15 22:50,0,47,-47,-47
56,2022/7/15 5:00,0,1,-1,-2
56,2022/7/15 5:10,4,1,3,3
56,2022/7/15 5:20,15,1,14,23
56,2022/7/15 5:30,12,1,11,17
56,2022/7/15 5:40,15,1,14,27
56,2022/7/15 5:50,20,1,19,34
56,2022/7/15 6:00,30,1,29,48
56,2022/7/15 6:10,35,2,33,61
56,2022/7/15 6:20,44,2,42,75
56,2022/7/15 6:30,70,5,65,74
56,2022/7/15 6:40,108,13,95,107
56,2022/7/15 6:50,147,62,85,74
56,2022/7/15 7:00,227,59,168,158
56,2022/7/15 7:10,245,52,193,224
56,2022/7/15 7:20,343,51,292,343
56,2022/7/15 7:30,325,78,247,304
56,2022/7/15 7:40,572,77,495,563
56,2022/7/15 7:50,632,90,542,608
56,2022/7/15 8:00,662,127,535,599
56,2022/7/15 8:10,392,93,299,281
56,2022/7/15 8:20,330,99,231,166
56,2022/7/15 8:30,284,75,209,141
56,2022/7/15 8:40,226,121,105,37
56,2022/7/15 8:50,168,83,85,37
56,2022/7/15 9:00,96,72,24,-68
56,2022/7/15 9:10,68,77,-9,-74
56,2022/7/15 9:20,44,99,-55,-109
56,2022/7/15 9:30,43,72,-29,-84
56,2022/7/15 9:40,38,62,-24,-89
56,2022/7/15 9:50,37,74,-37,-81
56,2022/7/15 10:00,29,69,-40,-67
56,2022/7/15 10:10,29,52,-23,-49
56,2022/7/15 10:20,26,65,-39,-64
56,2022/7/15 10:30,28,68,-40,-57
56,2022/7/15 10:40,28,67,-39,-60
56,2022/7/15 10:50,27,66,-39,-63
56,2022/7/15 11:00,25,23,2,-26
56,2022/7/15 11:10,24,62,-38,-63
56,2022/7/15 11:20,29,69,-40,-69
56,2022/7/15 11:30,28,71,-43,-32
56,2022/7/15 11:40,30,74,-44,-70
56,2022/7/15 11:50,28,50,-22,-53
56,2022/7/15 12:00,31,45,-14,-43
56,2022/7/15 12:10,30,61,-31,-58
56,2022/7/15 12:20,32,64,-32,-75
56,2022/7/15 12:30,33,74,-41,-59
56,2022/7/15 12:40,28,74,-46,-80
56,2022/7/15 12:50,27,52,-25,-62
56,2022/7/15 13:00,28,55,-27,-70
56,2022/7/15 13:10,25,72,-47,-87
56,2022/7/15 13:20,28,81,-53,-75
56,2022/7/15 13:30,27,68,-41,-44
56,2022/7/15 13:40,28,72,-44,-69
56,2022/7/15 13:50,24,50,-26,-59
56,2022/7/15 14:00,28,63,-35,-66
56,2022/7/15 14:10,27,71,-44,-70
56,2022/7/15 14:20,27,69,-42,-71
56,2022/7/15 14:30,25,77,-52,-53
56,2022/7/15 14:40,28,83,-55,-75
56,2022/7/15 14:50,27,48,-21,-56
56,2022/7/15 15:00,26,66,-40,-75
56,2022/7/15 15:10,29,67,-38,-80
56,2022/7/15 15:20,26,81,-55,-87
56,2022/7/15 15:30,29,83,-54,-64
56,2022/7/15 15:40,26,83,-57,-99
56,2022/7/15 15:50,27,60,-33,-68
56,2022/7/15 16:00,28,64,-36,-85
56,2022/7/15 16:10,28,82,-54,-88
56,2022/7/15 16:20,26,109,-83,-125
56,2022/7/15 16:30,33,103,-70,-83
56,2022/7/15 16:40,31,95,-64,-104
56,2022/7/15 16:50,31,90,-59,-91
56,2022/7/15 17:00,29,107,-78,-103
56,2022/7/15 17:10,53,108,-55,74
56,2022/7/15 17:20,42,126,-84,-21
56,2022/7/15 17:30,45,106,-61,-57
56,2022/7/15 17:40,47,177,-130,-147
56,2022/7/15 17:50,47,118,-71,-84
56,2022/7/15 18:00,45,119,-74,-119
56,2022/7/15 18:10,38,147,-109,-153
56,2022/7/15 18:20,32,326,-294,-346
56,2022/7/15 18:30,33,180,-147,-210
56,2022/7/15 18:40,28,180,-152,-229
56,2022/7/15 18:50,26,198,-172,-243
56,2022/7/15 19:00,28,328,-300,-367
56,2022/7/15 19:10,27,145,-118,-187
56,2022/7/15 19:20,21,180,-159,-247
56,2022/7/15 19:30,20,97,-77,-139
56,2022/7/15 19:40,21,180,-159,-219
56,2022/7/15 19:50,19,107,-88,-145
56,2022/7/15 20:00,19,106,-87,-150
56,2022/7/15 20:10,19,118,-99,-129
56,2022/7/15 20:20,17,108,-91,-133
56,2022/7/15 20:30,20,90,-70,-125
56,2022/7/15 20:40,16,95,-79,-131
56,2022/7/15 20:50,19,105,-86,-129
56,2022/7/15 21:00,14,104,-90,-135
56,2022/7/15 21:10,18,94,-76,-120
56,2022/7/15 21:20,16,110,-94,-139
56,2022/7/15 21:30,16,75,-59,-103
56,2022/7/15 21:40,12,92,-80,-133
56,2022/7/15 21:50,10,100,-90,-147
56,2022/7/15 22:00,9,72,-63,-105
56,2022/7/15 22:10,8,109,-101,-155
56,2022/7/15 22:20,5,78,-73,-122
56,2022/7/15 22:30,1,90,-89,-137
56,2022/7/15 22:40,0,79,-79,-122
56,2022/7/15 22:50,0,49,-49,-96
46,2022/7/15 5:00,0,1,-1,-3
46,2022/7/15 5:10,1,1,0,3
46,2022/7/15 5:20,10,1,9,32
46,2022/7/15 5:30,14,1,13,30
46,2022/7/15 5:40,15,1,14,41
46,2022/7/15 5:50,18,1,17,51
46,2022/7/15 6:00,25,1,24,72
46,2022/7/15 6:10,31,1,30,91
46,2022/7/15 6:20,32,1,31,106
46,2022/7/15 6:30,48,1,47,121
46,2022/7/15 6:40,58,23,35,142
46,2022/7/15 6:50,78,47,31,105
46,2022/7/15 7:00,70,47,23,181
46,2022/7/15 7:10,152,65,87,311
46,2022/7/15 7:20,245,69,176,519
46,2022/7/15 7:30,283,50,233,537
46,2022/7/15 7:40,328,60,268,831
46,2022/7/15 7:50,328,69,259,867
46,2022/7/15 8:00,326,72,254,853
46,2022/7/15 8:10,301,72,229,510
46,2022/7/15 8:20,254,106,148,314
46,2022/7/15 8:30,184,100,84,225
46,2022/7/15 8:40,163,87,76,113
46,2022/7/15 8:50,104,73,31,68
46,2022/7/15 9:00,68,84,-16,-84
46,2022/7/15 9:10,49,55,-6,-80
46,2022/7/15 9:20,43,48,-5,-114
46,2022/7/15 9:30,32,40,-8,-92
46,2022/7/15 9:40,32,63,-31,-120
46,2022/7/15 9:50,27,38,-11,-92
46,2022/7/15 10:00,28,61,-33,-100
46,2022/7/15 10:10,27,45,-18,-67
46,2022/7/15 10:20,25,8,17,-47
46,2022/7/15 10:30,20,51,-31,-88
46,2022/7/15 10:40,23,50,-27,-87
46,2022/7/15 10:50,23,41,-18,-81
46,2022/7/15 11:00,18,45,-27,-53
46,2022/7/15 11:10,23,38,-15,-78
46,2022/7/15 11:20,17,23,-6,-75
46,2022/7/15 11:30,20,44,-24,-56
46,2022/7/15 11:40,20,48,-28,-98
46,2022/7/15 11:50,22,49,-27,-80
46,2022/7/15 12:00,22,45,-23,-66
46,2022/7/15 12:10,23,22,1,-57
46,2022/7/15 12:20,27,40,-13,-88
46,2022/7/15 12:30,19,62,-43,-102
46,2022/7/15 12:40,23,56,-33,-113
46,2022/7/15 12:50,24,51,-27,-89
46,2022/7/15 13:00,23,49,-26,-96
46,2022/7/15 13:10,22,23,-1,-88
46,2022/7/15 13:20,19,46,-27,-102
46,2022/7/15 13:30,20,52,-32,-76
46,2022/7/15 13:40,21,48,-27,-96
46,2022/7/15 13:50,19,50,-31,-90
46,2022/7/15 14:00,17,60,-43,-109
46,2022/7/15 14:10,20,32,-12,-82
46,2022/7/15 14:20,17,47,-30,-101
46,2022/7/15 14:30,16,64,-48,-101
46,2022/7/15 14:40,20,65,-45,-120
46,2022/7/15 14:50,20,61,-41,-97
46,2022/7/15 15:00,17,66,-49,-124
46,2022/7/15 15:10,17,35,-18,-98
46,2022/7/15 15:20,20,57,-37,-124
46,2022/7/15 15:30,15,68,-53,-117
46,2022/7/15 15:40,21,72,-51,-150
46,2022/7/15 15:50,22,77,-55,-123
46,2022/7/15 16:00,21,77,-56,-141
46,2022/7/15 16:10,30,43,-13,-101
46,2022/7/15 16:20,28,68,-40,-165
46,2022/7/15 16:30,27,75,-48,-131
46,2022/7/15 16:40,28,106,-78,-182
46,2022/7/15 16:50,34,78,-44,-135
46,2022/7/15 17:00,31,77,-46,-149
46,2022/7/15 17:10,44,76,-32,42
46,2022/7/15 17:20,35,115,-80,-101
46,2022/7/15 17:30,30,103,-73,-130
46,2022/7/15 17:40,30,105,-75,-222
46,2022/7/15 17:50,35,105,-70,-154
46,2022/7/15 18:00,29,151,-122,-241
46,2022/7/15 18:10,28,128,-100,-253
46,2022/7/15 18:20,29,110,-81,-427
46,2022/7/15 18:30,28,112,-84,-294
46,2022/7/15 18:40,20,235,-215,-444
46,2022/7/15 18:50,20,111,-91,-334
46,2022/7/15 19:00,19,105,-86,-453
46,2022/7/15 19:10,15,114,-99,-286
46,2022/7/15 19:20,15,139,-124,-371
46,2022/7/15 19:30,14,104,-90,-229
46,2022/7/15 19:40,16,106,-90,-309
46,2022/7/15 19:50,12,76,-64,-209
46,2022/7/15 20:00,14,114,-100,-250
46,2022/7/15 20:10,13,71,-58,-187
46,2022/7/15 20:20,12,78,-66,-199
46,2022/7/15 20:30,11,54,-43,-168
46,2022/7/15 20:40,13,98,-85,-216
46,2022/7/15 20:50,14,66,-52,-181
46,2022/7/15 21:00,10,92,-82,-217
46,2022/7/15 21:10,15,47,-32,-152
46,2022/7/15 21:20,11,95,-84,-223
46,2022/7/15 21:30,8,71,-63,-166
46,2022/7/15 21:40,7,73,-66,-199
46,2022/7/15 21:50,5,86,-81,-228
46,2022/7/15 22:00,4,43,-39,-144
46,2022/7/15 22:10,2,96,-94,-249
46,2022/7/15 22:20,2,83,-81,-203
46,2022/7/15 22:30,2,64,-62,-199
46,2022/7/15 22:40,0,63,-63,-185
46,2022/7/15 22:50,0,54,-54,-150
49,2022/7/15 5:00,0,1,-1,-4
49,2022/7/15 5:10,0,1,-1,2
49,2022/7/15 5:20,7,1,6,38
49,2022/7/15 5:30,20,1,19,49
49,2022/7/15 5:40,19,1,18,59
49,2022/7/15 5:50,21,1,20,71
49,2022/7/15 6:00,26,1,25,97
49,2022/7/15 6:10,34,1,33,124
49,2022/7/15 6:20,40,2,38,144
49,2022/7/15 6:30,58,5,53,174
49,2022/7/15 6:40,100,34,66,208
49,2022/7/15 6:50,180,38,142,247
49,2022/7/15 7:00,169,23,146,327
49,2022/7/15 7:10,254,65,189,500
49,2022/7/15 7:20,361,47,314,833
49,2022/7/15 7:30,325,69,256,793
49,2022/7/15 7:40,591,61,530,1361
49,2022/7/15 7:50,663,65,598,1465
49,2022/7/15 8:00,629,69,560,1413
49,2022/7/15 8:10,592,93,499,1009
49,2022/7/15 8:20,376,74,302,616
49,2022/7/15 8:30,301,74,227,452
49,2022/7/15 8:40,280,62,218,331
49,2022/7/15 8:50,218,77,141,209
49,2022/7/15 9:00,148,61,87,3
49,2022/7/15 9:10,94,45,49,-31
49,2022/7/15 9:20,68,50,18,-96
49,2022/7/15 9:30,53,65,-12,-104
49,2022/7/15 9:40,40,45,-5,-125
49,2022/7/15 9:50,33,51,-18,-110
49,2022/7/15 10:00,31,41,-10,-110
49,2022/7/15 10:10,29,46,-17,-84
49,2022/7/15 10:20,27,49,-22,-69
49,2022/7/15 10:30,27,8,19,-69
49,2022/7/15 10:40,29,48,-19,-106
49,2022/7/15 10:50,28,50,-22,-103
49,2022/7/15 11:00,26,50,-24,-77
49,2022/7/15 11:10,29,50,-21,-99
49,2022/7/15 11:20,22,51,-29,-104
49,2022/7/15 11:30,23,8,15,-41
49,2022/7/15 11:40,27,61,-34,-132
49,2022/7/15 11:50,28,60,-32,-112
49,2022/7/15 12:00,27,51,-24,-90
49,2022/7/15 12:10,30,62,-32,-89
49,2022/7/15 12:20,27,51,-24,-112
49,2022/7/15 12:30,30,8,22,-80
49,2022/7/15 12:40,26,67,-41,-154
49,2022/7/15 12:50,28,63,-35,-124
49,2022/7/15 13:00,28,64,-36,-132
49,2022/7/15 13:10,25,60,-35,-123
49,2022/7/15 13:20,25,58,-33,-135
49,2022/7/15 13:30,29,17,12,-64
49,2022/7/15 13:40,22,60,-38,-134
49,2022/7/15 13:50,26,68,-42,-132
49,2022/7/15 14:00,21,65,-44,-153
49,2022/7/15 14:10,22,72,-50,-132
49,2022/7/15 14:20,20,63,-43,-144
49,2022/7/15 14:30,22,15,7,-94
49,2022/7/15 14:40,21,70,-49,-169
49,2022/7/15 14:50,22,70,-48,-145
49,2022/7/15 15:00,20,76,-56,-180
49,2022/7/15 15:10,27,74,-47,-145
49,2022/7/15 15:20,24,70,-46,-170
49,2022/7/15 15:30,20,22,-2,-119
49,2022/7/15 15:40,24,78,-54,-204
49,2022/7/15 15:50,24,90,-66,-189
49,2022/7/15 16:00,22,97,-75,-216
49,2022/7/15 16:10,28,99,-71,-172
49,2022/7/15 16:20,28,88,-60,-225
49,2022/7/15 16:30,28,101,-73,-204
49,2022/7/15 16:40,29,76,-47,-229
49,2022/7/15 16:50,26,91,-65,-200
49,2022/7/15 17:00,30,101,-71,-220
49,2022/7/15 17:10,31,118,-87,-45
49,2022/7/15 17:20,31,93,-62,-163
49,2022/7/15 17:30,34,116,-82,-212
49,2022/7/15 17:40,29,116,-87,-309
49,2022/7/15 17:50,26,255,-229,-383
49,2022/7/15 18:00,28,150,-122,-363
49,2022/7/15 18:10,32,154,-122,-375
49,2022/7/15 18:20,33,197,-164,-591
49,2022/7/15 18:30,27,537,-510,-804
49,2022/7/15 18:40,23,197,-174,-618
49,2022/7/15 18:50,25,191,-166,-500
49,2022/7/15 19:00,21,198,-177,-630
49,2022/7/15 19:10,18,286,-268,-554
49,2022/7/15 19:20,15,109,-94,-465
49,2022/7/15 19:30,15,123,-108,-337
49,2022/7/15 19:40,17,121,-104,-413
49,2022/7/15 19:50,17,126,-109,-318
49,2022/7/15 20:00,14,97,-83,-333
49,2022/7/15 20:10,14,95,-81,-268
49,2022/7/15 20:20,14,110,-96,-295
49,2022/7/15 20:30,15,107,-92,-260
49,2022/7/15 20:40,15,78,-63,-279
49,2022/7/15 20:50,14,92,-78,-259
49,2022/7/15 21:00,13,110,-97,-314
49,2022/7/15 21:10,14,106,-92,-244
49,2022/7/15 21:20,8,89,-81,-304
49,2022/7/15 21:30,10,97,-87,-253
49,2022/7/15 21:40,9,100,-91,-290
49,2022/7/15 21:50,7,95,-88,-316
49,2022/7/15 22:00,7,104,-97,-241
49,2022/7/15 22:10,10,95,-85,-334
49,2022/7/15 22:20,3,85,-82,-285
49,2022/7/15 22:30,2,78,-76,-275
49,2022/7/15 22:40,1,92,-91,-276
49,2022/7/15 22:50,0,63,-63,-213
48,2022/7/15 5:00,0,1,-1,-5
48,2022/7/15 5:10,0,1,-1,1
48,2022/7/15 5:20,5,1,4,42
48,2022/7/15 5:30,25,1,24,73
48,2022/7/15 5:40,25,1,24,83
48,2022/7/15 5:50,30,1,29,100
48,2022/7/15 6:00,32,2,30,127
48,2022/7/15 6:10,47,2,45,169
48,2022/7/15 6:20,60,5,55,199
48,2022/7/15 6:30,79,5,74,248
48,2022/7/15 6:40,149,61,88,296
48,2022/7/15 6:50,176,38,138,385
48,2022/7/15 7:00,223,52,171,498
48,2022/7/15 7:10,321,54,267,767
48,2022/7/15 7:20,369,67,302,1135
48,2022/7/15 7:30,654,62,592,1385
48,2022/7/15 7:40,737,88,649,2010
48,2022/7/15 7:50,1186,76,1110,2575
48,2022/7/15 8:00,1177,76,1101,2514
48,2022/7/15 8:10,1175,79,1096,2105
48,2022/7/15 8:20,736,76,660,1276
48,2022/7/15 8:30,638,81,557,1009
48,2022/7/15 8:40,442,79,363,694
48,2022/7/15 8:50,318,67,251,460
48,2022/7/15 9:00,274,83,191,194
48,2022/7/15 9:10,191,73,118,87
48,2022/7/15 9:20,149,64,85,-11
48,2022/7/15 9:30,78,64,14,-90
48,2022/7/15 9:40,67,68,-1,-126
48,2022/7/15 9:50,47,69,-22,-132
48,2022/7/15 10:00,44,73,-29,-139
48,2022/7/15 10:10,42,58,-16,-100
48,2022/7/15 10:20,40,68,-28,-97
48,2022/7/15 10:30,30,72,-42,-111
48,2022/7/15 10:40,37,64,-27,-133
48,2022/7/15 10:50,32,74,-42,-145
48,2022/7/15 11:00,29,69,-40,-117
48,2022/7/15 11:10,32,61,-29,-128
48,2022/7/15 11:20,31,64,-33,-137
48,2022/7/15 11:30,32,83,-51,-92
48,2022/7/15 11:40,29,61,-32,-164
48,2022/7/15 11:50,33,77,-44,-156
48,2022/7/15 12:00,34,71,-37,-127
48,2022/7/15 12:10,34,69,-35,-124
48,2022/7/15 12:20,37,70,-33,-145
48,2022/7/15 12:30,38,77,-39,-119
48,2022/7/15 12:40,38,70,-32,-186
48,2022/7/15 12:50,34,76,-42,-166
48,2022/7/15 13:00,36,68,-32,-164
48,2022/7/15 13:10,28,64,-36,-159
48,2022/7/15 13:20,30,81,-51,-186
48,2022/7/15 13:30,34,76,-42,-106
48,2022/7/15 13:40,36,66,-30,-164
48,2022/7/15 13:50,29,76,-47,-179
48,2022/7/15 14:00,29,73,-44,-197
48,2022/7/15 14:10,29,70,-41,-173
48,2022/7/15 14:20,29,77,-48,-192
48,2022/7/15 14:30,26,93,-67,-161
48,2022/7/15 14:40,29,71,-42,-211
48,2022/7/15 14:50,27,93,-66,-211
48,2022/7/15 15:00,27,80,-53,-233
48,2022/7/15 15:10,27,75,-48,-193
48,2022/7/15 15:20,27,99,-72,-242
48,2022/7/15 15:30,28,108,-80,-199
48,2022/7/15 15:40,27,73,-46,-250
48,2022/7/15 15:50,27,101,-74,-263
48,2022/7/15 16:00,28,103,-75,-291
48,2022/7/15 16:10,30,91,-61,-233
48,2022/7/15 16:20,31,101,-70,-295
48,2022/7/15 16:30,31,106,-75,-279
48,2022/7/15 16:40,37,125,-88,-317
48,2022/7/15 16:50,35,114,-79,-279
48,2022/7/15 17:00,37,110,-73,-293
48,2022/7/15 17:10,39,109,-70,-115
48,2022/7/15 17:20,45,152,-107,-270
48,2022/7/15 17:30,44,177,-133,-345
48,2022/7/15 17:40,45,195,-150,-459
48,2022/7/15 17:50,44,212,-168,-551
48,2022/7/15 18:00,35,380,-345,-708
48,2022/7/15 18:10,43,325,-282,-657
48,2022/7/15 18:20,33,433,-400,-991
48,2022/7/15 18:30,29,329,-300,-1104
48,2022/7/15 18:40,28,421,-393,-1011
48,2022/7/15 18:50,30,537,-507,-1007
48,2022/7/15 19:00,28,536,-508,-1138
48,2022/7/15 19:10,29,235,-206,-760
48,2022/7/15 19:20,28,285,-257,-722
48,2022/7/15 19:30,24,191,-167,-504
48,2022/7/15 19:40,26,150,-124,-537
48,2022/7/15 19:50,29,107,-78,-396
48,2022/7/15 20:00,22,124,-102,-435
48,2022/7/15 20:10,28,116,-88,-356
48,2022/7/15 20:20,24,114,-90,-385
48,2022/7/15 20:30,29,106,-77,-337
48,2022/7/15 20:40,24,124,-100,-379
48,2022/7/15 20:50,25,111,-86,-345
48,2022/7/15 21:00,25,124,-99,-413
48,2022/7/15 21:10,28,110,-82,-326
48,2022/7/15 21:20,26,115,-89,-393
48,2022/7/15 21:30,24,101,-77,-330
48,2022/7/15 21:40,22,100,-78,-368
48,2022/7/15 21:50,21,110,-89,-405
48,2022/7/15 22:00,21,113,-92,-333
48,2022/7/15 22:10,17,109,-92,-426
48,2022/7/15 22:20,10,93,-83,-368
48,2022/7/15 22:30,6,113,-107,-382
48,2022/7/15 22:40,2,124,-122,-398
48,2022/7/15 22:50,1,74,-73,-286
41,2022/7/15 5:00,0,1,-1,-6
41,2022/7/15 5:10,0,1,-1,0
41,2022/7/15 5:20,0,1,-1,41
41,2022/7/15 5:30,1,1,0,73
41,2022/7/15 5:40,8,1,7,90
41,2022/7/15 5:50,7,2,5,105
41,2022/7/15 6:00,9,5,4,131
41,2022/7/15 6:10,13,5,8,177
41,2022/7/15 6:20,17,8,9,208
41,2022/7/15 6:30,26,22,4,252
41,2022/7/15 6:40,27,21,6,302
41,2022/7/15 6:50,33,30,3,388
41,2022/7/15 7:00,36,33,3,501
41,2022/7/15 7:10,34,35,-1,766
41,2022/7/15 7:20,54,46,8,1143
41,2022/7/15 7:30,57,49,8,1393
41,2022/7/15 7:40,98,67,31,2041
41,2022/7/15 7:50,72,69,3,2578
41,2022/7/15 8:00,149,93,56,2570
41,2022/7/15 8:10,72,87,-15,2090
41,2022/7/15 8:20,103,79,24,1300
41,2022/7/15 8:30,54,62,-8,1001
41,2022/7/15 8:40,57,68,-11,683
41,2022/7/15 8:50,35,55,-20,440
41,2022/7/15 9:00,36,45,-9,185
41,2022/7/15 9:10,26,37,-11,76
41,2022/7/15 9:20,26,42,-16,-27
41,2022/7/15 9:30,20,32,-12,-102
41,2022/7/15 9:40,14,25,-11,-137
41,2022/7/15 9:50,16,23,-7,-139
41,2022/7/15 10:00,14,30,-16,-155
41,2022/7/15 10:10,12,29,-17,-117
41,2022/7/15 10:20,13,21,-8,-105
41,2022/7/15 10:30,12,23,-11,-122
41,2022/7/15 10:40,11,19,-8,-141
41,2022/7/15 10:50,11,21,-10,-155
41,2022/7/15 11:00,10,21,-11,-128
41,2022/7/15 11:10,11,19,-8,-136
41,2022/7/15 11:20,12,21,-9,-146
41,2022/7/15 11:30,10,21,-11,-103
41,2022/7/15 11:40,11,19,-8,-172
41,2022/7/15 11:50,8,21,-13,-169
41,2022/7/15 12:00,12,31,-19,-146
41,2022/7/15 12:10,13,21,-8,-132
41,2022/7/15 12:20,12,23,-11,-156
41,2022/7/15 12:30,12,28,-16,-135
41,2022/7/15 12:40,15,21,-6,-192
41,2022/7/15 12:50,13,25,-12,-178
41,2022/7/15 13:00,11,25,-14,-178
41,2022/7/15 13:10,12,23,-11,-170
41,2022/7/15 13:20,12,31,-19,-205
41,2022/7/15 13:30,10,29,-19,-125
41,2022/7/15 13:40,9,21,-12,-176
41,2022/7/15 13:50,9,23,-14,-193
41,2022/7/15 14:00,9,32,-23,-220
41,2022/7/15 14:10,11,25,-14,-187
41,2022/7/15 14:20,13,31,-18,-210
41,2022/7/15 14:30,12,32,-20,-181
41,2022/7/15 14:40,9,23,-14,-225
41,2022/7/15 14:50,9,25,-16,-227
41,2022/7/15 15:00,10,35,-25,-258
41,2022/7/15 15:10,12,25,-13,-206
41,2022/7/15 15:20,10,32,-22,-264
41,2022/7/15 15:30,13,40,-27,-226
41,2022/7/15 15:40,12,32,-20,-270
41,2022/7/15 15:50,14,38,-24,-287
41,2022/7/15 16:00,14,46,-32,-323
41,2022/7/15 16:10,17,37,-20,-253
41,2022/7/15 16:20,17,44,-27,-322
41,2022/7/15 16:30,24,45,-21,-300
41,2022/7/15 16:40,25,52,-27,-344
41,2022/7/15 16:50,23,46,-23,-302
41,2022/7/15 17:00,29,61,-32,-325
41,2022/7/15 17:10,26,57,-31,-146
41,2022/7/15 17:20,29,75,-46,-316
41,2022/7/15 17:30,25,70,-45,-390
41,2022/7/15 17:40,29,93,-64,-523
41,2022/7/15 17:50,28,76,-48,-599
41,2022/7/15 18:00,24,97,-73,-781
41,2022/7/15 18:10,26,77,-51,-708
41,2022/7/15 18:20,25,106,-81,-1072
41,2022/7/15 18:30,17,77,-60,-1164
41,2022/7/15 18:40,16,107,-91,-1102
41,2022/7/15 18:50,14,85,-71,-1078
41,2022/7/15 19:00,14,76,-62,-1200
41,2022/7/15 19:10,12,71,-59,-819
41,2022/7/15 19:20,10,61,-51,-773
41,2022/7/15 19:30,7,57,-50,-554
41,2022/7/15 19:40,8,54,-46,-583
41,2022/7/15 19:50,7,46,-39,-435
41,2022/7/15 20:00,5,55,-50,-485
41,2022/7/15 20:10,5,33,-28,-384
41,2022/7/15 20:20,6,47,-41,-426
41,2022/7/15 20:30,6,39,-33,-370
41,2022/7/15 20:40,8,52,-44,-423
41,2022/7/15 20:50,6,36,-30,-375
41,2022/7/15 21:00,7,47,-40,-453
41,2022/7/15 21:10,6,37,-31,-357
41,2022/7/15 21:20,4,34,-30,-423
41,2022/7/15 21:30,8,47,-39,-369
41,2022/7/15 21:40,6,40,-34,-402
41,2022/7/15 21:50,2,36,-34,-439
41,2022/7/15 22:00,2,40,-38,-371
41,2022/7/15 22:10,1,32,-31,-457
41,2022/7/15 22:20,2,35,-33,-401
41,2022/7/15 22:30,1,41,-40,-422
41,2022/7/15 22:40,0,32,-32,-430
41,2022/7/15 22:50,0,8,-8,-294
57,2022/7/15 5:00,0,1,-1,-7
57,2022/7/15 5:10,0,1,-1,-1
57,2022/7/15 5:20,0,1,-1,40
57,2022/7/15 5:30,0,1,-1,72
57,2022/7/15 5:40,2,1,1,91
57,2022/7/15 5:50,3,1,2,107
57,2022/7/15 6:00,3,1,2,133
57,2022/7/15 6:10,6,1,5,182
57,2022/7/15 6:20,10,1,9,217
57,2022/7/15 6:30,11,19,-8,244
57,2022/7/15 6:40,15,16,-1,301
57,2022/7/15 6:50,16,21,-5,383
57,2022/7/15 7:00,20,31,-11,490
57,2022/7/15 7:10,23,33,-10,756
57,2022/7/15 7:20,21,64,-43,1100
57,2022/7/15 7:30,26,64,-38,1355
57,2022/7/15 7:40,31,62,-31,2010
57,2022/7/15 7:50,33,103,-70,2508
57,2022/7/15 8:00,29,126,-97,2473
57,2022/7/15 8:10,32,107,-75,2015
57,2022/7/15 8:20,30,97,-67,1233
57,2022/7/15 8:30,29,92,-63,938
57,2022/7/15 8:40,27,105,-78,605
57,2022/7/15 8:50,22,96,-74,366
57,2022/7/15 9:00,17,64,-47,138
57,2022/7/15 9:10,14,94,-80,-4
57,2022/7/15 9:20,13,77,-64,-91
57,2022/7/15 9:30,12,69,-57,-159
57,2022/7/15 9:40,12,70,-58,-195
57,2022/7/15 9:50,10,74,-64,-203
57,2022/7/15 10:00,9,50,-41,-196
57,2022/7/15 10:10,12,58,-46,-163
57,2022/7/15 10:20,10,37,-27,-132
57,2022/7/15 10:30,9,23,-14,-136
57,2022/7/15 10:40,10,33,-23,-164
57,2022/7/15 10:50,11,23,-12,-167
57,2022/7/15 11:00,14,23,-9,-137
57,2022/7/15 11:10,10,23,-13,-149
57,2022/7/15 11:20,9,21,-12,-158
57,2022/7/15 11:30,10,16,-6,-109
57,2022/7/15 11:40,13,23,-10,-182
57,2022/7/15 11:50,19,19,0,-169
57,2022/7/15 12:00,20,23,-3,-149
57,2022/7/15 12:10,20,24,-4,-136
57,2022/7/15 12:20,16,22,-6,-162
57,2022/7/15 12:30,13,23,-10,-145
57,2022/7/15 12:40,16,36,-20,-212
57,2022/7/15 12:50,12,30,-18,-196
57,2022/7/15 13:00,12,32,-20,-198
57,2022/7/15 13:10,12,37,-25,-195
57,2022/7/15 13:20,12,32,-20,-225
57,2022/7/15 13:30,13,34,-21,-146
57,2022/7/15 13:40,14,37,-23,-199
57,2022/7/15 13:50,14,29,-15,-208
57,2022/7/15 14:00,12,33,-21,-241
57,2022/7/15 14:10,14,38,-24,-211
57,2022/7/15 14:20,15,31,-16,-226
57,2022/7/15 14:30,20,23,-3,-184
57,2022/7/15 14:40,34,37,-3,-228
57,2022/7/15 14:50,29,21,8,-219
57,2022/7/15 15:00,18,28,-10,-268
57,2022/7/15 15:10,19,31,-12,-218
57,2022/7/15 15:20,16,23,-7,-271
57,2022/7/15 15:30,22,23,-1,-227
57,2022/7/15 15:40,26,33,-7,-277
57,2022/7/15 15:50,24,32,-8,-295
57,2022/7/15 16:00,19,31,-12,-335
57,2022/7/15 16:10,21,36,-15,-268
57,2022/7/15 16:20,25,31,-6,-328
57,2022/7/15 16:30,25,38,-13,-313
57,2022/7/15 16:40,25,38,-13,-357
57,2022/7/15 16:50,25,44,-19,-321
57,2022/7/15 17:00,35,38,-3,-328
57,2022/7/15 17:10,43,52,-9,-155
57,2022/7/15 17:20,30,37,-7,-323
57,2022/7/15 17:30,32,57,-25,-415
57,2022/7/15 17:40,40,49,-9,-532
57,2022/7/15 17:50,27,58,-31,-630
57,2022/7/15 18:00,35,53,-18,-799
57,2022/7/15 18:10,30,61,-31,-739
57,2022/7/15 18:20,25,51,-26,-1098
57,2022/7/15 18:30,27,59,-32,-1196
57,2022/7/15 18:40,28,50,-22,-1124
57,2022/7/15 18:50,21,52,-31,-1109
57,2022/7/15 19:00,20,41,-21,-1221
57,2022/7/15 19:10,18,43,-25,-844
57,2022/7/15 19:20,14,33,-19,-792
57,2022/7/15 19:30,12,39,-27,-581
57,2022/7/15 19:40,12,25,-13,-596
57,2022/7/15 19:50,12,25,-13,-448
57,2022/7/15 20:00,10,23,-13,-498
57,2022/7/15 20:10,11,27,-16,-400
57,2022/7/15 20:20,9,23,-14,-440
57,2022/7/15 20:30,10,32,-22,-392
57,2022/7/15 20:40,14,25,-11,-434
57,2022/7/15 20:50,10,25,-15,-390
57,2022/7/15 21:00,7,23,-16,-469
57,2022/7/15 21:10,6,25,-19,-376
57,2022/7/15 21:20,8,25,-17,-440
57,2022/7/15 21:30,5,25,-20,-389
57,2022/7/15 21:40,7,25,-18,-420
57,2022/7/15 21:50,6,27,-21,-460
57,2022/7/15 22:00,5,23,-18,-389
57,2022/7/15 22:10,4,18,-14,-471
57,2022/7/15 22:20,2,21,-19,-420
57,2022/7/15 22:30,1,21,-20,-442
57,2022/7/15 22:40,1,15,-14,-444
57,2022/7/15 22:50,0,3,-3,-297
40,2022/7/15 5:00,0,1,-1,-8
40,2022/7/15 5:10,0,1,-1,-2
40,2022/7/15 5:20,0,1,-1,39
40,2022/7/15 5:30,2,1,1,73
40,2022/7/15 5:40,5,1,4,95
40,2022/7/15 5:50,8,7,1,108
40,2022/7/15 6:00,11,6,5,138
40,2022/7/15 6:10,16,6,10,192
40,2022/7/15 6:20,25,18,7,224
40,2022/7/15 6:30,29,56,-27,217
40,2022/7/15 6:40,30,54,-24,277
40,2022/7/15 6:50,35,49,-14,369
40,2022/7/15 7:00,42,89,-47,443
40,2022/7/15 7:10,51,88,-37,719
40,2022/7/15 7:20,58,118,-60,1040
40,2022/7/15 7:30,86,108,-22,1333
40,2022/7/15 7:40,126,111,15,2025
40,2022/7/15 7:50,168,123,45,2553
40,2022/7/15 8:00,149,134,15,2488
40,2022/7/15 8:10,122,121,1,2016
40,2022/7/15 8:20,146,104,42,1275
40,2022/7/15 8:30,77,109,-32,906
40,2022/7/15 8:40,59,143,-84,521
40,2022/7/15 8:50,49,107,-58,308
40,2022/7/15 9:00,36,99,-63,75
40,2022/7/15 9:10,39,84,-45,-49
40,2022/7/15 9:20,33,99,-66,-157
40,2022/7/15 9:30,27,73,-46,-205
40,2022/7/15 9:40,25,79,-54,-249
40,2022/7/15 9:50,24,74,-50,-253
40,2022/7/15 10:00,25,84,-59,-255
40,2022/7/15 10:10,23,59,-36,-199
40,2022/7/15 10:20,23,59,-36,-168
40,2022/7/15 10:30,24,71,-47,-183
40,2022/7/15 10:40,24,60,-36,-200
40,2022/7/15 10:50,23,63,-40,-207
40,2022/7/15 11:00,24,51,-27,-164
40,2022/7/15 11:10,26,51,-25,-174
40,2022/7/15 11:20,23,57,-34,-192
40,2022/7/15 11:30,20,60,-40,-149
40,2022/7/15 11:40,21,52,-31,-213
40,2022/7/15 11:50,25,60,-35,-204
40,2022/7/15 12:00,27,61,-34,-183
40,2022/7/15 12:10,20,50,-30,-166
40,2022/7/15 12:20,23,64,-41,-203
40,2022/7/15 12:30,26,61,-35,-180
40,2022/7/15 12:40,22,62,-40,-252
40,2022/7/15 12:50,22,62,-40,-236
40,2022/7/15 13:00,22,56,-34,-232
40,2022/7/15 13:10,21,56,-35,-230
40,2022/7/15 13:20,24,53,-29,-254
40,2022/7/15 13:30,25,63,-38,-184
40,2022/7/15 13:40,24,50,-26,-225
40,2022/7/15 13:50,26,57,-31,-239
40,2022/7/15 14:00,25,51,-26,-267
40,2022/7/15 14:10,24,50,-26,-237
40,2022/7/15 14:20,22,54,-32,-258
40,2022/7/15 14:30,25,61,-36,-220
40,2022/7/15 14:40,61,50,11,-217
40,2022/7/15 14:50,37,60,-23,-242
40,2022/7/15 15:00,32,62,-30,-298
40,2022/7/15 15:10,29,64,-35,-253
40,2022/7/15 15:20,27,68,-41,-312
40,2022/7/15 15:30,27,59,-32,-259
40,2022/7/15 15:40,43,57,-14,-291
40,2022/7/15 15:50,30,66,-36,-331
40,2022/7/15 16:00,28,59,-31,-366
40,2022/7/15 16:10,34,72,-38,-306
40,2022/7/15 16:20,39,61,-22,-350
40,2022/7/15 16:30,38,62,-24,-337
40,2022/7/15 16:40,36,84,-48,-405
40,2022/7/15 16:50,30,71,-41,-362
40,2022/7/15 17:00,44,93,-49,-377
40,2022/7/15 17:10,45,69,-24,-179
40,2022/7/15 17:20,39,111,-72,-395
40,2022/7/15 17:30,27,97,-70,-485
40,2022/7/15 17:40,35,126,-91,-623
40,2022/7/15 17:50,30,97,-67,-697
40,2022/7/15 18:00,37,102,-65,-864
40,2022/7/15 18:10,60,114,-54,-793
40,2022/7/15 18:20,46,107,-61,-1159
40,2022/7/15 18:30,37,107,-70,-1266
40,2022/7/15 18:40,29,108,-79,-1203
40,2022/7/15 18:50,24,106,-82,-1191
40,2022/7/15 19:00,28,112,-84,-1305
40,2022/7/15 19:10,27,75,-48,-892
40,2022/7/15 19:20,22,95,-73,-865
40,2022/7/15 19:30,22,75,-53,-634
40,2022/7/15 19:40,18,76,-58,-654
40,2022/7/15 19:50,17,60,-43,-491
40,2022/7/15 20:00,17,73,-56,-554
40,2022/7/15 20:10,20,59,-39,-439
40,2022/7/15 20:20,17,67,-50,-490
40,2022/7/15 20:30,14,60,-46,-438
40,2022/7/15 20:40,16,67,-51,-485
40,2022/7/15 20:50,13,63,-50,-440
40,2022/7/15 21:00,12,75,-63,-532
40,2022/7/15 21:10,15,52,-37,-413
40,2022/7/15 21:20,12,69,-57,-497
40,2022/7/15 21:30,11,68,-57,-446
40,2022/7/15 21:40,9,62,-53,-473
40,2022/7/15 21:50,10,71,-61,-521
40,2022/7/15 22:00,7,47,-40,-429
40,2022/7/15 22:10,12,64,-52,-523
40,2022/7/15 22:20,6,66,-60,-480
40,2022/7/15 22:30,2,42,-40,-482
40,2022/7/15 22:40,2,49,-47,-491
40,2022/7/15 22:50,0,8,-8,-305
53,2022/7/15 5:00,0,1,-1,-9
53,2022/7/15 5:10,0,1,-1,-3
53,2022/7/15 5:20,0,1,-1,38
53,2022/7/15 5:30,2,1,1,74
53,2022/7/15 5:40,2,1,1,96
53,2022/7/15 5:50,13,6,7,115
53,2022/7/15 6:00,11,2,9,147
53,2022/7/15 6:10,16,11,5,197
53,2022/7/15 6:20,25,19,6,230
53,2022/7/15 6:30,31,61,-30,187
53,2022/7/15 6:40,37,71,-34,243
53,2022/7/15 6:50,41,91,-50,319
53,2022/7/15 7:00,43,87,-44,399
53,2022/7/15 7:10,57,108,-51,668
53,2022/7/15 7:20,55,105,-50,990
53,2022/7/15 7:30,63,107,-44,1289
53,2022/7/15 7:40,123,107,16,2041
53,2022/7/15 7:50,164,125,39,2592
53,2022/7/15 8:00,167,131,36,2524
53,2022/7/15 8:10,181,334,-153,1863
53,2022/7/15 8:20,186,296,-110,1165
53,2022/7/15 8:30,149,344,-195,711
53,2022/7/15 8:40,93,377,-284,237
53,2022/7/15 8:50,79,332,-253,55
53,2022/7/15 9:00,62,222,-160,-85
53,2022/7/15 9:10,53,233,-180,-229
53,2022/7/15 9:20,52,108,-56,-213
53,2022/7/15 9:30,41,110,-69,-274
53,2022/7/15 9:40,38,107,-69,-318
53,2022/7/15 9:50,29,96,-67,-320
53,2022/7/15 10:00,29,76,-47,-302
53,2022/7/15 10:10,28,76,-48,-247
53,2022/7/15 10:20,27,67,-40,-208
53,2022/7/15 10:30,25,76,-51,-234
53,2022/7/15 10:40,29,69,-40,-240
53,2022/7/15 10:50,28,61,-33,-240
53,2022/7/15 11:00,28,73,-45,-209
53,2022/7/15 11:10,28,49,-21,-195
53,2022/7/15 11:20,27,59,-32,-224
53,2022/7/15 11:30,25,66,-41,-190
53,2022/7/15 11:40,27,67,-40,-253
53,2022/7/15 11:50,26,60,-34,-238
53,2022/7/15 12:00,27,66,-39,-222
53,2022/7/15 12:10,28,69,-41,-207
53,2022/7/15 12:20,23,60,-37,-240
53,2022/7/15 12:30,26,65,-39,-219
53,2022/7/15 12:40,25,78,-53,-305
53,2022/7/15 12:50,23,60,-37,-273
53,2022/7/15 13:00,23,72,-49,-281
53,2022/7/15 13:10,23,70,-47,-277
53,2022/7/15 13:20,28,61,-33,-287
53,2022/7/15 13:30,27,75,-48,-232
53,2022/7/15 13:40,24,68,-44,-269
53,2022/7/15 13:50,29,62,-33,-272
53,2022/7/15 14:00,25,72,-47,-314
53,2022/7/15 14:10,26,67,-41,-278
53,2022/7/15 14:20,31,52,-21,-279
53,2022/7/15 14:30,23,67,-44,-264
53,2022/7/15 14:40,22,64,-42,-259
53,2022/7/15 14:50,26,60,-34,-276
53,2022/7/15 15:00,27,64,-37,-335
53,2022/7/15 15:10,29,73,-44,-297
53,2022/7/15 15:20,31,59,-28,-340
53,2022/7/15 15:30,26,72,-46,-305
53,2022/7/15 15:40,26,78,-52,-343
53,2022/7/15 15:50,36,59,-23,-354
53,2022/7/15 16:00,35,63,-28,-394
53,2022/7/15 16:10,35,70,-35,-341
53,2022/7/15 16:20,38,77,-39,-389
53,2022/7/15 16:30,44,85,-41,-378
53,2022/7/15 16:40,44,82,-38,-443
53,2022/7/15 16:50,43,87,-44,-406
53,2022/7/15 17:00,85,90,-5,-382
53,2022/7/15 17:10,169,99,70,-109
53,2022/7/15 17:20,140,108,32,-363
53,2022/7/15 17:30,175,106,69,-416
53,2022/7/15 17:40,233,103,130,-493
53,2022/7/15 17:50,217,127,90,-607
53,2022/7/15 18:00,223,125,98,-766
53,2022/7/15 18:10,304,121,183,-610
53,2022/7/15 18:20,267,125,142,-1017
53,2022/7/15 18:30,191,110,81,-1185
53,2022/7/15 18:40,164,121,43,-1160
53,2022/7/15 18:50,82,88,-6,-1197
53,2022/7/15 19:00,69,106,-37,-1342
53,2022/7/15 19:10,50,102,-52,-944
53,2022/7/15 19:20,45,91,-46,-911
53,2022/7/15 19:30,41,89,-48,-682
53,2022/7/15 19:40,40,79,-39,-693
53,2022/7/15 19:50,33,73,-40,-531
53,2022/7/15 20:00,35,72,-37,-591
53,2022/7/15 20:10,31,64,-33,-472
53,2022/7/15 20:20,30,60,-30,-520
53,2022/7/15 20:30,30,63,-33,-471
53,2022/7/15 20:40,33,67,-34,-519
53,2022/7/15 20:50,29,71,-42,-482
53,2022/7/15 21:00,35,56,-21,-553
53,2022/7/15 21:10,27,63,-36,-449
53,2022/7/15 21:20,26,62,-36,-533
53,2022/7/15 21:30,25,65,-40,-486
53,2022/7/15 21:40,28,58,-30,-503
53,2022/7/15 21:50,29,70,-41,-562
53,2022/7/15 22:00,24,59,-35,-464
53,2022/7/15 22:10,24,48,-24,-547
53,2022/7/15 22:20,17,51,-34,-514
53,2022/7/15 22:30,10,49,-39,-521
53,2022/7/15 22:40,4,18,-14,-505
53,2022/7/15 22:50,1,10,-9,-314
38,2022/7/15 5:00,0,1,-1,-10
38,2022/7/15 5:10,0,1,-1,-4
38,2022/7/15 5:20,3,1,2,40
38,2022/7/15 5:30,6,1,5,79
38,2022/7/15 5:40,18,1,17,113
38,2022/7/15 5:50,20,1,19,134
38,2022/7/15 6:00,20,19,1,148
38,2022/7/15 6:10,30,21,9,206
38,2022/7/15 6:20,31,57,-26,204
38,2022/7/15 6:30,42,65,-23,164
38,2022/7/15 6:40,54,74,-20,223
38,2022/7/15 6:50,65,114,-49,270
38,2022/7/15 7:00,75,120,-45,354
38,2022/7/15 7:10,124,226,-102,566
38,2022/7/15 7:20,104,180,-76,914
38,2022/7/15 7:30,157,144,13,1302
38,2022/7/15 7:40,197,192,5,2046
38,2022/7/15 7:50,239,299,-60,2532
38,2022/7/15 8:00,279,509,-230,2294
38,2022/7/15 8:10,279,575,-296,1567
38,2022/7/15 8:20,251,586,-335,830
38,2022/7/15 8:30,247,1505,-1258,-547
38,2022/7/15 8:40,207,1873,-1666,-1429
38,2022/7/15 8:50,192,1120,-928,-873
38,2022/7/15 9:00,139,584,-445,-530
38,2022/7/15 9:10,84,426,-342,-571
38,2022/7/15 9:20,77,343,-266,-479
38,2022/7/15 9:30,64,196,-132,-406
38,2022/7/15 9:40,62,212,-150,-468
38,2022/7/15 9:50,48,167,-119,-439
38,2022/7/15 10:00,43,117,-74,-376
38,2022/7/15 10:10,43,126,-83,-330
38,2022/7/15 10:20,43,112,-69,-277
38,2022/7/15 10:30,42,111,-69,-303
38,2022/7/15 10:40,39,110,-71,-311
38,2022/7/15 10:50,37,93,-56,-296
38,2022/7/15 11:00,37,78,-41,-250
38,2022/7/15 11:10,43,93,-50,-245
38,2022/7/15 11:20,37,90,-53,-277
38,2022/7/15 11:30,41,81,-40,-230
38,2022/7/15 11:40,44,93,-49,-302
38,2022/7/15 11:50,41,81,-40,-278
38,2022/7/15 12:00,41,90,-49,-271
38,2022/7/15 12:10,44,100,-56,-263
38,2022/7/15 12:20,42,93,-51,-291
38,2022/7/15 12:30,44,105,-61,-280
38,2022/7/15 12:40,44,112,-68,-373
38,2022/7/15 12:50,43,106,-63,-336
38,2022/7/15 13:00,38,110,-72,-353
38,2022/7/15 13:10,46,112,-66,-343
38,2022/7/15 13:20,41,101,-60,-347
38,2022/7/15 13:30,35,101,-66,-298
38,2022/7/15 13:40,36,105,-69,-338
38,2022/7/15 13:50,39,99,-60,-332
38,2022/7/15 14:00,41,102,-61,-375
38,2022/7/15 14:10,42,96,-54,-332
38,2022/7/15 14:20,41,91,-50,-329
38,2022/7/15 14:30,43,90,-47,-311
38,2022/7/15 14:40,43,97,-54,-313
38,2022/7/15 14:50,47,97,-50,-326
38,2022/7/15 15:00,55,98,-43,-378
38,2022/7/15 15:10,63,105,-42,-339
38,2022/7/15 15:20,65,80,-15,-355
38,2022/7/15 15:30,65,103,-38,-343
38,2022/7/15 15:40,54,104,-50,-393
38,2022/7/15 15:50,79,92,-13,-367
38,2022/7/15 16:00,133,102,31,-363
38,2022/7/15 16:10,139,108,31,-310
38,2022/7/15 16:20,134,96,38,-351
38,2022/7/15 16:30,150,103,47,-331
38,2022/7/15 16:40,217,87,130,-313
38,2022/7/15 16:50,214,110,104,-302
38,2022/7/15 17:00,270,121,149,-233
38,2022/7/15 17:10,429,122,307,198
38,2022/7/15 17:20,352,120,232,-131
38,2022/7/15 17:30,307,108,199,-217
38,2022/7/15 17:40,578,181,397,-96
38,2022/7/15 17:50,567,127,440,-167
38,2022/7/15 18:00,461,226,235,-531
38,2022/7/15 18:10,830,155,675,65
38,2022/7/15 18:20,673,226,447,-570
38,2022/7/15 18:30,462,146,316,-869
38,2022/7/15 18:40,344,178,166,-994
38,2022/7/15 18:50,250,117,133,-1064
38,2022/7/15 19:00,179,117,62,-1280
38,2022/7/15 19:10,169,126,43,-901
38,2022/7/15 19:20,134,121,13,-898
38,2022/7/15 19:30,67,105,-38,-720
38,2022/7/15 19:40,70,113,-43,-736
38,2022/7/15 19:50,53,80,-27,-558
38,2022/7/15 20:00,52,95,-43,-634
38,2022/7/15 20:10,62,92,-30,-502
38,2022/7/15 20:20,48,79,-31,-551
38,2022/7/15 20:30,49,89,-40,-511
38,2022/7/15 20:40,47,76,-29,-548
38,2022/7/15 20:50,43,92,-49,-531
38,2022/7/15 21:00,43,85,-42,-595
38,2022/7/15 21:10,63,95,-32,-481
38,2022/7/15 21:20,43,79,-36,-569
38,2022/7/15 21:30,44,77,-33,-519
38,2022/7/15 21:40,37,95,-58,-561
38,2022/7/15 21:50,29,82,-53,-615
38,2022/7/15 22:00,31,86,-55,-519
38,2022/7/15 22:10,29,94,-65,-612
38,2022/7/15 22:20,29,77,-48,-562
38,2022/7/15 22:30,22,85,-63,-584
38,2022/7/15 22:40,13,62,-49,-554
38,2022/7/15 22:50,9,52,-43,-357
42,2022/7/15 5:00,0,1,-1,-11
42,2022/7/15 5:10,0,1,-1,-5
42,2022/7/15 5:20,0,1,-1,39
42,2022/7/15 5:30,0,1,-1,78
42,2022/7/15 5:40,3,1,2,115
42,2022/7/15 5:50,7,1,6,140
42,2022/7/15 6:00,20,2,18,166
42,2022/7/15 6:10,30,21,9,215
42,2022/7/15 6:20,32,38,-6,198
42,2022/7/15 6:30,38,23,15,179
42,2022/7/15 6:40,59,49,10,233
42,2022/7/15 6:50,78,72,6,276
42,2022/7/15 7:00,84,71,13,367
42,2022/7/15 7:10,177,74,103,669
42,2022/7/15 7:20,174,73,101,1015
42,2022/7/15 7:30,234,109,125,1427
42,2022/7/15 7:40,277,107,170,2216
42,2022/7/15 7:50,275,109,166,2698
42,2022/7/15 8:00,279,169,110,2404
42,2022/7/15 8:10,318,178,140,1707
42,2022/7/15 8:20,279,178,101,931
42,2022/7/15 8:30,282,332,-50,-597
42,2022/7/15 8:40,238,434,-196,-1625
42,2022/7/15 8:50,195,436,-241,-1114
42,2022/7/15 9:00,143,213,-70,-600
42,2022/7/15 9:10,135,320,-185,-756
42,2022/7/15 9:20,79,208,-129,-608
42,2022/7/15 9:30,66,110,-44,-450
42,2022/7/15 9:40,48,109,-61,-529
42,2022/7/15 9:50,40,103,-63,-502
42,2022/7/15 10:00,38,109,-71,-447
42,2022/7/15 10:10,39,80,-41,-371
42,2022/7/15 10:20,31,99,-68,-345
42,2022/7/15 10:30,32,88,-56,-359
42,2022/7/15 10:40,27,69,-42,-353
42,2022/7/15 10:50,29,75,-46,-342
42,2022/7/15 11:00,33,83,-50,-300
42,2022/7/15 11:10,32,65,-33,-278
42,2022/7/15 11:20,30,75,-45,-322
42,2022/7/15 11:30,30,62,-32,-262
42,2022/7/15 11:40,28,78,-50,-352
42,2022/7/15 11:50,29,64,-35,-313
42,2022/7/15 12:00,32,64,-32,-303
42,2022/7/15 12:10,31,74,-43,-306
42,2022/7/15 12:20,28,82,-54,-345
42,2022/7/15 12:30,35,81,-46,-326
42,2022/7/15 12:40,30,70,-40,-413
42,2022/7/15 12:50,32,87,-55,-391
42,2022/7/15 13:00,32,77,-45,-398
42,2022/7/15 13:10,31,70,-39,-382
42,2022/7/15 13:20,30,80,-50,-397
42,2022/7/15 13:30,32,70,-38,-336
42,2022/7/15 13:40,34,72,-38,-376
42,2022/7/15 13:50,31,74,-43,-375
42,2022/7/15 14:00,32,69,-37,-412
42,2022/7/15 14:10,26,75,-49,-381
42,2022/7/15 14:20,33,84,-51,-380
42,2022/7/15 14:30,32,77,-45,-356
42,2022/7/15 14:40,33,66,-33,-346
42,2022/7/15 14:50,28,76,-48,-374
42,2022/7/15 15:00,30,82,-52,-430
42,2022/7/15 15:10,30,75,-45,-384
42,2022/7/15 15:20,29,91,-62,-417
42,2022/7/15 15:30,34,91,-57,-400
42,2022/7/15 15:40,31,81,-50,-443
42,2022/7/15 15:50,30,101,-71,-438
42,2022/7/15 16:00,44,93,-49,-412
42,2022/7/15 16:10,40,90,-50,-360
42,2022/7/15 16:20,45,114,-69,-420
42,2022/7/15 16:30,47,93,-46,-377
42,2022/7/15 16:40,48,106,-58,-371
42,2022/7/15 16:50,48,116,-68,-370
42,2022/7/15 17:00,112,109,3,-230
42,2022/7/15 17:10,173,123,50,248
42,2022/7/15 17:20,88,124,-36,-167
42,2022/7/15 17:30,97,169,-72,-289
42,2022/7/15 17:40,239,116,123,27
42,2022/7/15 17:50,226,178,48,-119
42,2022/7/15 18:00,198,151,47,-484
42,2022/7/15 18:10,335,198,137,202
42,2022/7/15 18:20,307,144,163,-407
42,2022/7/15 18:30,213,178,35,-834
42,2022/7/15 18:40,204,126,78,-916
42,2022/7/15 18:50,137,155,-18,-1082
42,2022/7/15 19:00,96,113,-17,-1297
42,2022/7/15 19:10,75,113,-38,-939
42,2022/7/15 19:20,50,110,-60,-958
42,2022/7/15 19:30,46,90,-44,-764
42,2022/7/15 19:40,43,79,-36,-772
42,2022/7/15 19:50,37,104,-67,-625
42,2022/7/15 20:00,31,94,-63,-697
42,2022/7/15 20:10,35,79,-44,-546
42,2022/7/15 20:20,36,99,-63,-614
42,2022/7/15 20:30,27,89,-62,-573
42,2022/7/15 20:40,29,85,-56,-604
42,2022/7/15 20:50,28,85,-57,-588
42,2022/7/15 21:00,27,100,-73,-668
42,2022/7/15 21:10,35,70,-35,-516
42,2022/7/15 21:20,22,106,-84,-653
42,2022/7/15 21:30,27,68,-41,-560
42,2022/7/15 21:40,24,70,-46,-607
42,2022/7/15 21:50,23,100,-77,-692
42,2022/7/15 22:00,20,72,-52,-571
42,2022/7/15 22:10,23,70,-47,-659
42,2022/7/15 22:20,16,94,-78,-640
42,2022/7/15 22:30,8,61,-53,-637
42,2022/7/15 22:40,4,41,-37,-591
42,2022/7/15 22:50,2,65,-63,-420
30,2022/7/15 5:00,0,1,-1,-12
30,2022/7/15 5:10,0,1,-1,-6
30,2022/7/15 5:20,0,1,-1,38
30,2022/7/15 5:30,3,1,2,80
30,2022/7/15 5:40,6,1,5,120
30,2022/7/15 5:50,18,1,17,157
30,2022/7/15 6:00,20,1,19,185
30,2022/7/15 6:10,31,33,-2,213
30,2022/7/15 6:20,33,45,-12,186
30,2022/7/15 6:30,40,55,-15,164
30,2022/7/15 6:40,59,71,-12,221
30,2022/7/15 6:50,67,79,-12,264
30,2022/7/15 7:00,92,88,4,371
30,2022/7/15 7:10,156,114,42,711
30,2022/7/15 7:20,216,101,115,1130
30,2022/7/15 7:30,235,123,112,1539
30,2022/7/15 7:40,303,128,175,2391
30,2022/7/15 7:50,326,180,146,2844
30,2022/7/15 8:00,443,317,126,2530
30,2022/7/15 8:10,476,414,62,1769
30,2022/7/15 8:20,443,485,-42,889
30,2022/7/15 8:30,345,567,-222,-819
30,2022/7/15 8:40,330,1532,-1202,-2827
30,2022/7/15 8:50,254,592,-338,-1452
30,2022/7/15 9:00,225,505,-280,-880
30,2022/7/15 9:10,193,322,-129,-885
30,2022/7/15 9:20,173,231,-58,-666
30,2022/7/15 9:30,145,217,-72,-522
30,2022/7/15 9:40,91,191,-100,-629
30,2022/7/15 9:50,76,151,-75,-577
30,2022/7/15 10:00,73,121,-48,-495
30,2022/7/15 10:10,67,108,-41,-412
30,2022/7/15 10:20,57,123,-66,-411
30,2022/7/15 10:30,55,113,-58,-417
30,2022/7/15 10:40,48,105,-57,-410
30,2022/7/15 10:50,47,105,-58,-400
30,2022/7/15 11:00,50,105,-55,-355
30,2022/7/15 11:10,45,97,-52,-330
30,2022/7/15 11:20,43,103,-60,-382
30,2022/7/15 11:30,49,105,-56,-318
30,2022/7/15 11:40,54,100,-46,-398
30,2022/7/15 11:50,48,106,-58,-371
30,2022/7/15 12:00,60,105,-45,-348
30,2022/7/15 12:10,60,87,-27,-333
30,2022/7/15 12:20,67,103,-36,-381
30,2022/7/15 12:30,60,127,-67,-393
30,2022/7/15 12:40,67,123,-56,-469
30,2022/7/15 12:50,62,97,-35,-426
30,2022/7/15 13:00,68,126,-58,-456
30,2022/7/15 13:10,74,119,-45,-427
30,2022/7/15 13:20,71,103,-32,-429
30,2022/7/15 13:30,77,108,-31,-367
30,2022/7/15 13:40,71,122,-51,-427
30,2022/7/15 13:50,61,106,-45,-420
30,2022/7/15 14:00,67,104,-37,-449
30,2022/7/15 14:10,67,109,-42,-423
30,2022/7/15 14:20,68,112,-44,-424
30,2022/7/15 14:30,70,96,-26,-382
30,2022/7/15 14:40,66,104,-38,-384
30,2022/7/15 14:50,66,105,-39,-413
30,2022/7/15 15:00,70,122,-52,-482
30,2022/7/15 15:10,65,123,-58,-442
30,2022/7/15 15:20,64,110,-46,-463
30,2022/7/15 15:30,117,121,-4,-404
30,2022/7/15 15:40,85,121,-36,-479
30,2022/7/15 15:50,168,96,72,-366
30,2022/7/15 16:00,146,111,35,-377
30,2022/7/15 16:10,111,100,11,-349
30,2022/7/15 16:20,130,97,33,-387
30,2022/7/15 16:30,180,121,59,-318
30,2022/7/15 16:40,170,113,57,-314
30,2022/7/15 16:50,179,118,61,-309
30,2022/7/15 17:00,269,143,126,-104
30,2022/7/15 17:10,336,138,198,446
30,2022/7/15 17:20,269,152,117,-50
30,2022/7/15 17:30,568,178,390,101
30,2022/7/15 17:40,649,225,424,451
30,2022/7/15 17:50,422,218,204,85
30,2022/7/15 18:00,620,268,352,-132
30,2022/7/15 18:10,818,313,505,707
30,2022/7/15 18:20,569,217,352,-55
30,2022/7/15 18:30,351,300,51,-783
30,2022/7/15 18:40,310,269,41,-875
30,2022/7/15 18:50,265,232,33,-1049
30,2022/7/15 19:00,234,153,81,-1216
30,2022/7/15 19:10,216,139,77,-862
30,2022/7/15 19:20,179,112,67,-891
30,2022/7/15 19:30,137,125,12,-752
30,2022/7/15 19:40,137,108,29,-743
30,2022/7/15 19:50,115,103,12,-613
30,2022/7/15 20:00,96,104,-8,-705
30,2022/7/15 20:10,113,113,0,-546
30,2022/7/15 20:20,85,92,-7,-621
30,2022/7/15 20:30,125,97,28,-545
30,2022/7/15 20:40,79,106,-27,-631
30,2022/7/15 20:50,74,92,-18,-606
30,2022/7/15 21:00,144,78,66,-602
30,2022/7/15 21:10,138,92,46,-470
30,2022/7/15 21:20,89,80,9,-644
30,2022/7/15 21:30,64,111,-47,-607
30,2022/7/15 21:40,58,77,-19,-626
30,2022/7/15 21:50,41,67,-26,-718
30,2022/7/15 22:00,41,92,-51,-622
30,2022/7/15 22:10,34,78,-44,-703
30,2022/7/15 22:20,25,84,-59,-699
30,2022/7/15 22:30,22,80,-58,-695
30,2022/7/15 22:40,16,59,-43,-634
30,2022/7/15 22:50,10,51,-41,-461
32,2022/7/15 5:00,0,1,-1,-13
32,2022/7/15 5:10,0,1,-1,-7
32,2022/7/15 5:20,0,1,-1,37
32,2022/7/15 5:30,0,1,-1,79
32,2022/7/15 5:40,6,1,5,125
32,2022/7/15 5:50,20,1,19,176
32,2022/7/15 6:00,39,6,33,218
32,2022/7/15 6:10,43,51,-8,205
32,2022/7/15 6:20,55,45,10,196
32,2022/7/15 6:30,68,47,21,185
32,2022/7/15 6:40,121,70,51,272
32,2022/7/15 6:50,189,78,111,375
32,2022/7/15 7:00,222,94,128,499
32,2022/7/15 7:10,244,107,137,848
32,2022/7/15 7:20,281,106,175,1305
32,2022/7/15 7:30,360,119,241,1780
32,2022/7/15 7:40,475,170,305,2696
32,2022/7/15 7:50,598,178,420,3264
32,2022/7/15 8:00,442,117,325,2855
32,2022/7/15 8:10,366,268,98,1867
32,2022/7/15 8:20,341,192,149,1038
32,2022/7/15 8:30,344,180,164,-655
32,2022/7/15 8:40,278,180,98,-2729
32,2022/7/15 8:50,277,285,-8,-1460
32,2022/7/15 9:00,247,151,96,-784
32,2022/7/15 9:10,201,139,62,-823
32,2022/7/15 9:20,179,110,69,-597
32,2022/7/15 9:30,107,109,-2,-524
32,2022/7/15 9:40,72,112,-40,-669
32,2022/7/15 9:50,73,97,-24,-601
32,2022/7/15 10:00,49,101,-52,-547
32,2022/7/15 10:10,44,114,-70,-482
32,2022/7/15 10:20,46,80,-34,-445
32,2022/7/15 10:30,41,79,-38,-455
32,2022/7/15 10:40,43,80,-37,-447
32,2022/7/15 10:50,37,81,-44,-444
32,2022/7/15 11:00,41,87,-46,-401
32,2022/7/15 11:10,41,79,-38,-368
32,2022/7/15 11:20,41,83,-42,-424
32,2022/7/15 11:30,38,94,-56,-374
32,2022/7/15 11:40,39,69,-30,-428
32,2022/7/15 11:50,43,90,-47,-418
32,2022/7/15 12:00,41,101,-60,-408
32,2022/7/15 12:10,44,81,-37,-370
32,2022/7/15 12:20,43,93,-50,-431
32,2022/7/15 12:30,46,106,-60,-453
32,2022/7/15 12:40,44,78,-34,-503
32,2022/7/15 12:50,41,103,-62,-488
32,2022/7/15 13:00,45,111,-66,-522
32,2022/7/15 13:10,44,76,-32,-459
32,2022/7/15 13:20,38,100,-62,-491
32,2022/7/15 13:30,40,98,-58,-425
32,2022/7/15 13:40,40,73,-33,-460
32,2022/7/15 13:50,37,96,-59,-479
32,2022/7/15 14:00,44,108,-64,-513
32,2022/7/15 14:10,36,68,-32,-455
32,2022/7/15 14:20,37,94,-57,-481
32,2022/7/15 14:30,37,105,-68,-450
32,2022/7/15 14:40,37,76,-39,-423
32,2022/7/15 14:50,39,105,-66,-479
32,2022/7/15 15:00,41,111,-70,-552
32,2022/7/15 15:10,49,84,-35,-477
32,2022/7/15 15:20,44,112,-68,-531
32,2022/7/15 15:30,53,104,-51,-455
32,2022/7/15 15:40,41,81,-40,-519
32,2022/7/15 15:50,44,108,-64,-430
32,2022/7/15 16:00,60,123,-63,-440
32,2022/7/15 16:10,61,96,-35,-384
32,2022/7/15 16:20,55,106,-51,-438
32,2022/7/15 16:30,68,126,-58,-376
32,2022/7/15 16:40,79,103,-24,-338
32,2022/7/15 16:50,86,125,-39,-348
32,2022/7/15 17:00,207,103,104,0
32,2022/7/15 17:10,270,138,132,578
32,2022/7/15 17:20,214,143,71,21
32,2022/7/15 17:30,174,233,-59,42
32,2022/7/15 17:40,225,225,0,451
32,2022/7/15 17:50,206,298,-92,-7
32,2022/7/15 18:00,177,285,-108,-240
32,2022/7/15 18:10,222,328,-106,601
32,2022/7/15 18:20,169,284,-115,-170
32,2022/7/15 18:30,110,301,-191,-974
32,2022/7/15 18:40,80,285,-205,-1080
32,2022/7/15 18:50,59,235,-176,-1225
32,2022/7/15 19:00,48,192,-144,-1360
32,2022/7/15 19:10,46,154,-108,-970
32,2022/7/15 19:20,43,128,-85,-976
32,2022/7/15 19:30,36,110,-74,-826
32,2022/7/15 19:40,36,109,-73,-816
32,2022/7/15 19:50,32,106,-74,-687
32,2022/7/15 20:00,32,128,-96,-801
32,2022/7/15 20:10,35,107,-72,-618
32,2022/7/15 20:20,33,100,-67,-688
32,2022/7/15 20:30,29,100,-71,-616
32,2022/7/15 20:40,29,77,-48,-679
32,2022/7/15 20:50,32,129,-97,-703
32,2022/7/15 21:00,66,83,-17,-619
32,2022/7/15 21:10,32,125,-93,-563
32,2022/7/15 21:20,30,78,-48,-692
32,2022/7/15 21:30,27,107,-80,-687
32,2022/7/15 21:40,32,103,-71,-697
32,2022/7/15 21:50,27,94,-67,-785
32,2022/7/15 22:00,25,95,-70,-692
32,2022/7/15 22:10,17,110,-93,-796
32,2022/7/15 22:20,12,77,-65,-764
32,2022/7/15 22:30,7,108,-101,-796
32,2022/7/15 22:40,6,64,-58,-692
32,2022/7/15 22:50,3,66,-63,-524
59,2022/7/15 5:00,0,1,-1,-14
59,2022/7/15 5:10,0,1,-1,-8
59,2022/7/15 5:20,0,1,-1,36
59,2022/7/15 5:30,0,1,-1,78
59,2022/7/15 5:40,2,1,1,126
59,2022/7/15 5:50,14,1,13,189
59,2022/7/15 6:00,29,2,27,245
59,2022/7/15 6:10,31,29,2,207
59,2022/7/15 6:20,35,32,3,199
59,2022/7/15 6:30,33,32,1,186
59,2022/7/15 6:40,54,38,16,288
59,2022/7/15 6:50,70,37,33,408
59,2022/7/15 7:00,88,50,38,537
59,2022/7/15 7:10,157,52,105,953
59,2022/7/15 7:20,186,65,121,1426
59,2022/7/15 7:30,227,72,155,1935
59,2022/7/15 7:40,276,80,196,2892
59,2022/7/15 7:50,277,92,185,3449
59,2022/7/15 8:00,318,104,214,3069
59,2022/7/15 8:10,278,106,172,2039
59,2022/7/15 8:20,233,104,129,1167
59,2022/7/15 8:30,215,108,107,-548
59,2022/7/15 8:40,199,124,75,-2654
59,2022/7/15 8:50,123,90,33,-1427
59,2022/7/15 9:00,76,95,-19,-803
59,2022/7/15 9:10,63,77,-14,-837
59,2022/7/15 9:20,50,62,-12,-609
59,2022/7/15 9:30,43,70,-27,-551
59,2022/7/15 9:40,39,71,-32,-701
59,2022/7/15 9:50,35,79,-44,-645
59,2022/7/15 10:00,32,69,-37,-584
59,2022/7/15 10:10,26,60,-34,-516
59,2022/7/15 10:20,26,71,-45,-490
59,2022/7/15 10:30,22,72,-50,-505
59,2022/7/15 10:40,23,53,-30,-477
59,2022/7/15 10:50,29,70,-41,-485
59,2022/7/15 11:00,29,68,-39,-440
59,2022/7/15 11:10,28,52,-24,-392
59,2022/7/15 11:20,25,60,-35,-459
59,2022/7/15 11:30,30,64,-34,-408
59,2022/7/15 11:40,31,60,-29,-457
59,2022/7/15 11:50,27,65,-38,-456
59,2022/7/15 12:00,34,52,-18,-426
59,2022/7/15 12:10,31,66,-35,-405
59,2022/7/15 12:20,33,63,-30,-461
59,2022/7/15 12:30,37,57,-20,-473
59,2022/7/15 12:40,30,72,-42,-545
59,2022/7/15 12:50,27,61,-34,-522
59,2022/7/15 13:00,30,65,-35,-557
59,2022/7/15 13:10,28,72,-44,-503
59,2022/7/15 13:20,26,74,-48,-539
59,2022/7/15 13:30,29,60,-31,-456
59,2022/7/15 13:40,28,71,-43,-503
59,2022/7/15 13:50,28,66,-38,-517
59,2022/7/15 14:00,29,70,-41,-554
59,2022/7/15 14:10,30,82,-52,-507
59,2022/7/15 14:20,26,64,-38,-519
59,2022/7/15 14:30,28,65,-37,-487
59,2022/7/15 14:40,25,85,-60,-483
59,2022/7/15 14:50,29,69,-40,-519
59,2022/7/15 15:00,29,62,-33,-585
59,2022/7/15 15:10,28,77,-49,-526
59,2022/7/15 15:20,28,67,-39,-570
59,2022/7/15 15:30,28,60,-32,-487
59,2022/7/15 15:40,30,74,-44,-563
59,2022/7/15 15:50,32,76,-44,-474
59,2022/7/15 16:00,32,68,-36,-476
59,2022/7/15 16:10,29,77,-48,-432
59,2022/7/15 16:20,26,87,-61,-499
59,2022/7/15 16:30,33,69,-36,-412
59,2022/7/15 16:40,41,91,-50,-388
59,2022/7/15 16:50,33,92,-59,-407
59,2022/7/15 17:00,39,93,-54,-54
59,2022/7/15 17:10,41,108,-67,511
59,2022/7/15 17:20,39,105,-66,-45
59,2022/7/15 17:30,38,125,-87,-45
59,2022/7/15 17:40,54,103,-49,402
59,2022/7/15 17:50,43,105,-62,-69
59,2022/7/15 18:00,70,110,-40,-280
59,2022/7/15 18:10,45,109,-64,537
59,2022/7/15 18:20,46,105,-59,-229
59,2022/7/15 18:30,32,107,-75,-1049
59,2022/7/15 18:40,26,109,-83,-1163
59,2022/7/15 18:50,29,104,-75,-1300
59,2022/7/15 19:00,26,125,-99,-1459
59,2022/7/15 19:10,22,110,-88,-1058
59,2022/7/15 19:20,23,100,-77,-1053
59,2022/7/15 19:30,19,101,-82,-908
59,2022/7/15 19:40,21,86,-65,-881
59,2022/7/15 19:50,19,80,-61,-748
59,2022/7/15 20:00,19,62,-43,-844
59,2022/7/15 20:10,23,71,-48,-666
59,2022/7/15 20:20,23,78,-55,-743
59,2022/7/15 20:30,19,64,-45,-661
59,2022/7/15 20:40,21,84,-63,-742
59,2022/7/15 20:50,22,66,-44,-747
59,2022/7/15 21:00,18,84,-66,-685
59,2022/7/15 21:10,18,68,-50,-613
59,2022/7/15 21:20,16,78,-62,-754
59,2022/7/15 21:30,17,62,-45,-732
59,2022/7/15 21:40,15,75,-60,-757
59,2022/7/15 21:50,12,69,-57,-842
59,2022/7/15 22:00,13,66,-53,-745
59,2022/7/15 22:10,12,73,-61,-857
59,2022/7/15 22:20,7,66,-59,-823
59,2022/7/15 22:30,3,62,-59,-855
59,2022/7/15 22:40,2,62,-60,-752
59,2022/7/15 22:50,1,39,-38,-562
52,2022/7/15 5:00,0,1,-1,-15
52,2022/7/15 5:10,0,1,-1,-9
52,2022/7/15 5:20,0,1,-1,35
52,2022/7/15 5:30,0,1,-1,77
52,2022/7/15 5:40,6,1,5,131
52,2022/7/15 5:50,20,1,19,208
52,2022/7/15 6:00,42,6,36,281
52,2022/7/15 6:10,54,29,25,232
52,2022/7/15 6:20,70,30,40,239
52,2022/7/15 6:30,109,37,72,258
52,2022/7/15 6:40,212,46,166,454
52,2022/7/15 6:50,247,71,176,584
52,2022/7/15 7:00,359,82,277,814
52,2022/7/15 7:10,596,75,521,1474
52,2022/7/15 7:20,721,76,645,2071
52,2022/7/15 7:30,737,75,662,2597
52,2022/7/15 7:40,1051,105,946,3838
52,2022/7/15 7:50,1233,90,1143,4592
52,2022/7/15 8:00,1055,113,942,4011
52,2022/7/15 8:10,836,121,715,2754
52,2022/7/15 8:20,722,104,618,1785
52,2022/7/15 8:30,665,123,542,-6
52,2022/7/15 8:40,597,109,488,-2166
52,2022/7/15 8:50,374,108,266,-1161
52,2022/7/15 9:00,324,91,233,-570
52,2022/7/15 9:10,269,100,169,-668
52,2022/7/15 9:20,230,79,151,-458
52,2022/7/15 9:30,149,84,65,-486
52,2022/7/15 9:40,91,82,9,-692
52,2022/7/15 9:50,62,75,-13,-658
52,2022/7/15 10:00,57,70,-13,-597
52,2022/7/15 10:10,49,73,-24,-540
52,2022/7/15 10:20,41,69,-28,-518
52,2022/7/15 10:30,37,78,-41,-546
52,2022/7/15 10:40,35,72,-37,-514
52,2022/7/15 10:50,36,73,-37,-522
52,2022/7/15 11:00,35,75,-40,-480
52,2022/7/15 11:10,39,82,-43,-435
52,2022/7/15 11:20,33,70,-37,-496
52,2022/7/15 11:30,31,68,-37,-445
52,2022/7/15 11:40,38,76,-38,-495
52,2022/7/15 11:50,35,74,-39,-495
52,2022/7/15 12:00,37,81,-44,-470
52,2022/7/15 12:10,42,80,-38,-443
52,2022/7/15 12:20,41,66,-25,-486
52,2022/7/15 12:30,37,75,-38,-511
52,2022/7/15 12:40,37,82,-45,-590
52,2022/7/15 12:50,37,72,-35,-557
52,2022/7/15 13:00,39,87,-48,-605
52,2022/7/15 13:10,35,92,-57,-560
52,2022/7/15 13:20,38,72,-34,-573
52,2022/7/15 13:30,31,81,-50,-506
52,2022/7/15 13:40,33,90,-57,-560
52,2022/7/15 13:50,30,71,-41,-558
52,2022/7/15 14:00,33,81,-48,-602
52,2022/7/15 14:10,32,90,-58,-565
52,2022/7/15 14:20,29,71,-42,-561
52,2022/7/15 14:30,33,93,-60,-547
52,2022/7/15 14:40,33,98,-65,-548
52,2022/7/15 14:50,25,77,-52,-571
52,2022/7/15 15:00,27,101,-74,-659
52,2022/7/15 15:10,33,103,-70,-596
52,2022/7/15 15:20,32,76,-44,-614
52,2022/7/15 15:30,35,110,-75,-562
52,2022/7/15 15:40,29,114,-85,-648
52,2022/7/15 15:50,30,93,-63,-537
52,2022/7/15 16:00,35,122,-87,-563
52,2022/7/15 16:10,32,125,-93,-525
52,2022/7/15 16:20,29,94,-65,-564
52,2022/7/15 16:30,40,110,-70,-482
52,2022/7/15 16:40,43,123,-80,-468
52,2022/7/15 16:50,35,120,-85,-492
52,2022/7/15 17:00,60,144,-84,-138
52,2022/7/15 17:10,93,143,-50,461
52,2022/7/15 17:20,52,296,-244,-289
52,2022/7/15 17:30,56,205,-149,-194
52,2022/7/15 17:40,65,431,-366,36
52,2022/7/15 17:50,47,332,-285,-354
52,2022/7/15 18:00,45,501,-456,-736
52,2022/7/15 18:10,57,345,-288,249
52,2022/7/15 18:20,51,430,-379,-608
52,2022/7/15 18:30,45,323,-278,-1327
52,2022/7/15 18:40,39,429,-390,-1553
52,2022/7/15 18:50,29,334,-305,-1605
52,2022/7/15 19:00,33,435,-402,-1861
52,2022/7/15 19:10,35,223,-188,-1246
52,2022/7/15 19:20,26,234,-208,-1261
52,2022/7/15 19:30,28,116,-88,-996
52,2022/7/15 19:40,29,158,-129,-1010
52,2022/7/15 19:50,25,113,-88,-836
52,2022/7/15 20:00,28,109,-81,-925
52,2022/7/15 20:10,26,107,-81,-747
52,2022/7/15 20:20,26,92,-66,-809
52,2022/7/15 20:30,24,110,-86,-747
52,2022/7/15 20:40,22,111,-89,-831
52,2022/7/15 20:50,20,100,-80,-827
52,2022/7/15 21:00,21,123,-102,-787
52,2022/7/15 21:10,24,114,-90,-703
52,2022/7/15 21:20,18,97,-79,-833
52,2022/7/15 21:30,18,133,-115,-847
52,2022/7/15 21:40,18,108,-90,-847
52,2022/7/15 21:50,18,127,-109,-951
52,2022/7/15 22:00,13,106,-93,-838
52,2022/7/15 22:10,14,93,-79,-936
52,2022/7/15 22:20,7,118,-111,-934
52,2022/7/15 22:30,4,105,-101,-956
52,2022/7/15 22:40,3,89,-86,-838
52,2022/7/15 22:50,1,57,-56,-618
39,2022/7/15 5:00,0,1,-1,-16
39,2022/7/15 5:10,0,1,-1,-10
39,2022/7/15 5:20,0,1,-1,34
39,2022/7/15 5:30,0,1,-1,76
39,2022/7/15 5:40,5,1,4,135
39,2022/7/15 5:50,31,1,30,238
39,2022/7/15 6:00,47,17,30,311
39,2022/7/15 6:10,44,41,3,235
39,2022/7/15 6:20,72,51,21,260
39,2022/7/15 6:30,149,55,94,352
39,2022/7/15 6:40,212,64,148,602
39,2022/7/15 6:50,245,74,171,755
39,2022/7/15 7:00,278,66,212,1026
39,2022/7/15 7:10,338,95,243,1717
39,2022/7/15 7:20,469,110,359,2430
39,2022/7/15 7:30,699,114,585,3182
39,2022/7/15 7:40,829,109,720,4558
39,2022/7/15 7:50,1062,121,941,5533
39,2022/7/15 8:00,1061,112,949,4960
39,2022/7/15 8:10,870,298,572,3326
39,2022/7/15 8:20,682,159,523,2308
39,2022/7/15 8:30,722,183,539,533
39,2022/7/15 8:40,595,192,403,-1763
39,2022/7/15 8:50,324,159,165,-996
39,2022/7/15 9:00,312,123,189,-381
39,2022/7/15 9:10,281,106,175,-493
39,2022/7/15 9:20,207,108,99,-359
39,2022/7/15 9:30,149,104,45,-441
39,2022/7/15 9:40,86,103,-17,-709
39,2022/7/15 9:50,70,101,-31,-689
39,2022/7/15 10:00,64,97,-33,-630
39,2022/7/15 10:10,52,69,-17,-557
39,2022/7/15 10:20,47,87,-40,-558
39,2022/7/15 10:30,45,77,-32,-578
39,2022/7/15 10:40,46,94,-48,-562
39,2022/7/15 10:50,42,92,-50,-572
39,2022/7/15 11:00,46,88,-42,-522
39,2022/7/15 11:10,41,65,-24,-459
39,2022/7/15 11:20,43,76,-33,-529
39,2022/7/15 11:30,40,91,-51,-496
39,2022/7/15 11:40,44,75,-31,-526
39,2022/7/15 11:50,38,104,-66,-561
39,2022/7/15 12:00,48,97,-49,-519
39,2022/7/15 12:10,45,75,-30,-473
39,2022/7/15 12:20,46,97,-51,-537
39,2022/7/15 12:30,44,92,-48,-559
39,2022/7/15 12:40,43,92,-49,-639
39,2022/7/15 12:50,44,93,-49,-606
39,2022/7/15 13:00,45,108,-63,-668
39,2022/7/15 13:10,48,76,-28,-588
39,2022/7/15 13:20,41,92,-51,-624
39,2022/7/15 13:30,45,96,-51,-557
39,2022/7/15 13:40,40,77,-37,-597
39,2022/7/15 13:50,40,93,-53,-611
39,2022/7/15 14:00,41,94,-53,-655
39,2022/7/15 14:10,45,80,-35,-600
39,2022/7/15 14:20,41,99,-58,-619
39,2022/7/15 14:30,36,101,-65,-612
39,2022/7/15 14:40,37,105,-68,-616
39,2022/7/15 14:50,39,83,-44,-615
39,2022/7/15 15:00,43,96,-53,-712
39,2022/7/15 15:10,39,93,-54,-650
39,2022/7/15 15:20,41,112,-71,-685
39,2022/7/15 15:30,44,106,-62,-624
39,2022/7/15 15:40,44,97,-53,-701
39,2022/7/15 15:50,44,107,-63,-600
39,2022/7/15 16:00,43,102,-59,-622
39,2022/7/15 16:10,50,105,-55,-580
39,2022/7/15 16:20,56,121,-65,-629
39,2022/7/15 16:30,71,125,-54,-536
39,2022/7/15 16:40,71,107,-36,-504
39,2022/7/15 16:50,77,111,-34,-526
39,2022/7/15 17:00,210,114,96,-42
39,2022/7/15 17:10,222,178,44,505
39,2022/7/15 17:20,164,118,46,-243
39,2022/7/15 17:30,191,218,-27,-221
39,2022/7/15 17:40,258,206,52,88
39,2022/7/15 17:50,224,344,-120,-474
39,2022/7/15 18:00,199,254,-55,-791
39,2022/7/15 18:10,187,432,-245,4
39,2022/7/15 18:20,132,298,-166,-774
39,2022/7/15 18:30,87,535,-448,-1775
39,2022/7/15 18:40,76,300,-224,-1777
39,2022/7/15 18:50,61,510,-449,-2054
39,2022/7/15 19:00,44,219,-175,-2036
39,2022/7/15 19:10,44,341,-297,-1543
39,2022/7/15 19:20,39,158,-119,-1380
39,2022/7/15 19:30,36,225,-189,-1185
39,2022/7/15 19:40,28,111,-83,-1093
39,2022/7/15 19:50,31,120,-89,-925
39,2022/7/15 20:00,31,116,-85,-1010
39,2022/7/15 20:10,35,104,-69,-816
39,2022/7/15 20:20,32,111,-79,-888
39,2022/7/15 20:30,29,107,-78,-825
39,2022/7/15 20:40,30,104,-74,-905
39,2022/7/15 20:50,24,133,-109,-936
39,2022/7/15 21:00,25,107,-82,-869
39,2022/7/15 21:10,27,116,-89,-792
39,2022/7/15 21:20,29,106,-77,-910
39,2022/7/15 21:30,27,112,-85,-932
39,2022/7/15 21:40,25,109,-84,-931
39,2022/7/15 21:50,20,111,-91,-1042
39,2022/7/15 22:00,20,111,-91,-929
39,2022/7/15 22:10,14,106,-92,-1028
39,2022/7/15 22:20,9,95,-86,-1020
39,2022/7/15 22:30,7,105,-98,-1054
39,2022/7/15 22:40,5,95,-90,-928
39,2022/7/15 22:50,5,63,-58,-676
47,2022/7/15 5:00,0,1,-1,-17
47,2022/7/15 5:10,0,1,-1,-11
47,2022/7/15 5:20,0,1,-1,33
47,2022/7/15 5:30,0,1,-1,75
47,2022/7/15 5:40,4,1,3,138
47,2022/7/15 5:50,17,1,16,254
47,2022/7/15 6:00,30,13,17,328
47,2022/7/15 6:10,34,21,13,248
47,2022/7/15 6:20,29,34,-5,255
47,2022/7/15 6:30,39,33,6,358
47,2022/7/15 6:40,57,65,-8,594
47,2022/7/15 6:50,59,78,-19,736
47,2022/7/15 7:00,84,115,-31,995
47,2022/7/15 7:10,162,104,58,1775
47,2022/7/15 7:20,246,185,61,2491
47,2022/7/15 7:30,268,208,60,3242
47,2022/7/15 7:40,302,153,149,4707
47,2022/7/15 7:50,347,234,113,5646
47,2022/7/15 8:00,318,298,20,4980
47,2022/7/15 8:10,281,332,-51,3275
47,2022/7/15 8:20,252,378,-126,2182
47,2022/7/15 8:30,204,380,-176,357
47,2022/7/15 8:40,193,437,-244,-2007
47,2022/7/15 8:50,152,332,-180,-1176
47,2022/7/15 9:00,92,208,-116,-497
47,2022/7/15 9:10,69,147,-78,-571
47,2022/7/15 9:20,49,110,-61,-420
47,2022/7/15 9:30,47,108,-61,-502
47,2022/7/15 9:40,45,123,-78,-787
47,2022/7/15 9:50,41,93,-52,-741
47,2022/7/15 10:00,36,76,-40,-670
47,2022/7/15 10:10,36,93,-57,-614
47,2022/7/15 10:20,26,92,-66,-624
47,2022/7/15 10:30,36,79,-43,-621
47,2022/7/15 10:40,28,85,-57,-619
47,2022/7/15 10:50,27,81,-54,-626
47,2022/7/15 11:00,30,60,-30,-552
47,2022/7/15 11:10,31,83,-52,-511
47,2022/7/15 11:20,32,79,-47,-576
47,2022/7/15 11:30,31,57,-26,-522
47,2022/7/15 11:40,37,92,-55,-581
47,2022/7/15 11:50,41,83,-42,-603
47,2022/7/15 12:00,36,78,-42,-561
47,2022/7/15 12:10,35,75,-40,-513
47,2022/7/15 12:20,45,72,-27,-564
47,2022/7/15 12:30,34,81,-47,-606
47,2022/7/15 12:40,39,93,-54,-693
47,2022/7/15 12:50,36,76,-40,-646
47,2022/7/15 13:00,35,86,-51,-719
47,2022/7/15 13:10,39,93,-54,-642
47,2022/7/15 13:20,38,73,-35,-659
47,2022/7/15 13:30,32,76,-44,-601
47,2022/7/15 13:40,33,80,-47,-644
47,2022/7/15 13:50,39,80,-41,-652
47,2022/7/15 14:00,36,76,-40,-695
47,2022/7/15 14:10,34,94,-60,-660
47,2022/7/15 14:20,32,81,-49,-668
47,2022/7/15 14:30,71,76,-5,-617
47,2022/7/15 14:40,143,90,53,-563
47,2022/7/15 14:50,57,73,-16,-631
47,2022/7/15 15:00,57,77,-20,-732
47,2022/7/15 15:10,41,92,-51,-701
47,2022/7/15 15:20,46,80,-34,-719
47,2022/7/15 15:30,43,84,-41,-665
47,2022/7/15 15:40,45,101,-56,-757
47,2022/7/15 15:50,44,75,-31,-631
47,2022/7/15 16:00,47,96,-49,-671
47,2022/7/15 16:10,54,99,-45,-625
47,2022/7/15 16:20,70,83,-13,-642
47,2022/7/15 16:30,136,92,44,-492
47,2022/7/15 16:40,113,112,1,-503
47,2022/7/15 16:50,92,87,5,-521
47,2022/7/15 17:00,268,105,163,121
47,2022/7/15 17:10,270,109,161,666
47,2022/7/15 17:20,195,124,71,-172
47,2022/7/15 17:30,273,106,167,-54
47,2022/7/15 17:40,553,116,437,525
47,2022/7/15 17:50,272,124,148,-326
47,2022/7/15 18:00,235,116,119,-672
47,2022/7/15 18:10,336,110,226,230
47,2022/7/15 18:20,218,179,39,-735
47,2022/7/15 18:30,135,109,26,-1749
47,2022/7/15 18:40,82,170,-88,-1865
47,2022/7/15 18:50,58,109,-51,-2105
47,2022/7/15 19:00,44,117,-73,-2109
47,2022/7/15 19:10,37,107,-70,-1613
47,2022/7/15 19:20,32,126,-94,-1474
47,2022/7/15 19:30,28,95,-67,-1252
47,2022/7/15 19:40,25,110,-85,-1178
47,2022/7/15 19:50,29,80,-51,-976
47,2022/7/15 20:00,28,73,-45,-1055
47,2022/7/15 20:10,27,83,-56,-872
47,2022/7/15 20:20,29,75,-46,-934
47,2022/7/15 20:30,26,70,-44,-869
47,2022/7/15 20:40,26,79,-53,-958
47,2022/7/15 20:50,21,70,-49,-985
47,2022/7/15 21:00,26,85,-59,-928
47,2022/7/15 21:10,22,70,-48,-840
47,2022/7/15 21:20,23,95,-72,-982
47,2022/7/15 21:30,16,65,-49,-981
47,2022/7/15 21:40,19,83,-64,-995
47,2022/7/15 21:50,15,70,-55,-1097
47,2022/7/15 22:00,13,57,-44,-973
47,2022/7/15 22:10,9,71,-62,-1090
47,2022/7/15 22:20,5,53,-48,-1068
47,2022/7/15 22:30,6,50,-44,-1098
47,2022/7/15 22:40,2,74,-72,-1000
47,2022/7/15 22:50,2,27,-25,-701
55,2022/7/15 5:00,0,1,-1,-18
55,2022/7/15 5:10,0,1,-1,-12
55,2022/7/15 5:20,0,1,-1,32
55,2022/7/15 5:30,0,1,-1,74
55,2022/7/15 5:40,3,1,2,140
55,2022/7/15 5:50,10,1,9,263
55,2022/7/15 6:00,9,5,4,332
55,2022/7/15 6:10,11,16,-5,243
55,2022/7/15 6:20,16,14,2,257
55,2022/7/15 6:30,18,23,-5,353
55,2022/7/15 6:40,17,23,-6,588
55,2022/7/15 6:50,20,23,-3,733
55,2022/7/15 7:00,21,32,-11,984
55,2022/7/15 7:10,22,38,-16,1759
55,2022/7/15 7:20,31,51,-20,2471
55,2022/7/15 7:30,37,69,-32,3210
55,2022/7/15 7:40,40,75,-35,4672
55,2022/7/15 7:50,34,87,-53,5593
55,2022/7/15 8:00,43,78,-35,4945
55,2022/7/15 8:10,40,99,-59,3216
55,2022/7/15 8:20,38,75,-37,2145
55,2022/7/15 8:30,35,76,-41,316
55,2022/7/15 8:40,30,79,-49,-2056
55,2022/7/15 8:50,24,70,-46,-1222
55,2022/7/15 9:00,20,49,-29,-526
55,2022/7/15 9:10,21,55,-34,-605
55,2022/7/15 9:20,19,46,-27,-447
55,2022/7/15 9:30,16,47,-31,-533
55,2022/7/15 9:40,16,40,-24,-811
55,2022/7/15 9:50,14,40,-26,-767
55,2022/7/15 10:00,16,38,-22,-692
55,2022/7/15 10:10,15,33,-18,-632
55,2022/7/15 10:20,16,30,-14,-638
55,2022/7/15 10:30,15,40,-25,-646
55,2022/7/15 10:40,13,31,-18,-637
55,2022/7/15 10:50,13,23,-10,-636
55,2022/7/15 11:00,14,38,-24,-576
55,2022/7/15 11:10,13,32,-19,-530
55,2022/7/15 11:20,13,23,-10,-586
55,2022/7/15 11:30,12,34,-22,-544
55,2022/7/15 11:40,15,31,-16,-597
55,2022/7/15 11:50,14,25,-11,-614
55,2022/7/15 12:00,13,25,-12,-573
55,2022/7/15 12:10,14,23,-9,-522
55,2022/7/15 12:20,13,32,-19,-583
55,2022/7/15 12:30,13,38,-25,-631
55,2022/7/15 12:40,13,23,-10,-703
55,2022/7/15 12:50,15,38,-23,-669
55,2022/7/15 13:00,13,40,-27,-746
55,2022/7/15 13:10,15,23,-8,-650
55,2022/7/15 13:20,12,38,-26,-685
55,2022/7/15 13:30,13,38,-25,-626
55,2022/7/15 13:40,15,23,-8,-652
55,2022/7/15 13:50,15,38,-23,-675
55,2022/7/15 14:00,14,37,-23,-718
55,2022/7/15 14:10,14,23,-9,-669
55,2022/7/15 14:20,14,38,-24,-692
55,2022/7/15 14:30,15,38,-23,-640
55,2022/7/15 14:40,14,23,-9,-572
55,2022/7/15 14:50,14,32,-18,-649
55,2022/7/15 15:00,20,33,-13,-745
55,2022/7/15 15:10,17,19,-2,-703
55,2022/7/15 15:20,19,38,-19,-738
55,2022/7/15 15:30,16,37,-21,-686
55,2022/7/15 15:40,15,19,-4,-761
55,2022/7/15 15:50,16,35,-19,-650
55,2022/7/15 16:00,19,37,-18,-689
55,2022/7/15 16:10,18,21,-3,-628
55,2022/7/15 16:20,18,35,-17,-659
55,2022/7/15 16:30,25,37,-12,-504
55,2022/7/15 16:40,25,23,2,-501
55,2022/7/15 16:50,20,38,-18,-539
55,2022/7/15 17:00,44,39,5,126
55,2022/7/15 17:10,33,37,-4,662
55,2022/7/15 17:20,26,38,-12,-184
55,2022/7/15 17:30,19,45,-26,-80
55,2022/7/15 17:40,28,38,-10,515
55,2022/7/15 17:50,29,51,-22,-348
55,2022/7/15 18:00,28,46,-18,-690
55,2022/7/15 18:10,24,62,-38,192
55,2022/7/15 18:20,18,52,-34,-769
55,2022/7/15 18:30,20,60,-40,-1789
55,2022/7/15 18:40,15,48,-33,-1898
55,2022/7/15 18:50,16,67,-51,-2156
55,2022/7/15 19:00,17,52,-35,-2144
55,2022/7/15 19:10,13,63,-50,-1663
55,2022/7/15 19:20,11,40,-29,-1503
55,2022/7/15 19:30,12,49,-37,-1289
55,2022/7/15 19:40,9,34,-25,-1203
55,2022/7/15 19:50,8,25,-17,-993
55,2022/7/15 20:00,11,40,-29,-1084
55,2022/7/15 20:10,7,40,-33,-905
55,2022/7/15 20:20,6,27,-21,-955
55,2022/7/15 20:30,7,38,-31,-900
55,2022/7/15 20:40,9,37,-28,-986
55,2022/7/15 20:50,6,27,-21,-1006
55,2022/7/15 21:00,8,34,-26,-954
55,2022/7/15 21:10,6,33,-27,-867
55,2022/7/15 21:20,4,35,-31,-1013
55,2022/7/15 21:30,4,43,-39,-1020
55,2022/7/15 21:40,2,32,-30,-1025
55,2022/7/15 21:50,4,44,-40,-1137
55,2022/7/15 22:00,5,25,-20,-993
55,2022/7/15 22:10,2,25,-23,-1113
55,2022/7/15 22:20,0,40,-40,-1108
55,2022/7/15 22:30,0,33,-33,-1131
55,2022/7/15 22:40,0,23,-23,-1023
55,2022/7/15 22:50,0,34,-34,-735
54,2022/7/15 5:00,0,1,-1,-19
54,2022/7/15 5:10,0,1,-1,-13
54,2022/7/15 5:20,0,1,-1,31
54,2022/7/15 5:30,1,1,0,74
54,2022/7/15 5:40,20,1,19,159
54,2022/7/15 5:50,60,5,55,318
54,2022/7/15 6:00,106,19,87,419
54,2022/7/15 6:10,148,8,140,383
54,2022/7/15 6:20,205,43,162,419
54,2022/7/15 6:30,258,34,224,577
54,2022/7/15 6:40,276,52,224,812
54,2022/7/15 6:50,348,65,283,1016
54,2022/7/15 7:00,571,96,475,1459
54,2022/7/15 7:10,588,109,479,2238
54,2022/7/15 7:20,687,109,578,3049
54,2022/7/15 7:30,862,111,751,3961
54,2022/7/15 7:40,1221,105,1116,5788
54,2022/7/15 7:50,1370,100,1270,6863
54,2022/7/15 8:00,1232,122,1110,6055
54,2022/7/15 8:10,1175,104,1071,4287
54,2022/7/15 8:20,830,110,720,2865
54,2022/7/15 8:30,731,106,625,941
54,2022/7/15 8:40,627,125,502,-1554
54,2022/7/15 8:50,365,109,256,-966
54,2022/7/15 9:00,311,93,218,-308
54,2022/7/15 9:10,247,78,169,-436
54,2022/7/15 9:20,191,90,101,-346
54,2022/7/15 9:30,144,83,61,-472
54,2022/7/15 9:40,71,76,-5,-816
54,2022/7/15 9:50,62,84,-22,-789
54,2022/7/15 10:00,55,69,-14,-706
54,2022/7/15 10:10,47,70,-23,-655
54,2022/7/15 10:20,43,76,-33,-671
54,2022/7/15 10:30,44,64,-20,-666
54,2022/7/15 10:40,39,92,-53,-690
54,2022/7/15 10:50,39,75,-36,-672
54,2022/7/15 11:00,37,60,-23,-599
54,2022/7/15 11:10,38,91,-53,-583
54,2022/7/15 11:20,38,81,-43,-629
54,2022/7/15 11:30,37,68,-31,-575
54,2022/7/15 11:40,45,79,-34,-631
54,2022/7/15 11:50,44,75,-31,-645
54,2022/7/15 12:00,51,80,-29,-602
54,2022/7/15 12:10,46,92,-46,-568
54,2022/7/15 12:20,48,74,-26,-609
54,2022/7/15 12:30,45,82,-37,-668
54,2022/7/15 12:40,45,87,-42,-745
54,2022/7/15 12:50,45,75,-30,-699
54,2022/7/15 13:00,45,76,-31,-777
54,2022/7/15 13:10,45,80,-35,-685
54,2022/7/15 13:20,35,73,-38,-723
54,2022/7/15 13:30,36,78,-42,-668
54,2022/7/15 13:40,37,97,-60,-712
54,2022/7/15 13:50,36,76,-40,-715
54,2022/7/15 14:00,34,76,-42,-760
54,2022/7/15 14:10,37,91,-54,-723
54,2022/7/15 14:20,36,87,-51,-743
54,2022/7/15 14:30,33,77,-44,-684
54,2022/7/15 14:40,31,103,-72,-644
54,2022/7/15 14:50,29,101,-72,-721
54,2022/7/15 15:00,31,83,-52,-797
54,2022/7/15 15:10,34,101,-67,-770
54,2022/7/15 15:20,30,105,-75,-813
54,2022/7/15 15:30,33,108,-75,-761
54,2022/7/15 15:40,31,126,-95,-856
54,2022/7/15 15:50,28,120,-92,-742
54,2022/7/15 16:00,38,103,-65,-754
54,2022/7/15 16:10,37,109,-72,-700
54,2022/7/15 16:20,36,108,-72,-731
54,2022/7/15 16:30,47,122,-75,-579
54,2022/7/15 16:40,50,128,-78,-579
54,2022/7/15 16:50,42,117,-75,-614
54,2022/7/15 17:00,56,115,-59,67
54,2022/7/15 17:10,73,222,-149,513
54,2022/7/15 17:20,65,214,-149,-333
54,2022/7/15 17:30,55,282,-227,-307
54,2022/7/15 17:40,68,317,-249,266
54,2022/7/15 17:50,62,431,-369,-717
54,2022/7/15 18:00,74,320,-246,-936
54,2022/7/15 18:10,63,431,-368,-176
54,2022/7/15 18:20,43,503,-460,-1229
54,2022/7/15 18:30,35,417,-382,-2171
54,2022/7/15 18:40,30,537,-507,-2405
54,2022/7/15 18:50,32,433,-401,-2557
54,2022/7/15 19:00,31,434,-403,-2547
54,2022/7/15 19:10,27,533,-506,-2169
54,2022/7/15 19:20,29,283,-254,-1757
54,2022/7/15 19:30,27,255,-228,-1517
54,2022/7/15 19:40,27,176,-149,-1352
54,2022/7/15 19:50,24,190,-166,-1159
54,2022/7/15 20:00,24,104,-80,-1164
54,2022/7/15 20:10,28,115,-87,-992
54,2022/7/15 20:20,27,128,-101,-1056
54,2022/7/15 20:30,23,105,-82,-982
54,2022/7/15 20:40,26,128,-102,-1088
54,2022/7/15 20:50,24,119,-95,-1101
54,2022/7/15 21:00,23,110,-87,-1041
54,2022/7/15 21:10,22,119,-97,-964
54,2022/7/15 21:20,23,109,-86,-1099
54,2022/7/15 21:30,20,102,-82,-1102
54,2022/7/15 21:40,20,153,-133,-1158
54,2022/7/15 21:50,16,109,-93,-1230
54,2022/7/15 22:00,13,117,-104,-1097
54,2022/7/15 22:10,6,107,-101,-1214
54,2022/7/15 22:20,4,100,-96,-1204
54,2022/7/15 22:30,3,111,-108,-1239
54,2022/7/15 22:40,2,124,-122,-1145
54,2022/7/15 22:50,1,109,-108,-843
45,2022/7/15 5:00,1,1,0,-19
45,2022/7/15 5:10,0,1,-1,-14
45,2022/7/15 5:20,0,1,-1,30
45,2022/7/15 5:30,10,1,9,83
45,2022/7/15 5:40,34,1,33,192
45,2022/7/15 5:50,60,8,52,370
45,2022/7/15 6:00,67,19,48,467
45,2022/7/15 6:10,145,23,122,505
45,2022/7/15 6:20,188,68,120,539
45,2022/7/15 6:30,237,80,157,734
45,2022/7/15 6:40,347,71,276,1088
45,2022/7/15 6:50,386,86,300,1316
45,2022/7/15 7:00,652,105,547,2006
45,2022/7/15 7:10,854,127,727,2965
45,2022/7/15 7:20,1162,133,1029,4078
45,2022/7/15 7:30,1215,159,1056,5017
45,2022/7/15 7:40,1604,269,1335,7123
45,2022/7/15 7:50,1395,227,1168,8031
45,2022/7/15 8:00,1585,298,1287,7342
45,2022/7/15 8:10,1222,231,991,5278
45,2022/7/15 8:20,1061,326,735,3600
45,2022/7/15 8:30,847,332,515,1456
45,2022/7/15 8:40,683,326,357,-1197
45,2022/7/15 8:50,574,144,430,-536
45,2022/7/15 9:00,342,159,183,-125
45,2022/7/15 9:10,311,185,126,-310
45,2022/7/15 9:20,229,119,110,-236
45,2022/7/15 9:30,178,121,57,-415
45,2022/7/15 9:40,175,104,71,-745
45,2022/7/15 9:50,108,144,-36,-825
45,2022/7/15 10:00,82,110,-28,-734
45,2022/7/15 10:10,84,108,-24,-679
45,2022/7/15 10:20,72,118,-46,-717
45,2022/7/15 10:30,71,120,-49,-715
45,2022/7/15 10:40,69,126,-57,-747
45,2022/7/15 10:50,56,86,-30,-702
45,2022/7/15 11:00,64,106,-42,-641
45,2022/7/15 11:10,67,108,-41,-624
45,2022/7/15 11:20,57,123,-66,-695
45,2022/7/15 11:30,68,120,-52,-627
45,2022/7/15 11:40,72,103,-31,-662
45,2022/7/15 11:50,76,100,-24,-669
45,2022/7/15 12:00,74,106,-32,-634
45,2022/7/15 12:10,133,114,19,-549
45,2022/7/15 12:20,82,104,-22,-631
45,2022/7/15 12:30,130,99,31,-637
45,2022/7/15 12:40,95,107,-12,-757
45,2022/7/15 12:50,101,111,-10,-709
45,2022/7/15 13:00,73,107,-34,-811
45,2022/7/15 13:10,113,117,-4,-689
45,2022/7/15 13:20,89,110,-21,-744
45,2022/7/15 13:30,97,105,-8,-676
45,2022/7/15 13:40,80,116,-36,-748
45,2022/7/15 13:50,72,106,-34,-749
45,2022/7/15 14:00,73,105,-32,-792
45,2022/7/15 14:10,76,127,-51,-774
45,2022/7/15 14:20,75,124,-49,-792
45,2022/7/15 14:30,76,104,-28,-712
45,2022/7/15 14:40,67,116,-49,-693
45,2022/7/15 14:50,72,109,-37,-758
45,2022/7/15 15:00,73,122,-49,-846
45,2022/7/15 15:10,92,123,-31,-801
45,2022/7/15 15:20,82,127,-45,-858
45,2022/7/15 15:30,126,115,11,-750
45,2022/7/15 15:40,100,119,-19,-875
45,2022/7/15 15:50,96,119,-23,-765
45,2022/7/15 16:00,91,106,-15,-769
45,2022/7/15 16:10,137,139,-2,-702
45,2022/7/15 16:20,96,198,-102,-833
45,2022/7/15 16:30,168,105,63,-516
45,2022/7/15 16:40,209,213,-4,-583
45,2022/7/15 16:50,181,234,-53,-667
45,2022/7/15 17:00,212,179,33,100
45,2022/7/15 17:10,270,230,40,553
45,2022/7/15 17:20,265,343,-78,-411
45,2022/7/15 17:30,268,325,-57,-364
45,2022/7/15 17:40,312,321,-9,257
45,2022/7/15 17:50,343,426,-83,-800
45,2022/7/15 18:00,265,534,-269,-1205
45,2022/7/15 18:10,246,490,-244,-420
45,2022/7/15 18:20,225,419,-194,-1423
45,2022/7/15 18:30,136,578,-442,-2613
45,2022/7/15 18:40,130,430,-300,-2705
45,2022/7/15 18:50,61,580,-519,-3076
45,2022/7/15 19:00,74,438,-364,-2911
45,2022/7/15 19:10,60,431,-371,-2540
45,2022/7/15 19:20,60,377,-317,-2074
45,2022/7/15 19:30,40,535,-495,-2012
45,2022/7/15 19:40,48,196,-148,-1500
45,2022/7/15 19:50,44,256,-212,-1371
45,2022/7/15 20:00,46,191,-145,-1309
45,2022/7/15 20:10,47,115,-68,-1060
45,2022/7/15 20:20,56,180,-124,-1180
45,2022/7/15 20:30,46,137,-91,-1073
45,2022/7/15 20:40,44,121,-77,-1165
45,2022/7/15 20:50,44,181,-137,-1238
45,2022/7/15 21:00,41,104,-63,-1104
45,2022/7/15 21:10,36,143,-107,-1071
45,2022/7/15 21:20,35,121,-86,-1185
45,2022/7/15 21:30,35,192,-157,-1259
45,2022/7/15 21:40,31,114,-83,-1241
45,2022/7/15 21:50,25,108,-83,-1313
45,2022/7/15 22:00,25,116,-91,-1188
45,2022/7/15 22:10,11,105,-94,-1308
45,2022/7/15 22:20,10,108,-98,-1302
45,2022/7/15 22:30,6,94,-88,-1327
45,2022/7/15 22:40,4,92,-88,-1233
45,2022/7/15 22:50,4,101,-97,-940
44,2022/7/15 5:00,0,1,-1,-20
44,2022/7/15 5:10,0,1,-1,-15
44,2022/7/15 5:20,0,1,-1,29
44,2022/7/15 5:30,14,1,13,96
44,2022/7/15 5:40,25,1,24,216
44,2022/7/15 5:50,24,5,19,389
44,2022/7/15 6:00,30,5,25,492
44,2022/7/15 6:10,26,6,20,525
44,2022/7/15 6:20,45,8,37,576
44,2022/7/15 6:30,55,69,-14,720
44,2022/7/15 6:40,57,60,-3,1085
44,2022/7/15 6:50,74,76,-2,1314
44,2022/7/15 7:00,188,73,115,2121
44,2022/7/15 7:10,123,98,25,2990
44,2022/7/15 7:20,244,99,145,4223
44,2022/7/15 7:30,244,92,152,5169
44,2022/7/15 7:40,280,92,188,7311
44,2022/7/15 7:50,279,107,172,8203
44,2022/7/15 8:00,234,104,130,7472
44,2022/7/15 8:10,215,105,110,5388
44,2022/7/15 8:20,167,95,72,3672
44,2022/7/15 8:30,182,105,77,1533
44,2022/7/15 8:40,89,77,12,-1185
44,2022/7/15 8:50,53,81,-28,-564
44,2022/7/15 9:00,48,79,-31,-156
44,2022/7/15 9:10,45,76,-31,-341
44,2022/7/15 9:20,32,69,-37,-273
44,2022/7/15 9:30,24,70,-46,-461
44,2022/7/15 9:40,27,74,-47,-792
44,2022/7/15 9:50,27,69,-42,-867
44,2022/7/15 10:00,27,66,-39,-773
44,2022/7/15 10:10,27,67,-40,-719
44,2022/7/15 10:20,25,62,-37,-754
44,2022/7/15 10:30,27,66,-39,-754
44,2022/7/15 10:40,29,46,-17,-764
44,2022/7/15 10:50,26,74,-48,-750
44,2022/7/15 11:00,25,68,-43,-684
44,2022/7/15 11:10,28,48,-20,-644
44,2022/7/15 11:20,27,67,-40,-735
44,2022/7/15 11:30,26,65,-39,-666
44,2022/7/15 11:40,28,50,-22,-684
44,2022/7/15 11:50,26,66,-40,-709
44,2022/7/15 12:00,25,68,-43,-677
44,2022/7/15 12:10,27,52,-25,-574
44,2022/7/15 12:20,28,71,-43,-674
44,2022/7/15 12:30,28,67,-39,-676
44,2022/7/15 12:40,27,61,-34,-791
44,2022/7/15 12:50,22,79,-57,-766
44,2022/7/15 13:00,29,65,-36,-847
44,2022/7/15 13:10,24,65,-41,-730
44,2022/7/15 13:20,26,65,-39,-783
44,2022/7/15 13:30,26,63,-37,-713
44,2022/7/15 13:40,26,54,-28,-776
44,2022/7/15 13:50,23,68,-45,-794
44,2022/7/15 14:00,28,68,-40,-832
44,2022/7/15 14:10,28,56,-28,-802
44,2022/7/15 14:20,28,64,-36,-828
44,2022/7/15 14:30,25,65,-40,-752
44,2022/7/15 14:40,26,51,-25,-718
44,2022/7/15 14:50,27,67,-40,-798
44,2022/7/15 15:00,24,74,-50,-896
44,2022/7/15 15:10,29,61,-32,-833
44,2022/7/15 15:20,31,82,-51,-909
44,2022/7/15 15:30,26,78,-52,-802
44,2022/7/15 15:40,29,69,-40,-915
44,2022/7/15 15:50,26,76,-50,-815
44,2022/7/15 16:00,35,84,-49,-818
44,2022/7/15 16:10,24,70,-46,-748
44,2022/7/15 16:20,27,93,-66,-899
44,2022/7/15 16:30,31,77,-46,-562
44,2022/7/15 16:40,39,76,-37,-620
44,2022/7/15 16:50,53,103,-50,-717
44,2022/7/15 17:00,30,99,-69,31
44,2022/7/15 17:10,47,93,-46,507
44,2022/7/15 17:20,28,105,-77,-488
44,2022/7/15 17:30,39,107,-68,-432
44,2022/7/15 17:40,42,102,-60,197
44,2022/7/15 17:50,42,110,-68,-868
44,2022/7/15 18:00,37,128,-91,-1296
44,2022/7/15 18:10,34,119,-85,-505
44,2022/7/15 18:20,29,110,-81,-1504
44,2022/7/15 18:30,28,111,-83,-2696
44,2022/7/15 18:40,24,110,-86,-2791
44,2022/7/15 18:50,25,139,-114,-3190
44,2022/7/15 19:00,24,109,-85,-2996
44,2022/7/15 19:10,24,116,-92,-2632
44,2022/7/15 19:20,18,123,-105,-2179
44,2022/7/15 19:30,17,120,-103,-2115
44,2022/7/15 19:40,15,107,-92,-1592
44,2022/7/15 19:50,24,106,-82,-1453
44,2022/7/15 20:00,13,78,-65,-1374
44,2022/7/15 20:10,14,95,-81,-1141
44,2022/7/15 20:20,16,79,-63,-1243
44,2022/7/15 20:30,13,92,-79,-1152
44,2022/7/15 20:40,16,70,-54,-1219
44,2022/7/15 20:50,9,77,-68,-1306
44,2022/7/15 21:00,16,79,-63,-1167
44,2022/7/15 21:10,10,71,-61,-1132
44,2022/7/15 21:20,7,95,-88,-1273
44,2022/7/15 21:30,9,73,-64,-1323
44,2022/7/15 21:40,8,72,-64,-1305
44,2022/7/15 21:50,5,83,-78,-1391
44,2022/7/15 22:00,1,63,-62,-1250
44,2022/7/15 22:10,1,77,-76,-1384
44,2022/7/15 22:20,1,61,-60,-1362
44,2022/7/15 22:30,1,50,-49,-1376
44,2022/7/15 22:40,0,70,-70,-1303
44,2022/7/15 22:50,0,41,-41,-981
37,2022/7/15 5:00,0,1,-1,-21
37,2022/7/15 5:10,0,1,-1,-16
37,2022/7/15 5:20,5,1,4,33
37,2022/7/15 5:30,14,1,13,109
37,2022/7/15 5:40,23,1,22,238
37,2022/7/15 5:50,25,6,19,408
37,2022/7/15 6:00,32,6,26,518
37,2022/7/15 6:10,46,14,32,557
37,2022/7/15 6:20,58,16,42,618
37,2022/7/15 6:30,63,43,20,740
37,2022/7/15 6:40,68,61,7,1092
37,2022/7/15 6:50,124,67,57,1371
37,2022/7/15 7:00,245,91,154,2275
37,2022/7/15 7:10,281,102,179,3169
37,2022/7/15 7:20,349,102,247,4470
37,2022/7/15 7:30,339,109,230,5399
37,2022/7/15 7:40,474,109,365,7676
37,2022/7/15 7:50,572,192,380,8583
37,2022/7/15 8:00,322,110,212,7684
37,2022/7/15 8:10,323,192,131,5519
37,2022/7/15 8:20,277,120,157,3829
37,2022/7/15 8:30,250,119,131,1664
37,2022/7/15 8:40,157,115,42,-1143
37,2022/7/15 8:50,156,109,47,-517
37,2022/7/15 9:00,72,93,-21,-177
37,2022/7/15 9:10,47,93,-46,-387
37,2022/7/15 9:20,51,97,-46,-319
37,2022/7/15 9:30,38,79,-41,-502
37,2022/7/15 9:40,42,74,-32,-824
37,2022/7/15 9:50,27,75,-48,-915
37,2022/7/15 10:00,38,62,-24,-797
37,2022/7/15 10:10,31,69,-38,-757
37,2022/7/15 10:20,27,86,-59,-813
37,2022/7/15 10:30,34,59,-25,-779
37,2022/7/15 10:40,35,73,-38,-802
37,2022/7/15 10:50,30,73,-43,-793
37,2022/7/15 11:00,35,61,-26,-710
37,2022/7/15 11:10,30,70,-40,-684
37,2022/7/15 11:20,30,67,-37,-772
37,2022/7/15 11:30,30,61,-31,-697
37,2022/7/15 11:40,33,72,-39,-723
37,2022/7/15 11:50,36,61,-25,-734
37,2022/7/15 12:00,31,59,-28,-705
37,2022/7/15 12:10,29,68,-39,-613
37,2022/7/15 12:20,35,61,-26,-700
37,2022/7/15 12:30,34,74,-40,-716
37,2022/7/15 12:40,32,82,-50,-841
37,2022/7/15 12:50,33,68,-35,-801
37,2022/7/15 13:00,33,69,-36,-883
37,2022/7/15 13:10,31,79,-48,-778
37,2022/7/15 13:20,31,70,-39,-822
37,2022/7/15 13:30,28,74,-46,-759
37,2022/7/15 13:40,28,77,-49,-825
37,2022/7/15 13:50,31,69,-38,-832
37,2022/7/15 14:00,26,75,-49,-881
37,2022/7/15 14:10,33,83,-50,-852
37,2022/7/15 14:20,36,63,-27,-855
37,2022/7/15 14:30,31,83,-52,-804
37,2022/7/15 14:40,27,68,-41,-759
37,2022/7/15 14:50,28,61,-33,-831
37,2022/7/15 15:00,29,76,-47,-943
37,2022/7/15 15:10,23,73,-50,-883
37,2022/7/15 15:20,25,72,-47,-956
37,2022/7/15 15:30,29,75,-46,-848
37,2022/7/15 15:40,27,76,-49,-964
37,2022/7/15 15:50,30,63,-33,-848
37,2022/7/15 16:00,24,79,-55,-873
37,2022/7/15 16:10,41,91,-50,-798
37,2022/7/15 16:20,34,82,-48,-947
37,2022/7/15 16:30,42,98,-56,-618
37,2022/7/15 16:40,75,98,-23,-643
37,2022/7/15 16:50,67,93,-26,-743
37,2022/7/15 17:00,75,109,-34,-3
37,2022/7/15 17:10,174,106,68,575
37,2022/7/15 17:20,217,106,111,-377
37,2022/7/15 17:30,134,110,24,-408
37,2022/7/15 17:40,69,118,-49,148
37,2022/7/15 17:50,136,115,21,-847
37,2022/7/15 18:00,65,107,-42,-1338
37,2022/7/15 18:10,42,158,-116,-621
37,2022/7/15 18:20,42,128,-86,-1590
37,2022/7/15 18:30,38,226,-188,-2884
37,2022/7/15 18:40,28,181,-153,-2944
37,2022/7/15 18:50,32,234,-202,-3392
37,2022/7/15 19:00,25,143,-118,-3114
37,2022/7/15 19:10,27,198,-171,-2803
37,2022/7/15 19:20,25,134,-109,-2288
37,2022/7/15 19:30,24,152,-128,-2243
37,2022/7/15 19:40,25,103,-78,-1670
37,2022/7/15 19:50,23,110,-87,-1540
37,2022/7/15 20:00,27,114,-87,-1461
37,2022/7/15 20:10,20,109,-89,-1230
37,2022/7/15 20:20,17,106,-89,-1332
37,2022/7/15 20:30,19,77,-58,-1210
37,2022/7/15 20:40,17,114,-97,-1316
37,2022/7/15 20:50,16,105,-89,-1395
37,2022/7/15 21:00,17,94,-77,-1244
37,2022/7/15 21:10,17,107,-90,-1222
37,2022/7/15 21:20,14,84,-70,-1343
37,2022/7/15 21:30,12,110,-98,-1421
37,2022/7/15 21:40,9,79,-70,-1375
37,2022/7/15 21:50,9,75,-66,-1457
37,2022/7/15 22:00,3,99,-96,-1346
37,2022/7/15 22:10,2,73,-71,-1455
37,2022/7/15 22:20,2,70,-68,-1430
37,2022/7/15 22:30,2,83,-81,-1457
37,2022/7/15 22:40,2,63,-61,-1364
37,2022/7/15 22:50,1,65,-64,-1045
29,2022/7/15 5:00,0,1,-1,-22
29,2022/7/15 5:10,0,1,-1,-17
29,2022/7/15 5:20,6,1,5,38
29,2022/7/15 5:30,18,1,17,126
29,2022/7/15 5:40,14,1,13,251
29,2022/7/15 5:50,17,1,16,424
29,2022/7/15 6:00,26,1,25,543
29,2022/7/15 6:10,28,1,27,584
29,2022/7/15 6:20,40,5,35,653
29,2022/7/15 6:30,46,23,23,763
29,2022/7/15 6:40,70,23,47,1139
29,2022/7/15 6:50,84,41,43,1414
29,2022/7/15 7:00,169,55,114,2389
29,2022/7/15 7:10,232,38,194,3363
29,2022/7/15 7:20,283,105,178,4648
29,2022/7/15 7:30,279,64,215,5614
29,2022/7/15 7:40,279,80,199,7875
29,2022/7/15 7:50,267,70,197,8780
29,2022/7/15 8:00,237,107,130,7814
29,2022/7/15 8:10,189,93,96,5615
29,2022/7/15 8:20,156,75,81,3910
29,2022/7/15 8:30,150,75,75,1739
29,2022/7/15 8:40,61,100,-39,-1182
29,2022/7/15 8:50,56,68,-12,-529
29,2022/7/15 9:00,41,57,-16,-193
29,2022/7/15 9:10,28,66,-38,-425
29,2022/7/15 9:20,30,71,-41,-360
29,2022/7/15 9:30,29,65,-36,-538
29,2022/7/15 9:40,29,66,-37,-861
29,2022/7/15 9:50,28,47,-19,-934
29,2022/7/15 10:00,27,63,-36,-833
29,2022/7/15 10:10,23,61,-38,-795
29,2022/7/15 10:20,26,51,-25,-838
29,2022/7/15 10:30,25,32,-7,-786
29,2022/7/15 10:40,25,55,-30,-832
29,2022/7/15 10:50,27,64,-37,-830
29,2022/7/15 11:00,24,49,-25,-735
29,2022/7/15 11:10,25,11,14,-670
29,2022/7/15 11:20,27,50,-23,-795
29,2022/7/15 11:30,28,49,-21,-718
29,2022/7/15 11:40,28,51,-23,-746
29,2022/7/15 11:50,29,55,-26,-760
29,2022/7/15 12:00,26,54,-28,-733
29,2022/7/15 12:10,23,7,16,-597
29,2022/7/15 12:20,25,67,-42,-742
29,2022/7/15 12:30,24,58,-34,-750
29,2022/7/15 12:40,28,62,-34,-875
29,2022/7/15 12:50,23,60,-37,-838
29,2022/7/15 13:00,23,20,3,-880
29,2022/7/15 13:10,25,52,-27,-805
29,2022/7/15 13:20,22,63,-41,-863
29,2022/7/15 13:30,23,70,-47,-806
29,2022/7/15 13:40,20,66,-46,-871
29,2022/7/15 13:50,25,62,-37,-869
29,2022/7/15 14:00,22,30,-8,-889
29,2022/7/15 14:10,26,48,-22,-874
29,2022/7/15 14:20,25,61,-36,-891
29,2022/7/15 14:30,26,61,-35,-839
29,2022/7/15 14:40,23,62,-39,-798
29,2022/7/15 14:50,26,65,-39,-870
29,2022/7/15 15:00,24,27,-3,-946
29,2022/7/15 15:10,24,49,-25,-908
29,2022/7/15 15:20,27,67,-40,-996
29,2022/7/15 15:30,25,66,-41,-889
29,2022/7/15 15:40,24,67,-43,-1007
29,2022/7/15 15:50,28,70,-42,-890
29,2022/7/15 16:00,22,36,-14,-887
29,2022/7/15 16:10,24,48,-24,-822
29,2022/7/15 16:20,27,60,-33,-980
29,2022/7/15 16:30,28,67,-39,-657
29,2022/7/15 16:40,27,77,-50,-693
29,2022/7/15 16:50,31,77,-46,-789
29,2022/7/15 17:00,26,43,-17,-20
29,2022/7/15 17:10,37,76,-39,536
29,2022/7/15 17:20,32,105,-73,-450
29,2022/7/15 17:30,29,111,-82,-490
29,2022/7/15 17:40,34,122,-88,60
29,2022/7/15 17:50,28,100,-72,-919
29,2022/7/15 18:00,28,110,-82,-1420
29,2022/7/15 18:10,28,106,-78,-699
29,2022/7/15 18:20,26,122,-96,-1686
29,2022/7/15 18:30,27,128,-101,-2985
29,2022/7/15 18:40,20,125,-105,-3049
29,2022/7/15 18:50,20,98,-78,-3470
29,2022/7/15 19:00,17,121,-104,-3218
29,2022/7/15 19:10,16,110,-94,-2897
29,2022/7/15 19:20,13,107,-94,-2382
29,2022/7/15 19:30,14,112,-98,-2341
29,2022/7/15 19:40,17,106,-89,-1759
29,2022/7/15 19:50,15,101,-86,-1626
29,2022/7/15 20:00,14,79,-65,-1526
29,2022/7/15 20:10,14,85,-71,-1301
29,2022/7/15 20:20,12,84,-72,-1404
29,2022/7/15 20:30,12,94,-82,-1292
29,2022/7/15 20:40,12,35,-23,-1339
29,2022/7/15 20:50,10,79,-69,-1464
29,2022/7/15 21:00,11,77,-66,-1310
29,2022/7/15 21:10,11,86,-75,-1297
29,2022/7/15 21:20,8,75,-67,-1410
29,2022/7/15 21:30,7,10,-3,-1424
29,2022/7/15 21:40,8,76,-68,-1443
29,2022/7/15 21:50,2,78,-76,-1533
29,2022/7/15 22:00,0,14,-14,-1360
29,2022/7/15 22:10,0,69,-69,-1524
29,2022/7/15 22:20,0,77,-77,-1507
29,2022/7/15 22:30,0,23,-23,-1480
29,2022/7/15 22:40,0,56,-56,-1420
29,2022/7/15 22:50,0,62,-62,-1107
36,2022/7/15 5:00,0,1,-1,-23
36,2022/7/15 5:10,1,1,0,-17
36,2022/7/15 5:20,11,1,10,48
36,2022/7/15 5:30,25,1,24,150
36,2022/7/15 5:40,28,1,27,278
36,2022/7/15 5:50,30,1,29,453
36,2022/7/15 6:00,36,1,35,578
36,2022/7/15 6:10,49,1,48,632
36,2022/7/15 6:20,58,1,57,710
36,2022/7/15 6:30,73,1,72,835
36,2022/7/15 6:40,67,73,-6,1133
36,2022/7/15 6:50,87,21,66,1480
36,2022/7/15 7:00,206,63,143,2532
36,2022/7/15 7:10,217,110,107,3470
36,2022/7/15 7:20,282,102,180,4828
36,2022/7/15 7:30,254,104,150,5764
36,2022/7/15 7:40,316,109,207,8082
36,2022/7/15 7:50,227,119,108,8888
36,2022/7/15 8:00,229,112,117,7931
36,2022/7/15 8:10,198,111,87,5702
36,2022/7/15 8:20,186,171,15,3925
36,2022/7/15 8:30,85,120,-35,1704
36,2022/7/15 8:40,71,104,-33,-1215
36,2022/7/15 8:50,55,90,-35,-564
36,2022/7/15 9:00,44,123,-79,-272
36,2022/7/15 9:10,34,104,-70,-495
36,2022/7/15 9:20,28,82,-54,-414
36,2022/7/15 9:30,26,90,-64,-602
36,2022/7/15 9:40,27,108,-81,-942
36,2022/7/15 9:50,31,84,-53,-987
36,2022/7/15 10:00,27,72,-45,-878
36,2022/7/15 10:10,25,57,-32,-827
36,2022/7/15 10:20,28,67,-39,-877
36,2022/7/15 10:30,25,84,-59,-845
36,2022/7/15 10:40,26,73,-47,-879
36,2022/7/15 10:50,23,12,11,-819
36,2022/7/15 11:00,28,83,-55,-790
36,2022/7/15 11:10,25,62,-37,-707
36,2022/7/15 11:20,25,74,-49,-844
36,2022/7/15 11:30,25,65,-40,-758
36,2022/7/15 11:40,28,69,-41,-787
36,2022/7/15 11:50,25,16,9,-751
36,2022/7/15 12:00,27,70,-43,-776
36,2022/7/15 12:10,34,71,-37,-634
36,2022/7/15 12:20,28,77,-49,-791
36,2022/7/15 12:30,24,64,-40,-790
36,2022/7/15 12:40,29,21,8,-867
36,2022/7/15 12:50,38,61,-23,-861
36,2022/7/15 13:00,33,85,-52,-932
36,2022/7/15 13:10,30,69,-39,-844
36,2022/7/15 13:20,25,85,-60,-923
36,2022/7/15 13:30,26,71,-45,-851
36,2022/7/15 13:40,22,23,-1,-872
36,2022/7/15 13:50,25,66,-41,-910
36,2022/7/15 14:00,25,83,-58,-947
36,2022/7/15 14:10,24,63,-39,-913
36,2022/7/15 14:20,23,63,-40,-931
36,2022/7/15 14:30,24,65,-41,-880
36,2022/7/15 14:40,30,19,11,-787
36,2022/7/15 14:50,21,71,-50,-920
36,2022/7/15 15:00,26,72,-46,-992
36,2022/7/15 15:10,29,76,-47,-955
36,2022/7/15 15:20,31,83,-52,-1048
36,2022/7/15 15:30,28,77,-49,-938
36,2022/7/15 15:40,30,19,11,-996
36,2022/7/15 15:50,28,82,-54,-944
36,2022/7/15 16:00,29,76,-47,-934
36,2022/7/15 16:10,26,94,-68,-890
36,2022/7/15 16:20,37,98,-61,-1041
36,2022/7/15 16:30,30,80,-50,-707
36,2022/7/15 16:40,41,28,13,-680
36,2022/7/15 16:50,46,89,-43,-832
36,2022/7/15 17:00,42,102,-60,-80
36,2022/7/15 17:10,44,106,-62,474
36,2022/7/15 17:20,48,109,-61,-511
36,2022/7/15 17:30,73,122,-49,-539
36,2022/7/15 17:40,47,125,-78,-18
36,2022/7/15 17:50,41,105,-64,-983
36,2022/7/15 18:00,45,169,-124,-1544
36,2022/7/15 18:10,35,107,-72,-771
36,2022/7/15 18:20,45,107,-62,-1748
36,2022/7/15 18:30,41,123,-82,-3067
36,2022/7/15 18:40,42,200,-158,-3207
36,2022/7/15 18:50,36,180,-144,-3614
36,2022/7/15 19:00,25,119,-94,-3312
36,2022/7/15 19:10,25,124,-99,-2996
36,2022/7/15 19:20,24,233,-209,-2591
36,2022/7/15 19:30,21,103,-82,-2423
36,2022/7/15 19:40,18,90,-72,-1831
36,2022/7/15 19:50,18,105,-87,-1713
36,2022/7/15 20:00,18,104,-86,-1612
36,2022/7/15 20:10,22,104,-82,-1383
36,2022/7/15 20:20,16,78,-62,-1466
36,2022/7/15 20:30,18,97,-79,-1371
36,2022/7/15 20:40,21,95,-74,-1413
36,2022/7/15 20:50,14,107,-93,-1557
36,2022/7/15 21:00,17,100,-83,-1393
36,2022/7/15 21:10,14,100,-86,-1383
36,2022/7/15 21:20,17,3,14,-1396
36,2022/7/15 21:30,13,102,-89,-1513
36,2022/7/15 21:40,10,103,-93,-1536
36,2022/7/15 21:50,1,62,-61,-1594
36,2022/7/15 22:00,0,72,-72,-1432
36,2022/7/15 22:10,0,98,-98,-1622
36,2022/7/15 22:20,0,99,-99,-1606
36,2022/7/15 22:30,0,10,-10,-1490
36,2022/7/15 22:40,0,80,-80,-1500
36,2022/7/15 22:50,0,67,-67,-1174
35,2022/7/15 5:00,0,1,-1,-24
35,2022/7/15 5:10,2,1,1,-16
35,2022/7/15 5:20,31,1,30,78
35,2022/7/15 5:30,29,1,28,178
35,2022/7/15 5:40,37,1,36,314
35,2022/7/15 5:50,49,1,48,501
35,2022/7/15 6:00,56,2,54,632
35,2022/7/15 6:10,74,1,73,705
35,2022/7/15 6:20,91,2,89,799
35,2022/7/15 6:30,212,1,211,1046
35,2022/7/15 6:40,270,104,166,1299
35,2022/7/15 6:50,347,99,248,1728
35,2022/7/15 7:00,597,134,463,2995
35,2022/7/15 7:10,590,222,368,3838
35,2022/7/15 7:20,720,150,570,5398
35,2022/7/15 7:30,720,158,562,6326
35,2022/7/15 7:40,661,110,551,8633
35,2022/7/15 7:50,593,540,53,8941
35,2022/7/15 8:00,592,319,273,8204
35,2022/7/15 8:10,442,121,321,6023
35,2022/7/15 8:20,347,178,169,4094
35,2022/7/15 8:30,269,234,35,1739
35,2022/7/15 8:40,228,299,-71,-1286
35,2022/7/15 8:50,186,110,76,-488
35,2022/7/15 9:00,86,112,-26,-298
35,2022/7/15 9:10,142,159,-17,-512
35,2022/7/15 9:20,92,111,-19,-433
35,2022/7/15 9:30,70,100,-30,-632
35,2022/7/15 9:40,66,112,-46,-988
35,2022/7/15 9:50,70,108,-38,-1025
35,2022/7/15 10:00,66,124,-58,-936
35,2022/7/15 10:10,55,102,-47,-874
35,2022/7/15 10:20,69,103,-34,-911
35,2022/7/15 10:30,58,122,-64,-909
35,2022/7/15 10:40,54,31,23,-856
35,2022/7/15 10:50,56,98,-42,-861
35,2022/7/15 11:00,64,110,-46,-836
35,2022/7/15 11:10,63,99,-36,-743
35,2022/7/15 11:20,63,112,-49,-893
35,2022/7/15 11:30,83,81,2,-756
35,2022/7/15 11:40,109,59,50,-737
35,2022/7/15 11:50,128,104,24,-727
35,2022/7/15 12:00,111,109,2,-774
35,2022/7/15 12:10,156,109,47,-587
35,2022/7/15 12:20,149,109,40,-751
35,2022/7/15 12:30,129,42,87,-703
35,2022/7/15 12:40,99,111,-12,-879
35,2022/7/15 12:50,99,102,-3,-864
35,2022/7/15 13:00,81,120,-39,-971
35,2022/7/15 13:10,60,122,-62,-906
35,2022/7/15 13:20,72,105,-33,-956
35,2022/7/15 13:30,55,46,9,-842
35,2022/7/15 13:40,64,95,-31,-903
35,2022/7/15 13:50,57,103,-46,-956
35,2022/7/15 14:00,63,105,-42,-989
35,2022/7/15 14:10,65,105,-40,-953
35,2022/7/15 14:20,81,110,-29,-960
35,2022/7/15 14:30,60,35,25,-855
35,2022/7/15 14:40,82,102,-20,-807
35,2022/7/15 14:50,94,112,-18,-938
35,2022/7/15 15:00,96,108,-12,-1004
35,2022/7/15 15:10,83,96,-13,-968
35,2022/7/15 15:20,98,103,-5,-1053
35,2022/7/15 15:30,69,39,30,-908
35,2022/7/15 15:40,109,123,-14,-1010
35,2022/7/15 15:50,145,119,26,-918
35,2022/7/15 16:00,180,119,61,-873
35,2022/7/15 16:10,207,121,86,-804
35,2022/7/15 16:20,170,107,63,-978
35,2022/7/15 16:30,180,57,123,-584
35,2022/7/15 16:40,222,121,101,-579
35,2022/7/15 16:50,222,111,111,-721
35,2022/7/15 17:00,195,119,76,-4
35,2022/7/15 17:10,270,140,130,604
35,2022/7/15 17:20,287,109,178,-333
35,2022/7/15 17:30,265,54,211,-328
35,2022/7/15 17:40,223,317,-94,-112
35,2022/7/15 17:50,274,115,159,-824
35,2022/7/15 18:00,133,111,22,-1522
35,2022/7/15 18:10,156,179,-23,-794
35,2022/7/15 18:20,167,271,-104,-1852
35,2022/7/15 18:30,55,128,-73,-3140
35,2022/7/15 18:40,49,153,-104,-3311
35,2022/7/15 18:50,40,224,-184,-3798
35,2022/7/15 19:00,41,315,-274,-3586
35,2022/7/15 19:10,33,109,-76,-3072
35,2022/7/15 19:20,36,111,-75,-2666
35,2022/7/15 19:30,23,179,-156,-2579
35,2022/7/15 19:40,37,216,-179,-2010
35,2022/7/15 19:50,29,99,-70,-1783
35,2022/7/15 20:00,29,103,-74,-1686
35,2022/7/15 20:10,33,115,-82,-1465
35,2022/7/15 20:20,28,66,-38,-1504
35,2022/7/15 20:30,28,116,-88,-1459
35,2022/7/15 20:40,28,116,-88,-1501
35,2022/7/15 20:50,30,108,-78,-1635
35,2022/7/15 21:00,26,105,-79,-1472
35,2022/7/15 21:10,32,22,10,-1373
35,2022/7/15 21:20,27,112,-85,-1481
35,2022/7/15 21:30,21,106,-85,-1598
35,2022/7/15 21:40,13,100,-87,-1623
35,2022/7/15 21:50,0,3,-3,-1597
35,2022/7/15 22:00,0,102,-102,-1534
35,2022/7/15 22:10,0,107,-107,-1729
35,2022/7/15 22:20,0,3,-3,-1609
35,2022/7/15 22:30,0,104,-104,-1594
35,2022/7/15 22:40,0,92,-92,-1592
35,2022/7/15 22:50,0,3,-3,-1177
51,2022/7/15 5:00,0,1,-1,-22
51,2022/7/15 5:10,0,1,-1,-17
51,2022/7/15 5:20,0,1,-1,32
51,2022/7/15 5:30,7,1,6,115
51,2022/7/15 5:40,16,1,15,253
51,2022/7/15 5:50,9,1,8,416
51,2022/7/15 6:00,11,1,10,528
51,2022/7/15 6:10,16,1,15,572
51,2022/7/15 6:20,12,1,11,629
51,2022/7/15 6:30,19,12,7,747
51,2022/7/15 6:40,17,67,-50,1042
51,2022/7/15 6:50,25,60,-35,1336
51,2022/7/15 7:00,28,62,-34,2241
51,2022/7/15 7:10,25,91,-66,3103
51,2022/7/15 7:20,33,99,-66,4404
51,2022/7/15 7:30,34,99,-65,5334
51,2022/7/15 7:40,28,97,-69,7607
51,2022/7/15 7:50,30,106,-76,8507
51,2022/7/15 8:00,24,117,-93,7591
51,2022/7/15 8:10,30,95,-65,5454
51,2022/7/15 8:20,27,106,-79,3750
51,2022/7/15 8:30,23,128,-105,1559
51,2022/7/15 8:40,26,101,-75,-1218
51,2022/7/15 8:50,26,92,-66,-583
51,2022/7/15 9:00,24,103,-79,-256
51,2022/7/15 9:10,24,99,-75,-462
51,2022/7/15 9:20,20,109,-89,-408
51,2022/7/15 9:30,21,114,-93,-595
51,2022/7/15 9:40,18,91,-73,-897
51,2022/7/15 9:50,30,128,-98,-1013
51,2022/7/15 10:00,24,106,-82,-879
51,2022/7/15 10:10,33,91,-58,-815
51,2022/7/15 10:20,36,87,-51,-864
51,2022/7/15 10:30,27,47,-20,-799
51,2022/7/15 10:40,42,84,-42,-844
51,2022/7/15 10:50,30,93,-63,-856
51,2022/7/15 11:00,65,73,-8,-718
51,2022/7/15 11:10,42,65,-23,-707
51,2022/7/15 11:20,50,69,-19,-791
51,2022/7/15 11:30,47,34,13,-684
51,2022/7/15 11:40,39,67,-28,-751
51,2022/7/15 11:50,33,57,-24,-758
51,2022/7/15 12:00,30,60,-30,-735
51,2022/7/15 12:10,33,60,-27,-640
51,2022/7/15 12:20,35,18,17,-683
51,2022/7/15 12:30,30,56,-26,-742
51,2022/7/15 12:40,22,58,-36,-877
51,2022/7/15 12:50,23,55,-32,-833
51,2022/7/15 13:00,21,55,-34,-917
51,2022/7/15 13:10,25,63,-38,-816
51,2022/7/15 13:20,26,22,4,-818
51,2022/7/15 13:30,21,61,-40,-799
51,2022/7/15 13:40,22,61,-39,-864
51,2022/7/15 13:50,23,51,-28,-860
51,2022/7/15 14:00,15,55,-40,-921
51,2022/7/15 14:10,23,51,-28,-880
51,2022/7/15 14:20,20,19,1,-854
51,2022/7/15 14:30,25,48,-23,-827
51,2022/7/15 14:40,15,43,-28,-787
51,2022/7/15 14:50,22,39,-17,-848
51,2022/7/15 15:00,18,42,-24,-967
51,2022/7/15 15:10,21,47,-26,-909
51,2022/7/15 15:20,22,18,4,-952
51,2022/7/15 15:30,19,41,-22,-870
51,2022/7/15 15:40,23,50,-27,-991
51,2022/7/15 15:50,15,38,-23,-871
51,2022/7/15 16:00,20,38,-18,-891
51,2022/7/15 16:10,21,42,-21,-819
51,2022/7/15 16:20,25,22,3,-944
51,2022/7/15 16:30,23,38,-15,-633
51,2022/7/15 16:40,22,41,-19,-662
51,2022/7/15 16:50,30,49,-19,-762
51,2022/7/15 17:00,35,51,-16,-19
51,2022/7/15 17:10,36,61,-25,550
51,2022/7/15 17:20,31,29,2,-375
51,2022/7/15 17:30,20,70,-50,-458
51,2022/7/15 17:40,17,59,-42,106
51,2022/7/15 17:50,19,45,-26,-873
51,2022/7/15 18:00,22,39,-17,-1355
51,2022/7/15 18:10,21,62,-41,-662
51,2022/7/15 18:20,19,60,-41,-1631
51,2022/7/15 18:30,13,52,-39,-2923
51,2022/7/15 18:40,17,51,-34,-2978
51,2022/7/15 18:50,11,68,-57,-3449
51,2022/7/15 19:00,21,48,-27,-3141
51,2022/7/15 19:10,11,43,-32,-2835
51,2022/7/15 19:20,14,49,-35,-2323
51,2022/7/15 19:30,8,54,-46,-2289
51,2022/7/15 19:40,10,41,-31,-1701
51,2022/7/15 19:50,6,27,-21,-1561
51,2022/7/15 20:00,22,25,-3,-1464
51,2022/7/15 20:10,8,25,-17,-1247
51,2022/7/15 20:20,11,25,-14,-1346
51,2022/7/15 20:30,5,32,-27,-1237
51,2022/7/15 20:40,12,31,-19,-1335
51,2022/7/15 20:50,6,27,-21,-1416
51,2022/7/15 21:00,16,10,6,-1238
51,2022/7/15 21:10,15,23,-8,-1230
51,2022/7/15 21:20,1,37,-36,-1379
51,2022/7/15 21:30,1,31,-30,-1451
51,2022/7/15 21:40,1,3,-2,-1377
51,2022/7/15 21:50,0,31,-31,-1488
51,2022/7/15 22:00,0,33,-33,-1379
51,2022/7/15 22:10,0,21,-21,-1476
51,2022/7/15 22:20,0,13,-13,-1443
51,2022/7/15 22:30,0,25,-25,-1482
51,2022/7/15 22:40,0,10,-10,-1374
51,2022/7/15 22:50,0,8,-8,-1053
31,2022/7/15 5:00,0,1,-1,-23
31,2022/7/15 5:10,0,1,-1,-18
31,2022/7/15 5:20,2,1,1,33
31,2022/7/15 5:30,5,1,4,119
31,2022/7/15 5:40,3,1,2,255
31,2022/7/15 5:50,4,1,3,419
31,2022/7/15 6:00,13,1,12,540
31,2022/7/15 6:10,16,1,15,587
31,2022/7/15 6:20,19,1,18,647
31,2022/7/15 6:30,17,1,16,763
31,2022/7/15 6:40,23,23,0,1042
31,2022/7/15 6:50,23,21,2,1338
31,2022/7/15 7:00,29,33,-4,2237
31,2022/7/15 7:10,31,19,12,3115
31,2022/7/15 7:20,36,65,-29,4375
31,2022/7/15 7:30,31,64,-33,5301
31,2022/7/15 7:40,31,71,-40,7567
31,2022/7/15 7:50,31,50,-19,8488
31,2022/7/15 8:00,30,63,-33,7558
31,2022/7/15 8:10,22,51,-29,5425
31,2022/7/15 8:20,23,67,-44,3706
31,2022/7/15 8:30,19,59,-40,1519
31,2022/7/15 8:40,17,53,-36,-1254
31,2022/7/15 8:50,15,80,-65,-648
31,2022/7/15 9:00,10,47,-37,-293
31,2022/7/15 9:10,11,30,-19,-481
31,2022/7/15 9:20,11,35,-24,-432
31,2022/7/15 9:30,9,34,-25,-620
31,2022/7/15 9:40,9,37,-28,-925
31,2022/7/15 9:50,10,32,-22,-1035
31,2022/7/15 10:00,8,30,-22,-901
31,2022/7/15 10:10,9,37,-28,-843
31,2022/7/15 10:20,8,21,-13,-877
31,2022/7/15 10:30,8,32,-24,-823
31,2022/7/15 10:40,6,37,-31,-875
31,2022/7/15 10:50,8,29,-21,-877
31,2022/7/15 11:00,7,8,-1,-719
31,2022/7/15 11:10,10,33,-23,-730
31,2022/7/15 11:20,11,30,-19,-810
31,2022/7/15 11:30,10,29,-19,-703
31,2022/7/15 11:40,11,23,-12,-763
31,2022/7/15 11:50,11,23,-12,-770
31,2022/7/15 12:00,12,16,-4,-739
31,2022/7/15 12:10,10,15,-5,-645
31,2022/7/15 12:20,10,32,-22,-705
31,2022/7/15 12:30,13,23,-10,-752
31,2022/7/15 12:40,10,25,-15,-892
31,2022/7/15 12:50,8,22,-14,-847
31,2022/7/15 13:00,13,8,5,-912
31,2022/7/15 13:10,11,25,-14,-830
31,2022/7/15 13:20,10,31,-21,-839
31,2022/7/15 13:30,10,25,-15,-814
31,2022/7/15 13:40,11,29,-18,-882
31,2022/7/15 13:50,11,23,-12,-872
31,2022/7/15 14:00,8,12,-4,-925
31,2022/7/15 14:10,9,35,-26,-906
31,2022/7/15 14:20,10,32,-22,-876
31,2022/7/15 14:30,11,31,-20,-847
31,2022/7/15 14:40,11,23,-12,-799
31,2022/7/15 14:50,9,21,-12,-860
31,2022/7/15 15:00,11,21,-10,-977
31,2022/7/15 15:10,11,32,-21,-930
31,2022/7/15 15:20,12,35,-23,-975
31,2022/7/15 15:30,12,29,-17,-887
31,2022/7/15 15:40,13,32,-19,-1010
31,2022/7/15 15:50,12,30,-18,-889
31,2022/7/15 16:00,20,12,8,-883
31,2022/7/15 16:10,9,31,-22,-841
31,2022/7/15 16:20,26,23,3,-941
31,2022/7/15 16:30,20,47,-27,-660
31,2022/7/15 16:40,19,38,-19,-681
31,2022/7/15 16:50,26,32,-6,-768
31,2022/7/15 17:00,22,14,8,-11
31,2022/7/15 17:10,23,41,-18,532
31,2022/7/15 17:20,22,40,-18,-393
31,2022/7/15 17:30,33,38,-5,-463
31,2022/7/15 17:40,19,39,-20,86
31,2022/7/15 17:50,29,45,-16,-889
31,2022/7/15 18:00,21,45,-24,-1379
31,2022/7/15 18:10,15,48,-33,-695
31,2022/7/15 18:20,17,47,-30,-1661
31,2022/7/15 18:30,17,68,-51,-2974
31,2022/7/15 18:40,12,72,-60,-3038
31,2022/7/15 18:50,14,51,-37,-3486
31,2022/7/15 19:00,12,46,-34,-3175
31,2022/7/15 19:10,9,60,-51,-2886
31,2022/7/15 19:20,8,61,-53,-2376
31,2022/7/15 19:30,5,47,-42,-2331
31,2022/7/15 19:40,8,40,-32,-1733
31,2022/7/15 19:50,6,47,-41,-1602
31,2022/7/15 20:00,8,44,-36,-1500
31,2022/7/15 20:10,3,37,-34,-1281
31,2022/7/15 20:20,2,34,-32,-1378
31,2022/7/15 20:30,4,40,-36,-1273
31,2022/7/15 20:40,5,10,-5,-1340
31,2022/7/15 20:50,3,40,-37,-1453
31,2022/7/15 21:00,2,34,-32,-1270
31,2022/7/15 21:10,2,36,-34,-1264
31,2022/7/15 21:20,2,36,-34,-1413
31,2022/7/15 21:30,3,7,-4,-1455
31,2022/7/15 21:40,0,35,-35,-1412
31,2022/7/15 21:50,0,34,-34,-1522
31,2022/7/15 22:00,0,10,-10,-1389
31,2022/7/15 22:10,0,25,-25,-1501
31,2022/7/15 22:20,0,31,-31,-1474
31,2022/7/15 22:30,0,21,-21,-1503
31,2022/7/15 22:40,0,13,-13,-1387
31,2022/7/15 22:50,0,21,-21,-1074
50,2022/7/15 5:00,0,1,-1,-27
50,2022/7/15 5:10,0,1,-1,-19
50,2022/7/15 5:20,3,1,2,80
50,2022/7/15 5:30,15,1,14,202
50,2022/7/15 5:40,11,1,10,341
50,2022/7/15 5:50,12,1,11,523
50,2022/7/15 6:00,14,1,13,667
50,2022/7/15 6:10,17,1,16,751
50,2022/7/15 6:20,30,1,29,857
50,2022/7/15 6:30,30,1,29,1098
50,2022/7/15 6:40,32,8,24,1273
50,2022/7/15 6:50,41,38,3,1698
50,2022/7/15 7:00,45,33,12,2969
50,2022/7/15 7:10,60,59,1,3785
50,2022/7/15 7:20,70,77,-7,5296
50,2022/7/15 7:30,56,72,-16,6212
50,2022/7/15 7:40,80,83,-3,8521
50,2022/7/15 7:50,77,123,-46,8800
50,2022/7/15 8:00,40,103,-63,8015
50,2022/7/15 8:10,79,104,-25,5904
50,2022/7/15 8:20,34,105,-71,3900
50,2022/7/15 8:30,29,116,-87,1507
50,2022/7/15 8:40,23,93,-70,-1467
50,2022/7/15 8:50,18,87,-69,-688
50,2022/7/15 9:00,21,69,-48,-462
50,2022/7/15 9:10,25,100,-75,-681
50,2022/7/15 9:20,13,54,-41,-587
50,2022/7/15 9:30,15,45,-30,-780
50,2022/7/15 9:40,13,49,-36,-1125
50,2022/7/15 9:50,12,44,-32,-1177
50,2022/7/15 10:00,15,49,-34,-1074
50,2022/7/15 10:10,22,38,-16,-976
50,2022/7/15 10:20,12,39,-27,-1002
50,2022/7/15 10:30,10,37,-27,-980
50,2022/7/15 10:40,13,38,-25,-954
50,2022/7/15 10:50,12,12,0,-945
50,2022/7/15 11:00,11,38,-27,-872
50,2022/7/15 11:10,18,47,-29,-818
50,2022/7/15 11:20,19,38,-19,-950
50,2022/7/15 11:30,17,43,-26,-788
50,2022/7/15 11:40,16,25,-9,-786
50,2022/7/15 11:50,14,23,-9,-772
50,2022/7/15 12:00,25,41,-16,-824
50,2022/7/15 12:10,25,46,-21,-640
50,2022/7/15 12:20,17,46,-29,-785
50,2022/7/15 12:30,17,38,-21,-760
50,2022/7/15 12:40,16,8,8,-922
50,2022/7/15 12:50,13,49,-36,-946
50,2022/7/15 13:00,17,45,-28,-1028
50,2022/7/15 13:10,21,46,-25,-983
50,2022/7/15 13:20,14,38,-24,-997
50,2022/7/15 13:30,12,37,-25,-922
50,2022/7/15 13:40,15,19,-4,-964
50,2022/7/15 13:50,13,41,-28,-1024
50,2022/7/15 14:00,12,38,-26,-1059
50,2022/7/15 14:10,16,38,-22,-1029
50,2022/7/15 14:20,16,37,-21,-1002
50,2022/7/15 14:30,17,41,-24,-922
50,2022/7/15 14:40,16,14,2,-845
50,2022/7/15 14:50,13,40,-27,-994
50,2022/7/15 15:00,15,45,-30,-1068
50,2022/7/15 15:10,20,40,-20,-1035
50,2022/7/15 15:20,17,46,-29,-1101
50,2022/7/15 15:30,15,46,-31,-978
50,2022/7/15 15:40,19,12,7,-1049
50,2022/7/15 15:50,19,50,-31,-990
50,2022/7/15 16:00,28,52,-24,-907
50,2022/7/15 16:10,41,63,-22,-869
50,2022/7/15 16:20,25,50,-25,-997
50,2022/7/15 16:30,37,51,-14,-640
50,2022/7/15 16:40,45,23,22,-595
50,2022/7/15 16:50,38,54,-16,-762
50,2022/7/15 17:00,48,66,-18,-30
50,2022/7/15 17:10,72,61,11,572
50,2022/7/15 17:20,36,69,-33,-382
50,2022/7/15 17:30,37,66,-29,-412
50,2022/7/15 17:40,40,71,-31,-205
50,2022/7/15 17:50,31,60,-29,-895
50,2022/7/15 18:00,33,63,-30,-1593
50,2022/7/15 18:10,41,78,-37,-905
50,2022/7/15 18:20,22,69,-47,-1970
50,2022/7/15 18:30,25,70,-45,-3275
50,2022/7/15 18:40,20,74,-54,-3459
50,2022/7/15 18:50,17,97,-80,-3972
50,2022/7/15 19:00,18,91,-73,-3720
50,2022/7/15 19:10,28,72,-44,-3199
50,2022/7/15 19:20,16,75,-59,-2813
50,2022/7/15 19:30,13,94,-81,-2748
50,2022/7/15 19:40,11,77,-66,-2139
50,2022/7/15 19:50,10,74,-64,-1909
50,2022/7/15 20:00,13,71,-58,-1783
50,2022/7/15 20:10,18,67,-49,-1565
50,2022/7/15 20:20,9,33,-24,-1574
50,2022/7/15 20:30,8,59,-51,-1573
50,2022/7/15 20:40,12,68,-56,-1581
50,2022/7/15 20:50,8,64,-56,-1749
50,2022/7/15 21:00,6,63,-57,-1555
50,2022/7/15 21:10,11,66,-55,-1470
50,2022/7/15 21:20,6,15,-9,-1560
50,2022/7/15 21:30,2,52,-50,-1682
50,2022/7/15 21:40,1,65,-64,-1724
50,2022/7/15 21:50,1,44,-43,-1705
50,2022/7/15 22:00,0,31,-31,-1608
50,2022/7/15 22:10,0,55,-55,-1830
50,2022/7/15 22:20,0,47,-47,-1700
50,2022/7/15 22:30,0,3,-3,-1643
50,2022/7/15 22:40,0,46,-46,-1661
50,2022/7/15 22:50,0,38,-38,-1244
28,2022/7/15 5:00,0,1,-1,-28
28,2022/7/15 5:10,6,1,5,-14
28,2022/7/15 5:20,23,1,22,102
28,2022/7/15 5:30,24,1,23,225
28,2022/7/15 5:40,26,2,24,365
28,2022/7/15 5:50,31,1,30,553
28,2022/7/15 6:00,29,5,24,691
28,2022/7/15 6:10,54,6,48,799
28,2022/7/15 6:20,59,5,54,911
28,2022/7/15 6:30,92,8,84,1182
28,2022/7/15 6:40,94,19,75,1348
28,2022/7/15 6:50,149,77,72,1770
28,2022/7/15 7:00,195,76,119,3088
28,2022/7/15 7:10,184,99,85,3870
28,2022/7/15 7:20,227,108,119,5415
28,2022/7/15 7:30,264,104,160,6372
28,2022/7/15 7:40,215,111,104,8625
28,2022/7/15 7:50,188,108,80,8880
28,2022/7/15 8:00,194,98,96,8111
28,2022/7/15 8:10,144,139,5,5909
28,2022/7/15 8:20,99,123,-24,3876
28,2022/7/15 8:30,68,110,-42,1465
28,2022/7/15 8:40,60,133,-73,-1540
28,2022/7/15 8:50,56,122,-66,-754
28,2022/7/15 9:00,45,99,-54,-516
28,2022/7/15 9:10,38,105,-67,-748
28,2022/7/15 9:20,38,87,-49,-636
28,2022/7/15 9:30,36,108,-72,-852
28,2022/7/15 9:40,28,87,-59,-1184
28,2022/7/15 9:50,29,76,-47,-1224
28,2022/7/15 10:00,32,109,-77,-1151
28,2022/7/15 10:10,29,81,-52,-1028
28,2022/7/15 10:20,29,76,-47,-1049
28,2022/7/15 10:30,30,76,-46,-1026
28,2022/7/15 10:40,30,23,7,-947
28,2022/7/15 10:50,31,101,-70,-1015
28,2022/7/15 11:00,31,93,-62,-934
28,2022/7/15 11:10,27,96,-69,-887
28,2022/7/15 11:20,29,76,-47,-997
28,2022/7/15 11:30,31,36,-5,-793
28,2022/7/15 11:40,37,97,-60,-846
28,2022/7/15 11:50,32,92,-60,-832
28,2022/7/15 12:00,36,96,-60,-884
28,2022/7/15 12:10,36,93,-57,-697
28,2022/7/15 12:20,35,70,-35,-820
28,2022/7/15 12:30,33,68,-35,-795
28,2022/7/15 12:40,37,93,-56,-978
28,2022/7/15 12:50,35,91,-56,-1002
28,2022/7/15 13:00,39,94,-55,-1083
28,2022/7/15 13:10,36,97,-61,-1044
28,2022/7/15 13:20,31,61,-30,-1027
28,2022/7/15 13:30,32,64,-32,-954
28,2022/7/15 13:40,33,97,-64,-1028
28,2022/7/15 13:50,40,97,-57,-1081
28,2022/7/15 14:00,32,90,-58,-1117
28,2022/7/15 14:10,33,97,-64,-1093
28,2022/7/15 14:20,32,58,-26,-1028
28,2022/7/15 14:30,33,57,-24,-946
28,2022/7/15 14:40,30,93,-63,-908
28,2022/7/15 14:50,32,95,-63,-1057
28,2022/7/15 15:00,37,100,-63,-1131
28,2022/7/15 15:10,37,95,-58,-1093
28,2022/7/15 15:20,35,97,-62,-1163
28,2022/7/15 15:30,33,22,11,-967
28,2022/7/15 15:40,33,102,-69,-1118
28,2022/7/15 15:50,37,102,-65,-1055
28,2022/7/15 16:00,37,102,-65,-972
28,2022/7/15 16:10,41,101,-60,-929
28,2022/7/15 16:20,48,85,-37,-1034
28,2022/7/15 16:30,53,59,-6,-646
28,2022/7/15 16:40,52,118,-66,-661
28,2022/7/15 16:50,89,102,-13,-775
28,2022/7/15 17:00,70,122,-52,-82
28,2022/7/15 17:10,73,124,-51,521
28,2022/7/15 17:20,66,103,-37,-419
28,2022/7/15 17:30,73,78,-5,-417
28,2022/7/15 17:40,73,132,-59,-264
28,2022/7/15 17:50,61,179,-118,-1013
28,2022/7/15 18:00,70,124,-54,-1647
28,2022/7/15 18:10,57,123,-66,-971
28,2022/7/15 18:20,47,110,-63,-2033
28,2022/7/15 18:30,42,214,-172,-3447
28,2022/7/15 18:40,40,110,-70,-3529
28,2022/7/15 18:50,37,110,-73,-4045
28,2022/7/15 19:00,37,110,-73,-3793
28,2022/7/15 19:10,41,180,-139,-3338
28,2022/7/15 19:20,34,126,-92,-2905
28,2022/7/15 19:30,34,99,-65,-2813
28,2022/7/15 19:40,37,117,-80,-2219
28,2022/7/15 19:50,33,103,-70,-1979
28,2022/7/15 20:00,30,95,-65,-1848
28,2022/7/15 20:10,37,88,-51,-1616
28,2022/7/15 20:20,25,84,-59,-1633
28,2022/7/15 20:30,29,92,-63,-1636
28,2022/7/15 20:40,27,82,-55,-1636
28,2022/7/15 20:50,25,88,-63,-1812
28,2022/7/15 21:00,26,75,-49,-1604
28,2022/7/15 21:10,26,23,3,-1467
28,2022/7/15 21:20,25,75,-50,-1610
28,2022/7/15 21:30,26,76,-50,-1732
28,2022/7/15 21:40,7,85,-78,-1802
28,2022/7/15 21:50,7,8,-1,-1706
28,2022/7/15 22:00,7,82,-75,-1683
28,2022/7/15 22:10,4,85,-81,-1911
28,2022/7/15 22:20,1,15,-14,-1714
28,2022/7/15 22:30,2,70,-68,-1711
28,2022/7/15 22:40,2,74,-72,-1733
28,2022/7/15 22:50,1,10,-9,-1253
58,2022/7/15 5:00,0,1,-1,-29
58,2022/7/15 5:10,0,1,-1,-15
58,2022/7/15 5:20,0,1,-1,101
58,2022/7/15 5:30,18,1,17,242
58,2022/7/15 5:40,21,1,20,385
58,2022/7/15 5:50,19,1,18,571
58,2022/7/15 6:00,22,1,21,712
58,2022/7/15 6:10,30,1,29,828
58,2022/7/15 6:20,36,1,35,946
58,2022/7/15 6:30,57,1,56,1238
58,2022/7/15 6:40,78,1,77,1425
58,2022/7/15 6:50,111,38,73,1843
58,2022/7/15 7:00,183,38,145,3233
58,2022/7/15 7:10,180,45,135,4005
58,2022/7/15 7:20,207,11,196,5611
58,2022/7/15 7:30,219,59,160,6532
58,2022/7/15 7:40,200,46,154,8779
58,2022/7/15 7:50,200,65,135,9015
58,2022/7/15 8:00,162,64,98,8209
58,2022/7/15 8:10,107,93,14,5923
58,2022/7/15 8:20,85,121,-36,3840
58,2022/7/15 8:30,51,95,-44,1421
58,2022/7/15 8:40,54,75,-21,-1561
58,2022/7/15 8:50,34,66,-32,-786
58,2022/7/15 9:00,37,79,-42,-558
58,2022/7/15 9:10,32,57,-25,-773
58,2022/7/15 9:20,30,46,-16,-652
58,2022/7/15 9:30,27,60,-33,-885
58,2022/7/15 9:40,29,50,-21,-1205
58,2022/7/15 9:50,27,40,-13,-1237
58,2022/7/15 10:00,25,40,-15,-1166
58,2022/7/15 10:10,25,46,-21,-1049
58,2022/7/15 10:20,26,61,-35,-1084
58,2022/7/15 10:30,22,22,0,-1026
58,2022/7/15 10:40,22,38,-16,-963
58,2022/7/15 10:50,21,62,-41,-1056
58,2022/7/15 11:00,21,51,-30,-964
58,2022/7/15 11:10,18,12,6,-881
58,2022/7/15 11:20,23,51,-28,-1025
58,2022/7/15 11:30,22,42,-20,-813
58,2022/7/15 11:40,21,45,-24,-870
58,2022/7/15 11:50,21,49,-28,-860
58,2022/7/15 12:00,22,50,-28,-912
58,2022/7/15 12:10,26,54,-28,-725
58,2022/7/15 12:20,28,12,16,-804
58,2022/7/15 12:30,24,54,-30,-825
58,2022/7/15 12:40,21,52,-31,-1009
58,2022/7/15 12:50,25,61,-36,-1038
58,2022/7/15 13:00,22,54,-32,-1115
58,2022/7/15 13:10,28,44,-16,-1060
58,2022/7/15 13:20,20,25,-5,-1032
58,2022/7/15 13:30,21,58,-37,-991
58,2022/7/15 13:40,20,52,-32,-1060
58,2022/7/15 13:50,18,57,-39,-1120
58,2022/7/15 14:00,22,50,-28,-1145
58,2022/7/15 14:10,15,37,-22,-1115
58,2022/7/15 14:20,17,37,-20,-1048
58,2022/7/15 14:30,21,48,-27,-973
58,2022/7/15 14:40,21,54,-33,-941
58,2022/7/15 14:50,19,52,-33,-1090
58,2022/7/15 15:00,21,61,-40,-1171
58,2022/7/15 15:10,21,37,-16,-1109
58,2022/7/15 15:20,24,70,-46,-1209
58,2022/7/15 15:30,22,25,-3,-970
58,2022/7/15 15:40,18,66,-48,-1166
58,2022/7/15 15:50,23,64,-41,-1096
58,2022/7/15 16:00,21,66,-45,-1017
58,2022/7/15 16:10,20,50,-30,-959
58,2022/7/15 16:20,21,36,-15,-1049
58,2022/7/15 16:30,25,60,-35,-681
58,2022/7/15 16:40,24,85,-61,-722
58,2022/7/15 16:50,27,74,-47,-822
58,2022/7/15 17:00,26,69,-43,-125
58,2022/7/15 17:10,25,70,-45,476
58,2022/7/15 17:20,25,49,-24,-443
58,2022/7/15 17:30,29,88,-59,-476
58,2022/7/15 17:40,36,90,-54,-318
58,2022/7/15 17:50,33,93,-60,-1073
58,2022/7/15 18:00,31,104,-73,-1720
58,2022/7/15 18:10,31,93,-62,-1033
58,2022/7/15 18:20,29,95,-66,-2099
58,2022/7/15 18:30,25,115,-90,-3537
58,2022/7/15 18:40,28,128,-100,-3629
58,2022/7/15 18:50,26,114,-88,-4133
58,2022/7/15 19:00,23,107,-84,-3877
58,2022/7/15 19:10,21,112,-91,-3429
58,2022/7/15 19:20,19,109,-90,-2995
58,2022/7/15 19:30,14,108,-94,-2907
58,2022/7/15 19:40,13,113,-100,-2319
58,2022/7/15 19:50,16,100,-84,-2063
58,2022/7/15 20:00,15,129,-114,-1962
58,2022/7/15 20:10,15,77,-62,-1678
58,2022/7/15 20:20,12,74,-62,-1695
58,2022/7/15 20:30,13,83,-70,-1706
58,2022/7/15 20:40,9,76,-67,-1703
58,2022/7/15 20:50,9,77,-68,-1880
58,2022/7/15 21:00,10,18,-8,-1612
58,2022/7/15 21:10,13,74,-61,-1528
58,2022/7/15 21:20,12,71,-59,-1669
58,2022/7/15 21:30,8,79,-71,-1803
58,2022/7/15 21:40,1,31,-30,-1832
58,2022/7/15 21:50,2,69,-67,-1773
58,2022/7/15 22:00,1,74,-73,-1756
58,2022/7/15 22:10,2,74,-72,-1983
58,2022/7/15 22:20,2,4,-2,-1716
58,2022/7/15 22:30,1,68,-67,-1778
58,2022/7/15 22:40,0,61,-61,-1794
58,2022/7/15 22:50,1,3,-2,-1255
33,2022/7/15 5:00,0,1,-1,-30
33,2022/7/15 5:10,0,1,-1,-16
33,2022/7/15 5:20,3,1,2,103
33,2022/7/15 5:30,13,1,12,254
33,2022/7/15 5:40,8,1,7,392
33,2022/7/15 5:50,8,1,7,578
33,2022/7/15 6:00,10,1,9,721
33,2022/7/15 6:10,15,1,14,842
33,2022/7/15 6:20,24,1,23,969
33,2022/7/15 6:30,28,1,27,1265
33,2022/7/15 6:40,39,1,38,1463
33,2022/7/15 6:50,49,1,48,1891
33,2022/7/15 7:00,55,45,10,3243
33,2022/7/15 7:10,64,12,52,4057
33,2022/7/15 7:20,59,29,30,5641
33,2022/7/15 7:30,76,50,26,6558
33,2022/7/15 7:40,48,38,10,8789
33,2022/7/15 7:50,55,37,18,9033
33,2022/7/15 8:00,42,59,-17,8192
33,2022/7/15 8:10,50,45,5,5928
33,2022/7/15 8:20,36,44,-8,3832
33,2022/7/15 8:30,29,51,-22,1399
33,2022/7/15 8:40,30,65,-35,-1596
33,2022/7/15 8:50,26,46,-20,-806
33,2022/7/15 9:00,21,48,-27,-585
33,2022/7/15 9:10,21,38,-17,-790
33,2022/7/15 9:20,21,59,-38,-690
33,2022/7/15 9:30,13,37,-24,-909
33,2022/7/15 9:40,15,38,-23,-1228
33,2022/7/15 9:50,18,48,-30,-1267
33,2022/7/15 10:00,13,40,-27,-1193
33,2022/7/15 10:10,13,28,-15,-1064
33,2022/7/15 10:20,14,38,-24,-1108
33,2022/7/15 10:30,13,38,-25,-1051
33,2022/7/15 10:40,12,37,-25,-988
33,2022/7/15 10:50,17,40,-23,-1079
33,2022/7/15 11:00,11,8,3,-961
33,2022/7/15 11:10,16,40,-24,-905
33,2022/7/15 11:20,11,39,-28,-1053
33,2022/7/15 11:30,10,29,-19,-832
33,2022/7/15 11:40,19,37,-18,-888
33,2022/7/15 11:50,12,33,-21,-881
33,2022/7/15 12:00,14,8,6,-906
33,2022/7/15 12:10,13,33,-20,-745
33,2022/7/15 12:20,9,38,-29,-833
33,2022/7/15 12:30,16,38,-22,-847
33,2022/7/15 12:40,12,25,-13,-1022
33,2022/7/15 12:50,8,8,0,-1038
33,2022/7/15 13:00,13,25,-12,-1127
33,2022/7/15 13:10,11,33,-22,-1082
33,2022/7/15 13:20,12,38,-26,-1058
33,2022/7/15 13:30,13,32,-19,-1010
33,2022/7/15 13:40,12,38,-26,-1086
33,2022/7/15 13:50,10,8,2,-1118
33,2022/7/15 14:00,12,35,-23,-1168
33,2022/7/15 14:10,10,35,-25,-1140
33,2022/7/15 14:20,8,33,-25,-1073
33,2022/7/15 14:30,17,38,-21,-994
33,2022/7/15 14:40,9,38,-29,-970
33,2022/7/15 14:50,10,7,3,-1087
33,2022/7/15 15:00,15,33,-18,-1189
33,2022/7/15 15:10,15,40,-25,-1134
33,2022/7/15 15:20,13,38,-25,-1234
33,2022/7/15 15:30,14,44,-30,-1000
33,2022/7/15 15:40,13,38,-25,-1191
33,2022/7/15 15:50,19,8,11,-1085
33,2022/7/15 16:00,15,37,-22,-1039
33,2022/7/15 16:10,15,45,-30,-989
33,2022/7/15 16:20,14,44,-30,-1079
33,2022/7/15 16:30,16,47,-31,-712
33,2022/7/15 16:40,16,46,-30,-752
33,2022/7/15 16:50,14,19,-5,-827
33,2022/7/15 17:00,18,46,-28,-153
33,2022/7/15 17:10,20,54,-34,442
33,2022/7/15 17:20,19,61,-42,-485
33,2022/7/15 17:30,17,63,-46,-522
33,2022/7/15 17:40,22,66,-44,-362
33,2022/7/15 17:50,21,71,-50,-1123
33,2022/7/15 18:00,20,62,-42,-1762
33,2022/7/15 18:10,19,63,-44,-1077
33,2022/7/15 18:20,19,98,-79,-2178
33,2022/7/15 18:30,14,71,-57,-3594
33,2022/7/15 18:40,15,69,-54,-3683
33,2022/7/15 18:50,10,64,-54,-4187
33,2022/7/15 19:00,9,101,-92,-3969
33,2022/7/15 19:10,15,74,-59,-3488
33,2022/7/15 19:20,8,79,-71,-3066
33,2022/7/15 19:30,8,71,-63,-2970
33,2022/7/15 19:40,8,103,-95,-2414
33,2022/7/15 19:50,5,73,-68,-2131
33,2022/7/15 20:00,6,67,-61,-2023
33,2022/7/15 20:10,6,56,-50,-1728
33,2022/7/15 20:20,4,73,-69,-1764
33,2022/7/15 20:30,2,47,-45,-1751
33,2022/7/15 20:40,5,8,-3,-1706
33,2022/7/15 20:50,4,52,-48,-1928
33,2022/7/15 21:00,4,49,-45,-1657
33,2022/7/15 21:10,4,43,-39,-1567
33,2022/7/15 21:20,1,40,-39,-1708
33,2022/7/15 21:30,0,11,-11,-1814
33,2022/7/15 21:40,0,45,-45,-1877
33,2022/7/15 21:50,0,43,-43,-1816
33,2022/7/15 22:00,0,49,-49,-1805
33,2022/7/15 22:10,0,4,-4,-1987
33,2022/7/15 22:20,0,43,-43,-1759
33,2022/7/15 22:30,0,33,-33,-1811
33,2022/7/15 22:40,0,3,-3,-1797
33,2022/7/15 22:50,0,33,-33,-1288
34,2022/7/15 5:00,0,1,-1,-31
34,2022/7/15 5:10,0,1,-1,-17
34,2022/7/15 5:20,11,1,10,113
34,2022/7/15 5:30,17,1,16,270
34,2022/7/15 5:40,16,1,15,407
34,2022/7/15 5:50,20,1,19,597
34,2022/7/15 6:00,22,1,21,742
34,2022/7/15 6:10,28,1,27,869
34,2022/7/15 6:20,38,1,37,1006
34,2022/7/15 6:30,57,1,56,1321
34,2022/7/15 6:40,73,5,68,1531
34,2022/7/15 6:50,155,5,150,2041
34,2022/7/15 7:00,143,57,86,3329
34,2022/7/15 7:10,283,62,221,4278
34,2022/7/15 7:20,246,64,182,5823
34,2022/7/15 7:30,151,69,82,6640
34,2022/7/15 7:40,186,62,124,8913
34,2022/7/15 7:50,124,70,54,9087
34,2022/7/15 8:00,148,70,78,8270
34,2022/7/15 8:10,71,81,-10,5918
34,2022/7/15 8:20,65,96,-31,3801
34,2022/7/15 8:30,51,69,-18,1381
34,2022/7/15 8:40,53,65,-12,-1608
34,2022/7/15 8:50,33,95,-62,-868
34,2022/7/15 9:00,26,71,-45,-630
34,2022/7/15 9:10,31,61,-30,-820
34,2022/7/15 9:20,28,75,-47,-737
34,2022/7/15 9:30,24,87,-63,-972
34,2022/7/15 9:40,22,67,-45,-1273
34,2022/7/15 9:50,22,75,-53,-1320
34,2022/7/15 10:00,28,60,-32,-1225
34,2022/7/15 10:10,23,98,-75,-1139
34,2022/7/15 10:20,27,67,-40,-1148
34,2022/7/15 10:30,22,66,-44,-1095
34,2022/7/15 10:40,29,62,-33,-1021
34,2022/7/15 10:50,25,7,18,-1061
34,2022/7/15 11:00,25,82,-57,-1018
34,2022/7/15 11:10,17,72,-55,-960
34,2022/7/15 11:20,24,76,-52,-1105
34,2022/7/15 11:30,17,59,-42,-874
34,2022/7/15 11:40,22,35,-13,-901
34,2022/7/15 11:50,22,42,-20,-901
34,2022/7/15 12:00,27,67,-40,-946
34,2022/7/15 12:10,25,66,-41,-786
34,2022/7/15 12:20,27,67,-40,-873
34,2022/7/15 12:30,20,67,-47,-894
34,2022/7/15 12:40,28,7,21,-1001
34,2022/7/15 12:50,21,61,-40,-1078
34,2022/7/15 13:00,24,65,-41,-1168
34,2022/7/15 13:10,26,65,-39,-1121
34,2022/7/15 13:20,29,65,-36,-1094
34,2022/7/15 13:30,24,60,-36,-1046
34,2022/7/15 13:40,28,9,19,-1067
34,2022/7/15 13:50,29,59,-30,-1148
34,2022/7/15 14:00,24,60,-36,-1204
34,2022/7/15 14:10,28,67,-39,-1179
34,2022/7/15 14:20,23,62,-39,-1112
34,2022/7/15 14:30,29,62,-33,-1027
34,2022/7/15 14:40,26,7,19,-951
34,2022/7/15 14:50,26,61,-35,-1122
34,2022/7/15 15:00,25,68,-43,-1232
34,2022/7/15 15:10,25,66,-41,-1175
34,2022/7/15 15:20,23,61,-38,-1272
34,2022/7/15 15:30,28,69,-41,-1041
34,2022/7/15 15:40,34,2,32,-1159
34,2022/7/15 15:50,28,69,-41,-1126
34,2022/7/15 16:00,24,72,-48,-1087
34,2022/7/15 16:10,26,65,-39,-1028
34,2022/7/15 16:20,26,71,-45,-1124
34,2022/7/15 16:30,32,72,-40,-752
34,2022/7/15 16:40,25,5,20,-732
34,2022/7/15 16:50,27,83,-56,-883
34,2022/7/15 17:00,24,69,-45,-198
34,2022/7/15 17:10,25,90,-65,377
34,2022/7/15 17:20,28,77,-49,-534
34,2022/7/15 17:30,24,78,-54,-576
34,2022/7/15 17:40,26,23,3,-359
34,2022/7/15 17:50,25,122,-97,-1220
34,2022/7/15 18:00,27,93,-66,-1828
34,2022/7/15 18:10,26,85,-59,-1136
34,2022/7/15 18:20,23,97,-74,-2252
34,2022/7/15 18:30,25,111,-86,-3680
34,2022/7/15 18:40,25,107,-82,-3765
34,2022/7/15 18:50,22,107,-85,-4272
34,2022/7/15 19:00,19,114,-95,-4064
34,2022/7/15 19:10,18,116,-98,-3586
34,2022/7/15 19:20,14,89,-75,-3141
34,2022/7/15 19:30,15,106,-91,-3061
34,2022/7/15 19:40,19,112,-93,-2507
34,2022/7/15 19:50,13,111,-98,-2229
34,2022/7/15 20:00,14,92,-78,-2101
34,2022/7/15 20:10,11,78,-67,-1795
34,2022/7/15 20:20,11,83,-72,-1836
34,2022/7/15 20:30,10,73,-63,-1814
34,2022/7/15 20:40,7,69,-62,-1768
34,2022/7/15 20:50,8,77,-69,-1997
34,2022/7/15 21:00,9,77,-68,-1725
34,2022/7/15 21:10,11,66,-55,-1622
34,2022/7/15 21:20,9,59,-50,-1758
34,2022/7/15 21:30,0,28,-28,-1842
34,2022/7/15 21:40,0,67,-67,-1944
34,2022/7/15 21:50,0,72,-72,-1888
34,2022/7/15 22:00,0,3,-3,-1808
34,2022/7/15 22:10,0,68,-68,-2055
34,2022/7/15 22:20,0,69,-69,-1828
34,2022/7/15 22:30,0,59,-59,-1870
34,2022/7/15 22:40,0,4,-4,-1801
34,2022/7/15 22:50,0,55,-55,-1343
65,2022/7/15 5:00,0,1,-1,-1
65,2022/7/15 5:10,0,1,-1,-1
65,2022/7/15 5:20,0,1,-1,-1
65,2022/7/15 5:30,1,1,0,0
65,2022/7/15 5:40,19,1,18,18
65,2022/7/15 5:50,31,1,30,30
65,2022/7/15 6:00,24,1,23,23
65,2022/7/15 6:10,27,1,26,26
65,2022/7/15 6:20,38,1,37,37
65,2022/7/15 6:30,47,53,-6,-6
65,2022/7/15 6:40,58,38,20,20
65,2022/7/15 6:50,56,46,10,10
65,2022/7/15 7:00,83,78,5,5
65,2022/7/15 7:10,150,102,48,48
65,2022/7/15 7:20,187,96,91,91
65,2022/7/15 7:30,223,109,114,114
65,2022/7/15 7:40,274,269,5,5
65,2022/7/15 7:50,282,297,-15,-15
65,2022/7/15 8:00,183,221,-38,-38
65,2022/7/15 8:10,146,324,-178,-178
65,2022/7/15 8:20,79,425,-346,-346
65,2022/7/15 8:30,60,486,-426,-426
65,2022/7/15 8:40,54,231,-177,-177
65,2022/7/15 8:50,51,120,-69,-69
65,2022/7/15 9:00,36,112,-76,-76
65,2022/7/15 9:10,28,99,-71,-71
65,2022/7/15 9:20,32,90,-58,-58
65,2022/7/15 9:30,23,96,-73,-73
65,2022/7/15 9:40,27,71,-44,-44
65,2022/7/15 9:50,22,77,-55,-55
65,2022/7/15 10:00,22,72,-50,-50
65,2022/7/15 10:10,27,57,-30,-30
65,2022/7/15 10:20,25,67,-42,-42
65,2022/7/15 10:30,21,65,-44,-44
65,2022/7/15 10:40,21,62,-41,-41
65,2022/7/15 10:50,24,69,-45,-45
65,2022/7/15 11:00,27,67,-40,-40
65,2022/7/15 11:10,28,59,-31,-31
65,2022/7/15 11:20,20,65,-45,-45
65,2022/7/15 11:30,26,65,-39,-39
65,2022/7/15 11:40,28,62,-34,-34
65,2022/7/15 11:50,27,73,-46,-46
65,2022/7/15 12:00,26,71,-45,-45
65,2022/7/15 12:10,33,65,-32,-32
65,2022/7/15 12:20,30,74,-44,-44
65,2022/7/15 12:30,39,66,-27,-27
65,2022/7/15 12:40,30,69,-39,-39
65,2022/7/15 12:50,30,68,-38,-38
65,2022/7/15 13:00,22,68,-46,-46
65,2022/7/15 13:10,26,75,-49,-49
65,2022/7/15 13:20,24,71,-47,-47
65,2022/7/15 13:30,24,62,-38,-38
65,2022/7/15 13:40,23,67,-44,-44
65,2022/7/15 13:50,24,71,-47,-47
65,2022/7/15 14:00,21,73,-52,-52
65,2022/7/15 14:10,20,68,-48,-48
65,2022/7/15 14:20,24,67,-43,-43
65,2022/7/15 14:30,21,71,-50,-50
65,2022/7/15 14:40,24,68,-44,-44
65,2022/7/15 14:50,23,67,-44,-44
65,2022/7/15 15:00,26,62,-36,-36
65,2022/7/15 15:10,23,73,-50,-50
65,2022/7/15 15:20,21,66,-45,-45
65,2022/7/15 15:30,24,65,-41,-41
65,2022/7/15 15:40,30,69,-39,-39
65,2022/7/15 15:50,31,69,-38,-38
65,2022/7/15 16:00,35,86,-51,-51
65,2022/7/15 16:10,45,75,-30,-30
65,2022/7/15 16:20,62,83,-21,-21
65,2022/7/15 16:30,41,92,-51,-51
65,2022/7/15 16:40,57,76,-19,-19
65,2022/7/15 16:50,73,82,-9,-9
65,2022/7/15 17:00,73,87,-14,-14
65,2022/7/15 17:10,128,90,38,38
65,2022/7/15 17:20,137,92,45,45
65,2022/7/15 17:30,96,101,-5,-5
65,2022/7/15 17:40,257,106,151,151
65,2022/7/15 17:50,302,109,193,193
65,2022/7/15 18:00,236,107,129,129
65,2022/7/15 18:10,163,118,45,45
65,2022/7/15 18:20,90,109,-19,-19
65,2022/7/15 18:30,70,123,-53,-53
65,2022/7/15 18:40,43,111,-68,-68
65,2022/7/15 18:50,39,110,-71,-71
65,2022/7/15 19:00,31,113,-82,-82
65,2022/7/15 19:10,34,109,-75,-75
65,2022/7/15 19:20,35,105,-70,-70
65,2022/7/15 19:30,29,117,-88,-88
65,2022/7/15 19:40,28,114,-86,-86
65,2022/7/15 19:50,28,106,-78,-78
65,2022/7/15 20:00,29,104,-75,-75
65,2022/7/15 20:10,28,86,-58,-58
65,2022/7/15 20:20,27,99,-72,-72
65,2022/7/15 20:30,27,92,-65,-65
65,2022/7/15 20:40,27,79,-52,-52
65,2022/7/15 20:50,27,74,-47,-47
65,2022/7/15 21:00,28,100,-72,-72
65,2022/7/15 21:10,27,85,-58,-58
65,2022/7/15 21:20,23,73,-50,-50
65,2022/7/15 21:30,25,92,-67,-67
65,2022/7/15 21:40,21,77,-56,-56
65,2022/7/15 21:50,12,77,-65,-65
65,2022/7/15 22:00,0,85,-85,-85
65,2022/7/15 22:10,0,78,-78,-78
65,2022/7/15 22:20,0,71,-71,-71
65,2022/7/15 22:30,0,66,-66,-66
65,2022/7/15 22:40,0,65,-65,-65
65,2022/7/15 22:50,0,47,-47,-47
70,2022/7/15 5:00,0,1,-1,-2
70,2022/7/15 5:10,0,1,-1,-2
70,2022/7/15 5:20,0,1,-1,-2
70,2022/7/15 5:30,0,1,-1,-1
70,2022/7/15 5:40,4,1,3,21
70,2022/7/15 5:50,13,1,12,42
70,2022/7/15 6:00,12,1,11,34
70,2022/7/15 6:10,17,1,16,42
70,2022/7/15 6:20,32,1,31,68
70,2022/7/15 6:30,31,33,-2,-8
70,2022/7/15 6:40,29,31,-2,18
70,2022/7/15 6:50,32,7,25,35
70,2022/7/15 7:00,52,22,30,35
70,2022/7/15 7:10,57,48,9,57
70,2022/7/15 7:20,55,75,-20,71
70,2022/7/15 7:30,64,64,0,114
70,2022/7/15 7:40,69,93,-24,-19
70,2022/7/15 7:50,76,98,-22,-37
70,2022/7/15 8:00,72,213,-141,-179
70,2022/7/15 8:10,57,128,-71,-249
70,2022/7/15 8:20,45,75,-30,-376
70,2022/7/15 8:30,48,87,-39,-465
70,2022/7/15 8:40,28,111,-83,-260
70,2022/7/15 8:50,25,71,-46,-115
70,2022/7/15 9:00,25,59,-34,-110
70,2022/7/15 9:10,15,63,-48,-119
70,2022/7/15 9:20,15,65,-50,-108
70,2022/7/15 9:30,22,47,-25,-98
70,2022/7/15 9:40,12,38,-26,-70
70,2022/7/15 9:50,16,38,-22,-77
70,2022/7/15 10:00,14,32,-18,-68
70,2022/7/15 10:10,14,25,-11,-41
70,2022/7/15 10:20,15,31,-16,-58
70,2022/7/15 10:30,12,38,-26,-70
70,2022/7/15 10:40,14,21,-7,-48
70,2022/7/15 10:50,13,19,-6,-51
70,2022/7/15 11:00,15,21,-6,-46
70,2022/7/15 11:10,16,19,-3,-34
70,2022/7/15 11:20,15,23,-8,-53
70,2022/7/15 11:30,16,25,-9,-48
70,2022/7/15 11:40,16,21,-5,-39
70,2022/7/15 11:50,15,23,-8,-54
70,2022/7/15 12:00,19,23,-4,-49
70,2022/7/15 12:10,13,23,-10,-42
70,2022/7/15 12:20,16,25,-9,-53
70,2022/7/15 12:30,19,31,-12,-39
70,2022/7/15 12:40,22,31,-9,-48
70,2022/7/15 12:50,12,30,-18,-56
70,2022/7/15 13:00,18,23,-5,-51
70,2022/7/15 13:10,16,23,-7,-56
70,2022/7/15 13:20,16,23,-7,-54
70,2022/7/15 13:30,12,23,-11,-49
70,2022/7/15 13:40,16,29,-13,-57
70,2022/7/15 13:50,15,21,-6,-53
70,2022/7/15 14:00,13,23,-10,-62
70,2022/7/15 14:10,16,23,-7,-55
70,2022/7/15 14:20,17,23,-6,-49
70,2022/7/15 14:30,16,19,-3,-53
70,2022/7/15 14:40,21,21,0,-44
70,2022/7/15 14:50,17,22,-5,-49
70,2022/7/15 15:00,16,23,-7,-43
70,2022/7/15 15:10,21,23,-2,-52
70,2022/7/15 15:20,19,21,-2,-47
70,2022/7/15 15:30,24,23,1,-40
70,2022/7/15 15:40,20,23,-3,-42
70,2022/7/15 15:50,22,25,-3,-41
70,2022/7/15 16:00,22,23,-1,-52
70,2022/7/15 16:10,24,23,1,-29
70,2022/7/15 16:20,25,23,2,-19
70,2022/7/15 16:30,34,23,11,-40
70,2022/7/15 16:40,35,30,5,-14
70,2022/7/15 16:50,36,33,3,-6
70,2022/7/15 17:00,52,33,19,5
70,2022/7/15 17:10,203,38,165,203
70,2022/7/15 17:20,70,35,35,80
70,2022/7/15 17:30,45,52,-7,-12
70,2022/7/15 17:40,47,32,15,166
70,2022/7/15 17:50,43,48,-5,188
70,2022/7/15 18:00,26,52,-26,103
70,2022/7/15 18:10,28,51,-23,22
70,2022/7/15 18:20,28,63,-35,-54
70,2022/7/15 18:30,22,64,-42,-95
70,2022/7/15 18:40,16,61,-45,-113
70,2022/7/15 18:50,20,67,-47,-118
70,2022/7/15 19:00,15,47,-32,-114
70,2022/7/15 19:10,12,45,-33,-108
70,2022/7/15 19:20,14,51,-37,-107
70,2022/7/15 19:30,12,47,-35,-123
70,2022/7/15 19:40,13,29,-16,-102
70,2022/7/15 19:50,12,47,-35,-113
70,2022/7/15 20:00,12,38,-26,-101
70,2022/7/15 20:10,10,30,-20,-78
70,2022/7/15 20:20,8,25,-17,-89
70,2022/7/15 20:30,7,34,-27,-92
70,2022/7/15 20:40,7,23,-16,-68
70,2022/7/15 20:50,9,34,-25,-72
70,2022/7/15 21:00,5,21,-16,-88
70,2022/7/15 21:10,6,25,-19,-77
70,2022/7/15 21:20,4,21,-17,-67
70,2022/7/15 21:30,2,27,-25,-92
70,2022/7/15 21:40,4,23,-19,-75
70,2022/7/15 21:50,2,22,-20,-85
70,2022/7/15 22:00,1,23,-22,-107
70,2022/7/15 22:10,0,25,-25,-103
70,2022/7/15 22:20,0,25,-25,-96
70,2022/7/15 22:30,0,23,-23,-89
70,2022/7/15 22:40,0,25,-25,-90
70,2022/7/15 22:50,0,13,-13,-60
66,2022/7/15 5:00,0,1,-1,-3
66,2022/7/15 5:10,0,1,-1,-3
66,2022/7/15 5:20,0,1,-1,-3
66,2022/7/15 5:30,0,1,-1,-2
66,2022/7/15 5:40,6,1,5,26
66,2022/7/15 5:50,20,1,19,61
66,2022/7/15 6:00,32,1,31,65
66,2022/7/15 6:10,32,1,31,73
66,2022/7/15 6:20,32,33,-1,67
66,2022/7/15 6:30,58,19,39,31
66,2022/7/15 6:40,60,29,31,49
66,2022/7/15 6:50,67,48,19,54
66,2022/7/15 7:00,99,6,93,128
66,2022/7/15 7:10,187,91,96,153
66,2022/7/15 7:20,207,76,131,202
66,2022/7/15 7:30,274,89,185,299
66,2022/7/15 7:40,302,89,213,194
66,2022/7/15 7:50,343,181,162,125
66,2022/7/15 8:00,327,99,228,49
66,2022/7/15 8:10,276,105,171,-78
66,2022/7/15 8:20,234,91,143,-233
66,2022/7/15 8:30,183,113,70,-395
66,2022/7/15 8:40,81,60,21,-239
66,2022/7/15 8:50,59,51,8,-107
66,2022/7/15 9:00,44,46,-2,-112
66,2022/7/15 9:10,38,72,-34,-153
66,2022/7/15 9:20,32,49,-17,-125
66,2022/7/15 9:30,31,63,-32,-130
66,2022/7/15 9:40,28,47,-19,-89
66,2022/7/15 9:50,25,42,-17,-94
66,2022/7/15 10:00,22,47,-25,-93
66,2022/7/15 10:10,26,44,-18,-59
66,2022/7/15 10:20,19,41,-22,-80
66,2022/7/15 10:30,19,31,-12,-82
66,2022/7/15 10:40,20,40,-20,-68
66,2022/7/15 10:50,20,38,-18,-69
66,2022/7/15 11:00,17,32,-15,-61
66,2022/7/15 11:10,17,39,-22,-56
66,2022/7/15 11:20,19,45,-26,-79
66,2022/7/15 11:30,19,38,-19,-67
66,2022/7/15 11:40,18,41,-23,-62
66,2022/7/15 11:50,22,42,-20,-74
66,2022/7/15 12:00,23,40,-17,-66
66,2022/7/15 12:10,21,47,-26,-68
66,2022/7/15 12:20,26,38,-12,-65
66,2022/7/15 12:30,21,47,-26,-65
66,2022/7/15 12:40,22,45,-23,-71
66,2022/7/15 12:50,20,50,-30,-86
66,2022/7/15 13:00,19,45,-26,-77
66,2022/7/15 13:10,18,42,-24,-80
66,2022/7/15 13:20,19,46,-27,-81
66,2022/7/15 13:30,16,46,-30,-79
66,2022/7/15 13:40,20,50,-30,-87
66,2022/7/15 13:50,21,47,-26,-79
66,2022/7/15 14:00,18,49,-31,-93
66,2022/7/15 14:10,17,50,-33,-88
66,2022/7/15 14:20,16,47,-31,-80
66,2022/7/15 14:30,18,51,-33,-86
66,2022/7/15 14:40,16,57,-41,-85
66,2022/7/15 14:50,14,51,-37,-86
66,2022/7/15 15:00,19,57,-38,-81
66,2022/7/15 15:10,14,58,-44,-96
66,2022/7/15 15:20,19,61,-42,-89
66,2022/7/15 15:30,20,62,-42,-82
66,2022/7/15 15:40,22,66,-44,-86
66,2022/7/15 15:50,24,59,-35,-76
66,2022/7/15 16:00,24,67,-43,-95
66,2022/7/15 16:10,25,68,-43,-72
66,2022/7/15 16:20,28,65,-37,-56
66,2022/7/15 16:30,30,65,-35,-75
66,2022/7/15 16:40,32,70,-38,-52
66,2022/7/15 16:50,30,75,-45,-51
66,2022/7/15 17:00,63,98,-35,-30
66,2022/7/15 17:10,70,90,-20,183
66,2022/7/15 17:20,73,99,-26,54
66,2022/7/15 17:30,43,89,-46,-58
66,2022/7/15 17:40,39,111,-72,94
66,2022/7/15 17:50,29,118,-89,99
66,2022/7/15 18:00,28,123,-95,8
66,2022/7/15 18:10,28,112,-84,-62
66,2022/7/15 18:20,28,109,-81,-135
66,2022/7/15 18:30,27,111,-84,-179
66,2022/7/15 18:40,19,109,-90,-203
66,2022/7/15 18:50,19,104,-85,-203
66,2022/7/15 19:00,21,107,-86,-200
66,2022/7/15 19:10,18,109,-91,-199
66,2022/7/15 19:20,17,122,-105,-212
66,2022/7/15 19:30,14,107,-93,-216
66,2022/7/15 19:40,15,102,-87,-189
66,2022/7/15 19:50,15,94,-79,-192
66,2022/7/15 20:00,12,78,-66,-167
66,2022/7/15 20:10,13,79,-66,-144
66,2022/7/15 20:20,12,64,-52,-141
66,2022/7/15 20:30,11,79,-68,-160
66,2022/7/15 20:40,12,84,-72,-140
66,2022/7/15 20:50,11,62,-51,-123
66,2022/7/15 21:00,10,56,-46,-134
66,2022/7/15 21:10,9,72,-63,-140
66,2022/7/15 21:20,10,72,-62,-129
66,2022/7/15 21:30,6,73,-67,-159
66,2022/7/15 21:40,6,71,-65,-140
66,2022/7/15 21:50,6,72,-66,-151
66,2022/7/15 22:00,1,59,-58,-165
66,2022/7/15 22:10,0,64,-64,-167
66,2022/7/15 22:20,0,63,-63,-159
66,2022/7/15 22:30,0,68,-68,-157
66,2022/7/15 22:40,0,63,-63,-153
66,2022/7/15 22:50,0,3,-3,-63
72,2022/7/15 5:00,0,1,-1,-4
72,2022/7/15 5:10,0,1,-1,-4
72,2022/7/15 5:20,0,1,-1,-4
72,2022/7/15 5:30,0,1,-1,-3
72,2022/7/15 5:40,3,1,2,28
72,2022/7/15 5:50,11,1,10,71
72,2022/7/15 6:00,31,1,30,95
72,2022/7/15 6:10,30,1,29,102
72,2022/7/15 6:20,37,19,18,85
72,2022/7/15 6:30,44,19,25,56
72,2022/7/15 6:40,60,38,22,71
72,2022/7/15 6:50,76,47,29,83
72,2022/7/15 7:00,85,41,44,172
72,2022/7/15 7:10,155,39,116,269
72,2022/7/15 7:20,236,51,185,387
72,2022/7/15 7:30,281,48,233,532
72,2022/7/15 7:40,278,70,208,402
72,2022/7/15 7:50,331,63,268,393
72,2022/7/15 8:00,346,53,293,342
72,2022/7/15 8:10,303,54,249,171
72,2022/7/15 8:20,244,76,168,-65
72,2022/7/15 8:30,195,62,133,-262
72,2022/7/15 8:40,86,47,39,-200
72,2022/7/15 8:50,72,47,25,-82
72,2022/7/15 9:00,48,56,-8,-120
72,2022/7/15 9:10,37,41,-4,-157
72,2022/7/15 9:20,30,50,-20,-145
72,2022/7/15 9:30,28,38,-10,-140
72,2022/7/15 9:40,24,41,-17,-106
72,2022/7/15 9:50,27,38,-11,-105
72,2022/7/15 10:00,25,23,2,-91
72,2022/7/15 10:10,22,47,-25,-84
72,2022/7/15 10:20,21,31,-10,-90
72,2022/7/15 10:30,18,38,-20,-102
72,2022/7/15 10:40,18,38,-20,-88
72,2022/7/15 10:50,18,36,-18,-87
72,2022/7/15 11:00,16,33,-17,-78
72,2022/7/15 11:10,18,38,-20,-76
72,2022/7/15 11:20,18,38,-20,-99
72,2022/7/15 11:30,17,39,-22,-89
72,2022/7/15 11:40,17,38,-21,-83
72,2022/7/15 11:50,20,46,-26,-100
72,2022/7/15 12:00,22,42,-20,-86
72,2022/7/15 12:10,22,38,-16,-84
72,2022/7/15 12:20,21,38,-17,-82
72,2022/7/15 12:30,19,46,-27,-92
72,2022/7/15 12:40,23,38,-15,-86
72,2022/7/15 12:50,17,38,-21,-107
72,2022/7/15 13:00,17,41,-24,-101
72,2022/7/15 13:10,19,47,-28,-108
72,2022/7/15 13:20,13,47,-34,-115
72,2022/7/15 13:30,15,42,-27,-106
72,2022/7/15 13:40,18,50,-32,-119
72,2022/7/15 13:50,17,41,-24,-103
72,2022/7/15 14:00,17,44,-27,-120
72,2022/7/15 14:10,15,49,-34,-122
72,2022/7/15 14:20,13,48,-35,-115
72,2022/7/15 14:30,14,50,-36,-122
72,2022/7/15 14:40,15,45,-30,-115
72,2022/7/15 14:50,16,57,-41,-127
72,2022/7/15 15:00,10,57,-47,-128
72,2022/7/15 15:10,15,57,-42,-138
72,2022/7/15 15:20,16,57,-41,-130
72,2022/7/15 15:30,16,62,-46,-128
72,2022/7/15 15:40,17,62,-45,-131
72,2022/7/15 15:50,14,62,-48,-124
72,2022/7/15 16:00,17,66,-49,-144
72,2022/7/15 16:10,20,71,-51,-123
72,2022/7/15 16:20,22,72,-50,-106
72,2022/7/15 16:30,25,68,-43,-118
72,2022/7/15 16:40,27,71,-44,-96
72,2022/7/15 16:50,35,82,-47,-98
72,2022/7/15 17:00,37,76,-39,-69
72,2022/7/15 17:10,43,90,-47,136
72,2022/7/15 17:20,33,104,-71,-17
72,2022/7/15 17:30,28,118,-90,-148
72,2022/7/15 17:40,26,117,-91,3
72,2022/7/15 17:50,33,116,-83,16
72,2022/7/15 18:00,39,110,-71,-63
72,2022/7/15 18:10,25,132,-107,-169
72,2022/7/15 18:20,26,133,-107,-242
72,2022/7/15 18:30,21,121,-100,-279
72,2022/7/15 18:40,19,124,-105,-308
72,2022/7/15 18:50,17,107,-90,-293
72,2022/7/15 19:00,14,107,-93,-293
72,2022/7/15 19:10,18,106,-88,-287
72,2022/7/15 19:20,15,120,-105,-317
72,2022/7/15 19:30,14,117,-103,-319
72,2022/7/15 19:40,15,102,-87,-276
72,2022/7/15 19:50,15,94,-79,-271
72,2022/7/15 20:00,20,79,-59,-226
72,2022/7/15 20:10,15,78,-63,-207
72,2022/7/15 20:20,13,80,-67,-208
72,2022/7/15 20:30,17,75,-58,-218
72,2022/7/15 20:40,15,70,-55,-195
72,2022/7/15 20:50,13,64,-51,-174
72,2022/7/15 21:00,14,71,-57,-191
72,2022/7/15 21:10,16,73,-57,-197
72,2022/7/15 21:20,14,75,-61,-190
72,2022/7/15 21:30,12,73,-61,-220
72,2022/7/15 21:40,12,74,-62,-202
72,2022/7/15 21:50,9,75,-66,-217
72,2022/7/15 22:00,6,71,-65,-230
72,2022/7/15 22:10,0,64,-64,-231
72,2022/7/15 22:20,0,65,-65,-224
72,2022/7/15 22:30,0,56,-56,-213
72,2022/7/15 22:40,0,40,-40,-193
72,2022/7/15 22:50,0,3,-3,-66
67,2022/7/15 5:00,0,1,-1,-5
67,2022/7/15 5:10,0,1,-1,-5
67,2022/7/15 5:20,0,1,-1,-5
67,2022/7/15 5:30,0,1,-1,-4
67,2022/7/15 5:40,2,1,1,29
67,2022/7/15 5:50,6,1,5,76
67,2022/7/15 6:00,20,1,19,114
67,2022/7/15 6:10,20,5,15,117
67,2022/7/15 6:20,27,23,4,89
67,2022/7/15 6:30,33,23,10,66
67,2022/7/15 6:40,40,37,3,74
67,2022/7/15 6:50,47,49,-2,81
67,2022/7/15 7:00,76,34,42,214
67,2022/7/15 7:10,130,57,73,342
67,2022/7/15 7:20,193,63,130,517
67,2022/7/15 7:30,235,77,158,690
67,2022/7/15 7:40,278,99,179,581
67,2022/7/15 7:50,349,82,267,660
67,2022/7/15 8:00,330,69,261,603
67,2022/7/15 8:10,281,76,205,376
67,2022/7/15 8:20,240,69,171,106
67,2022/7/15 8:30,184,83,101,-161
67,2022/7/15 8:40,87,57,30,-170
67,2022/7/15 8:50,71,53,18,-64
67,2022/7/15 9:00,42,52,-10,-130
67,2022/7/15 9:10,29,51,-22,-179
67,2022/7/15 9:20,30,35,-5,-150
67,2022/7/15 9:30,28,41,-13,-153
67,2022/7/15 9:40,22,32,-10,-116
67,2022/7/15 9:50,22,32,-10,-115
67,2022/7/15 10:00,19,29,-10,-101
67,2022/7/15 10:10,18,23,-5,-89
67,2022/7/15 10:20,15,31,-16,-106
67,2022/7/15 10:30,14,30,-16,-118
67,2022/7/15 10:40,16,33,-17,-105
67,2022/7/15 10:50,15,32,-17,-104
67,2022/7/15 11:00,14,32,-18,-96
67,2022/7/15 11:10,13,37,-24,-100
67,2022/7/15 11:20,12,38,-26,-125
67,2022/7/15 11:30,13,37,-24,-113
67,2022/7/15 11:40,14,38,-24,-107
67,2022/7/15 11:50,15,37,-22,-122
67,2022/7/15 12:00,15,40,-25,-111
67,2022/7/15 12:10,17,38,-21,-105
67,2022/7/15 12:20,18,38,-20,-102
67,2022/7/15 12:30,19,40,-21,-113
67,2022/7/15 12:40,14,42,-28,-114
67,2022/7/15 12:50,15,40,-25,-132
67,2022/7/15 13:00,14,33,-19,-120
67,2022/7/15 13:10,13,38,-25,-133
67,2022/7/15 13:20,12,38,-26,-141
67,2022/7/15 13:30,13,38,-25,-131
67,2022/7/15 13:40,13,43,-30,-149
67,2022/7/15 13:50,13,37,-24,-127
67,2022/7/15 14:00,10,48,-38,-158
67,2022/7/15 14:10,9,47,-38,-160
67,2022/7/15 14:20,12,45,-33,-148
67,2022/7/15 14:30,11,45,-34,-156
67,2022/7/15 14:40,11,41,-30,-145
67,2022/7/15 14:50,11,50,-39,-166
67,2022/7/15 15:00,11,52,-41,-169
67,2022/7/15 15:10,13,55,-42,-180
67,2022/7/15 15:20,11,51,-40,-170
67,2022/7/15 15:30,13,54,-41,-169
67,2022/7/15 15:40,11,63,-52,-183
67,2022/7/15 15:50,13,57,-44,-168
67,2022/7/15 16:00,12,66,-54,-198
67,2022/7/15 16:10,15,66,-51,-174
67,2022/7/15 16:20,16,69,-53,-159
67,2022/7/15 16:30,17,70,-53,-171
67,2022/7/15 16:40,21,69,-48,-144
67,2022/7/15 16:50,21,70,-49,-147
67,2022/7/15 17:00,24,92,-68,-137
67,2022/7/15 17:10,26,98,-72,64
67,2022/7/15 17:20,26,96,-70,-87
67,2022/7/15 17:30,24,117,-93,-241
67,2022/7/15 17:40,28,116,-88,-85
67,2022/7/15 17:50,32,109,-77,-61
67,2022/7/15 18:00,41,133,-92,-155
67,2022/7/15 18:10,26,143,-117,-286
67,2022/7/15 18:20,22,117,-95,-337
67,2022/7/15 18:30,19,111,-92,-371
67,2022/7/15 18:40,17,117,-100,-408
67,2022/7/15 18:50,12,111,-99,-392
67,2022/7/15 19:00,12,112,-100,-393
67,2022/7/15 19:10,12,123,-111,-398
67,2022/7/15 19:20,12,91,-79,-396
67,2022/7/15 19:30,13,105,-92,-411
67,2022/7/15 19:40,12,95,-83,-359
67,2022/7/15 19:50,12,79,-67,-338
67,2022/7/15 20:00,10,78,-68,-294
67,2022/7/15 20:10,12,76,-64,-271
67,2022/7/15 20:20,11,72,-61,-269
67,2022/7/15 20:30,10,71,-61,-279
67,2022/7/15 20:40,10,57,-47,-242
67,2022/7/15 20:50,10,77,-67,-241
67,2022/7/15 21:00,11,73,-62,-253
67,2022/7/15 21:10,9,67,-58,-255
67,2022/7/15 21:20,10,73,-63,-253
67,2022/7/15 21:30,8,62,-54,-274
67,2022/7/15 21:40,6,62,-56,-258
67,2022/7/15 21:50,3,74,-71,-288
67,2022/7/15 22:00,4,59,-55,-285
67,2022/7/15 22:10,2,62,-60,-291
67,2022/7/15 22:20,2,67,-65,-289
67,2022/7/15 22:30,1,50,-49,-262
67,2022/7/15 22:40,0,49,-49,-242
67,2022/7/15 22:50,0,3,-3,-69
61,2022/7/15 5:00,0,1,-1,-6
61,2022/7/15 5:10,0,1,-1,-6
61,2022/7/15 5:20,0,1,-1,-6
61,2022/7/15 5:30,0,1,-1,-5
61,2022/7/15 5:40,1,1,0,29
61,2022/7/15 5:50,5,1,4,80
61,2022/7/15 6:00,26,1,25,139
61,2022/7/15 6:10,37,5,32,149
61,2022/7/15 6:20,41,21,20,109
61,2022/7/15 6:30,54,21,33,99
61,2022/7/15 6:40,60,23,37,111
61,2022/7/15 6:50,81,45,36,117
61,2022/7/15 7:00,151,47,104,318
61,2022/7/15 7:10,185,49,136,478
61,2022/7/15 7:20,236,51,185,702
61,2022/7/15 7:30,277,55,222,912
61,2022/7/15 7:40,303,51,252,833
61,2022/7/15 7:50,339,46,293,953
61,2022/7/15 8:00,359,41,318,921
61,2022/7/15 8:10,327,46,281,657
61,2022/7/15 8:20,283,44,239,345
61,2022/7/15 8:30,230,37,193,32
61,2022/7/15 8:40,127,37,90,-80
61,2022/7/15 8:50,87,24,63,-1
61,2022/7/15 9:00,53,29,24,-106
61,2022/7/15 9:10,48,29,19,-160
61,2022/7/15 9:20,34,37,-3,-153
61,2022/7/15 9:30,29,29,0,-153
61,2022/7/15 9:40,27,32,-5,-121
61,2022/7/15 9:50,28,32,-4,-119
61,2022/7/15 10:00,23,23,0,-101
61,2022/7/15 10:10,19,19,0,-89
61,2022/7/15 10:20,20,42,-22,-128
61,2022/7/15 10:30,18,32,-14,-132
61,2022/7/15 10:40,18,23,-5,-110
61,2022/7/15 10:50,15,29,-14,-118
61,2022/7/15 11:00,19,32,-13,-109
61,2022/7/15 11:10,15,33,-18,-118
61,2022/7/15 11:20,14,32,-18,-143
61,2022/7/15 11:30,15,38,-23,-136
61,2022/7/15 11:40,17,32,-15,-122
61,2022/7/15 11:50,18,38,-20,-142
61,2022/7/15 12:00,19,35,-16,-127
61,2022/7/15 12:10,21,34,-13,-118
61,2022/7/15 12:20,21,38,-17,-119
61,2022/7/15 12:30,17,38,-21,-134
61,2022/7/15 12:40,17,38,-21,-135
61,2022/7/15 12:50,18,38,-20,-152
61,2022/7/15 13:00,18,34,-16,-136
61,2022/7/15 13:10,15,32,-17,-150
61,2022/7/15 13:20,16,38,-22,-163
61,2022/7/15 13:30,17,38,-21,-152
61,2022/7/15 13:40,12,36,-24,-173
61,2022/7/15 13:50,14,46,-32,-159
61,2022/7/15 14:00,13,38,-25,-183
61,2022/7/15 14:10,16,46,-30,-190
61,2022/7/15 14:20,13,47,-34,-182
61,2022/7/15 14:30,14,43,-29,-185
61,2022/7/15 14:40,12,45,-33,-178
61,2022/7/15 14:50,14,51,-37,-203
61,2022/7/15 15:00,13,42,-29,-198
61,2022/7/15 15:10,14,56,-42,-222
61,2022/7/15 15:20,15,49,-34,-204
61,2022/7/15 15:30,14,61,-47,-216
61,2022/7/15 15:40,14,61,-47,-230
61,2022/7/15 15:50,14,57,-43,-211
61,2022/7/15 16:00,16,71,-55,-253
61,2022/7/15 16:10,14,70,-56,-230
61,2022/7/15 16:20,17,75,-58,-217
61,2022/7/15 16:30,20,67,-47,-218
61,2022/7/15 16:40,27,77,-50,-194
61,2022/7/15 16:50,27,93,-66,-213
61,2022/7/15 17:00,29,90,-61,-198
61,2022/7/15 17:10,29,106,-77,-13
61,2022/7/15 17:20,22,102,-80,-167
61,2022/7/15 17:30,20,96,-76,-317
61,2022/7/15 17:40,14,110,-96,-181
61,2022/7/15 17:50,18,111,-93,-154
61,2022/7/15 18:00,15,104,-89,-244
61,2022/7/15 18:10,16,117,-101,-387
61,2022/7/15 18:20,14,117,-103,-440
61,2022/7/15 18:30,13,116,-103,-474
61,2022/7/15 18:40,13,121,-108,-516
61,2022/7/15 18:50,14,124,-110,-502
61,2022/7/15 19:00,12,106,-94,-487
61,2022/7/15 19:10,11,103,-92,-490
61,2022/7/15 19:20,11,107,-96,-492
61,2022/7/15 19:30,8,111,-103,-514
61,2022/7/15 19:40,8,91,-83,-442
61,2022/7/15 19:50,9,77,-68,-406
61,2022/7/15 20:00,9,76,-67,-361
61,2022/7/15 20:10,8,78,-70,-341
61,2022/7/15 20:20,9,77,-68,-337
61,2022/7/15 20:30,11,70,-59,-338
61,2022/7/15 20:40,6,85,-79,-321
61,2022/7/15 20:50,11,55,-44,-285
61,2022/7/15 21:00,8,68,-60,-313
61,2022/7/15 21:10,8,66,-58,-313
61,2022/7/15 21:20,5,72,-67,-320
61,2022/7/15 21:30,4,66,-62,-336
61,2022/7/15 21:40,4,61,-57,-315
61,2022/7/15 21:50,4,71,-67,-355
61,2022/7/15 22:00,2,71,-69,-354
61,2022/7/15 22:10,1,68,-67,-358
61,2022/7/15 22:20,0,49,-49,-338
61,2022/7/15 22:30,0,53,-53,-315
61,2022/7/15 22:40,0,36,-36,-278
61,2022/7/15 22:50,0,3,-3,-72
62,2022/7/15 5:00,0,1,-1,-7
62,2022/7/15 5:10,0,1,-1,-7
62,2022/7/15 5:20,0,1,-1,-7
62,2022/7/15 5:30,0,1,-1,-6
62,2022/7/15 5:40,0,1,-1,28
62,2022/7/15 5:50,1,1,0,80
62,2022/7/15 6:00,2,1,1,140
62,2022/7/15 6:10,6,22,-16,133
62,2022/7/15 6:20,6,38,-32,77
62,2022/7/15 6:30,8,42,-34,65
62,2022/7/15 6:40,8,75,-67,44
62,2022/7/15 6:50,10,66,-56,61
62,2022/7/15 7:00,16,111,-95,223
62,2022/7/15 7:10,18,64,-46,432
62,2022/7/15 7:20,10,46,-36,666
62,2022/7/15 7:30,12,34,-22,890
62,2022/7/15 7:40,14,63,-49,784
62,2022/7/15 7:50,18,61,-43,910
62,2022/7/15 8:00,19,69,-50,871
62,2022/7/15 8:10,15,62,-47,610
62,2022/7/15 8:20,14,67,-53,292
62,2022/7/15 8:30,12,33,-21,11
62,2022/7/15 8:40,11,42,-31,-111
62,2022/7/15 8:50,6,23,-17,-18
62,2022/7/15 9:00,4,23,-19,-125
62,2022/7/15 9:10,4,23,-19,-179
62,2022/7/15 9:20,4,25,-21,-174
62,2022/7/15 9:30,7,19,-12,-165
62,2022/7/15 9:40,2,21,-19,-140
62,2022/7/15 9:50,4,23,-19,-138
62,2022/7/15 10:00,6,23,-17,-118
62,2022/7/15 10:10,2,23,-21,-110
62,2022/7/15 10:20,5,19,-14,-142
62,2022/7/15 10:30,4,22,-18,-150
62,2022/7/15 10:40,4,19,-15,-125
62,2022/7/15 10:50,2,19,-17,-135
62,2022/7/15 11:00,7,17,-10,-119
62,2022/7/15 11:10,7,16,-9,-127
62,2022/7/15 11:20,5,16,-11,-154
62,2022/7/15 11:30,6,14,-8,-144
62,2022/7/15 11:40,5,15,-10,-132
62,2022/7/15 11:50,7,18,-11,-153
62,2022/7/15 12:00,4,15,-11,-138
62,2022/7/15 12:10,8,18,-10,-128
62,2022/7/15 12:20,5,19,-14,-133
62,2022/7/15 12:30,4,14,-10,-144
62,2022/7/15 12:40,4,14,-10,-145
62,2022/7/15 12:50,7,16,-9,-161
62,2022/7/15 13:00,6,19,-13,-149
62,2022/7/15 13:10,2,18,-16,-166
62,2022/7/15 13:20,7,21,-14,-177
62,2022/7/15 13:30,7,12,-5,-157
62,2022/7/15 13:40,6,15,-9,-182
62,2022/7/15 13:50,3,19,-16,-175
62,2022/7/15 14:00,5,16,-11,-194
62,2022/7/15 14:10,7,14,-7,-197
62,2022/7/15 14:20,6,16,-10,-192
62,2022/7/15 14:30,7,8,-1,-186
62,2022/7/15 14:40,4,8,-4,-182
62,2022/7/15 14:50,8,12,-4,-207
62,2022/7/15 15:00,9,12,-3,-201
62,2022/7/15 15:10,8,12,-4,-226
62,2022/7/15 15:20,9,12,-3,-207
62,2022/7/15 15:30,8,8,0,-216
62,2022/7/15 15:40,10,12,-2,-232
62,2022/7/15 15:50,8,16,-8,-219
62,2022/7/15 16:00,11,11,0,-253
62,2022/7/15 16:10,14,12,2,-228
62,2022/7/15 16:20,13,14,-1,-218
62,2022/7/15 16:30,26,8,18,-200
62,2022/7/15 16:40,51,23,28,-166
62,2022/7/15 16:50,32,23,9,-204
62,2022/7/15 17:00,30,21,9,-189
62,2022/7/15 17:10,26,19,7,-6
62,2022/7/15 17:20,20,23,-3,-170
62,2022/7/15 17:30,15,23,-8,-325
62,2022/7/15 17:40,15,23,-8,-189
62,2022/7/15 17:50,11,23,-12,-166
62,2022/7/15 18:00,13,32,-19,-263
62,2022/7/15 18:10,13,26,-13,-400
62,2022/7/15 18:20,12,27,-15,-455
62,2022/7/15 18:30,12,23,-11,-485
62,2022/7/15 18:40,14,25,-11,-527
62,2022/7/15 18:50,11,25,-14,-516
62,2022/7/15 19:00,10,25,-15,-502
62,2022/7/15 19:10,6,25,-19,-509
62,2022/7/15 19:20,4,21,-17,-509
62,2022/7/15 19:30,6,22,-16,-530
62,2022/7/15 19:40,5,13,-8,-450
62,2022/7/15 19:50,3,15,-12,-418
62,2022/7/15 20:00,2,15,-13,-374
62,2022/7/15 20:10,2,15,-13,-354
62,2022/7/15 20:20,2,8,-6,-343
62,2022/7/15 20:30,3,13,-10,-348
62,2022/7/15 20:40,2,13,-11,-332
62,2022/7/15 20:50,2,10,-8,-293
62,2022/7/15 21:00,2,13,-11,-324
62,2022/7/15 21:10,2,10,-8,-321
62,2022/7/15 21:20,2,13,-11,-331
62,2022/7/15 21:30,2,15,-13,-349
62,2022/7/15 21:40,1,10,-9,-324
62,2022/7/15 21:50,1,8,-7,-362
62,2022/7/15 22:00,2,10,-8,-362
62,2022/7/15 22:10,1,7,-6,-364
62,2022/7/15 22:20,0,8,-8,-346
62,2022/7/15 22:30,0,10,-10,-325
62,2022/7/15 22:40,0,3,-3,-281
62,2022/7/15 22:50,0,3,-3,-75
60,2022/7/15 5:00,0,1,-1,-8
60,2022/7/15 5:10,0,1,-1,-8
60,2022/7/15 5:20,0,1,-1,-8
60,2022/7/15 5:30,0,1,-1,-7
60,2022/7/15 5:40,3,1,2,30
60,2022/7/15 5:50,8,1,7,87
60,2022/7/15 6:00,20,1,19,159
60,2022/7/15 6:10,37,13,24,157
60,2022/7/15 6:20,35,21,14,91
60,2022/7/15 6:30,45,23,22,87
60,2022/7/15 6:40,53,21,32,76
60,2022/7/15 6:50,73,33,40,101
60,2022/7/15 7:00,99,38,61,284
60,2022/7/15 7:10,154,49,105,537
60,2022/7/15 7:20,196,62,134,800
60,2022/7/15 7:30,245,72,173,1063
60,2022/7/15 7:40,282,81,201,985
60,2022/7/15 7:50,360,90,270,1180
60,2022/7/15 8:00,343,90,253,1124
60,2022/7/15 8:10,279,103,176,786
60,2022/7/15 8:20,253,75,178,470
60,2022/7/15 8:30,192,64,128,139
60,2022/7/15 8:40,154,67,87,-24
60,2022/7/15 8:50,79,61,18,0
60,2022/7/15 9:00,52,54,-2,-127
60,2022/7/15 9:10,48,60,-12,-191
60,2022/7/15 9:20,40,45,-5,-179
60,2022/7/15 9:30,29,57,-28,-193
60,2022/7/15 9:40,28,50,-22,-162
60,2022/7/15 9:50,27,38,-11,-149
60,2022/7/15 10:00,28,45,-17,-135
60,2022/7/15 10:10,26,38,-12,-122
60,2022/7/15 10:20,20,42,-22,-164
60,2022/7/15 10:30,22,46,-24,-174
60,2022/7/15 10:40,19,46,-27,-152
60,2022/7/15 10:50,19,38,-19,-154
60,2022/7/15 11:00,22,38,-16,-135
60,2022/7/15 11:10,17,46,-29,-156
60,2022/7/15 11:20,22,45,-23,-177
60,2022/7/15 11:30,21,41,-20,-164
60,2022/7/15 11:40,22,46,-24,-156
60,2022/7/15 11:50,23,45,-22,-175
60,2022/7/15 12:00,24,41,-17,-155
60,2022/7/15 12:10,24,45,-21,-149
60,2022/7/15 12:20,26,44,-18,-151
60,2022/7/15 12:30,22,40,-18,-162
60,2022/7/15 12:40,23,48,-25,-170
60,2022/7/15 12:50,22,45,-23,-184
60,2022/7/15 13:00,23,51,-28,-177
60,2022/7/15 13:10,23,45,-22,-188
60,2022/7/15 13:20,20,48,-28,-205
60,2022/7/15 13:30,17,50,-33,-190
60,2022/7/15 13:40,21,50,-29,-211
60,2022/7/15 13:50,18,49,-31,-206
60,2022/7/15 14:00,20,45,-25,-219
60,2022/7/15 14:10,16,58,-42,-239
60,2022/7/15 14:20,18,49,-31,-223
60,2022/7/15 14:30,20,58,-38,-224
60,2022/7/15 14:40,20,54,-34,-216
60,2022/7/15 14:50,21,49,-28,-235
60,2022/7/15 15:00,19,54,-35,-236
60,2022/7/15 15:10,21,56,-35,-261
60,2022/7/15 15:20,23,61,-38,-245
60,2022/7/15 15:30,24,61,-37,-253
60,2022/7/15 15:40,19,59,-40,-272
60,2022/7/15 15:50,22,67,-45,-264
60,2022/7/15 16:00,27,69,-42,-295
60,2022/7/15 16:10,28,72,-44,-272
60,2022/7/15 16:20,25,72,-47,-265
60,2022/7/15 16:30,27,70,-43,-243
60,2022/7/15 16:40,28,73,-45,-211
60,2022/7/15 16:50,25,83,-58,-262
60,2022/7/15 17:00,41,76,-35,-224
60,2022/7/15 17:10,43,105,-62,-68
60,2022/7/15 17:20,31,102,-71,-241
60,2022/7/15 17:30,27,122,-95,-420
60,2022/7/15 17:40,25,121,-96,-285
60,2022/7/15 17:50,28,123,-95,-261
60,2022/7/15 18:00,28,111,-83,-346
60,2022/7/15 18:10,25,181,-156,-556
60,2022/7/15 18:20,24,143,-119,-574
60,2022/7/15 18:30,21,181,-160,-645
60,2022/7/15 18:40,23,124,-101,-628
60,2022/7/15 18:50,17,109,-92,-608
60,2022/7/15 19:00,17,109,-92,-594
60,2022/7/15 19:10,20,124,-104,-613
60,2022/7/15 19:20,17,104,-87,-596
60,2022/7/15 19:30,17,98,-81,-611
60,2022/7/15 19:40,13,93,-80,-530
60,2022/7/15 19:50,13,77,-64,-482
60,2022/7/15 20:00,13,83,-70,-444
60,2022/7/15 20:10,14,87,-73,-427
60,2022/7/15 20:20,13,64,-51,-394
60,2022/7/15 20:30,15,77,-62,-410
60,2022/7/15 20:40,14,73,-59,-391
60,2022/7/15 20:50,14,71,-57,-350
60,2022/7/15 21:00,13,71,-58,-382
60,2022/7/15 21:10,12,84,-72,-393
60,2022/7/15 21:20,11,71,-60,-391
60,2022/7/15 21:30,8,70,-62,-411
60,2022/7/15 21:40,8,78,-70,-394
60,2022/7/15 21:50,9,83,-74,-436
60,2022/7/15 22:00,6,70,-64,-426
60,2022/7/15 22:10,5,67,-62,-426
60,2022/7/15 22:20,1,74,-73,-419
60,2022/7/15 22:30,2,49,-47,-372
60,2022/7/15 22:40,0,3,-3,-284
60,2022/7/15 22:50,0,3,-3,-78
68,2022/7/15 5:00,0,1,-1,-9
68,2022/7/15 5:10,0,1,-1,-9
68,2022/7/15 5:20,0,1,-1,-9
68,2022/7/15 5:30,0,1,-1,-8
68,2022/7/15 5:40,0,1,-1,29
68,2022/7/15 5:50,6,1,5,92
68,2022/7/15 6:00,22,1,21,180
68,2022/7/15 6:10,35,16,19,176
68,2022/7/15 6:20,42,32,10,101
68,2022/7/15 6:30,54,37,17,104
68,2022/7/15 6:40,61,45,16,92
68,2022/7/15 6:50,87,52,35,136
68,2022/7/15 7:00,156,72,84,368
68,2022/7/15 7:10,234,73,161,698
68,2022/7/15 7:20,238,105,133,933
68,2022/7/15 7:30,319,90,229,1292
68,2022/7/15 7:40,573,123,450,1435
68,2022/7/15 7:50,590,108,482,1662
68,2022/7/15 8:00,599,192,407,1531
68,2022/7/15 8:10,597,121,476,1262
68,2022/7/15 8:20,337,192,145,615
68,2022/7/15 8:30,277,152,125,264
68,2022/7/15 8:40,227,336,-109,-133
68,2022/7/15 8:50,184,150,34,34
68,2022/7/15 9:00,120,226,-106,-233
68,2022/7/15 9:10,61,159,-98,-289
68,2022/7/15 9:20,51,179,-128,-307
68,2022/7/15 9:30,40,125,-85,-278
68,2022/7/15 9:40,38,105,-67,-229
68,2022/7/15 9:50,31,112,-81,-230
68,2022/7/15 10:00,31,76,-45,-180
68,2022/7/15 10:10,33,77,-44,-166
68,2022/7/15 10:20,32,76,-44,-208
68,2022/7/15 10:30,26,77,-51,-225
68,2022/7/15 10:40,28,69,-41,-193
68,2022/7/15 10:50,28,74,-46,-200
68,2022/7/15 11:00,30,71,-41,-176
68,2022/7/15 11:10,26,66,-40,-196
68,2022/7/15 11:20,30,66,-36,-213
68,2022/7/15 11:30,28,69,-41,-205
68,2022/7/15 11:40,30,66,-36,-192
68,2022/7/15 11:50,32,72,-40,-215
68,2022/7/15 12:00,30,62,-32,-187
68,2022/7/15 12:10,36,64,-28,-177
68,2022/7/15 12:20,33,62,-29,-180
68,2022/7/15 12:30,33,74,-41,-203
68,2022/7/15 12:40,35,74,-39,-209
68,2022/7/15 12:50,28,71,-43,-227
68,2022/7/15 13:00,29,82,-53,-230
68,2022/7/15 13:10,29,82,-53,-241
68,2022/7/15 13:20,26,85,-59,-264
68,2022/7/15 13:30,35,65,-30,-220
68,2022/7/15 13:40,29,74,-45,-256
68,2022/7/15 13:50,28,81,-53,-259
68,2022/7/15 14:00,25,72,-47,-266
68,2022/7/15 14:10,26,62,-36,-275
68,2022/7/15 14:20,29,69,-40,-263
68,2022/7/15 14:30,30,66,-36,-260
68,2022/7/15 14:40,32,74,-42,-258
68,2022/7/15 14:50,31,76,-45,-280
68,2022/7/15 15:00,29,81,-52,-288
68,2022/7/15 15:10,31,69,-38,-299
68,2022/7/15 15:20,35,82,-47,-292
68,2022/7/15 15:30,28,83,-55,-308
68,2022/7/15 15:40,32,84,-52,-324
68,2022/7/15 15:50,33,78,-45,-309
68,2022/7/15 16:00,40,76,-36,-331
68,2022/7/15 16:10,35,90,-55,-327
68,2022/7/15 16:20,36,90,-54,-319
68,2022/7/15 16:30,43,92,-49,-292
68,2022/7/15 16:40,45,97,-52,-263
68,2022/7/15 16:50,43,104,-61,-323
68,2022/7/15 17:00,198,125,73,-151
68,2022/7/15 17:10,144,122,22,-46
68,2022/7/15 17:20,70,110,-40,-281
68,2022/7/15 17:30,103,191,-88,-508
68,2022/7/15 17:40,204,191,13,-272
68,2022/7/15 17:50,149,178,-29,-290
68,2022/7/15 18:00,143,215,-72,-418
68,2022/7/15 18:10,217,257,-40,-596
68,2022/7/15 18:20,137,219,-82,-656
68,2022/7/15 18:30,110,223,-113,-758
68,2022/7/15 18:40,88,214,-126,-754
68,2022/7/15 18:50,60,191,-131,-739
68,2022/7/15 19:00,45,153,-108,-702
68,2022/7/15 19:10,44,104,-60,-673
68,2022/7/15 19:20,38,126,-88,-684
68,2022/7/15 19:30,33,90,-57,-668
68,2022/7/15 19:40,29,114,-85,-615
68,2022/7/15 19:50,28,108,-80,-562
68,2022/7/15 20:00,24,95,-71,-515
68,2022/7/15 20:10,33,95,-62,-489
68,2022/7/15 20:20,29,85,-56,-450
68,2022/7/15 20:30,29,71,-42,-452
68,2022/7/15 20:40,29,112,-83,-474
68,2022/7/15 20:50,28,85,-57,-407
68,2022/7/15 21:00,28,79,-51,-433
68,2022/7/15 21:10,25,92,-67,-460
68,2022/7/15 21:20,28,77,-49,-440
68,2022/7/15 21:30,25,79,-54,-465
68,2022/7/15 21:40,23,95,-72,-466
68,2022/7/15 21:50,19,89,-70,-506
68,2022/7/15 22:00,18,79,-61,-487
68,2022/7/15 22:10,14,85,-71,-497
68,2022/7/15 22:20,3,82,-79,-498
68,2022/7/15 22:30,0,54,-54,-426
68,2022/7/15 22:40,0,3,-3,-287
68,2022/7/15 22:50,0,3,-3,-81
69,2022/7/15 5:00,0,1,-1,-10
69,2022/7/15 5:10,0,1,-1,-10
69,2022/7/15 5:20,0,1,-1,-10
69,2022/7/15 5:30,1,1,0,-8
69,2022/7/15 5:40,2,1,1,30
69,2022/7/15 5:50,5,1,4,96
69,2022/7/15 6:00,16,1,15,195
69,2022/7/15 6:10,31,19,12,188
69,2022/7/15 6:20,33,41,-8,93
69,2022/7/15 6:30,39,38,1,105
69,2022/7/15 6:40,54,63,-9,83
69,2022/7/15 6:50,57,63,-6,130
69,2022/7/15 7:00,82,73,9,377
69,2022/7/15 7:10,114,84,30,728
69,2022/7/15 7:20,231,106,125,1058
69,2022/7/15 7:30,264,102,162,1454
69,2022/7/15 7:40,330,102,228,1663
69,2022/7/15 7:50,442,109,333,1995
69,2022/7/15 8:00,323,144,179,1710
69,2022/7/15 8:10,324,231,93,1355
69,2022/7/15 8:20,357,225,132,747
69,2022/7/15 8:30,252,225,27,291
69,2022/7/15 8:40,222,325,-103,-236
69,2022/7/15 8:50,167,321,-154,-120
69,2022/7/15 9:00,78,191,-113,-346
69,2022/7/15 9:10,70,116,-46,-335
69,2022/7/15 9:20,54,133,-79,-386
69,2022/7/15 9:30,44,108,-64,-342
69,2022/7/15 9:40,39,106,-67,-296
69,2022/7/15 9:50,35,78,-43,-273
69,2022/7/15 10:00,31,91,-60,-240
69,2022/7/15 10:10,31,97,-66,-232
69,2022/7/15 10:20,29,77,-48,-256
69,2022/7/15 10:30,33,87,-54,-279
69,2022/7/15 10:40,27,72,-45,-238
69,2022/7/15 10:50,30,83,-53,-253
69,2022/7/15 11:00,32,74,-42,-218
69,2022/7/15 11:10,29,64,-35,-231
69,2022/7/15 11:20,29,74,-45,-258
69,2022/7/15 11:30,31,72,-41,-246
69,2022/7/15 11:40,31,69,-38,-230
69,2022/7/15 11:50,31,66,-35,-250
69,2022/7/15 12:00,34,62,-28,-215
69,2022/7/15 12:10,31,61,-30,-207
69,2022/7/15 12:20,35,69,-34,-214
69,2022/7/15 12:30,31,83,-52,-255
69,2022/7/15 12:40,30,73,-43,-252
69,2022/7/15 12:50,30,73,-43,-270
69,2022/7/15 13:00,32,69,-37,-267
69,2022/7/15 13:10,32,77,-45,-286
69,2022/7/15 13:20,33,78,-45,-309
69,2022/7/15 13:30,32,84,-52,-272
69,2022/7/15 13:40,28,76,-48,-304
69,2022/7/15 13:50,32,84,-52,-311
69,2022/7/15 14:00,33,77,-44,-310
69,2022/7/15 14:10,31,74,-43,-318
69,2022/7/15 14:20,31,69,-38,-301
69,2022/7/15 14:30,34,84,-50,-310
69,2022/7/15 14:40,33,82,-49,-307
69,2022/7/15 14:50,33,69,-36,-316
69,2022/7/15 15:00,33,81,-48,-336
69,2022/7/15 15:10,35,76,-41,-340
69,2022/7/15 15:20,37,76,-39,-331
69,2022/7/15 15:30,33,83,-50,-358
69,2022/7/15 15:40,33,76,-43,-367
69,2022/7/15 15:50,35,88,-53,-362
69,2022/7/15 16:00,39,90,-51,-382
69,2022/7/15 16:10,45,77,-32,-359
69,2022/7/15 16:20,46,99,-53,-372
69,2022/7/15 16:30,49,90,-41,-333
69,2022/7/15 16:40,45,103,-58,-321
69,2022/7/15 16:50,48,109,-61,-384
69,2022/7/15 17:00,243,106,137,-14
69,2022/7/15 17:10,222,108,114,68
69,2022/7/15 17:20,130,115,15,-266
69,2022/7/15 17:30,207,170,37,-471
69,2022/7/15 17:40,245,153,92,-180
69,2022/7/15 17:50,142,190,-48,-338
69,2022/7/15 18:00,149,234,-85,-503
69,2022/7/15 18:10,234,224,10,-586
69,2022/7/15 18:20,157,234,-77,-733
69,2022/7/15 18:30,77,178,-101,-859
69,2022/7/15 18:40,67,180,-113,-867
69,2022/7/15 18:50,48,184,-136,-875
69,2022/7/15 19:00,39,154,-115,-817
69,2022/7/15 19:10,41,124,-83,-756
69,2022/7/15 19:20,29,99,-70,-754
69,2022/7/15 19:30,31,110,-79,-747
69,2022/7/15 19:40,31,110,-79,-694
69,2022/7/15 19:50,29,98,-69,-631
69,2022/7/15 20:00,36,95,-59,-574
69,2022/7/15 20:10,38,89,-51,-540
69,2022/7/15 20:20,35,77,-42,-492
69,2022/7/15 20:30,29,110,-81,-533
69,2022/7/15 20:40,26,68,-42,-516
69,2022/7/15 20:50,24,79,-55,-462
69,2022/7/15 21:00,29,78,-49,-482
69,2022/7/15 21:10,25,83,-58,-518
69,2022/7/15 21:20,25,83,-58,-498
69,2022/7/15 21:30,25,77,-52,-517
69,2022/7/15 21:40,25,86,-61,-527
69,2022/7/15 21:50,24,79,-55,-561
69,2022/7/15 22:00,20,87,-67,-554
69,2022/7/15 22:10,15,67,-52,-549
69,2022/7/15 22:20,8,70,-62,-560
69,2022/7/15 22:30,1,59,-58,-484
69,2022/7/15 22:40,0,3,-3,-290
69,2022/7/15 22:50,0,3,-3,-84
64,2022/7/15 5:00,0,1,-1,-11
64,2022/7/15 5:10,0,1,-1,-11
64,2022/7/15 5:20,0,1,-1,-11
64,2022/7/15 5:30,0,1,-1,-9
64,2022/7/15 5:40,3,1,2,32
64,2022/7/15 5:50,8,1,7,103
64,2022/7/15 6:00,14,16,-2,193
64,2022/7/15 6:10,29,11,18,206
64,2022/7/15 6:20,40,30,10,103
64,2022/7/15 6:30,56,32,24,129
64,2022/7/15 6:40,57,40,17,100
64,2022/7/15 6:50,74,50,24,154
64,2022/7/15 7:00,152,66,86,463
64,2022/7/15 7:10,192,68,124,852
64,2022/7/15 7:20,225,84,141,1199
64,2022/7/15 7:30,282,100,182,1636
64,2022/7/15 7:40,367,106,261,1924
64,2022/7/15 7:50,597,108,489,2484
64,2022/7/15 8:00,590,122,468,2178
64,2022/7/15 8:10,474,109,365,1720
64,2022/7/15 8:20,357,119,238,985
64,2022/7/15 8:30,278,124,154,445
64,2022/7/15 8:40,246,100,146,-90
64,2022/7/15 8:50,191,119,72,-48
64,2022/7/15 9:00,145,109,36,-310
64,2022/7/15 9:10,101,99,2,-333
64,2022/7/15 9:20,70,87,-17,-403
64,2022/7/15 9:30,50,71,-21,-363
64,2022/7/15 9:40,44,69,-25,-321
64,2022/7/15 9:50,36,78,-42,-315
64,2022/7/15 10:00,34,71,-37,-277
64,2022/7/15 10:10,34,62,-28,-260
64,2022/7/15 10:20,30,63,-33,-289
64,2022/7/15 10:30,27,61,-34,-313
64,2022/7/15 10:40,28,67,-39,-277
64,2022/7/15 10:50,31,61,-30,-283
64,2022/7/15 11:00,31,53,-22,-240
64,2022/7/15 11:10,27,61,-34,-265
64,2022/7/15 11:20,31,55,-24,-282
64,2022/7/15 11:30,27,57,-30,-276
64,2022/7/15 11:40,28,60,-32,-262
64,2022/7/15 11:50,30,65,-35,-285
64,2022/7/15 12:00,30,60,-30,-245
64,2022/7/15 12:10,33,61,-28,-235
64,2022/7/15 12:20,30,63,-33,-247
64,2022/7/15 12:30,35,69,-34,-289
64,2022/7/15 12:40,35,64,-29,-281
64,2022/7/15 12:50,32,70,-38,-308
64,2022/7/15 13:00,30,67,-37,-304
64,2022/7/15 13:10,34,72,-38,-324
64,2022/7/15 13:20,24,68,-44,-353
64,2022/7/15 13:30,23,70,-47,-319
64,2022/7/15 13:40,26,72,-46,-350
64,2022/7/15 13:50,32,71,-39,-350
64,2022/7/15 14:00,24,69,-45,-355
64,2022/7/15 14:10,24,72,-48,-366
64,2022/7/15 14:20,27,65,-38,-339
64,2022/7/15 14:30,26,69,-43,-353
64,2022/7/15 14:40,28,71,-43,-350
64,2022/7/15 14:50,24,73,-49,-365
64,2022/7/15 15:00,27,72,-45,-381
64,2022/7/15 15:10,29,73,-44,-384
64,2022/7/15 15:20,30,73,-43,-374
64,2022/7/15 15:30,29,76,-47,-405
64,2022/7/15 15:40,24,76,-52,-419
64,2022/7/15 15:50,29,79,-50,-412
64,2022/7/15 16:00,28,79,-51,-433
64,2022/7/15 16:10,33,76,-43,-402
64,2022/7/15 16:20,31,90,-59,-431
64,2022/7/15 16:30,43,84,-41,-374
64,2022/7/15 16:40,46,103,-57,-378
64,2022/7/15 16:50,44,106,-62,-446
64,2022/7/15 17:00,129,102,27,13
64,2022/7/15 17:10,139,109,30,98
64,2022/7/15 17:20,62,118,-56,-322
64,2022/7/15 17:30,74,168,-94,-565
64,2022/7/15 17:40,77,153,-76,-256
64,2022/7/15 17:50,49,179,-130,-468
64,2022/7/15 18:00,53,213,-160,-663
64,2022/7/15 18:10,42,226,-184,-770
64,2022/7/15 18:20,36,234,-198,-931
64,2022/7/15 18:30,37,227,-190,-1049
64,2022/7/15 18:40,32,199,-167,-1034
64,2022/7/15 18:50,31,178,-147,-1022
64,2022/7/15 19:00,28,128,-100,-917
64,2022/7/15 19:10,25,105,-80,-836
64,2022/7/15 19:20,28,103,-75,-829
64,2022/7/15 19:30,27,107,-80,-827
64,2022/7/15 19:40,21,110,-89,-783
64,2022/7/15 19:50,21,106,-85,-716
64,2022/7/15 20:00,21,93,-72,-646
64,2022/7/15 20:10,21,93,-72,-612
64,2022/7/15 20:20,18,80,-62,-554
64,2022/7/15 20:30,18,77,-59,-592
64,2022/7/15 20:40,20,71,-51,-567
64,2022/7/15 20:50,19,78,-59,-521
64,2022/7/15 21:00,20,85,-65,-547
64,2022/7/15 21:10,16,99,-83,-601
64,2022/7/15 21:20,19,95,-76,-574
64,2022/7/15 21:30,14,84,-70,-587
64,2022/7/15 21:40,14,95,-81,-608
64,2022/7/15 21:50,9,83,-74,-635
64,2022/7/15 22:00,12,89,-77,-631
64,2022/7/15 22:10,10,83,-73,-622
64,2022/7/15 22:20,4,105,-101,-661
64,2022/7/15 22:30,0,16,-16,-500
64,2022/7/15 22:40,0,3,-3,-293
64,2022/7/15 22:50,0,3,-3,-87
71,2022/7/15 5:00,0,1,-1,-12
71,2022/7/15 5:10,0,1,-1,-12
71,2022/7/15 5:20,0,1,-1,-12
71,2022/7/15 5:30,0,1,-1,-10
71,2022/7/15 5:40,1,1,0,32
71,2022/7/15 5:50,8,1,7,110
71,2022/7/15 6:00,8,1,7,200
71,2022/7/15 6:10,10,2,8,214
71,2022/7/15 6:20,17,37,-20,83
71,2022/7/15 6:30,15,23,-8,121
71,2022/7/15 6:40,22,41,-19,81
71,2022/7/15 6:50,22,47,-25,129
71,2022/7/15 7:00,25,59,-34,429
71,2022/7/15 7:10,27,62,-35,817
71,2022/7/15 7:20,30,74,-44,1155
71,2022/7/15 7:30,36,93,-57,1579
71,2022/7/15 7:40,42,102,-60,1864
71,2022/7/15 7:50,53,109,-56,2428
71,2022/7/15 8:00,62,137,-75,2103
71,2022/7/15 8:10,53,380,-327,1393
71,2022/7/15 8:20,42,231,-189,796
71,2022/7/15 8:30,33,382,-349,96
71,2022/7/15 8:40,35,534,-499,-589
71,2022/7/15 8:50,30,332,-302,-350
71,2022/7/15 9:00,29,181,-152,-462
71,2022/7/15 9:10,27,170,-143,-476
71,2022/7/15 9:20,26,105,-79,-482
71,2022/7/15 9:30,22,82,-60,-423
71,2022/7/15 9:40,18,76,-58,-379
71,2022/7/15 9:50,17,67,-50,-365
71,2022/7/15 10:00,17,68,-51,-328
71,2022/7/15 10:10,16,63,-47,-307
71,2022/7/15 10:20,15,60,-45,-334
71,2022/7/15 10:30,16,52,-36,-349
71,2022/7/15 10:40,16,49,-33,-310
71,2022/7/15 10:50,19,51,-32,-315
71,2022/7/15 11:00,16,40,-24,-264
71,2022/7/15 11:10,23,47,-24,-289
71,2022/7/15 11:20,22,45,-23,-305
71,2022/7/15 11:30,21,46,-25,-301
71,2022/7/15 11:40,22,42,-20,-282
71,2022/7/15 11:50,21,46,-25,-310
71,2022/7/15 12:00,26,47,-21,-266
71,2022/7/15 12:10,22,40,-18,-253
71,2022/7/15 12:20,21,47,-26,-273
71,2022/7/15 12:30,20,46,-26,-315
71,2022/7/15 12:40,25,49,-24,-305
71,2022/7/15 12:50,20,51,-31,-339
71,2022/7/15 13:00,18,49,-31,-335
71,2022/7/15 13:10,22,53,-31,-355
71,2022/7/15 13:20,18,50,-32,-385
71,2022/7/15 13:30,20,48,-28,-347
71,2022/7/15 13:40,22,49,-27,-377
71,2022/7/15 13:50,22,49,-27,-377
71,2022/7/15 14:00,21,47,-26,-381
71,2022/7/15 14:10,19,50,-31,-397
71,2022/7/15 14:20,22,48,-26,-365
71,2022/7/15 14:30,21,45,-24,-377
71,2022/7/15 14:40,21,48,-27,-377
71,2022/7/15 14:50,24,46,-22,-387
71,2022/7/15 15:00,23,45,-22,-403
71,2022/7/15 15:10,26,46,-20,-404
71,2022/7/15 15:20,25,41,-16,-390
71,2022/7/15 15:30,21,47,-26,-431
71,2022/7/15 15:40,25,47,-22,-441
71,2022/7/15 15:50,27,51,-24,-436
71,2022/7/15 16:00,28,40,-12,-445
71,2022/7/15 16:10,27,37,-10,-412
71,2022/7/15 16:20,28,55,-27,-458
71,2022/7/15 16:30,44,55,-11,-385
71,2022/7/15 16:40,40,42,-2,-380
71,2022/7/15 16:50,47,52,-5,-451
71,2022/7/15 17:00,94,62,32,45
71,2022/7/15 17:10,197,60,137,235
71,2022/7/15 17:20,79,64,15,-307
71,2022/7/15 17:30,266,70,196,-369
71,2022/7/15 17:40,461,72,389,133
71,2022/7/15 17:50,227,69,158,-310
71,2022/7/15 18:00,216,85,131,-532
71,2022/7/15 18:10,268,77,191,-579
71,2022/7/15 18:20,137,77,60,-871
71,2022/7/15 18:30,65,72,-7,-1056
71,2022/7/15 18:40,44,64,-20,-1054
71,2022/7/15 18:50,38,76,-38,-1060
71,2022/7/15 19:00,35,64,-29,-946
71,2022/7/15 19:10,32,74,-42,-878
71,2022/7/15 19:20,28,65,-37,-866
71,2022/7/15 19:30,26,63,-37,-864
71,2022/7/15 19:40,26,54,-28,-811
71,2022/7/15 19:50,19,52,-33,-749
71,2022/7/15 20:00,19,50,-31,-677
71,2022/7/15 20:10,21,47,-26,-638
71,2022/7/15 20:20,20,34,-14,-568
71,2022/7/15 20:30,17,48,-31,-623
71,2022/7/15 20:40,18,40,-22,-589
71,2022/7/15 20:50,15,42,-27,-548
71,2022/7/15 21:00,15,50,-35,-582
71,2022/7/15 21:10,19,39,-20,-621
71,2022/7/15 21:20,15,50,-35,-609
71,2022/7/15 21:30,12,50,-38,-625
71,2022/7/15 21:40,12,44,-32,-640
71,2022/7/15 21:50,12,48,-36,-671
71,2022/7/15 22:00,10,49,-39,-670
71,2022/7/15 22:10,10,47,-37,-659
71,2022/7/15 22:20,3,25,-22,-683
71,2022/7/15 22:30,0,4,-4,-504
71,2022/7/15 22:40,0,3,-3,-296
71,2022/7/15 22:50,0,3,-3,-90
63,2022/7/15 5:00,0,1,-1,-13
63,2022/7/15 5:10,0,1,-1,-13
63,2022/7/15 5:20,0,1,-1,-13
63,2022/7/15 5:30,1,1,0,-10
63,2022/7/15 5:40,1,1,0,32
63,2022/7/15 5:50,10,1,9,119
63,2022/7/15 6:00,6,1,5,205
63,2022/7/15 6:10,12,21,-9,205
63,2022/7/15 6:20,15,6,9,92
63,2022/7/15 6:30,17,32,-15,106
63,2022/7/15 6:40,26,25,1,82
63,2022/7/15 6:50,29,37,-8,121
63,2022/7/15 7:00,30,50,-20,409
63,2022/7/15 7:10,34,69,-35,782
63,2022/7/15 7:20,36,78,-42,1113
63,2022/7/15 7:30,41,90,-49,1530
63,2022/7/15 7:40,48,108,-60,1804
63,2022/7/15 7:50,53,169,-116,2312
63,2022/7/15 8:00,55,432,-377,1726
63,2022/7/15 8:10,59,433,-374,1019
63,2022/7/15 8:20,52,436,-384,412
63,2022/7/15 8:30,44,533,-489,-393
63,2022/7/15 8:40,36,495,-459,-1048
63,2022/7/15 8:50,32,332,-300,-650
63,2022/7/15 9:00,32,234,-202,-664
63,2022/7/15 9:10,29,146,-117,-593
63,2022/7/15 9:20,28,111,-83,-565
63,2022/7/15 9:30,26,105,-79,-502
63,2022/7/15 9:40,24,105,-81,-460
63,2022/7/15 9:50,20,84,-64,-429
63,2022/7/15 10:00,21,92,-71,-399
63,2022/7/15 10:10,22,70,-48,-355
63,2022/7/15 10:20,22,67,-45,-379
63,2022/7/15 10:30,21,62,-41,-390
63,2022/7/15 10:40,22,61,-39,-349
63,2022/7/15 10:50,19,54,-35,-350
63,2022/7/15 11:00,22,47,-25,-289
63,2022/7/15 11:10,23,50,-27,-316
63,2022/7/15 11:20,25,44,-19,-324
63,2022/7/15 11:30,26,58,-32,-333
63,2022/7/15 11:40,28,51,-23,-305
63,2022/7/15 11:50,24,50,-26,-336
63,2022/7/15 12:00,30,46,-16,-282
63,2022/7/15 12:10,27,47,-20,-273
63,2022/7/15 12:20,22,51,-29,-302
63,2022/7/15 12:30,24,55,-31,-346
63,2022/7/15 12:40,26,67,-41,-346
63,2022/7/15 12:50,22,62,-40,-379
63,2022/7/15 13:00,26,64,-38,-373
63,2022/7/15 13:10,23,70,-47,-402
63,2022/7/15 13:20,26,61,-35,-420
63,2022/7/15 13:30,27,65,-38,-385
63,2022/7/15 13:40,24,62,-38,-415
63,2022/7/15 13:50,22,54,-32,-409
63,2022/7/15 14:00,22,52,-30,-411
63,2022/7/15 14:10,26,54,-28,-425
63,2022/7/15 14:20,26,54,-28,-393
63,2022/7/15 14:30,27,56,-29,-406
63,2022/7/15 14:40,25,53,-28,-405
63,2022/7/15 14:50,28,56,-28,-415
63,2022/7/15 15:00,29,56,-27,-430
63,2022/7/15 15:10,27,57,-30,-434
63,2022/7/15 15:20,25,52,-27,-417
63,2022/7/15 15:30,29,61,-32,-463
63,2022/7/15 15:40,26,54,-28,-469
63,2022/7/15 15:50,29,62,-33,-469
63,2022/7/15 16:00,30,62,-32,-477
63,2022/7/15 16:10,32,61,-29,-441
63,2022/7/15 16:20,32,66,-34,-492
63,2022/7/15 16:30,44,57,-13,-398
63,2022/7/15 16:40,41,74,-33,-413
63,2022/7/15 16:50,50,55,-5,-456
63,2022/7/15 17:00,274,70,204,249
63,2022/7/15 17:10,368,67,301,536
63,2022/7/15 17:20,227,65,162,-145
63,2022/7/15 17:30,260,75,185,-184
63,2022/7/15 17:40,577,84,493,626
63,2022/7/15 17:50,287,79,208,-102
63,2022/7/15 18:00,227,93,134,-398
63,2022/7/15 18:10,291,92,199,-380
63,2022/7/15 18:20,213,99,114,-757
63,2022/7/15 18:30,132,81,51,-1005
63,2022/7/15 18:40,131,78,53,-1001
63,2022/7/15 18:50,63,80,-17,-1077
63,2022/7/15 19:00,44,77,-33,-979
63,2022/7/15 19:10,42,64,-22,-900
63,2022/7/15 19:20,31,68,-37,-903
63,2022/7/15 19:30,28,55,-27,-891
63,2022/7/15 19:40,24,55,-31,-842
63,2022/7/15 19:50,28,57,-29,-778
63,2022/7/15 20:00,29,52,-23,-700
63,2022/7/15 20:10,28,48,-20,-658
63,2022/7/15 20:20,27,47,-20,-588
63,2022/7/15 20:30,27,48,-21,-644
63,2022/7/15 20:40,26,50,-24,-613
63,2022/7/15 20:50,22,41,-19,-567
63,2022/7/15 21:00,21,52,-31,-613
63,2022/7/15 21:10,24,47,-23,-644
63,2022/7/15 21:20,22,51,-29,-638
63,2022/7/15 21:30,24,52,-28,-653
63,2022/7/15 21:40,21,44,-23,-663
63,2022/7/15 21:50,11,48,-37,-708
63,2022/7/15 22:00,12,40,-28,-698
63,2022/7/15 22:10,13,38,-25,-684
63,2022/7/15 22:20,3,34,-31,-714
63,2022/7/15 22:30,1,15,-14,-518
63,2022/7/15 22:40,0,3,-3,-299
63,2022/7/15 22:50,0,3,-3,-93
77,2022/7/15 5:00,0,1,-1,-1
77,2022/7/15 5:10,0,1,-1,-1
77,2022/7/15 5:20,0,1,-1,-1
77,2022/7/15 5:30,3,1,2,2
77,2022/7/15 5:40,30,1,29,29
77,2022/7/15 5:50,67,1,66,66
77,2022/7/15 6:00,60,1,59,59
77,2022/7/15 6:10,97,1,96,96
77,2022/7/15 6:20,215,1,214,214
77,2022/7/15 6:30,235,54,181,181
77,2022/7/15 6:40,277,37,240,240
77,2022/7/15 6:50,328,37,291,291
77,2022/7/15 7:00,599,49,550,550
77,2022/7/15 7:10,730,56,674,674
77,2022/7/15 7:20,824,83,741,741
77,2022/7/15 7:30,1214,75,1139,1139
77,2022/7/15 7:40,1600,92,1508,1508
77,2022/7/15 7:50,1987,87,1900,1900
77,2022/7/15 8:00,1988,109,1879,1879
77,2022/7/15 8:10,1638,121,1517,1517
77,2022/7/15 8:20,1384,110,1274,1274
77,2022/7/15 8:30,1167,108,1059,1059
77,2022/7/15 8:40,726,111,615,615
77,2022/7/15 8:50,639,106,533,533
77,2022/7/15 9:00,432,106,326,326
77,2022/7/15 9:10,275,121,154,154
77,2022/7/15 9:20,275,93,182,182
77,2022/7/15 9:30,219,93,126,126
77,2022/7/15 9:40,177,74,103,103
77,2022/7/15 9:50,140,94,46,46
77,2022/7/15 10:00,85,104,-19,-19
77,2022/7/15 10:10,76,85,-9,-9
77,2022/7/15 10:20,62,84,-22,-22
77,2022/7/15 10:30,58,87,-29,-29
77,2022/7/15 10:40,57,102,-45,-45
77,2022/7/15 10:50,48,80,-32,-32
77,2022/7/15 11:00,47,77,-30,-30
77,2022/7/15 11:10,47,106,-59,-59
77,2022/7/15 11:20,45,108,-63,-63
77,2022/7/15 11:30,44,87,-43,-43
77,2022/7/15 11:40,59,69,-10,-10
77,2022/7/15 11:50,66,107,-41,-41
77,2022/7/15 12:00,62,102,-40,-40
77,2022/7/15 12:10,62,77,-15,-15
77,2022/7/15 12:20,68,75,-7,-7
77,2022/7/15 12:30,67,103,-36,-36
77,2022/7/15 12:40,64,103,-39,-39
77,2022/7/15 12:50,56,79,-23,-23
77,2022/7/15 13:00,54,75,-21,-21
77,2022/7/15 13:10,55,108,-53,-53
77,2022/7/15 13:20,45,110,-65,-65
77,2022/7/15 13:30,43,90,-47,-47
77,2022/7/15 13:40,43,82,-39,-39
77,2022/7/15 13:50,48,93,-45,-45
77,2022/7/15 14:00,42,124,-82,-82
77,2022/7/15 14:10,41,87,-46,-46
77,2022/7/15 14:20,41,93,-52,-52
77,2022/7/15 14:30,40,108,-68,-68
77,2022/7/15 14:40,43,115,-72,-72
77,2022/7/15 14:50,40,105,-65,-65
77,2022/7/15 15:00,40,93,-53,-53
77,2022/7/15 15:10,41,102,-61,-61
77,2022/7/15 15:20,38,109,-71,-71
77,2022/7/15 15:30,46,106,-60,-60
77,2022/7/15 15:40,46,105,-59,-59
77,2022/7/15 15:50,41,121,-80,-80
77,2022/7/15 16:00,44,184,-140,-140
77,2022/7/15 16:10,44,120,-76,-76
77,2022/7/15 16:20,43,124,-81,-81
77,2022/7/15 16:30,44,115,-71,-71
77,2022/7/15 16:40,50,198,-148,-148
77,2022/7/15 16:50,44,120,-76,-76
77,2022/7/15 17:00,49,118,-69,-69
77,2022/7/15 17:10,70,317,-247,-247
77,2022/7/15 17:20,53,175,-122,-122
77,2022/7/15 17:30,54,231,-177,-177
77,2022/7/15 17:40,128,531,-403,-403
77,2022/7/15 17:50,75,317,-242,-242
77,2022/7/15 18:00,66,477,-411,-411
77,2022/7/15 18:10,70,573,-503,-503
77,2022/7/15 18:20,67,503,-436,-436
77,2022/7/15 18:30,46,601,-555,-555
77,2022/7/15 18:40,42,1109,-1067,-1067
77,2022/7/15 18:50,36,402,-366,-366
77,2022/7/15 19:00,43,626,-583,-583
77,2022/7/15 19:10,29,584,-555,-555
77,2022/7/15 19:20,28,326,-298,-298
77,2022/7/15 19:30,33,504,-471,-471
77,2022/7/15 19:40,31,435,-404,-404
77,2022/7/15 19:50,26,169,-143,-143
77,2022/7/15 20:00,30,272,-242,-242
77,2022/7/15 20:10,33,219,-186,-186
77,2022/7/15 20:20,30,112,-82,-82
77,2022/7/15 20:30,28,237,-209,-209
77,2022/7/15 20:40,36,109,-73,-73
77,2022/7/15 20:50,24,144,-120,-120
77,2022/7/15 21:00,32,198,-166,-166
77,2022/7/15 21:10,25,109,-84,-84
77,2022/7/15 21:20,24,128,-104,-104
77,2022/7/15 21:30,27,111,-84,-84
77,2022/7/15 21:40,28,273,-245,-245
77,2022/7/15 21:50,26,153,-127,-127
77,2022/7/15 22:00,20,110,-90,-90
77,2022/7/15 22:10,1,115,-114,-114
77,2022/7/15 22:20,1,209,-208,-208
77,2022/7/15 22:30,0,122,-122,-122
77,2022/7/15 22:40,0,100,-100,-100
77,2022/7/15 22:50,0,95,-95,-95
76,2022/7/15 5:00,0,1,-1,-2
76,2022/7/15 5:10,0,1,-1,-2
76,2022/7/15 5:20,0,1,-1,-2
76,2022/7/15 5:30,0,1,-1,1
76,2022/7/15 5:40,4,1,3,32
76,2022/7/15 5:50,17,1,16,82
76,2022/7/15 6:00,19,1,18,77
76,2022/7/15 6:10,23,1,22,118
76,2022/7/15 6:20,25,1,24,238
76,2022/7/15 6:30,32,19,13,194
76,2022/7/15 6:40,31,8,23,263
76,2022/7/15 6:50,32,31,1,292
76,2022/7/15 7:00,27,23,4,554
76,2022/7/15 7:10,43,21,22,696
76,2022/7/15 7:20,49,40,9,750
76,2022/7/15 7:30,47,37,10,1149
76,2022/7/15 7:40,80,41,39,1547
76,2022/7/15 7:50,80,67,13,1913
76,2022/7/15 8:00,56,102,-46,1833
76,2022/7/15 8:10,52,89,-37,1480
76,2022/7/15 8:20,59,112,-53,1221
76,2022/7/15 8:30,53,108,-55,1004
76,2022/7/15 8:40,39,114,-75,540
76,2022/7/15 8:50,32,125,-93,440
76,2022/7/15 9:00,27,98,-71,255
76,2022/7/15 9:10,24,60,-36,118
76,2022/7/15 9:20,24,77,-53,129
76,2022/7/15 9:30,23,58,-35,91
76,2022/7/15 9:40,20,72,-52,51
76,2022/7/15 9:50,20,51,-31,15
76,2022/7/15 10:00,19,38,-19,-38
76,2022/7/15 10:10,18,40,-22,-31
76,2022/7/15 10:20,19,60,-41,-63
76,2022/7/15 10:30,14,41,-27,-56
76,2022/7/15 10:40,16,33,-17,-62
76,2022/7/15 10:50,16,31,-15,-47
76,2022/7/15 11:00,17,45,-28,-58
76,2022/7/15 11:10,17,33,-16,-75
76,2022/7/15 11:20,16,31,-15,-78
76,2022/7/15 11:30,15,32,-17,-60
76,2022/7/15 11:40,17,44,-27,-37
76,2022/7/15 11:50,17,34,-17,-58
76,2022/7/15 12:00,18,29,-11,-51
76,2022/7/15 12:10,18,31,-13,-28
76,2022/7/15 12:20,20,49,-29,-36
76,2022/7/15 12:30,20,34,-14,-50
76,2022/7/15 12:40,17,40,-23,-62
76,2022/7/15 12:50,17,31,-14,-37
76,2022/7/15 13:00,19,52,-33,-54
76,2022/7/15 13:10,15,39,-24,-77
76,2022/7/15 13:20,16,38,-22,-87
76,2022/7/15 13:30,19,38,-19,-66
76,2022/7/15 13:40,19,61,-42,-81
76,2022/7/15 13:50,19,47,-28,-73
76,2022/7/15 14:00,20,40,-20,-102
76,2022/7/15 14:10,17,38,-21,-67
76,2022/7/15 14:20,20,61,-41,-93
76,2022/7/15 14:30,16,46,-30,-98
76,2022/7/15 14:40,16,38,-22,-94
76,2022/7/15 14:50,19,38,-19,-84
76,2022/7/15 15:00,16,62,-46,-99
76,2022/7/15 15:10,17,38,-21,-82
76,2022/7/15 15:20,18,37,-19,-90
76,2022/7/15 15:30,18,38,-20,-80
76,2022/7/15 15:40,20,67,-47,-106
76,2022/7/15 15:50,18,48,-30,-110
76,2022/7/15 16:00,19,38,-19,-159
76,2022/7/15 16:10,20,41,-21,-97
76,2022/7/15 16:20,17,63,-46,-127
76,2022/7/15 16:30,22,49,-27,-98
76,2022/7/15 16:40,25,45,-20,-168
76,2022/7/15 16:50,23,47,-24,-100
76,2022/7/15 17:00,28,73,-45,-114
76,2022/7/15 17:10,28,48,-20,-267
76,2022/7/15 17:20,33,63,-30,-152
76,2022/7/15 17:30,35,70,-35,-212
76,2022/7/15 17:40,68,61,7,-396
76,2022/7/15 17:50,35,75,-40,-282
76,2022/7/15 18:00,37,79,-42,-453
76,2022/7/15 18:10,62,71,-9,-512
76,2022/7/15 18:20,47,89,-42,-478
76,2022/7/15 18:30,35,97,-62,-617
76,2022/7/15 18:40,29,75,-46,-1113
76,2022/7/15 18:50,29,92,-63,-429
76,2022/7/15 19:00,26,88,-62,-645
76,2022/7/15 19:10,24,65,-41,-596
76,2022/7/15 19:20,20,72,-52,-350
76,2022/7/15 19:30,15,75,-60,-531
76,2022/7/15 19:40,16,53,-37,-441
76,2022/7/15 19:50,16,70,-54,-197
76,2022/7/15 20:00,13,60,-47,-289
76,2022/7/15 20:10,15,38,-23,-209
76,2022/7/15 20:20,12,52,-40,-122
76,2022/7/15 20:30,12,39,-27,-236
76,2022/7/15 20:40,11,43,-32,-105
76,2022/7/15 20:50,10,53,-43,-163
76,2022/7/15 21:00,12,30,-18,-184
76,2022/7/15 21:10,15,32,-17,-101
76,2022/7/15 21:20,13,32,-19,-123
76,2022/7/15 21:30,10,51,-41,-125
76,2022/7/15 21:40,11,34,-23,-268
76,2022/7/15 21:50,8,27,-19,-146
76,2022/7/15 22:00,9,37,-28,-118
76,2022/7/15 22:10,1,46,-45,-159
76,2022/7/15 22:20,0,34,-34,-242
76,2022/7/15 22:30,0,27,-27,-149
76,2022/7/15 22:40,0,26,-26,-126
76,2022/7/15 22:50,0,21,-21,-116
74,2022/7/15 5:00,0,1,-1,-3
74,2022/7/15 5:10,0,1,-1,-3
74,2022/7/15 5:20,0,1,-1,-3
74,2022/7/15 5:30,0,1,-1,0
74,2022/7/15 5:40,3,1,2,34
74,2022/7/15 5:50,17,1,16,98
74,2022/7/15 6:00,31,2,29,106
74,2022/7/15 6:10,31,1,30,148
74,2022/7/15 6:20,43,2,41,279
74,2022/7/15 6:30,57,22,35,229
74,2022/7/15 6:40,72,30,42,305
74,2022/7/15 6:50,85,23,62,354
74,2022/7/15 7:00,148,32,116,670
74,2022/7/15 7:10,217,48,169,865
74,2022/7/15 7:20,280,44,236,986
74,2022/7/15 7:30,351,51,300,1449
74,2022/7/15 7:40,474,69,405,1952
74,2022/7/15 7:50,598,66,532,2445
74,2022/7/15 8:00,631,72,559,2392
74,2022/7/15 8:10,590,93,497,1977
74,2022/7/15 8:20,474,86,388,1609
74,2022/7/15 8:30,331,98,233,1237
74,2022/7/15 8:40,278,110,168,708
74,2022/7/15 8:50,200,124,76,516
74,2022/7/15 9:00,145,97,48,303
74,2022/7/15 9:10,95,77,18,136
74,2022/7/15 9:20,64,56,8,137
74,2022/7/15 9:30,46,71,-25,66
74,2022/7/15 9:40,43,54,-11,40
74,2022/7/15 9:50,40,52,-12,3
74,2022/7/15 10:00,31,61,-30,-68
74,2022/7/15 10:10,30,58,-28,-59
74,2022/7/15 10:20,28,47,-19,-82
74,2022/7/15 10:30,29,50,-21,-77
74,2022/7/15 10:40,28,48,-20,-82
74,2022/7/15 10:50,28,64,-36,-83
74,2022/7/15 11:00,24,45,-21,-79
74,2022/7/15 11:10,28,48,-20,-95
74,2022/7/15 11:20,25,64,-39,-117
74,2022/7/15 11:30,22,62,-40,-100
74,2022/7/15 11:40,28,54,-26,-63
74,2022/7/15 11:50,28,54,-26,-84
74,2022/7/15 12:00,30,60,-30,-81
74,2022/7/15 12:10,28,64,-36,-64
74,2022/7/15 12:20,29,48,-19,-55
74,2022/7/15 12:30,30,51,-21,-71
74,2022/7/15 12:40,29,64,-35,-97
74,2022/7/15 12:50,27,72,-45,-82
74,2022/7/15 13:00,29,66,-37,-91
74,2022/7/15 13:10,28,49,-21,-98
74,2022/7/15 13:20,28,65,-37,-124
74,2022/7/15 13:30,29,84,-55,-121
74,2022/7/15 13:40,28,54,-26,-107
74,2022/7/15 13:50,26,58,-32,-105
74,2022/7/15 14:00,28,59,-31,-133
74,2022/7/15 14:10,27,83,-56,-123
74,2022/7/15 14:20,29,60,-31,-124
74,2022/7/15 14:30,22,66,-44,-142
74,2022/7/15 14:40,27,67,-40,-134
74,2022/7/15 14:50,28,77,-49,-133
74,2022/7/15 15:00,22,64,-42,-141
74,2022/7/15 15:10,26,66,-40,-122
74,2022/7/15 15:20,27,75,-48,-138
74,2022/7/15 15:30,25,93,-68,-148
74,2022/7/15 15:40,26,69,-43,-149
74,2022/7/15 15:50,25,83,-58,-168
74,2022/7/15 16:00,29,90,-61,-220
74,2022/7/15 16:10,27,110,-83,-180
74,2022/7/15 16:20,28,77,-49,-176
74,2022/7/15 16:30,27,77,-50,-148
74,2022/7/15 16:40,29,110,-81,-249
74,2022/7/15 16:50,30,108,-78,-178
74,2022/7/15 17:00,28,108,-80,-194
74,2022/7/15 17:10,39,122,-83,-350
74,2022/7/15 17:20,29,106,-77,-229
74,2022/7/15 17:30,35,120,-85,-297
74,2022/7/15 17:40,40,183,-143,-539
74,2022/7/15 17:50,29,110,-81,-363
74,2022/7/15 18:00,48,223,-175,-628
74,2022/7/15 18:10,77,322,-245,-757
74,2022/7/15 18:20,45,110,-65,-543
74,2022/7/15 18:30,35,337,-302,-919
74,2022/7/15 18:40,39,322,-283,-1396
74,2022/7/15 18:50,29,119,-90,-519
74,2022/7/15 19:00,28,285,-257,-902
74,2022/7/15 19:10,26,178,-152,-748
74,2022/7/15 19:20,25,113,-88,-438
74,2022/7/15 19:30,24,103,-79,-610
74,2022/7/15 19:40,23,112,-89,-530
74,2022/7/15 19:50,21,97,-76,-273
74,2022/7/15 20:00,22,103,-81,-370
74,2022/7/15 20:10,19,109,-90,-299
74,2022/7/15 20:20,18,81,-63,-185
74,2022/7/15 20:30,17,104,-87,-323
74,2022/7/15 20:40,19,89,-70,-175
74,2022/7/15 20:50,17,83,-66,-229
74,2022/7/15 21:00,19,78,-59,-243
74,2022/7/15 21:10,16,107,-91,-192
74,2022/7/15 21:20,13,75,-62,-185
74,2022/7/15 21:30,13,85,-72,-197
74,2022/7/15 21:40,13,92,-79,-347
74,2022/7/15 21:50,11,109,-98,-244
74,2022/7/15 22:00,12,94,-82,-200
74,2022/7/15 22:10,6,78,-72,-231
74,2022/7/15 22:20,1,71,-70,-312
74,2022/7/15 22:30,1,92,-91,-240
74,2022/7/15 22:40,1,59,-58,-184
74,2022/7/15 22:50,0,3,-3,-119
78,2022/7/15 5:00,0,1,-1,-4
78,2022/7/15 5:10,0,1,-1,-4
78,2022/7/15 5:20,0,1,-1,-4
78,2022/7/15 5:30,0,1,-1,-1
78,2022/7/15 5:40,1,1,0,34
78,2022/7/15 5:50,13,1,12,110
78,2022/7/15 6:00,30,1,29,135
78,2022/7/15 6:10,31,1,30,178
78,2022/7/15 6:20,46,23,23,302
78,2022/7/15 6:30,57,33,24,253
78,2022/7/15 6:40,87,41,46,351
78,2022/7/15 6:50,154,39,115,469
78,2022/7/15 7:00,225,45,180,850
78,2022/7/15 7:10,279,46,233,1098
78,2022/7/15 7:20,350,60,290,1276
78,2022/7/15 7:30,441,77,364,1813
78,2022/7/15 7:40,593,68,525,2477
78,2022/7/15 7:50,599,126,473,2918
78,2022/7/15 8:00,688,109,579,2971
78,2022/7/15 8:10,663,115,548,2525
78,2022/7/15 8:20,590,180,410,2019
78,2022/7/15 8:30,375,106,269,1506
78,2022/7/15 8:40,281,194,87,795
78,2022/7/15 8:50,247,181,66,582
78,2022/7/15 9:00,200,133,67,370
78,2022/7/15 9:10,149,102,47,183
78,2022/7/15 9:20,81,89,-8,129
78,2022/7/15 9:30,58,79,-21,45
78,2022/7/15 9:40,51,83,-32,8
78,2022/7/15 9:50,43,75,-32,-29
78,2022/7/15 10:00,36,80,-44,-112
78,2022/7/15 10:10,37,54,-17,-76
78,2022/7/15 10:20,31,63,-32,-114
78,2022/7/15 10:30,35,71,-36,-113
78,2022/7/15 10:40,27,64,-37,-119
78,2022/7/15 10:50,29,51,-22,-105
78,2022/7/15 11:00,29,45,-16,-95
78,2022/7/15 11:10,28,60,-32,-127
78,2022/7/15 11:20,26,59,-33,-150
78,2022/7/15 11:30,26,46,-20,-120
78,2022/7/15 11:40,27,55,-28,-91
78,2022/7/15 11:50,33,63,-30,-114
78,2022/7/15 12:00,25,61,-36,-117
78,2022/7/15 12:10,34,57,-23,-87
78,2022/7/15 12:20,33,65,-32,-87
78,2022/7/15 12:30,28,85,-57,-128
78,2022/7/15 12:40,31,64,-33,-130
78,2022/7/15 12:50,31,53,-22,-104
78,2022/7/15 13:00,29,63,-34,-125
78,2022/7/15 13:10,32,69,-37,-135
78,2022/7/15 13:20,27,69,-42,-166
78,2022/7/15 13:30,28,65,-37,-158
78,2022/7/15 13:40,29,64,-35,-142
78,2022/7/15 13:50,28,73,-45,-150
78,2022/7/15 14:00,26,73,-47,-180
78,2022/7/15 14:10,28,62,-34,-157
78,2022/7/15 14:20,25,66,-41,-165
78,2022/7/15 14:30,26,76,-50,-192
78,2022/7/15 14:40,23,75,-52,-186
78,2022/7/15 14:50,26,60,-34,-167
78,2022/7/15 15:00,29,69,-40,-181
78,2022/7/15 15:10,30,80,-50,-172
78,2022/7/15 15:20,27,75,-48,-186
78,2022/7/15 15:30,31,73,-42,-190
78,2022/7/15 15:40,27,83,-56,-205
78,2022/7/15 15:50,28,105,-77,-245
78,2022/7/15 16:00,32,92,-60,-280
78,2022/7/15 16:10,26,74,-48,-228
78,2022/7/15 16:20,27,80,-53,-229
78,2022/7/15 16:30,36,121,-85,-233
78,2022/7/15 16:40,37,112,-75,-324
78,2022/7/15 16:50,33,105,-72,-250
78,2022/7/15 17:00,54,109,-55,-249
78,2022/7/15 17:10,81,100,-19,-369
78,2022/7/15 17:20,57,181,-124,-353
78,2022/7/15 17:30,73,144,-71,-368
78,2022/7/15 17:40,216,157,59,-480
78,2022/7/15 17:50,139,333,-194,-557
78,2022/7/15 18:00,70,225,-155,-783
78,2022/7/15 18:10,197,299,-102,-859
78,2022/7/15 18:20,92,328,-236,-779
78,2022/7/15 18:30,56,227,-171,-1090
78,2022/7/15 18:40,48,300,-252,-1648
78,2022/7/15 18:50,43,329,-286,-805
78,2022/7/15 19:00,38,158,-120,-1022
78,2022/7/15 19:10,38,154,-116,-864
78,2022/7/15 19:20,31,146,-115,-553
78,2022/7/15 19:30,28,122,-94,-704
78,2022/7/15 19:40,33,124,-91,-621
78,2022/7/15 19:50,27,115,-88,-361
78,2022/7/15 20:00,27,109,-82,-452
78,2022/7/15 20:10,28,92,-64,-363
78,2022/7/15 20:20,26,122,-96,-281
78,2022/7/15 20:30,25,89,-64,-387
78,2022/7/15 20:40,22,91,-69,-244
78,2022/7/15 20:50,20,91,-71,-300
78,2022/7/15 21:00,21,123,-102,-345
78,2022/7/15 21:10,22,92,-70,-262
78,2022/7/15 21:20,17,77,-60,-245
78,2022/7/15 21:30,17,95,-78,-275
78,2022/7/15 21:40,16,127,-111,-458
78,2022/7/15 21:50,16,75,-59,-303
78,2022/7/15 22:00,13,78,-65,-265
78,2022/7/15 22:10,10,84,-74,-305
78,2022/7/15 22:20,2,103,-101,-413
78,2022/7/15 22:30,2,71,-69,-309
78,2022/7/15 22:40,0,54,-54,-238
78,2022/7/15 22:50,0,3,-3,-122
80,2022/7/15 5:00,0,1,-1,-5
80,2022/7/15 5:10,0,1,-1,-5
80,2022/7/15 5:20,0,1,-1,-5
80,2022/7/15 5:30,0,1,-1,-2
80,2022/7/15 5:40,0,1,-1,33
80,2022/7/15 5:50,4,1,3,113
80,2022/7/15 6:00,11,1,10,145
80,2022/7/15 6:10,10,6,4,182
80,2022/7/15 6:20,16,35,-19,283
80,2022/7/15 6:30,20,23,-3,250
80,2022/7/15 6:40,29,50,-21,330
80,2022/7/15 6:50,32,84,-52,417
80,2022/7/15 7:00,32,66,-34,816
80,2022/7/15 7:10,33,99,-66,1032
80,2022/7/15 7:20,54,97,-43,1233
80,2022/7/15 7:30,60,124,-64,1749
80,2022/7/15 7:40,88,184,-96,2381
80,2022/7/15 7:50,112,131,-19,2899
80,2022/7/15 8:00,157,322,-165,2806
80,2022/7/15 8:10,150,428,-278,2247
80,2022/7/15 8:20,163,494,-331,1688
80,2022/7/15 8:30,143,1459,-1316,190
80,2022/7/15 8:40,87,1904,-1817,-1022
80,2022/7/15 8:50,57,411,-354,228
80,2022/7/15 9:00,48,434,-386,-16
80,2022/7/15 9:10,37,501,-464,-281
80,2022/7/15 9:20,39,316,-277,-148
80,2022/7/15 9:30,29,196,-167,-122
80,2022/7/15 9:40,30,376,-346,-338
80,2022/7/15 9:50,33,177,-144,-173
80,2022/7/15 10:00,28,110,-82,-194
80,2022/7/15 10:10,28,106,-78,-154
80,2022/7/15 10:20,33,110,-77,-191
80,2022/7/15 10:30,31,97,-66,-179
80,2022/7/15 10:40,33,93,-60,-179
80,2022/7/15 10:50,30,77,-47,-152
80,2022/7/15 11:00,31,108,-77,-172
80,2022/7/15 11:10,29,75,-46,-173
80,2022/7/15 11:20,33,61,-28,-178
80,2022/7/15 11:30,33,64,-31,-151
80,2022/7/15 11:40,33,101,-68,-159
80,2022/7/15 11:50,30,83,-53,-167
80,2022/7/15 12:00,32,78,-46,-163
80,2022/7/15 12:10,35,72,-37,-124
80,2022/7/15 12:20,42,105,-63,-150
80,2022/7/15 12:30,36,82,-46,-174
80,2022/7/15 12:40,36,76,-40,-170
80,2022/7/15 12:50,37,73,-36,-140
80,2022/7/15 13:00,36,110,-74,-199
80,2022/7/15 13:10,39,75,-36,-171
80,2022/7/15 13:20,36,74,-38,-204
80,2022/7/15 13:30,35,77,-42,-200
80,2022/7/15 13:40,38,104,-66,-208
80,2022/7/15 13:50,37,76,-39,-189
80,2022/7/15 14:00,39,74,-35,-215
80,2022/7/15 14:10,35,69,-34,-191
80,2022/7/15 14:20,43,106,-63,-228
80,2022/7/15 14:30,38,84,-46,-238
80,2022/7/15 14:40,44,84,-40,-226
80,2022/7/15 14:50,40,62,-22,-189
80,2022/7/15 15:00,39,101,-62,-243
80,2022/7/15 15:10,43,85,-42,-214
80,2022/7/15 15:20,43,81,-38,-224
80,2022/7/15 15:30,38,74,-36,-226
80,2022/7/15 15:40,45,109,-64,-269
80,2022/7/15 15:50,43,85,-42,-287
80,2022/7/15 16:00,48,83,-35,-315
80,2022/7/15 16:10,49,67,-18,-246
80,2022/7/15 16:20,54,104,-50,-279
80,2022/7/15 16:30,62,81,-19,-252
80,2022/7/15 16:40,98,84,14,-310
80,2022/7/15 16:50,72,74,-2,-252
80,2022/7/15 17:00,177,103,74,-175
80,2022/7/15 17:10,271,109,162,-207
80,2022/7/15 17:20,319,83,236,-117
80,2022/7/15 17:30,317,112,205,-163
80,2022/7/15 17:40,660,110,550,70
80,2022/7/15 17:50,432,108,324,-233
80,2022/7/15 18:00,369,111,258,-525
80,2022/7/15 18:10,723,143,580,-279
80,2022/7/15 18:20,657,123,534,-245
80,2022/7/15 18:30,326,152,174,-916
80,2022/7/15 18:40,361,111,250,-1398
80,2022/7/15 18:50,275,107,168,-637
80,2022/7/15 19:00,214,111,103,-919
80,2022/7/15 19:10,225,123,102,-762
80,2022/7/15 19:20,177,76,101,-452
80,2022/7/15 19:30,129,106,23,-681
80,2022/7/15 19:40,110,91,19,-602
80,2022/7/15 19:50,77,56,21,-340
80,2022/7/15 20:00,77,81,-4,-456
80,2022/7/15 20:10,85,73,12,-351
80,2022/7/15 20:20,70,59,11,-270
80,2022/7/15 20:30,63,57,6,-381
80,2022/7/15 20:40,63,67,-4,-248
80,2022/7/15 20:50,55,71,-16,-316
80,2022/7/15 21:00,56,52,4,-341
80,2022/7/15 21:10,74,53,21,-241
80,2022/7/15 21:20,75,64,11,-234
80,2022/7/15 21:30,59,73,-14,-289
80,2022/7/15 21:40,63,51,12,-446
80,2022/7/15 21:50,48,51,-3,-306
80,2022/7/15 22:00,42,58,-16,-281
80,2022/7/15 22:10,40,66,-26,-331
80,2022/7/15 22:20,12,42,-30,-443
80,2022/7/15 22:30,2,36,-34,-343
80,2022/7/15 22:40,0,31,-31,-269
80,2022/7/15 22:50,0,3,-3,-125
73,2022/7/15 5:00,0,1,-1,-6
73,2022/7/15 5:10,0,1,-1,-6
73,2022/7/15 5:20,0,1,-1,-6
73,2022/7/15 5:30,0,1,-1,-3
73,2022/7/15 5:40,0,1,-1,32
73,2022/7/15 5:50,3,1,2,115
73,2022/7/15 6:00,20,1,19,164
73,2022/7/15 6:10,22,8,14,196
73,2022/7/15 6:20,27,30,-3,280
73,2022/7/15 6:30,34,31,3,253
73,2022/7/15 6:40,47,45,2,332
73,2022/7/15 6:50,57,50,7,424
73,2022/7/15 7:00,66,46,20,836
73,2022/7/15 7:10,88,81,7,1039
73,2022/7/15 7:20,105,89,16,1249
73,2022/7/15 7:30,187,93,94,1843
73,2022/7/15 7:40,217,107,110,2491
73,2022/7/15 7:50,236,117,119,3018
73,2022/7/15 8:00,256,190,66,2872
73,2022/7/15 8:10,268,509,-241,2006
73,2022/7/15 8:20,243,500,-257,1431
73,2022/7/15 8:30,233,326,-93,97
73,2022/7/15 8:40,199,493,-294,-1316
73,2022/7/15 8:50,155,421,-266,-38
73,2022/7/15 9:00,76,226,-150,-166
73,2022/7/15 9:10,59,300,-241,-522
73,2022/7/15 9:20,49,120,-71,-219
73,2022/7/15 9:30,40,183,-143,-265
73,2022/7/15 9:40,37,103,-66,-404
73,2022/7/15 9:50,31,88,-57,-230
73,2022/7/15 10:00,27,76,-49,-243
73,2022/7/15 10:10,30,105,-75,-229
73,2022/7/15 10:20,27,69,-42,-233
73,2022/7/15 10:30,29,67,-38,-217
73,2022/7/15 10:40,27,67,-40,-219
73,2022/7/15 10:50,27,76,-49,-201
73,2022/7/15 11:00,31,62,-31,-203
73,2022/7/15 11:10,28,67,-39,-212
73,2022/7/15 11:20,26,61,-35,-213
73,2022/7/15 11:30,29,62,-33,-184
73,2022/7/15 11:40,27,64,-37,-196
73,2022/7/15 11:50,32,55,-23,-190
73,2022/7/15 12:00,32,62,-30,-193
73,2022/7/15 12:10,32,79,-47,-171
73,2022/7/15 12:20,28,62,-34,-184
73,2022/7/15 12:30,35,64,-29,-203
73,2022/7/15 12:40,31,63,-32,-202
73,2022/7/15 12:50,33,90,-57,-197
73,2022/7/15 13:00,30,63,-33,-232
73,2022/7/15 13:10,30,62,-32,-203
73,2022/7/15 13:20,28,66,-38,-242
73,2022/7/15 13:30,28,97,-69,-269
73,2022/7/15 13:40,30,69,-39,-247
73,2022/7/15 13:50,26,70,-44,-233
73,2022/7/15 14:00,29,61,-32,-247
73,2022/7/15 14:10,33,93,-60,-251
73,2022/7/15 14:20,33,70,-37,-265
73,2022/7/15 14:30,25,60,-35,-273
73,2022/7/15 14:40,31,64,-33,-259
73,2022/7/15 14:50,27,80,-53,-242
73,2022/7/15 15:00,34,70,-36,-279
73,2022/7/15 15:10,26,69,-43,-257
73,2022/7/15 15:20,31,69,-38,-262
73,2022/7/15 15:30,33,87,-54,-280
73,2022/7/15 15:40,29,67,-38,-307
73,2022/7/15 15:50,25,67,-42,-329
73,2022/7/15 16:00,32,65,-33,-348
73,2022/7/15 16:10,38,93,-55,-301
73,2022/7/15 16:20,40,81,-41,-320
73,2022/7/15 16:30,47,78,-31,-283
73,2022/7/15 16:40,46,74,-28,-338
73,2022/7/15 16:50,48,106,-58,-310
73,2022/7/15 17:00,110,77,33,-142
73,2022/7/15 17:10,227,103,124,-83
73,2022/7/15 17:20,137,117,20,-97
73,2022/7/15 17:30,228,112,116,-47
73,2022/7/15 17:40,351,132,219,289
73,2022/7/15 17:50,305,151,154,-79
73,2022/7/15 18:00,271,120,151,-374
73,2022/7/15 18:10,352,191,161,-118
73,2022/7/15 18:20,319,192,127,-118
73,2022/7/15 18:30,205,114,91,-825
73,2022/7/15 18:40,175,139,36,-1362
73,2022/7/15 18:50,132,143,-11,-648
73,2022/7/15 19:00,77,108,-31,-950
73,2022/7/15 19:10,58,115,-57,-819
73,2022/7/15 19:20,52,127,-75,-527
73,2022/7/15 19:30,46,104,-58,-739
73,2022/7/15 19:40,40,110,-70,-672
73,2022/7/15 19:50,35,97,-62,-402
73,2022/7/15 20:00,32,70,-38,-494
73,2022/7/15 20:10,34,93,-59,-410
73,2022/7/15 20:20,35,66,-31,-301
73,2022/7/15 20:30,31,71,-40,-421
73,2022/7/15 20:40,28,109,-81,-329
73,2022/7/15 20:50,29,74,-45,-361
73,2022/7/15 21:00,26,72,-46,-387
73,2022/7/15 21:10,31,68,-37,-278
73,2022/7/15 21:20,33,95,-62,-296
73,2022/7/15 21:30,29,76,-47,-336
73,2022/7/15 21:40,28,70,-42,-488
73,2022/7/15 21:50,26,83,-57,-363
73,2022/7/15 22:00,20,89,-69,-350
73,2022/7/15 22:10,17,65,-48,-379
73,2022/7/15 22:20,9,55,-46,-489
73,2022/7/15 22:30,3,62,-59,-402
73,2022/7/15 22:40,0,46,-46,-315
73,2022/7/15 22:50,0,3,-3,-128
75,2022/7/15 5:00,0,1,-1,-7
75,2022/7/15 5:10,0,1,-1,-7
75,2022/7/15 5:20,0,1,-1,-7
75,2022/7/15 5:30,0,1,-1,-4
75,2022/7/15 5:40,0,1,-1,31
75,2022/7/15 5:50,3,1,2,117
75,2022/7/15 6:00,13,1,12,176
75,2022/7/15 6:10,18,19,-1,195
75,2022/7/15 6:20,23,25,-2,278
75,2022/7/15 6:30,32,37,-5,248
75,2022/7/15 6:40,32,50,-18,314
75,2022/7/15 6:50,41,52,-11,413
75,2022/7/15 7:00,36,51,-15,821
75,2022/7/15 7:10,57,73,-16,1023
75,2022/7/15 7:20,56,88,-32,1217
75,2022/7/15 7:30,68,99,-31,1812
75,2022/7/15 7:40,87,124,-37,2454
75,2022/7/15 7:50,155,88,67,3085
75,2022/7/15 8:00,168,133,35,2907
75,2022/7/15 8:10,198,197,1,2007
75,2022/7/15 8:20,183,155,28,1459
75,2022/7/15 8:30,181,214,-33,64
75,2022/7/15 8:40,148,268,-120,-1436
75,2022/7/15 8:50,122,155,-33,-71
75,2022/7/15 9:00,69,139,-70,-236
75,2022/7/15 9:10,64,125,-61,-583
75,2022/7/15 9:20,49,110,-61,-280
75,2022/7/15 9:30,46,105,-59,-324
75,2022/7/15 9:40,38,125,-87,-491
75,2022/7/15 9:50,38,123,-85,-315
75,2022/7/15 10:00,29,103,-74,-317
75,2022/7/15 10:10,32,110,-78,-307
75,2022/7/15 10:20,31,108,-77,-310
75,2022/7/15 10:30,27,114,-87,-304
75,2022/7/15 10:40,29,103,-74,-293
75,2022/7/15 10:50,29,99,-70,-271
75,2022/7/15 11:00,34,110,-76,-279
75,2022/7/15 11:10,28,105,-77,-289
75,2022/7/15 11:20,29,99,-70,-283
75,2022/7/15 11:30,31,101,-70,-254
75,2022/7/15 11:40,39,108,-69,-265
75,2022/7/15 11:50,45,110,-65,-255
75,2022/7/15 12:00,45,112,-67,-260
75,2022/7/15 12:10,52,99,-47,-218
75,2022/7/15 12:20,44,105,-61,-245
75,2022/7/15 12:30,47,108,-61,-264
75,2022/7/15 12:40,40,104,-64,-266
75,2022/7/15 12:50,49,103,-54,-251
75,2022/7/15 13:00,56,113,-57,-289
75,2022/7/15 13:10,59,105,-46,-249
75,2022/7/15 13:20,47,104,-57,-299
75,2022/7/15 13:30,55,104,-49,-318
75,2022/7/15 13:40,51,107,-56,-303
75,2022/7/15 13:50,47,105,-58,-291
75,2022/7/15 14:00,56,110,-54,-301
75,2022/7/15 14:10,55,106,-51,-302
75,2022/7/15 14:20,59,102,-43,-308
75,2022/7/15 14:30,59,110,-51,-324
75,2022/7/15 14:40,57,112,-55,-314
75,2022/7/15 14:50,64,97,-33,-275
75,2022/7/15 15:00,55,104,-49,-328
75,2022/7/15 15:10,67,108,-41,-298
75,2022/7/15 15:20,72,112,-40,-302
75,2022/7/15 15:30,64,104,-40,-320
75,2022/7/15 15:40,76,110,-34,-341
75,2022/7/15 15:50,76,103,-27,-356
75,2022/7/15 16:00,73,108,-35,-383
75,2022/7/15 16:10,71,101,-30,-331
75,2022/7/15 16:20,70,99,-29,-349
75,2022/7/15 16:30,168,95,73,-210
75,2022/7/15 16:40,128,121,7,-331
75,2022/7/15 16:50,175,116,59,-251
75,2022/7/15 17:00,234,110,124,-18
75,2022/7/15 17:10,272,143,129,46
75,2022/7/15 17:20,205,149,56,-41
75,2022/7/15 17:30,213,221,-8,-55
75,2022/7/15 17:40,235,232,3,292
75,2022/7/15 17:50,255,268,-13,-92
75,2022/7/15 18:00,202,336,-134,-508
75,2022/7/15 18:10,268,320,-52,-170
75,2022/7/15 18:20,205,321,-116,-234
75,2022/7/15 18:30,211,387,-176,-1001
75,2022/7/15 18:40,165,336,-171,-1533
75,2022/7/15 18:50,142,285,-143,-791
75,2022/7/15 19:00,127,197,-70,-1020
75,2022/7/15 19:10,110,158,-48,-867
75,2022/7/15 19:20,96,128,-32,-559
75,2022/7/15 19:30,83,111,-28,-767
75,2022/7/15 19:40,101,115,-14,-686
75,2022/7/15 19:50,133,116,17,-385
75,2022/7/15 20:00,170,106,64,-430
75,2022/7/15 20:10,167,107,60,-350
75,2022/7/15 20:20,196,112,84,-217
75,2022/7/15 20:30,273,99,174,-247
75,2022/7/15 20:40,268,89,179,-150
75,2022/7/15 20:50,208,94,114,-247
75,2022/7/15 21:00,204,93,111,-276
75,2022/7/15 21:10,149,94,55,-223
75,2022/7/15 21:20,157,76,81,-215
75,2022/7/15 21:30,159,78,81,-255
75,2022/7/15 21:40,114,78,36,-452
75,2022/7/15 21:50,124,75,49,-314
75,2022/7/15 22:00,271,76,195,-155
75,2022/7/15 22:10,90,62,28,-351
75,2022/7/15 22:20,24,69,-45,-534
75,2022/7/15 22:30,10,67,-57,-459
75,2022/7/15 22:40,1,21,-20,-335
75,2022/7/15 22:50,0,3,-3,-131
79,2022/7/15 5:00,0,1,-1,-8
79,2022/7/15 5:10,0,1,-1,-8
79,2022/7/15 5:20,0,1,-1,-8
79,2022/7/15 5:30,0,1,-1,-5
79,2022/7/15 5:40,0,1,-1,30
79,2022/7/15 5:50,3,1,2,119
79,2022/7/15 6:00,7,1,6,182
79,2022/7/15 6:10,13,2,11,206
79,2022/7/15 6:20,15,23,-8,270
79,2022/7/15 6:30,20,23,-3,245
79,2022/7/15 6:40,21,33,-12,302
79,2022/7/15 6:50,29,46,-17,396
79,2022/7/15 7:00,31,60,-29,792
79,2022/7/15 7:10,39,64,-25,998
79,2022/7/15 7:20,36,80,-44,1173
79,2022/7/15 7:30,38,81,-43,1769
79,2022/7/15 7:40,57,97,-40,2414
79,2022/7/15 7:50,58,98,-40,3045
79,2022/7/15 8:00,58,121,-63,2844
79,2022/7/15 8:10,69,178,-109,1898
79,2022/7/15 8:20,67,217,-150,1309
79,2022/7/15 8:30,63,206,-143,-79
79,2022/7/15 8:40,52,321,-269,-1705
79,2022/7/15 8:50,40,382,-342,-413
79,2022/7/15 9:00,38,185,-147,-383
79,2022/7/15 9:10,35,119,-84,-667
79,2022/7/15 9:20,30,121,-91,-371
79,2022/7/15 9:30,30,183,-153,-477
79,2022/7/15 9:40,28,120,-92,-583
79,2022/7/15 9:50,25,98,-73,-388
79,2022/7/15 10:00,27,97,-70,-387
79,2022/7/15 10:10,29,106,-77,-384
79,2022/7/15 10:20,28,76,-48,-358
79,2022/7/15 10:30,29,61,-32,-336
79,2022/7/15 10:40,23,72,-49,-342
79,2022/7/15 10:50,29,83,-54,-325
79,2022/7/15 11:00,26,61,-35,-314
79,2022/7/15 11:10,28,50,-22,-311
79,2022/7/15 11:20,26,62,-36,-319
79,2022/7/15 11:30,27,84,-57,-311
79,2022/7/15 11:40,29,54,-25,-290
79,2022/7/15 11:50,28,50,-22,-277
79,2022/7/15 12:00,27,64,-37,-297
79,2022/7/15 12:10,29,82,-53,-271
79,2022/7/15 12:20,25,57,-32,-277
79,2022/7/15 12:30,25,62,-37,-301
79,2022/7/15 12:40,28,62,-34,-300
79,2022/7/15 12:50,29,75,-46,-297
79,2022/7/15 13:00,26,63,-37,-326
79,2022/7/15 13:10,28,59,-31,-280
79,2022/7/15 13:20,28,71,-43,-342
79,2022/7/15 13:30,29,79,-50,-368
79,2022/7/15 13:40,27,70,-43,-346
79,2022/7/15 13:50,28,61,-33,-324
79,2022/7/15 14:00,29,62,-33,-334
79,2022/7/15 14:10,26,81,-55,-357
79,2022/7/15 14:20,25,60,-35,-343
79,2022/7/15 14:30,28,63,-35,-359
79,2022/7/15 14:40,25,64,-39,-353
79,2022/7/15 14:50,27,76,-49,-324
79,2022/7/15 15:00,30,62,-32,-360
79,2022/7/15 15:10,26,60,-34,-332
79,2022/7/15 15:20,28,63,-35,-337
79,2022/7/15 15:30,32,77,-45,-365
79,2022/7/15 15:40,35,70,-35,-376
79,2022/7/15 15:50,29,70,-41,-397
79,2022/7/15 16:00,34,66,-32,-415
79,2022/7/15 16:10,37,80,-43,-374
79,2022/7/15 16:20,37,65,-28,-377
79,2022/7/15 16:30,43,72,-29,-239
79,2022/7/15 16:40,46,73,-27,-358
79,2022/7/15 16:50,46,93,-47,-298
79,2022/7/15 17:00,148,69,79,61
79,2022/7/15 17:10,167,77,90,136
79,2022/7/15 17:20,98,99,-1,-42
79,2022/7/15 17:30,206,99,107,52
79,2022/7/15 17:40,233,112,121,413
79,2022/7/15 17:50,139,120,19,-73
79,2022/7/15 18:00,225,107,118,-390
79,2022/7/15 18:10,308,101,207,37
79,2022/7/15 18:20,216,110,106,-128
79,2022/7/15 18:30,154,95,59,-942
79,2022/7/15 18:40,129,107,22,-1511
79,2022/7/15 18:50,65,107,-42,-833
79,2022/7/15 19:00,59,78,-19,-1039
79,2022/7/15 19:10,54,77,-23,-890
79,2022/7/15 19:20,44,95,-51,-610
79,2022/7/15 19:30,37,67,-30,-797
79,2022/7/15 19:40,35,70,-35,-721
79,2022/7/15 19:50,28,66,-38,-423
79,2022/7/15 20:00,31,50,-19,-449
79,2022/7/15 20:10,34,70,-36,-386
79,2022/7/15 20:20,27,50,-23,-240
79,2022/7/15 20:30,29,48,-19,-266
79,2022/7/15 20:40,29,62,-33,-183
79,2022/7/15 20:50,29,67,-38,-285
79,2022/7/15 21:00,27,47,-20,-296
79,2022/7/15 21:10,28,40,-12,-235
79,2022/7/15 21:20,28,60,-32,-247
79,2022/7/15 21:30,26,61,-35,-290
79,2022/7/15 21:40,26,50,-24,-476
79,2022/7/15 21:50,25,51,-26,-340
79,2022/7/15 22:00,26,56,-30,-185
79,2022/7/15 22:10,24,53,-29,-380
79,2022/7/15 22:20,13,40,-27,-561
79,2022/7/15 22:30,2,32,-30,-489
79,2022/7/15 22:40,0,3,-3,-338
79,2022/7/15 22:50,0,3,-3,-134
88,2022/7/15 5:00,0,1,-1,-1
88,2022/7/15 5:10,0,1,-1,-1
88,2022/7/15 5:20,0,1,-1,-1
88,2022/7/15 5:30,2,1,1,1
88,2022/7/15 5:40,4,1,3,3
88,2022/7/15 5:50,7,1,6,6
88,2022/7/15 6:00,4,1,3,3
88,2022/7/15 6:10,14,1,13,13
88,2022/7/15 6:20,13,5,8,8
88,2022/7/15 6:30,12,5,7,7
88,2022/7/15 6:40,12,23,-11,-11
88,2022/7/15 6:50,17,38,-21,-21
88,2022/7/15 7:00,14,54,-40,-40
88,2022/7/15 7:10,16,61,-45,-45
88,2022/7/15 7:20,15,57,-42,-42
88,2022/7/15 7:30,17,46,-29,-29
88,2022/7/15 7:40,18,47,-29,-29
88,2022/7/15 7:50,19,50,-31,-31
88,2022/7/15 8:00,16,50,-34,-34
88,2022/7/15 8:10,16,68,-52,-52
88,2022/7/15 8:20,19,54,-35,-35
88,2022/7/15 8:30,18,51,-33,-33
88,2022/7/15 8:40,16,41,-25,-25
88,2022/7/15 8:50,14,33,-19,-19
88,2022/7/15 9:00,11,23,-12,-12
88,2022/7/15 9:10,13,23,-10,-10
88,2022/7/15 9:20,15,31,-16,-16
88,2022/7/15 9:30,11,32,-21,-21
88,2022/7/15 9:40,13,24,-11,-11
88,2022/7/15 9:50,11,23,-12,-12
88,2022/7/15 10:00,10,16,-6,-6
88,2022/7/15 10:10,7,19,-12,-12
88,2022/7/15 10:20,9,23,-14,-14
88,2022/7/15 10:30,10,16,-6,-6
88,2022/7/15 10:40,10,12,-2,-2
88,2022/7/15 10:50,8,21,-13,-13
88,2022/7/15 11:00,10,19,-9,-9
88,2022/7/15 11:10,8,18,-10,-10
88,2022/7/15 11:20,11,23,-12,-12
88,2022/7/15 11:30,10,19,-9,-9
88,2022/7/15 11:40,8,21,-13,-13
88,2022/7/15 11:50,12,25,-13,-13
88,2022/7/15 12:00,12,21,-9,-9
88,2022/7/15 12:10,10,19,-9,-9
88,2022/7/15 12:20,13,25,-12,-12
88,2022/7/15 12:30,10,19,-9,-9
88,2022/7/15 12:40,10,19,-9,-9
88,2022/7/15 12:50,10,23,-13,-13
88,2022/7/15 13:00,12,23,-11,-11
88,2022/7/15 13:10,8,22,-14,-14
88,2022/7/15 13:20,10,22,-12,-12
88,2022/7/15 13:30,11,19,-8,-8
88,2022/7/15 13:40,11,19,-8,-8
88,2022/7/15 13:50,8,21,-13,-13
88,2022/7/15 14:00,11,19,-8,-8
88,2022/7/15 14:10,10,23,-13,-13
88,2022/7/15 14:20,10,23,-13,-13
88,2022/7/15 14:30,11,21,-10,-10
88,2022/7/15 14:40,10,14,-4,-4
88,2022/7/15 14:50,12,21,-9,-9
88,2022/7/15 15:00,13,29,-16,-16
88,2022/7/15 15:10,13,23,-10,-10
88,2022/7/15 15:20,12,19,-7,-7
88,2022/7/15 15:30,15,21,-6,-6
88,2022/7/15 15:40,16,22,-6,-6
88,2022/7/15 15:50,12,23,-11,-11
88,2022/7/15 16:00,14,23,-9,-9
88,2022/7/15 16:10,16,22,-6,-6
88,2022/7/15 16:20,18,23,-5,-5
88,2022/7/15 16:30,13,23,-10,-10
88,2022/7/15 16:40,19,21,-2,-2
88,2022/7/15 16:50,19,23,-4,-4
88,2022/7/15 17:00,17,39,-22,-22
88,2022/7/15 17:10,19,23,-4,-4
88,2022/7/15 17:20,22,25,-3,-3
88,2022/7/15 17:30,20,38,-18,-18
88,2022/7/15 17:40,24,30,-6,-6
88,2022/7/15 17:50,27,38,-11,-11
88,2022/7/15 18:00,22,25,-3,-3
88,2022/7/15 18:10,20,32,-12,-12
88,2022/7/15 18:20,22,23,-1,-1
88,2022/7/15 18:30,25,21,4,4
88,2022/7/15 18:40,21,23,-2,-2
88,2022/7/15 18:50,17,23,-6,-6
88,2022/7/15 19:00,16,23,-7,-7
88,2022/7/15 19:10,12,13,-1,-1
88,2022/7/15 19:20,11,21,-10,-10
88,2022/7/15 19:30,14,18,-4,-4
88,2022/7/15 19:40,12,13,-1,-1
88,2022/7/15 19:50,10,18,-8,-8
88,2022/7/15 20:00,9,10,-1,-1
88,2022/7/15 20:10,8,13,-5,-5
88,2022/7/15 20:20,8,15,-7,-7
88,2022/7/15 20:30,9,10,-1,-1
88,2022/7/15 20:40,7,8,-1,-1
88,2022/7/15 20:50,7,10,-3,-3
88,2022/7/15 21:00,7,8,-1,-1
88,2022/7/15 21:10,8,7,1,1
88,2022/7/15 21:20,12,4,8,8
88,2022/7/15 21:30,6,8,-2,-2
88,2022/7/15 21:40,8,7,1,1
88,2022/7/15 21:50,6,13,-7,-7
88,2022/7/15 22:00,1,8,-7,-7
88,2022/7/15 22:10,0,3,-3,-3
88,2022/7/15 22:20,0,8,-8,-8
88,2022/7/15 22:30,0,3,-3,-3
88,2022/7/15 22:40,0,3,-3,-3
88,2022/7/15 22:50,0,4,-4,-4
84,2022/7/15 5:00,0,1,-1,-2
84,2022/7/15 5:10,0,1,-1,-2
84,2022/7/15 5:20,0,1,-1,-2
84,2022/7/15 5:30,0,1,-1,0
84,2022/7/15 5:40,1,1,0,3
84,2022/7/15 5:50,0,2,-2,4
84,2022/7/15 6:00,1,1,0,3
84,2022/7/15 6:10,3,1,2,15
84,2022/7/15 6:20,1,1,0,8
84,2022/7/15 6:30,4,1,3,10
84,2022/7/15 6:40,5,12,-7,-18
84,2022/7/15 6:50,1,8,-7,-28
84,2022/7/15 7:00,4,21,-17,-57
84,2022/7/15 7:10,3,16,-13,-58
84,2022/7/15 7:20,6,19,-13,-55
84,2022/7/15 7:30,8,21,-13,-42
84,2022/7/15 7:40,14,19,-5,-34
84,2022/7/15 7:50,8,23,-15,-46
84,2022/7/15 8:00,7,25,-18,-52
84,2022/7/15 8:10,6,31,-25,-77
84,2022/7/15 8:20,8,39,-31,-66
84,2022/7/15 8:30,6,38,-32,-65
84,2022/7/15 8:40,3,23,-20,-45
84,2022/7/15 8:50,3,31,-28,-47
84,2022/7/15 9:00,2,17,-15,-27
84,2022/7/15 9:10,1,21,-20,-30
84,2022/7/15 9:20,1,13,-12,-28
84,2022/7/15 9:30,1,14,-13,-34
84,2022/7/15 9:40,1,8,-7,-18
84,2022/7/15 9:50,2,8,-6,-18
84,2022/7/15 10:00,1,5,-4,-10
84,2022/7/15 10:10,1,7,-6,-18
84,2022/7/15 10:20,1,5,-4,-18
84,2022/7/15 10:30,1,2,-1,-7
84,2022/7/15 10:40,2,2,0,-2
84,2022/7/15 10:50,1,1,0,-13
84,2022/7/15 11:00,1,5,-4,-13
84,2022/7/15 11:10,1,5,-4,-14
84,2022/7/15 11:20,2,5,-3,-15
84,2022/7/15 11:30,1,5,-4,-13
84,2022/7/15 11:40,2,2,0,-13
84,2022/7/15 11:50,2,1,1,-12
84,2022/7/15 12:00,3,5,-2,-11
84,2022/7/15 12:10,2,1,1,-8
84,2022/7/15 12:20,2,5,-3,-15
84,2022/7/15 12:30,1,5,-4,-13
84,2022/7/15 12:40,2,8,-6,-15
84,2022/7/15 12:50,2,5,-3,-16
84,2022/7/15 13:00,1,5,-4,-15
84,2022/7/15 13:10,1,5,-4,-18
84,2022/7/15 13:20,2,2,0,-12
84,2022/7/15 13:30,1,7,-6,-14
84,2022/7/15 13:40,1,1,0,-8
84,2022/7/15 13:50,3,5,-2,-15
84,2022/7/15 14:00,2,5,-3,-11
84,2022/7/15 14:10,2,2,0,-13
84,2022/7/15 14:20,2,7,-5,-18
84,2022/7/15 14:30,2,5,-3,-13
84,2022/7/15 14:40,2,5,-3,-7
84,2022/7/15 14:50,2,5,-3,-12
84,2022/7/15 15:00,2,7,-5,-21
84,2022/7/15 15:10,2,5,-3,-13
84,2022/7/15 15:20,1,2,-1,-8
84,2022/7/15 15:30,2,5,-3,-9
84,2022/7/15 15:40,3,7,-4,-10
84,2022/7/15 15:50,3,5,-2,-13
84,2022/7/15 16:00,3,5,-2,-11
84,2022/7/15 16:10,4,2,2,-4
84,2022/7/15 16:20,7,5,2,-3
84,2022/7/15 16:30,6,5,1,-9
84,2022/7/15 16:40,12,5,7,5
84,2022/7/15 16:50,11,7,4,0
84,2022/7/15 17:00,11,5,6,-16
84,2022/7/15 17:10,11,11,0,-4
84,2022/7/15 17:20,11,21,-10,-13
84,2022/7/15 17:30,11,15,-4,-22
84,2022/7/15 17:40,10,12,-2,-8
84,2022/7/15 17:50,10,8,2,-9
84,2022/7/15 18:00,8,10,-2,-5
84,2022/7/15 18:10,11,13,-2,-14
84,2022/7/15 18:20,11,10,1,0
84,2022/7/15 18:30,9,15,-6,-2
84,2022/7/15 18:40,7,8,-1,-3
84,2022/7/15 18:50,4,13,-9,-15
84,2022/7/15 19:00,3,15,-12,-19
84,2022/7/15 19:10,4,13,-9,-10
84,2022/7/15 19:20,2,15,-13,-23
84,2022/7/15 19:30,2,8,-6,-10
84,2022/7/15 19:40,2,15,-13,-14
84,2022/7/15 19:50,1,8,-7,-15
84,2022/7/15 20:00,1,3,-2,-3
84,2022/7/15 20:10,2,7,-5,-10
84,2022/7/15 20:20,2,8,-6,-13
84,2022/7/15 20:30,1,7,-6,-7
84,2022/7/15 20:40,2,8,-6,-7
84,2022/7/15 20:50,2,4,-2,-5
84,2022/7/15 21:00,1,7,-6,-7
84,2022/7/15 21:10,1,10,-9,-8
84,2022/7/15 21:20,2,7,-5,3
84,2022/7/15 21:30,1,3,-2,-4
84,2022/7/15 21:40,1,8,-7,-6
84,2022/7/15 21:50,1,8,-7,-14
84,2022/7/15 22:00,0,8,-8,-15
84,2022/7/15 22:10,0,3,-3,-6
84,2022/7/15 22:20,0,3,-3,-11
84,2022/7/15 22:30,0,3,-3,-6
84,2022/7/15 22:40,0,3,-3,-6
84,2022/7/15 22:50,0,3,-3,-7
92,2022/7/15 5:00,0,1,-1,-3
92,2022/7/15 5:10,0,1,-1,-3
92,2022/7/15 5:20,0,1,-1,-3
92,2022/7/15 5:30,0,1,-1,-1
92,2022/7/15 5:40,2,1,1,4
92,2022/7/15 5:50,13,1,12,16
92,2022/7/15 6:00,19,1,18,21
92,2022/7/15 6:10,35,2,33,48
92,2022/7/15 6:20,60,2,58,66
92,2022/7/15 6:30,60,23,37,47
92,2022/7/15 6:40,61,32,29,11
92,2022/7/15 6:50,150,42,108,80
92,2022/7/15 7:00,107,63,44,-13
92,2022/7/15 7:10,142,68,74,16
92,2022/7/15 7:20,225,72,153,98
92,2022/7/15 7:30,244,98,146,104
92,2022/7/15 7:40,286,106,180,146
92,2022/7/15 7:50,283,106,177,131
92,2022/7/15 8:00,263,104,159,107
92,2022/7/15 8:10,250,96,154,77
92,2022/7/15 8:20,182,104,78,12
92,2022/7/15 8:30,156,96,60,-5
92,2022/7/15 8:40,142,107,35,-10
92,2022/7/15 8:50,73,86,-13,-60
92,2022/7/15 9:00,68,81,-13,-40
92,2022/7/15 9:10,49,68,-19,-49
92,2022/7/15 9:20,38,77,-39,-67
92,2022/7/15 9:30,28,81,-53,-87
92,2022/7/15 9:40,37,66,-29,-47
92,2022/7/15 9:50,23,62,-39,-57
92,2022/7/15 10:00,26,47,-21,-31
92,2022/7/15 10:10,29,69,-40,-58
92,2022/7/15 10:20,28,63,-35,-53
92,2022/7/15 10:30,28,62,-34,-41
92,2022/7/15 10:40,27,38,-11,-13
92,2022/7/15 10:50,32,63,-31,-44
92,2022/7/15 11:00,24,59,-35,-48
92,2022/7/15 11:10,20,65,-45,-59
92,2022/7/15 11:20,25,63,-38,-53
92,2022/7/15 11:30,20,49,-29,-42
92,2022/7/15 11:40,28,66,-38,-51
92,2022/7/15 11:50,32,47,-15,-27
92,2022/7/15 12:00,21,65,-44,-55
92,2022/7/15 12:10,25,68,-43,-51
92,2022/7/15 12:20,31,70,-39,-54
92,2022/7/15 12:30,21,62,-41,-54
92,2022/7/15 12:40,24,57,-33,-48
92,2022/7/15 12:50,25,72,-47,-63
92,2022/7/15 13:00,25,64,-39,-54
92,2022/7/15 13:10,26,71,-45,-63
92,2022/7/15 13:20,25,68,-43,-55
92,2022/7/15 13:30,22,62,-40,-54
92,2022/7/15 13:40,23,83,-60,-68
92,2022/7/15 13:50,24,54,-30,-45
92,2022/7/15 14:00,26,60,-34,-45
92,2022/7/15 14:10,24,66,-42,-55
92,2022/7/15 14:20,25,69,-44,-62
92,2022/7/15 14:30,28,72,-44,-57
92,2022/7/15 14:40,22,59,-37,-44
92,2022/7/15 14:50,21,71,-50,-62
92,2022/7/15 15:00,22,84,-62,-83
92,2022/7/15 15:10,23,82,-59,-72
92,2022/7/15 15:20,22,73,-51,-59
92,2022/7/15 15:30,23,62,-39,-48
92,2022/7/15 15:40,26,104,-78,-88
92,2022/7/15 15:50,22,76,-54,-67
92,2022/7/15 16:00,27,76,-49,-60
92,2022/7/15 16:10,27,103,-76,-80
92,2022/7/15 16:20,31,97,-66,-69
92,2022/7/15 16:30,40,71,-31,-40
92,2022/7/15 16:40,62,122,-60,-55
92,2022/7/15 16:50,35,85,-50,-50
92,2022/7/15 17:00,45,126,-81,-97
92,2022/7/15 17:10,70,97,-27,-31
92,2022/7/15 17:20,56,118,-62,-75
92,2022/7/15 17:30,38,118,-80,-102
92,2022/7/15 17:40,39,106,-67,-75
92,2022/7/15 17:50,43,151,-108,-117
92,2022/7/15 18:00,27,109,-82,-87
92,2022/7/15 18:10,26,197,-171,-185
92,2022/7/15 18:20,25,128,-103,-103
92,2022/7/15 18:30,27,120,-93,-95
92,2022/7/15 18:40,26,184,-158,-161
92,2022/7/15 18:50,21,128,-107,-122
92,2022/7/15 19:00,16,198,-182,-201
92,2022/7/15 19:10,19,123,-104,-114
92,2022/7/15 19:20,16,178,-162,-185
92,2022/7/15 19:30,15,115,-100,-110
92,2022/7/15 19:40,14,124,-110,-124
92,2022/7/15 19:50,14,113,-99,-114
92,2022/7/15 20:00,14,98,-84,-87
92,2022/7/15 20:10,12,77,-65,-75
92,2022/7/15 20:20,12,107,-95,-108
92,2022/7/15 20:30,12,73,-61,-68
92,2022/7/15 20:40,10,80,-70,-77
92,2022/7/15 20:50,13,77,-64,-69
92,2022/7/15 21:00,8,76,-68,-75
92,2022/7/15 21:10,10,92,-82,-90
92,2022/7/15 21:20,7,92,-85,-82
92,2022/7/15 21:30,8,93,-85,-89
92,2022/7/15 21:40,5,18,-13,-19
92,2022/7/15 21:50,2,84,-82,-96
92,2022/7/15 22:00,2,101,-99,-114
92,2022/7/15 22:10,1,95,-94,-100
92,2022/7/15 22:20,0,8,-8,-19
92,2022/7/15 22:30,0,3,-3,-9
92,2022/7/15 22:40,0,4,-4,-10
92,2022/7/15 22:50,0,3,-3,-10
83,2022/7/15 5:00,0,1,-1,-4
83,2022/7/15 5:10,0,1,-1,-4
83,2022/7/15 5:20,0,1,-1,-4
83,2022/7/15 5:30,0,1,-1,-2
83,2022/7/15 5:40,0,1,-1,3
83,2022/7/15 5:50,12,1,11,27
83,2022/7/15 6:00,36,1,35,56
83,2022/7/15 6:10,77,2,75,123
83,2022/7/15 6:20,70,11,59,125
83,2022/7/15 6:30,91,6,85,132
83,2022/7/15 6:40,155,25,130,141
83,2022/7/15 6:50,190,21,169,249
83,2022/7/15 7:00,218,25,193,180
83,2022/7/15 7:10,229,32,197,213
83,2022/7/15 7:20,284,41,243,341
83,2022/7/15 7:30,277,32,245,349
83,2022/7/15 7:40,279,39,240,386
83,2022/7/15 7:50,284,38,246,377
83,2022/7/15 8:00,280,40,240,347
83,2022/7/15 8:10,252,42,210,287
83,2022/7/15 8:20,193,38,155,167
83,2022/7/15 8:30,185,41,144,139
83,2022/7/15 8:40,149,40,109,99
83,2022/7/15 8:50,86,49,37,-23
83,2022/7/15 9:00,61,37,24,-16
83,2022/7/15 9:10,53,47,6,-43
83,2022/7/15 9:20,44,38,6,-61
83,2022/7/15 9:30,36,45,-9,-96
83,2022/7/15 9:40,25,50,-25,-72
83,2022/7/15 9:50,29,57,-28,-85
83,2022/7/15 10:00,30,40,-10,-41
83,2022/7/15 10:10,27,44,-17,-75
83,2022/7/15 10:20,26,47,-21,-74
83,2022/7/15 10:30,28,65,-37,-78
83,2022/7/15 10:40,27,42,-15,-28
83,2022/7/15 10:50,21,47,-26,-70
83,2022/7/15 11:00,28,38,-10,-58
83,2022/7/15 11:10,19,49,-30,-89
83,2022/7/15 11:20,25,49,-24,-77
83,2022/7/15 11:30,21,32,-11,-53
83,2022/7/15 11:40,33,41,-8,-59
83,2022/7/15 11:50,25,51,-26,-53
83,2022/7/15 12:00,28,47,-19,-74
83,2022/7/15 12:10,23,45,-22,-73
83,2022/7/15 12:20,33,37,-4,-58
83,2022/7/15 12:30,22,60,-38,-92
83,2022/7/15 12:40,27,43,-16,-64
83,2022/7/15 12:50,22,50,-28,-91
83,2022/7/15 13:00,24,47,-23,-77
83,2022/7/15 13:10,21,53,-32,-95
83,2022/7/15 13:20,28,66,-38,-93
83,2022/7/15 13:30,19,46,-27,-81
83,2022/7/15 13:40,24,52,-28,-96
83,2022/7/15 13:50,20,61,-41,-86
83,2022/7/15 14:00,23,52,-29,-74
83,2022/7/15 14:10,17,60,-43,-98
83,2022/7/15 14:20,23,46,-23,-85
83,2022/7/15 14:30,17,71,-54,-111
83,2022/7/15 14:40,16,59,-43,-87
83,2022/7/15 14:50,19,56,-37,-99
83,2022/7/15 15:00,19,63,-44,-127
83,2022/7/15 15:10,16,64,-48,-120
83,2022/7/15 15:20,17,83,-66,-125
83,2022/7/15 15:30,20,53,-33,-81
83,2022/7/15 15:40,15,69,-54,-142
83,2022/7/15 15:50,15,72,-57,-124
83,2022/7/15 16:00,18,90,-72,-132
83,2022/7/15 16:10,17,75,-58,-138
83,2022/7/15 16:20,18,71,-53,-122
83,2022/7/15 16:30,20,102,-82,-122
83,2022/7/15 16:40,18,76,-58,-113
83,2022/7/15 16:50,22,87,-65,-115
83,2022/7/15 17:00,17,83,-66,-163
83,2022/7/15 17:10,20,122,-102,-133
83,2022/7/15 17:20,13,89,-76,-151
83,2022/7/15 17:30,17,108,-91,-193
83,2022/7/15 17:40,18,103,-85,-160
83,2022/7/15 17:50,19,108,-89,-206
83,2022/7/15 18:00,15,144,-129,-216
83,2022/7/15 18:10,15,110,-95,-280
83,2022/7/15 18:20,15,139,-124,-227
83,2022/7/15 18:30,14,180,-166,-261
83,2022/7/15 18:40,15,127,-112,-273
83,2022/7/15 18:50,16,235,-219,-341
83,2022/7/15 19:00,14,110,-96,-297
83,2022/7/15 19:10,12,222,-210,-324
83,2022/7/15 19:20,11,192,-181,-366
83,2022/7/15 19:30,13,180,-167,-277
83,2022/7/15 19:40,11,104,-93,-217
83,2022/7/15 19:50,11,95,-84,-198
83,2022/7/15 20:00,11,119,-108,-195
83,2022/7/15 20:10,13,92,-79,-154
83,2022/7/15 20:20,7,95,-88,-196
83,2022/7/15 20:30,11,101,-90,-158
83,2022/7/15 20:40,8,126,-118,-195
83,2022/7/15 20:50,8,85,-77,-146
83,2022/7/15 21:00,7,95,-88,-163
83,2022/7/15 21:10,7,104,-97,-187
83,2022/7/15 21:20,6,69,-63,-145
83,2022/7/15 21:30,4,62,-58,-147
83,2022/7/15 21:40,5,104,-99,-118
83,2022/7/15 21:50,1,101,-100,-196
83,2022/7/15 22:00,1,91,-90,-204
83,2022/7/15 22:10,1,69,-68,-168
83,2022/7/15 22:20,1,102,-101,-120
83,2022/7/15 22:30,0,7,-7,-16
83,2022/7/15 22:40,0,3,-3,-13
83,2022/7/15 22:50,0,3,-3,-13
82,2022/7/15 5:00,0,1,-1,-5
82,2022/7/15 5:10,0,1,-1,-5
82,2022/7/15 5:20,0,1,-1,-5
82,2022/7/15 5:30,0,1,-1,-3
82,2022/7/15 5:40,0,1,-1,2
82,2022/7/15 5:50,2,1,1,28
82,2022/7/15 6:00,27,1,26,82
82,2022/7/15 6:10,21,1,20,143
82,2022/7/15 6:20,30,1,29,154
82,2022/7/15 6:30,21,2,19,151
82,2022/7/15 6:40,33,5,28,169
82,2022/7/15 6:50,28,6,22,271
82,2022/7/15 7:00,40,8,32,212
82,2022/7/15 7:10,32,21,11,224
82,2022/7/15 7:20,77,23,54,395
82,2022/7/15 7:30,58,25,33,382
82,2022/7/15 7:40,82,23,59,445
82,2022/7/15 7:50,62,23,39,416
82,2022/7/15 8:00,52,21,31,378
82,2022/7/15 8:10,36,21,15,302
82,2022/7/15 8:20,36,21,15,182
82,2022/7/15 8:30,35,21,14,153
82,2022/7/15 8:40,18,21,-3,96
82,2022/7/15 8:50,29,19,10,-13
82,2022/7/15 9:00,12,14,-2,-18
82,2022/7/15 9:10,13,19,-6,-49
82,2022/7/15 9:20,16,21,-5,-66
82,2022/7/15 9:30,5,18,-13,-109
82,2022/7/15 9:40,14,21,-7,-79
82,2022/7/15 9:50,10,19,-9,-94
82,2022/7/15 10:00,4,23,-19,-60
82,2022/7/15 10:10,12,21,-9,-84
82,2022/7/15 10:20,5,19,-14,-88
82,2022/7/15 10:30,8,21,-13,-91
82,2022/7/15 10:40,9,19,-10,-38
82,2022/7/15 10:50,4,23,-19,-89
82,2022/7/15 11:00,8,21,-13,-71
82,2022/7/15 11:10,4,16,-12,-101
82,2022/7/15 11:20,11,15,-4,-81
82,2022/7/15 11:30,4,23,-19,-72
82,2022/7/15 11:40,11,16,-5,-64
82,2022/7/15 11:50,2,21,-19,-72
82,2022/7/15 12:00,13,16,-3,-77
82,2022/7/15 12:10,6,25,-19,-92
82,2022/7/15 12:20,10,16,-6,-64
82,2022/7/15 12:30,10,18,-8,-100
82,2022/7/15 12:40,5,21,-16,-80
82,2022/7/15 12:50,8,29,-21,-112
82,2022/7/15 13:00,3,23,-20,-97
82,2022/7/15 13:10,9,14,-5,-100
82,2022/7/15 13:20,7,21,-14,-107
82,2022/7/15 13:30,4,23,-19,-100
82,2022/7/15 13:40,8,23,-15,-111
82,2022/7/15 13:50,2,21,-19,-105
82,2022/7/15 14:00,7,19,-12,-86
82,2022/7/15 14:10,6,33,-27,-125
82,2022/7/15 14:20,4,19,-15,-100
82,2022/7/15 14:30,7,23,-16,-127
82,2022/7/15 14:40,2,23,-21,-108
82,2022/7/15 14:50,6,29,-23,-122
82,2022/7/15 15:00,6,21,-15,-142
82,2022/7/15 15:10,4,17,-13,-133
82,2022/7/15 15:20,6,28,-22,-147
82,2022/7/15 15:30,2,38,-36,-117
82,2022/7/15 15:40,9,37,-28,-170
82,2022/7/15 15:50,8,36,-28,-152
82,2022/7/15 16:00,3,31,-28,-160
82,2022/7/15 16:10,9,53,-44,-182
82,2022/7/15 16:20,4,29,-25,-147
82,2022/7/15 16:30,10,50,-40,-162
82,2022/7/15 16:40,12,44,-32,-145
82,2022/7/15 16:50,7,38,-31,-146
82,2022/7/15 17:00,11,59,-48,-211
82,2022/7/15 17:10,6,38,-32,-165
82,2022/7/15 17:20,6,67,-61,-212
82,2022/7/15 17:30,10,51,-41,-234
82,2022/7/15 17:40,4,56,-52,-212
82,2022/7/15 17:50,12,82,-70,-276
82,2022/7/15 18:00,9,61,-52,-268
82,2022/7/15 18:10,5,94,-89,-369
82,2022/7/15 18:20,3,65,-62,-289
82,2022/7/15 18:30,6,99,-93,-354
82,2022/7/15 18:40,5,62,-57,-330
82,2022/7/15 18:50,2,70,-68,-409
82,2022/7/15 19:00,5,92,-87,-384
82,2022/7/15 19:10,4,72,-68,-392
82,2022/7/15 19:20,2,92,-90,-456
82,2022/7/15 19:30,2,56,-54,-331
82,2022/7/15 19:40,2,70,-68,-285
82,2022/7/15 19:50,1,47,-46,-244
82,2022/7/15 20:00,2,46,-44,-239
82,2022/7/15 20:10,1,67,-66,-220
82,2022/7/15 20:20,2,39,-37,-233
82,2022/7/15 20:30,1,36,-35,-193
82,2022/7/15 20:40,2,25,-23,-218
82,2022/7/15 20:50,1,50,-49,-195
82,2022/7/15 21:00,2,40,-38,-201
82,2022/7/15 21:10,2,41,-39,-226
82,2022/7/15 21:20,1,8,-7,-152
82,2022/7/15 21:30,2,43,-41,-188
82,2022/7/15 21:40,0,40,-40,-158
82,2022/7/15 21:50,0,33,-33,-229
82,2022/7/15 22:00,0,7,-7,-211
82,2022/7/15 22:10,0,40,-40,-208
82,2022/7/15 22:20,0,38,-38,-158
82,2022/7/15 22:30,0,3,-3,-19
82,2022/7/15 22:40,0,3,-3,-16
82,2022/7/15 22:50,0,3,-3,-16
91,2022/7/15 5:00,0,1,-1,-6
91,2022/7/15 5:10,0,1,-1,-6
91,2022/7/15 5:20,0,1,-1,-6
91,2022/7/15 5:30,0,1,-1,-4
91,2022/7/15 5:40,0,1,-1,1
91,2022/7/15 5:50,28,1,27,55
91,2022/7/15 6:00,121,1,120,202
91,2022/7/15 6:10,42,16,26,169
91,2022/7/15 6:20,73,16,57,211
91,2022/7/15 6:30,94,22,72,223
91,2022/7/15 6:40,168,19,149,318
91,2022/7/15 6:50,134,43,91,362
91,2022/7/15 7:00,147,52,95,307
91,2022/7/15 7:10,209,83,126,350
91,2022/7/15 7:20,227,81,146,541
91,2022/7/15 7:30,239,67,172,554
91,2022/7/15 7:40,318,76,242,687
91,2022/7/15 7:50,173,72,101,517
91,2022/7/15 8:00,161,77,84,462
91,2022/7/15 8:10,158,83,75,377
91,2022/7/15 8:20,85,62,23,205
91,2022/7/15 8:30,71,74,-3,150
91,2022/7/15 8:40,72,61,11,107
91,2022/7/15 8:50,55,64,-9,-22
91,2022/7/15 9:00,35,49,-14,-32
91,2022/7/15 9:10,27,60,-33,-82
91,2022/7/15 9:20,37,64,-27,-93
91,2022/7/15 9:30,26,68,-42,-151
91,2022/7/15 9:40,28,80,-52,-131
91,2022/7/15 9:50,31,65,-34,-128
91,2022/7/15 10:00,24,66,-42,-102
91,2022/7/15 10:10,24,55,-31,-115
91,2022/7/15 10:20,24,63,-39,-127
91,2022/7/15 10:30,29,73,-44,-135
91,2022/7/15 10:40,21,54,-33,-71
91,2022/7/15 10:50,21,46,-25,-114
91,2022/7/15 11:00,26,64,-38,-109
91,2022/7/15 11:10,26,69,-43,-144
91,2022/7/15 11:20,26,54,-28,-109
91,2022/7/15 11:30,25,57,-32,-104
91,2022/7/15 11:40,25,44,-19,-83
91,2022/7/15 11:50,22,65,-43,-115
91,2022/7/15 12:00,28,38,-10,-87
91,2022/7/15 12:10,24,58,-34,-126
91,2022/7/15 12:20,25,53,-28,-92
91,2022/7/15 12:30,22,71,-49,-149
91,2022/7/15 12:40,22,53,-31,-111
91,2022/7/15 12:50,29,45,-16,-128
91,2022/7/15 13:00,22,65,-43,-140
91,2022/7/15 13:10,24,80,-56,-156
91,2022/7/15 13:20,26,63,-37,-144
91,2022/7/15 13:30,24,59,-35,-135
91,2022/7/15 13:40,24,51,-27,-138
91,2022/7/15 13:50,26,81,-55,-160
91,2022/7/15 14:00,28,49,-21,-107
91,2022/7/15 14:10,26,62,-36,-161
91,2022/7/15 14:20,25,63,-38,-138
91,2022/7/15 14:30,25,68,-43,-170
91,2022/7/15 14:40,25,57,-32,-140
91,2022/7/15 14:50,26,54,-28,-150
91,2022/7/15 15:00,25,57,-32,-174
91,2022/7/15 15:10,23,73,-50,-183
91,2022/7/15 15:20,27,60,-33,-180
91,2022/7/15 15:30,25,68,-43,-160
91,2022/7/15 15:40,29,56,-27,-197
91,2022/7/15 15:50,24,92,-68,-220
91,2022/7/15 16:00,26,76,-50,-210
91,2022/7/15 16:10,23,71,-48,-230
91,2022/7/15 16:20,28,90,-62,-209
91,2022/7/15 16:30,27,93,-66,-228
91,2022/7/15 16:40,23,67,-44,-189
91,2022/7/15 16:50,25,100,-75,-221
91,2022/7/15 17:00,31,75,-44,-255
91,2022/7/15 17:10,37,105,-68,-233
91,2022/7/15 17:20,29,87,-58,-270
91,2022/7/15 17:30,29,111,-82,-316
91,2022/7/15 17:40,27,110,-83,-295
91,2022/7/15 17:50,27,108,-81,-357
91,2022/7/15 18:00,27,128,-101,-369
91,2022/7/15 18:10,20,114,-94,-463
91,2022/7/15 18:20,15,192,-177,-466
91,2022/7/15 18:30,23,129,-106,-460
91,2022/7/15 18:40,18,113,-95,-425
91,2022/7/15 18:50,15,184,-169,-578
91,2022/7/15 19:00,15,104,-89,-473
91,2022/7/15 19:10,12,179,-167,-559
91,2022/7/15 19:20,11,104,-93,-549
91,2022/7/15 19:30,7,109,-102,-433
91,2022/7/15 19:40,10,92,-82,-367
91,2022/7/15 19:50,9,108,-99,-343
91,2022/7/15 20:00,7,86,-79,-318
91,2022/7/15 20:10,7,85,-78,-298
91,2022/7/15 20:20,6,70,-64,-297
91,2022/7/15 20:30,6,107,-101,-294
91,2022/7/15 20:40,4,67,-63,-281
91,2022/7/15 20:50,2,73,-71,-266
91,2022/7/15 21:00,5,67,-62,-263
91,2022/7/15 21:10,2,61,-59,-285
91,2022/7/15 21:20,3,83,-80,-232
91,2022/7/15 21:30,2,71,-69,-257
91,2022/7/15 21:40,2,64,-62,-220
91,2022/7/15 21:50,1,8,-7,-236
91,2022/7/15 22:00,1,73,-72,-283
91,2022/7/15 22:10,0,70,-70,-278
91,2022/7/15 22:20,0,13,-13,-171
91,2022/7/15 22:30,0,62,-62,-81
91,2022/7/15 22:40,0,3,-3,-19
91,2022/7/15 22:50,0,3,-3,-19
85,2022/7/15 5:00,0,1,-1,-7
85,2022/7/15 5:10,0,1,-1,-7
85,2022/7/15 5:20,0,1,-1,-7
85,2022/7/15 5:30,0,1,-1,-5
85,2022/7/15 5:40,6,1,5,6
85,2022/7/15 5:50,72,1,71,126
85,2022/7/15 6:00,113,1,112,314
85,2022/7/15 6:10,169,1,168,337
85,2022/7/15 6:20,233,49,184,395
85,2022/7/15 6:30,249,38,211,434
85,2022/7/15 6:40,348,46,302,620
85,2022/7/15 6:50,339,41,298,660
85,2022/7/15 7:00,390,69,321,628
85,2022/7/15 7:10,345,75,270,620
85,2022/7/15 7:20,340,86,254,795
85,2022/7/15 7:30,347,105,242,796
85,2022/7/15 7:40,280,92,188,875
85,2022/7/15 7:50,274,96,178,695
85,2022/7/15 8:00,222,85,137,599
85,2022/7/15 8:10,220,105,115,492
85,2022/7/15 8:20,185,101,84,289
85,2022/7/15 8:30,147,105,42,192
85,2022/7/15 8:40,111,103,8,115
85,2022/7/15 8:50,90,88,2,-20
85,2022/7/15 9:00,57,85,-28,-60
85,2022/7/15 9:10,65,74,-9,-91
85,2022/7/15 9:20,47,92,-45,-138
85,2022/7/15 9:30,50,87,-37,-188
85,2022/7/15 9:40,43,100,-57,-188
85,2022/7/15 9:50,41,103,-62,-190
85,2022/7/15 10:00,39,102,-63,-165
85,2022/7/15 10:10,40,98,-58,-173
85,2022/7/15 10:20,42,77,-35,-162
85,2022/7/15 10:30,41,76,-35,-170
85,2022/7/15 10:40,41,124,-83,-154
85,2022/7/15 10:50,42,98,-56,-170
85,2022/7/15 11:00,41,67,-26,-135
85,2022/7/15 11:10,42,93,-51,-195
85,2022/7/15 11:20,43,105,-62,-171
85,2022/7/15 11:30,47,98,-51,-155
85,2022/7/15 11:40,61,93,-32,-115
85,2022/7/15 11:50,61,66,-5,-120
85,2022/7/15 12:00,44,123,-79,-166
85,2022/7/15 12:10,58,92,-34,-160
85,2022/7/15 12:20,47,90,-43,-135
85,2022/7/15 12:30,55,91,-36,-185
85,2022/7/15 12:40,45,118,-73,-184
85,2022/7/15 12:50,46,106,-60,-188
85,2022/7/15 13:00,37,97,-60,-200
85,2022/7/15 13:10,47,103,-56,-212
85,2022/7/15 13:20,49,114,-65,-209
85,2022/7/15 13:30,43,100,-57,-192
85,2022/7/15 13:40,39,105,-66,-204
85,2022/7/15 13:50,40,82,-42,-202
85,2022/7/15 14:00,41,108,-67,-174
85,2022/7/15 14:10,49,89,-40,-201
85,2022/7/15 14:20,54,99,-45,-183
85,2022/7/15 14:30,52,100,-48,-218
85,2022/7/15 14:40,44,119,-75,-215
85,2022/7/15 14:50,55,83,-28,-178
85,2022/7/15 15:00,45,89,-44,-218
85,2022/7/15 15:10,49,102,-53,-236
85,2022/7/15 15:20,50,108,-58,-238
85,2022/7/15 15:30,45,97,-52,-212
85,2022/7/15 15:40,44,117,-73,-270
85,2022/7/15 15:50,41,99,-58,-278
85,2022/7/15 16:00,43,110,-67,-277
85,2022/7/15 16:10,54,146,-92,-322
85,2022/7/15 16:20,44,119,-75,-284
85,2022/7/15 16:30,54,119,-65,-293
85,2022/7/15 16:40,43,179,-136,-325
85,2022/7/15 16:50,55,105,-50,-271
85,2022/7/15 17:00,51,283,-232,-487
85,2022/7/15 17:10,62,110,-48,-281
85,2022/7/15 17:20,46,180,-134,-404
85,2022/7/15 17:30,44,125,-81,-397
85,2022/7/15 17:40,38,116,-78,-373
85,2022/7/15 17:50,35,233,-198,-555
85,2022/7/15 18:00,32,110,-78,-447
85,2022/7/15 18:10,33,235,-202,-665
85,2022/7/15 18:20,29,104,-75,-541
85,2022/7/15 18:30,28,198,-170,-630
85,2022/7/15 18:40,30,180,-150,-575
85,2022/7/15 18:50,25,119,-94,-672
85,2022/7/15 19:00,24,330,-306,-779
85,2022/7/15 19:10,22,110,-88,-647
85,2022/7/15 19:20,28,256,-228,-777
85,2022/7/15 19:30,25,128,-103,-536
85,2022/7/15 19:40,23,192,-169,-536
85,2022/7/15 19:50,22,121,-99,-442
85,2022/7/15 20:00,21,109,-88,-406
85,2022/7/15 20:10,25,101,-76,-374
85,2022/7/15 20:20,21,106,-85,-382
85,2022/7/15 20:30,24,93,-69,-363
85,2022/7/15 20:40,17,123,-106,-387
85,2022/7/15 20:50,18,87,-69,-335
85,2022/7/15 21:00,19,95,-76,-339
85,2022/7/15 21:10,19,77,-58,-343
85,2022/7/15 21:20,15,76,-61,-293
85,2022/7/15 21:30,12,101,-89,-346
85,2022/7/15 21:40,12,98,-86,-306
85,2022/7/15 21:50,7,17,-10,-246
85,2022/7/15 22:00,6,91,-85,-368
85,2022/7/15 22:10,5,89,-84,-362
85,2022/7/15 22:20,1,7,-6,-177
85,2022/7/15 22:30,0,90,-90,-171
85,2022/7/15 22:40,0,89,-89,-108
85,2022/7/15 22:50,0,3,-3,-22
86,2022/7/15 5:00,0,1,-1,-8
86,2022/7/15 5:10,0,1,-1,-8
86,2022/7/15 5:20,0,1,-1,-8
86,2022/7/15 5:30,0,1,-1,-6
86,2022/7/15 5:40,0,1,-1,5
86,2022/7/15 5:50,0,1,-1,125
86,2022/7/15 6:00,24,1,23,337
86,2022/7/15 6:10,32,1,31,368
86,2022/7/15 6:20,30,2,28,423
86,2022/7/15 6:30,26,2,24,458
86,2022/7/15 6:40,35,1,34,654
86,2022/7/15 6:50,36,2,34,694
86,2022/7/15 7:00,55,8,47,675
86,2022/7/15 7:10,44,6,38,658
86,2022/7/15 7:20,37,14,23,818
86,2022/7/15 7:30,49,25,24,820
86,2022/7/15 7:40,34,23,11,886
86,2022/7/15 7:50,26,23,3,698
86,2022/7/15 8:00,29,23,6,605
86,2022/7/15 8:10,24,21,3,495
86,2022/7/15 8:20,19,19,0,289
86,2022/7/15 8:30,16,21,-5,187
86,2022/7/15 8:40,17,19,-2,113
86,2022/7/15 8:50,13,19,-6,-26
86,2022/7/15 9:00,9,19,-10,-70
86,2022/7/15 9:10,8,16,-8,-99
86,2022/7/15 9:20,8,21,-13,-151
86,2022/7/15 9:30,6,23,-17,-205
86,2022/7/15 9:40,9,19,-10,-198
86,2022/7/15 9:50,6,16,-10,-200
86,2022/7/15 10:00,11,18,-7,-172
86,2022/7/15 10:10,8,19,-11,-184
86,2022/7/15 10:20,7,23,-16,-178
86,2022/7/15 10:30,10,17,-7,-177
86,2022/7/15 10:40,8,16,-8,-162
86,2022/7/15 10:50,9,17,-8,-178
86,2022/7/15 11:00,6,14,-8,-143
86,2022/7/15 11:10,9,21,-12,-207
86,2022/7/15 11:20,11,18,-7,-178
86,2022/7/15 11:30,17,8,9,-146
86,2022/7/15 11:40,16,16,0,-115
86,2022/7/15 11:50,13,23,-10,-130
86,2022/7/15 12:00,14,17,-3,-169
86,2022/7/15 12:10,14,16,-2,-162
86,2022/7/15 12:20,7,12,-5,-140
86,2022/7/15 12:30,12,32,-20,-205
86,2022/7/15 12:40,13,14,-1,-185
86,2022/7/15 12:50,10,17,-7,-195
86,2022/7/15 13:00,12,21,-9,-209
86,2022/7/15 13:10,11,19,-8,-220
86,2022/7/15 13:20,6,19,-13,-222
86,2022/7/15 13:30,7,12,-5,-197
86,2022/7/15 13:40,6,19,-13,-217
86,2022/7/15 13:50,10,21,-11,-213
86,2022/7/15 14:00,10,14,-4,-178
86,2022/7/15 14:10,9,11,-2,-203
86,2022/7/15 14:20,7,16,-9,-192
86,2022/7/15 14:30,7,23,-16,-234
86,2022/7/15 14:40,10,14,-4,-219
86,2022/7/15 14:50,7,14,-7,-185
86,2022/7/15 15:00,10,21,-11,-229
86,2022/7/15 15:10,8,23,-15,-251
86,2022/7/15 15:20,7,22,-15,-253
86,2022/7/15 15:30,8,18,-10,-222
86,2022/7/15 15:40,12,22,-10,-280
86,2022/7/15 15:50,5,37,-32,-310
86,2022/7/15 16:00,6,22,-16,-293
86,2022/7/15 16:10,10,35,-25,-347
86,2022/7/15 16:20,12,23,-11,-295
86,2022/7/15 16:30,8,46,-38,-331
86,2022/7/15 16:40,7,22,-15,-340
86,2022/7/15 16:50,6,44,-38,-309
86,2022/7/15 17:00,3,36,-33,-520
86,2022/7/15 17:10,8,32,-24,-305
86,2022/7/15 17:20,6,46,-40,-444
86,2022/7/15 17:30,7,25,-18,-415
86,2022/7/15 17:40,3,46,-43,-416
86,2022/7/15 17:50,6,37,-31,-586
86,2022/7/15 18:00,3,40,-37,-484
86,2022/7/15 18:10,2,46,-44,-709
86,2022/7/15 18:20,2,32,-30,-571
86,2022/7/15 18:30,3,43,-40,-670
86,2022/7/15 18:40,3,38,-35,-610
86,2022/7/15 18:50,1,57,-56,-728
86,2022/7/15 19:00,2,39,-37,-816
86,2022/7/15 19:10,2,39,-37,-684
86,2022/7/15 19:20,2,56,-54,-831
86,2022/7/15 19:30,1,35,-34,-570
86,2022/7/15 19:40,1,48,-47,-583
86,2022/7/15 19:50,1,23,-22,-464
86,2022/7/15 20:00,1,40,-39,-445
86,2022/7/15 20:10,0,18,-18,-392
86,2022/7/15 20:20,1,18,-17,-399
86,2022/7/15 20:30,1,25,-24,-387
86,2022/7/15 20:40,1,15,-14,-401
86,2022/7/15 20:50,1,15,-14,-349
86,2022/7/15 21:00,0,10,-10,-349
86,2022/7/15 21:10,0,25,-25,-368
86,2022/7/15 21:20,0,21,-21,-314
86,2022/7/15 21:30,0,21,-21,-367
86,2022/7/15 21:40,0,3,-3,-309
86,2022/7/15 21:50,0,15,-15,-261
86,2022/7/15 22:00,0,23,-23,-391
86,2022/7/15 22:10,0,3,-3,-365
86,2022/7/15 22:20,0,15,-15,-192
86,2022/7/15 22:30,0,3,-3,-174
86,2022/7/15 22:40,0,13,-13,-121
86,2022/7/15 22:50,0,10,-10,-32
90,2022/7/15 5:00,0,1,-1,-9
90,2022/7/15 5:10,0,1,-1,-9
90,2022/7/15 5:20,0,1,-1,-9
90,2022/7/15 5:30,0,1,-1,-7
90,2022/7/15 5:40,1,1,0,5
90,2022/7/15 5:50,36,1,35,160
90,2022/7/15 6:00,34,1,33,370
90,2022/7/15 6:10,32,1,31,399
90,2022/7/15 6:20,28,1,27,450
90,2022/7/15 6:30,43,1,42,500
90,2022/7/15 6:40,34,19,15,669
90,2022/7/15 6:50,55,6,49,743
90,2022/7/15 7:00,47,6,41,716
90,2022/7/15 7:10,51,19,32,690
90,2022/7/15 7:20,54,19,35,853
90,2022/7/15 7:30,38,19,19,839
90,2022/7/15 7:40,43,23,20,906
90,2022/7/15 7:50,29,32,-3,695
90,2022/7/15 8:00,29,22,7,612
90,2022/7/15 8:10,21,23,-2,493
90,2022/7/15 8:20,23,21,2,291
90,2022/7/15 8:30,15,29,-14,173
90,2022/7/15 8:40,15,32,-17,96
90,2022/7/15 8:50,11,23,-12,-38
90,2022/7/15 9:00,13,30,-17,-87
90,2022/7/15 9:10,6,32,-26,-125
90,2022/7/15 9:20,15,21,-6,-157
90,2022/7/15 9:30,8,23,-15,-220
90,2022/7/15 9:40,9,31,-22,-220
90,2022/7/15 9:50,8,23,-15,-215
90,2022/7/15 10:00,12,23,-11,-183
90,2022/7/15 10:10,6,31,-25,-209
90,2022/7/15 10:20,3,32,-29,-207
90,2022/7/15 10:30,5,38,-33,-210
90,2022/7/15 10:40,9,23,-14,-176
90,2022/7/15 10:50,6,25,-19,-197
90,2022/7/15 11:00,6,27,-21,-164
90,2022/7/15 11:10,7,37,-30,-237
90,2022/7/15 11:20,12,23,-11,-189
90,2022/7/15 11:30,7,23,-16,-162
90,2022/7/15 11:40,8,18,-10,-125
90,2022/7/15 11:50,9,37,-28,-158
90,2022/7/15 12:00,8,21,-13,-182
90,2022/7/15 12:10,7,23,-16,-178
90,2022/7/15 12:20,6,23,-17,-157
90,2022/7/15 12:30,7,32,-25,-230
90,2022/7/15 12:40,15,23,-8,-193
90,2022/7/15 12:50,5,15,-10,-205
90,2022/7/15 13:00,10,29,-19,-228
90,2022/7/15 13:10,9,37,-28,-248
90,2022/7/15 13:20,12,23,-11,-233
90,2022/7/15 13:30,7,31,-24,-221
90,2022/7/15 13:40,6,22,-16,-233
90,2022/7/15 13:50,6,37,-31,-244
90,2022/7/15 14:00,10,19,-9,-187
90,2022/7/15 14:10,8,34,-26,-229
90,2022/7/15 14:20,7,28,-21,-213
90,2022/7/15 14:30,8,40,-32,-266
90,2022/7/15 14:40,9,31,-22,-241
90,2022/7/15 14:50,9,23,-14,-199
90,2022/7/15 15:00,6,32,-26,-255
90,2022/7/15 15:10,7,43,-36,-287
90,2022/7/15 15:20,11,34,-23,-276
90,2022/7/15 15:30,8,31,-23,-245
90,2022/7/15 15:40,6,29,-23,-303
90,2022/7/15 15:50,8,60,-52,-362
90,2022/7/15 16:00,9,36,-27,-320
90,2022/7/15 16:10,13,40,-27,-374
90,2022/7/15 16:20,13,38,-25,-320
90,2022/7/15 16:30,9,63,-54,-385
90,2022/7/15 16:40,9,51,-42,-382
90,2022/7/15 16:50,14,38,-24,-333
90,2022/7/15 17:00,9,59,-50,-570
90,2022/7/15 17:10,9,48,-39,-344
90,2022/7/15 17:20,9,68,-59,-503
90,2022/7/15 17:30,9,51,-42,-457
90,2022/7/15 17:40,6,57,-51,-467
90,2022/7/15 17:50,10,71,-61,-647
90,2022/7/15 18:00,8,52,-44,-528
90,2022/7/15 18:10,7,72,-65,-774
90,2022/7/15 18:20,5,47,-42,-613
90,2022/7/15 18:30,6,72,-66,-736
90,2022/7/15 18:40,4,49,-45,-655
90,2022/7/15 18:50,2,58,-56,-784
90,2022/7/15 19:00,2,73,-71,-887
90,2022/7/15 19:10,4,53,-49,-733
90,2022/7/15 19:20,2,66,-64,-895
90,2022/7/15 19:30,2,47,-45,-615
90,2022/7/15 19:40,1,62,-61,-644
90,2022/7/15 19:50,4,63,-59,-523
90,2022/7/15 20:00,1,52,-51,-496
90,2022/7/15 20:10,3,42,-39,-431
90,2022/7/15 20:20,1,33,-32,-431
90,2022/7/15 20:30,2,54,-52,-439
90,2022/7/15 20:40,1,27,-26,-427
90,2022/7/15 20:50,1,32,-31,-380
90,2022/7/15 21:00,1,25,-24,-373
90,2022/7/15 21:10,2,47,-45,-413
90,2022/7/15 21:20,2,32,-30,-344
90,2022/7/15 21:30,0,25,-25,-392
90,2022/7/15 21:40,0,40,-40,-349
90,2022/7/15 21:50,0,4,-4,-265
90,2022/7/15 22:00,0,39,-39,-430
90,2022/7/15 22:10,0,31,-31,-396
90,2022/7/15 22:20,0,3,-3,-195
90,2022/7/15 22:30,0,32,-32,-206
90,2022/7/15 22:40,0,27,-27,-148
90,2022/7/15 22:50,0,7,-7,-39
87,2022/7/15 5:00,0,1,-1,-10
87,2022/7/15 5:10,0,1,-1,-10
87,2022/7/15 5:20,0,1,-1,-10
87,2022/7/15 5:30,0,1,-1,-8
87,2022/7/15 5:40,1,1,0,5
87,2022/7/15 5:50,9,1,8,168
87,2022/7/15 6:00,7,1,6,376
87,2022/7/15 6:10,3,1,2,401
87,2022/7/15 6:20,30,1,29,479
87,2022/7/15 6:30,22,1,21,521
87,2022/7/15 6:40,30,1,29,698
87,2022/7/15 6:50,28,23,5,748
87,2022/7/15 7:00,29,11,18,734
87,2022/7/15 7:10,26,17,9,699
87,2022/7/15 7:20,51,36,15,868
87,2022/7/15 7:30,28,36,-8,831
87,2022/7/15 7:40,28,60,-32,874
87,2022/7/15 7:50,29,57,-28,667
87,2022/7/15 8:00,18,32,-14,598
87,2022/7/15 8:10,19,45,-26,467
87,2022/7/15 8:20,25,55,-30,261
87,2022/7/15 8:30,11,43,-32,141
87,2022/7/15 8:40,16,40,-24,72
87,2022/7/15 8:50,18,64,-46,-84
87,2022/7/15 9:00,17,49,-32,-119
87,2022/7/15 9:10,12,35,-23,-148
87,2022/7/15 9:20,11,60,-49,-206
87,2022/7/15 9:30,12,46,-34,-254
87,2022/7/15 9:40,12,50,-38,-258
87,2022/7/15 9:50,19,37,-18,-233
87,2022/7/15 10:00,15,46,-31,-214
87,2022/7/15 10:10,19,45,-26,-235
87,2022/7/15 10:20,22,53,-31,-238
87,2022/7/15 10:30,20,40,-20,-230
87,2022/7/15 10:40,19,38,-19,-195
87,2022/7/15 10:50,13,36,-23,-220
87,2022/7/15 11:00,19,66,-47,-211
87,2022/7/15 11:10,18,37,-19,-256
87,2022/7/15 11:20,19,37,-18,-207
87,2022/7/15 11:30,14,38,-24,-186
87,2022/7/15 11:40,22,50,-28,-153
87,2022/7/15 11:50,14,49,-35,-193
87,2022/7/15 12:00,23,40,-17,-199
87,2022/7/15 12:10,25,29,-4,-182
87,2022/7/15 12:20,23,56,-33,-190
87,2022/7/15 12:30,23,38,-15,-245
87,2022/7/15 12:40,22,34,-12,-205
87,2022/7/15 12:50,19,37,-18,-223
87,2022/7/15 13:00,24,49,-25,-253
87,2022/7/15 13:10,25,38,-13,-261
87,2022/7/15 13:20,22,32,-10,-243
87,2022/7/15 13:30,19,29,-10,-231
87,2022/7/15 13:40,16,51,-35,-268
87,2022/7/15 13:50,21,34,-13,-257
87,2022/7/15 14:00,21,31,-10,-197
87,2022/7/15 14:10,21,25,-4,-233
87,2022/7/15 14:20,21,51,-30,-243
87,2022/7/15 14:30,26,38,-12,-278
87,2022/7/15 14:40,19,32,-13,-254
87,2022/7/15 14:50,22,38,-16,-215
87,2022/7/15 15:00,22,43,-21,-276
87,2022/7/15 15:10,26,38,-12,-299
87,2022/7/15 15:20,31,32,-1,-277
87,2022/7/15 15:30,28,33,-5,-250
87,2022/7/15 15:40,25,53,-28,-331
87,2022/7/15 15:50,19,37,-18,-380
87,2022/7/15 16:00,26,38,-12,-332
87,2022/7/15 16:10,24,37,-13,-387
87,2022/7/15 16:20,28,44,-16,-336
87,2022/7/15 16:30,22,62,-40,-425
87,2022/7/15 16:40,24,45,-21,-403
87,2022/7/15 16:50,21,45,-24,-357
87,2022/7/15 17:00,25,60,-35,-605
87,2022/7/15 17:10,21,32,-11,-355
87,2022/7/15 17:20,22,69,-47,-550
87,2022/7/15 17:30,12,45,-33,-490
87,2022/7/15 17:40,21,60,-39,-506
87,2022/7/15 17:50,23,40,-17,-664
87,2022/7/15 18:00,7,41,-34,-562
87,2022/7/15 18:10,17,63,-46,-820
87,2022/7/15 18:20,11,48,-37,-650
87,2022/7/15 18:30,7,69,-62,-798
87,2022/7/15 18:40,10,50,-40,-695
87,2022/7/15 18:50,12,74,-62,-846
87,2022/7/15 19:00,2,56,-54,-941
87,2022/7/15 19:10,13,49,-36,-769
87,2022/7/15 19:20,8,73,-65,-960
87,2022/7/15 19:30,5,46,-41,-656
87,2022/7/15 19:40,7,62,-55,-699
87,2022/7/15 19:50,8,49,-41,-564
87,2022/7/15 20:00,4,71,-67,-563
87,2022/7/15 20:10,10,50,-40,-471
87,2022/7/15 20:20,4,47,-43,-474
87,2022/7/15 20:30,5,43,-38,-477
87,2022/7/15 20:40,0,39,-39,-466
87,2022/7/15 20:50,9,38,-29,-409
87,2022/7/15 21:00,2,49,-47,-420
87,2022/7/15 21:10,3,39,-36,-449
87,2022/7/15 21:20,1,25,-24,-368
87,2022/7/15 21:30,2,27,-25,-417
87,2022/7/15 21:40,1,25,-24,-373
87,2022/7/15 21:50,1,30,-29,-294
87,2022/7/15 22:00,0,33,-33,-463
87,2022/7/15 22:10,0,3,-3,-399
87,2022/7/15 22:20,0,31,-31,-226
87,2022/7/15 22:30,0,24,-24,-230
87,2022/7/15 22:40,0,7,-7,-155
87,2022/7/15 22:50,0,25,-25,-64
81,2022/7/15 5:00,0,1,-1,-11
81,2022/7/15 5:10,0,1,-1,-11
81,2022/7/15 5:20,0,1,-1,-11
81,2022/7/15 5:30,0,1,-1,-9
81,2022/7/15 5:40,8,1,7,12
81,2022/7/15 5:50,5,1,4,172
81,2022/7/15 6:00,11,1,10,386
81,2022/7/15 6:10,18,1,17,418
81,2022/7/15 6:20,18,1,17,496
81,2022/7/15 6:30,22,1,21,542
81,2022/7/15 6:40,28,1,27,725
81,2022/7/15 6:50,29,68,-39,709
81,2022/7/15 7:00,41,52,-11,723
81,2022/7/15 7:10,24,71,-47,652
81,2022/7/15 7:20,34,76,-42,826
81,2022/7/15 7:30,19,70,-51,780
81,2022/7/15 7:40,26,50,-24,850
81,2022/7/15 7:50,22,62,-40,627
81,2022/7/15 8:00,23,75,-52,546
81,2022/7/15 8:10,21,78,-57,410
81,2022/7/15 8:20,16,82,-66,195
81,2022/7/15 8:30,18,75,-57,84
81,2022/7/15 8:40,13,76,-63,9
81,2022/7/15 8:50,22,81,-59,-143
81,2022/7/15 9:00,12,69,-57,-176
81,2022/7/15 9:10,13,61,-48,-196
81,2022/7/15 9:20,11,62,-51,-257
81,2022/7/15 9:30,13,38,-25,-279
81,2022/7/15 9:40,14,57,-43,-301
81,2022/7/15 9:50,20,51,-31,-264
81,2022/7/15 10:00,12,49,-37,-251
81,2022/7/15 10:10,24,47,-23,-258
81,2022/7/15 10:20,18,49,-31,-269
81,2022/7/15 10:30,21,52,-31,-261
81,2022/7/15 10:40,18,69,-51,-246
81,2022/7/15 10:50,22,51,-29,-249
81,2022/7/15 11:00,18,48,-30,-241
81,2022/7/15 11:10,20,48,-28,-284
81,2022/7/15 11:20,17,66,-49,-256
81,2022/7/15 11:30,23,46,-23,-209
81,2022/7/15 11:40,17,48,-31,-184
81,2022/7/15 11:50,23,33,-10,-203
81,2022/7/15 12:00,19,60,-41,-240
81,2022/7/15 12:10,23,34,-11,-193
81,2022/7/15 12:20,20,40,-20,-210
81,2022/7/15 12:30,20,38,-18,-263
81,2022/7/15 12:40,18,53,-35,-240
81,2022/7/15 12:50,20,45,-25,-248
81,2022/7/15 13:00,21,35,-14,-267
81,2022/7/15 13:10,22,38,-16,-277
81,2022/7/15 13:20,20,53,-33,-276
81,2022/7/15 13:30,23,38,-15,-246
81,2022/7/15 13:40,21,44,-23,-291
81,2022/7/15 13:50,20,37,-17,-274
81,2022/7/15 14:00,24,67,-43,-240
81,2022/7/15 14:10,25,41,-16,-249
81,2022/7/15 14:20,25,38,-13,-256
81,2022/7/15 14:30,22,38,-16,-294
81,2022/7/15 14:40,22,50,-28,-282
81,2022/7/15 14:50,23,38,-15,-230
81,2022/7/15 15:00,26,36,-10,-286
81,2022/7/15 15:10,29,35,-6,-305
81,2022/7/15 15:20,23,40,-17,-294
81,2022/7/15 15:30,30,50,-20,-270
81,2022/7/15 15:40,42,35,7,-324
81,2022/7/15 15:50,34,32,2,-378
81,2022/7/15 16:00,26,62,-36,-368
81,2022/7/15 16:10,39,32,7,-380
81,2022/7/15 16:20,26,36,-10,-346
81,2022/7/15 16:30,34,38,-4,-429
81,2022/7/15 16:40,25,45,-20,-423
81,2022/7/15 16:50,24,45,-21,-378
81,2022/7/15 17:00,31,31,0,-605
81,2022/7/15 17:10,21,45,-24,-379
81,2022/7/15 17:20,26,35,-9,-559
81,2022/7/15 17:30,23,53,-30,-520
81,2022/7/15 17:40,22,37,-15,-521
81,2022/7/15 17:50,11,34,-23,-687
81,2022/7/15 18:00,17,69,-52,-614
81,2022/7/15 18:10,16,47,-31,-851
81,2022/7/15 18:20,14,55,-41,-691
81,2022/7/15 18:30,8,39,-31,-829
81,2022/7/15 18:40,13,59,-46,-741
81,2022/7/15 18:50,14,49,-35,-881
81,2022/7/15 19:00,5,41,-36,-977
81,2022/7/15 19:10,4,60,-56,-825
81,2022/7/15 19:20,10,38,-28,-988
81,2022/7/15 19:30,10,63,-53,-709
81,2022/7/15 19:40,4,34,-30,-729
81,2022/7/15 19:50,6,34,-28,-592
81,2022/7/15 20:00,1,56,-55,-618
81,2022/7/15 20:10,7,39,-32,-503
81,2022/7/15 20:20,4,40,-36,-510
81,2022/7/15 20:30,4,25,-21,-498
81,2022/7/15 20:40,2,41,-39,-505
81,2022/7/15 20:50,1,25,-24,-433
81,2022/7/15 21:00,1,25,-24,-444
81,2022/7/15 21:10,2,25,-23,-472
81,2022/7/15 21:20,0,33,-33,-401
81,2022/7/15 21:30,1,23,-22,-439
81,2022/7/15 21:40,0,25,-25,-398
81,2022/7/15 21:50,1,29,-28,-322
81,2022/7/15 22:00,0,3,-3,-466
81,2022/7/15 22:10,0,25,-25,-424
81,2022/7/15 22:20,0,34,-34,-260
81,2022/7/15 22:30,0,3,-3,-233
81,2022/7/15 22:40,0,27,-27,-182
81,2022/7/15 22:50,0,4,-4,-68
89,2022/7/15 5:00,0,1,-1,-12
89,2022/7/15 5:10,0,1,-1,-12
89,2022/7/15 5:20,0,1,-1,-12
89,2022/7/15 5:30,0,1,-1,-10
89,2022/7/15 5:40,0,1,-1,11
89,2022/7/15 5:50,1,1,0,172
89,2022/7/15 6:00,16,1,15,401
89,2022/7/15 6:10,51,1,50,468
89,2022/7/15 6:20,28,6,22,518
89,2022/7/15 6:30,35,6,29,571
89,2022/7/15 6:40,68,5,63,788
89,2022/7/15 6:50,55,23,32,741
89,2022/7/15 7:00,80,23,57,780
89,2022/7/15 7:10,85,23,62,714
89,2022/7/15 7:20,151,50,101,927
89,2022/7/15 7:30,150,66,84,864
89,2022/7/15 7:40,149,60,89,939
89,2022/7/15 7:50,54,65,-11,616
89,2022/7/15 8:00,77,68,9,555
89,2022/7/15 8:10,38,66,-28,382
89,2022/7/15 8:20,47,71,-24,171
89,2022/7/15 8:30,28,53,-25,59
89,2022/7/15 8:40,37,60,-23,-14
89,2022/7/15 8:50,25,53,-28,-171
89,2022/7/15 9:00,22,44,-22,-198
89,2022/7/15 9:10,25,39,-14,-210
89,2022/7/15 9:20,17,50,-33,-290
89,2022/7/15 9:30,22,51,-29,-308
89,2022/7/15 9:40,15,47,-32,-333
89,2022/7/15 9:50,13,47,-34,-298
89,2022/7/15 10:00,14,45,-31,-282
89,2022/7/15 10:10,16,65,-49,-307
89,2022/7/15 10:20,24,41,-17,-286
89,2022/7/15 10:30,18,49,-31,-292
89,2022/7/15 10:40,20,41,-21,-267
89,2022/7/15 10:50,18,54,-36,-285
89,2022/7/15 11:00,16,45,-29,-270
89,2022/7/15 11:10,18,45,-27,-311
89,2022/7/15 11:20,18,28,-10,-266
89,2022/7/15 11:30,18,62,-44,-253
89,2022/7/15 11:40,20,32,-12,-196
89,2022/7/15 11:50,20,47,-27,-230
89,2022/7/15 12:00,21,38,-17,-257
89,2022/7/15 12:10,19,51,-32,-225
89,2022/7/15 12:20,19,43,-24,-234
89,2022/7/15 12:30,23,29,-6,-269
89,2022/7/15 12:40,20,44,-24,-264
89,2022/7/15 12:50,20,58,-38,-286
89,2022/7/15 13:00,18,48,-30,-297
89,2022/7/15 13:10,14,44,-30,-307
89,2022/7/15 13:20,15,31,-16,-292
89,2022/7/15 13:30,13,57,-44,-290
89,2022/7/15 13:40,11,29,-18,-309
89,2022/7/15 13:50,16,40,-24,-298
89,2022/7/15 14:00,16,42,-26,-266
89,2022/7/15 14:10,16,48,-32,-281
89,2022/7/15 14:20,19,44,-25,-281
89,2022/7/15 14:30,18,32,-14,-308
89,2022/7/15 14:40,20,39,-19,-301
89,2022/7/15 14:50,18,45,-27,-257
89,2022/7/15 15:00,18,45,-27,-313
89,2022/7/15 15:10,20,41,-21,-326
89,2022/7/15 15:20,22,37,-15,-309
89,2022/7/15 15:30,21,58,-37,-307
89,2022/7/15 15:40,21,44,-23,-347
89,2022/7/15 15:50,26,49,-23,-401
89,2022/7/15 16:00,24,55,-31,-399
89,2022/7/15 16:10,28,62,-34,-414
89,2022/7/15 16:20,27,68,-41,-387
89,2022/7/15 16:30,26,41,-15,-444
89,2022/7/15 16:40,20,68,-48,-471
89,2022/7/15 16:50,30,61,-31,-409
89,2022/7/15 17:00,25,78,-53,-658
89,2022/7/15 17:10,36,60,-24,-403
89,2022/7/15 17:20,24,59,-35,-594
89,2022/7/15 17:30,20,88,-68,-588
89,2022/7/15 17:40,25,73,-48,-569
89,2022/7/15 17:50,15,93,-78,-765
89,2022/7/15 18:00,15,74,-59,-673
89,2022/7/15 18:10,16,100,-84,-935
89,2022/7/15 18:20,12,77,-65,-756
89,2022/7/15 18:30,8,83,-75,-904
89,2022/7/15 18:40,14,126,-112,-853
89,2022/7/15 18:50,9,86,-77,-958
89,2022/7/15 19:00,8,105,-97,-1074
89,2022/7/15 19:10,8,86,-78,-903
89,2022/7/15 19:20,7,75,-68,-1056
89,2022/7/15 19:30,6,115,-109,-818
89,2022/7/15 19:40,4,67,-63,-792
89,2022/7/15 19:50,3,75,-72,-664
89,2022/7/15 20:00,4,44,-40,-658
89,2022/7/15 20:10,2,70,-68,-571
89,2022/7/15 20:20,3,51,-48,-558
89,2022/7/15 20:30,2,44,-42,-540
89,2022/7/15 20:40,3,41,-38,-543
89,2022/7/15 20:50,4,56,-52,-485
89,2022/7/15 21:00,2,47,-45,-489
89,2022/7/15 21:10,1,39,-38,-510
89,2022/7/15 21:20,2,46,-44,-445
89,2022/7/15 21:30,2,3,-1,-440
89,2022/7/15 21:40,2,46,-44,-442
89,2022/7/15 21:50,2,46,-44,-366
89,2022/7/15 22:00,1,40,-39,-505
89,2022/7/15 22:10,1,7,-6,-430
89,2022/7/15 22:20,0,45,-45,-305
89,2022/7/15 22:30,0,30,-30,-263
89,2022/7/15 22:40,0,10,-10,-192
89,2022/7/15 22:50,0,3,-3,-71
96,2022/7/15 5:00,0,1,-1,-1
96,2022/7/15 5:10,16,1,15,15
96,2022/7/15 5:20,23,1,22,22
96,2022/7/15 5:30,25,1,24,24
96,2022/7/15 5:40,29,1,28,28
96,2022/7/15 5:50,38,1,37,37
96,2022/7/15 6:00,47,1,46,46
96,2022/7/15 6:10,66,64,2,2
96,2022/7/15 6:20,148,61,87,87
96,2022/7/15 6:30,185,84,101,101
96,2022/7/15 6:40,236,108,128,128
96,2022/7/15 6:50,275,91,184,184
96,2022/7/15 7:00,325,93,232,232
96,2022/7/15 7:10,593,119,474,474
96,2022/7/15 7:20,683,123,560,560
96,2022/7/15 7:30,666,114,552,552
96,2022/7/15 7:40,687,108,579,579
96,2022/7/15 7:50,862,127,735,735
96,2022/7/15 8:00,753,144,609,609
96,2022/7/15 8:10,665,106,559,559
96,2022/7/15 8:20,611,114,497,497
96,2022/7/15 8:30,474,122,352,352
96,2022/7/15 8:40,282,111,171,171
96,2022/7/15 8:50,246,110,136,136
96,2022/7/15 9:00,173,109,64,64
96,2022/7/15 9:10,121,110,11,11
96,2022/7/15 9:20,94,108,-14,-14
96,2022/7/15 9:30,63,90,-27,-27
96,2022/7/15 9:40,77,94,-17,-17
96,2022/7/15 9:50,58,77,-19,-19
96,2022/7/15 10:00,42,91,-49,-49
96,2022/7/15 10:10,46,87,-41,-41
96,2022/7/15 10:20,45,77,-32,-32
96,2022/7/15 10:30,45,74,-29,-29
96,2022/7/15 10:40,51,71,-20,-20
96,2022/7/15 10:50,53,90,-37,-37
96,2022/7/15 11:00,46,79,-33,-33
96,2022/7/15 11:10,58,76,-18,-18
96,2022/7/15 11:20,42,61,-19,-19
96,2022/7/15 11:30,73,82,-9,-9
96,2022/7/15 11:40,69,93,-24,-24
96,2022/7/15 11:50,57,94,-37,-37
96,2022/7/15 12:00,63,75,-12,-12
96,2022/7/15 12:10,62,78,-16,-16
96,2022/7/15 12:20,60,80,-20,-20
96,2022/7/15 12:30,47,109,-62,-62
96,2022/7/15 12:40,42,101,-59,-59
96,2022/7/15 12:50,44,82,-38,-38
96,2022/7/15 13:00,41,105,-64,-64
96,2022/7/15 13:10,43,73,-30,-30
96,2022/7/15 13:20,41,83,-42,-42
96,2022/7/15 13:30,45,92,-47,-47
96,2022/7/15 13:40,41,90,-49,-49
96,2022/7/15 13:50,42,73,-31,-31
96,2022/7/15 14:00,39,91,-52,-52
96,2022/7/15 14:10,39,64,-25,-25
96,2022/7/15 14:20,45,70,-25,-25
96,2022/7/15 14:30,38,97,-59,-59
96,2022/7/15 14:40,47,90,-43,-43
96,2022/7/15 14:50,43,75,-32,-32
96,2022/7/15 15:00,40,75,-35,-35
96,2022/7/15 15:10,41,76,-35,-35
96,2022/7/15 15:20,45,96,-51,-51
96,2022/7/15 15:30,39,97,-58,-58
96,2022/7/15 15:40,43,113,-70,-70
96,2022/7/15 15:50,44,90,-46,-46
96,2022/7/15 16:00,45,98,-53,-53
96,2022/7/15 16:10,58,74,-16,-16
96,2022/7/15 16:20,63,108,-45,-45
96,2022/7/15 16:30,61,107,-46,-46
96,2022/7/15 16:40,92,111,-19,-19
96,2022/7/15 16:50,128,103,25,25
96,2022/7/15 17:00,129,124,5,5
96,2022/7/15 17:10,156,102,54,54
96,2022/7/15 17:20,158,118,40,40
96,2022/7/15 17:30,59,107,-48,-48
96,2022/7/15 17:40,86,222,-136,-136
96,2022/7/15 17:50,47,118,-71,-71
96,2022/7/15 18:00,41,284,-243,-243
96,2022/7/15 18:10,39,269,-230,-230
96,2022/7/15 18:20,30,217,-187,-187
96,2022/7/15 18:30,28,314,-286,-286
96,2022/7/15 18:40,27,300,-273,-273
96,2022/7/15 18:50,29,333,-304,-304
96,2022/7/15 19:00,23,304,-281,-281
96,2022/7/15 19:10,23,299,-276,-276
96,2022/7/15 19:20,20,149,-129,-129
96,2022/7/15 19:30,18,180,-162,-162
96,2022/7/15 19:40,19,128,-109,-109
96,2022/7/15 19:50,18,106,-88,-88
96,2022/7/15 20:00,15,120,-105,-105
96,2022/7/15 20:10,16,122,-106,-106
96,2022/7/15 20:20,16,92,-76,-76
96,2022/7/15 20:30,13,127,-114,-114
96,2022/7/15 20:40,18,77,-59,-59
96,2022/7/15 20:50,10,106,-96,-96
96,2022/7/15 21:00,12,106,-94,-94
96,2022/7/15 21:10,9,107,-98,-98
96,2022/7/15 21:20,7,106,-99,-99
96,2022/7/15 21:30,10,110,-100,-100
96,2022/7/15 21:40,8,88,-80,-80
96,2022/7/15 21:50,7,92,-85,-85
96,2022/7/15 22:00,4,95,-91,-91
96,2022/7/15 22:10,7,82,-75,-75
96,2022/7/15 22:20,2,83,-81,-81
96,2022/7/15 22:30,0,95,-95,-95
96,2022/7/15 22:40,0,89,-89,-89
96,2022/7/15 22:50,0,95,-95,-95
119,2022/7/15 5:00,0,1,-1,-2
119,2022/7/15 5:10,5,1,4,19
119,2022/7/15 5:20,11,1,10,32
119,2022/7/15 5:30,10,1,9,33
119,2022/7/15 5:40,14,1,13,41
119,2022/7/15 5:50,19,1,18,55
119,2022/7/15 6:00,26,1,25,71
119,2022/7/15 6:10,27,13,14,16
119,2022/7/15 6:20,32,6,26,113
119,2022/7/15 6:30,37,8,29,130
119,2022/7/15 6:40,48,14,34,162
119,2022/7/15 6:50,71,19,52,236
119,2022/7/15 7:00,85,23,62,294
119,2022/7/15 7:10,181,23,158,632
119,2022/7/15 7:20,222,34,188,748
119,2022/7/15 7:30,236,62,174,726
119,2022/7/15 7:40,236,53,183,762
119,2022/7/15 7:50,234,63,171,906
119,2022/7/15 8:00,224,61,163,772
119,2022/7/15 8:10,188,78,110,669
119,2022/7/15 8:20,122,67,55,552
119,2022/7/15 8:30,76,72,4,356
119,2022/7/15 8:40,63,72,-9,162
119,2022/7/15 8:50,50,72,-22,114
119,2022/7/15 9:00,39,38,1,65
119,2022/7/15 9:10,30,48,-18,-7
119,2022/7/15 9:20,25,38,-13,-27
119,2022/7/15 9:30,28,40,-12,-39
119,2022/7/15 9:40,20,37,-17,-34
119,2022/7/15 9:50,21,34,-13,-32
119,2022/7/15 10:00,21,38,-17,-66
119,2022/7/15 10:10,17,31,-14,-55
119,2022/7/15 10:20,22,37,-15,-47
119,2022/7/15 10:30,18,32,-14,-43
119,2022/7/15 10:40,16,32,-16,-36
119,2022/7/15 10:50,14,23,-9,-46
119,2022/7/15 11:00,16,38,-22,-55
119,2022/7/15 11:10,15,31,-16,-34
119,2022/7/15 11:20,18,23,-5,-24
119,2022/7/15 11:30,17,19,-2,-11
119,2022/7/15 11:40,16,32,-16,-40
119,2022/7/15 11:50,17,29,-12,-49
119,2022/7/15 12:00,18,37,-19,-31
119,2022/7/15 12:10,19,30,-11,-27
119,2022/7/15 12:20,16,25,-9,-29
119,2022/7/15 12:30,18,21,-3,-65
119,2022/7/15 12:40,15,35,-20,-79
119,2022/7/15 12:50,15,35,-20,-58
119,2022/7/15 13:00,19,38,-19,-83
119,2022/7/15 13:10,16,31,-15,-45
119,2022/7/15 13:20,16,32,-16,-58
119,2022/7/15 13:30,16,25,-9,-56
119,2022/7/15 13:40,14,38,-24,-73
119,2022/7/15 13:50,15,38,-23,-54
119,2022/7/15 14:00,12,30,-18,-70
119,2022/7/15 14:10,14,37,-23,-48
119,2022/7/15 14:20,12,32,-20,-45
119,2022/7/15 14:30,14,32,-18,-77
119,2022/7/15 14:40,15,33,-18,-61
119,2022/7/15 14:50,14,38,-24,-56
119,2022/7/15 15:00,16,38,-22,-57
119,2022/7/15 15:10,17,37,-20,-55
119,2022/7/15 15:20,16,31,-15,-66
119,2022/7/15 15:30,16,33,-17,-75
119,2022/7/15 15:40,16,50,-34,-104
119,2022/7/15 15:50,17,47,-30,-76
119,2022/7/15 16:00,22,38,-16,-69
119,2022/7/15 16:10,15,45,-30,-46
119,2022/7/15 16:20,19,45,-26,-71
119,2022/7/15 16:30,24,48,-24,-70
119,2022/7/15 16:40,22,52,-30,-49
119,2022/7/15 16:50,20,62,-42,-17
119,2022/7/15 17:00,31,60,-29,-24
119,2022/7/15 17:10,32,64,-32,22
119,2022/7/15 17:20,27,54,-27,13
119,2022/7/15 17:30,27,76,-49,-97
119,2022/7/15 17:40,26,60,-34,-170
119,2022/7/15 17:50,20,101,-81,-152
119,2022/7/15 18:00,19,107,-88,-331
119,2022/7/15 18:10,22,102,-80,-310
119,2022/7/15 18:20,12,98,-86,-273
119,2022/7/15 18:30,14,113,-99,-385
119,2022/7/15 18:40,11,91,-80,-353
119,2022/7/15 18:50,13,126,-113,-417
119,2022/7/15 19:00,9,110,-101,-382
119,2022/7/15 19:10,11,107,-96,-372
119,2022/7/15 19:20,8,95,-87,-216
119,2022/7/15 19:30,7,92,-85,-247
119,2022/7/15 19:40,10,71,-61,-170
119,2022/7/15 19:50,8,74,-66,-154
119,2022/7/15 20:00,6,73,-67,-172
119,2022/7/15 20:10,9,52,-43,-149
119,2022/7/15 20:20,8,70,-62,-138
119,2022/7/15 20:30,7,64,-57,-171
119,2022/7/15 20:40,4,62,-58,-117
119,2022/7/15 20:50,8,63,-55,-151
119,2022/7/15 21:00,5,54,-49,-143
119,2022/7/15 21:10,6,55,-49,-147
119,2022/7/15 21:20,3,46,-43,-142
119,2022/7/15 21:30,3,60,-57,-157
119,2022/7/15 21:40,2,52,-50,-130
119,2022/7/15 21:50,5,48,-43,-128
119,2022/7/15 22:00,5,51,-46,-137
119,2022/7/15 22:10,2,52,-50,-125
119,2022/7/15 22:20,1,52,-51,-132
119,2022/7/15 22:30,1,60,-59,-154
119,2022/7/15 22:40,0,66,-66,-155
119,2022/7/15 22:50,0,62,-62,-157
93,2022/7/15 5:00,0,1,-1,-3
93,2022/7/15 5:10,10,1,9,28
93,2022/7/15 5:20,26,1,25,57
93,2022/7/15 5:30,27,1,26,59
93,2022/7/15 5:40,31,2,29,70
93,2022/7/15 5:50,34,1,33,88
93,2022/7/15 6:00,52,25,27,98
93,2022/7/15 6:10,59,5,54,70
93,2022/7/15 6:20,81,6,75,188
93,2022/7/15 6:30,155,23,132,262
93,2022/7/15 6:40,227,23,204,366
93,2022/7/15 6:50,277,29,248,484
93,2022/7/15 7:00,316,51,265,559
93,2022/7/15 7:10,589,42,547,1179
93,2022/7/15 7:20,706,101,605,1353
93,2022/7/15 7:30,839,100,739,1465
93,2022/7/15 7:40,1061,84,977,1739
93,2022/7/15 7:50,1056,87,969,1875
93,2022/7/15 8:00,1057,71,986,1758
93,2022/7/15 8:10,857,73,784,1453
93,2022/7/15 8:20,654,71,583,1135
93,2022/7/15 8:30,573,73,500,856
93,2022/7/15 8:40,350,60,290,452
93,2022/7/15 8:50,281,75,206,320
93,2022/7/15 9:00,229,48,181,246
93,2022/7/15 9:10,162,69,93,86
93,2022/7/15 9:20,77,70,7,-20
93,2022/7/15 9:30,62,75,-13,-52
93,2022/7/15 9:40,50,68,-18,-52
93,2022/7/15 9:50,45,85,-40,-72
93,2022/7/15 10:00,42,69,-27,-93
93,2022/7/15 10:10,35,67,-32,-87
93,2022/7/15 10:20,35,62,-27,-74
93,2022/7/15 10:30,36,59,-23,-66
93,2022/7/15 10:40,30,60,-30,-66
93,2022/7/15 10:50,35,51,-16,-62
93,2022/7/15 11:00,29,67,-38,-93
93,2022/7/15 11:10,30,66,-36,-70
93,2022/7/15 11:20,30,57,-27,-51
93,2022/7/15 11:30,45,66,-21,-32
93,2022/7/15 11:40,42,38,4,-36
93,2022/7/15 11:50,36,71,-35,-84
93,2022/7/15 12:00,39,70,-31,-62
93,2022/7/15 12:10,38,74,-36,-63
93,2022/7/15 12:20,37,59,-22,-51
93,2022/7/15 12:30,37,60,-23,-88
93,2022/7/15 12:40,30,46,-16,-95
93,2022/7/15 12:50,32,71,-39,-97
93,2022/7/15 13:00,28,62,-34,-117
93,2022/7/15 13:10,28,68,-40,-85
93,2022/7/15 13:20,27,64,-37,-95
93,2022/7/15 13:30,27,64,-37,-93
93,2022/7/15 13:40,25,57,-32,-105
93,2022/7/15 13:50,26,76,-50,-104
93,2022/7/15 14:00,28,61,-33,-103
93,2022/7/15 14:10,25,71,-46,-94
93,2022/7/15 14:20,23,68,-45,-90
93,2022/7/15 14:30,26,66,-40,-117
93,2022/7/15 14:40,29,70,-41,-102
93,2022/7/15 14:50,34,75,-41,-97
93,2022/7/15 15:00,24,91,-67,-124
93,2022/7/15 15:10,25,78,-53,-108
93,2022/7/15 15:20,28,91,-63,-129
93,2022/7/15 15:30,26,65,-39,-114
93,2022/7/15 15:40,29,72,-43,-147
93,2022/7/15 15:50,27,95,-68,-144
93,2022/7/15 16:00,27,101,-74,-143
93,2022/7/15 16:10,29,91,-62,-108
93,2022/7/15 16:20,29,93,-64,-135
93,2022/7/15 16:30,39,93,-54,-124
93,2022/7/15 16:40,31,96,-65,-114
93,2022/7/15 16:50,29,100,-71,-88
93,2022/7/15 17:00,30,122,-92,-116
93,2022/7/15 17:10,42,103,-61,-39
93,2022/7/15 17:20,40,111,-71,-58
93,2022/7/15 17:30,35,125,-90,-187
93,2022/7/15 17:40,28,143,-115,-285
93,2022/7/15 17:50,28,194,-166,-318
93,2022/7/15 18:00,29,269,-240,-571
93,2022/7/15 18:10,25,197,-172,-482
93,2022/7/15 18:20,29,340,-311,-584
93,2022/7/15 18:30,26,257,-231,-616
93,2022/7/15 18:40,23,365,-342,-695
93,2022/7/15 18:50,22,483,-461,-878
93,2022/7/15 19:00,25,382,-357,-739
93,2022/7/15 19:10,25,225,-200,-572
93,2022/7/15 19:20,22,334,-312,-528
93,2022/7/15 19:30,17,181,-164,-411
93,2022/7/15 19:40,20,206,-186,-356
93,2022/7/15 19:50,18,125,-107,-261
93,2022/7/15 20:00,16,124,-108,-280
93,2022/7/15 20:10,19,104,-85,-234
93,2022/7/15 20:20,17,117,-100,-238
93,2022/7/15 20:30,17,107,-90,-261
93,2022/7/15 20:40,14,113,-99,-216
93,2022/7/15 20:50,20,109,-89,-240
93,2022/7/15 21:00,19,127,-108,-251
93,2022/7/15 21:10,16,107,-91,-238
93,2022/7/15 21:20,14,106,-92,-234
93,2022/7/15 21:30,12,75,-63,-220
93,2022/7/15 21:40,10,98,-88,-218
93,2022/7/15 21:50,11,105,-94,-222
93,2022/7/15 22:00,10,100,-90,-227
93,2022/7/15 22:10,8,103,-95,-220
93,2022/7/15 22:20,6,59,-53,-185
93,2022/7/15 22:30,3,103,-100,-254
93,2022/7/15 22:40,2,80,-78,-233
93,2022/7/15 22:50,2,105,-103,-260
97,2022/7/15 5:00,1,1,0,-3
97,2022/7/15 5:10,7,1,6,34
97,2022/7/15 5:20,27,1,26,83
97,2022/7/15 5:30,34,2,32,91
97,2022/7/15 5:40,34,1,33,103
97,2022/7/15 5:50,54,1,53,141
97,2022/7/15 6:00,115,46,69,167
97,2022/7/15 6:10,225,38,187,257
97,2022/7/15 6:20,319,38,281,469
97,2022/7/15 6:30,391,39,352,614
97,2022/7/15 6:40,573,55,518,884
97,2022/7/15 6:50,638,76,562,1046
97,2022/7/15 7:00,679,58,621,1180
97,2022/7/15 7:10,1060,103,957,2136
97,2022/7/15 7:20,1215,101,1114,2467
97,2022/7/15 7:30,1581,117,1464,2929
97,2022/7/15 7:40,1584,144,1440,3179
97,2022/7/15 7:50,1979,117,1862,3737
97,2022/7/15 8:00,1596,110,1486,3244
97,2022/7/15 8:10,1595,114,1481,2934
97,2022/7/15 8:20,1367,115,1252,2387
97,2022/7/15 8:30,1060,128,932,1788
97,2022/7/15 8:40,679,109,570,1022
97,2022/7/15 8:50,600,108,492,812
97,2022/7/15 9:00,464,98,366,612
97,2022/7/15 9:10,289,100,189,275
97,2022/7/15 9:20,244,105,139,119
97,2022/7/15 9:30,220,100,120,68
97,2022/7/15 9:40,156,88,68,16
97,2022/7/15 9:50,148,103,45,-27
97,2022/7/15 10:00,112,91,21,-72
97,2022/7/15 10:10,73,81,-8,-95
97,2022/7/15 10:20,80,83,-3,-77
97,2022/7/15 10:30,55,96,-41,-107
97,2022/7/15 10:40,60,97,-37,-103
97,2022/7/15 10:50,47,65,-18,-80
97,2022/7/15 11:00,43,87,-44,-137
97,2022/7/15 11:10,52,97,-45,-115
97,2022/7/15 11:20,52,97,-45,-96
97,2022/7/15 11:30,42,76,-34,-66
97,2022/7/15 11:40,59,93,-34,-70
97,2022/7/15 11:50,66,73,-7,-91
97,2022/7/15 12:00,62,93,-31,-93
97,2022/7/15 12:10,68,108,-40,-103
97,2022/7/15 12:20,74,111,-37,-88
97,2022/7/15 12:30,51,80,-29,-117
97,2022/7/15 12:40,69,104,-35,-130
97,2022/7/15 12:50,54,71,-17,-114
97,2022/7/15 13:00,58,106,-48,-165
97,2022/7/15 13:10,54,108,-54,-139
97,2022/7/15 13:20,42,103,-61,-156
97,2022/7/15 13:30,43,96,-53,-146
97,2022/7/15 13:40,44,91,-47,-152
97,2022/7/15 13:50,45,102,-57,-161
97,2022/7/15 14:00,37,100,-63,-166
97,2022/7/15 14:10,38,105,-67,-161
97,2022/7/15 14:20,37,109,-72,-162
97,2022/7/15 14:30,39,98,-59,-176
97,2022/7/15 14:40,35,101,-66,-168
97,2022/7/15 14:50,41,98,-57,-154
97,2022/7/15 15:00,35,99,-64,-188
97,2022/7/15 15:10,35,119,-84,-192
97,2022/7/15 15:20,37,119,-82,-211
97,2022/7/15 15:30,32,121,-89,-203
97,2022/7/15 15:40,46,108,-62,-209
97,2022/7/15 15:50,42,123,-81,-225
97,2022/7/15 16:00,43,129,-86,-229
97,2022/7/15 16:10,47,137,-90,-198
97,2022/7/15 16:20,42,111,-69,-204
97,2022/7/15 16:30,46,169,-123,-247
97,2022/7/15 16:40,45,132,-87,-201
97,2022/7/15 16:50,51,128,-77,-165
97,2022/7/15 17:00,135,214,-79,-195
97,2022/7/15 17:10,202,279,-77,-116
97,2022/7/15 17:20,76,230,-154,-212
97,2022/7/15 17:30,157,367,-210,-397
97,2022/7/15 17:40,130,371,-241,-526
97,2022/7/15 17:50,111,484,-373,-691
97,2022/7/15 18:00,79,434,-355,-926
97,2022/7/15 18:10,132,314,-182,-664
97,2022/7/15 18:20,76,595,-519,-1103
97,2022/7/15 18:30,55,407,-352,-968
97,2022/7/15 18:40,46,1099,-1053,-1748
97,2022/7/15 18:50,43,621,-578,-1456
97,2022/7/15 19:00,35,492,-457,-1196
97,2022/7/15 19:10,29,292,-263,-835
97,2022/7/15 19:20,28,484,-456,-984
97,2022/7/15 19:30,27,223,-196,-607
97,2022/7/15 19:40,25,385,-360,-716
97,2022/7/15 19:50,28,254,-226,-487
97,2022/7/15 20:00,25,128,-103,-383
97,2022/7/15 20:10,28,234,-206,-440
97,2022/7/15 20:20,26,123,-97,-335
97,2022/7/15 20:30,25,179,-154,-415
97,2022/7/15 20:40,25,171,-146,-362
97,2022/7/15 20:50,23,151,-128,-368
97,2022/7/15 21:00,22,128,-106,-357
97,2022/7/15 21:10,25,126,-101,-339
97,2022/7/15 21:20,24,119,-95,-329
97,2022/7/15 21:30,16,128,-112,-332
97,2022/7/15 21:40,19,110,-91,-309
97,2022/7/15 21:50,14,124,-110,-332
97,2022/7/15 22:00,14,136,-122,-349
97,2022/7/15 22:10,13,114,-101,-321
97,2022/7/15 22:20,12,115,-103,-288
97,2022/7/15 22:30,6,120,-114,-368
97,2022/7/15 22:40,2,155,-153,-386
97,2022/7/15 22:50,1,123,-122,-382
101,2022/7/15 5:00,0,1,-1,-4
101,2022/7/15 5:10,1,1,0,34
101,2022/7/15 5:20,12,1,11,94
101,2022/7/15 5:30,25,1,24,115
101,2022/7/15 5:40,30,1,29,132
101,2022/7/15 5:50,36,1,35,176
101,2022/7/15 6:00,45,13,32,199
101,2022/7/15 6:10,61,11,50,307
101,2022/7/15 6:20,87,21,66,535
101,2022/7/15 6:30,108,42,66,680
101,2022/7/15 6:40,128,47,81,965
101,2022/7/15 6:50,215,66,149,1195
101,2022/7/15 7:00,245,85,160,1340
101,2022/7/15 7:10,304,71,233,2369
101,2022/7/15 7:20,393,123,270,2737
101,2022/7/15 7:30,630,109,521,3450
101,2022/7/15 7:40,718,146,572,3751
101,2022/7/15 7:50,687,108,579,4316
101,2022/7/15 8:00,713,106,607,3851
101,2022/7/15 8:10,630,108,522,3456
101,2022/7/15 8:20,447,115,332,2719
101,2022/7/15 8:30,317,119,198,1986
101,2022/7/15 8:40,235,152,83,1105
101,2022/7/15 8:50,188,108,80,892
101,2022/7/15 9:00,83,114,-31,581
101,2022/7/15 9:10,72,100,-28,247
101,2022/7/15 9:20,57,83,-26,93
101,2022/7/15 9:30,45,77,-32,36
101,2022/7/15 9:40,35,59,-24,-8
101,2022/7/15 9:50,36,72,-36,-63
101,2022/7/15 10:00,34,61,-27,-99
101,2022/7/15 10:10,31,59,-28,-123
101,2022/7/15 10:20,27,64,-37,-114
101,2022/7/15 10:30,28,51,-23,-130
101,2022/7/15 10:40,29,61,-32,-135
101,2022/7/15 10:50,29,55,-26,-106
101,2022/7/15 11:00,29,51,-22,-159
101,2022/7/15 11:10,27,36,-9,-124
101,2022/7/15 11:20,27,64,-37,-133
101,2022/7/15 11:30,23,65,-42,-108
101,2022/7/15 11:40,23,62,-39,-109
101,2022/7/15 11:50,26,48,-22,-113
101,2022/7/15 12:00,31,47,-16,-109
101,2022/7/15 12:10,29,44,-15,-118
101,2022/7/15 12:20,30,61,-31,-119
101,2022/7/15 12:30,23,63,-40,-157
101,2022/7/15 12:40,23,55,-32,-162
101,2022/7/15 12:50,23,57,-34,-148
101,2022/7/15 13:00,26,50,-24,-189
101,2022/7/15 13:10,29,54,-25,-164
101,2022/7/15 13:20,24,62,-38,-194
101,2022/7/15 13:30,23,60,-37,-183
101,2022/7/15 13:40,24,59,-35,-187
101,2022/7/15 13:50,22,62,-40,-201
101,2022/7/15 14:00,29,49,-20,-186
101,2022/7/15 14:10,26,60,-34,-195
101,2022/7/15 14:20,24,67,-43,-205
101,2022/7/15 14:30,24,67,-43,-219
101,2022/7/15 14:40,27,61,-34,-202
101,2022/7/15 14:50,25,64,-39,-193
101,2022/7/15 15:00,26,56,-30,-218
101,2022/7/15 15:10,24,68,-44,-236
101,2022/7/15 15:20,27,82,-55,-266
101,2022/7/15 15:30,34,75,-41,-244
101,2022/7/15 15:40,39,81,-42,-251
101,2022/7/15 15:50,31,83,-52,-277
101,2022/7/15 16:00,38,69,-31,-260
101,2022/7/15 16:10,38,74,-36,-234
101,2022/7/15 16:20,36,77,-41,-245
101,2022/7/15 16:30,41,97,-56,-303
101,2022/7/15 16:40,58,91,-33,-234
101,2022/7/15 16:50,42,96,-54,-219
101,2022/7/15 17:00,38,85,-47,-242
101,2022/7/15 17:10,40,106,-66,-182
101,2022/7/15 17:20,38,105,-67,-279
101,2022/7/15 17:30,57,110,-53,-450
101,2022/7/15 17:40,139,97,42,-484
101,2022/7/15 17:50,60,225,-165,-856
101,2022/7/15 18:00,75,152,-77,-1003
101,2022/7/15 18:10,86,127,-41,-705
101,2022/7/15 18:20,52,198,-146,-1249
101,2022/7/15 18:30,43,143,-100,-1068
101,2022/7/15 18:40,29,209,-180,-1928
101,2022/7/15 18:50,28,174,-146,-1602
101,2022/7/15 19:00,28,213,-185,-1381
101,2022/7/15 19:10,30,105,-75,-910
101,2022/7/15 19:20,27,137,-110,-1094
101,2022/7/15 19:30,28,127,-99,-706
101,2022/7/15 19:40,23,95,-72,-788
101,2022/7/15 19:50,19,102,-83,-570
101,2022/7/15 20:00,17,106,-89,-472
101,2022/7/15 20:10,22,66,-44,-484
101,2022/7/15 20:20,17,110,-93,-428
101,2022/7/15 20:30,15,73,-58,-473
101,2022/7/15 20:40,16,85,-69,-431
101,2022/7/15 20:50,16,78,-62,-430
101,2022/7/15 21:00,17,89,-72,-429
101,2022/7/15 21:10,22,76,-54,-393
101,2022/7/15 21:20,12,80,-68,-397
101,2022/7/15 21:30,12,83,-71,-403
101,2022/7/15 21:40,10,72,-62,-371
101,2022/7/15 21:50,9,85,-76,-408
101,2022/7/15 22:00,9,78,-69,-418
101,2022/7/15 22:10,8,76,-68,-389
101,2022/7/15 22:20,5,80,-75,-363
101,2022/7/15 22:30,4,80,-76,-444
101,2022/7/15 22:40,2,84,-82,-468
101,2022/7/15 22:50,1,78,-77,-459
113,2022/7/15 5:00,0,1,-1,-5
113,2022/7/15 5:10,5,1,4,38
113,2022/7/15 5:20,20,1,19,113
113,2022/7/15 5:30,50,1,49,164
113,2022/7/15 5:40,65,6,59,191
113,2022/7/15 5:50,99,14,85,261
113,2022/7/15 6:00,187,38,149,348
113,2022/7/15 6:10,277,33,244,551
113,2022/7/15 6:20,360,46,314,849
113,2022/7/15 6:30,574,51,523,1203
113,2022/7/15 6:40,687,67,620,1585
113,2022/7/15 6:50,866,80,786,1981
113,2022/7/15 7:00,1177,75,1102,2442
113,2022/7/15 7:10,1367,73,1294,3663
113,2022/7/15 7:20,1983,112,1871,4608
113,2022/7/15 7:30,1990,111,1879,5329
113,2022/7/15 7:40,2479,105,2374,6125
113,2022/7/15 7:50,2560,111,2449,6765
113,2022/7/15 8:00,2570,104,2466,6317
113,2022/7/15 8:10,2557,110,2447,5903
113,2022/7/15 8:20,1990,107,1883,4602
113,2022/7/15 8:30,1550,107,1443,3429
113,2022/7/15 8:40,1215,107,1108,2213
113,2022/7/15 8:50,858,97,761,1653
113,2022/7/15 9:00,709,101,608,1189
113,2022/7/15 9:10,578,90,488,735
113,2022/7/15 9:20,339,105,234,327
113,2022/7/15 9:30,275,91,184,220
113,2022/7/15 9:40,237,80,157,149
113,2022/7/15 9:50,205,104,101,38
113,2022/7/15 10:00,174,96,78,-21
113,2022/7/15 10:10,147,87,60,-63
113,2022/7/15 10:20,81,110,-29,-143
113,2022/7/15 10:30,77,110,-33,-163
113,2022/7/15 10:40,75,80,-5,-140
113,2022/7/15 10:50,70,106,-36,-142
113,2022/7/15 11:00,66,96,-30,-189
113,2022/7/15 11:10,74,90,-16,-140
113,2022/7/15 11:20,64,84,-20,-153
113,2022/7/15 11:30,59,107,-48,-156
113,2022/7/15 11:40,72,112,-40,-149
113,2022/7/15 11:50,114,108,6,-107
113,2022/7/15 12:00,75,90,-15,-124
113,2022/7/15 12:10,93,77,16,-102
113,2022/7/15 12:20,96,106,-10,-129
113,2022/7/15 12:30,86,104,-18,-175
113,2022/7/15 12:40,75,95,-20,-182
113,2022/7/15 12:50,77,101,-24,-172
113,2022/7/15 13:00,70,100,-30,-219
113,2022/7/15 13:10,74,96,-22,-186
113,2022/7/15 13:20,63,105,-42,-236
113,2022/7/15 13:30,65,102,-37,-220
113,2022/7/15 13:40,48,105,-57,-244
113,2022/7/15 13:50,57,102,-45,-246
113,2022/7/15 14:00,43,103,-60,-246
113,2022/7/15 14:10,42,96,-54,-249
113,2022/7/15 14:20,45,119,-74,-279
113,2022/7/15 14:30,45,108,-63,-282
113,2022/7/15 14:40,45,124,-79,-281
113,2022/7/15 14:50,46,111,-65,-258
113,2022/7/15 15:00,41,110,-69,-287
113,2022/7/15 15:10,48,104,-56,-292
113,2022/7/15 15:20,44,124,-80,-346
113,2022/7/15 15:30,41,118,-77,-321
113,2022/7/15 15:40,44,159,-115,-366
113,2022/7/15 15:50,43,111,-68,-345
113,2022/7/15 16:00,44,192,-148,-408
113,2022/7/15 16:10,49,109,-60,-294
113,2022/7/15 16:20,54,192,-138,-383
113,2022/7/15 16:30,66,198,-132,-435
113,2022/7/15 16:40,68,234,-166,-400
113,2022/7/15 16:50,66,181,-115,-334
113,2022/7/15 17:00,71,295,-224,-466
113,2022/7/15 17:10,75,221,-146,-328
113,2022/7/15 17:20,78,426,-348,-627
113,2022/7/15 17:30,69,303,-234,-684
113,2022/7/15 17:40,76,473,-397,-881
113,2022/7/15 17:50,76,1140,-1064,-1920
113,2022/7/15 18:00,92,564,-472,-1475
113,2022/7/15 18:10,64,563,-499,-1204
113,2022/7/15 18:20,68,1589,-1521,-2770
113,2022/7/15 18:30,54,559,-505,-1573
113,2022/7/15 18:40,56,1915,-1859,-3787
113,2022/7/15 18:50,43,1067,-1024,-2626
113,2022/7/15 19:00,44,1164,-1120,-2501
113,2022/7/15 19:10,39,413,-374,-1284
113,2022/7/15 19:20,34,477,-443,-1537
113,2022/7/15 19:30,30,381,-351,-1057
113,2022/7/15 19:40,30,330,-300,-1088
113,2022/7/15 19:50,29,234,-205,-775
113,2022/7/15 20:00,31,181,-150,-622
113,2022/7/15 20:10,30,234,-204,-688
113,2022/7/15 20:20,27,229,-202,-630
113,2022/7/15 20:30,30,122,-92,-565
113,2022/7/15 20:40,33,191,-158,-589
113,2022/7/15 20:50,31,118,-87,-517
113,2022/7/15 21:00,32,179,-147,-576
113,2022/7/15 21:10,31,126,-95,-488
113,2022/7/15 21:20,26,184,-158,-555
113,2022/7/15 21:30,26,121,-95,-498
113,2022/7/15 21:40,26,111,-85,-456
113,2022/7/15 21:50,23,137,-114,-522
113,2022/7/15 22:00,26,111,-85,-503
113,2022/7/15 22:10,22,124,-102,-491
113,2022/7/15 22:20,21,155,-134,-497
113,2022/7/15 22:30,16,130,-114,-558
113,2022/7/15 22:40,5,202,-197,-665
113,2022/7/15 22:50,6,114,-108,-567
98,2022/7/15 5:00,0,1,-1,-6
98,2022/7/15 5:10,1,1,0,38
98,2022/7/15 5:20,10,1,9,122
98,2022/7/15 5:30,31,1,30,194
98,2022/7/15 5:40,33,2,31,222
98,2022/7/15 5:50,54,16,38,299
98,2022/7/15 6:00,72,19,53,401
98,2022/7/15 6:10,151,19,132,683
98,2022/7/15 6:20,225,25,200,1049
98,2022/7/15 6:30,302,35,267,1470
98,2022/7/15 6:40,468,46,422,2007
98,2022/7/15 6:50,630,50,580,2561
98,2022/7/15 7:00,672,61,611,3053
98,2022/7/15 7:10,741,77,664,4327
98,2022/7/15 7:20,1172,75,1097,5705
98,2022/7/15 7:30,1578,99,1479,6808
98,2022/7/15 7:40,1584,100,1484,7609
98,2022/7/15 7:50,1584,98,1486,8251
98,2022/7/15 8:00,1584,104,1480,7797
98,2022/7/15 8:10,1604,133,1471,7374
98,2022/7/15 8:20,1369,182,1187,5789
98,2022/7/15 8:30,1060,150,910,4339
98,2022/7/15 8:40,690,298,392,2605
98,2022/7/15 8:50,596,108,488,2141
98,2022/7/15 9:00,428,151,277,1466
98,2022/7/15 9:10,341,122,219,954
98,2022/7/15 9:20,237,125,112,439
98,2022/7/15 9:30,193,102,91,311
98,2022/7/15 9:40,168,127,41,190
98,2022/7/15 9:50,106,110,-4,34
98,2022/7/15 10:00,84,102,-18,-39
98,2022/7/15 10:10,76,99,-23,-86
98,2022/7/15 10:20,57,103,-46,-189
98,2022/7/15 10:30,54,103,-49,-212
98,2022/7/15 10:40,45,77,-32,-172
98,2022/7/15 10:50,41,107,-66,-208
98,2022/7/15 11:00,46,101,-55,-244
98,2022/7/15 11:10,46,101,-55,-195
98,2022/7/15 11:20,48,108,-60,-213
98,2022/7/15 11:30,47,81,-34,-190
98,2022/7/15 11:40,43,105,-62,-211
98,2022/7/15 11:50,56,106,-50,-157
98,2022/7/15 12:00,61,110,-49,-173
98,2022/7/15 12:10,67,101,-34,-136
98,2022/7/15 12:20,65,103,-38,-167
98,2022/7/15 12:30,63,84,-21,-196
98,2022/7/15 12:40,64,107,-43,-225
98,2022/7/15 12:50,54,126,-72,-244
98,2022/7/15 13:00,68,100,-32,-251
98,2022/7/15 13:10,50,111,-61,-247
98,2022/7/15 13:20,56,108,-52,-288
98,2022/7/15 13:30,45,87,-42,-262
98,2022/7/15 13:40,46,107,-61,-305
98,2022/7/15 13:50,45,85,-40,-286
98,2022/7/15 14:00,47,106,-59,-305
98,2022/7/15 14:10,46,106,-60,-309
98,2022/7/15 14:20,46,109,-63,-342
98,2022/7/15 14:30,44,104,-60,-342
98,2022/7/15 14:40,46,107,-61,-342
98,2022/7/15 14:50,45,111,-66,-324
98,2022/7/15 15:00,47,107,-60,-347
98,2022/7/15 15:10,45,122,-77,-369
98,2022/7/15 15:20,48,103,-55,-401
98,2022/7/15 15:30,44,109,-65,-386
98,2022/7/15 15:40,47,108,-61,-427
98,2022/7/15 15:50,47,115,-68,-413
98,2022/7/15 16:00,43,133,-90,-498
98,2022/7/15 16:10,53,116,-63,-357
98,2022/7/15 16:20,59,111,-52,-435
98,2022/7/15 16:30,64,104,-40,-475
98,2022/7/15 16:40,63,159,-96,-496
98,2022/7/15 16:50,70,233,-163,-497
98,2022/7/15 17:00,114,150,-36,-502
98,2022/7/15 17:10,154,316,-162,-490
98,2022/7/15 17:20,84,317,-233,-860
98,2022/7/15 17:30,97,317,-220,-904
98,2022/7/15 17:40,204,478,-274,-1155
98,2022/7/15 17:50,132,486,-354,-2274
98,2022/7/15 18:00,148,412,-264,-1739
98,2022/7/15 18:10,213,574,-361,-1565
98,2022/7/15 18:20,176,462,-286,-3056
98,2022/7/15 18:30,116,565,-449,-2022
98,2022/7/15 18:40,89,1110,-1021,-4808
98,2022/7/15 18:50,64,563,-499,-3125
98,2022/7/15 19:00,58,486,-428,-2929
98,2022/7/15 19:10,60,491,-431,-1715
98,2022/7/15 19:20,44,328,-284,-1821
98,2022/7/15 19:30,43,383,-340,-1397
98,2022/7/15 19:40,43,196,-153,-1241
98,2022/7/15 19:50,36,114,-78,-853
98,2022/7/15 20:00,44,179,-135,-757
98,2022/7/15 20:10,45,115,-70,-758
98,2022/7/15 20:20,38,159,-121,-751
98,2022/7/15 20:30,44,122,-78,-643
98,2022/7/15 20:40,41,104,-63,-652
98,2022/7/15 20:50,43,125,-82,-599
98,2022/7/15 21:00,56,109,-53,-629
98,2022/7/15 21:10,48,112,-64,-552
98,2022/7/15 21:20,37,95,-58,-613
98,2022/7/15 21:30,40,126,-86,-584
98,2022/7/15 21:40,37,117,-80,-536
98,2022/7/15 21:50,31,104,-73,-595
98,2022/7/15 22:00,31,116,-85,-588
98,2022/7/15 22:10,26,66,-40,-531
98,2022/7/15 22:20,23,109,-86,-583
98,2022/7/15 22:30,19,107,-88,-646
98,2022/7/15 22:40,12,108,-96,-761
98,2022/7/15 22:50,8,122,-114,-681
105,2022/7/15 5:00,0,1,-1,-7
105,2022/7/15 5:10,6,1,5,43
105,2022/7/15 5:20,10,1,9,131
105,2022/7/15 5:30,35,1,34,228
105,2022/7/15 5:40,65,21,44,266
105,2022/7/15 5:50,145,29,116,415
105,2022/7/15 6:00,185,23,162,563
105,2022/7/15 6:10,279,38,241,924
105,2022/7/15 6:20,325,42,283,1332
105,2022/7/15 6:30,688,55,633,2103
105,2022/7/15 6:40,825,80,745,2752
105,2022/7/15 6:50,1063,93,970,3531
105,2022/7/15 7:00,1209,126,1083,4136
105,2022/7/15 7:10,1363,103,1260,5587
105,2022/7/15 7:20,1982,125,1857,7562
105,2022/7/15 7:30,1980,123,1857,8665
105,2022/7/15 7:40,2532,110,2422,10031
105,2022/7/15 7:50,2005,105,1900,10151
105,2022/7/15 8:00,2070,153,1917,9714
105,2022/7/15 8:10,2468,182,2286,9660
105,2022/7/15 8:20,1994,185,1809,7598
105,2022/7/15 8:30,1992,109,1883,6222
105,2022/7/15 8:40,1363,178,1185,3790
105,2022/7/15 8:50,1226,117,1109,3250
105,2022/7/15 9:00,852,110,742,2208
105,2022/7/15 9:10,698,114,584,1538
105,2022/7/15 9:20,581,114,467,906
105,2022/7/15 9:30,320,105,215,526
105,2022/7/15 9:40,274,121,153,343
105,2022/7/15 9:50,261,95,166,200
105,2022/7/15 10:00,232,104,128,89
105,2022/7/15 10:10,211,107,104,18
105,2022/7/15 10:20,176,108,68,-121
105,2022/7/15 10:30,162,113,49,-163
105,2022/7/15 10:40,112,97,15,-157
105,2022/7/15 10:50,114,104,10,-198
105,2022/7/15 11:00,91,103,-12,-256
105,2022/7/15 11:10,88,124,-36,-231
105,2022/7/15 11:20,80,105,-25,-238
105,2022/7/15 11:30,76,104,-28,-218
105,2022/7/15 11:40,108,99,9,-202
105,2022/7/15 11:50,107,102,5,-152
105,2022/7/15 12:00,137,117,20,-153
105,2022/7/15 12:10,167,123,44,-92
105,2022/7/15 12:20,176,102,74,-93
105,2022/7/15 12:30,176,112,64,-132
105,2022/7/15 12:40,131,106,25,-200
105,2022/7/15 12:50,140,101,39,-205
105,2022/7/15 13:00,141,119,22,-229
105,2022/7/15 13:10,136,122,14,-233
105,2022/7/15 13:20,88,83,5,-283
105,2022/7/15 13:30,84,99,-15,-277
105,2022/7/15 13:40,75,102,-27,-332
105,2022/7/15 13:50,71,97,-26,-312
105,2022/7/15 14:00,67,109,-42,-347
105,2022/7/15 14:10,69,112,-43,-352
105,2022/7/15 14:20,68,112,-44,-386
105,2022/7/15 14:30,64,99,-35,-377
105,2022/7/15 14:40,65,116,-51,-393
105,2022/7/15 14:50,64,129,-65,-389
105,2022/7/15 15:00,64,110,-46,-393
105,2022/7/15 15:10,71,192,-121,-490
105,2022/7/15 15:20,64,126,-62,-463
105,2022/7/15 15:30,68,169,-101,-487
105,2022/7/15 15:40,53,152,-99,-526
105,2022/7/15 15:50,68,179,-111,-524
105,2022/7/15 16:00,65,216,-151,-649
105,2022/7/15 16:10,83,224,-141,-498
105,2022/7/15 16:20,82,195,-113,-548
105,2022/7/15 16:30,105,196,-91,-566
105,2022/7/15 16:40,156,213,-57,-553
105,2022/7/15 16:50,176,327,-151,-648
105,2022/7/15 17:00,215,424,-209,-711
105,2022/7/15 17:10,260,309,-49,-539
105,2022/7/15 17:20,243,400,-157,-1017
105,2022/7/15 17:30,222,467,-245,-1149
105,2022/7/15 17:40,242,1488,-1246,-2401
105,2022/7/15 17:50,201,1099,-898,-3172
105,2022/7/15 18:00,184,403,-219,-1958
105,2022/7/15 18:10,222,2667,-2445,-4010
105,2022/7/15 18:20,198,568,-370,-3426
105,2022/7/15 18:30,166,1777,-1611,-3633
105,2022/7/15 18:40,181,1753,-1572,-6380
105,2022/7/15 18:50,139,1773,-1634,-4759
105,2022/7/15 19:00,71,423,-352,-3281
105,2022/7/15 19:10,137,1929,-1792,-3507
105,2022/7/15 19:20,66,366,-300,-2121
105,2022/7/15 19:30,64,469,-405,-1802
105,2022/7/15 19:40,46,384,-338,-1579
105,2022/7/15 19:50,41,307,-266,-1119
105,2022/7/15 20:00,46,314,-268,-1025
105,2022/7/15 20:10,43,217,-174,-932
105,2022/7/15 20:20,41,293,-252,-1003
105,2022/7/15 20:30,41,269,-228,-871
105,2022/7/15 20:40,40,269,-229,-881
105,2022/7/15 20:50,37,269,-232,-831
105,2022/7/15 21:00,41,234,-193,-822
105,2022/7/15 21:10,34,178,-144,-696
105,2022/7/15 21:20,29,198,-169,-782
105,2022/7/15 21:30,27,227,-200,-784
105,2022/7/15 21:40,28,236,-208,-744
105,2022/7/15 21:50,26,229,-203,-798
105,2022/7/15 22:00,25,185,-160,-748
105,2022/7/15 22:10,28,218,-190,-721
105,2022/7/15 22:20,24,213,-189,-772
105,2022/7/15 22:30,17,291,-274,-920
105,2022/7/15 22:40,11,151,-140,-901
105,2022/7/15 22:50,8,116,-108,-789
115,2022/7/15 5:00,0,1,-1,-8
115,2022/7/15 5:10,0,1,-1,42
115,2022/7/15 5:20,3,1,2,133
115,2022/7/15 5:30,5,1,4,232
115,2022/7/15 5:40,15,1,14,280
115,2022/7/15 5:50,16,50,-34,381
115,2022/7/15 6:00,21,46,-25,538
115,2022/7/15 6:10,27,66,-39,885
115,2022/7/15 6:20,36,62,-26,1306
115,2022/7/15 6:30,42,76,-34,2069
115,2022/7/15 6:40,55,61,-6,2746
115,2022/7/15 6:50,88,111,-23,3508
115,2022/7/15 7:00,108,112,-4,4132
115,2022/7/15 7:10,155,104,51,5638
115,2022/7/15 7:20,223,127,96,7658
115,2022/7/15 7:30,285,180,105,8770
115,2022/7/15 7:40,319,300,19,10050
115,2022/7/15 7:50,299,335,-36,10115
115,2022/7/15 8:00,358,1069,-711,9003
115,2022/7/15 8:10,333,1845,-1512,8148
115,2022/7/15 8:20,346,1484,-1138,6460
115,2022/7/15 8:30,315,1058,-743,5479
115,2022/7/15 8:40,277,1709,-1432,2358
115,2022/7/15 8:50,238,546,-308,2942
115,2022/7/15 9:00,191,421,-230,1978
115,2022/7/15 9:10,172,339,-167,1371
115,2022/7/15 9:20,152,375,-223,683
115,2022/7/15 9:30,78,191,-113,413
115,2022/7/15 9:40,65,171,-106,237
115,2022/7/15 9:50,62,127,-65,135
115,2022/7/15 10:00,60,109,-49,40
115,2022/7/15 10:10,61,123,-62,-44
115,2022/7/15 10:20,54,97,-43,-164
115,2022/7/15 10:30,58,120,-62,-225
115,2022/7/15 10:40,59,104,-45,-202
115,2022/7/15 10:50,59,105,-46,-244
115,2022/7/15 11:00,54,87,-33,-289
115,2022/7/15 11:10,59,112,-53,-284
115,2022/7/15 11:20,58,105,-47,-285
115,2022/7/15 11:30,57,112,-55,-273
115,2022/7/15 11:40,61,89,-28,-230
115,2022/7/15 11:50,50,87,-37,-189
115,2022/7/15 12:00,55,91,-36,-189
115,2022/7/15 12:10,62,107,-45,-137
115,2022/7/15 12:20,66,103,-37,-130
115,2022/7/15 12:30,62,104,-42,-174
115,2022/7/15 12:40,59,102,-43,-243
115,2022/7/15 12:50,61,105,-44,-249
115,2022/7/15 13:00,63,102,-39,-268
115,2022/7/15 13:10,60,120,-60,-293
115,2022/7/15 13:20,57,120,-63,-346
115,2022/7/15 13:30,52,107,-55,-332
115,2022/7/15 13:40,65,119,-54,-386
115,2022/7/15 13:50,52,100,-48,-360
115,2022/7/15 14:00,65,109,-44,-391
115,2022/7/15 14:10,77,119,-42,-394
115,2022/7/15 14:20,62,119,-57,-443
115,2022/7/15 14:30,68,100,-32,-409
115,2022/7/15 14:40,66,84,-18,-411
115,2022/7/15 14:50,64,102,-38,-427
115,2022/7/15 15:00,83,111,-28,-421
115,2022/7/15 15:10,76,103,-27,-517
115,2022/7/15 15:20,89,126,-37,-500
115,2022/7/15 15:30,71,98,-27,-514
115,2022/7/15 15:40,82,112,-30,-556
115,2022/7/15 15:50,138,102,36,-488
115,2022/7/15 16:00,132,86,46,-603
115,2022/7/15 16:10,157,110,47,-451
115,2022/7/15 16:20,156,119,37,-511
115,2022/7/15 16:30,242,99,143,-423
115,2022/7/15 16:40,235,109,126,-427
115,2022/7/15 16:50,227,99,128,-520
115,2022/7/15 17:00,269,123,146,-565
115,2022/7/15 17:10,694,106,588,49
115,2022/7/15 17:20,630,114,516,-501
115,2022/7/15 17:30,550,121,429,-720
115,2022/7/15 17:40,847,190,657,-1744
115,2022/7/15 17:50,1171,136,1035,-2137
115,2022/7/15 18:00,660,122,538,-1420
115,2022/7/15 18:10,838,222,616,-3394
115,2022/7/15 18:20,1044,110,934,-2492
115,2022/7/15 18:30,639,182,457,-3176
115,2022/7/15 18:40,455,181,274,-6106
115,2022/7/15 18:50,278,192,86,-4673
115,2022/7/15 19:00,198,105,93,-3188
115,2022/7/15 19:10,184,111,73,-3434
115,2022/7/15 19:20,115,120,-5,-2126
115,2022/7/15 19:30,77,101,-24,-1826
115,2022/7/15 19:40,72,106,-34,-1613
115,2022/7/15 19:50,67,106,-39,-1158
115,2022/7/15 20:00,46,77,-31,-1056
115,2022/7/15 20:10,50,97,-47,-979
115,2022/7/15 20:20,43,72,-29,-1032
115,2022/7/15 20:30,39,85,-46,-917
115,2022/7/15 20:40,42,76,-34,-915
115,2022/7/15 20:50,39,84,-45,-876
115,2022/7/15 21:00,30,62,-32,-854
115,2022/7/15 21:10,33,74,-41,-737
115,2022/7/15 21:20,26,74,-48,-830
115,2022/7/15 21:30,27,65,-38,-822
115,2022/7/15 21:40,28,70,-42,-786
115,2022/7/15 21:50,26,74,-48,-846
115,2022/7/15 22:00,25,64,-39,-787
115,2022/7/15 22:10,28,67,-39,-760
115,2022/7/15 22:20,20,66,-46,-818
115,2022/7/15 22:30,16,71,-55,-975
115,2022/7/15 22:40,11,62,-51,-952
115,2022/7/15 22:50,6,52,-46,-835
109,2022/7/15 5:00,0,1,-1,-9
109,2022/7/15 5:10,0,1,-1,41
109,2022/7/15 5:20,3,1,2,135
109,2022/7/15 5:30,7,1,6,238
109,2022/7/15 5:40,17,1,16,296
109,2022/7/15 5:50,19,23,-4,377
109,2022/7/15 6:00,32,31,1,539
109,2022/7/15 6:10,35,36,-1,884
109,2022/7/15 6:20,43,65,-22,1284
109,2022/7/15 6:30,61,76,-15,2054
109,2022/7/15 6:40,101,90,11,2757
109,2022/7/15 6:50,186,109,77,3585
109,2022/7/15 7:00,223,110,113,4245
109,2022/7/15 7:10,277,85,192,5830
109,2022/7/15 7:20,275,104,171,7829
109,2022/7/15 7:30,436,171,265,9035
109,2022/7/15 7:40,630,214,416,10466
109,2022/7/15 7:50,721,300,421,10536
109,2022/7/15 8:00,717,524,193,9196
109,2022/7/15 8:10,734,557,177,8325
109,2022/7/15 8:20,682,1076,-394,6066
109,2022/7/15 8:30,652,1718,-1066,4413
109,2022/7/15 8:40,392,1494,-1102,1256
109,2022/7/15 8:50,355,1103,-748,2194
109,2022/7/15 9:00,277,417,-140,1838
109,2022/7/15 9:10,232,436,-204,1167
109,2022/7/15 9:20,192,330,-138,545
109,2022/7/15 9:30,143,229,-86,327
109,2022/7/15 9:40,106,304,-198,39
109,2022/7/15 9:50,72,178,-106,29
109,2022/7/15 10:00,54,118,-64,-24
109,2022/7/15 10:10,59,121,-62,-106
109,2022/7/15 10:20,53,110,-57,-221
109,2022/7/15 10:30,51,105,-54,-279
109,2022/7/15 10:40,46,121,-75,-277
109,2022/7/15 10:50,47,99,-52,-296
109,2022/7/15 11:00,48,97,-49,-338
109,2022/7/15 11:10,44,80,-36,-320
109,2022/7/15 11:20,45,100,-55,-340
109,2022/7/15 11:30,45,87,-42,-315
109,2022/7/15 11:40,56,105,-49,-279
109,2022/7/15 11:50,59,91,-32,-221
109,2022/7/15 12:00,57,87,-30,-219
109,2022/7/15 12:10,65,89,-24,-161
109,2022/7/15 12:20,71,111,-40,-170
109,2022/7/15 12:30,67,126,-59,-233
109,2022/7/15 12:40,72,109,-37,-280
109,2022/7/15 12:50,54,105,-51,-300
109,2022/7/15 13:00,62,110,-48,-316
109,2022/7/15 13:10,62,90,-28,-321
109,2022/7/15 13:20,73,117,-44,-390
109,2022/7/15 13:30,66,126,-60,-392
109,2022/7/15 13:40,57,108,-51,-437
109,2022/7/15 13:50,62,110,-48,-408
109,2022/7/15 14:00,66,104,-38,-429
109,2022/7/15 14:10,64,101,-37,-431
109,2022/7/15 14:20,68,110,-42,-485
109,2022/7/15 14:30,59,96,-37,-446
109,2022/7/15 14:40,63,109,-46,-457
109,2022/7/15 14:50,70,101,-31,-458
109,2022/7/15 15:00,76,90,-14,-435
109,2022/7/15 15:10,92,95,-3,-520
109,2022/7/15 15:20,94,104,-10,-510
109,2022/7/15 15:30,84,114,-30,-544
109,2022/7/15 15:40,75,109,-34,-590
109,2022/7/15 15:50,87,105,-18,-506
109,2022/7/15 16:00,92,102,-10,-613
109,2022/7/15 16:10,133,100,33,-418
109,2022/7/15 16:20,142,120,22,-489
109,2022/7/15 16:30,179,117,62,-361
109,2022/7/15 16:40,190,107,83,-344
109,2022/7/15 16:50,211,104,107,-413
109,2022/7/15 17:00,288,108,180,-385
109,2022/7/15 17:10,641,181,460,509
109,2022/7/15 17:20,547,123,424,-77
109,2022/7/15 17:30,368,232,136,-584
109,2022/7/15 17:40,1046,233,813,-931
109,2022/7/15 17:50,806,207,599,-1538
109,2022/7/15 18:00,697,253,444,-976
109,2022/7/15 18:10,1163,270,893,-2501
109,2022/7/15 18:20,1162,179,983,-1509
109,2022/7/15 18:30,648,329,319,-2857
109,2022/7/15 18:40,568,228,340,-5766
109,2022/7/15 18:50,462,206,256,-4417
109,2022/7/15 19:00,307,192,115,-3073
109,2022/7/15 19:10,268,193,75,-3359
109,2022/7/15 19:20,225,111,114,-2012
109,2022/7/15 19:30,188,112,76,-1750
109,2022/7/15 19:40,137,109,28,-1585
109,2022/7/15 19:50,132,104,28,-1130
109,2022/7/15 20:00,110,99,11,-1045
109,2022/7/15 20:10,129,100,29,-950
109,2022/7/15 20:20,84,95,-11,-1043
109,2022/7/15 20:30,73,95,-22,-939
109,2022/7/15 20:40,74,82,-8,-923
109,2022/7/15 20:50,75,101,-26,-902
109,2022/7/15 21:00,70,78,-8,-862
109,2022/7/15 21:10,67,87,-20,-757
109,2022/7/15 21:20,85,89,-4,-834
109,2022/7/15 21:30,56,99,-43,-865
109,2022/7/15 21:40,42,92,-50,-836
109,2022/7/15 21:50,38,89,-51,-897
109,2022/7/15 22:00,38,78,-40,-827
109,2022/7/15 22:10,27,83,-56,-816
109,2022/7/15 22:20,26,95,-69,-887
109,2022/7/15 22:30,22,78,-56,-1031
109,2022/7/15 22:40,16,70,-54,-1006
109,2022/7/15 22:50,9,83,-74,-909
118,2022/7/15 5:00,0,1,-1,-10
118,2022/7/15 5:10,0,1,-1,40
118,2022/7/15 5:20,0,1,-1,134
118,2022/7/15 5:30,16,1,15,253
118,2022/7/15 5:40,28,12,16,312
118,2022/7/15 5:50,32,32,0,377
118,2022/7/15 6:00,41,38,3,542
118,2022/7/15 6:10,58,56,2,886
118,2022/7/15 6:20,83,83,0,1284
118,2022/7/15 6:30,157,93,64,2118
118,2022/7/15 6:40,234,117,117,2874
118,2022/7/15 6:50,247,108,139,3724
118,2022/7/15 7:00,322,336,-14,4231
118,2022/7/15 7:10,367,378,-11,5819
118,2022/7/15 7:20,440,297,143,7972
118,2022/7/15 7:30,688,331,357,9392
118,2022/7/15 7:40,1057,320,737,11203
118,2022/7/15 7:50,1055,377,678,11214
118,2022/7/15 8:00,1190,296,894,10090
118,2022/7/15 8:10,1181,371,810,9135
118,2022/7/15 8:20,1183,330,853,6919
118,2022/7/15 8:30,1054,493,561,4974
118,2022/7/15 8:40,829,338,491,1747
118,2022/7/15 8:50,721,526,195,2389
118,2022/7/15 9:00,579,327,252,2090
118,2022/7/15 9:10,466,377,89,1256
118,2022/7/15 9:20,351,206,145,690
118,2022/7/15 9:30,277,290,-13,314
118,2022/7/15 9:40,247,152,95,134
118,2022/7/15 9:50,227,179,48,77
118,2022/7/15 10:00,213,142,71,47
118,2022/7/15 10:10,208,118,90,-16
118,2022/7/15 10:20,176,108,68,-153
118,2022/7/15 10:30,173,100,73,-206
118,2022/7/15 10:40,173,117,56,-221
118,2022/7/15 10:50,148,111,37,-259
118,2022/7/15 11:00,169,106,63,-275
118,2022/7/15 11:10,160,121,39,-281
118,2022/7/15 11:20,173,110,63,-277
118,2022/7/15 11:30,173,102,71,-244
118,2022/7/15 11:40,153,120,33,-246
118,2022/7/15 11:50,166,117,49,-172
118,2022/7/15 12:00,167,120,47,-172
118,2022/7/15 12:10,161,100,61,-100
118,2022/7/15 12:20,168,102,66,-104
118,2022/7/15 12:30,142,104,38,-195
118,2022/7/15 12:40,144,128,16,-264
118,2022/7/15 12:50,137,109,28,-272
118,2022/7/15 13:00,141,119,22,-294
118,2022/7/15 13:10,161,108,53,-268
118,2022/7/15 13:20,173,121,52,-338
118,2022/7/15 13:30,156,120,36,-356
118,2022/7/15 13:40,176,128,48,-389
118,2022/7/15 13:50,166,109,57,-351
118,2022/7/15 14:00,156,110,46,-383
118,2022/7/15 14:10,174,119,55,-376
118,2022/7/15 14:20,176,107,69,-416
118,2022/7/15 14:30,174,109,65,-381
118,2022/7/15 14:40,175,169,6,-451
118,2022/7/15 14:50,185,114,71,-387
118,2022/7/15 15:00,271,131,140,-295
118,2022/7/15 15:10,258,100,158,-362
118,2022/7/15 15:20,236,138,98,-412
118,2022/7/15 15:30,219,117,102,-442
118,2022/7/15 15:40,260,138,122,-468
118,2022/7/15 15:50,244,119,125,-381
118,2022/7/15 16:00,225,127,98,-515
118,2022/7/15 16:10,223,127,96,-322
118,2022/7/15 16:20,228,118,110,-379
118,2022/7/15 16:30,266,170,96,-265
118,2022/7/15 16:40,305,226,79,-265
118,2022/7/15 16:50,274,108,166,-247
118,2022/7/15 17:00,311,193,118,-267
118,2022/7/15 17:10,577,227,350,859
118,2022/7/15 17:20,325,325,0,-77
118,2022/7/15 17:30,328,479,-151,-735
118,2022/7/15 17:40,576,428,148,-783
118,2022/7/15 17:50,311,410,-99,-1637
118,2022/7/15 18:00,308,564,-256,-1232
118,2022/7/15 18:10,568,520,48,-2453
118,2022/7/15 18:20,321,406,-85,-1594
118,2022/7/15 18:30,316,559,-243,-3100
118,2022/7/15 18:40,271,470,-199,-5965
118,2022/7/15 18:50,214,367,-153,-4570
118,2022/7/15 19:00,208,433,-225,-3298
118,2022/7/15 19:10,206,328,-122,-3481
118,2022/7/15 19:20,156,383,-227,-2239
118,2022/7/15 19:30,131,232,-101,-1851
118,2022/7/15 19:40,113,139,-26,-1611
118,2022/7/15 19:50,90,197,-107,-1237
118,2022/7/15 20:00,97,108,-11,-1056
118,2022/7/15 20:10,111,153,-42,-992
118,2022/7/15 20:20,111,128,-17,-1060
118,2022/7/15 20:30,92,110,-18,-957
118,2022/7/15 20:40,129,112,17,-906
118,2022/7/15 20:50,86,109,-23,-925
118,2022/7/15 21:00,94,109,-15,-877
118,2022/7/15 21:10,78,105,-27,-784
118,2022/7/15 21:20,68,102,-34,-868
118,2022/7/15 21:30,67,108,-41,-906
118,2022/7/15 21:40,63,110,-47,-883
118,2022/7/15 21:50,41,123,-82,-979
118,2022/7/15 22:00,42,70,-28,-855
118,2022/7/15 22:10,62,118,-56,-872
118,2022/7/15 22:20,30,93,-63,-950
118,2022/7/15 22:30,25,100,-75,-1106
118,2022/7/15 22:40,21,113,-92,-1098
118,2022/7/15 22:50,14,120,-106,-1015
120,2022/7/15 5:00,0,1,-1,-11
120,2022/7/15 5:10,0,1,-1,39
120,2022/7/15 5:20,3,1,2,136
120,2022/7/15 5:30,11,1,10,263
120,2022/7/15 5:40,20,6,14,326
120,2022/7/15 5:50,27,33,-6,371
120,2022/7/15 6:00,37,32,5,547
120,2022/7/15 6:10,45,23,22,908
120,2022/7/15 6:20,58,68,-10,1274
120,2022/7/15 6:30,83,75,8,2126
120,2022/7/15 6:40,109,108,1,2875
120,2022/7/15 6:50,156,155,1,3725
120,2022/7/15 7:00,195,181,14,4245
120,2022/7/15 7:10,244,142,102,5921
120,2022/7/15 7:20,254,115,139,8111
120,2022/7/15 7:30,303,139,164,9556
120,2022/7/15 7:40,573,133,440,11643
120,2022/7/15 7:50,600,138,462,11676
120,2022/7/15 8:00,627,196,431,10521
120,2022/7/15 8:10,663,326,337,9472
120,2022/7/15 8:20,632,221,411,7330
120,2022/7/15 8:30,598,268,330,5304
120,2022/7/15 8:40,474,206,268,2015
120,2022/7/15 8:50,350,205,145,2534
120,2022/7/15 9:00,273,121,152,2242
120,2022/7/15 9:10,233,129,104,1360
120,2022/7/15 9:20,213,121,92,782
120,2022/7/15 9:30,178,125,53,367
120,2022/7/15 9:40,120,126,-6,128
120,2022/7/15 9:50,90,110,-20,57
120,2022/7/15 10:00,69,92,-23,24
120,2022/7/15 10:10,67,106,-39,-55
120,2022/7/15 10:20,59,99,-40,-193
120,2022/7/15 10:30,47,91,-44,-250
120,2022/7/15 10:40,57,68,-11,-232
120,2022/7/15 10:50,47,105,-58,-317
120,2022/7/15 11:00,50,101,-51,-326
120,2022/7/15 11:10,55,96,-41,-322
120,2022/7/15 11:20,45,75,-30,-307
120,2022/7/15 11:30,44,84,-40,-284
120,2022/7/15 11:40,55,80,-25,-271
120,2022/7/15 11:50,46,103,-57,-229
120,2022/7/15 12:00,58,102,-44,-216
120,2022/7/15 12:10,59,99,-40,-140
120,2022/7/15 12:20,63,84,-21,-125
120,2022/7/15 12:30,60,90,-30,-225
120,2022/7/15 12:40,57,81,-24,-288
120,2022/7/15 12:50,59,105,-46,-318
120,2022/7/15 13:00,60,109,-49,-343
120,2022/7/15 13:10,62,100,-38,-306
120,2022/7/15 13:20,62,80,-18,-356
120,2022/7/15 13:30,45,84,-39,-395
120,2022/7/15 13:40,44,87,-43,-432
120,2022/7/15 13:50,50,102,-52,-403
120,2022/7/15 14:00,44,109,-65,-448
120,2022/7/15 14:10,45,97,-52,-428
120,2022/7/15 14:20,44,90,-46,-462
120,2022/7/15 14:30,46,73,-27,-408
120,2022/7/15 14:40,45,101,-56,-507
120,2022/7/15 14:50,41,99,-58,-445
120,2022/7/15 15:00,51,100,-49,-344
120,2022/7/15 15:10,55,99,-44,-406
120,2022/7/15 15:20,53,110,-57,-469
120,2022/7/15 15:30,57,94,-37,-479
120,2022/7/15 15:40,58,105,-47,-515
120,2022/7/15 15:50,51,99,-48,-429
120,2022/7/15 16:00,74,104,-30,-545
120,2022/7/15 16:10,72,104,-32,-354
120,2022/7/15 16:20,73,109,-36,-415
120,2022/7/15 16:30,75,97,-22,-287
120,2022/7/15 16:40,100,109,-9,-274
120,2022/7/15 16:50,130,117,13,-234
120,2022/7/15 17:00,207,121,86,-181
120,2022/7/15 17:10,313,137,176,1035
120,2022/7/15 17:20,257,152,105,28
120,2022/7/15 17:30,292,283,9,-726
120,2022/7/15 17:40,461,213,248,-535
120,2022/7/15 17:50,289,182,107,-1530
120,2022/7/15 18:00,276,318,-42,-1274
120,2022/7/15 18:10,234,192,42,-2411
120,2022/7/15 18:20,207,321,-114,-1708
120,2022/7/15 18:30,170,365,-195,-3295
120,2022/7/15 18:40,114,321,-207,-6172
120,2022/7/15 18:50,73,140,-67,-4637
120,2022/7/15 19:00,76,316,-240,-3538
120,2022/7/15 19:10,55,106,-51,-3532
120,2022/7/15 19:20,54,179,-125,-2364
120,2022/7/15 19:30,44,111,-67,-1918
120,2022/7/15 19:40,44,121,-77,-1688
120,2022/7/15 19:50,42,108,-66,-1303
120,2022/7/15 20:00,41,121,-80,-1136
120,2022/7/15 20:10,44,98,-54,-1046
120,2022/7/15 20:20,41,91,-50,-1110
120,2022/7/15 20:30,35,122,-87,-1044
120,2022/7/15 20:40,36,125,-89,-995
120,2022/7/15 20:50,34,111,-77,-1002
120,2022/7/15 21:00,35,116,-81,-958
120,2022/7/15 21:10,31,104,-73,-857
120,2022/7/15 21:20,35,110,-75,-943
120,2022/7/15 21:30,27,104,-77,-983
120,2022/7/15 21:40,25,108,-83,-966
120,2022/7/15 21:50,29,107,-78,-1057
120,2022/7/15 22:00,28,105,-77,-932
120,2022/7/15 22:10,26,103,-77,-949
120,2022/7/15 22:20,21,97,-76,-1026
120,2022/7/15 22:30,16,106,-90,-1196
120,2022/7/15 22:40,13,79,-66,-1164
120,2022/7/15 22:50,8,73,-65,-1080
108,2022/7/15 5:00,3,1,2,-9
108,2022/7/15 5:10,43,1,42,81
108,2022/7/15 5:20,39,16,23,159
108,2022/7/15 5:30,35,13,22,285
108,2022/7/15 5:40,33,25,8,334
108,2022/7/15 5:50,31,28,3,374
108,2022/7/15 6:00,27,111,-84,463
108,2022/7/15 6:10,36,124,-88,820
108,2022/7/15 6:20,49,130,-81,1193
108,2022/7/15 6:30,181,152,29,2155
108,2022/7/15 6:40,129,335,-206,2669
108,2022/7/15 6:50,147,218,-71,3654
108,2022/7/15 7:00,228,286,-58,4187
108,2022/7/15 7:10,257,411,-154,5767
108,2022/7/15 7:20,362,560,-198,7913
108,2022/7/15 7:30,708,1415,-707,8849
108,2022/7/15 7:40,916,1603,-687,10956
108,2022/7/15 7:50,1039,2206,-1167,10509
108,2022/7/15 8:00,1043,1834,-791,9730
108,2022/7/15 8:10,1272,4865,-3593,5879
108,2022/7/15 8:20,1049,6873,-5824,1506
108,2022/7/15 8:30,1654,4451,-2797,2507
108,2022/7/15 8:40,1423,5303,-3880,-1865
108,2022/7/15 8:50,1154,4613,-3459,-925
108,2022/7/15 9:00,666,2292,-1626,616
108,2022/7/15 9:10,697,1754,-1057,303
108,2022/7/15 9:20,671,1492,-821,-39
108,2022/7/15 9:30,582,553,29,396
108,2022/7/15 9:40,650,395,255,383
108,2022/7/15 9:50,352,392,-40,17
108,2022/7/15 10:00,316,495,-179,-155
108,2022/7/15 10:10,376,500,-124,-179
108,2022/7/15 10:20,592,377,215,22
108,2022/7/15 10:30,422,314,108,-142
108,2022/7/15 10:40,546,529,17,-215
108,2022/7/15 10:50,548,317,231,-86
108,2022/7/15 11:00,267,318,-51,-377
108,2022/7/15 11:10,264,291,-27,-349
108,2022/7/15 11:20,308,330,-22,-329
108,2022/7/15 11:30,304,285,19,-265
108,2022/7/15 11:40,551,318,233,-38
108,2022/7/15 11:50,295,323,-28,-257
108,2022/7/15 12:00,316,319,-3,-219
108,2022/7/15 12:10,327,308,19,-121
108,2022/7/15 12:20,329,295,34,-91
108,2022/7/15 12:30,349,312,37,-188
108,2022/7/15 12:40,587,401,186,-102
108,2022/7/15 12:50,300,365,-65,-383
108,2022/7/15 13:00,343,349,-6,-349
108,2022/7/15 13:10,310,419,-109,-415
108,2022/7/15 13:20,285,301,-16,-372
108,2022/7/15 13:30,288,309,-21,-416
108,2022/7/15 13:40,633,322,311,-121
108,2022/7/15 13:50,351,345,6,-397
108,2022/7/15 14:00,297,302,-5,-453
108,2022/7/15 14:10,353,272,81,-347
108,2022/7/15 14:20,288,305,-17,-479
108,2022/7/15 14:30,301,303,-2,-410
108,2022/7/15 14:40,585,326,259,-248
108,2022/7/15 14:50,344,317,27,-418
108,2022/7/15 15:00,312,275,37,-307
108,2022/7/15 15:10,584,339,245,-161
108,2022/7/15 15:20,369,290,79,-390
108,2022/7/15 15:30,549,297,252,-227
108,2022/7/15 15:40,651,306,345,-170
108,2022/7/15 15:50,616,339,277,-152
108,2022/7/15 16:00,543,284,259,-286
108,2022/7/15 16:10,592,285,307,-47
108,2022/7/15 16:20,584,270,314,-101
108,2022/7/15 16:30,807,506,301,14
108,2022/7/15 16:40,812,467,345,71
108,2022/7/15 16:50,713,306,407,173
108,2022/7/15 17:00,1145,384,761,580
108,2022/7/15 17:10,1584,400,1184,2219
108,2022/7/15 17:20,1590,458,1132,1160
108,2022/7/15 17:30,1360,549,811,85
108,2022/7/15 17:40,2478,455,2023,1488
108,2022/7/15 17:50,1970,550,1420,-110
108,2022/7/15 18:00,1995,1067,928,-346
108,2022/7/15 18:10,1994,563,1431,-980
108,2022/7/15 18:20,1993,1057,936,-772
108,2022/7/15 18:30,1972,566,1406,-1889
108,2022/7/15 18:40,1969,560,1409,-4763
108,2022/7/15 18:50,1397,482,915,-3722
108,2022/7/15 19:00,1165,386,779,-2759
108,2022/7/15 19:10,831,456,375,-3157
108,2022/7/15 19:20,727,349,378,-1986
108,2022/7/15 19:30,636,293,343,-1575
108,2022/7/15 19:40,676,242,434,-1254
108,2022/7/15 19:50,431,198,233,-1070
108,2022/7/15 20:00,314,203,111,-1025
108,2022/7/15 20:10,271,179,92,-954
108,2022/7/15 20:20,246,174,72,-1038
108,2022/7/15 20:30,325,182,143,-901
108,2022/7/15 20:40,325,181,144,-851
108,2022/7/15 20:50,206,141,65,-937
108,2022/7/15 21:00,273,108,165,-793
108,2022/7/15 21:10,192,140,52,-805
108,2022/7/15 21:20,188,204,-16,-959
108,2022/7/15 21:30,200,192,8,-975
108,2022/7/15 21:40,244,170,74,-892
108,2022/7/15 21:50,175,120,55,-1002
108,2022/7/15 22:00,225,119,106,-826
108,2022/7/15 22:10,117,152,-35,-984
108,2022/7/15 22:20,109,153,-44,-1070
108,2022/7/15 22:30,83,120,-37,-1233
108,2022/7/15 22:40,59,112,-53,-1217
108,2022/7/15 22:50,30,88,-58,-1138
99,2022/7/15 5:00,0,1,-1,-10
99,2022/7/15 5:10,1,1,0,81
99,2022/7/15 5:20,5,1,4,163
99,2022/7/15 5:30,6,2,4,289
99,2022/7/15 5:40,13,5,8,342
99,2022/7/15 5:50,16,12,4,378
99,2022/7/15 6:00,14,31,-17,446
99,2022/7/15 6:10,20,33,-13,807
99,2022/7/15 6:20,28,41,-13,1180
99,2022/7/15 6:30,35,51,-16,2139
99,2022/7/15 6:40,37,69,-32,2637
99,2022/7/15 6:50,45,70,-25,3629
99,2022/7/15 7:00,54,76,-22,4165
99,2022/7/15 7:10,56,111,-55,5712
99,2022/7/15 7:20,55,107,-52,7861
99,2022/7/15 7:30,76,110,-34,8815
99,2022/7/15 7:40,97,182,-85,10871
99,2022/7/15 7:50,149,282,-133,10376
99,2022/7/15 8:00,184,505,-321,9409
99,2022/7/15 8:10,189,567,-378,5501
99,2022/7/15 8:20,217,1091,-874,632
99,2022/7/15 8:30,221,1478,-1257,1250
99,2022/7/15 8:40,238,2339,-2101,-3966
99,2022/7/15 8:50,238,2280,-2042,-2967
99,2022/7/15 9:00,207,1797,-1590,-974
99,2022/7/15 9:10,192,1095,-903,-600
99,2022/7/15 9:20,150,407,-257,-296
99,2022/7/15 9:30,137,511,-374,22
99,2022/7/15 9:40,144,333,-189,194
99,2022/7/15 9:50,82,204,-122,-105
99,2022/7/15 10:00,74,192,-118,-273
99,2022/7/15 10:10,75,142,-67,-246
99,2022/7/15 10:20,73,109,-36,-14
99,2022/7/15 10:30,74,121,-47,-189
99,2022/7/15 10:40,72,86,-14,-229
99,2022/7/15 10:50,73,116,-43,-129
99,2022/7/15 11:00,74,105,-31,-408
99,2022/7/15 11:10,70,105,-35,-384
99,2022/7/15 11:20,70,104,-34,-363
99,2022/7/15 11:30,77,105,-28,-293
99,2022/7/15 11:40,71,98,-27,-65
99,2022/7/15 11:50,64,90,-26,-283
99,2022/7/15 12:00,65,110,-45,-264
99,2022/7/15 12:10,72,106,-34,-155
99,2022/7/15 12:20,76,105,-29,-120
99,2022/7/15 12:30,64,110,-46,-234
99,2022/7/15 12:40,58,104,-46,-148
99,2022/7/15 12:50,64,119,-55,-438
99,2022/7/15 13:00,62,108,-46,-395
99,2022/7/15 13:10,77,108,-31,-446
99,2022/7/15 13:20,76,102,-26,-398
99,2022/7/15 13:30,77,122,-45,-461
99,2022/7/15 13:40,86,123,-37,-158
99,2022/7/15 13:50,76,100,-24,-421
99,2022/7/15 14:00,82,110,-28,-481
99,2022/7/15 14:10,81,101,-20,-367
99,2022/7/15 14:20,77,105,-28,-507
99,2022/7/15 14:30,83,112,-29,-439
99,2022/7/15 14:40,80,112,-32,-280
99,2022/7/15 14:50,81,103,-22,-440
99,2022/7/15 15:00,102,105,-3,-310
99,2022/7/15 15:10,126,108,18,-143
99,2022/7/15 15:20,92,109,-17,-407
99,2022/7/15 15:30,79,99,-20,-247
99,2022/7/15 15:40,134,111,23,-147
99,2022/7/15 15:50,157,110,47,-105
99,2022/7/15 16:00,173,112,61,-225
99,2022/7/15 16:10,172,99,73,26
99,2022/7/15 16:20,145,106,39,-62
99,2022/7/15 16:30,205,111,94,108
99,2022/7/15 16:40,216,109,107,178
99,2022/7/15 16:50,265,105,160,333
99,2022/7/15 17:00,651,105,546,1126
99,2022/7/15 17:10,712,101,611,2830
99,2022/7/15 17:20,574,125,449,1609
99,2022/7/15 17:30,828,126,702,787
99,2022/7/15 17:40,1358,115,1243,2731
99,2022/7/15 17:50,824,121,703,593
99,2022/7/15 18:00,1038,110,928,582
99,2022/7/15 18:10,1361,119,1242,262
99,2022/7/15 18:20,819,104,715,-57
99,2022/7/15 18:30,607,124,483,-1406
99,2022/7/15 18:40,461,112,349,-4414
99,2022/7/15 18:50,270,114,156,-3566
99,2022/7/15 19:00,240,120,120,-2639
99,2022/7/15 19:10,222,110,112,-3045
99,2022/7/15 19:20,161,102,59,-1927
99,2022/7/15 19:30,131,89,42,-1533
99,2022/7/15 19:40,88,84,4,-1250
99,2022/7/15 19:50,70,83,-13,-1083
99,2022/7/15 20:00,77,76,1,-1024
99,2022/7/15 20:10,68,76,-8,-962
99,2022/7/15 20:20,55,62,-7,-1045
99,2022/7/15 20:30,49,69,-20,-921
99,2022/7/15 20:40,49,82,-33,-884
99,2022/7/15 20:50,44,72,-28,-965
99,2022/7/15 21:00,42,76,-34,-827
99,2022/7/15 21:10,42,83,-41,-846
99,2022/7/15 21:20,42,64,-22,-981
99,2022/7/15 21:30,30,80,-50,-1025
99,2022/7/15 21:40,33,70,-37,-929
99,2022/7/15 21:50,35,80,-45,-1047
99,2022/7/15 22:00,29,70,-41,-867
99,2022/7/15 22:10,29,80,-51,-1035
99,2022/7/15 22:20,24,76,-52,-1122
99,2022/7/15 22:30,18,66,-48,-1281
99,2022/7/15 22:40,17,55,-38,-1255
99,2022/7/15 22:50,12,38,-26,-1164
102,2022/7/15 5:00,3,1,2,-8
102,2022/7/15 5:10,7,5,2,83
102,2022/7/15 5:20,12,11,1,164
102,2022/7/15 5:30,15,8,7,296
102,2022/7/15 5:40,12,8,4,346
102,2022/7/15 5:50,16,25,-9,369
102,2022/7/15 6:00,21,69,-48,398
102,2022/7/15 6:10,23,66,-43,764
102,2022/7/15 6:20,34,63,-29,1151
102,2022/7/15 6:30,32,97,-65,2074
102,2022/7/15 6:40,38,101,-63,2574
102,2022/7/15 6:50,41,117,-76,3553
102,2022/7/15 7:00,47,106,-59,4106
102,2022/7/15 7:10,53,142,-89,5623
102,2022/7/15 7:20,58,230,-172,7689
102,2022/7/15 7:30,60,325,-265,8550
102,2022/7/15 7:40,83,507,-424,10447
102,2022/7/15 7:50,76,417,-341,10035
102,2022/7/15 8:00,99,878,-779,8630
102,2022/7/15 8:10,150,2212,-2062,3439
102,2022/7/15 8:20,167,2866,-2699,-2067
102,2022/7/15 8:30,150,2532,-2382,-1132
102,2022/7/15 8:40,128,4979,-4851,-8817
102,2022/7/15 8:50,128,5856,-5728,-8695
102,2022/7/15 9:00,108,5302,-5194,-6168
102,2022/7/15 9:10,139,2931,-2792,-3392
102,2022/7/15 9:20,88,3128,-3040,-3336
102,2022/7/15 9:30,79,1701,-1622,-1600
102,2022/7/15 9:40,92,1707,-1615,-1421
102,2022/7/15 9:50,71,719,-648,-753
102,2022/7/15 10:00,74,430,-356,-629
102,2022/7/15 10:10,75,374,-299,-545
102,2022/7/15 10:20,79,332,-253,-267
102,2022/7/15 10:30,73,298,-225,-414
102,2022/7/15 10:40,109,281,-172,-401
102,2022/7/15 10:50,82,177,-95,-224
102,2022/7/15 11:00,128,227,-99,-507
102,2022/7/15 11:10,89,139,-50,-434
102,2022/7/15 11:20,113,153,-40,-403
102,2022/7/15 11:30,136,170,-34,-327
102,2022/7/15 11:40,141,192,-51,-116
102,2022/7/15 11:50,137,146,-9,-292
102,2022/7/15 12:00,137,146,-9,-273
102,2022/7/15 12:10,162,117,45,-110
102,2022/7/15 12:20,147,184,-37,-157
102,2022/7/15 12:30,131,181,-50,-284
102,2022/7/15 12:40,138,146,-8,-156
102,2022/7/15 12:50,141,214,-73,-511
102,2022/7/15 13:00,156,179,-23,-418
102,2022/7/15 13:10,156,185,-29,-475
102,2022/7/15 13:20,179,226,-47,-445
102,2022/7/15 13:30,188,198,-10,-471
102,2022/7/15 13:40,179,214,-35,-193
102,2022/7/15 13:50,197,181,16,-405
102,2022/7/15 14:00,206,184,22,-459
102,2022/7/15 14:10,207,152,55,-312
102,2022/7/15 14:20,205,152,53,-454
102,2022/7/15 14:30,207,123,84,-355
102,2022/7/15 14:40,191,110,81,-199
102,2022/7/15 14:50,197,128,69,-371
102,2022/7/15 15:00,208,133,75,-235
102,2022/7/15 15:10,220,110,110,-33
102,2022/7/15 15:20,238,105,133,-274
102,2022/7/15 15:30,242,129,113,-134
102,2022/7/15 15:40,269,125,144,-3
102,2022/7/15 15:50,258,109,149,44
102,2022/7/15 16:00,267,108,159,-66
102,2022/7/15 16:10,333,110,223,249
102,2022/7/15 16:20,311,108,203,141
102,2022/7/15 16:30,345,128,217,325
102,2022/7/15 16:40,428,105,323,501
102,2022/7/15 16:50,454,109,345,678
102,2022/7/15 17:00,712,115,597,1723
102,2022/7/15 17:10,1140,152,988,3818
102,2022/7/15 17:20,803,180,623,2232
102,2022/7/15 17:30,1196,197,999,1786
102,2022/7/15 17:40,1978,225,1753,4484
102,2022/7/15 17:50,1352,217,1135,1728
102,2022/7/15 18:00,1972,231,1741,2323
102,2022/7/15 18:10,3023,219,2804,3066
102,2022/7/15 18:20,1987,235,1752,1695
102,2022/7/15 18:30,1359,256,1103,-303
102,2022/7/15 18:40,1197,234,963,-3451
102,2022/7/15 18:50,1036,179,857,-2709
102,2022/7/15 19:00,803,181,622,-2017
102,2022/7/15 19:10,625,127,498,-2547
102,2022/7/15 19:20,566,125,441,-1486
102,2022/7/15 19:30,429,124,305,-1228
102,2022/7/15 19:40,310,104,206,-1044
102,2022/7/15 19:50,333,107,226,-857
102,2022/7/15 20:00,327,96,231,-793
102,2022/7/15 20:10,358,89,269,-693
102,2022/7/15 20:20,316,95,221,-824
102,2022/7/15 20:30,309,77,232,-689
102,2022/7/15 20:40,331,77,254,-630
102,2022/7/15 20:50,272,78,194,-771
102,2022/7/15 21:00,319,75,244,-583
102,2022/7/15 21:10,339,75,264,-582
102,2022/7/15 21:20,317,80,237,-744
102,2022/7/15 21:30,267,77,190,-835
102,2022/7/15 21:40,267,72,195,-734
102,2022/7/15 21:50,249,78,171,-876
102,2022/7/15 22:00,595,74,521,-346
102,2022/7/15 22:10,265,75,190,-845
102,2022/7/15 22:20,131,83,48,-1074
102,2022/7/15 22:30,65,73,-8,-1289
102,2022/7/15 22:40,41,68,-27,-1282
102,2022/7/15 22:50,23,55,-32,-1196
107,2022/7/15 5:00,1,2,-1,-9
107,2022/7/15 5:10,2,1,1,84
107,2022/7/15 5:20,4,2,2,166
107,2022/7/15 5:30,10,14,-4,292
107,2022/7/15 5:40,12,23,-11,335
107,2022/7/15 5:50,18,33,-15,354
107,2022/7/15 6:00,23,48,-25,373
107,2022/7/15 6:10,31,80,-49,715
107,2022/7/15 6:20,29,107,-78,1073
107,2022/7/15 6:30,49,108,-59,2015
107,2022/7/15 6:40,57,119,-62,2512
107,2022/7/15 6:50,65,223,-158,3395
107,2022/7/15 7:00,71,317,-246,3860
107,2022/7/15 7:10,97,500,-403,5220
107,2022/7/15 7:20,151,438,-287,7402
107,2022/7/15 7:30,182,431,-249,8301
107,2022/7/15 7:40,184,475,-291,10156
107,2022/7/15 7:50,259,605,-346,9689
107,2022/7/15 8:00,281,1172,-891,7739
107,2022/7/15 8:10,361,1931,-1570,1869
107,2022/7/15 8:20,339,2046,-1707,-3774
107,2022/7/15 8:30,357,2230,-1873,-3005
107,2022/7/15 8:40,357,2489,-2132,-10949
107,2022/7/15 8:50,280,2760,-2480,-11175
107,2022/7/15 9:00,271,2275,-2004,-8172
107,2022/7/15 9:10,248,2946,-2698,-6090
107,2022/7/15 9:20,228,1726,-1498,-4834
107,2022/7/15 9:30,192,565,-373,-1973
107,2022/7/15 9:40,188,578,-390,-1811
107,2022/7/15 9:50,174,391,-217,-970
107,2022/7/15 10:00,173,421,-248,-877
107,2022/7/15 10:10,171,427,-256,-801
107,2022/7/15 10:20,176,320,-144,-411
107,2022/7/15 10:30,173,432,-259,-673
107,2022/7/15 10:40,178,334,-156,-557
107,2022/7/15 10:50,181,319,-138,-362
107,2022/7/15 11:00,173,282,-109,-616
107,2022/7/15 11:10,203,266,-63,-497
107,2022/7/15 11:20,172,232,-60,-463
107,2022/7/15 11:30,203,268,-65,-392
107,2022/7/15 11:40,208,283,-75,-191
107,2022/7/15 11:50,216,284,-68,-360
107,2022/7/15 12:00,222,231,-9,-282
107,2022/7/15 12:10,234,267,-33,-143
107,2022/7/15 12:20,236,231,5,-152
107,2022/7/15 12:30,227,268,-41,-325
107,2022/7/15 12:40,233,326,-93,-249
107,2022/7/15 12:50,242,333,-91,-602
107,2022/7/15 13:00,271,295,-24,-442
107,2022/7/15 13:10,272,331,-59,-534
107,2022/7/15 13:20,268,317,-49,-494
107,2022/7/15 13:30,269,282,-13,-484
107,2022/7/15 13:40,270,335,-65,-258
107,2022/7/15 13:50,265,298,-33,-438
107,2022/7/15 14:00,288,283,5,-454
107,2022/7/15 14:10,334,254,80,-232
107,2022/7/15 14:20,315,225,90,-364
107,2022/7/15 14:30,336,196,140,-215
107,2022/7/15 14:40,334,231,103,-96
107,2022/7/15 14:50,327,218,109,-262
107,2022/7/15 15:00,349,208,141,-94
107,2022/7/15 15:10,350,181,169,136
107,2022/7/15 15:20,429,208,221,-53
107,2022/7/15 15:30,461,233,228,94
107,2022/7/15 15:40,550,198,352,349
107,2022/7/15 15:50,576,226,350,394
107,2022/7/15 16:00,572,207,365,299
107,2022/7/15 16:10,637,180,457,706
107,2022/7/15 16:20,587,198,389,530
107,2022/7/15 16:30,638,180,458,783
107,2022/7/15 16:40,658,234,424,925
107,2022/7/15 16:50,657,197,460,1138
107,2022/7/15 17:00,843,230,613,2336
107,2022/7/15 17:10,1206,316,890,4708
107,2022/7/15 17:20,1157,328,829,3061
107,2022/7/15 17:30,1156,336,820,2606
107,2022/7/15 17:40,1592,431,1161,5645
107,2022/7/15 17:50,1360,498,862,2590
107,2022/7/15 18:00,1585,492,1093,3416
107,2022/7/15 18:10,1996,427,1569,4635
107,2022/7/15 18:20,1564,425,1139,2834
107,2022/7/15 18:30,1585,416,1169,866
107,2022/7/15 18:40,1351,520,831,-2620
107,2022/7/15 18:50,1160,370,790,-1919
107,2022/7/15 19:00,816,321,495,-1522
107,2022/7/15 19:10,659,279,380,-2167
107,2022/7/15 19:20,616,180,436,-1050
107,2022/7/15 19:30,579,137,442,-786
107,2022/7/15 19:40,457,120,337,-707
107,2022/7/15 19:50,350,124,226,-631
107,2022/7/15 20:00,422,126,296,-497
107,2022/7/15 20:10,578,105,473,-220
107,2022/7/15 20:20,455,106,349,-475
107,2022/7/15 20:30,422,98,324,-365
107,2022/7/15 20:40,592,108,484,-146
107,2022/7/15 20:50,457,100,357,-414
107,2022/7/15 21:00,597,106,491,-92
107,2022/7/15 21:10,641,109,532,-50
107,2022/7/15 21:20,573,106,467,-277
107,2022/7/15 21:30,570,111,459,-376
107,2022/7/15 21:40,573,108,465,-269
107,2022/7/15 21:50,582,112,470,-406
107,2022/7/15 22:00,674,97,577,231
107,2022/7/15 22:10,842,102,740,-105
107,2022/7/15 22:20,272,82,190,-884
107,2022/7/15 22:30,159,70,89,-1200
107,2022/7/15 22:40,70,72,-2,-1284
107,2022/7/15 22:50,34,52,-18,-1214
95,2022/7/15 5:00,2,1,1,-8
95,2022/7/15 5:10,4,1,3,87
95,2022/7/15 5:20,8,1,7,173
95,2022/7/15 5:30,7,1,6,298
95,2022/7/15 5:40,7,5,2,337
95,2022/7/15 5:50,9,19,-10,344
95,2022/7/15 6:00,7,23,-16,357
95,2022/7/15 6:10,13,53,-40,675
95,2022/7/15 6:20,14,74,-60,1013
95,2022/7/15 6:30,22,73,-51,1964
95,2022/7/15 6:40,29,102,-73,2439
95,2022/7/15 6:50,31,109,-78,3317
95,2022/7/15 7:00,36,108,-72,3788
95,2022/7/15 7:10,36,112,-76,5144
95,2022/7/15 7:20,35,152,-117,7285
95,2022/7/15 7:30,32,227,-195,8106
95,2022/7/15 7:40,34,256,-222,9934
95,2022/7/15 7:50,38,299,-261,9428
95,2022/7/15 8:00,54,267,-213,7526
95,2022/7/15 8:10,52,332,-280,1589
95,2022/7/15 8:20,57,316,-259,-4033
95,2022/7/15 8:30,57,436,-379,-3384
95,2022/7/15 8:40,51,422,-371,-11320
95,2022/7/15 8:50,55,503,-448,-11623
95,2022/7/15 9:00,42,318,-276,-8448
95,2022/7/15 9:10,43,284,-241,-6331
95,2022/7/15 9:20,38,256,-218,-5052
95,2022/7/15 9:30,40,192,-152,-2125
95,2022/7/15 9:40,39,150,-111,-1922
95,2022/7/15 9:50,37,108,-71,-1041
95,2022/7/15 10:00,35,99,-64,-941
95,2022/7/15 10:10,30,111,-81,-882
95,2022/7/15 10:20,29,103,-74,-485
95,2022/7/15 10:30,33,109,-76,-749
95,2022/7/15 10:40,29,106,-77,-634
95,2022/7/15 10:50,28,93,-65,-427
95,2022/7/15 11:00,27,93,-66,-682
95,2022/7/15 11:10,33,81,-48,-545
95,2022/7/15 11:20,37,76,-39,-502
95,2022/7/15 11:30,29,75,-46,-438
95,2022/7/15 11:40,30,91,-61,-252
95,2022/7/15 11:50,30,75,-45,-405
95,2022/7/15 12:00,32,73,-41,-323
95,2022/7/15 12:10,31,76,-45,-188
95,2022/7/15 12:20,29,77,-48,-200
95,2022/7/15 12:30,31,91,-60,-385
95,2022/7/15 12:40,31,108,-77,-326
95,2022/7/15 12:50,36,98,-62,-664
95,2022/7/15 13:00,29,105,-76,-518
95,2022/7/15 13:10,31,101,-70,-604
95,2022/7/15 13:20,30,109,-79,-573
95,2022/7/15 13:30,32,93,-61,-545
95,2022/7/15 13:40,32,93,-61,-319
95,2022/7/15 13:50,32,88,-56,-494
95,2022/7/15 14:00,37,94,-57,-511
95,2022/7/15 14:10,38,76,-38,-270
95,2022/7/15 14:20,38,76,-38,-402
95,2022/7/15 14:30,37,76,-39,-254
95,2022/7/15 14:40,40,81,-41,-137
95,2022/7/15 14:50,37,76,-39,-301
95,2022/7/15 15:00,41,75,-34,-128
95,2022/7/15 15:10,41,84,-43,93
95,2022/7/15 15:20,44,81,-37,-90
95,2022/7/15 15:30,55,77,-22,72
95,2022/7/15 15:40,50,75,-25,324
95,2022/7/15 15:50,56,85,-29,365
95,2022/7/15 16:00,57,76,-19,280
95,2022/7/15 16:10,68,72,-4,702
95,2022/7/15 16:20,64,71,-7,523
95,2022/7/15 16:30,83,86,-3,780
95,2022/7/15 16:40,140,79,61,986
95,2022/7/15 16:50,242,74,168,1306
95,2022/7/15 17:00,325,85,240,2576
95,2022/7/15 17:10,344,76,268,4976
95,2022/7/15 17:20,224,90,134,3195
95,2022/7/15 17:30,270,98,172,2778
95,2022/7/15 17:40,344,110,234,5879
95,2022/7/15 17:50,230,104,126,2716
95,2022/7/15 18:00,240,106,134,3550
95,2022/7/15 18:10,352,107,245,4880
95,2022/7/15 18:20,249,104,145,2979
95,2022/7/15 18:30,170,105,65,931
95,2022/7/15 18:40,139,104,35,-2585
95,2022/7/15 18:50,81,96,-15,-1934
95,2022/7/15 19:00,65,78,-13,-1535
95,2022/7/15 19:10,55,81,-26,-2193
95,2022/7/15 19:20,43,77,-34,-1084
95,2022/7/15 19:30,43,64,-21,-807
95,2022/7/15 19:40,38,69,-31,-738
95,2022/7/15 19:50,37,58,-21,-652
95,2022/7/15 20:00,36,58,-22,-519
95,2022/7/15 20:10,37,54,-17,-237
95,2022/7/15 20:20,30,55,-25,-500
95,2022/7/15 20:30,33,49,-16,-381
95,2022/7/15 20:40,31,43,-12,-158
95,2022/7/15 20:50,31,52,-21,-435
95,2022/7/15 21:00,25,48,-23,-115
95,2022/7/15 21:10,35,52,-17,-67
95,2022/7/15 21:20,25,61,-36,-313
95,2022/7/15 21:30,29,51,-22,-398
95,2022/7/15 21:40,25,50,-25,-294
95,2022/7/15 21:50,26,51,-25,-431
95,2022/7/15 22:00,26,47,-21,210
95,2022/7/15 22:10,24,49,-25,-130
95,2022/7/15 22:20,23,49,-26,-910
95,2022/7/15 22:30,18,34,-16,-1216
95,2022/7/15 22:40,15,32,-17,-1301
95,2022/7/15 22:50,10,25,-15,-1229
100,2022/7/15 5:00,0,1,-1,-9
100,2022/7/15 5:10,2,1,1,88
100,2022/7/15 5:20,3,1,2,175
100,2022/7/15 5:30,5,1,4,302
100,2022/7/15 5:40,9,5,4,341
100,2022/7/15 5:50,6,6,0,344
100,2022/7/15 6:00,6,21,-15,342
100,2022/7/15 6:10,10,32,-22,653
100,2022/7/15 6:20,19,46,-27,986
100,2022/7/15 6:30,23,50,-27,1937
100,2022/7/15 6:40,30,71,-41,2398
100,2022/7/15 6:50,33,106,-73,3244
100,2022/7/15 7:00,37,109,-72,3716
100,2022/7/15 7:10,46,139,-93,5051
100,2022/7/15 7:20,38,117,-79,7206
100,2022/7/15 7:30,42,154,-112,7994
100,2022/7/15 7:40,41,227,-186,9748
100,2022/7/15 7:50,59,208,-149,9279
100,2022/7/15 8:00,64,208,-144,7382
100,2022/7/15 8:10,63,226,-163,1426
100,2022/7/15 8:20,57,192,-135,-4168
100,2022/7/15 8:30,60,218,-158,-3542
100,2022/7/15 8:40,58,284,-226,-11546
100,2022/7/15 8:50,54,198,-144,-11767
100,2022/7/15 9:00,41,144,-103,-8551
100,2022/7/15 9:10,40,117,-77,-6408
100,2022/7/15 9:20,33,121,-88,-5140
100,2022/7/15 9:30,30,124,-94,-2219
100,2022/7/15 9:40,28,102,-74,-1996
100,2022/7/15 9:50,29,105,-76,-1117
100,2022/7/15 10:00,26,96,-70,-1011
100,2022/7/15 10:10,28,76,-48,-930
100,2022/7/15 10:20,28,76,-48,-533
100,2022/7/15 10:30,29,73,-44,-793
100,2022/7/15 10:40,28,83,-55,-689
100,2022/7/15 10:50,29,64,-35,-462
100,2022/7/15 11:00,27,70,-43,-725
100,2022/7/15 11:10,28,66,-38,-583
100,2022/7/15 11:20,28,75,-47,-549
100,2022/7/15 11:30,29,72,-43,-481
100,2022/7/15 11:40,27,70,-43,-295
100,2022/7/15 11:50,28,63,-35,-440
100,2022/7/15 12:00,29,71,-42,-365
100,2022/7/15 12:10,27,66,-39,-227
100,2022/7/15 12:20,27,71,-44,-244
100,2022/7/15 12:30,25,68,-43,-428
100,2022/7/15 12:40,28,76,-48,-374
100,2022/7/15 12:50,28,77,-49,-713
100,2022/7/15 13:00,28,75,-47,-565
100,2022/7/15 13:10,30,76,-46,-650
100,2022/7/15 13:20,30,89,-59,-632
100,2022/7/15 13:30,30,93,-63,-608
100,2022/7/15 13:40,29,77,-48,-367
100,2022/7/15 13:50,32,77,-45,-539
100,2022/7/15 14:00,24,85,-61,-572
100,2022/7/15 14:10,31,81,-50,-320
100,2022/7/15 14:20,27,81,-54,-456
100,2022/7/15 14:30,30,71,-41,-295
100,2022/7/15 14:40,32,77,-45,-182
100,2022/7/15 14:50,33,72,-39,-340
100,2022/7/15 15:00,41,69,-28,-156
100,2022/7/15 15:10,40,83,-43,50
100,2022/7/15 15:20,42,75,-33,-123
100,2022/7/15 15:30,43,82,-39,33
100,2022/7/15 15:40,38,73,-35,289
100,2022/7/15 15:50,42,85,-43,322
100,2022/7/15 16:00,59,69,-10,270
100,2022/7/15 16:10,59,69,-10,692
100,2022/7/15 16:20,57,74,-17,506
100,2022/7/15 16:30,129,69,60,840
100,2022/7/15 16:40,195,85,110,1096
100,2022/7/15 16:50,162,76,86,1392
100,2022/7/15 17:00,201,77,124,2700
100,2022/7/15 17:10,293,75,218,5194
100,2022/7/15 17:20,271,97,174,3369
100,2022/7/15 17:30,264,102,162,2940
100,2022/7/15 17:40,274,105,169,6048
100,2022/7/15 17:50,177,106,71,2787
100,2022/7/15 18:00,173,89,84,3634
100,2022/7/15 18:10,224,108,116,4996
100,2022/7/15 18:20,174,106,68,3047
100,2022/7/15 18:30,99,104,-5,926
100,2022/7/15 18:40,75,104,-29,-2614
100,2022/7/15 18:50,55,105,-50,-1984
100,2022/7/15 19:00,44,105,-61,-1596
100,2022/7/15 19:10,47,89,-42,-2235
100,2022/7/15 19:20,39,80,-41,-1125
100,2022/7/15 19:30,35,73,-38,-845
100,2022/7/15 19:40,32,80,-48,-786
100,2022/7/15 19:50,29,68,-39,-691
100,2022/7/15 20:00,38,61,-23,-542
100,2022/7/15 20:10,36,62,-26,-263
100,2022/7/15 20:20,42,59,-17,-517
100,2022/7/15 20:30,30,62,-32,-413
100,2022/7/15 20:40,36,64,-28,-186
100,2022/7/15 20:50,32,56,-24,-459
100,2022/7/15 21:00,28,57,-29,-144
100,2022/7/15 21:10,29,62,-33,-100
100,2022/7/15 21:20,33,53,-20,-333
100,2022/7/15 21:30,26,66,-40,-438
100,2022/7/15 21:40,23,62,-39,-333
100,2022/7/15 21:50,27,56,-29,-460
100,2022/7/15 22:00,26,52,-26,184
100,2022/7/15 22:10,25,55,-30,-160
100,2022/7/15 22:20,22,50,-28,-938
100,2022/7/15 22:30,22,45,-23,-1239
100,2022/7/15 22:40,14,38,-24,-1325
100,2022/7/15 22:50,4,25,-21,-1250
117,2022/7/15 5:00,2,1,1,-8
117,2022/7/15 5:10,5,1,4,92
117,2022/7/15 5:20,7,1,6,181
117,2022/7/15 5:30,8,2,6,308
117,2022/7/15 5:40,15,22,-7,334
117,2022/7/15 5:50,22,16,6,350
117,2022/7/15 6:00,25,21,4,346
117,2022/7/15 6:10,32,68,-36,617
117,2022/7/15 6:20,32,70,-38,948
117,2022/7/15 6:30,36,104,-68,1869
117,2022/7/15 6:40,58,114,-56,2342
117,2022/7/15 6:50,60,159,-99,3145
117,2022/7/15 7:00,85,195,-110,3606
117,2022/7/15 7:10,128,435,-307,4744
117,2022/7/15 7:20,157,435,-278,6928
117,2022/7/15 7:30,215,509,-294,7700
117,2022/7/15 7:40,234,421,-187,9561
117,2022/7/15 7:50,279,588,-309,8970
117,2022/7/15 8:00,277,1550,-1273,6109
117,2022/7/15 8:10,346,3229,-2883,-1457
117,2022/7/15 8:20,344,4136,-3792,-7960
117,2022/7/15 8:30,334,6610,-6276,-9818
117,2022/7/15 8:40,316,7797,-7481,-19027
117,2022/7/15 8:50,286,6941,-6655,-18422
117,2022/7/15 9:00,277,6583,-6306,-14857
117,2022/7/15 9:10,260,4899,-4639,-11047
117,2022/7/15 9:20,239,2864,-2625,-7765
117,2022/7/15 9:30,232,2192,-1960,-4179
117,2022/7/15 9:40,225,1713,-1488,-3484
117,2022/7/15 9:50,207,1208,-1001,-2118
117,2022/7/15 10:00,223,556,-333,-1344
117,2022/7/15 10:10,232,416,-184,-1114
117,2022/7/15 10:20,254,434,-180,-713
117,2022/7/15 10:30,273,422,-149,-942
117,2022/7/15 10:40,269,425,-156,-845
117,2022/7/15 10:50,274,427,-153,-615
117,2022/7/15 11:00,271,315,-44,-769
117,2022/7/15 11:10,270,518,-248,-831
117,2022/7/15 11:20,268,378,-110,-659
117,2022/7/15 11:30,270,532,-262,-743
117,2022/7/15 11:40,303,432,-129,-424
117,2022/7/15 11:50,335,434,-99,-539
117,2022/7/15 12:00,334,373,-39,-404
117,2022/7/15 12:10,326,317,9,-218
117,2022/7/15 12:20,368,431,-63,-307
117,2022/7/15 12:30,348,432,-84,-512
117,2022/7/15 12:40,368,499,-131,-505
117,2022/7/15 12:50,456,432,24,-689
117,2022/7/15 13:00,570,532,38,-527
117,2022/7/15 13:10,569,527,42,-608
117,2022/7/15 13:20,578,531,47,-585
117,2022/7/15 13:30,569,525,44,-564
117,2022/7/15 13:40,569,500,69,-298
117,2022/7/15 13:50,587,492,95,-444
117,2022/7/15 14:00,609,431,178,-394
117,2022/7/15 14:10,609,431,178,-142
117,2022/7/15 14:20,592,433,159,-297
117,2022/7/15 14:30,620,376,244,-51
117,2022/7/15 14:40,587,379,208,26
117,2022/7/15 14:50,587,319,268,-72
117,2022/7/15 15:00,637,431,206,50
117,2022/7/15 15:10,638,339,299,349
117,2022/7/15 15:20,648,315,333,210
117,2022/7/15 15:30,657,319,338,371
117,2022/7/15 15:40,673,377,296,585
117,2022/7/15 15:50,680,332,348,670
117,2022/7/15 16:00,807,372,435,705
117,2022/7/15 16:10,832,378,454,1146
117,2022/7/15 16:20,845,371,474,980
117,2022/7/15 16:30,1151,374,777,1617
117,2022/7/15 16:40,1160,377,783,1879
117,2022/7/15 16:50,1169,520,649,2041
117,2022/7/15 17:00,1584,489,1095,3795
117,2022/7/15 17:10,1973,425,1548,6742
117,2022/7/15 17:20,1966,402,1564,4933
117,2022/7/15 17:30,2477,558,1919,4859
117,2022/7/15 17:40,3302,561,2741,8789
117,2022/7/15 17:50,1989,584,1405,4192
117,2022/7/15 18:00,2546,1091,1455,5089
117,2022/7/15 18:10,3366,1094,2272,7268
117,2022/7/15 18:20,2539,1090,1449,4496
117,2022/7/15 18:30,1982,1089,893,1819
117,2022/7/15 18:40,1969,1096,873,-1741
117,2022/7/15 18:50,1583,558,1025,-959
117,2022/7/15 19:00,1366,419,947,-649
117,2022/7/15 19:10,1197,427,770,-1465
117,2022/7/15 19:20,1148,314,834,-291
117,2022/7/15 19:30,1035,314,721,-124
117,2022/7/15 19:40,823,233,590,-196
117,2022/7/15 19:50,806,183,623,-68
117,2022/7/15 20:00,1027,159,868,326
117,2022/7/15 20:10,835,114,721,458
117,2022/7/15 20:20,821,108,713,196
117,2022/7/15 20:30,1027,122,905,492
117,2022/7/15 20:40,1019,101,918,732
117,2022/7/15 20:50,837,101,736,277
117,2022/7/15 21:00,1257,121,1136,992
117,2022/7/15 21:10,1218,105,1113,1013
117,2022/7/15 21:20,827,117,710,377
117,2022/7/15 21:30,1208,86,1122,684
117,2022/7/15 21:40,812,88,724,391
117,2022/7/15 21:50,647,111,536,76
117,2022/7/15 22:00,1649,111,1538,1722
117,2022/7/15 22:10,1028,105,923,763
117,2022/7/15 22:20,608,107,501,-437
117,2022/7/15 22:30,75,74,1,-1238
117,2022/7/15 22:40,31,67,-36,-1361
117,2022/7/15 22:50,15,71,-56,-1306
111,2022/7/15 5:00,0,1,-1,-9
111,2022/7/15 5:10,4,1,3,95
111,2022/7/15 5:20,6,1,5,186
111,2022/7/15 5:30,6,1,5,313
111,2022/7/15 5:40,7,13,-6,328
111,2022/7/15 5:50,13,12,1,351
111,2022/7/15 6:00,16,21,-5,341
111,2022/7/15 6:10,18,38,-20,597
111,2022/7/15 6:20,22,45,-23,925
111,2022/7/15 6:30,31,76,-45,1824
111,2022/7/15 6:40,32,111,-79,2263
111,2022/7/15 6:50,47,112,-65,3080
111,2022/7/15 7:00,47,127,-80,3526
111,2022/7/15 7:10,57,114,-57,4687
111,2022/7/15 7:20,63,108,-45,6883
111,2022/7/15 7:30,88,144,-56,7644
111,2022/7/15 7:40,95,192,-97,9464
111,2022/7/15 7:50,187,326,-139,8831
111,2022/7/15 8:00,194,508,-314,5795
111,2022/7/15 8:10,230,564,-334,-1791
111,2022/7/15 8:20,213,418,-205,-8165
111,2022/7/15 8:30,169,1128,-959,-10777
111,2022/7/15 8:40,143,1565,-1422,-20449
111,2022/7/15 8:50,87,595,-508,-18930
111,2022/7/15 9:00,71,424,-353,-15210
111,2022/7/15 9:10,65,500,-435,-11482
111,2022/7/15 9:20,46,377,-331,-8096
111,2022/7/15 9:30,43,298,-255,-4434
111,2022/7/15 9:40,38,179,-141,-3625
111,2022/7/15 9:50,39,151,-112,-2230
111,2022/7/15 10:00,34,125,-91,-1435
111,2022/7/15 10:10,37,109,-72,-1186
111,2022/7/15 10:20,34,121,-87,-800
111,2022/7/15 10:30,35,115,-80,-1022
111,2022/7/15 10:40,31,120,-89,-934
111,2022/7/15 10:50,33,100,-67,-682
111,2022/7/15 11:00,30,125,-95,-864
111,2022/7/15 11:10,30,99,-69,-900
111,2022/7/15 11:20,26,108,-82,-741
111,2022/7/15 11:30,31,88,-57,-800
111,2022/7/15 11:40,32,84,-52,-476
111,2022/7/15 11:50,36,102,-66,-605
111,2022/7/15 12:00,36,126,-90,-494
111,2022/7/15 12:10,35,108,-73,-291
111,2022/7/15 12:20,37,122,-85,-392
111,2022/7/15 12:30,38,122,-84,-596
111,2022/7/15 12:40,40,117,-77,-582
111,2022/7/15 12:50,38,103,-65,-754
111,2022/7/15 13:00,39,125,-86,-613
111,2022/7/15 13:10,42,109,-67,-675
111,2022/7/15 13:20,37,119,-82,-667
111,2022/7/15 13:30,40,114,-74,-638
111,2022/7/15 13:40,41,104,-63,-361
111,2022/7/15 13:50,43,106,-63,-507
111,2022/7/15 14:00,38,100,-62,-456
111,2022/7/15 14:10,38,120,-82,-224
111,2022/7/15 14:20,41,116,-75,-372
111,2022/7/15 14:30,41,124,-83,-134
111,2022/7/15 14:40,44,123,-79,-53
111,2022/7/15 14:50,48,102,-54,-126
111,2022/7/15 15:00,41,104,-63,-13
111,2022/7/15 15:10,41,122,-81,268
111,2022/7/15 15:20,42,109,-67,143
111,2022/7/15 15:30,43,126,-83,288
111,2022/7/15 15:40,42,126,-84,501
111,2022/7/15 15:50,46,103,-57,613
111,2022/7/15 16:00,45,102,-57,648
111,2022/7/15 16:10,47,108,-61,1085
111,2022/7/15 16:20,62,121,-59,921
111,2022/7/15 16:30,67,103,-36,1581
111,2022/7/15 16:40,104,110,-6,1873
111,2022/7/15 16:50,80,117,-37,2004
111,2022/7/15 17:00,163,127,36,3831
111,2022/7/15 17:10,236,152,84,6826
111,2022/7/15 17:20,214,178,36,4969
111,2022/7/15 17:30,247,207,40,4899
111,2022/7/15 17:40,551,224,327,9116
111,2022/7/15 17:50,324,268,56,4248
111,2022/7/15 18:00,259,320,-61,5028
111,2022/7/15 18:10,421,255,166,7434
111,2022/7/15 18:20,305,320,-15,4481
111,2022/7/15 18:30,216,322,-106,1713
111,2022/7/15 18:40,198,308,-110,-1851
111,2022/7/15 18:50,174,287,-113,-1072
111,2022/7/15 19:00,77,215,-138,-787
111,2022/7/15 19:10,70,109,-39,-1504
111,2022/7/15 19:20,56,117,-61,-352
111,2022/7/15 19:30,46,122,-76,-200
111,2022/7/15 19:40,45,121,-76,-272
111,2022/7/15 19:50,35,114,-79,-147
111,2022/7/15 20:00,37,108,-71,255
111,2022/7/15 20:10,35,111,-76,382
111,2022/7/15 20:20,36,100,-64,132
111,2022/7/15 20:30,35,92,-57,435
111,2022/7/15 20:40,37,100,-63,669
111,2022/7/15 20:50,35,95,-60,217
111,2022/7/15 21:00,37,95,-58,934
111,2022/7/15 21:10,40,89,-49,964
111,2022/7/15 21:20,30,94,-64,313
111,2022/7/15 21:30,31,97,-66,618
111,2022/7/15 21:40,29,99,-70,321
111,2022/7/15 21:50,24,92,-68,8
111,2022/7/15 22:00,37,94,-57,1665
111,2022/7/15 22:10,24,89,-65,698
111,2022/7/15 22:20,20,92,-72,-509
111,2022/7/15 22:30,13,89,-76,-1314
111,2022/7/15 22:40,9,66,-57,-1418
111,2022/7/15 22:50,6,64,-58,-1364
94,2022/7/15 5:00,2,1,1,-8
94,2022/7/15 5:10,6,1,5,100
94,2022/7/15 5:20,14,1,13,199
94,2022/7/15 5:30,18,1,17,330
94,2022/7/15 5:40,24,2,22,350
94,2022/7/15 5:50,30,23,7,358
94,2022/7/15 6:00,42,19,23,364
94,2022/7/15 6:10,54,38,16,613
94,2022/7/15 6:20,75,59,16,941
94,2022/7/15 6:30,184,71,113,1937
94,2022/7/15 6:40,256,98,158,2421
94,2022/7/15 6:50,317,105,212,3292
94,2022/7/15 7:00,386,118,268,3794
94,2022/7/15 7:10,598,138,460,5147
94,2022/7/15 7:20,656,177,479,7362
94,2022/7/15 7:30,741,325,416,8060
94,2022/7/15 7:40,870,378,492,9956
94,2022/7/15 7:50,1193,439,754,9585
94,2022/7/15 8:00,1054,554,500,6295
94,2022/7/15 8:10,1063,1779,-716,-2507
94,2022/7/15 8:20,837,1013,-176,-8341
94,2022/7/15 8:30,705,1707,-1002,-11779
94,2022/7/15 8:40,720,1674,-954,-21403
94,2022/7/15 8:50,722,1457,-735,-19665
94,2022/7/15 9:00,584,578,6,-15204
94,2022/7/15 9:10,466,415,51,-11431
94,2022/7/15 9:20,363,519,-156,-8252
94,2022/7/15 9:30,297,319,-22,-4456
94,2022/7/15 9:40,269,298,-29,-3654
94,2022/7/15 9:50,212,224,-12,-2242
94,2022/7/15 10:00,202,145,57,-1378
94,2022/7/15 10:10,202,170,32,-1154
94,2022/7/15 10:20,176,115,61,-739
94,2022/7/15 10:30,167,106,61,-961
94,2022/7/15 10:40,153,105,48,-886
94,2022/7/15 10:50,143,106,37,-645
94,2022/7/15 11:00,149,103,46,-818
94,2022/7/15 11:10,149,109,40,-860
94,2022/7/15 11:20,137,102,35,-706
94,2022/7/15 11:30,173,100,73,-727
94,2022/7/15 11:40,135,105,30,-446
94,2022/7/15 11:50,164,121,43,-562
94,2022/7/15 12:00,167,120,47,-447
94,2022/7/15 12:10,170,108,62,-229
94,2022/7/15 12:20,174,115,59,-333
94,2022/7/15 12:30,187,111,76,-520
94,2022/7/15 12:40,176,103,73,-509
94,2022/7/15 12:50,173,121,52,-702
94,2022/7/15 13:00,162,112,50,-563
94,2022/7/15 13:10,173,125,48,-627
94,2022/7/15 13:20,162,121,41,-626
94,2022/7/15 13:30,166,117,49,-589
94,2022/7/15 13:40,160,115,45,-316
94,2022/7/15 13:50,158,117,41,-466
94,2022/7/15 14:00,167,109,58,-398
94,2022/7/15 14:10,142,138,4,-220
94,2022/7/15 14:20,141,108,33,-339
94,2022/7/15 14:30,157,111,46,-88
94,2022/7/15 14:40,157,121,36,-17
94,2022/7/15 14:50,166,110,56,-70
94,2022/7/15 15:00,199,133,66,53
94,2022/7/15 15:10,220,108,112,380
94,2022/7/15 15:20,196,133,63,206
94,2022/7/15 15:30,204,111,93,381
94,2022/7/15 15:40,207,128,79,580
94,2022/7/15 15:50,204,108,96,709
94,2022/7/15 16:00,268,119,149,797
94,2022/7/15 16:10,272,115,157,1242
94,2022/7/15 16:20,263,145,118,1039
94,2022/7/15 16:30,331,109,222,1803
94,2022/7/15 16:40,585,159,426,2299
94,2022/7/15 16:50,606,154,452,2456
94,2022/7/15 17:00,680,193,487,4318
94,2022/7/15 17:10,1037,230,807,7633
94,2022/7/15 17:20,810,295,515,5484
94,2022/7/15 17:30,838,377,461,5360
94,2022/7/15 17:40,1163,372,791,9907
94,2022/7/15 17:50,848,492,356,4604
94,2022/7/15 18:00,654,506,148,5176
94,2022/7/15 18:10,1039,535,504,7938
94,2022/7/15 18:20,804,534,270,4751
94,2022/7/15 18:30,571,493,78,1791
94,2022/7/15 18:40,350,504,-154,-2005
94,2022/7/15 18:50,317,365,-48,-1120
94,2022/7/15 19:00,266,342,-76,-863
94,2022/7/15 19:10,222,285,-63,-1567
94,2022/7/15 19:20,187,217,-30,-382
94,2022/7/15 19:30,156,177,-21,-221
94,2022/7/15 19:40,114,190,-76,-348
94,2022/7/15 19:50,133,126,7,-140
94,2022/7/15 20:00,73,142,-69,186
94,2022/7/15 20:10,91,128,-37,345
94,2022/7/15 20:20,84,107,-23,109
94,2022/7/15 20:30,76,111,-35,400
94,2022/7/15 20:40,70,128,-58,611
94,2022/7/15 20:50,82,103,-21,196
94,2022/7/15 21:00,77,121,-44,890
94,2022/7/15 21:10,61,107,-46,918
94,2022/7/15 21:20,59,109,-50,263
94,2022/7/15 21:30,44,116,-72,546
94,2022/7/15 21:40,47,119,-72,249
94,2022/7/15 21:50,37,121,-84,-76
94,2022/7/15 22:00,27,102,-75,1590
94,2022/7/15 22:10,29,105,-76,622
94,2022/7/15 22:20,21,120,-99,-608
94,2022/7/15 22:30,24,106,-82,-1396
94,2022/7/15 22:40,12,103,-91,-1509
94,2022/7/15 22:50,1,77,-76,-1440
110,2022/7/15 5:00,26,1,25,17
110,2022/7/15 5:10,32,1,31,131
110,2022/7/15 5:20,31,1,30,229
110,2022/7/15 5:30,29,1,28,358
110,2022/7/15 5:40,28,8,20,370
110,2022/7/15 5:50,27,38,-11,347
110,2022/7/15 6:00,31,38,-7,357
110,2022/7/15 6:10,53,47,6,619
110,2022/7/15 6:20,91,76,15,956
110,2022/7/15 6:30,162,89,73,2010
110,2022/7/15 6:40,155,108,47,2468
110,2022/7/15 6:50,186,111,75,3367
110,2022/7/15 7:00,271,119,152,3946
110,2022/7/15 7:10,286,125,161,5308
110,2022/7/15 7:20,608,135,473,7835
110,2022/7/15 7:30,679,145,534,8594
110,2022/7/15 7:40,746,152,594,10550
110,2022/7/15 7:50,843,152,691,10276
110,2022/7/15 8:00,1240,213,1027,7322
110,2022/7/15 8:10,1051,197,854,-1653
110,2022/7/15 8:20,682,178,504,-7837
110,2022/7/15 8:30,1164,197,967,-10812
110,2022/7/15 8:40,592,219,373,-21030
110,2022/7/15 8:50,324,192,132,-19533
110,2022/7/15 9:00,586,139,447,-14757
110,2022/7/15 9:10,346,110,236,-11195
110,2022/7/15 9:20,266,118,148,-8104
110,2022/7/15 9:30,278,110,168,-4288
110,2022/7/15 9:40,187,118,69,-3585
110,2022/7/15 9:50,140,127,13,-2229
110,2022/7/15 10:00,62,108,-46,-1424
110,2022/7/15 10:10,135,123,12,-1142
110,2022/7/15 10:20,86,96,-10,-749
110,2022/7/15 10:30,53,112,-59,-1020
110,2022/7/15 10:40,106,94,12,-874
110,2022/7/15 10:50,133,114,19,-626
110,2022/7/15 11:00,89,103,-14,-832
110,2022/7/15 11:10,74,111,-37,-897
110,2022/7/15 11:20,93,102,-9,-715
110,2022/7/15 11:30,80,115,-35,-762
110,2022/7/15 11:40,62,86,-24,-470
110,2022/7/15 11:50,65,111,-46,-608
110,2022/7/15 12:00,122,98,24,-423
110,2022/7/15 12:10,66,124,-58,-287
110,2022/7/15 12:20,74,97,-23,-356
110,2022/7/15 12:30,164,109,55,-465
110,2022/7/15 12:40,54,119,-65,-574
110,2022/7/15 12:50,108,107,1,-701
110,2022/7/15 13:00,115,108,7,-556
110,2022/7/15 13:10,129,109,20,-607
110,2022/7/15 13:20,75,113,-38,-664
110,2022/7/15 13:30,79,108,-29,-618
110,2022/7/15 13:40,60,97,-37,-353
110,2022/7/15 13:50,53,117,-64,-530
110,2022/7/15 14:00,108,123,-15,-413
110,2022/7/15 14:10,70,117,-47,-267
110,2022/7/15 14:20,56,109,-53,-392
110,2022/7/15 14:30,68,102,-34,-122
110,2022/7/15 14:40,41,121,-80,-97
110,2022/7/15 14:50,61,129,-68,-138
110,2022/7/15 15:00,78,114,-36,17
110,2022/7/15 15:10,112,104,8,388
110,2022/7/15 15:20,63,117,-54,152
110,2022/7/15 15:30,89,120,-31,350
110,2022/7/15 15:40,51,150,-99,481
110,2022/7/15 15:50,68,172,-104,605
110,2022/7/15 16:00,96,168,-72,725
110,2022/7/15 16:10,194,169,25,1267
110,2022/7/15 16:20,74,156,-82,957
110,2022/7/15 16:30,94,160,-66,1737
110,2022/7/15 16:40,177,191,-14,2285
110,2022/7/15 16:50,202,225,-23,2433
110,2022/7/15 17:00,240,213,27,4345
110,2022/7/15 17:10,270,251,19,7652
110,2022/7/15 17:20,207,295,-88,5396
110,2022/7/15 17:30,262,301,-39,5321
110,2022/7/15 17:40,238,427,-189,9718
110,2022/7/15 17:50,228,401,-173,4431
110,2022/7/15 18:00,270,515,-245,4931
110,2022/7/15 18:10,256,471,-215,7723
110,2022/7/15 18:20,227,471,-244,4507
110,2022/7/15 18:30,209,420,-211,1580
110,2022/7/15 18:40,153,414,-261,-2266
110,2022/7/15 18:50,125,366,-241,-1361
110,2022/7/15 19:00,85,417,-332,-1195
110,2022/7/15 19:10,50,322,-272,-1839
110,2022/7/15 19:20,45,285,-240,-622
110,2022/7/15 19:30,44,219,-175,-396
110,2022/7/15 19:40,36,191,-155,-503
110,2022/7/15 19:50,40,150,-110,-250
110,2022/7/15 20:00,39,109,-70,116
110,2022/7/15 20:10,33,137,-104,241
110,2022/7/15 20:20,42,151,-109,0
110,2022/7/15 20:30,37,110,-73,327
110,2022/7/15 20:40,64,122,-58,553
110,2022/7/15 20:50,56,119,-63,133
110,2022/7/15 21:00,131,111,20,910
110,2022/7/15 21:10,56,115,-59,859
110,2022/7/15 21:20,31,106,-75,188
110,2022/7/15 21:30,28,108,-80,466
110,2022/7/15 21:40,24,124,-100,149
110,2022/7/15 21:50,25,118,-93,-169
110,2022/7/15 22:00,30,102,-72,1518
110,2022/7/15 22:10,25,105,-80,542
110,2022/7/15 22:20,15,120,-105,-713
110,2022/7/15 22:30,18,112,-94,-1490
110,2022/7/15 22:40,3,82,-79,-1588
110,2022/7/15 22:50,0,69,-69,-1509
103,2022/7/15 5:00,0,1,-1,16
103,2022/7/15 5:10,2,1,1,132
103,2022/7/15 5:20,16,1,15,244
103,2022/7/15 5:30,24,1,23,381
103,2022/7/15 5:40,30,2,28,398
103,2022/7/15 5:50,33,43,-10,337
103,2022/7/15 6:00,53,23,30,387
103,2022/7/15 6:10,67,23,44,663
103,2022/7/15 6:20,91,65,26,982
103,2022/7/15 6:30,227,70,157,2167
103,2022/7/15 6:40,280,104,176,2644
103,2022/7/15 6:50,389,105,284,3651
103,2022/7/15 7:00,475,100,375,4321
103,2022/7/15 7:10,686,110,576,5884
103,2022/7/15 7:20,738,152,586,8421
103,2022/7/15 7:30,1180,234,946,9540
103,2022/7/15 7:40,1370,223,1147,11697
103,2022/7/15 7:50,1370,192,1178,11454
103,2022/7/15 8:00,1576,197,1379,8701
103,2022/7/15 8:10,1214,233,981,-672
103,2022/7/15 8:20,1175,213,962,-6875
103,2022/7/15 8:30,870,198,672,-10140
103,2022/7/15 8:40,844,180,664,-20366
103,2022/7/15 8:50,684,146,538,-18995
103,2022/7/15 9:00,615,150,465,-14292
103,2022/7/15 9:10,367,120,247,-10948
103,2022/7/15 9:20,311,121,190,-7914
103,2022/7/15 9:30,245,107,138,-4150
103,2022/7/15 9:40,216,106,110,-3475
103,2022/7/15 9:50,188,114,74,-2155
103,2022/7/15 10:00,132,101,31,-1393
103,2022/7/15 10:10,96,106,-10,-1152
103,2022/7/15 10:20,86,105,-19,-768
103,2022/7/15 10:30,66,91,-25,-1045
103,2022/7/15 10:40,58,105,-47,-921
103,2022/7/15 10:50,59,97,-38,-664
103,2022/7/15 11:00,43,117,-74,-906
103,2022/7/15 11:10,53,92,-39,-936
103,2022/7/15 11:20,56,109,-53,-768
103,2022/7/15 11:30,51,109,-58,-820
103,2022/7/15 11:40,46,104,-58,-528
103,2022/7/15 11:50,44,104,-60,-668
103,2022/7/15 12:00,69,105,-36,-459
103,2022/7/15 12:10,67,103,-36,-323
103,2022/7/15 12:20,78,108,-30,-386
103,2022/7/15 12:30,75,102,-27,-492
103,2022/7/15 12:40,70,99,-29,-603
103,2022/7/15 12:50,71,112,-41,-742
103,2022/7/15 13:00,66,110,-44,-600
103,2022/7/15 13:10,76,86,-10,-617
103,2022/7/15 13:20,60,117,-57,-721
103,2022/7/15 13:30,59,104,-45,-663
103,2022/7/15 13:40,44,102,-58,-411
103,2022/7/15 13:50,55,126,-71,-601
103,2022/7/15 14:00,45,108,-63,-476
103,2022/7/15 14:10,53,104,-51,-318
103,2022/7/15 14:20,45,117,-72,-464
103,2022/7/15 14:30,53,119,-66,-188
103,2022/7/15 14:40,48,106,-58,-155
103,2022/7/15 14:50,52,110,-58,-196
103,2022/7/15 15:00,46,121,-75,-58
103,2022/7/15 15:10,45,109,-64,324
103,2022/7/15 15:20,53,117,-64,88
103,2022/7/15 15:30,45,126,-81,269
103,2022/7/15 15:40,56,142,-86,395
103,2022/7/15 15:50,58,150,-92,513
103,2022/7/15 16:00,65,117,-52,673
103,2022/7/15 16:10,73,179,-106,1161
103,2022/7/15 16:20,86,185,-99,858
103,2022/7/15 16:30,129,198,-69,1668
103,2022/7/15 16:40,134,234,-100,2185
103,2022/7/15 16:50,136,208,-72,2361
103,2022/7/15 17:00,208,316,-108,4237
103,2022/7/15 17:10,265,320,-55,7597
103,2022/7/15 17:20,223,432,-209,5187
103,2022/7/15 17:30,256,432,-176,5145
103,2022/7/15 17:40,264,428,-164,9554
103,2022/7/15 17:50,196,471,-275,4156
103,2022/7/15 18:00,221,421,-200,4731
103,2022/7/15 18:10,208,560,-352,7371
103,2022/7/15 18:20,174,421,-247,4260
103,2022/7/15 18:30,164,565,-401,1179
103,2022/7/15 18:40,134,584,-450,-2716
103,2022/7/15 18:50,73,568,-495,-1856
103,2022/7/15 19:00,56,413,-357,-1552
103,2022/7/15 19:10,44,495,-451,-2290
103,2022/7/15 19:20,41,318,-277,-899
103,2022/7/15 19:30,34,322,-288,-684
103,2022/7/15 19:40,30,224,-194,-697
103,2022/7/15 19:50,27,207,-180,-430
103,2022/7/15 20:00,25,128,-103,13
103,2022/7/15 20:10,30,192,-162,79
103,2022/7/15 20:20,31,132,-101,-101
103,2022/7/15 20:30,27,119,-92,235
103,2022/7/15 20:40,29,198,-169,384
103,2022/7/15 20:50,28,109,-81,52
103,2022/7/15 21:00,24,133,-109,801
103,2022/7/15 21:10,31,116,-85,774
103,2022/7/15 21:20,31,118,-87,101
103,2022/7/15 21:30,27,137,-110,356
103,2022/7/15 21:40,28,109,-81,68
103,2022/7/15 21:50,21,112,-91,-260
103,2022/7/15 22:00,16,122,-106,1412
103,2022/7/15 22:10,21,116,-95,447
103,2022/7/15 22:20,12,104,-92,-805
103,2022/7/15 22:30,9,119,-110,-1600
103,2022/7/15 22:40,1,99,-98,-1686
103,2022/7/15 22:50,1,80,-79,-1588
104,2022/7/15 5:00,1,1,0,16
104,2022/7/15 5:10,7,1,6,138
104,2022/7/15 5:20,21,1,20,264
104,2022/7/15 5:30,40,1,39,420
104,2022/7/15 5:40,75,2,73,471
104,2022/7/15 5:50,149,5,144,481
104,2022/7/15 6:00,211,60,151,538
104,2022/7/15 6:10,280,43,237,900
104,2022/7/15 6:20,580,83,497,1479
104,2022/7/15 6:30,653,95,558,2725
104,2022/7/15 6:40,735,137,598,3242
104,2022/7/15 6:50,1166,233,933,4584
104,2022/7/15 7:00,1213,216,997,5318
104,2022/7/15 7:10,1967,326,1641,7525
104,2022/7/15 7:20,2043,378,1665,10086
104,2022/7/15 7:30,3211,432,2779,12319
104,2022/7/15 7:40,3181,533,2648,14345
104,2022/7/15 7:50,3264,494,2770,14224
104,2022/7/15 8:00,3372,494,2878,11579
104,2022/7/15 8:10,3339,420,2919,2247
104,2022/7/15 8:20,3279,499,2780,-4095
104,2022/7/15 8:30,2571,428,2143,-7997
104,2022/7/15 8:40,2479,434,2045,-18321
104,2022/7/15 8:50,2075,439,1636,-17359
104,2022/7/15 9:00,1632,420,1212,-13080
104,2022/7/15 9:10,1387,315,1072,-9876
104,2022/7/15 9:20,1155,297,858,-7056
104,2022/7/15 9:30,830,297,533,-3617
104,2022/7/15 9:40,660,232,428,-3047
104,2022/7/15 9:50,613,177,436,-1719
104,2022/7/15 10:00,456,208,248,-1145
104,2022/7/15 10:10,461,179,282,-870
104,2022/7/15 10:20,310,198,112,-656
104,2022/7/15 10:30,314,170,144,-901
104,2022/7/15 10:40,311,181,130,-791
104,2022/7/15 10:50,305,227,78,-586
104,2022/7/15 11:00,273,192,81,-825
104,2022/7/15 11:10,289,223,66,-870
104,2022/7/15 11:20,270,145,125,-643
104,2022/7/15 11:30,270,180,90,-730
104,2022/7/15 11:40,268,192,76,-452
104,2022/7/15 11:50,285,193,92,-576
104,2022/7/15 12:00,311,223,88,-371
104,2022/7/15 12:10,333,185,148,-175
104,2022/7/15 12:20,333,196,137,-249
104,2022/7/15 12:30,325,222,103,-389
104,2022/7/15 12:40,376,234,142,-461
104,2022/7/15 12:50,312,225,87,-655
104,2022/7/15 13:00,332,233,99,-501
104,2022/7/15 13:10,332,213,119,-498
104,2022/7/15 13:20,288,208,80,-641
104,2022/7/15 13:30,265,180,85,-578
104,2022/7/15 13:40,271,254,17,-394
104,2022/7/15 13:50,267,178,89,-512
104,2022/7/15 14:00,270,254,16,-460
104,2022/7/15 14:10,261,207,54,-264
104,2022/7/15 14:20,274,297,-23,-487
104,2022/7/15 14:30,267,206,61,-127
104,2022/7/15 14:40,265,325,-60,-215
104,2022/7/15 14:50,270,217,53,-143
104,2022/7/15 15:00,272,322,-50,-108
104,2022/7/15 15:10,315,290,25,349
104,2022/7/15 15:20,264,379,-115,-27
104,2022/7/15 15:30,268,317,-49,220
104,2022/7/15 15:40,287,364,-77,318
104,2022/7/15 15:50,262,421,-159,354
104,2022/7/15 16:00,332,427,-95,578
104,2022/7/15 16:10,346,310,36,1197
104,2022/7/15 16:20,326,408,-82,776
104,2022/7/15 16:30,430,410,20,1688
104,2022/7/15 16:40,421,408,13,2198
104,2022/7/15 16:50,587,414,173,2534
104,2022/7/15 17:00,617,552,65,4302
104,2022/7/15 17:10,697,550,147,7744
104,2022/7/15 17:20,696,1413,-717,4470
104,2022/7/15 17:30,679,1474,-795,4350
104,2022/7/15 17:40,709,1640,-931,8623
104,2022/7/15 17:50,652,1627,-975,3181
104,2022/7/15 18:00,639,2051,-1412,3319
104,2022/7/15 18:10,712,2436,-1724,5647
104,2022/7/15 18:20,617,2441,-1824,2436
104,2022/7/15 18:30,609,2387,-1778,-599
104,2022/7/15 18:40,457,2621,-2164,-4880
104,2022/7/15 18:50,335,2167,-1832,-3688
104,2022/7/15 19:00,264,1980,-1716,-3268
104,2022/7/15 19:10,227,2106,-1879,-4169
104,2022/7/15 19:20,192,1101,-909,-1808
104,2022/7/15 19:30,182,556,-374,-1058
104,2022/7/15 19:40,159,454,-295,-992
104,2022/7/15 19:50,168,399,-231,-661
104,2022/7/15 20:00,139,417,-278,-265
104,2022/7/15 20:10,169,430,-261,-182
104,2022/7/15 20:20,146,340,-194,-295
104,2022/7/15 20:30,128,340,-212,23
104,2022/7/15 20:40,160,320,-160,224
104,2022/7/15 20:50,140,506,-366,-314
104,2022/7/15 21:00,127,338,-211,590
104,2022/7/15 21:10,151,326,-175,599
104,2022/7/15 21:20,132,263,-131,-30
104,2022/7/15 21:30,225,196,29,385
104,2022/7/15 21:40,132,316,-184,-116
104,2022/7/15 21:50,44,314,-270,-530
104,2022/7/15 22:00,45,238,-193,1219
104,2022/7/15 22:10,35,288,-253,194
104,2022/7/15 22:20,28,319,-291,-1096
104,2022/7/15 22:30,12,202,-190,-1790
104,2022/7/15 22:40,2,217,-215,-1901
104,2022/7/15 22:50,2,136,-134,-1722
114,2022/7/15 5:00,0,1,-1,15
114,2022/7/15 5:10,3,1,2,140
114,2022/7/15 5:20,12,1,11,275
114,2022/7/15 5:30,13,1,12,432
114,2022/7/15 5:40,19,1,18,489
114,2022/7/15 5:50,25,1,24,505
114,2022/7/15 6:00,32,22,10,548
114,2022/7/15 6:10,48,14,34,934
114,2022/7/15 6:20,76,23,53,1532
114,2022/7/15 6:30,128,38,90,2815
114,2022/7/15 6:40,186,64,122,3364
114,2022/7/15 6:50,245,69,176,4760
114,2022/7/15 7:00,302,97,205,5523
114,2022/7/15 7:10,474,98,376,7901
114,2022/7/15 7:20,661,127,534,10620
114,2022/7/15 7:30,820,146,674,12993
114,2022/7/15 7:40,1062,109,953,15298
114,2022/7/15 7:50,1374,104,1270,15494
114,2022/7/15 8:00,1371,110,1261,12840
114,2022/7/15 8:10,1173,113,1060,3307
114,2022/7/15 8:20,874,97,777,-3318
114,2022/7/15 8:30,818,104,714,-7283
114,2022/7/15 8:40,661,95,566,-17755
114,2022/7/15 8:50,570,83,487,-16872
114,2022/7/15 9:00,354,85,269,-12811
114,2022/7/15 9:10,278,72,206,-9670
114,2022/7/15 9:20,207,76,131,-6925
114,2022/7/15 9:30,141,71,70,-3547
114,2022/7/15 9:40,90,69,21,-3026
114,2022/7/15 9:50,71,66,5,-1714
114,2022/7/15 10:00,59,72,-13,-1158
114,2022/7/15 10:10,49,67,-18,-888
114,2022/7/15 10:20,43,63,-20,-676
114,2022/7/15 10:30,46,61,-15,-916
114,2022/7/15 10:40,36,69,-33,-824
114,2022/7/15 10:50,36,66,-30,-616
114,2022/7/15 11:00,29,72,-43,-868
114,2022/7/15 11:10,31,68,-37,-907
114,2022/7/15 11:20,36,62,-26,-669
114,2022/7/15 11:30,35,62,-27,-757
114,2022/7/15 11:40,36,67,-31,-483
114,2022/7/15 11:50,34,68,-34,-610
114,2022/7/15 12:00,42,63,-21,-392
114,2022/7/15 12:10,42,74,-32,-207
114,2022/7/15 12:20,36,66,-30,-279
114,2022/7/15 12:30,43,84,-41,-430
114,2022/7/15 12:40,37,60,-23,-484
114,2022/7/15 12:50,34,85,-51,-706
114,2022/7/15 13:00,39,77,-38,-539
114,2022/7/15 13:10,33,76,-43,-541
114,2022/7/15 13:20,28,65,-37,-678
114,2022/7/15 13:30,30,78,-48,-626
114,2022/7/15 13:40,32,85,-53,-447
114,2022/7/15 13:50,30,75,-45,-557
114,2022/7/15 14:00,27,80,-53,-513
114,2022/7/15 14:10,26,75,-49,-313
114,2022/7/15 14:20,48,93,-45,-532
114,2022/7/15 14:30,43,90,-47,-174
114,2022/7/15 14:40,31,77,-46,-261
114,2022/7/15 14:50,24,90,-66,-209
114,2022/7/15 15:00,31,90,-59,-167
114,2022/7/15 15:10,38,103,-65,284
114,2022/7/15 15:20,38,102,-64,-91
114,2022/7/15 15:30,35,110,-75,145
114,2022/7/15 15:40,28,103,-75,243
114,2022/7/15 15:50,26,106,-80,274
114,2022/7/15 16:00,45,105,-60,518
114,2022/7/15 16:10,46,117,-71,1126
114,2022/7/15 16:20,37,122,-85,691
114,2022/7/15 16:30,31,121,-90,1598
114,2022/7/15 16:40,38,133,-95,2103
114,2022/7/15 16:50,47,132,-85,2449
114,2022/7/15 17:00,56,115,-59,4243
114,2022/7/15 17:10,65,195,-130,7614
114,2022/7/15 17:20,46,175,-129,4341
114,2022/7/15 17:30,45,204,-159,4191
114,2022/7/15 17:40,58,339,-281,8342
114,2022/7/15 17:50,45,340,-295,2886
114,2022/7/15 18:00,60,426,-366,2953
114,2022/7/15 18:10,58,427,-369,5278
114,2022/7/15 18:20,48,421,-373,2063
114,2022/7/15 18:30,38,495,-457,-1056
114,2022/7/15 18:40,35,534,-499,-5379
114,2022/7/15 18:50,29,440,-411,-4099
114,2022/7/15 19:00,26,430,-404,-3672
114,2022/7/15 19:10,23,318,-295,-4464
114,2022/7/15 19:20,29,234,-205,-2013
114,2022/7/15 19:30,25,179,-154,-1212
114,2022/7/15 19:40,23,142,-119,-1111
114,2022/7/15 19:50,21,115,-94,-755
114,2022/7/15 20:00,20,111,-91,-356
114,2022/7/15 20:10,18,125,-107,-289
114,2022/7/15 20:20,22,118,-96,-391
114,2022/7/15 20:30,17,126,-109,-86
114,2022/7/15 20:40,20,121,-101,123
114,2022/7/15 20:50,14,103,-89,-403
114,2022/7/15 21:00,16,105,-89,501
114,2022/7/15 21:10,15,103,-88,511
114,2022/7/15 21:20,18,106,-88,-118
114,2022/7/15 21:30,14,126,-112,273
114,2022/7/15 21:40,13,124,-111,-227
114,2022/7/15 21:50,13,106,-93,-623
114,2022/7/15 22:00,11,106,-95,1124
114,2022/7/15 22:10,8,110,-102,92
114,2022/7/15 22:20,4,97,-93,-1189
114,2022/7/15 22:30,1,89,-88,-1878
114,2022/7/15 22:40,0,77,-77,-1978
114,2022/7/15 22:50,1,62,-61,-1783
112,2022/7/15 5:00,5,1,4,19
112,2022/7/15 5:10,24,1,23,163
112,2022/7/15 5:20,45,1,44,319
112,2022/7/15 5:30,34,2,32,464
112,2022/7/15 5:40,57,1,56,545
112,2022/7/15 5:50,109,1,108,613
112,2022/7/15 6:00,173,67,106,654
112,2022/7/15 6:10,390,56,334,1268
112,2022/7/15 6:20,598,111,487,2019
112,2022/7/15 6:30,742,108,634,3449
112,2022/7/15 6:40,1401,191,1210,4574
112,2022/7/15 6:50,1399,340,1059,5819
112,2022/7/15 7:00,1993,429,1564,7087
112,2022/7/15 7:10,3074,430,2644,10545
112,2022/7/15 7:20,3335,415,2920,13540
112,2022/7/15 7:30,3430,568,2862,15855
112,2022/7/15 7:40,3426,1130,2296,17594
112,2022/7/15 7:50,3540,1121,2419,17913
112,2022/7/15 8:00,3462,1514,1948,14788
112,2022/7/15 8:10,3429,1467,1962,5269
112,2022/7/15 8:20,3357,1498,1859,-1459
112,2022/7/15 8:30,3407,1711,1696,-5587
112,2022/7/15 8:40,3092,1435,1657,-16098
112,2022/7/15 8:50,2550,552,1998,-14874
112,2022/7/15 9:00,1976,426,1550,-11261
112,2022/7/15 9:10,1709,433,1276,-8394
112,2022/7/15 9:20,1347,490,857,-6068
112,2022/7/15 9:30,1151,516,635,-2912
112,2022/7/15 9:40,811,316,495,-2531
112,2022/7/15 9:50,672,343,329,-1385
112,2022/7/15 10:00,701,320,381,-777
112,2022/7/15 10:10,608,221,387,-501
112,2022/7/15 10:20,577,333,244,-432
112,2022/7/15 10:30,551,312,239,-677
112,2022/7/15 10:40,377,268,109,-715
112,2022/7/15 10:50,455,221,234,-382
112,2022/7/15 11:00,325,266,59,-809
112,2022/7/15 11:10,309,318,-9,-916
112,2022/7/15 11:20,372,297,75,-594
112,2022/7/15 11:30,332,297,35,-722
112,2022/7/15 11:40,336,332,4,-479
112,2022/7/15 11:50,366,318,48,-562
112,2022/7/15 12:00,462,290,172,-220
112,2022/7/15 12:10,544,317,227,20
112,2022/7/15 12:20,576,326,250,-29
112,2022/7/15 12:30,580,327,253,-177
112,2022/7/15 12:40,576,341,235,-249
112,2022/7/15 12:50,426,339,87,-619
112,2022/7/15 13:00,563,309,254,-285
112,2022/7/15 13:10,421,427,-6,-547
112,2022/7/15 13:20,455,288,167,-511
112,2022/7/15 13:30,367,378,-11,-637
112,2022/7/15 13:40,308,320,-12,-459
112,2022/7/15 13:50,308,357,-49,-606
112,2022/7/15 14:00,308,318,-10,-523
112,2022/7/15 14:10,327,376,-49,-362
112,2022/7/15 14:20,309,325,-16,-548
112,2022/7/15 14:30,335,432,-97,-271
112,2022/7/15 14:40,333,430,-97,-358
112,2022/7/15 14:50,334,377,-43,-252
112,2022/7/15 15:00,345,364,-19,-186
112,2022/7/15 15:10,327,417,-90,194
112,2022/7/15 15:20,339,337,2,-89
112,2022/7/15 15:30,326,428,-102,43
112,2022/7/15 15:40,308,486,-178,65
112,2022/7/15 15:50,371,427,-56,218
112,2022/7/15 16:00,313,419,-106,412
112,2022/7/15 16:10,457,472,-15,1111
112,2022/7/15 16:20,580,413,167,858
112,2022/7/15 16:30,623,582,41,1639
112,2022/7/15 16:40,635,570,65,2168
112,2022/7/15 16:50,673,1140,-467,1982
112,2022/7/15 17:00,804,1081,-277,3966
112,2022/7/15 17:10,1157,1696,-539,7075
112,2022/7/15 17:20,1034,1730,-696,3645
112,2022/7/15 17:30,1158,1683,-525,3666
112,2022/7/15 17:40,1369,2409,-1040,7302
112,2022/7/15 17:50,1396,2295,-899,1987
112,2022/7/15 18:00,1160,3869,-2709,244
112,2022/7/15 18:10,1215,1746,-531,4747
112,2022/7/15 18:20,1025,3586,-2561,-498
112,2022/7/15 18:30,812,4338,-3526,-4582
112,2022/7/15 18:40,672,2859,-2187,-7566
112,2022/7/15 18:50,607,5038,-4431,-8530
112,2022/7/15 19:00,455,4584,-4129,-7801
112,2022/7/15 19:10,345,2076,-1731,-6195
112,2022/7/15 19:20,303,2359,-2056,-4069
112,2022/7/15 19:30,269,1824,-1555,-2767
112,2022/7/15 19:40,263,1572,-1309,-2420
112,2022/7/15 19:50,225,593,-368,-1123
112,2022/7/15 20:00,217,574,-357,-713
112,2022/7/15 20:10,263,424,-161,-450
112,2022/7/15 20:20,273,378,-105,-496
112,2022/7/15 20:30,235,485,-250,-336
112,2022/7/15 20:40,230,425,-195,-72
112,2022/7/15 20:50,267,427,-160,-563
112,2022/7/15 21:00,228,502,-274,227
112,2022/7/15 21:10,275,519,-244,267
112,2022/7/15 21:20,229,504,-275,-393
112,2022/7/15 21:30,198,360,-162,111
112,2022/7/15 21:40,190,416,-226,-453
112,2022/7/15 21:50,143,495,-352,-975
112,2022/7/15 22:00,138,371,-233,891
112,2022/7/15 22:10,183,339,-156,-64
112,2022/7/15 22:20,33,323,-290,-1479
112,2022/7/15 22:30,2,431,-429,-2307
112,2022/7/15 22:40,2,374,-372,-2350
112,2022/7/15 22:50,2,297,-295,-2078
106,2022/7/15 5:00,1,1,0,19
106,2022/7/15 5:10,6,6,0,163
106,2022/7/15 5:20,16,1,15,334
106,2022/7/15 5:30,14,17,-3,461
106,2022/7/15 5:40,20,29,-9,536
106,2022/7/15 5:50,29,23,6,619
106,2022/7/15 6:00,32,113,-81,573
106,2022/7/15 6:10,37,112,-75,1193
106,2022/7/15 6:20,37,117,-80,1939
106,2022/7/15 6:30,39,102,-63,3386
106,2022/7/15 6:40,52,121,-69,4505
106,2022/7/15 6:50,75,121,-46,5773
106,2022/7/15 7:00,69,224,-155,6932
106,2022/7/15 7:10,80,267,-187,10358
106,2022/7/15 7:20,85,345,-260,13280
106,2022/7/15 7:30,150,509,-359,15496
106,2022/7/15 7:40,146,436,-290,17304
106,2022/7/15 7:50,195,578,-383,17530
106,2022/7/15 8:00,230,1792,-1562,13226
106,2022/7/15 8:10,232,2954,-2722,2547
106,2022/7/15 8:20,226,2619,-2393,-3852
106,2022/7/15 8:30,231,4745,-4514,-10101
106,2022/7/15 8:40,192,6335,-6143,-22241
106,2022/7/15 8:50,202,5623,-5421,-20295
106,2022/7/15 9:00,185,4993,-4808,-16069
106,2022/7/15 9:10,188,2869,-2681,-11075
106,2022/7/15 9:20,169,1712,-1543,-7611
106,2022/7/15 9:30,156,563,-407,-3319
106,2022/7/15 9:40,155,553,-398,-2929
106,2022/7/15 9:50,147,417,-270,-1655
106,2022/7/15 10:00,160,531,-371,-1148
106,2022/7/15 10:10,153,318,-165,-666
106,2022/7/15 10:20,175,332,-157,-589
106,2022/7/15 10:30,183,332,-149,-826
106,2022/7/15 10:40,181,331,-150,-865
106,2022/7/15 10:50,211,298,-87,-469
106,2022/7/15 11:00,216,232,-16,-825
106,2022/7/15 11:10,215,254,-39,-955
106,2022/7/15 11:20,218,254,-36,-630
106,2022/7/15 11:30,218,233,-15,-737
106,2022/7/15 11:40,266,255,11,-468
106,2022/7/15 11:50,262,269,-7,-569
106,2022/7/15 12:00,263,195,68,-152
106,2022/7/15 12:10,267,217,50,70
106,2022/7/15 12:20,300,255,45,16
106,2022/7/15 12:30,346,268,78,-99
106,2022/7/15 12:40,343,299,44,-205
106,2022/7/15 12:50,333,299,34,-585
106,2022/7/15 13:00,367,283,84,-201
106,2022/7/15 13:10,367,318,49,-498
106,2022/7/15 13:20,454,318,136,-375
106,2022/7/15 13:30,457,298,159,-478
106,2022/7/15 13:40,422,298,124,-335
106,2022/7/15 13:50,456,299,157,-449
106,2022/7/15 14:00,545,267,278,-245
106,2022/7/15 14:10,549,232,317,-45
106,2022/7/15 14:20,574,232,342,-206
106,2022/7/15 14:30,558,197,361,90
106,2022/7/15 14:40,580,207,373,15
106,2022/7/15 14:50,570,232,338,86
106,2022/7/15 15:00,573,223,350,164
106,2022/7/15 15:10,591,223,368,562
106,2022/7/15 15:20,587,233,354,265
106,2022/7/15 15:30,639,226,413,456
106,2022/7/15 15:40,637,226,411,476
106,2022/7/15 15:50,596,214,382,600
106,2022/7/15 16:00,638,225,413,825
106,2022/7/15 16:10,640,223,417,1528
106,2022/7/15 16:20,686,208,478,1336
106,2022/7/15 16:30,635,198,437,2076
106,2022/7/15 16:40,708,226,482,2650
106,2022/7/15 16:50,705,233,472,2454
106,2022/7/15 17:00,1145,265,880,4846
106,2022/7/15 17:10,1576,294,1282,8357
106,2022/7/15 17:20,1377,336,1041,4686
106,2022/7/15 17:30,1967,363,1604,5270
106,2022/7/15 17:40,3043,363,2680,9982
106,2022/7/15 17:50,1988,494,1494,3481
106,2022/7/15 18:00,1966,414,1552,1796
106,2022/7/15 18:10,3308,411,2897,7644
106,2022/7/15 18:20,3001,418,2583,2085
106,2022/7/15 18:30,1609,417,1192,-3390
106,2022/7/15 18:40,1360,424,936,-6630
106,2022/7/15 18:50,1140,459,681,-7849
106,2022/7/15 19:00,1034,321,713,-7088
106,2022/7/15 19:10,833,212,621,-5574
106,2022/7/15 19:20,711,180,531,-3538
106,2022/7/15 19:30,658,150,508,-2259
106,2022/7/15 19:40,645,116,529,-1891
106,2022/7/15 19:50,627,111,516,-607
106,2022/7/15 20:00,645,105,540,-173
106,2022/7/15 20:10,726,108,618,168
106,2022/7/15 20:20,637,106,531,35
106,2022/7/15 20:30,658,85,573,237
106,2022/7/15 20:40,726,104,622,550
106,2022/7/15 20:50,721,99,622,59
106,2022/7/15 21:00,817,104,713,940
106,2022/7/15 21:10,840,97,743,1010
106,2022/7/15 21:20,723,97,626,233
106,2022/7/15 21:30,679,102,577,688
106,2022/7/15 21:40,673,88,585,132
106,2022/7/15 21:50,642,95,547,-428
106,2022/7/15 22:00,1404,92,1312,2203
106,2022/7/15 22:10,1248,94,1154,1090
106,2022/7/15 22:20,238,89,149,-1330
106,2022/7/15 22:30,124,79,45,-2262
106,2022/7/15 22:40,60,83,-23,-2373
106,2022/7/15 22:50,26,72,-46,-2124
116,2022/7/15 5:00,1,1,0,19
116,2022/7/15 5:10,6,6,0,163
116,2022/7/15 5:20,7,5,2,336
116,2022/7/15 5:30,11,2,9,470
116,2022/7/15 5:40,16,5,11,547
116,2022/7/15 5:50,19,6,13,632
116,2022/7/15 6:00,26,42,-16,557
116,2022/7/15 6:10,30,47,-17,1176
116,2022/7/15 6:20,31,38,-7,1932
116,2022/7/15 6:30,40,65,-25,3361
116,2022/7/15 6:40,49,62,-13,4492
116,2022/7/15 6:50,57,93,-36,5737
116,2022/7/15 7:00,67,106,-39,6893
116,2022/7/15 7:10,70,107,-37,10321
116,2022/7/15 7:20,86,119,-33,13247
116,2022/7/15 7:30,84,126,-42,15454
116,2022/7/15 7:40,104,147,-43,17261
116,2022/7/15 7:50,162,197,-35,17495
116,2022/7/15 8:00,183,296,-113,13113
116,2022/7/15 8:10,204,431,-227,2320
116,2022/7/15 8:20,199,432,-233,-4085
116,2022/7/15 8:30,188,431,-243,-10344
116,2022/7/15 8:40,179,578,-399,-22640
116,2022/7/15 8:50,155,425,-270,-20565
116,2022/7/15 9:00,136,502,-366,-16435
116,2022/7/15 9:10,105,317,-212,-11287
116,2022/7/15 9:20,79,266,-187,-7798
116,2022/7/15 9:30,74,178,-104,-3423
116,2022/7/15 9:40,62,149,-87,-3016
116,2022/7/15 9:50,59,116,-57,-1712
116,2022/7/15 10:00,48,117,-69,-1217
116,2022/7/15 10:10,45,110,-65,-731
116,2022/7/15 10:20,49,113,-64,-653
116,2022/7/15 10:30,47,106,-59,-885
116,2022/7/15 10:40,45,108,-63,-928
116,2022/7/15 10:50,42,91,-49,-518
116,2022/7/15 11:00,40,96,-56,-881
116,2022/7/15 11:10,41,87,-46,-1001
116,2022/7/15 11:20,41,90,-49,-679
116,2022/7/15 11:30,43,77,-34,-771
116,2022/7/15 11:40,43,93,-50,-518
116,2022/7/15 11:50,40,81,-41,-610
116,2022/7/15 12:00,45,74,-29,-181
116,2022/7/15 12:10,48,90,-42,28
116,2022/7/15 12:20,45,105,-60,-44
116,2022/7/15 12:30,45,98,-53,-152
116,2022/7/15 12:40,47,90,-43,-248
116,2022/7/15 12:50,43,109,-66,-651
116,2022/7/15 13:00,45,98,-53,-254
116,2022/7/15 13:10,48,108,-60,-558
116,2022/7/15 13:20,44,103,-59,-434
116,2022/7/15 13:30,45,93,-48,-526
116,2022/7/15 13:40,44,109,-65,-400
116,2022/7/15 13:50,44,90,-46,-495
116,2022/7/15 14:00,48,91,-43,-288
116,2022/7/15 14:10,50,96,-46,-91
116,2022/7/15 14:20,49,88,-39,-245
116,2022/7/15 14:30,42,99,-57,33
116,2022/7/15 14:40,48,82,-34,-19
116,2022/7/15 14:50,45,93,-48,38
116,2022/7/15 15:00,69,86,-17,147
116,2022/7/15 15:10,61,93,-32,530
116,2022/7/15 15:20,66,91,-25,240
116,2022/7/15 15:30,61,97,-36,420
116,2022/7/15 15:40,65,93,-28,448
116,2022/7/15 15:50,69,101,-32,568
116,2022/7/15 16:00,83,88,-5,820
116,2022/7/15 16:10,128,96,32,1560
116,2022/7/15 16:20,131,93,38,1374
116,2022/7/15 16:30,147,109,38,2114
116,2022/7/15 16:40,169,96,73,2723
116,2022/7/15 16:50,190,109,81,2535
116,2022/7/15 17:00,273,105,168,5014
116,2022/7/15 17:10,269,112,157,8514
116,2022/7/15 17:20,272,121,151,4837
116,2022/7/15 17:30,425,100,325,5595
116,2022/7/15 17:40,575,112,463,10445
116,2022/7/15 17:50,311,106,205,3686
116,2022/7/15 18:00,327,124,203,1999
116,2022/7/15 18:10,550,123,427,8071
116,2022/7/15 18:20,336,128,208,2293
116,2022/7/15 18:30,275,107,168,-3222
116,2022/7/15 18:40,214,111,103,-6527
116,2022/7/15 18:50,170,113,57,-7792
116,2022/7/15 19:00,132,109,23,-7065
116,2022/7/15 19:10,105,107,-2,-5576
116,2022/7/15 19:20,70,102,-32,-3570
116,2022/7/15 19:30,55,99,-44,-2303
116,2022/7/15 19:40,50,81,-31,-1922
116,2022/7/15 19:50,40,86,-46,-653
116,2022/7/15 20:00,41,76,-35,-208
116,2022/7/15 20:10,42,77,-35,133
116,2022/7/15 20:20,40,83,-43,-8
116,2022/7/15 20:30,43,83,-40,197
116,2022/7/15 20:40,34,78,-44,506
116,2022/7/15 20:50,34,79,-45,14
116,2022/7/15 21:00,42,73,-31,909
116,2022/7/15 21:10,40,77,-37,973
116,2022/7/15 21:20,37,74,-37,196
116,2022/7/15 21:30,31,79,-48,640
116,2022/7/15 21:40,27,93,-66,66
116,2022/7/15 21:50,27,69,-42,-470
116,2022/7/15 22:00,25,77,-52,2151
116,2022/7/15 22:10,27,78,-51,1039
116,2022/7/15 22:20,23,100,-77,-1407
116,2022/7/15 22:30,17,78,-61,-2323
116,2022/7/15 22:40,15,75,-60,-2433
116,2022/7/15 22:50,10,68,-58,-2182
145,2022/7/15 5:00,2,1,1,1
145,2022/7/15 5:10,15,1,14,14
145,2022/7/15 5:20,32,1,31,31
145,2022/7/15 5:30,36,1,35,35
145,2022/7/15 5:40,44,1,43,43
145,2022/7/15 5:50,51,1,50,50
145,2022/7/15 6:00,142,5,137,137
145,2022/7/15 6:10,128,66,62,62
145,2022/7/15 6:20,246,57,189,189
145,2022/7/15 6:30,301,62,239,239
145,2022/7/15 6:40,385,105,280,280
145,2022/7/15 6:50,652,92,560,560
145,2022/7/15 7:00,681,121,560,560
145,2022/7/15 7:10,1201,128,1073,1073
145,2022/7/15 7:20,1357,136,1221,1221
145,2022/7/15 7:30,1968,178,1790,1790
145,2022/7/15 7:40,1982,268,1714,1714
145,2022/7/15 7:50,2049,305,1744,1744
145,2022/7/15 8:00,2554,418,2136,2136
145,2022/7/15 8:10,2551,287,2264,2264
145,2022/7/15 8:20,1979,383,1596,1596
145,2022/7/15 8:30,1406,417,989,989
145,2022/7/15 8:40,1019,262,757,757
145,2022/7/15 8:50,679,460,219,219
145,2022/7/15 9:00,694,309,385,385
145,2022/7/15 9:10,481,278,203,203
145,2022/7/15 9:20,314,260,54,54
145,2022/7/15 9:30,293,314,-21,-21
145,2022/7/15 9:40,271,265,6,6
145,2022/7/15 9:50,218,173,45,45
145,2022/7/15 10:00,225,213,12,12
145,2022/7/15 10:10,211,178,33,33
145,2022/7/15 10:20,215,172,43,43
145,2022/7/15 10:30,213,214,-1,-1
145,2022/7/15 10:40,159,118,41,41
145,2022/7/15 10:50,201,168,33,33
145,2022/7/15 11:00,135,110,25,25
145,2022/7/15 11:10,217,108,109,109
145,2022/7/15 11:20,180,169,11,11
145,2022/7/15 11:30,171,118,53,53
145,2022/7/15 11:40,186,124,62,62
145,2022/7/15 11:50,229,120,109,109
145,2022/7/15 12:00,231,139,92,92
145,2022/7/15 12:10,183,104,79,79
145,2022/7/15 12:20,262,124,138,138
145,2022/7/15 12:30,265,115,150,150
145,2022/7/15 12:40,231,180,51,51
145,2022/7/15 12:50,247,111,136,136
145,2022/7/15 13:00,197,110,87,87
145,2022/7/15 13:10,248,126,122,122
145,2022/7/15 13:20,181,158,23,23
145,2022/7/15 13:30,266,129,137,137
145,2022/7/15 13:40,142,120,22,22
145,2022/7/15 13:50,164,142,22,22
145,2022/7/15 14:00,128,193,-65,-65
145,2022/7/15 14:10,137,119,18,18
145,2022/7/15 14:20,177,108,69,69
145,2022/7/15 14:30,143,154,-11,-11
145,2022/7/15 14:40,121,193,-72,-72
145,2022/7/15 14:50,203,109,94,94
145,2022/7/15 15:00,118,110,8,8
145,2022/7/15 15:10,166,233,-67,-67
145,2022/7/15 15:20,176,159,17,17
145,2022/7/15 15:30,175,181,-6,-6
145,2022/7/15 15:40,163,151,12,12
145,2022/7/15 15:50,163,223,-60,-60
145,2022/7/15 16:00,158,224,-66,-66
145,2022/7/15 16:10,188,217,-29,-29
145,2022/7/15 16:20,188,216,-28,-28
145,2022/7/15 16:30,255,206,49,49
145,2022/7/15 16:40,272,268,4,4
145,2022/7/15 16:50,317,283,34,34
145,2022/7/15 17:00,261,204,57,57
145,2022/7/15 17:10,336,228,108,108
145,2022/7/15 17:20,442,214,228,228
145,2022/7/15 17:30,443,429,14,14
145,2022/7/15 17:40,301,281,20,20
145,2022/7/15 17:50,327,486,-159,-159
145,2022/7/15 18:00,308,484,-176,-176
145,2022/7/15 18:10,308,419,-111,-111
145,2022/7/15 18:20,227,2058,-1831,-1831
145,2022/7/15 18:30,192,416,-224,-224
145,2022/7/15 18:40,162,1957,-1795,-1795
145,2022/7/15 18:50,109,1583,-1474,-1474
145,2022/7/15 19:00,65,1570,-1505,-1505
145,2022/7/15 19:10,57,600,-543,-543
145,2022/7/15 19:20,62,476,-414,-414
145,2022/7/15 19:30,45,406,-361,-361
145,2022/7/15 19:40,37,300,-263,-263
145,2022/7/15 19:50,41,466,-425,-425
145,2022/7/15 20:00,35,232,-197,-197
145,2022/7/15 20:10,39,528,-489,-489
145,2022/7/15 20:20,37,197,-160,-160
145,2022/7/15 20:30,28,336,-308,-308
145,2022/7/15 20:40,38,271,-233,-233
145,2022/7/15 20:50,35,189,-154,-154
145,2022/7/15 21:00,27,218,-191,-191
145,2022/7/15 21:10,35,382,-347,-347
145,2022/7/15 21:20,28,196,-168,-168
145,2022/7/15 21:30,24,226,-202,-202
145,2022/7/15 21:40,25,198,-173,-173
145,2022/7/15 21:50,23,207,-184,-184
145,2022/7/15 22:00,21,149,-128,-128
145,2022/7/15 22:10,14,132,-118,-118
145,2022/7/15 22:20,17,184,-167,-167
145,2022/7/15 22:30,11,224,-213,-213
145,2022/7/15 22:40,4,105,-101,-101
145,2022/7/15 22:50,1,119,-118,-118
128,2022/7/15 5:00,0,1,-1,0
128,2022/7/15 5:10,4,1,3,17
128,2022/7/15 5:20,4,1,3,34
128,2022/7/15 5:30,6,21,-15,20
128,2022/7/15 5:40,14,15,-1,42
128,2022/7/15 5:50,13,23,-10,40
128,2022/7/15 6:00,24,106,-82,55
128,2022/7/15 6:10,21,103,-82,-20
128,2022/7/15 6:20,31,259,-228,-39
128,2022/7/15 6:30,39,378,-339,-100
128,2022/7/15 6:40,45,491,-446,-166
128,2022/7/15 6:50,59,490,-431,129
128,2022/7/15 7:00,82,410,-328,232
128,2022/7/15 7:10,182,516,-334,739
128,2022/7/15 7:20,196,411,-215,1006
128,2022/7/15 7:30,250,590,-340,1450
128,2022/7/15 7:40,302,1136,-834,880
128,2022/7/15 7:50,449,1123,-674,1070
128,2022/7/15 8:00,367,560,-193,1943
128,2022/7/15 8:10,650,1428,-778,1486
128,2022/7/15 8:20,915,1475,-560,1036
128,2022/7/15 8:30,347,1029,-682,307
128,2022/7/15 8:40,616,1478,-862,-105
128,2022/7/15 8:50,281,551,-270,-51
128,2022/7/15 9:00,280,568,-288,97
128,2022/7/15 9:10,587,466,121,324
128,2022/7/15 9:20,270,558,-288,-234
128,2022/7/15 9:30,364,465,-101,-122
128,2022/7/15 9:40,211,411,-200,-194
128,2022/7/15 9:50,83,395,-312,-267
128,2022/7/15 10:00,68,420,-352,-340
128,2022/7/15 10:10,272,476,-204,-171
128,2022/7/15 10:20,203,315,-112,-69
128,2022/7/15 10:30,206,460,-254,-255
128,2022/7/15 10:40,270,324,-54,-13
128,2022/7/15 10:50,184,271,-87,-54
128,2022/7/15 11:00,160,323,-163,-138
128,2022/7/15 11:10,170,272,-102,7
128,2022/7/15 11:20,255,240,15,26
128,2022/7/15 11:30,195,212,-17,36
128,2022/7/15 11:40,230,276,-46,16
128,2022/7/15 11:50,200,288,-88,21
128,2022/7/15 12:00,160,232,-72,20
128,2022/7/15 12:10,130,172,-42,37
128,2022/7/15 12:20,195,297,-102,36
128,2022/7/15 12:30,143,319,-176,-26
128,2022/7/15 12:40,265,290,-25,26
128,2022/7/15 12:50,238,280,-42,94
128,2022/7/15 13:00,256,469,-213,-126
128,2022/7/15 13:10,607,437,170,292
128,2022/7/15 13:20,336,475,-139,-116
128,2022/7/15 13:30,621,295,326,463
128,2022/7/15 13:40,336,360,-24,-2
128,2022/7/15 13:50,636,367,269,291
128,2022/7/15 14:00,339,311,28,-37
128,2022/7/15 14:10,367,290,77,95
128,2022/7/15 14:20,456,465,-9,60
128,2022/7/15 14:30,589,351,238,227
128,2022/7/15 14:40,564,328,236,164
128,2022/7/15 14:50,455,290,165,259
128,2022/7/15 15:00,679,472,207,215
128,2022/7/15 15:10,638,473,165,98
128,2022/7/15 15:20,572,367,205,222
128,2022/7/15 15:30,655,467,188,182
128,2022/7/15 15:40,583,360,223,235
128,2022/7/15 15:50,336,468,-132,-192
128,2022/7/15 16:00,637,287,350,284
128,2022/7/15 16:10,839,456,383,354
128,2022/7/15 16:20,637,288,349,321
128,2022/7/15 16:30,820,456,364,413
128,2022/7/15 16:40,620,309,311,315
128,2022/7/15 16:50,428,315,113,147
128,2022/7/15 17:00,830,331,499,556
128,2022/7/15 17:10,834,284,550,658
128,2022/7/15 17:20,600,364,236,464
128,2022/7/15 17:30,1247,415,832,846
128,2022/7/15 17:40,1415,324,1091,1111
128,2022/7/15 17:50,643,344,299,140
128,2022/7/15 18:00,457,371,86,-90
128,2022/7/15 18:10,697,644,53,-58
128,2022/7/15 18:20,735,418,317,-1514
128,2022/7/15 18:30,611,518,93,-131
128,2022/7/15 18:40,336,734,-398,-2193
128,2022/7/15 18:50,828,376,452,-1022
128,2022/7/15 19:00,1204,371,833,-672
128,2022/7/15 19:10,733,453,280,-263
128,2022/7/15 19:20,649,344,305,-109
128,2022/7/15 19:30,326,269,57,-304
128,2022/7/15 19:40,721,272,449,186
128,2022/7/15 19:50,679,239,440,15
128,2022/7/15 20:00,801,220,581,384
128,2022/7/15 20:10,845,117,728,239
128,2022/7/15 20:20,813,116,697,537
128,2022/7/15 20:30,637,172,465,157
128,2022/7/15 20:40,817,110,707,474
128,2022/7/15 20:50,643,139,504,350
128,2022/7/15 21:00,615,112,503,312
128,2022/7/15 21:10,583,117,466,119
128,2022/7/15 21:20,812,100,712,544
128,2022/7/15 21:30,321,100,221,19
128,2022/7/15 21:40,582,101,481,308
128,2022/7/15 21:50,248,72,176,-8
128,2022/7/15 22:00,193,92,101,-27
128,2022/7/15 22:10,434,92,342,224
128,2022/7/15 22:20,326,88,238,71
128,2022/7/15 22:30,129,74,55,-158
128,2022/7/15 22:40,78,73,5,-96
128,2022/7/15 22:50,56,60,-4,-122
127,2022/7/15 5:00,2,1,1,1
127,2022/7/15 5:10,5,1,4,21
127,2022/7/15 5:20,8,1,7,41
127,2022/7/15 5:30,9,6,3,23
127,2022/7/15 5:40,20,5,15,57
127,2022/7/15 5:50,22,8,14,54
127,2022/7/15 6:00,26,83,-57,-2
127,2022/7/15 6:10,31,69,-38,-58
127,2022/7/15 6:20,29,85,-56,-95
127,2022/7/15 6:30,45,118,-73,-173
127,2022/7/15 6:40,51,101,-50,-216
127,2022/7/15 6:50,68,119,-51,78
127,2022/7/15 7:00,87,105,-18,214
127,2022/7/15 7:10,146,128,18,757
127,2022/7/15 7:20,146,109,37,1043
127,2022/7/15 7:30,185,151,34,1484
127,2022/7/15 7:40,302,159,143,1023
127,2022/7/15 7:50,326,335,-9,1061
127,2022/7/15 8:00,601,510,91,2034
127,2022/7/15 8:10,609,315,294,1780
127,2022/7/15 8:20,475,492,-17,1019
127,2022/7/15 8:30,321,327,-6,301
127,2022/7/15 8:40,327,176,151,46
127,2022/7/15 8:50,276,195,81,30
127,2022/7/15 9:00,203,119,84,181
127,2022/7/15 9:10,201,142,59,383
127,2022/7/15 9:20,179,113,66,-168
127,2022/7/15 9:30,137,109,28,-94
127,2022/7/15 9:40,79,108,-29,-223
127,2022/7/15 9:50,72,108,-36,-303
127,2022/7/15 10:00,54,113,-59,-399
127,2022/7/15 10:10,62,121,-59,-230
127,2022/7/15 10:20,44,121,-77,-146
127,2022/7/15 10:30,51,123,-72,-327
127,2022/7/15 10:40,48,124,-76,-89
127,2022/7/15 10:50,50,119,-69,-123
127,2022/7/15 11:00,54,119,-65,-203
127,2022/7/15 11:10,53,108,-55,-48
127,2022/7/15 11:20,58,110,-52,-26
127,2022/7/15 11:30,63,124,-61,-25
127,2022/7/15 11:40,59,110,-51,-35
127,2022/7/15 11:50,58,107,-49,-28
127,2022/7/15 12:00,70,99,-29,-9
127,2022/7/15 12:10,110,123,-13,24
127,2022/7/15 12:20,86,112,-26,10
127,2022/7/15 12:30,59,106,-47,-73
127,2022/7/15 12:40,59,104,-45,-19
127,2022/7/15 12:50,63,123,-60,34
127,2022/7/15 13:00,55,103,-48,-174
127,2022/7/15 13:10,52,105,-53,239
127,2022/7/15 13:20,52,100,-48,-164
127,2022/7/15 13:30,59,122,-63,400
127,2022/7/15 13:40,55,114,-59,-61
127,2022/7/15 13:50,67,102,-35,256
127,2022/7/15 14:00,53,102,-49,-86
127,2022/7/15 14:10,57,104,-47,48
127,2022/7/15 14:20,56,113,-57,3
127,2022/7/15 14:30,64,99,-35,192
127,2022/7/15 14:40,56,102,-46,118
127,2022/7/15 14:50,50,126,-76,183
127,2022/7/15 15:00,65,100,-35,180
127,2022/7/15 15:10,70,102,-32,66
127,2022/7/15 15:20,64,107,-43,179
127,2022/7/15 15:30,69,101,-32,150
127,2022/7/15 15:40,72,120,-48,187
127,2022/7/15 15:50,87,101,-14,-206
127,2022/7/15 16:00,105,101,4,288
127,2022/7/15 16:10,175,123,52,406
127,2022/7/15 16:20,136,104,32,353
127,2022/7/15 16:30,173,121,52,465
127,2022/7/15 16:40,161,96,65,380
127,2022/7/15 16:50,202,108,94,241
127,2022/7/15 17:00,330,115,215,771
127,2022/7/15 17:10,310,108,202,860
127,2022/7/15 17:20,304,122,182,646
127,2022/7/15 17:30,270,103,167,1013
127,2022/7/15 17:40,273,183,90,1201
127,2022/7/15 17:50,267,196,71,211
127,2022/7/15 18:00,264,235,29,-61
127,2022/7/15 18:10,211,116,95,37
127,2022/7/15 18:20,203,271,-68,-1582
127,2022/7/15 18:30,211,198,13,-118
127,2022/7/15 18:40,177,170,7,-2186
127,2022/7/15 18:50,173,209,-36,-1058
127,2022/7/15 19:00,150,118,32,-640
127,2022/7/15 19:10,137,151,-14,-277
127,2022/7/15 19:20,123,111,12,-97
127,2022/7/15 19:30,120,112,8,-296
127,2022/7/15 19:40,126,103,23,209
127,2022/7/15 19:50,74,112,-38,-23
127,2022/7/15 20:00,96,103,-7,377
127,2022/7/15 20:10,110,77,33,272
127,2022/7/15 20:20,81,103,-22,515
127,2022/7/15 20:30,71,77,-6,151
127,2022/7/15 20:40,57,99,-42,432
127,2022/7/15 20:50,63,71,-8,342
127,2022/7/15 21:00,65,81,-16,296
127,2022/7/15 21:10,57,50,7,126
127,2022/7/15 21:20,47,77,-30,514
127,2022/7/15 21:30,46,79,-33,-14
127,2022/7/15 21:40,43,62,-19,289
127,2022/7/15 21:50,44,71,-27,-35
127,2022/7/15 22:00,42,63,-21,-48
127,2022/7/15 22:10,42,71,-29,195
127,2022/7/15 22:20,34,68,-34,37
127,2022/7/15 22:30,29,66,-37,-195
127,2022/7/15 22:40,23,49,-26,-122
127,2022/7/15 22:50,20,51,-31,-153
142,2022/7/15 5:00,1,1,0,1
142,2022/7/15 5:10,5,1,4,25
142,2022/7/15 5:20,20,1,19,60
142,2022/7/15 5:30,36,1,35,58
142,2022/7/15 5:40,38,6,32,89
142,2022/7/15 5:50,57,25,32,86
142,2022/7/15 6:00,124,21,103,101
142,2022/7/15 6:10,151,47,104,46
142,2022/7/15 6:20,227,62,165,70
142,2022/7/15 6:30,350,99,251,78
142,2022/7/15 6:40,662,113,549,333
142,2022/7/15 6:50,722,93,629,707
142,2022/7/15 7:00,829,100,729,943
142,2022/7/15 7:10,1206,110,1096,1853
142,2022/7/15 7:20,1380,115,1265,2308
142,2022/7/15 7:30,1977,323,1654,3138
142,2022/7/15 7:40,2071,537,1534,2557
142,2022/7/15 7:50,2559,493,2066,3127
142,2022/7/15 8:00,3341,732,2609,4643
142,2022/7/15 8:10,3326,1875,1451,3231
142,2022/7/15 8:20,3237,2194,1043,2062
142,2022/7/15 8:30,1978,6106,-4128,-3827
142,2022/7/15 8:40,1578,6142,-4564,-4518
142,2022/7/15 8:50,1357,4332,-2975,-2945
142,2022/7/15 9:00,1028,1875,-847,-666
142,2022/7/15 9:10,720,1099,-379,4
142,2022/7/15 9:20,649,581,68,-100
142,2022/7/15 9:30,553,427,126,32
142,2022/7/15 9:40,351,515,-164,-387
142,2022/7/15 9:50,276,386,-110,-413
142,2022/7/15 10:00,220,276,-56,-455
142,2022/7/15 10:10,221,197,24,-206
142,2022/7/15 10:20,189,181,8,-138
142,2022/7/15 10:30,212,119,93,-234
142,2022/7/15 10:40,175,116,59,-30
142,2022/7/15 10:50,174,118,56,-67
142,2022/7/15 11:00,174,108,66,-137
142,2022/7/15 11:10,174,122,52,4
142,2022/7/15 11:20,180,105,75,49
142,2022/7/15 11:30,182,116,66,41
142,2022/7/15 11:40,216,109,107,72
142,2022/7/15 11:50,214,118,96,68
142,2022/7/15 12:00,209,108,101,92
142,2022/7/15 12:10,272,114,158,182
142,2022/7/15 12:20,199,116,83,93
142,2022/7/15 12:30,214,110,104,31
142,2022/7/15 12:40,209,150,59,40
142,2022/7/15 12:50,205,128,77,111
142,2022/7/15 13:00,197,184,13,-161
142,2022/7/15 13:10,196,130,66,305
142,2022/7/15 13:20,174,184,-10,-174
142,2022/7/15 13:30,174,117,57,457
142,2022/7/15 13:40,150,184,-34,-95
142,2022/7/15 13:50,148,126,22,278
142,2022/7/15 14:00,114,152,-38,-124
142,2022/7/15 14:10,173,122,51,99
142,2022/7/15 14:20,143,146,-3,0
142,2022/7/15 14:30,134,127,7,199
142,2022/7/15 14:40,147,150,-3,115
142,2022/7/15 14:50,144,115,29,212
142,2022/7/15 15:00,137,150,-13,167
142,2022/7/15 15:10,173,138,35,101
142,2022/7/15 15:20,173,185,-12,167
142,2022/7/15 15:30,165,185,-20,130
142,2022/7/15 15:40,214,181,33,220
142,2022/7/15 15:50,166,192,-26,-232
142,2022/7/15 16:00,182,207,-25,263
142,2022/7/15 16:10,201,145,56,462
142,2022/7/15 16:20,224,231,-7,346
142,2022/7/15 16:30,235,196,39,504
142,2022/7/15 16:40,269,296,-27,353
142,2022/7/15 16:50,270,298,-28,213
142,2022/7/15 17:00,456,331,125,896
142,2022/7/15 17:10,703,376,327,1187
142,2022/7/15 17:20,633,424,209,855
142,2022/7/15 17:30,802,492,310,1323
142,2022/7/15 17:40,1592,569,1023,2224
142,2022/7/15 17:50,1561,593,968,1179
142,2022/7/15 18:00,1589,1074,515,454
142,2022/7/15 18:10,3331,1084,2247,2284
142,2022/7/15 18:20,3213,557,2656,1074
142,2022/7/15 18:30,1982,1479,503,385
142,2022/7/15 18:40,1361,1471,-110,-2296
142,2022/7/15 18:50,828,1013,-185,-1243
142,2022/7/15 19:00,696,1078,-382,-1022
142,2022/7/15 19:10,575,593,-18,-295
142,2022/7/15 19:20,423,428,-5,-102
142,2022/7/15 19:30,294,430,-136,-432
142,2022/7/15 19:40,277,534,-257,-48
142,2022/7/15 19:50,223,328,-105,-128
142,2022/7/15 20:00,217,328,-111,266
142,2022/7/15 20:10,234,322,-88,184
142,2022/7/15 20:20,207,334,-127,388
142,2022/7/15 20:30,142,336,-194,-43
142,2022/7/15 20:40,137,207,-70,362
142,2022/7/15 20:50,87,329,-242,100
142,2022/7/15 21:00,70,231,-161,135
142,2022/7/15 21:10,148,207,-59,67
142,2022/7/15 21:20,78,298,-220,294
142,2022/7/15 21:30,47,270,-223,-237
142,2022/7/15 21:40,47,328,-281,8
142,2022/7/15 21:50,36,300,-264,-299
142,2022/7/15 22:00,29,237,-208,-256
142,2022/7/15 22:10,31,224,-193,2
142,2022/7/15 22:20,26,232,-206,-169
142,2022/7/15 22:30,20,276,-256,-451
142,2022/7/15 22:40,13,185,-172,-294
142,2022/7/15 22:50,9,133,-124,-277
121,2022/7/15 5:00,0,1,-1,0
121,2022/7/15 5:10,2,1,1,26
121,2022/7/15 5:20,15,1,14,74
121,2022/7/15 5:30,24,1,23,81
121,2022/7/15 5:40,31,5,26,115
121,2022/7/15 5:50,35,16,19,105
121,2022/7/15 6:00,52,16,36,137
121,2022/7/15 6:10,60,11,49,95
121,2022/7/15 6:20,89,40,49,119
121,2022/7/15 6:30,183,32,151,229
121,2022/7/15 6:40,231,63,168,501
121,2022/7/15 6:50,277,73,204,911
121,2022/7/15 7:00,337,80,257,1200
121,2022/7/15 7:10,325,83,242,2095
121,2022/7/15 7:20,475,108,367,2675
121,2022/7/15 7:30,682,127,555,3693
121,2022/7/15 7:40,869,122,747,3304
121,2022/7/15 7:50,1234,122,1112,4239
121,2022/7/15 8:00,1577,110,1467,6110
121,2022/7/15 8:10,1582,159,1423,4654
121,2022/7/15 8:20,1389,222,1167,3229
121,2022/7/15 8:30,1217,180,1037,-2790
121,2022/7/15 8:40,862,213,649,-3869
121,2022/7/15 8:50,705,178,527,-2418
121,2022/7/15 9:00,614,133,481,-185
121,2022/7/15 9:10,434,109,325,329
121,2022/7/15 9:20,314,113,201,101
121,2022/7/15 9:30,229,121,108,140
121,2022/7/15 9:40,219,103,116,-271
121,2022/7/15 9:50,181,104,77,-336
121,2022/7/15 10:00,139,101,38,-417
121,2022/7/15 10:10,96,108,-12,-218
121,2022/7/15 10:20,86,92,-6,-144
121,2022/7/15 10:30,70,98,-28,-262
121,2022/7/15 10:40,62,96,-34,-64
121,2022/7/15 10:50,58,93,-35,-102
121,2022/7/15 11:00,57,90,-33,-170
121,2022/7/15 11:10,53,96,-43,-39
121,2022/7/15 11:20,60,93,-33,16
121,2022/7/15 11:30,54,93,-39,2
121,2022/7/15 11:40,51,98,-47,25
121,2022/7/15 11:50,55,111,-56,12
121,2022/7/15 12:00,69,101,-32,60
121,2022/7/15 12:10,62,109,-47,135
121,2022/7/15 12:20,72,105,-33,60
121,2022/7/15 12:30,77,108,-31,0
121,2022/7/15 12:40,70,109,-39,1
121,2022/7/15 12:50,76,99,-23,88
121,2022/7/15 13:00,76,106,-30,-191
121,2022/7/15 13:10,70,111,-41,264
121,2022/7/15 13:20,62,102,-40,-214
121,2022/7/15 13:30,62,101,-39,418
121,2022/7/15 13:40,59,103,-44,-139
121,2022/7/15 13:50,56,102,-46,232
121,2022/7/15 14:00,46,105,-59,-183
121,2022/7/15 14:10,48,106,-58,41
121,2022/7/15 14:20,47,103,-56,-56
121,2022/7/15 14:30,48,106,-58,141
121,2022/7/15 14:40,46,116,-70,45
121,2022/7/15 14:50,46,103,-57,155
121,2022/7/15 15:00,45,104,-59,108
121,2022/7/15 15:10,48,107,-59,42
121,2022/7/15 15:20,45,119,-74,93
121,2022/7/15 15:30,49,104,-55,75
121,2022/7/15 15:40,44,109,-65,155
121,2022/7/15 15:50,45,129,-84,-316
121,2022/7/15 16:00,60,125,-65,198
121,2022/7/15 16:10,71,114,-43,419
121,2022/7/15 16:20,65,121,-56,290
121,2022/7/15 16:30,76,133,-57,447
121,2022/7/15 16:40,96,159,-63,290
121,2022/7/15 16:50,79,170,-91,122
121,2022/7/15 17:00,219,155,64,960
121,2022/7/15 17:10,207,229,-22,1165
121,2022/7/15 17:20,147,296,-149,706
121,2022/7/15 17:30,206,318,-112,1211
121,2022/7/15 17:40,240,498,-258,1966
121,2022/7/15 17:50,198,416,-218,961
121,2022/7/15 18:00,201,434,-233,221
121,2022/7/15 18:10,202,432,-230,2054
121,2022/7/15 18:20,164,430,-266,808
121,2022/7/15 18:30,96,570,-474,-89
121,2022/7/15 18:40,75,424,-349,-2645
121,2022/7/15 18:50,68,429,-361,-1604
121,2022/7/15 19:00,53,418,-365,-1387
121,2022/7/15 19:10,48,528,-480,-775
121,2022/7/15 19:20,47,326,-279,-381
121,2022/7/15 19:30,42,256,-214,-646
121,2022/7/15 19:40,37,179,-142,-190
121,2022/7/15 19:50,34,177,-143,-271
121,2022/7/15 20:00,37,159,-122,144
121,2022/7/15 20:10,35,185,-150,34
121,2022/7/15 20:20,36,181,-145,243
121,2022/7/15 20:30,40,109,-69,-112
121,2022/7/15 20:40,37,192,-155,207
121,2022/7/15 20:50,29,109,-80,20
121,2022/7/15 21:00,28,180,-152,-17
121,2022/7/15 21:10,28,109,-81,-14
121,2022/7/15 21:20,31,124,-93,201
121,2022/7/15 21:30,24,109,-85,-322
121,2022/7/15 21:40,33,119,-86,-78
121,2022/7/15 21:50,26,116,-90,-389
121,2022/7/15 22:00,24,105,-81,-337
121,2022/7/15 22:10,25,112,-87,-85
121,2022/7/15 22:20,17,102,-85,-254
121,2022/7/15 22:30,12,111,-99,-550
121,2022/7/15 22:40,9,111,-102,-396
121,2022/7/15 22:50,5,98,-93,-370
144,2022/7/15 5:00,0,1,-1,-1
144,2022/7/15 5:10,0,1,-1,25
144,2022/7/15 5:20,6,1,5,79
144,2022/7/15 5:30,13,1,12,93
144,2022/7/15 5:40,20,2,18,133
144,2022/7/15 5:50,21,19,2,107
144,2022/7/15 6:00,32,11,21,158
144,2022/7/15 6:10,36,16,20,115
144,2022/7/15 6:20,48,47,1,120
144,2022/7/15 6:30,56,60,-4,225
144,2022/7/15 6:40,94,68,26,527
144,2022/7/15 6:50,184,99,85,996
144,2022/7/15 7:00,248,102,146,1346
144,2022/7/15 7:10,282,128,154,2249
144,2022/7/15 7:20,346,120,226,2901
144,2022/7/15 7:30,590,116,474,4167
144,2022/7/15 7:40,686,128,558,3862
144,2022/7/15 7:50,861,198,663,4902
144,2022/7/15 8:00,864,267,597,6707
144,2022/7/15 8:10,1055,321,734,5388
144,2022/7/15 8:20,859,431,428,3657
144,2022/7/15 8:30,740,579,161,-2629
144,2022/7/15 8:40,627,482,145,-3724
144,2022/7/15 8:50,572,520,52,-2366
144,2022/7/15 9:00,340,299,41,-144
144,2022/7/15 9:10,271,198,73,402
144,2022/7/15 9:20,219,139,80,181
144,2022/7/15 9:30,183,117,66,206
144,2022/7/15 9:40,143,110,33,-238
144,2022/7/15 9:50,93,119,-26,-362
144,2022/7/15 10:00,80,105,-25,-442
144,2022/7/15 10:10,69,105,-36,-254
144,2022/7/15 10:20,60,105,-45,-189
144,2022/7/15 10:30,44,98,-54,-316
144,2022/7/15 10:40,44,93,-49,-113
144,2022/7/15 10:50,46,104,-58,-160
144,2022/7/15 11:00,47,93,-46,-216
144,2022/7/15 11:10,47,93,-46,-85
144,2022/7/15 11:20,46,93,-47,-31
144,2022/7/15 11:30,47,106,-59,-57
144,2022/7/15 11:40,48,105,-57,-32
144,2022/7/15 11:50,48,104,-56,-44
144,2022/7/15 12:00,55,105,-50,10
144,2022/7/15 12:10,57,106,-49,86
144,2022/7/15 12:20,55,104,-49,11
144,2022/7/15 12:30,62,104,-42,-42
144,2022/7/15 12:40,64,108,-44,-43
144,2022/7/15 12:50,53,104,-51,37
144,2022/7/15 13:00,61,105,-44,-235
144,2022/7/15 13:10,67,113,-46,218
144,2022/7/15 13:20,60,105,-45,-259
144,2022/7/15 13:30,56,107,-51,367
144,2022/7/15 13:40,58,104,-46,-185
144,2022/7/15 13:50,56,112,-56,176
144,2022/7/15 14:00,52,101,-49,-232
144,2022/7/15 14:10,48,98,-50,-9
144,2022/7/15 14:20,56,105,-49,-105
144,2022/7/15 14:30,49,108,-59,82
144,2022/7/15 14:40,55,108,-53,-8
144,2022/7/15 14:50,58,126,-68,87
144,2022/7/15 15:00,63,108,-45,63
144,2022/7/15 15:10,77,124,-47,-5
144,2022/7/15 15:20,68,100,-32,61
144,2022/7/15 15:30,57,116,-59,16
144,2022/7/15 15:40,60,123,-63,92
144,2022/7/15 15:50,65,117,-52,-368
144,2022/7/15 16:00,64,104,-40,158
144,2022/7/15 16:10,83,105,-22,397
144,2022/7/15 16:20,82,110,-28,262
144,2022/7/15 16:30,144,127,17,464
144,2022/7/15 16:40,224,110,114,404
144,2022/7/15 16:50,212,159,53,175
144,2022/7/15 17:00,223,117,106,1066
144,2022/7/15 17:10,331,195,136,1301
144,2022/7/15 17:20,272,194,78,784
144,2022/7/15 17:30,272,297,-25,1186
144,2022/7/15 17:40,579,329,250,2216
144,2022/7/15 17:50,371,315,56,1017
144,2022/7/15 18:00,316,326,-10,211
144,2022/7/15 18:10,576,380,196,2250
144,2022/7/15 18:20,616,506,110,918
144,2022/7/15 18:30,291,510,-219,-308
144,2022/7/15 18:40,230,535,-305,-2950
144,2022/7/15 18:50,188,320,-132,-1736
144,2022/7/15 19:00,128,351,-223,-1610
144,2022/7/15 19:10,92,257,-165,-940
144,2022/7/15 19:20,72,158,-86,-467
144,2022/7/15 19:30,55,158,-103,-749
144,2022/7/15 19:40,47,108,-61,-251
144,2022/7/15 19:50,44,116,-72,-343
144,2022/7/15 20:00,44,107,-63,81
144,2022/7/15 20:10,57,110,-53,-19
144,2022/7/15 20:20,57,118,-61,182
144,2022/7/15 20:30,46,105,-59,-171
144,2022/7/15 20:40,45,109,-64,143
144,2022/7/15 20:50,43,122,-79,-59
144,2022/7/15 21:00,43,106,-63,-80
144,2022/7/15 21:10,45,104,-59,-73
144,2022/7/15 21:20,37,98,-61,140
144,2022/7/15 21:30,32,109,-77,-399
144,2022/7/15 21:40,28,101,-73,-151
144,2022/7/15 21:50,29,84,-55,-444
144,2022/7/15 22:00,35,89,-54,-391
144,2022/7/15 22:10,25,111,-86,-171
144,2022/7/15 22:20,22,107,-85,-339
144,2022/7/15 22:30,13,113,-100,-650
144,2022/7/15 22:40,13,82,-69,-465
144,2022/7/15 22:50,9,70,-61,-431
135,2022/7/15 5:00,0,1,-1,-2
135,2022/7/15 5:10,5,1,4,29
135,2022/7/15 5:20,8,1,7,86
135,2022/7/15 5:30,19,1,18,111
135,2022/7/15 5:40,34,2,32,165
135,2022/7/15 5:50,35,33,2,109
135,2022/7/15 6:00,53,19,34,192
135,2022/7/15 6:10,66,41,25,140
135,2022/7/15 6:20,85,40,45,165
135,2022/7/15 6:30,155,68,87,312
135,2022/7/15 6:40,216,92,124,651
135,2022/7/15 6:50,273,103,170,1166
135,2022/7/15 7:00,348,121,227,1573
135,2022/7/15 7:10,443,114,329,2578
135,2022/7/15 7:20,597,206,391,3292
135,2022/7/15 7:30,629,343,286,4453
135,2022/7/15 7:40,821,441,380,4242
135,2022/7/15 7:50,1177,1156,21,4923
135,2022/7/15 8:00,1216,2741,-1525,5182
135,2022/7/15 8:10,1363,2566,-1203,4185
135,2022/7/15 8:20,1387,2504,-1117,2540
135,2022/7/15 8:30,1216,3899,-2683,-5312
135,2022/7/15 8:40,870,5928,-5058,-8782
135,2022/7/15 8:50,695,5126,-4431,-6797
135,2022/7/15 9:00,709,2882,-2173,-2317
135,2022/7/15 9:10,582,2032,-1450,-1048
135,2022/7/15 9:20,374,1084,-710,-529
135,2022/7/15 9:30,344,551,-207,-1
135,2022/7/15 9:40,274,410,-136,-374
135,2022/7/15 9:50,217,379,-162,-524
135,2022/7/15 10:00,211,327,-116,-558
135,2022/7/15 10:10,208,209,-1,-255
135,2022/7/15 10:20,184,180,4,-185
135,2022/7/15 10:30,208,179,29,-287
135,2022/7/15 10:40,187,214,-27,-140
135,2022/7/15 10:50,174,140,34,-126
135,2022/7/15 11:00,184,198,-14,-230
135,2022/7/15 11:10,185,115,70,-15
135,2022/7/15 11:20,178,179,-1,-32
135,2022/7/15 11:30,185,146,39,-18
135,2022/7/15 11:40,204,198,6,-26
135,2022/7/15 11:50,181,146,35,-9
135,2022/7/15 12:00,202,192,10,20
135,2022/7/15 12:10,214,160,54,140
135,2022/7/15 12:20,241,223,18,29
135,2022/7/15 12:30,238,154,84,42
135,2022/7/15 12:40,257,198,59,16
135,2022/7/15 12:50,246,213,33,70
135,2022/7/15 13:00,272,223,49,-186
135,2022/7/15 13:10,264,181,83,301
135,2022/7/15 13:20,257,218,39,-220
135,2022/7/15 13:30,224,181,43,410
135,2022/7/15 13:40,234,233,1,-184
135,2022/7/15 13:50,224,180,44,220
135,2022/7/15 14:00,235,197,38,-194
135,2022/7/15 14:10,228,192,36,27
135,2022/7/15 14:20,226,180,46,-59
135,2022/7/15 14:30,225,185,40,122
135,2022/7/15 14:40,226,198,28,20
135,2022/7/15 14:50,265,159,106,193
135,2022/7/15 15:00,241,180,61,124
135,2022/7/15 15:10,258,192,66,61
135,2022/7/15 15:20,239,214,25,86
135,2022/7/15 15:30,240,214,26,42
135,2022/7/15 15:40,266,197,69,161
135,2022/7/15 15:50,243,198,45,-323
135,2022/7/15 16:00,272,207,65,223
135,2022/7/15 16:10,306,212,94,491
135,2022/7/15 16:20,304,216,88,350
135,2022/7/15 16:30,345,218,127,591
135,2022/7/15 16:40,371,284,87,491
135,2022/7/15 16:50,556,255,301,476
135,2022/7/15 17:00,670,314,356,1422
135,2022/7/15 17:10,1205,381,824,2125
135,2022/7/15 17:20,1140,503,637,1421
135,2022/7/15 17:30,1149,426,723,1909
135,2022/7/15 17:40,2484,426,2058,4274
135,2022/7/15 17:50,2057,568,1489,2506
135,2022/7/15 18:00,1987,575,1412,1623
135,2022/7/15 18:10,2551,575,1976,4226
135,2022/7/15 18:20,2004,574,1430,2348
135,2022/7/15 18:30,1590,1093,497,189
135,2022/7/15 18:40,1149,570,579,-2371
135,2022/7/15 18:50,815,577,238,-1498
135,2022/7/15 19:00,638,421,217,-1393
135,2022/7/15 19:10,636,417,219,-721
135,2022/7/15 19:20,587,519,68,-399
135,2022/7/15 19:30,456,379,77,-672
135,2022/7/15 19:40,353,299,54,-197
135,2022/7/15 19:50,332,257,75,-268
135,2022/7/15 20:00,324,223,101,182
135,2022/7/15 20:10,327,184,143,124
135,2022/7/15 20:20,336,169,167,349
135,2022/7/15 20:30,301,199,102,-69
135,2022/7/15 20:40,275,120,155,298
135,2022/7/15 20:50,269,191,78,19
135,2022/7/15 21:00,292,180,112,32
135,2022/7/15 21:10,317,137,180,107
135,2022/7/15 21:20,236,181,55,195
135,2022/7/15 21:30,225,137,88,-311
135,2022/7/15 21:40,215,150,65,-86
135,2022/7/15 21:50,189,116,73,-371
135,2022/7/15 22:00,274,109,165,-226
135,2022/7/15 22:10,314,120,194,23
135,2022/7/15 22:20,150,109,41,-298
135,2022/7/15 22:30,40,126,-86,-736
135,2022/7/15 22:40,24,112,-88,-553
135,2022/7/15 22:50,24,101,-77,-508
148,2022/7/15 5:00,0,1,-1,-3
148,2022/7/15 5:10,1,1,0,29
148,2022/7/15 5:20,9,1,8,94
148,2022/7/15 5:30,16,1,15,126
148,2022/7/15 5:40,30,8,22,187
148,2022/7/15 5:50,29,23,6,115
148,2022/7/15 6:00,38,30,8,200
148,2022/7/15 6:10,51,39,12,152
148,2022/7/15 6:20,60,64,-4,161
148,2022/7/15 6:30,74,77,-3,309
148,2022/7/15 6:40,147,110,37,688
148,2022/7/15 6:50,227,112,115,1281
148,2022/7/15 7:00,284,126,158,1731
148,2022/7/15 7:10,275,112,163,2741
148,2022/7/15 7:20,383,159,224,3516
148,2022/7/15 7:30,596,197,399,4852
148,2022/7/15 7:40,678,269,409,4651
148,2022/7/15 7:50,871,329,542,5465
148,2022/7/15 8:00,1170,420,750,5932
148,2022/7/15 8:10,1208,553,655,4840
148,2022/7/15 8:20,1213,1089,124,2664
148,2022/7/15 8:30,1184,1117,67,-5245
148,2022/7/15 8:40,868,2006,-1138,-9920
148,2022/7/15 8:50,678,1582,-904,-7701
148,2022/7/15 9:00,615,1124,-509,-2826
148,2022/7/15 9:10,586,1127,-541,-1589
148,2022/7/15 9:20,330,589,-259,-788
148,2022/7/15 9:30,309,417,-108,-109
148,2022/7/15 9:40,246,426,-180,-554
148,2022/7/15 9:50,217,436,-219,-743
148,2022/7/15 10:00,215,334,-119,-677
148,2022/7/15 10:10,190,297,-107,-362
148,2022/7/15 10:20,196,221,-25,-210
148,2022/7/15 10:30,184,197,-13,-300
148,2022/7/15 10:40,174,222,-48,-188
148,2022/7/15 10:50,168,207,-39,-165
148,2022/7/15 11:00,175,222,-47,-277
148,2022/7/15 11:10,185,223,-38,-53
148,2022/7/15 11:20,187,180,7,-25
148,2022/7/15 11:30,206,233,-27,-45
148,2022/7/15 11:40,212,218,-6,-32
148,2022/7/15 11:50,208,234,-26,-35
148,2022/7/15 12:00,236,232,4,24
148,2022/7/15 12:10,257,196,61,201
148,2022/7/15 12:20,264,232,32,61
148,2022/7/15 12:30,274,255,19,61
148,2022/7/15 12:40,269,283,-14,2
148,2022/7/15 12:50,273,283,-10,60
148,2022/7/15 13:00,271,216,55,-131
148,2022/7/15 13:10,262,232,30,331
148,2022/7/15 13:20,270,217,53,-167
148,2022/7/15 13:30,265,232,33,443
148,2022/7/15 13:40,286,233,53,-131
148,2022/7/15 13:50,267,269,-2,218
148,2022/7/15 14:00,269,232,37,-157
148,2022/7/15 14:10,265,196,69,96
148,2022/7/15 14:20,268,233,35,-24
148,2022/7/15 14:30,268,196,72,194
148,2022/7/15 14:40,264,218,46,66
148,2022/7/15 14:50,260,218,42,235
148,2022/7/15 15:00,262,232,30,154
148,2022/7/15 15:10,317,267,50,111
148,2022/7/15 15:20,261,216,45,131
148,2022/7/15 15:30,288,297,-9,33
148,2022/7/15 15:40,316,290,26,187
148,2022/7/15 15:50,291,320,-29,-352
148,2022/7/15 16:00,312,318,-6,217
148,2022/7/15 16:10,329,297,32,523
148,2022/7/15 16:20,310,339,-29,321
148,2022/7/15 16:30,309,311,-2,589
148,2022/7/15 16:40,368,316,52,543
148,2022/7/15 16:50,350,318,32,508
148,2022/7/15 17:00,634,500,134,1556
148,2022/7/15 17:10,794,498,296,2421
148,2022/7/15 17:20,637,419,218,1639
148,2022/7/15 17:30,836,560,276,2185
148,2022/7/15 17:40,1156,561,595,4869
148,2022/7/15 17:50,832,1115,-283,2223
148,2022/7/15 18:00,1025,1784,-759,864
148,2022/7/15 18:10,1352,1110,242,4468
148,2022/7/15 18:20,1163,1694,-531,1817
148,2022/7/15 18:30,831,1519,-688,-499
148,2022/7/15 18:40,706,1752,-1046,-3417
148,2022/7/15 18:50,646,1479,-833,-2331
148,2022/7/15 19:00,615,606,9,-1384
148,2022/7/15 19:10,587,469,118,-603
148,2022/7/15 19:20,542,415,127,-272
148,2022/7/15 19:30,422,494,-72,-744
148,2022/7/15 19:40,425,341,84,-113
148,2022/7/15 19:50,314,327,-13,-281
148,2022/7/15 20:00,429,236,193,375
148,2022/7/15 20:10,549,218,331,455
148,2022/7/15 20:20,369,234,135,484
148,2022/7/15 20:30,550,221,329,260
148,2022/7/15 20:40,585,179,406,704
148,2022/7/15 20:50,571,150,421,440
148,2022/7/15 21:00,591,192,399,431
148,2022/7/15 21:10,614,191,423,530
148,2022/7/15 21:20,558,142,416,611
148,2022/7/15 21:30,585,192,393,82
148,2022/7/15 21:40,466,110,356,270
148,2022/7/15 21:50,322,115,207,-164
148,2022/7/15 22:00,576,128,448,222
148,2022/7/15 22:10,258,133,125,148
148,2022/7/15 22:20,124,110,14,-284
148,2022/7/15 22:30,44,112,-68,-804
148,2022/7/15 22:40,26,103,-77,-630
148,2022/7/15 22:50,23,94,-71,-579
130,2022/7/15 5:00,0,1,-1,-4
130,2022/7/15 5:10,0,1,-1,28
130,2022/7/15 5:20,3,1,2,96
130,2022/7/15 5:30,11,1,10,136
130,2022/7/15 5:40,21,6,15,202
130,2022/7/15 5:50,26,21,5,120
130,2022/7/15 6:00,26,23,3,203
130,2022/7/15 6:10,34,49,-15,137
130,2022/7/15 6:20,40,48,-8,153
130,2022/7/15 6:30,54,72,-18,291
130,2022/7/15 6:40,69,76,-7,681
130,2022/7/15 6:50,85,96,-11,1270
130,2022/7/15 7:00,102,102,0,1731
130,2022/7/15 7:10,190,183,7,2748
130,2022/7/15 7:20,215,224,-9,3507
130,2022/7/15 7:30,242,232,10,4862
130,2022/7/15 7:40,317,316,1,4652
130,2022/7/15 7:50,367,505,-138,5327
130,2022/7/15 8:00,571,584,-13,5919
130,2022/7/15 8:10,598,1537,-939,3901
130,2022/7/15 8:20,628,1757,-1129,1535
130,2022/7/15 8:30,572,2665,-2093,-7338
130,2022/7/15 8:40,350,2349,-1999,-11919
130,2022/7/15 8:50,282,2742,-2460,-10161
130,2022/7/15 9:00,270,1537,-1267,-4093
130,2022/7/15 9:10,237,1124,-887,-2476
130,2022/7/15 9:20,216,561,-345,-1133
130,2022/7/15 9:30,190,405,-215,-324
130,2022/7/15 9:40,187,376,-189,-743
130,2022/7/15 9:50,156,254,-98,-841
130,2022/7/15 10:00,108,233,-125,-802
130,2022/7/15 10:10,89,183,-94,-456
130,2022/7/15 10:20,95,181,-86,-296
130,2022/7/15 10:30,91,117,-26,-326
130,2022/7/15 10:40,84,122,-38,-226
130,2022/7/15 10:50,101,108,-7,-172
130,2022/7/15 11:00,81,124,-43,-320
130,2022/7/15 11:10,98,108,-10,-63
130,2022/7/15 11:20,123,125,-2,-27
130,2022/7/15 11:30,131,122,9,-36
130,2022/7/15 11:40,148,102,46,14
130,2022/7/15 11:50,131,104,27,-8
130,2022/7/15 12:00,135,121,14,38
130,2022/7/15 12:10,131,106,25,226
130,2022/7/15 12:20,128,123,5,66
130,2022/7/15 12:30,132,108,24,85
130,2022/7/15 12:40,132,108,24,26
130,2022/7/15 12:50,109,119,-10,50
130,2022/7/15 13:00,132,129,3,-128
130,2022/7/15 13:10,137,170,-33,298
130,2022/7/15 13:20,170,139,31,-136
130,2022/7/15 13:30,144,128,16,459
130,2022/7/15 13:40,148,126,22,-109
130,2022/7/15 13:50,153,117,36,254
130,2022/7/15 14:00,156,111,45,-112
130,2022/7/15 14:10,156,108,48,144
130,2022/7/15 14:20,173,109,64,40
130,2022/7/15 14:30,169,106,63,257
130,2022/7/15 14:40,171,120,51,117
130,2022/7/15 14:50,164,109,55,290
130,2022/7/15 15:00,206,114,92,246
130,2022/7/15 15:10,192,121,71,182
130,2022/7/15 15:20,196,109,87,218
130,2022/7/15 15:30,216,108,108,141
130,2022/7/15 15:40,207,105,102,289
130,2022/7/15 15:50,218,109,109,-243
130,2022/7/15 16:00,216,122,94,311
130,2022/7/15 16:10,221,109,112,635
130,2022/7/15 16:20,224,121,103,424
130,2022/7/15 16:30,265,108,157,746
130,2022/7/15 16:40,329,125,204,747
130,2022/7/15 16:50,336,128,208,716
130,2022/7/15 17:00,697,138,559,2115
130,2022/7/15 17:10,1044,142,902,3323
130,2022/7/15 17:20,696,145,551,2190
130,2022/7/15 17:30,713,196,517,2702
130,2022/7/15 17:40,1594,298,1296,6165
130,2022/7/15 17:50,1206,298,908,3131
130,2022/7/15 18:00,1033,301,732,1596
130,2022/7/15 18:10,1992,284,1708,6176
130,2022/7/15 18:20,1568,300,1268,3085
130,2022/7/15 18:30,1035,301,734,235
130,2022/7/15 18:40,698,301,397,-3020
130,2022/7/15 18:50,575,300,275,-2056
130,2022/7/15 19:00,310,224,86,-1298
130,2022/7/15 19:10,347,179,168,-435
130,2022/7/15 19:20,270,111,159,-113
130,2022/7/15 19:30,220,107,113,-631
130,2022/7/15 19:40,218,125,93,-20
130,2022/7/15 19:50,173,117,56,-225
130,2022/7/15 20:00,174,88,86,461
130,2022/7/15 20:10,175,108,67,522
130,2022/7/15 20:20,137,103,34,518
130,2022/7/15 20:30,137,114,23,283
130,2022/7/15 20:40,114,107,7,711
130,2022/7/15 20:50,96,104,-8,432
130,2022/7/15 21:00,101,106,-5,426
130,2022/7/15 21:10,133,108,25,555
130,2022/7/15 21:20,77,121,-44,567
130,2022/7/15 21:30,66,112,-46,36
130,2022/7/15 21:40,49,110,-61,209
130,2022/7/15 21:50,42,111,-69,-233
130,2022/7/15 22:00,39,103,-64,158
130,2022/7/15 22:10,41,105,-64,84
130,2022/7/15 22:20,28,112,-84,-368
130,2022/7/15 22:30,27,98,-71,-875
130,2022/7/15 22:40,23,79,-56,-686
130,2022/7/15 22:50,14,73,-59,-638
132,2022/7/15 5:00,0,1,-1,-5
132,2022/7/15 5:10,4,1,3,31
132,2022/7/15 5:20,7,1,6,102
132,2022/7/15 5:30,15,1,14,150
132,2022/7/15 5:40,22,15,7,209
132,2022/7/15 5:50,25,30,-5,115
132,2022/7/15 6:00,31,53,-22,181
132,2022/7/15 6:10,36,65,-29,108
132,2022/7/15 6:20,31,107,-76,77
132,2022/7/15 6:30,42,109,-67,224
132,2022/7/15 6:40,54,108,-54,627
132,2022/7/15 6:50,72,121,-49,1221
132,2022/7/15 7:00,99,266,-167,1564
132,2022/7/15 7:10,148,313,-165,2583
132,2022/7/15 7:20,190,439,-249,3258
132,2022/7/15 7:30,227,426,-199,4663
132,2022/7/15 7:40,274,572,-298,4354
132,2022/7/15 7:50,343,1120,-777,4550
132,2022/7/15 8:00,436,2063,-1627,4292
132,2022/7/15 8:10,468,2811,-2343,1558
132,2022/7/15 8:20,571,2437,-1866,-331
132,2022/7/15 8:30,383,4184,-3801,-11139
132,2022/7/15 8:40,339,6572,-6233,-18152
132,2022/7/15 8:50,303,5902,-5599,-15760
132,2022/7/15 9:00,275,4439,-4164,-8257
132,2022/7/15 9:10,271,6273,-6002,-8478
132,2022/7/15 9:20,275,4112,-3837,-4970
132,2022/7/15 9:30,229,2394,-2165,-2489
132,2022/7/15 9:40,237,2506,-2269,-3012
132,2022/7/15 9:50,228,1497,-1269,-2110
132,2022/7/15 10:00,212,601,-389,-1191
132,2022/7/15 10:10,221,482,-261,-717
132,2022/7/15 10:20,233,415,-182,-478
132,2022/7/15 10:30,237,499,-262,-588
132,2022/7/15 10:40,244,427,-183,-409
132,2022/7/15 10:50,263,324,-61,-233
132,2022/7/15 11:00,268,379,-111,-431
132,2022/7/15 11:10,266,336,-70,-133
132,2022/7/15 11:20,267,378,-111,-138
132,2022/7/15 11:30,263,334,-71,-107
132,2022/7/15 11:40,298,432,-134,-120
132,2022/7/15 11:50,298,317,-19,-27
132,2022/7/15 12:00,335,433,-98,-60
132,2022/7/15 12:10,327,378,-51,175
132,2022/7/15 12:20,328,424,-96,-30
132,2022/7/15 12:30,332,419,-87,-2
132,2022/7/15 12:40,333,499,-166,-140
132,2022/7/15 12:50,327,344,-17,33
132,2022/7/15 13:00,327,500,-173,-301
132,2022/7/15 13:10,310,417,-107,191
132,2022/7/15 13:20,349,516,-167,-303
132,2022/7/15 13:30,312,380,-68,391
132,2022/7/15 13:40,421,499,-78,-187
132,2022/7/15 13:50,370,338,32,286
132,2022/7/15 14:00,463,433,30,-82
132,2022/7/15 14:10,547,337,210,354
132,2022/7/15 14:20,544,376,168,208
132,2022/7/15 14:30,590,316,274,531
132,2022/7/15 14:40,455,332,123,240
132,2022/7/15 14:50,573,267,306,596
132,2022/7/15 15:00,580,332,248,494
132,2022/7/15 15:10,581,282,299,481
132,2022/7/15 15:20,588,318,270,488
132,2022/7/15 15:30,678,254,424,565
132,2022/7/15 15:40,679,338,341,630
132,2022/7/15 15:50,622,298,324,81
132,2022/7/15 16:00,678,318,360,671
132,2022/7/15 16:10,655,282,373,1008
132,2022/7/15 16:20,659,298,361,785
132,2022/7/15 16:30,703,233,470,1216
132,2022/7/15 16:40,804,298,506,1253
132,2022/7/15 16:50,829,319,510,1226
132,2022/7/15 17:00,1344,313,1031,3146
132,2022/7/15 17:10,1971,312,1659,4982
132,2022/7/15 17:20,1557,489,1068,3258
132,2022/7/15 17:30,1977,409,1568,4270
132,2022/7/15 17:40,2555,472,2083,8248
132,2022/7/15 17:50,1986,472,1514,4645
132,2022/7/15 18:00,1993,565,1428,3024
132,2022/7/15 18:10,3368,561,2807,8983
132,2022/7/15 18:20,3030,560,2470,5555
132,2022/7/15 18:30,1986,565,1421,1656
132,2022/7/15 18:40,1974,558,1416,-1604
132,2022/7/15 18:50,1584,561,1023,-1033
132,2022/7/15 19:00,1353,418,935,-363
132,2022/7/15 19:10,1199,374,825,390
132,2022/7/15 19:20,1036,321,715,602
132,2022/7/15 19:30,798,232,566,-65
132,2022/7/15 19:40,668,179,489,469
132,2022/7/15 19:50,653,158,495,270
132,2022/7/15 20:00,657,115,542,1003
132,2022/7/15 20:10,668,116,552,1074
132,2022/7/15 20:20,678,104,574,1092
132,2022/7/15 20:30,694,124,570,853
132,2022/7/15 20:40,647,124,523,1234
132,2022/7/15 20:50,675,122,553,985
132,2022/7/15 21:00,682,120,562,988
132,2022/7/15 21:10,672,100,572,1127
132,2022/7/15 21:20,623,114,509,1076
132,2022/7/15 21:30,574,102,472,508
132,2022/7/15 21:40,685,115,570,779
132,2022/7/15 21:50,561,111,450,217
132,2022/7/15 22:00,607,110,497,655
132,2022/7/15 22:10,729,103,626,710
132,2022/7/15 22:20,306,103,203,-165
132,2022/7/15 22:30,132,92,40,-835
132,2022/7/15 22:40,54,79,-25,-711
132,2022/7/15 22:50,26,77,-51,-689
138,2022/7/15 5:00,0,1,-1,-6
138,2022/7/15 5:10,3,1,2,33
138,2022/7/15 5:20,7,1,6,108
138,2022/7/15 5:30,15,1,14,164
138,2022/7/15 5:40,19,21,-2,207
138,2022/7/15 5:50,29,14,15,130
138,2022/7/15 6:00,28,50,-22,159
138,2022/7/15 6:10,33,73,-40,68
138,2022/7/15 6:20,37,75,-38,39
138,2022/7/15 6:30,51,110,-59,165
138,2022/7/15 6:40,59,121,-62,565
138,2022/7/15 6:50,91,133,-42,1179
138,2022/7/15 7:00,123,183,-60,1504
138,2022/7/15 7:10,169,331,-162,2421
138,2022/7/15 7:20,185,435,-250,3008
138,2022/7/15 7:30,232,509,-277,4386
138,2022/7/15 7:40,278,492,-214,4140
138,2022/7/15 7:50,367,1152,-785,3765
138,2022/7/15 8:00,596,1926,-1330,2962
138,2022/7/15 8:10,589,4236,-3647,-2089
138,2022/7/15 8:20,598,4076,-3478,-3809
138,2022/7/15 8:30,475,5453,-4978,-16117
138,2022/7/15 8:40,354,5392,-5038,-23190
138,2022/7/15 8:50,346,5351,-5005,-20765
138,2022/7/15 9:00,274,6341,-6067,-14324
138,2022/7/15 9:10,260,5964,-5704,-14182
138,2022/7/15 9:20,225,4214,-3989,-8959
138,2022/7/15 9:30,232,2729,-2497,-4986
138,2022/7/15 9:40,226,2301,-2075,-5087
138,2022/7/15 9:50,200,1777,-1577,-3687
138,2022/7/15 10:00,211,610,-399,-1590
138,2022/7/15 10:10,226,421,-195,-912
138,2022/7/15 10:20,218,425,-207,-685
138,2022/7/15 10:30,225,524,-299,-887
138,2022/7/15 10:40,227,502,-275,-684
138,2022/7/15 10:50,226,314,-88,-321
138,2022/7/15 11:00,238,316,-78,-509
138,2022/7/15 11:10,266,332,-66,-199
138,2022/7/15 11:20,270,331,-61,-199
138,2022/7/15 11:30,271,318,-47,-154
138,2022/7/15 11:40,273,333,-60,-180
138,2022/7/15 11:50,268,333,-65,-92
138,2022/7/15 12:00,291,322,-31,-91
138,2022/7/15 12:10,333,332,1,176
138,2022/7/15 12:20,304,317,-13,-43
138,2022/7/15 12:30,299,428,-129,-131
138,2022/7/15 12:40,311,339,-28,-168
138,2022/7/15 12:50,311,492,-181,-148
138,2022/7/15 13:00,330,319,11,-290
138,2022/7/15 13:10,343,486,-143,48
138,2022/7/15 13:20,348,377,-29,-332
138,2022/7/15 13:30,326,373,-47,344
138,2022/7/15 13:40,333,432,-99,-286
138,2022/7/15 13:50,325,318,7,293
138,2022/7/15 14:00,326,316,10,-72
138,2022/7/15 14:10,422,317,105,459
138,2022/7/15 14:20,309,332,-23,185
138,2022/7/15 14:30,352,325,27,558
138,2022/7/15 14:40,367,326,41,281
138,2022/7/15 14:50,370,232,138,734
138,2022/7/15 15:00,426,253,173,667
138,2022/7/15 15:10,552,297,255,736
138,2022/7/15 15:20,544,232,312,800
138,2022/7/15 15:30,579,233,346,911
138,2022/7/15 15:40,584,268,316,946
138,2022/7/15 15:50,590,195,395,476
138,2022/7/15 16:00,636,195,441,1112
138,2022/7/15 16:10,686,216,470,1478
138,2022/7/15 16:20,627,282,345,1130
138,2022/7/15 16:30,709,207,502,1718
138,2022/7/15 16:40,823,255,568,1821
138,2022/7/15 16:50,1023,327,696,1922
138,2022/7/15 17:00,1571,330,1241,4387
138,2022/7/15 17:10,1988,315,1673,6655
138,2022/7/15 17:20,1634,368,1266,4524
138,2022/7/15 17:30,1986,427,1559,5829
138,2022/7/15 17:40,3338,423,2915,11163
138,2022/7/15 17:50,2558,410,2148,6793
138,2022/7/15 18:00,2487,426,2061,5085
138,2022/7/15 18:10,3391,482,2909,11892
138,2022/7/15 18:20,3342,412,2930,8485
138,2022/7/15 18:30,2071,417,1654,3310
138,2022/7/15 18:40,1994,481,1513,-91
138,2022/7/15 18:50,1645,424,1221,188
138,2022/7/15 19:00,1350,514,836,473
138,2022/7/15 19:10,1150,318,832,1222
138,2022/7/15 19:20,839,270,569,1171
138,2022/7/15 19:30,650,226,424,359
138,2022/7/15 19:40,654,179,475,944
138,2022/7/15 19:50,692,136,556,826
138,2022/7/15 20:00,637,128,509,1512
138,2022/7/15 20:10,694,109,585,1659
138,2022/7/15 20:20,615,100,515,1607
138,2022/7/15 20:30,585,123,462,1315
138,2022/7/15 20:40,617,119,498,1732
138,2022/7/15 20:50,589,107,482,1467
138,2022/7/15 21:00,682,107,575,1563
138,2022/7/15 21:10,648,102,546,1673
138,2022/7/15 21:20,594,122,472,1548
138,2022/7/15 21:30,601,112,489,997
138,2022/7/15 21:40,648,104,544,1323
138,2022/7/15 21:50,595,104,491,708
138,2022/7/15 22:00,628,100,528,1183
138,2022/7/15 22:10,372,106,266,976
138,2022/7/15 22:20,203,95,108,-57
138,2022/7/15 22:30,119,85,34,-801
138,2022/7/15 22:40,41,69,-28,-739
138,2022/7/15 22:50,24,69,-45,-734
137,2022/7/15 5:00,0,1,-1,-7
137,2022/7/15 5:10,2,1,1,34
137,2022/7/15 5:20,10,1,9,117
137,2022/7/15 5:30,14,8,6,170
137,2022/7/15 5:40,18,6,12,219
137,2022/7/15 5:50,23,11,12,142
137,2022/7/15 6:00,22,40,-18,141
137,2022/7/15 6:10,27,64,-37,31
137,2022/7/15 6:20,31,62,-31,8
137,2022/7/15 6:30,38,74,-36,129
137,2022/7/15 6:40,41,111,-70,495
137,2022/7/15 6:50,40,105,-65,1114
137,2022/7/15 7:00,47,120,-73,1431
137,2022/7/15 7:10,56,126,-70,2351
137,2022/7/15 7:20,74,212,-138,2870
137,2022/7/15 7:30,76,323,-247,4139
137,2022/7/15 7:40,94,508,-414,3726
137,2022/7/15 7:50,169,484,-315,3450
137,2022/7/15 8:00,183,1810,-1627,1335
137,2022/7/15 8:10,226,2426,-2200,-4289
137,2022/7/15 8:20,224,2142,-1918,-5727
137,2022/7/15 8:30,216,2545,-2329,-18446
137,2022/7/15 8:40,184,8977,-8793,-31983
137,2022/7/15 8:50,157,4543,-4386,-25151
137,2022/7/15 9:00,145,2814,-2669,-16993
137,2022/7/15 9:10,142,2158,-2016,-16198
137,2022/7/15 9:20,137,1555,-1418,-10377
137,2022/7/15 9:30,155,1098,-943,-5929
137,2022/7/15 9:40,136,571,-435,-5522
137,2022/7/15 9:50,100,475,-375,-4062
137,2022/7/15 10:00,137,427,-290,-1880
137,2022/7/15 10:10,153,433,-280,-1192
137,2022/7/15 10:20,147,374,-227,-912
137,2022/7/15 10:30,172,347,-175,-1062
137,2022/7/15 10:40,174,324,-150,-834
137,2022/7/15 10:50,162,318,-156,-477
137,2022/7/15 11:00,180,297,-117,-626
137,2022/7/15 11:10,205,232,-27,-226
137,2022/7/15 11:20,218,298,-80,-279
137,2022/7/15 11:30,211,298,-87,-241
137,2022/7/15 11:40,221,299,-78,-258
137,2022/7/15 11:50,225,318,-93,-185
137,2022/7/15 12:00,243,268,-25,-116
137,2022/7/15 12:10,254,267,-13,163
137,2022/7/15 12:20,258,318,-60,-103
137,2022/7/15 12:30,267,298,-31,-162
137,2022/7/15 12:40,276,326,-50,-218
137,2022/7/15 12:50,272,333,-61,-209
137,2022/7/15 13:00,287,326,-39,-329
137,2022/7/15 13:10,309,326,-17,31
137,2022/7/15 13:20,315,318,-3,-335
137,2022/7/15 13:30,333,326,7,351
137,2022/7/15 13:40,330,298,32,-254
137,2022/7/15 13:50,344,326,18,311
137,2022/7/15 14:00,332,325,7,-65
137,2022/7/15 14:10,348,232,116,575
137,2022/7/15 14:20,333,325,8,193
137,2022/7/15 14:30,343,254,89,647
137,2022/7/15 14:40,330,233,97,378
137,2022/7/15 14:50,332,269,63,797
137,2022/7/15 15:00,371,226,145,812
137,2022/7/15 15:10,372,218,154,890
137,2022/7/15 15:20,349,226,123,923
137,2022/7/15 15:30,352,219,133,1044
137,2022/7/15 15:40,369,208,161,1107
137,2022/7/15 15:50,461,223,238,714
137,2022/7/15 16:00,576,178,398,1510
137,2022/7/15 16:10,570,180,390,1868
137,2022/7/15 16:20,579,198,381,1511
137,2022/7/15 16:30,621,180,441,2159
137,2022/7/15 16:40,687,214,473,2294
137,2022/7/15 16:50,696,198,498,2420
137,2022/7/15 17:00,1193,178,1015,5402
137,2022/7/15 17:10,1555,228,1327,7982
137,2022/7/15 17:20,1202,316,886,5410
137,2022/7/15 17:30,1586,325,1261,7090
137,2022/7/15 17:40,2008,326,1682,12845
137,2022/7/15 17:50,1562,339,1223,8016
137,2022/7/15 18:00,1583,521,1062,6147
137,2022/7/15 18:10,1978,522,1456,13348
137,2022/7/15 18:20,1534,366,1168,9653
137,2022/7/15 18:30,1143,523,620,3930
137,2022/7/15 18:40,1146,482,664,573
137,2022/7/15 18:50,798,325,473,661
137,2022/7/15 19:00,670,256,414,887
137,2022/7/15 19:10,655,229,426,1648
137,2022/7/15 19:20,575,148,427,1598
137,2022/7/15 19:30,565,108,457,816
137,2022/7/15 19:40,588,113,475,1419
137,2022/7/15 19:50,548,109,439,1265
137,2022/7/15 20:00,559,116,443,1955
137,2022/7/15 20:10,582,102,480,2139
137,2022/7/15 20:20,551,105,446,2053
137,2022/7/15 20:30,553,104,449,1764
137,2022/7/15 20:40,571,104,467,2199
137,2022/7/15 20:50,465,106,359,1826
137,2022/7/15 21:00,588,89,499,2062
137,2022/7/15 21:10,590,102,488,2161
137,2022/7/15 21:20,582,95,487,2035
137,2022/7/15 21:30,593,95,498,1495
137,2022/7/15 21:40,353,91,262,1585
137,2022/7/15 21:50,339,85,254,962
137,2022/7/15 22:00,714,93,621,1804
137,2022/7/15 22:10,267,78,189,1165
137,2022/7/15 22:20,116,93,23,-34
137,2022/7/15 22:30,101,75,26,-775
137,2022/7/15 22:40,33,84,-51,-790
137,2022/7/15 22:50,24,70,-46,-780
136,2022/7/15 5:00,4,1,3,-4
136,2022/7/15 5:10,6,1,5,39
136,2022/7/15 5:20,26,1,25,142
136,2022/7/15 5:30,19,1,18,188
136,2022/7/15 5:40,32,6,26,245
136,2022/7/15 5:50,31,14,17,159
136,2022/7/15 6:00,42,82,-40,101
136,2022/7/15 6:10,42,76,-34,-3
136,2022/7/15 6:20,30,105,-75,-67
136,2022/7/15 6:30,45,112,-67,62
136,2022/7/15 6:40,53,105,-52,443
136,2022/7/15 6:50,58,192,-134,980
136,2022/7/15 7:00,77,281,-204,1227
136,2022/7/15 7:10,95,287,-192,2159
136,2022/7/15 7:20,99,376,-277,2593
136,2022/7/15 7:30,156,1528,-1372,2767
136,2022/7/15 7:40,182,2801,-2619,1107
136,2022/7/15 7:50,216,5057,-4841,-1391
136,2022/7/15 8:00,275,4121,-3846,-2511
136,2022/7/15 8:10,274,14814,-14540,-18829
136,2022/7/15 8:20,274,12876,-12602,-18329
136,2022/7/15 8:30,280,11749,-11469,-29915
136,2022/7/15 8:40,278,14995,-14717,-46700
136,2022/7/15 8:50,227,8814,-8587,-33738
136,2022/7/15 9:00,267,13667,-13400,-30393
136,2022/7/15 9:10,267,6907,-6640,-22838
136,2022/7/15 9:20,220,4308,-4088,-14465
136,2022/7/15 9:30,220,3506,-3286,-9215
136,2022/7/15 9:40,205,4116,-3911,-9433
136,2022/7/15 9:50,198,2125,-1927,-5989
136,2022/7/15 10:00,211,599,-388,-2268
136,2022/7/15 10:10,213,422,-209,-1401
136,2022/7/15 10:20,215,430,-215,-1127
136,2022/7/15 10:30,259,428,-169,-1231
136,2022/7/15 10:40,257,491,-234,-1068
136,2022/7/15 10:50,242,518,-276,-753
136,2022/7/15 11:00,269,376,-107,-733
136,2022/7/15 11:10,270,375,-105,-331
136,2022/7/15 11:20,289,379,-90,-369
136,2022/7/15 11:30,332,379,-47,-288
136,2022/7/15 11:40,366,380,-14,-272
136,2022/7/15 11:50,347,315,32,-153
136,2022/7/15 12:00,310,325,-15,-131
136,2022/7/15 12:10,425,337,88,251
136,2022/7/15 12:20,368,332,36,-67
136,2022/7/15 12:30,325,516,-191,-353
136,2022/7/15 12:40,333,501,-168,-386
136,2022/7/15 12:50,308,508,-200,-409
136,2022/7/15 13:00,308,490,-182,-511
136,2022/7/15 13:10,422,425,-3,28
136,2022/7/15 13:20,426,427,-1,-336
136,2022/7/15 13:30,422,417,5,356
136,2022/7/15 13:40,422,427,-5,-259
136,2022/7/15 13:50,461,497,-36,275
136,2022/7/15 14:00,423,428,-5,-70
136,2022/7/15 14:10,457,431,26,601
136,2022/7/15 14:20,463,383,80,273
136,2022/7/15 14:30,554,381,173,820
136,2022/7/15 14:40,460,339,121,499
136,2022/7/15 14:50,454,345,109,906
136,2022/7/15 15:00,568,317,251,1063
136,2022/7/15 15:10,639,317,322,1212
136,2022/7/15 15:20,610,322,288,1211
136,2022/7/15 15:30,618,322,296,1340
136,2022/7/15 15:40,637,324,313,1420
136,2022/7/15 15:50,616,318,298,1012
136,2022/7/15 16:00,693,331,362,1872
136,2022/7/15 16:10,709,317,392,2260
136,2022/7/15 16:20,714,289,425,1936
136,2022/7/15 16:30,800,333,467,2626
136,2022/7/15 16:40,1163,326,837,3131
136,2022/7/15 16:50,1164,324,840,3260
136,2022/7/15 17:00,1659,324,1335,6737
136,2022/7/15 17:10,3407,316,3091,11073
136,2022/7/15 17:20,3328,485,2843,8253
136,2022/7/15 17:30,3332,398,2934,10024
136,2022/7/15 17:40,3705,410,3295,16140
136,2022/7/15 17:50,3670,412,3258,11274
136,2022/7/15 18:00,3488,454,3034,9181
136,2022/7/15 18:10,3730,468,3262,16610
136,2022/7/15 18:20,3669,407,3262,12915
136,2022/7/15 18:30,3466,470,2996,6926
136,2022/7/15 18:40,3413,471,2942,3515
136,2022/7/15 18:50,3468,393,3075,3736
136,2022/7/15 19:00,2551,471,2080,2967
136,2022/7/15 19:10,2549,319,2230,3878
136,2022/7/15 19:20,1982,249,1733,3331
136,2022/7/15 19:30,1583,227,1356,2172
136,2022/7/15 19:40,1340,225,1115,2534
136,2022/7/15 19:50,1191,106,1085,2350
136,2022/7/15 20:00,1197,119,1078,3033
136,2022/7/15 20:10,1192,120,1072,3211
136,2022/7/15 20:20,1151,120,1031,3084
136,2022/7/15 20:30,1012,121,891,2655
136,2022/7/15 20:40,1016,128,888,3087
136,2022/7/15 20:50,1010,100,910,2736
136,2022/7/15 21:00,1021,121,900,2962
136,2022/7/15 21:10,1180,119,1061,3222
136,2022/7/15 21:20,1013,116,897,2932
136,2022/7/15 21:30,889,127,762,2257
136,2022/7/15 21:40,836,104,732,2317
136,2022/7/15 21:50,668,117,551,1513
136,2022/7/15 22:00,1258,105,1153,2957
136,2022/7/15 22:10,802,105,697,1862
136,2022/7/15 22:20,363,86,277,243
136,2022/7/15 22:30,201,104,97,-678
136,2022/7/15 22:40,119,82,37,-753
136,2022/7/15 22:50,34,73,-39,-819
124,2022/7/15 5:00,1,1,0,-4
124,2022/7/15 5:10,8,1,7,46
124,2022/7/15 5:20,20,1,19,161
124,2022/7/15 5:30,20,6,14,202
124,2022/7/15 5:40,23,1,22,267
124,2022/7/15 5:50,32,1,31,190
124,2022/7/15 6:00,33,21,12,113
124,2022/7/15 6:10,40,75,-35,-38
124,2022/7/15 6:20,56,77,-21,-88
124,2022/7/15 6:30,79,68,11,73
124,2022/7/15 6:40,108,105,3,446
124,2022/7/15 6:50,155,160,-5,975
124,2022/7/15 7:00,196,216,-20,1207
124,2022/7/15 7:10,233,157,76,2235
124,2022/7/15 7:20,280,190,90,2683
124,2022/7/15 7:30,340,386,-46,2721
124,2022/7/15 7:40,597,431,166,1273
124,2022/7/15 7:50,722,580,142,-1249
124,2022/7/15 8:00,819,1870,-1051,-3562
124,2022/7/15 8:10,868,2581,-1713,-20542
124,2022/7/15 8:20,1183,2167,-984,-19313
124,2022/7/15 8:30,1054,6395,-5341,-35256
124,2022/7/15 8:40,734,7344,-6610,-53310
124,2022/7/15 8:50,715,6363,-5648,-39386
124,2022/7/15 9:00,579,2599,-2020,-32413
124,2022/7/15 9:10,434,1917,-1483,-24321
124,2022/7/15 9:20,340,571,-231,-14696
124,2022/7/15 9:30,269,557,-288,-9503
124,2022/7/15 9:40,252,414,-162,-9595
124,2022/7/15 9:50,219,320,-101,-6090
124,2022/7/15 10:00,204,255,-51,-2319
124,2022/7/15 10:10,212,214,-2,-1403
124,2022/7/15 10:20,190,154,36,-1091
124,2022/7/15 10:30,190,193,-3,-1234
124,2022/7/15 10:40,188,152,36,-1032
124,2022/7/15 10:50,161,112,49,-704
124,2022/7/15 11:00,168,119,49,-684
124,2022/7/15 11:10,173,119,54,-277
124,2022/7/15 11:20,173,119,54,-315
124,2022/7/15 11:30,200,112,88,-200
124,2022/7/15 11:40,209,111,98,-174
124,2022/7/15 11:50,203,121,82,-71
124,2022/7/15 12:00,209,144,65,-66
124,2022/7/15 12:10,226,119,107,358
124,2022/7/15 12:20,206,144,62,-5
124,2022/7/15 12:30,209,144,65,-288
124,2022/7/15 12:40,194,144,50,-336
124,2022/7/15 12:50,226,153,73,-336
124,2022/7/15 13:00,216,192,24,-487
124,2022/7/15 13:10,227,145,82,110
124,2022/7/15 13:20,229,179,50,-286
124,2022/7/15 13:30,217,178,39,395
124,2022/7/15 13:40,213,180,33,-226
124,2022/7/15 13:50,191,151,40,315
124,2022/7/15 14:00,197,150,47,-23
124,2022/7/15 14:10,208,146,62,663
124,2022/7/15 14:20,198,151,47,320
124,2022/7/15 14:30,204,181,23,843
124,2022/7/15 14:40,208,154,54,553
124,2022/7/15 14:50,203,127,76,982
124,2022/7/15 15:00,224,150,74,1137
124,2022/7/15 15:10,261,117,144,1356
124,2022/7/15 15:20,263,169,94,1305
124,2022/7/15 15:30,260,143,117,1457
124,2022/7/15 15:40,265,192,73,1493
124,2022/7/15 15:50,224,138,86,1098
124,2022/7/15 16:00,259,170,89,1961
124,2022/7/15 16:10,307,181,126,2386
124,2022/7/15 16:20,272,155,117,2053
124,2022/7/15 16:30,343,138,205,2831
124,2022/7/15 16:40,578,179,399,3530
124,2022/7/15 16:50,638,198,440,3700
124,2022/7/15 17:00,802,219,583,7320
124,2022/7/15 17:10,1189,194,995,12068
124,2022/7/15 17:20,1027,296,731,8984
124,2022/7/15 17:30,1148,324,824,10848
124,2022/7/15 17:40,1987,382,1605,17745
124,2022/7/15 17:50,1988,503,1485,12759
124,2022/7/15 18:00,1559,420,1139,10320
124,2022/7/15 18:10,2541,505,2036,18646
124,2022/7/15 18:20,2482,415,2067,14982
124,2022/7/15 18:30,1350,493,857,7783
124,2022/7/15 18:40,1355,437,918,4433
124,2022/7/15 18:50,1035,510,525,4261
124,2022/7/15 19:00,634,381,253,3220
124,2022/7/15 19:10,694,286,408,4286
124,2022/7/15 19:20,577,209,368,3699
124,2022/7/15 19:30,333,191,142,2314
124,2022/7/15 19:40,341,127,214,2748
124,2022/7/15 19:50,270,109,161,2511
124,2022/7/15 20:00,268,125,143,3176
124,2022/7/15 20:10,292,113,179,3390
124,2022/7/15 20:20,272,124,148,3232
124,2022/7/15 20:30,228,121,107,2762
124,2022/7/15 20:40,276,121,155,3242
124,2022/7/15 20:50,227,109,118,2854
124,2022/7/15 21:00,232,109,123,3085
124,2022/7/15 21:10,224,109,115,3337
124,2022/7/15 21:20,183,128,55,2987
124,2022/7/15 21:30,175,133,42,2299
124,2022/7/15 21:40,137,122,15,2332
124,2022/7/15 21:50,82,119,-37,1476
124,2022/7/15 22:00,67,112,-45,2912
124,2022/7/15 22:10,75,124,-49,1813
124,2022/7/15 22:20,42,111,-69,174
124,2022/7/15 22:30,28,122,-94,-772
124,2022/7/15 22:40,29,112,-83,-836
124,2022/7/15 22:50,18,96,-78,-897
140,2022/7/15 5:00,1,1,0,-4
140,2022/7/15 5:10,3,1,2,48
140,2022/7/15 5:20,4,1,3,164
140,2022/7/15 5:30,6,1,5,207
140,2022/7/15 5:40,7,2,5,272
140,2022/7/15 5:50,7,1,6,196
140,2022/7/15 6:00,12,19,-7,106
140,2022/7/15 6:10,15,62,-47,-85
140,2022/7/15 6:20,17,53,-36,-124
140,2022/7/15 6:30,30,34,-4,69
140,2022/7/15 6:40,32,72,-40,406
140,2022/7/15 6:50,43,90,-47,928
140,2022/7/15 7:00,47,105,-58,1149
140,2022/7/15 7:10,70,105,-35,2200
140,2022/7/15 7:20,138,122,16,2699
140,2022/7/15 7:30,156,128,28,2749
140,2022/7/15 7:40,249,197,52,1325
140,2022/7/15 7:50,251,233,18,-1231
140,2022/7/15 8:00,303,319,-16,-3578
140,2022/7/15 8:10,280,500,-220,-20762
140,2022/7/15 8:20,277,437,-160,-19473
140,2022/7/15 8:30,278,428,-150,-35406
140,2022/7/15 8:40,232,426,-194,-53504
140,2022/7/15 8:50,217,486,-269,-39655
140,2022/7/15 9:00,163,284,-121,-32534
140,2022/7/15 9:10,143,178,-35,-24356
140,2022/7/15 9:20,140,161,-21,-14717
140,2022/7/15 9:30,89,154,-65,-9568
140,2022/7/15 9:40,64,125,-61,-9656
140,2022/7/15 9:50,48,125,-77,-6167
140,2022/7/15 10:00,44,114,-70,-2389
140,2022/7/15 10:10,46,126,-80,-1483
140,2022/7/15 10:20,50,123,-73,-1164
140,2022/7/15 10:30,47,105,-58,-1292
140,2022/7/15 10:40,44,109,-65,-1097
140,2022/7/15 10:50,46,104,-58,-762
140,2022/7/15 11:00,55,109,-54,-738
140,2022/7/15 11:10,43,112,-69,-346
140,2022/7/15 11:20,49,99,-50,-365
140,2022/7/15 11:30,55,108,-53,-253
140,2022/7/15 11:40,53,102,-49,-223
140,2022/7/15 11:50,57,105,-48,-119
140,2022/7/15 12:00,53,106,-53,-119
140,2022/7/15 12:10,65,106,-41,317
140,2022/7/15 12:20,45,105,-60,-65
140,2022/7/15 12:30,53,116,-63,-351
140,2022/7/15 12:40,52,102,-50,-386
140,2022/7/15 12:50,44,110,-66,-402
140,2022/7/15 13:00,55,123,-68,-555
140,2022/7/15 13:10,45,109,-64,46
140,2022/7/15 13:20,53,122,-69,-355
140,2022/7/15 13:30,55,109,-54,341
140,2022/7/15 13:40,57,97,-40,-266
140,2022/7/15 13:50,60,118,-58,257
140,2022/7/15 14:00,62,123,-61,-84
140,2022/7/15 14:10,63,117,-54,609
140,2022/7/15 14:20,61,100,-39,281
140,2022/7/15 14:30,76,120,-44,799
140,2022/7/15 14:40,68,95,-27,526
140,2022/7/15 14:50,87,123,-36,946
140,2022/7/15 15:00,70,98,-28,1109
140,2022/7/15 15:10,119,104,15,1371
140,2022/7/15 15:20,127,103,24,1329
140,2022/7/15 15:30,104,95,9,1466
140,2022/7/15 15:40,129,104,25,1518
140,2022/7/15 15:50,85,126,-41,1057
140,2022/7/15 16:00,149,98,51,2012
140,2022/7/15 16:10,155,102,53,2439
140,2022/7/15 16:20,158,105,53,2106
140,2022/7/15 16:30,172,103,69,2900
140,2022/7/15 16:40,228,105,123,3653
140,2022/7/15 16:50,197,103,94,3794
140,2022/7/15 17:00,210,119,91,7411
140,2022/7/15 17:10,268,107,161,12229
140,2022/7/15 17:20,305,130,175,9159
140,2022/7/15 17:30,374,119,255,11103
140,2022/7/15 17:40,578,108,470,18215
140,2022/7/15 17:50,337,149,188,12947
140,2022/7/15 18:00,305,192,113,10433
140,2022/7/15 18:10,319,182,137,18783
140,2022/7/15 18:20,337,180,157,15139
140,2022/7/15 18:30,265,192,73,7856
140,2022/7/15 18:40,209,180,29,4462
140,2022/7/15 18:50,176,151,25,4286
140,2022/7/15 19:00,132,117,15,3235
140,2022/7/15 19:10,84,121,-37,4249
140,2022/7/15 19:20,82,121,-39,3660
140,2022/7/15 19:30,60,103,-43,2271
140,2022/7/15 19:40,65,106,-41,2707
140,2022/7/15 19:50,50,91,-41,2470
140,2022/7/15 20:00,45,88,-43,3133
140,2022/7/15 20:10,44,78,-34,3356
140,2022/7/15 20:20,38,72,-34,3198
140,2022/7/15 20:30,38,77,-39,2723
140,2022/7/15 20:40,29,66,-37,3205
140,2022/7/15 20:50,30,65,-35,2819
140,2022/7/15 21:00,25,70,-45,3040
140,2022/7/15 21:10,26,67,-41,3296
140,2022/7/15 21:20,22,70,-48,2939
140,2022/7/15 21:30,27,70,-43,2256
140,2022/7/15 21:40,41,61,-20,2312
140,2022/7/15 21:50,18,60,-42,1434
140,2022/7/15 22:00,21,66,-45,2867
140,2022/7/15 22:10,17,71,-54,1759
140,2022/7/15 22:20,13,53,-40,134
140,2022/7/15 22:30,8,49,-41,-813
140,2022/7/15 22:40,7,44,-37,-873
140,2022/7/15 22:50,4,40,-36,-933
141,2022/7/15 5:00,2,1,1,-3
141,2022/7/15 5:10,8,1,7,55
141,2022/7/15 5:20,7,1,6,170
141,2022/7/15 5:30,10,1,9,216
141,2022/7/15 5:40,13,1,12,284
141,2022/7/15 5:50,18,1,17,213
141,2022/7/15 6:00,29,1,28,134
141,2022/7/15 6:10,35,22,13,-72
141,2022/7/15 6:20,43,23,20,-104
141,2022/7/15 6:30,59,40,19,88
141,2022/7/15 6:40,62,62,0,406
141,2022/7/15 6:50,122,73,49,977
141,2022/7/15 7:00,176,88,88,1237
141,2022/7/15 7:10,234,103,131,2331
141,2022/7/15 7:20,343,124,219,2918
141,2022/7/15 7:30,598,110,488,3237
141,2022/7/15 7:40,825,108,717,2042
141,2022/7/15 7:50,1050,144,906,-325
141,2022/7/15 8:00,1361,110,1251,-2327
141,2022/7/15 8:10,1361,111,1250,-19512
141,2022/7/15 8:20,1214,153,1061,-18412
141,2022/7/15 8:30,1054,111,943,-34463
141,2022/7/15 8:40,738,150,588,-52916
141,2022/7/15 8:50,650,119,531,-39124
141,2022/7/15 9:00,575,103,472,-32062
141,2022/7/15 9:10,325,104,221,-24135
141,2022/7/15 9:20,271,93,178,-14539
141,2022/7/15 9:30,200,99,101,-9467
141,2022/7/15 9:40,156,90,66,-9590
141,2022/7/15 9:50,72,92,-20,-6187
141,2022/7/15 10:00,52,79,-27,-2416
141,2022/7/15 10:10,44,83,-39,-1522
141,2022/7/15 10:20,42,78,-36,-1200
141,2022/7/15 10:30,37,74,-37,-1329
141,2022/7/15 10:40,39,82,-43,-1140
141,2022/7/15 10:50,34,84,-50,-812
141,2022/7/15 11:00,31,82,-51,-789
141,2022/7/15 11:10,32,80,-48,-394
141,2022/7/15 11:20,35,75,-40,-405
141,2022/7/15 11:30,29,77,-48,-301
141,2022/7/15 11:40,33,84,-51,-274
141,2022/7/15 11:50,37,91,-54,-173
141,2022/7/15 12:00,37,77,-40,-159
141,2022/7/15 12:10,34,76,-42,275
141,2022/7/15 12:20,41,79,-38,-103
141,2022/7/15 12:30,41,93,-52,-403
141,2022/7/15 12:40,37,87,-50,-436
141,2022/7/15 12:50,38,90,-52,-454
141,2022/7/15 13:00,38,93,-55,-610
141,2022/7/15 13:10,36,94,-58,-12
141,2022/7/15 13:20,40,88,-48,-403
141,2022/7/15 13:30,36,92,-56,285
141,2022/7/15 13:40,37,95,-58,-324
141,2022/7/15 13:50,35,97,-62,195
141,2022/7/15 14:00,38,90,-52,-136
141,2022/7/15 14:10,33,93,-60,549
141,2022/7/15 14:20,30,102,-72,209
141,2022/7/15 14:30,35,99,-64,735
141,2022/7/15 14:40,32,93,-61,465
141,2022/7/15 14:50,32,93,-61,885
141,2022/7/15 15:00,34,101,-67,1042
141,2022/7/15 15:10,37,97,-60,1311
141,2022/7/15 15:20,42,101,-59,1270
141,2022/7/15 15:30,41,105,-64,1402
141,2022/7/15 15:40,37,100,-63,1455
141,2022/7/15 15:50,38,102,-64,993
141,2022/7/15 16:00,43,111,-68,1944
141,2022/7/15 16:10,42,101,-59,2380
141,2022/7/15 16:20,42,103,-61,2045
141,2022/7/15 16:30,52,99,-47,2853
141,2022/7/15 16:40,86,124,-38,3615
141,2022/7/15 16:50,81,114,-33,3761
141,2022/7/15 17:00,110,108,2,7413
141,2022/7/15 17:10,147,114,33,12262
141,2022/7/15 17:20,174,230,-56,9103
141,2022/7/15 17:30,222,324,-102,11001
141,2022/7/15 17:40,181,332,-151,18064
141,2022/7/15 17:50,132,334,-202,12745
141,2022/7/15 18:00,161,502,-341,10092
141,2022/7/15 18:10,128,507,-379,18404
141,2022/7/15 18:20,66,496,-430,14709
141,2022/7/15 18:30,50,421,-371,7485
141,2022/7/15 18:40,44,421,-377,4085
141,2022/7/15 18:50,38,508,-470,3816
141,2022/7/15 19:00,40,497,-457,2778
141,2022/7/15 19:10,28,320,-292,3957
141,2022/7/15 19:20,31,232,-201,3459
141,2022/7/15 19:30,32,179,-147,2124
141,2022/7/15 19:40,25,183,-158,2549
141,2022/7/15 19:50,29,183,-154,2316
141,2022/7/15 20:00,28,111,-83,3050
141,2022/7/15 20:10,27,117,-90,3266
141,2022/7/15 20:20,26,119,-93,3105
141,2022/7/15 20:30,23,111,-88,2635
141,2022/7/15 20:40,28,121,-93,3112
141,2022/7/15 20:50,26,110,-84,2735
141,2022/7/15 21:00,27,104,-77,2963
141,2022/7/15 21:10,30,107,-77,3219
141,2022/7/15 21:20,26,104,-78,2861
141,2022/7/15 21:30,25,110,-85,2171
141,2022/7/15 21:40,23,111,-88,2224
141,2022/7/15 21:50,22,104,-82,1352
141,2022/7/15 22:00,19,123,-104,2763
141,2022/7/15 22:10,20,125,-105,1654
141,2022/7/15 22:20,10,110,-100,34
141,2022/7/15 22:30,7,111,-104,-917
141,2022/7/15 22:40,7,97,-90,-963
141,2022/7/15 22:50,4,74,-70,-1003
134,2022/7/15 5:00,10,1,9,6
134,2022/7/15 5:10,17,1,16,71
134,2022/7/15 5:20,19,1,18,188
134,2022/7/15 5:30,26,1,25,241
134,2022/7/15 5:40,31,2,29,313
134,2022/7/15 5:50,55,1,54,267
134,2022/7/15 6:00,54,6,48,182
134,2022/7/15 6:10,143,23,120,48
134,2022/7/15 6:20,87,95,-8,-112
134,2022/7/15 6:30,256,88,168,256
134,2022/7/15 6:40,277,112,165,571
134,2022/7/15 6:50,302,110,192,1169
134,2022/7/15 7:00,345,104,241,1478
134,2022/7/15 7:10,639,217,422,2753
134,2022/7/15 7:20,663,298,365,3283
134,2022/7/15 7:30,869,299,570,3807
134,2022/7/15 7:40,1215,269,946,2988
134,2022/7/15 7:50,1632,327,1305,980
134,2022/7/15 8:00,1980,331,1649,-678
134,2022/7/15 8:10,1976,333,1643,-17869
134,2022/7/15 8:20,1977,298,1679,-16733
134,2022/7/15 8:30,1583,233,1350,-33113
134,2022/7/15 8:40,1201,221,980,-51936
134,2022/7/15 8:50,1167,196,971,-38153
134,2022/7/15 9:00,678,192,486,-31576
134,2022/7/15 9:10,653,153,500,-23635
134,2022/7/15 9:20,580,112,468,-14071
134,2022/7/15 9:30,338,151,187,-9280
134,2022/7/15 9:40,270,117,153,-9437
134,2022/7/15 9:50,209,105,104,-6083
134,2022/7/15 10:00,165,109,56,-2360
134,2022/7/15 10:10,142,113,29,-1493
134,2022/7/15 10:20,100,123,-23,-1223
134,2022/7/15 10:30,76,110,-34,-1363
134,2022/7/15 10:40,75,111,-36,-1176
134,2022/7/15 10:50,70,118,-48,-860
134,2022/7/15 11:00,73,123,-50,-839
134,2022/7/15 11:10,71,106,-35,-429
134,2022/7/15 11:20,72,108,-36,-441
134,2022/7/15 11:30,56,123,-67,-368
134,2022/7/15 11:40,78,118,-40,-314
134,2022/7/15 11:50,108,111,-3,-176
134,2022/7/15 12:00,82,109,-27,-186
134,2022/7/15 12:10,136,110,26,301
134,2022/7/15 12:20,162,127,35,-68
134,2022/7/15 12:30,135,115,20,-383
134,2022/7/15 12:40,163,122,41,-395
134,2022/7/15 12:50,155,108,47,-407
134,2022/7/15 13:00,137,111,26,-584
134,2022/7/15 13:10,119,109,10,-2
134,2022/7/15 13:20,126,112,14,-389
134,2022/7/15 13:30,137,114,23,308
134,2022/7/15 13:40,125,117,8,-316
134,2022/7/15 13:50,85,121,-36,159
134,2022/7/15 14:00,71,106,-35,-171
134,2022/7/15 14:10,84,111,-27,522
134,2022/7/15 14:20,109,107,2,211
134,2022/7/15 14:30,68,124,-56,679
134,2022/7/15 14:40,69,116,-47,418
134,2022/7/15 14:50,64,127,-63,822
134,2022/7/15 15:00,78,111,-33,1009
134,2022/7/15 15:10,89,110,-21,1290
134,2022/7/15 15:20,81,181,-100,1170
134,2022/7/15 15:30,71,181,-110,1292
134,2022/7/15 15:40,124,185,-61,1394
134,2022/7/15 15:50,118,159,-41,952
134,2022/7/15 16:00,132,178,-46,1898
134,2022/7/15 16:10,176,185,-9,2371
134,2022/7/15 16:20,174,197,-23,2022
134,2022/7/15 16:30,148,180,-32,2821
134,2022/7/15 16:40,195,197,-2,3613
134,2022/7/15 16:50,197,285,-88,3673
134,2022/7/15 17:00,273,296,-23,7390
134,2022/7/15 17:10,297,320,-23,12239
134,2022/7/15 17:20,341,377,-36,9067
134,2022/7/15 17:30,305,415,-110,10891
134,2022/7/15 17:40,455,421,34,18098
134,2022/7/15 17:50,370,603,-233,12512
134,2022/7/15 18:00,263,559,-296,9796
134,2022/7/15 18:10,285,1477,-1192,17212
134,2022/7/15 18:20,267,1097,-830,13879
134,2022/7/15 18:30,196,1539,-1343,6142
134,2022/7/15 18:40,183,1485,-1302,2783
134,2022/7/15 18:50,174,1094,-920,2896
134,2022/7/15 19:00,168,597,-429,2349
134,2022/7/15 19:10,138,422,-284,3673
134,2022/7/15 19:20,89,508,-419,3040
134,2022/7/15 19:30,137,381,-244,1880
134,2022/7/15 19:40,58,329,-271,2278
134,2022/7/15 19:50,127,284,-157,2159
134,2022/7/15 20:00,70,257,-187,2863
134,2022/7/15 20:10,89,180,-91,3175
134,2022/7/15 20:20,64,224,-160,2945
134,2022/7/15 20:30,93,159,-66,2569
134,2022/7/15 20:40,54,224,-170,2942
134,2022/7/15 20:50,83,146,-63,2672
134,2022/7/15 21:00,69,185,-116,2847
134,2022/7/15 21:10,76,139,-63,3156
134,2022/7/15 21:20,63,184,-121,2740
134,2022/7/15 21:30,68,169,-101,2070
134,2022/7/15 21:40,42,169,-127,2097
134,2022/7/15 21:50,43,119,-76,1276
134,2022/7/15 22:00,30,153,-123,2640
134,2022/7/15 22:10,25,121,-96,1558
134,2022/7/15 22:20,27,134,-107,-73
134,2022/7/15 22:30,15,120,-105,-1022
134,2022/7/15 22:40,9,111,-102,-1065
134,2022/7/15 22:50,14,107,-93,-1096
147,2022/7/15 5:00,0,1,-1,5
147,2022/7/15 5:10,2,1,1,72
147,2022/7/15 5:20,10,1,9,197
147,2022/7/15 5:30,21,1,20,261
147,2022/7/15 5:40,16,1,15,328
147,2022/7/15 5:50,25,1,24,291
147,2022/7/15 6:00,26,1,25,207
147,2022/7/15 6:10,29,1,28,76
147,2022/7/15 6:20,44,59,-15,-127
147,2022/7/15 6:30,77,73,4,260
147,2022/7/15 6:40,59,109,-50,521
147,2022/7/15 6:50,81,104,-23,1146
147,2022/7/15 7:00,149,175,-26,1452
147,2022/7/15 7:10,188,229,-41,2712
147,2022/7/15 7:20,190,501,-311,2972
147,2022/7/15 7:30,282,558,-276,3531
147,2022/7/15 7:40,320,1521,-1201,1787
147,2022/7/15 7:50,436,2526,-2090,-1110
147,2022/7/15 8:00,467,3161,-2694,-3372
147,2022/7/15 8:10,443,4070,-3627,-21496
147,2022/7/15 8:20,324,5045,-4721,-21454
147,2022/7/15 8:30,280,4302,-4022,-37135
147,2022/7/15 8:40,267,3560,-3293,-55229
147,2022/7/15 8:50,231,3243,-3012,-41165
147,2022/7/15 9:00,215,3274,-3059,-34635
147,2022/7/15 9:10,168,2827,-2659,-26294
147,2022/7/15 9:20,162,2520,-2358,-16429
147,2022/7/15 9:30,92,1684,-1592,-10872
147,2022/7/15 9:40,116,624,-508,-9945
147,2022/7/15 9:50,76,499,-423,-6506
147,2022/7/15 10:00,65,363,-298,-2658
147,2022/7/15 10:10,67,196,-129,-1622
147,2022/7/15 10:20,63,179,-116,-1339
147,2022/7/15 10:30,65,137,-72,-1435
147,2022/7/15 10:40,58,107,-49,-1225
147,2022/7/15 10:50,69,104,-35,-895
147,2022/7/15 11:00,69,109,-40,-879
147,2022/7/15 11:10,81,124,-43,-472
147,2022/7/15 11:20,88,111,-23,-464
147,2022/7/15 11:30,132,110,22,-346
147,2022/7/15 11:40,147,105,42,-272
147,2022/7/15 11:50,149,111,38,-138
147,2022/7/15 12:00,169,108,61,-125
147,2022/7/15 12:10,186,133,53,354
147,2022/7/15 12:20,157,125,32,-36
147,2022/7/15 12:30,175,109,66,-317
147,2022/7/15 12:40,148,117,31,-364
147,2022/7/15 12:50,162,152,10,-397
147,2022/7/15 13:00,125,108,17,-567
147,2022/7/15 13:10,137,111,26,24
147,2022/7/15 13:20,136,107,29,-360
147,2022/7/15 13:30,139,129,10,318
147,2022/7/15 13:40,145,125,20,-296
147,2022/7/15 13:50,137,110,27,186
147,2022/7/15 14:00,136,108,28,-143
147,2022/7/15 14:10,120,109,11,533
147,2022/7/15 14:20,129,121,8,219
147,2022/7/15 14:30,161,102,59,738
147,2022/7/15 14:40,124,111,13,431
147,2022/7/15 14:50,113,119,-6,816
147,2022/7/15 15:00,141,126,15,1024
147,2022/7/15 15:10,184,122,62,1352
147,2022/7/15 15:20,197,121,76,1246
147,2022/7/15 15:30,265,104,161,1453
147,2022/7/15 15:40,230,116,114,1508
147,2022/7/15 15:50,215,129,86,1038
147,2022/7/15 16:00,271,116,155,2053
147,2022/7/15 16:10,338,109,229,2600
147,2022/7/15 16:20,272,122,150,2172
147,2022/7/15 16:30,568,105,463,3284
147,2022/7/15 16:40,637,108,529,4142
147,2022/7/15 16:50,638,133,505,4178
147,2022/7/15 17:00,814,152,662,8052
147,2022/7/15 17:10,1558,150,1408,13647
147,2022/7/15 17:20,1620,183,1437,10504
147,2022/7/15 17:30,1354,231,1123,12014
147,2022/7/15 17:40,2546,255,2291,20389
147,2022/7/15 17:50,2534,268,2266,14778
147,2022/7/15 18:00,1557,323,1234,11030
147,2022/7/15 18:10,2534,329,2205,19417
147,2022/7/15 18:20,2530,319,2211,16090
147,2022/7/15 18:30,1610,319,1291,7433
147,2022/7/15 18:40,1641,494,1147,3930
147,2022/7/15 18:50,1191,318,873,3769
147,2022/7/15 19:00,825,377,448,2797
147,2022/7/15 19:10,805,319,486,4159
147,2022/7/15 19:20,655,222,433,3473
147,2022/7/15 19:30,587,222,365,2245
147,2022/7/15 19:40,583,98,485,2763
147,2022/7/15 19:50,309,177,132,2291
147,2022/7/15 20:00,318,109,209,3072
147,2022/7/15 20:10,315,150,165,3340
147,2022/7/15 20:20,268,111,157,3102
147,2022/7/15 20:30,258,120,138,2707
147,2022/7/15 20:40,276,104,172,3114
147,2022/7/15 20:50,202,114,88,2760
147,2022/7/15 21:00,203,123,80,2927
147,2022/7/15 21:10,237,105,132,3288
147,2022/7/15 21:20,178,109,69,2809
147,2022/7/15 21:30,77,111,-34,2036
147,2022/7/15 21:40,66,121,-55,2042
147,2022/7/15 21:50,44,122,-78,1198
147,2022/7/15 22:00,42,123,-81,2559
147,2022/7/15 22:10,35,96,-61,1497
147,2022/7/15 22:20,30,126,-96,-169
147,2022/7/15 22:30,19,105,-86,-1108
147,2022/7/15 22:40,13,70,-57,-1122
147,2022/7/15 22:50,4,105,-101,-1197
131,2022/7/15 5:00,0,1,-1,4
131,2022/7/15 5:10,3,1,2,74
131,2022/7/15 5:20,17,1,16,213
131,2022/7/15 5:30,10,1,9,270
131,2022/7/15 5:40,18,1,17,345
131,2022/7/15 5:50,19,2,17,308
131,2022/7/15 6:00,31,2,29,236
131,2022/7/15 6:10,30,1,29,105
131,2022/7/15 6:20,55,47,8,-119
131,2022/7/15 6:30,46,68,-22,238
131,2022/7/15 6:40,88,77,11,532
131,2022/7/15 6:50,87,100,-13,1133
131,2022/7/15 7:00,170,105,65,1517
131,2022/7/15 7:10,233,122,111,2823
131,2022/7/15 7:20,352,297,55,3027
131,2022/7/15 7:30,662,536,126,3657
131,2022/7/15 7:40,680,477,203,1990
131,2022/7/15 7:50,1181,1532,-351,-1461
131,2022/7/15 8:00,1165,2378,-1213,-4585
131,2022/7/15 8:10,1062,3335,-2273,-23769
131,2022/7/15 8:20,691,2896,-2205,-23659
131,2022/7/15 8:30,591,4883,-4292,-41427
131,2022/7/15 8:40,371,6126,-5755,-60984
131,2022/7/15 8:50,365,4759,-4394,-45559
131,2022/7/15 9:00,271,2353,-2082,-36717
131,2022/7/15 9:10,273,3085,-2812,-29106
131,2022/7/15 9:20,215,2861,-2646,-19075
131,2022/7/15 9:30,145,2091,-1946,-12818
131,2022/7/15 9:40,79,1637,-1558,-11503
131,2022/7/15 9:50,59,699,-640,-7146
131,2022/7/15 10:00,58,432,-374,-3032
131,2022/7/15 10:10,53,268,-215,-1837
131,2022/7/15 10:20,41,208,-167,-1506
131,2022/7/15 10:30,44,115,-71,-1506
131,2022/7/15 10:40,45,150,-105,-1330
131,2022/7/15 10:50,46,109,-63,-958
131,2022/7/15 11:00,48,115,-67,-946
131,2022/7/15 11:10,51,115,-64,-536
131,2022/7/15 11:20,48,123,-75,-539
131,2022/7/15 11:30,64,117,-53,-399
131,2022/7/15 11:40,65,123,-58,-330
131,2022/7/15 11:50,75,119,-44,-182
131,2022/7/15 12:00,86,106,-20,-145
131,2022/7/15 12:10,109,121,-12,342
131,2022/7/15 12:20,130,96,34,-2
131,2022/7/15 12:30,84,103,-19,-336
131,2022/7/15 12:40,84,130,-46,-410
131,2022/7/15 12:50,137,117,20,-377
131,2022/7/15 13:00,91,108,-17,-584
131,2022/7/15 13:10,91,114,-23,1
131,2022/7/15 13:20,125,114,11,-349
131,2022/7/15 13:30,71,108,-37,281
131,2022/7/15 13:40,70,108,-38,-334
131,2022/7/15 13:50,72,87,-15,171
131,2022/7/15 14:00,64,123,-59,-202
131,2022/7/15 14:10,72,127,-55,478
131,2022/7/15 14:20,71,117,-46,173
131,2022/7/15 14:30,66,103,-37,701
131,2022/7/15 14:40,81,118,-37,394
131,2022/7/15 14:50,80,86,-6,810
131,2022/7/15 15:00,82,106,-24,1000
131,2022/7/15 15:10,126,105,21,1373
131,2022/7/15 15:20,133,104,29,1275
131,2022/7/15 15:30,125,107,18,1471
131,2022/7/15 15:40,127,104,23,1531
131,2022/7/15 15:50,124,104,20,1058
131,2022/7/15 16:00,196,114,82,2135
131,2022/7/15 16:10,211,105,106,2706
131,2022/7/15 16:20,214,99,115,2287
131,2022/7/15 16:30,275,98,177,3461
131,2022/7/15 16:40,696,103,593,4735
131,2022/7/15 16:50,575,122,453,4631
131,2022/7/15 17:00,803,111,692,8744
131,2022/7/15 17:10,1587,116,1471,15118
131,2022/7/15 17:20,1349,182,1167,11671
131,2022/7/15 17:30,1587,158,1429,13443
131,2022/7/15 17:40,2555,212,2343,22732
131,2022/7/15 17:50,1990,268,1722,16500
131,2022/7/15 18:00,1618,334,1284,12314
131,2022/7/15 18:10,3061,377,2684,22101
131,2022/7/15 18:20,2558,382,2176,18266
131,2022/7/15 18:30,1989,435,1554,8987
131,2022/7/15 18:40,1591,378,1213,5143
131,2022/7/15 18:50,1194,532,662,4431
131,2022/7/15 19:00,809,383,426,3223
131,2022/7/15 19:10,703,336,367,4526
131,2022/7/15 19:20,574,269,305,3778
131,2022/7/15 19:30,574,219,355,2600
131,2022/7/15 19:40,577,118,459,3222
131,2022/7/15 19:50,318,212,106,2397
131,2022/7/15 20:00,429,115,314,3386
131,2022/7/15 20:10,324,117,207,3547
131,2022/7/15 20:20,271,125,146,3248
131,2022/7/15 20:30,271,110,161,2868
131,2022/7/15 20:40,268,109,159,3273
131,2022/7/15 20:50,277,103,174,2934
131,2022/7/15 21:00,267,97,170,3097
131,2022/7/15 21:10,274,90,184,3472
131,2022/7/15 21:20,239,102,137,2946
131,2022/7/15 21:30,187,85,102,2138
131,2022/7/15 21:40,165,104,61,2103
131,2022/7/15 21:50,81,104,-23,1175
131,2022/7/15 22:00,169,103,66,2625
131,2022/7/15 22:10,46,109,-63,1434
131,2022/7/15 22:20,24,104,-80,-249
131,2022/7/15 22:30,25,100,-75,-1183
131,2022/7/15 22:40,12,80,-68,-1190
131,2022/7/15 22:50,5,75,-70,-1267
125,2022/7/15 5:00,0,1,-1,3
125,2022/7/15 5:10,19,1,18,92
125,2022/7/15 5:20,40,1,39,252
125,2022/7/15 5:30,32,1,31,301
125,2022/7/15 5:40,54,1,53,398
125,2022/7/15 5:50,77,1,76,384
125,2022/7/15 6:00,86,1,85,321
125,2022/7/15 6:10,108,1,107,212
125,2022/7/15 6:20,194,45,149,30
125,2022/7/15 6:30,185,50,135,373
125,2022/7/15 6:40,281,72,209,741
125,2022/7/15 6:50,347,63,284,1417
125,2022/7/15 7:00,602,106,496,2013
125,2022/7/15 7:10,684,92,592,3415
125,2022/7/15 7:20,1158,177,981,4008
125,2022/7/15 7:30,1982,268,1714,5371
125,2022/7/15 7:40,2555,512,2043,4033
125,2022/7/15 7:50,3279,441,2838,1377
125,2022/7/15 8:00,3287,1075,2212,-2373
125,2022/7/15 8:10,3262,1489,1773,-21996
125,2022/7/15 8:20,2544,1493,1051,-22608
125,2022/7/15 8:30,1969,1717,252,-41175
125,2022/7/15 8:40,1553,1680,-127,-61111
125,2022/7/15 8:50,1047,1061,-14,-45573
125,2022/7/15 9:00,861,573,288,-36429
125,2022/7/15 9:10,690,573,117,-28989
125,2022/7/15 9:20,357,421,-64,-19139
125,2022/7/15 9:30,269,524,-255,-13073
125,2022/7/15 9:40,237,368,-131,-11634
125,2022/7/15 9:50,201,216,-15,-7161
125,2022/7/15 10:00,108,121,-13,-3045
125,2022/7/15 10:10,131,119,12,-1825
125,2022/7/15 10:20,75,108,-33,-1539
125,2022/7/15 10:30,65,100,-35,-1541
125,2022/7/15 10:40,73,104,-31,-1361
125,2022/7/15 10:50,71,101,-30,-988
125,2022/7/15 11:00,58,112,-54,-1000
125,2022/7/15 11:10,79,93,-14,-550
125,2022/7/15 11:20,66,113,-47,-586
125,2022/7/15 11:30,72,108,-36,-435
125,2022/7/15 11:40,75,113,-38,-368
125,2022/7/15 11:50,89,103,-14,-196
125,2022/7/15 12:00,86,105,-19,-164
125,2022/7/15 12:10,128,110,18,360
125,2022/7/15 12:20,136,102,34,32
125,2022/7/15 12:30,95,104,-9,-345
125,2022/7/15 12:40,94,114,-20,-430
125,2022/7/15 12:50,110,103,7,-370
125,2022/7/15 13:00,97,99,-2,-586
125,2022/7/15 13:10,79,103,-24,-23
125,2022/7/15 13:20,83,106,-23,-372
125,2022/7/15 13:30,82,111,-29,252
125,2022/7/15 13:40,72,102,-30,-364
125,2022/7/15 13:50,71,100,-29,142
125,2022/7/15 14:00,57,116,-59,-261
125,2022/7/15 14:10,61,105,-44,434
125,2022/7/15 14:20,57,107,-50,123
125,2022/7/15 14:30,60,119,-59,642
125,2022/7/15 14:40,68,102,-34,360
125,2022/7/15 14:50,53,124,-71,739
125,2022/7/15 15:00,59,126,-67,933
125,2022/7/15 15:10,71,107,-36,1337
125,2022/7/15 15:20,64,118,-54,1221
125,2022/7/15 15:30,60,106,-46,1425
125,2022/7/15 15:40,64,109,-45,1486
125,2022/7/15 15:50,73,98,-25,1033
125,2022/7/15 16:00,69,125,-56,2079
125,2022/7/15 16:10,132,124,8,2714
125,2022/7/15 16:20,114,133,-19,2268
125,2022/7/15 16:30,130,133,-3,3458
125,2022/7/15 16:40,225,144,81,4816
125,2022/7/15 16:50,259,138,121,4752
125,2022/7/15 17:00,349,175,174,8918
125,2022/7/15 17:10,653,219,434,15552
125,2022/7/15 17:20,1156,252,904,12575
125,2022/7/15 17:30,1148,281,867,14310
125,2022/7/15 17:40,1564,383,1181,23913
125,2022/7/15 17:50,1589,424,1165,17665
125,2022/7/15 18:00,1396,398,998,13312
125,2022/7/15 18:10,1367,572,795,22896
125,2022/7/15 18:20,1406,572,834,19100
125,2022/7/15 18:30,833,1079,-246,8741
125,2022/7/15 18:40,633,1498,-865,4278
125,2022/7/15 18:50,587,1576,-989,3442
125,2022/7/15 19:00,359,1533,-1174,2049
125,2022/7/15 19:10,307,1510,-1203,3323
125,2022/7/15 19:20,258,557,-299,3479
125,2022/7/15 19:30,208,426,-218,2382
125,2022/7/15 19:40,138,377,-239,2983
125,2022/7/15 19:50,152,430,-278,2119
125,2022/7/15 20:00,115,321,-206,3180
125,2022/7/15 20:10,160,318,-158,3389
125,2022/7/15 20:20,174,148,26,3274
125,2022/7/15 20:30,92,378,-286,2582
125,2022/7/15 20:40,93,321,-228,3045
125,2022/7/15 20:50,79,256,-177,2757
125,2022/7/15 21:00,70,225,-155,2942
125,2022/7/15 21:10,98,277,-179,3293
125,2022/7/15 21:20,63,233,-170,2776
125,2022/7/15 21:30,48,197,-149,1989
125,2022/7/15 21:40,35,257,-222,1881
125,2022/7/15 21:50,33,196,-163,1012
125,2022/7/15 22:00,24,186,-162,2463
125,2022/7/15 22:10,23,186,-163,1271
125,2022/7/15 22:20,22,186,-164,-413
125,2022/7/15 22:30,13,240,-227,-1410
125,2022/7/15 22:40,2,221,-219,-1409
125,2022/7/15 22:50,0,124,-124,-1391
143,2022/7/15 5:00,0,1,-1,2
143,2022/7/15 5:10,0,1,-1,91
143,2022/7/15 5:20,0,1,-1,251
143,2022/7/15 5:30,0,1,-1,300
143,2022/7/15 5:40,1,1,0,398
143,2022/7/15 5:50,13,1,12,396
143,2022/7/15 6:00,14,2,12,333
143,2022/7/15 6:10,30,2,28,240
143,2022/7/15 6:20,59,6,53,83
143,2022/7/15 6:30,112,47,65,438
143,2022/7/15 6:40,162,51,111,852
143,2022/7/15 6:50,213,44,169,1586
143,2022/7/15 7:00,283,73,210,2223
143,2022/7/15 7:10,442,68,374,3789
143,2022/7/15 7:20,705,108,597,4605
143,2022/7/15 7:30,1216,100,1116,6487
143,2022/7/15 7:40,1366,150,1216,5249
143,2022/7/15 7:50,1367,114,1253,2630
143,2022/7/15 8:00,1177,193,984,-1389
143,2022/7/15 8:10,734,222,512,-21484
143,2022/7/15 8:20,740,115,625,-21983
143,2022/7/15 8:30,720,153,567,-40608
143,2022/7/15 8:40,594,153,441,-60670
143,2022/7/15 8:50,457,102,355,-45218
143,2022/7/15 9:00,340,95,245,-36184
143,2022/7/15 9:10,227,105,122,-28867
143,2022/7/15 9:20,177,73,104,-19035
143,2022/7/15 9:30,122,93,29,-13044
143,2022/7/15 9:40,72,97,-25,-11659
143,2022/7/15 9:50,44,70,-26,-7187
143,2022/7/15 10:00,52,75,-23,-3068
143,2022/7/15 10:10,36,82,-46,-1871
143,2022/7/15 10:20,29,45,-16,-1555
143,2022/7/15 10:30,32,75,-43,-1584
143,2022/7/15 10:40,36,68,-32,-1393
143,2022/7/15 10:50,28,75,-47,-1035
143,2022/7/15 11:00,29,62,-33,-1033
143,2022/7/15 11:10,36,69,-33,-583
143,2022/7/15 11:20,40,64,-24,-610
143,2022/7/15 11:30,37,69,-32,-467
143,2022/7/15 11:40,35,76,-41,-409
143,2022/7/15 11:50,40,110,-70,-266
143,2022/7/15 12:00,54,72,-18,-182
143,2022/7/15 12:10,40,72,-32,328
143,2022/7/15 12:20,47,72,-25,7
143,2022/7/15 12:30,59,71,-12,-357
143,2022/7/15 12:40,44,92,-48,-478
143,2022/7/15 12:50,40,93,-53,-423
143,2022/7/15 13:00,43,72,-29,-615
143,2022/7/15 13:10,36,69,-33,-56
143,2022/7/15 13:20,44,72,-28,-400
143,2022/7/15 13:30,32,69,-37,215
143,2022/7/15 13:40,26,109,-83,-447
143,2022/7/15 13:50,40,72,-32,110
143,2022/7/15 14:00,32,73,-41,-302
143,2022/7/15 14:10,26,68,-42,392
143,2022/7/15 14:20,24,81,-57,66
143,2022/7/15 14:30,33,76,-43,599
143,2022/7/15 14:40,26,99,-73,287
143,2022/7/15 14:50,23,72,-49,690
143,2022/7/15 15:00,22,90,-68,865
143,2022/7/15 15:10,31,78,-47,1290
143,2022/7/15 15:20,25,76,-51,1170
143,2022/7/15 15:30,33,121,-88,1337
143,2022/7/15 15:40,25,87,-62,1424
143,2022/7/15 15:50,28,91,-63,970
143,2022/7/15 16:00,33,88,-55,2024
143,2022/7/15 16:10,30,109,-79,2635
143,2022/7/15 16:20,41,108,-67,2201
143,2022/7/15 16:30,30,110,-80,3378
143,2022/7/15 16:40,41,105,-64,4752
143,2022/7/15 16:50,39,105,-66,4686
143,2022/7/15 17:00,38,123,-85,8833
143,2022/7/15 17:10,73,106,-33,15519
143,2022/7/15 17:20,82,190,-108,12467
143,2022/7/15 17:30,156,111,45,14355
143,2022/7/15 17:40,140,195,-55,23858
143,2022/7/15 17:50,126,297,-171,17494
143,2022/7/15 18:00,63,224,-161,13151
143,2022/7/15 18:10,58,508,-450,22446
143,2022/7/15 18:20,64,268,-204,18896
143,2022/7/15 18:30,57,492,-435,8306
143,2022/7/15 18:40,44,484,-440,3838
143,2022/7/15 18:50,38,429,-391,3051
143,2022/7/15 19:00,33,433,-400,1649
143,2022/7/15 19:10,29,364,-335,2988
143,2022/7/15 19:20,30,434,-404,3075
143,2022/7/15 19:30,22,224,-202,2180
143,2022/7/15 19:40,26,340,-314,2669
143,2022/7/15 19:50,25,191,-166,1953
143,2022/7/15 20:00,25,215,-190,2990
143,2022/7/15 20:10,27,191,-164,3225
143,2022/7/15 20:20,24,110,-86,3188
143,2022/7/15 20:30,25,169,-144,2438
143,2022/7/15 20:40,23,122,-99,2946
143,2022/7/15 20:50,22,119,-97,2660
143,2022/7/15 21:00,17,191,-174,2768
143,2022/7/15 21:10,17,91,-74,3219
143,2022/7/15 21:20,18,178,-160,2616
143,2022/7/15 21:30,16,106,-90,1899
143,2022/7/15 21:40,12,151,-139,1742
143,2022/7/15 21:50,12,115,-103,909
143,2022/7/15 22:00,6,104,-98,2365
143,2022/7/15 22:10,4,105,-101,1170
143,2022/7/15 22:20,2,107,-105,-518
143,2022/7/15 22:30,1,47,-46,-1456
143,2022/7/15 22:40,0,3,-3,-1412
143,2022/7/15 22:50,0,3,-3,-1394
123,2022/7/15 5:00,0,1,-1,1
123,2022/7/15 5:10,0,1,-1,90
123,2022/7/15 5:20,0,1,-1,250
123,2022/7/15 5:30,0,1,-1,299
123,2022/7/15 5:40,0,1,-1,397
123,2022/7/15 5:50,1,1,0,396
123,2022/7/15 6:00,4,1,3,336
123,2022/7/15 6:10,16,1,15,255
123,2022/7/15 6:20,27,2,25,108
123,2022/7/15 6:30,19,6,13,451
123,2022/7/15 6:40,27,16,11,863
123,2022/7/15 6:50,29,8,21,1607
123,2022/7/15 7:00,28,14,14,2237
123,2022/7/15 7:10,34,33,1,3790
123,2022/7/15 7:20,35,21,14,4619
123,2022/7/15 7:30,41,50,-9,6478
123,2022/7/15 7:40,59,34,25,5274
123,2022/7/15 7:50,73,53,20,2650
123,2022/7/15 8:00,57,48,9,-1380
123,2022/7/15 8:10,42,42,0,-21484
123,2022/7/15 8:20,31,56,-25,-22008
123,2022/7/15 8:30,28,47,-19,-40627
123,2022/7/15 8:40,21,32,-11,-60681
123,2022/7/15 8:50,16,44,-28,-45246
123,2022/7/15 9:00,12,33,-21,-36205
123,2022/7/15 9:10,11,22,-11,-28878
123,2022/7/15 9:20,9,23,-14,-19049
123,2022/7/15 9:30,10,22,-12,-13056
123,2022/7/15 9:40,11,19,-8,-11667
123,2022/7/15 9:50,8,30,-22,-7209
123,2022/7/15 10:00,7,23,-16,-3084
123,2022/7/15 10:10,8,11,-3,-1874
123,2022/7/15 10:20,6,21,-15,-1570
123,2022/7/15 10:30,5,19,-14,-1598
123,2022/7/15 10:40,5,16,-11,-1404
123,2022/7/15 10:50,6,11,-5,-1040
123,2022/7/15 11:00,5,19,-14,-1047
123,2022/7/15 11:10,7,23,-16,-599
123,2022/7/15 11:20,6,12,-6,-616
123,2022/7/15 11:30,7,19,-12,-479
123,2022/7/15 11:40,8,19,-11,-420
123,2022/7/15 11:50,5,16,-11,-277
123,2022/7/15 12:00,9,19,-10,-192
123,2022/7/15 12:10,8,21,-13,315
123,2022/7/15 12:20,8,19,-11,-4
123,2022/7/15 12:30,9,16,-7,-364
123,2022/7/15 12:40,7,14,-7,-485
123,2022/7/15 12:50,7,19,-12,-435
123,2022/7/15 13:00,7,23,-16,-631
123,2022/7/15 13:10,7,23,-16,-72
123,2022/7/15 13:20,6,14,-8,-408
123,2022/7/15 13:30,7,18,-11,204
123,2022/7/15 13:40,6,21,-15,-462
123,2022/7/15 13:50,8,19,-11,99
123,2022/7/15 14:00,6,25,-19,-321
123,2022/7/15 14:10,6,23,-17,375
123,2022/7/15 14:20,6,19,-13,53
123,2022/7/15 14:30,4,23,-19,580
123,2022/7/15 14:40,6,21,-15,272
123,2022/7/15 14:50,6,31,-25,665
123,2022/7/15 15:00,6,19,-13,852
123,2022/7/15 15:10,5,23,-18,1272
123,2022/7/15 15:20,6,21,-15,1155
123,2022/7/15 15:30,6,21,-15,1322
123,2022/7/15 15:40,5,21,-16,1408
123,2022/7/15 15:50,6,25,-19,951
123,2022/7/15 16:00,7,23,-16,2008
123,2022/7/15 16:10,8,21,-13,2622
123,2022/7/15 16:20,9,25,-16,2185
123,2022/7/15 16:30,11,23,-12,3366
123,2022/7/15 16:40,21,23,-2,4750
123,2022/7/15 16:50,14,42,-28,4658
123,2022/7/15 17:00,14,23,-9,8824
123,2022/7/15 17:10,18,38,-20,15499
123,2022/7/15 17:20,15,25,-10,12457
123,2022/7/15 17:30,12,46,-34,14321
123,2022/7/15 17:40,16,50,-34,23824
123,2022/7/15 17:50,19,42,-23,17471
123,2022/7/15 18:00,14,51,-37,13114
123,2022/7/15 18:10,9,38,-29,22417
123,2022/7/15 18:20,10,73,-63,18833
123,2022/7/15 18:30,7,50,-43,8263
123,2022/7/15 18:40,6,69,-63,3775
123,2022/7/15 18:50,7,75,-68,2983
123,2022/7/15 19:00,8,50,-42,1607
123,2022/7/15 19:10,5,67,-62,2926
123,2022/7/15 19:20,5,39,-34,3041
123,2022/7/15 19:30,5,60,-55,2125
123,2022/7/15 19:40,3,38,-35,2634
123,2022/7/15 19:50,3,40,-37,1916
123,2022/7/15 20:00,3,40,-37,2953
123,2022/7/15 20:10,2,25,-23,3202
123,2022/7/15 20:20,2,33,-31,3157
123,2022/7/15 20:30,2,25,-23,2415
123,2022/7/15 20:40,2,40,-38,2908
123,2022/7/15 20:50,1,25,-24,2636
123,2022/7/15 21:00,1,39,-38,2730
123,2022/7/15 21:10,2,31,-29,3190
123,2022/7/15 21:20,1,32,-31,2585
123,2022/7/15 21:30,2,36,-34,1865
123,2022/7/15 21:40,1,21,-20,1722
123,2022/7/15 21:50,1,35,-34,875
123,2022/7/15 22:00,0,32,-32,2333
123,2022/7/15 22:10,0,21,-21,1149
123,2022/7/15 22:20,0,18,-18,-536
123,2022/7/15 22:30,0,21,-21,-1477
123,2022/7/15 22:40,0,3,-3,-1415
123,2022/7/15 22:50,0,3,-3,-1397
129,2022/7/15 5:00,0,1,-1,0
129,2022/7/15 5:10,0,1,-1,89
129,2022/7/15 5:20,0,1,-1,249
129,2022/7/15 5:30,0,1,-1,298
129,2022/7/15 5:40,0,1,-1,396
129,2022/7/15 5:50,7,1,6,402
129,2022/7/15 6:00,23,1,22,358
129,2022/7/15 6:10,50,1,49,304
129,2022/7/15 6:20,79,8,71,179
129,2022/7/15 6:30,87,8,79,530
129,2022/7/15 6:40,168,50,118,981
129,2022/7/15 6:50,206,47,159,1766
129,2022/7/15 7:00,245,62,183,2420
129,2022/7/15 7:10,344,60,284,4074
129,2022/7/15 7:20,590,73,517,5136
129,2022/7/15 7:30,722,40,682,7160
129,2022/7/15 7:40,830,75,755,6029
129,2022/7/15 7:50,838,62,776,3426
129,2022/7/15 8:00,735,84,651,-729
129,2022/7/15 8:10,688,87,601,-20883
129,2022/7/15 8:20,593,51,542,-21466
129,2022/7/15 8:30,347,85,262,-40365
129,2022/7/15 8:40,236,75,161,-60520
129,2022/7/15 8:50,223,57,166,-45080
129,2022/7/15 9:00,149,68,81,-36124
129,2022/7/15 9:10,77,65,12,-28866
129,2022/7/15 9:20,60,54,6,-19043
129,2022/7/15 9:30,48,68,-20,-13076
129,2022/7/15 9:40,41,70,-29,-11696
129,2022/7/15 9:50,36,49,-13,-7222
129,2022/7/15 10:00,31,62,-31,-3115
129,2022/7/15 10:10,30,73,-43,-1917
129,2022/7/15 10:20,28,50,-22,-1592
129,2022/7/15 10:30,27,64,-37,-1635
129,2022/7/15 10:40,25,59,-34,-1438
129,2022/7/15 10:50,30,45,-15,-1055
129,2022/7/15 11:00,25,53,-28,-1075
129,2022/7/15 11:10,26,52,-26,-625
129,2022/7/15 11:20,29,54,-25,-641
129,2022/7/15 11:30,30,68,-38,-517
129,2022/7/15 11:40,31,57,-26,-446
129,2022/7/15 11:50,29,57,-28,-305
129,2022/7/15 12:00,25,52,-27,-219
129,2022/7/15 12:10,28,51,-23,292
129,2022/7/15 12:20,33,55,-22,-26
129,2022/7/15 12:30,27,86,-59,-423
129,2022/7/15 12:40,29,57,-28,-513
129,2022/7/15 12:50,27,64,-37,-472
129,2022/7/15 13:00,27,59,-32,-663
129,2022/7/15 13:10,28,49,-21,-93
129,2022/7/15 13:20,28,69,-41,-449
129,2022/7/15 13:30,29,72,-43,161
129,2022/7/15 13:40,28,61,-33,-495
129,2022/7/15 13:50,24,53,-29,70
129,2022/7/15 14:00,24,52,-28,-349
129,2022/7/15 14:10,25,63,-38,337
129,2022/7/15 14:20,24,77,-53,0
129,2022/7/15 14:30,22,72,-50,530
129,2022/7/15 14:40,22,64,-42,230
129,2022/7/15 14:50,23,60,-37,628
129,2022/7/15 15:00,22,67,-45,807
129,2022/7/15 15:10,24,67,-43,1229
129,2022/7/15 15:20,22,96,-74,1081
129,2022/7/15 15:30,22,75,-53,1269
129,2022/7/15 15:40,24,68,-44,1364
129,2022/7/15 15:50,28,75,-47,904
129,2022/7/15 16:00,29,75,-46,1962
129,2022/7/15 16:10,27,90,-63,2559
129,2022/7/15 16:20,27,113,-86,2099
129,2022/7/15 16:30,33,96,-63,3303
129,2022/7/15 16:40,33,93,-60,4690
129,2022/7/15 16:50,29,99,-70,4588
129,2022/7/15 17:00,25,108,-83,8741
129,2022/7/15 17:10,32,91,-59,15440
129,2022/7/15 17:20,24,150,-126,12331
129,2022/7/15 17:30,29,104,-75,14246
129,2022/7/15 17:40,28,180,-152,23672
129,2022/7/15 17:50,28,196,-168,17303
129,2022/7/15 18:00,27,182,-155,12959
129,2022/7/15 18:10,28,268,-240,22177
129,2022/7/15 18:20,24,197,-173,18660
129,2022/7/15 18:30,21,383,-362,7901
129,2022/7/15 18:40,20,203,-183,3592
129,2022/7/15 18:50,23,386,-363,2620
129,2022/7/15 19:00,20,327,-307,1300
129,2022/7/15 19:10,20,222,-202,2724
129,2022/7/15 19:20,18,335,-317,2724
129,2022/7/15 19:30,14,128,-114,2011
129,2022/7/15 19:40,15,224,-209,2425
129,2022/7/15 19:50,13,120,-107,1809
129,2022/7/15 20:00,14,93,-79,2874
129,2022/7/15 20:10,15,153,-138,3064
129,2022/7/15 20:20,13,74,-61,3096
129,2022/7/15 20:30,12,110,-98,2317
129,2022/7/15 20:40,13,91,-78,2830
129,2022/7/15 20:50,14,122,-108,2528
129,2022/7/15 21:00,13,107,-94,2636
129,2022/7/15 21:10,12,121,-109,3081
129,2022/7/15 21:20,12,122,-110,2475
129,2022/7/15 21:30,8,82,-74,1791
129,2022/7/15 21:40,11,104,-93,1629
129,2022/7/15 21:50,4,107,-103,772
129,2022/7/15 22:00,4,100,-96,2237
129,2022/7/15 22:10,2,72,-70,1079
129,2022/7/15 22:20,2,104,-102,-638
129,2022/7/15 22:30,0,64,-64,-1541
129,2022/7/15 22:40,0,3,-3,-1418
129,2022/7/15 22:50,0,3,-3,-1400
122,2022/7/15 5:00,0,1,-1,-1
122,2022/7/15 5:10,0,1,-1,88
122,2022/7/15 5:20,0,1,-1,248
122,2022/7/15 5:30,0,1,-1,297
122,2022/7/15 5:40,0,1,-1,395
122,2022/7/15 5:50,28,1,27,429
122,2022/7/15 6:00,55,2,53,411
122,2022/7/15 6:10,148,13,135,439
122,2022/7/15 6:20,152,8,144,323
122,2022/7/15 6:30,222,15,207,737
122,2022/7/15 6:40,227,66,161,1142
122,2022/7/15 6:50,247,66,181,1947
122,2022/7/15 7:00,346,108,238,2658
122,2022/7/15 7:10,436,90,346,4420
122,2022/7/15 7:20,722,100,622,5758
122,2022/7/15 7:30,741,98,643,7803
122,2022/7/15 7:40,1177,106,1071,7100
122,2022/7/15 7:50,865,119,746,4172
122,2022/7/15 8:00,732,93,639,-90
122,2022/7/15 8:10,723,115,608,-20275
122,2022/7/15 8:20,589,101,488,-20978
122,2022/7/15 8:30,357,87,270,-40095
122,2022/7/15 8:40,278,114,164,-60356
122,2022/7/15 8:50,250,102,148,-44932
122,2022/7/15 9:00,206,93,113,-36011
122,2022/7/15 9:10,151,109,42,-28824
122,2022/7/15 9:20,115,105,10,-19033
122,2022/7/15 9:30,60,97,-37,-13113
122,2022/7/15 9:40,57,105,-48,-11744
122,2022/7/15 9:50,48,105,-57,-7279
122,2022/7/15 10:00,48,94,-46,-3161
122,2022/7/15 10:10,43,103,-60,-1977
122,2022/7/15 10:20,42,93,-51,-1643
122,2022/7/15 10:30,42,68,-26,-1661
122,2022/7/15 10:40,40,100,-60,-1498
122,2022/7/15 10:50,40,75,-35,-1090
122,2022/7/15 11:00,45,102,-57,-1132
122,2022/7/15 11:10,39,103,-64,-689
122,2022/7/15 11:20,43,76,-33,-674
122,2022/7/15 11:30,41,83,-42,-559
122,2022/7/15 11:40,41,77,-36,-482
122,2022/7/15 11:50,47,84,-37,-342
122,2022/7/15 12:00,46,100,-54,-273
122,2022/7/15 12:10,44,81,-37,255
122,2022/7/15 12:20,48,77,-29,-55
122,2022/7/15 12:30,47,78,-31,-454
122,2022/7/15 12:40,41,80,-39,-552
122,2022/7/15 12:50,35,76,-41,-513
122,2022/7/15 13:00,43,106,-63,-726
122,2022/7/15 13:10,34,89,-55,-148
122,2022/7/15 13:20,39,80,-41,-490
122,2022/7/15 13:30,34,83,-49,112
122,2022/7/15 13:40,37,78,-41,-536
122,2022/7/15 13:50,39,102,-63,7
122,2022/7/15 14:00,35,93,-58,-407
122,2022/7/15 14:10,37,93,-56,281
122,2022/7/15 14:20,37,86,-49,-49
122,2022/7/15 14:30,32,92,-60,470
122,2022/7/15 14:40,39,90,-51,179
122,2022/7/15 14:50,29,118,-89,539
122,2022/7/15 15:00,34,105,-71,736
122,2022/7/15 15:10,37,107,-70,1159
122,2022/7/15 15:20,35,90,-55,1026
122,2022/7/15 15:30,37,98,-61,1208
122,2022/7/15 15:40,33,101,-68,1296
122,2022/7/15 15:50,38,109,-71,833
122,2022/7/15 16:00,37,104,-67,1895
122,2022/7/15 16:10,38,111,-73,2486
122,2022/7/15 16:20,45,113,-68,2031
122,2022/7/15 16:30,44,103,-59,3244
122,2022/7/15 16:40,70,150,-80,4610
122,2022/7/15 16:50,133,117,16,4604
122,2022/7/15 17:00,74,110,-36,8705
122,2022/7/15 17:10,49,145,-96,15344
122,2022/7/15 17:20,47,110,-63,12268
122,2022/7/15 17:30,42,268,-226,14020
122,2022/7/15 17:40,41,108,-67,23605
122,2022/7/15 17:50,42,324,-282,17021
122,2022/7/15 18:00,45,232,-187,12772
122,2022/7/15 18:10,40,341,-301,21876
122,2022/7/15 18:20,37,379,-342,18318
122,2022/7/15 18:30,28,217,-189,7712
122,2022/7/15 18:40,27,428,-401,3191
122,2022/7/15 18:50,28,229,-201,2419
122,2022/7/15 19:00,27,439,-412,888
122,2022/7/15 19:10,27,231,-204,2520
122,2022/7/15 19:20,25,300,-275,2449
122,2022/7/15 19:30,26,285,-259,1752
122,2022/7/15 19:40,25,118,-93,2332
122,2022/7/15 19:50,25,213,-188,1621
122,2022/7/15 20:00,29,101,-72,2802
122,2022/7/15 20:10,28,150,-122,2942
122,2022/7/15 20:20,22,111,-89,3007
122,2022/7/15 20:30,28,106,-78,2239
122,2022/7/15 20:40,23,110,-87,2743
122,2022/7/15 20:50,24,107,-83,2445
122,2022/7/15 21:00,24,110,-86,2550
122,2022/7/15 21:10,22,104,-82,2999
122,2022/7/15 21:20,18,111,-93,2382
122,2022/7/15 21:30,17,132,-115,1676
122,2022/7/15 21:40,16,94,-78,1551
122,2022/7/15 21:50,11,111,-100,672
122,2022/7/15 22:00,7,89,-82,2155
122,2022/7/15 22:10,5,104,-99,980
122,2022/7/15 22:20,2,78,-76,-714
122,2022/7/15 22:30,0,66,-66,-1607
122,2022/7/15 22:40,0,56,-56,-1474
122,2022/7/15 22:50,0,3,-3,-1403
133,2022/7/15 5:00,0,1,-1,-2
133,2022/7/15 5:10,0,1,-1,87
133,2022/7/15 5:20,0,1,-1,247
133,2022/7/15 5:30,0,1,-1,296
133,2022/7/15 5:40,0,1,-1,394
133,2022/7/15 5:50,14,1,13,442
133,2022/7/15 6:00,29,1,28,439
133,2022/7/15 6:10,47,1,46,485
133,2022/7/15 6:20,31,1,30,353
133,2022/7/15 6:30,51,1,50,787
133,2022/7/15 6:40,48,5,43,1185
133,2022/7/15 6:50,48,19,29,1976
133,2022/7/15 7:00,57,6,51,2709
133,2022/7/15 7:10,76,19,57,4477
133,2022/7/15 7:20,147,14,133,5891
133,2022/7/15 7:30,156,23,133,7936
133,2022/7/15 7:40,148,25,123,7223
133,2022/7/15 7:50,150,23,127,4299
133,2022/7/15 8:00,144,40,104,14
133,2022/7/15 8:10,82,21,61,-20214
133,2022/7/15 8:20,62,47,15,-20963
133,2022/7/15 8:30,44,31,13,-40082
133,2022/7/15 8:40,35,19,16,-60340
133,2022/7/15 8:50,32,38,-6,-44938
133,2022/7/15 9:00,27,37,-10,-36021
133,2022/7/15 9:10,25,23,2,-28822
133,2022/7/15 9:20,12,39,-27,-19060
133,2022/7/15 9:30,20,23,-3,-13116
133,2022/7/15 9:40,16,23,-7,-11751
133,2022/7/15 9:50,14,30,-16,-7295
133,2022/7/15 10:00,16,33,-17,-3178
133,2022/7/15 10:10,16,17,-1,-1978
133,2022/7/15 10:20,9,30,-21,-1664
133,2022/7/15 10:30,13,24,-11,-1672
133,2022/7/15 10:40,7,21,-14,-1512
133,2022/7/15 10:50,15,25,-10,-1100
133,2022/7/15 11:00,9,19,-10,-1142
133,2022/7/15 11:10,11,25,-14,-703
133,2022/7/15 11:20,10,22,-12,-686
133,2022/7/15 11:30,12,34,-22,-581
133,2022/7/15 11:40,14,23,-9,-491
133,2022/7/15 11:50,11,25,-14,-356
133,2022/7/15 12:00,10,23,-13,-286
133,2022/7/15 12:10,15,23,-8,247
133,2022/7/15 12:20,12,23,-11,-66
133,2022/7/15 12:30,19,32,-13,-467
133,2022/7/15 12:40,6,23,-17,-569
133,2022/7/15 12:50,13,23,-10,-523
133,2022/7/15 13:00,10,23,-13,-739
133,2022/7/15 13:10,9,23,-14,-162
133,2022/7/15 13:20,10,37,-27,-517
133,2022/7/15 13:30,10,33,-23,89
133,2022/7/15 13:40,7,23,-16,-552
133,2022/7/15 13:50,12,23,-11,-4
133,2022/7/15 14:00,9,23,-14,-421
133,2022/7/15 14:10,10,30,-20,261
133,2022/7/15 14:20,8,40,-32,-81
133,2022/7/15 14:30,9,25,-16,454
133,2022/7/15 14:40,6,32,-26,153
133,2022/7/15 14:50,10,30,-20,519
133,2022/7/15 15:00,7,31,-24,712
133,2022/7/15 15:10,9,32,-23,1136
133,2022/7/15 15:20,10,59,-49,977
133,2022/7/15 15:30,11,39,-28,1180
133,2022/7/15 15:40,9,37,-28,1268
133,2022/7/15 15:50,7,39,-32,801
133,2022/7/15 16:00,6,44,-38,1857
133,2022/7/15 16:10,11,65,-54,2432
133,2022/7/15 16:20,10,38,-28,2003
133,2022/7/15 16:30,12,44,-32,3212
133,2022/7/15 16:40,11,48,-37,4573
133,2022/7/15 16:50,10,46,-36,4568
133,2022/7/15 17:00,7,54,-47,8658
133,2022/7/15 17:10,16,68,-52,15292
133,2022/7/15 17:20,12,62,-50,12218
133,2022/7/15 17:30,11,60,-49,13971
133,2022/7/15 17:40,11,73,-62,23543
133,2022/7/15 17:50,12,65,-53,16968
133,2022/7/15 18:00,11,93,-82,12690
133,2022/7/15 18:10,12,71,-59,21817
133,2022/7/15 18:20,10,92,-82,18236
133,2022/7/15 18:30,8,102,-94,7618
133,2022/7/15 18:40,8,79,-71,3120
133,2022/7/15 18:50,9,107,-98,2321
133,2022/7/15 19:00,6,75,-69,819
133,2022/7/15 19:10,9,108,-99,2421
133,2022/7/15 19:20,3,73,-70,2379
133,2022/7/15 19:30,9,95,-86,1666
133,2022/7/15 19:40,4,80,-76,2256
133,2022/7/15 19:50,6,51,-45,1576
133,2022/7/15 20:00,4,73,-69,2733
133,2022/7/15 20:10,5,39,-34,2908
133,2022/7/15 20:20,3,71,-68,2939
133,2022/7/15 20:30,3,51,-48,2191
133,2022/7/15 20:40,3,53,-50,2693
133,2022/7/15 20:50,2,63,-61,2384
133,2022/7/15 21:00,2,41,-39,2511
133,2022/7/15 21:10,1,67,-66,2933
133,2022/7/15 21:20,2,51,-49,2333
133,2022/7/15 21:30,1,45,-44,1632
133,2022/7/15 21:40,2,55,-53,1498
133,2022/7/15 21:50,1,39,-38,634
133,2022/7/15 22:00,1,62,-61,2094
133,2022/7/15 22:10,0,30,-30,950
133,2022/7/15 22:20,0,46,-46,-760
133,2022/7/15 22:30,0,20,-20,-1627
133,2022/7/15 22:40,0,18,-18,-1492
133,2022/7/15 22:50,0,3,-3,-1406
146,2022/7/15 5:00,0,1,-1,-3
146,2022/7/15 5:10,0,1,-1,86
146,2022/7/15 5:20,0,1,-1,246
146,2022/7/15 5:30,0,1,-1,295
146,2022/7/15 5:40,0,1,-1,393
146,2022/7/15 5:50,9,1,8,450
146,2022/7/15 6:00,20,1,19,458
146,2022/7/15 6:10,20,1,19,504
146,2022/7/15 6:20,27,1,26,379
146,2022/7/15 6:30,23,1,22,809
146,2022/7/15 6:40,27,1,26,1211
146,2022/7/15 6:50,29,19,10,1986
146,2022/7/15 7:00,30,8,22,2731
146,2022/7/15 7:10,32,11,21,4498
146,2022/7/15 7:20,30,8,22,5913
146,2022/7/15 7:30,32,11,21,7957
146,2022/7/15 7:40,32,33,-1,7222
146,2022/7/15 7:50,32,16,16,4315
146,2022/7/15 8:00,29,31,-2,12
146,2022/7/15 8:10,23,31,-8,-20222
146,2022/7/15 8:20,17,23,-6,-20969
146,2022/7/15 8:30,19,45,-26,-40108
146,2022/7/15 8:40,14,63,-49,-60389
146,2022/7/15 8:50,11,40,-29,-44967
146,2022/7/15 9:00,10,60,-50,-36071
146,2022/7/15 9:10,9,67,-58,-28880
146,2022/7/15 9:20,8,38,-30,-19090
146,2022/7/15 9:30,5,46,-41,-13157
146,2022/7/15 9:40,6,48,-42,-11793
146,2022/7/15 9:50,4,28,-24,-7319
146,2022/7/15 10:00,7,46,-39,-3217
146,2022/7/15 10:10,5,39,-34,-2012
146,2022/7/15 10:20,5,31,-26,-1690
146,2022/7/15 10:30,7,38,-31,-1703
146,2022/7/15 10:40,6,33,-27,-1539
146,2022/7/15 10:50,6,23,-17,-1117
146,2022/7/15 11:00,4,32,-28,-1170
146,2022/7/15 11:10,4,23,-19,-722
146,2022/7/15 11:20,7,19,-12,-698
146,2022/7/15 11:30,7,29,-22,-603
146,2022/7/15 11:40,8,21,-13,-504
146,2022/7/15 11:50,7,19,-12,-368
146,2022/7/15 12:00,7,38,-31,-317
146,2022/7/15 12:10,9,23,-14,233
146,2022/7/15 12:20,6,23,-17,-83
146,2022/7/15 12:30,10,21,-11,-478
146,2022/7/15 12:40,9,14,-5,-574
146,2022/7/15 12:50,6,32,-26,-549
146,2022/7/15 13:00,8,23,-15,-754
146,2022/7/15 13:10,6,25,-19,-181
146,2022/7/15 13:20,7,23,-16,-533
146,2022/7/15 13:30,7,19,-12,77
146,2022/7/15 13:40,9,21,-12,-564
146,2022/7/15 13:50,5,29,-24,-28
146,2022/7/15 14:00,8,23,-15,-436
146,2022/7/15 14:10,8,21,-13,248
146,2022/7/15 14:20,5,23,-18,-99
146,2022/7/15 14:30,5,23,-18,436
146,2022/7/15 14:40,8,21,-13,140
146,2022/7/15 14:50,6,23,-17,502
146,2022/7/15 15:00,8,23,-15,697
146,2022/7/15 15:10,10,19,-9,1127
146,2022/7/15 15:20,7,19,-12,965
146,2022/7/15 15:30,10,21,-11,1169
146,2022/7/15 15:40,9,21,-12,1256
146,2022/7/15 15:50,8,31,-23,778
146,2022/7/15 16:00,9,19,-10,1847
146,2022/7/15 16:10,12,25,-13,2419
146,2022/7/15 16:20,10,23,-13,1990
146,2022/7/15 16:30,10,28,-18,3194
146,2022/7/15 16:40,10,38,-28,4545
146,2022/7/15 16:50,14,37,-23,4545
146,2022/7/15 17:00,12,33,-21,8637
146,2022/7/15 17:10,16,35,-19,15273
146,2022/7/15 17:20,10,38,-28,12190
146,2022/7/15 17:30,14,24,-10,13961
146,2022/7/15 17:40,14,50,-36,23507
146,2022/7/15 17:50,10,49,-39,16929
146,2022/7/15 18:00,17,43,-26,12664
146,2022/7/15 18:10,14,65,-51,21766
146,2022/7/15 18:20,11,43,-32,18204
146,2022/7/15 18:30,8,63,-55,7563
146,2022/7/15 18:40,8,43,-35,3085
146,2022/7/15 18:50,5,58,-53,2268
146,2022/7/15 19:00,8,47,-39,780
146,2022/7/15 19:10,7,40,-33,2388
146,2022/7/15 19:20,5,52,-47,2332
146,2022/7/15 19:30,3,32,-29,1637
146,2022/7/15 19:40,3,41,-38,2218
146,2022/7/15 19:50,3,40,-37,1539
146,2022/7/15 20:00,6,32,-26,2707
146,2022/7/15 20:10,4,33,-29,2879
146,2022/7/15 20:20,4,23,-19,2920
146,2022/7/15 20:30,4,30,-26,2165
146,2022/7/15 20:40,4,25,-21,2672
146,2022/7/15 20:50,4,27,-23,2361
146,2022/7/15 21:00,17,25,-8,2503
146,2022/7/15 21:10,29,25,4,2937
146,2022/7/15 21:20,13,40,-27,2306
146,2022/7/15 21:30,4,21,-17,1615
146,2022/7/15 21:40,2,31,-29,1469
146,2022/7/15 21:50,2,26,-24,610
146,2022/7/15 22:00,1,21,-20,2074
146,2022/7/15 22:10,0,25,-25,925
146,2022/7/15 22:20,0,13,-13,-773
146,2022/7/15 22:30,0,34,-34,-1661
146,2022/7/15 22:40,0,22,-22,-1514
146,2022/7/15 22:50,0,21,-21,-1427
126,2022/7/15 5:00,0,1,-1,-4
126,2022/7/15 5:10,0,1,-1,85
126,2022/7/15 5:20,0,1,-1,245
126,2022/7/15 5:30,0,1,-1,294
126,2022/7/15 5:40,3,1,2,395
126,2022/7/15 5:50,7,1,6,456
126,2022/7/15 6:00,4,1,3,461
126,2022/7/15 6:10,6,1,5,509
126,2022/7/15 6:20,7,1,6,385
126,2022/7/15 6:30,8,12,-4,805
126,2022/7/15 6:40,10,6,4,1215
126,2022/7/15 6:50,6,14,-8,1978
126,2022/7/15 7:00,10,31,-21,2710
126,2022/7/15 7:10,9,42,-33,4465
126,2022/7/15 7:20,7,51,-44,5869
126,2022/7/15 7:30,13,50,-37,7920
126,2022/7/15 7:40,12,75,-63,7159
126,2022/7/15 7:50,13,68,-55,4260
126,2022/7/15 8:00,13,113,-100,-88
126,2022/7/15 8:10,16,98,-82,-20304
126,2022/7/15 8:20,14,114,-100,-21069
126,2022/7/15 8:30,18,102,-84,-40192
126,2022/7/15 8:40,17,71,-54,-60443
126,2022/7/15 8:50,14,88,-74,-45041
126,2022/7/15 9:00,12,72,-60,-36131
126,2022/7/15 9:10,12,48,-36,-28916
126,2022/7/15 9:20,9,61,-52,-19142
126,2022/7/15 9:30,15,51,-36,-13193
126,2022/7/15 9:40,8,33,-25,-11818
126,2022/7/15 9:50,10,45,-35,-7354
126,2022/7/15 10:00,7,33,-26,-3243
126,2022/7/15 10:10,10,25,-15,-2027
126,2022/7/15 10:20,5,24,-19,-1709
126,2022/7/15 10:30,13,31,-18,-1721
126,2022/7/15 10:40,9,7,2,-1537
126,2022/7/15 10:50,6,34,-28,-1145
126,2022/7/15 11:00,8,22,-14,-1184
126,2022/7/15 11:10,12,21,-9,-731
126,2022/7/15 11:20,12,23,-11,-709
126,2022/7/15 11:30,10,19,-9,-612
126,2022/7/15 11:40,9,16,-7,-511
126,2022/7/15 11:50,8,23,-15,-383
126,2022/7/15 12:00,9,23,-14,-331
126,2022/7/15 12:10,12,23,-11,222
126,2022/7/15 12:20,10,19,-9,-92
126,2022/7/15 12:30,7,25,-18,-496
126,2022/7/15 12:40,6,21,-15,-589
126,2022/7/15 12:50,7,29,-22,-571
126,2022/7/15 13:00,5,23,-18,-772
126,2022/7/15 13:10,11,16,-5,-186
126,2022/7/15 13:20,10,23,-13,-546
126,2022/7/15 13:30,9,19,-10,67
126,2022/7/15 13:40,9,16,-7,-571
126,2022/7/15 13:50,9,21,-12,-40
126,2022/7/15 14:00,11,12,-1,-437
126,2022/7/15 14:10,12,17,-5,243
126,2022/7/15 14:20,8,14,-6,-105
126,2022/7/15 14:30,8,19,-11,425
126,2022/7/15 14:40,13,19,-6,134
126,2022/7/15 14:50,12,16,-4,498
126,2022/7/15 15:00,12,19,-7,690
126,2022/7/15 15:10,13,19,-6,1121
126,2022/7/15 15:20,15,14,1,966
126,2022/7/15 15:30,17,19,-2,1167
126,2022/7/15 15:40,21,23,-2,1254
126,2022/7/15 15:50,24,18,6,784
126,2022/7/15 16:00,27,14,13,1860
126,2022/7/15 16:10,27,19,8,2427
126,2022/7/15 16:20,28,12,16,2006
126,2022/7/15 16:30,37,21,16,3210
126,2022/7/15 16:40,29,18,11,4556
126,2022/7/15 16:50,16,12,4,4549
126,2022/7/15 17:00,23,14,9,8646
126,2022/7/15 17:10,23,12,11,15284
126,2022/7/15 17:20,26,21,5,12195
126,2022/7/15 17:30,23,7,16,13977
126,2022/7/15 17:40,17,16,1,23508
126,2022/7/15 17:50,11,12,-1,16928
126,2022/7/15 18:00,9,25,-16,12648
126,2022/7/15 18:10,8,23,-15,21751
126,2022/7/15 18:20,7,21,-14,18190
126,2022/7/15 18:30,12,21,-9,7554
126,2022/7/15 18:40,3,15,-12,3073
126,2022/7/15 18:50,5,22,-17,2251
126,2022/7/15 19:00,6,15,-9,771
126,2022/7/15 19:10,4,25,-21,2367
126,2022/7/15 19:20,7,32,-25,2307
126,2022/7/15 19:30,5,25,-20,1617
126,2022/7/15 19:40,4,24,-20,2198
126,2022/7/15 19:50,4,15,-11,1528
126,2022/7/15 20:00,6,30,-24,2683
126,2022/7/15 20:10,7,31,-24,2855
126,2022/7/15 20:20,7,25,-18,2902
126,2022/7/15 20:30,8,23,-15,2150
126,2022/7/15 20:40,5,13,-8,2664
126,2022/7/15 20:50,5,22,-17,2344
126,2022/7/15 21:00,2,15,-13,2490
126,2022/7/15 21:10,4,21,-17,2920
126,2022/7/15 21:20,2,21,-19,2287
126,2022/7/15 21:30,2,16,-14,1601
126,2022/7/15 21:40,1,23,-22,1447
126,2022/7/15 21:50,2,18,-16,594
126,2022/7/15 22:00,1,21,-20,2054
126,2022/7/15 22:10,0,10,-10,915
126,2022/7/15 22:20,0,13,-13,-786
126,2022/7/15 22:30,0,8,-8,-1669
126,2022/7/15 22:40,0,3,-3,-1517
126,2022/7/15 22:50,0,3,-3,-1430
139,2022/7/15 5:00,0,1,-1,-5
139,2022/7/15 5:10,0,1,-1,84
139,2022/7/15 5:20,0,1,-1,244
139,2022/7/15 5:30,0,1,-1,293
139,2022/7/15 5:40,47,1,46,441
139,2022/7/15 5:50,29,1,28,484
139,2022/7/15 6:00,27,1,26,487
139,2022/7/15 6:10,24,1,23,532
139,2022/7/15 6:20,20,1,19,404
139,2022/7/15 6:30,23,80,-57,748
139,2022/7/15 6:40,25,70,-45,1170
139,2022/7/15 6:50,25,45,-20,1958
139,2022/7/15 7:00,23,108,-85,2625
139,2022/7/15 7:10,27,102,-75,4390
139,2022/7/15 7:20,27,110,-83,5786
139,2022/7/15 7:30,29,120,-91,7829
139,2022/7/15 7:40,30,110,-80,7079
139,2022/7/15 7:50,28,110,-82,4178
139,2022/7/15 8:00,26,110,-84,-172
139,2022/7/15 8:10,41,213,-172,-20476
139,2022/7/15 8:20,41,126,-85,-21154
139,2022/7/15 8:30,45,152,-107,-40299
139,2022/7/15 8:40,54,117,-63,-60506
139,2022/7/15 8:50,59,108,-49,-45090
139,2022/7/15 9:00,61,111,-50,-36181
139,2022/7/15 9:10,47,103,-56,-28972
139,2022/7/15 9:20,37,109,-72,-19214
139,2022/7/15 9:30,35,122,-87,-13280
139,2022/7/15 9:40,28,110,-82,-11900
139,2022/7/15 9:50,25,110,-85,-7439
139,2022/7/15 10:00,29,107,-78,-3321
139,2022/7/15 10:10,30,142,-112,-2139
139,2022/7/15 10:20,32,54,-22,-1731
139,2022/7/15 10:30,38,108,-70,-1791
139,2022/7/15 10:40,40,77,-37,-1574
139,2022/7/15 10:50,39,102,-63,-1208
139,2022/7/15 11:00,34,107,-73,-1257
139,2022/7/15 11:10,41,76,-35,-766
139,2022/7/15 11:20,43,112,-69,-778
139,2022/7/15 11:30,36,103,-67,-679
139,2022/7/15 11:40,42,91,-49,-560
139,2022/7/15 11:50,37,83,-46,-429
139,2022/7/15 12:00,37,93,-56,-387
139,2022/7/15 12:10,39,93,-54,168
139,2022/7/15 12:20,35,103,-68,-160
139,2022/7/15 12:30,34,98,-64,-560
139,2022/7/15 12:40,33,77,-44,-633
139,2022/7/15 12:50,24,77,-53,-624
139,2022/7/15 13:00,27,77,-50,-822
139,2022/7/15 13:10,31,73,-42,-228
139,2022/7/15 13:20,31,106,-75,-621
139,2022/7/15 13:30,35,98,-63,4
139,2022/7/15 13:40,28,98,-70,-641
139,2022/7/15 13:50,29,90,-61,-101
139,2022/7/15 14:00,29,93,-64,-501
139,2022/7/15 14:10,32,120,-88,155
139,2022/7/15 14:20,34,102,-68,-173
139,2022/7/15 14:30,38,110,-72,353
139,2022/7/15 14:40,38,97,-59,75
139,2022/7/15 14:50,35,101,-66,432
139,2022/7/15 15:00,46,106,-60,630
139,2022/7/15 15:10,47,119,-72,1049
139,2022/7/15 15:20,58,105,-47,919
139,2022/7/15 15:30,47,108,-61,1106
139,2022/7/15 15:40,56,93,-37,1217
139,2022/7/15 15:50,66,94,-28,756
139,2022/7/15 16:00,66,100,-34,1826
139,2022/7/15 16:10,62,103,-41,2386
139,2022/7/15 16:20,58,103,-45,1961
139,2022/7/15 16:30,66,83,-17,3193
139,2022/7/15 16:40,44,95,-51,4505
139,2022/7/15 16:50,52,90,-38,4511
139,2022/7/15 17:00,59,110,-51,8595
139,2022/7/15 17:10,73,98,-25,15259
139,2022/7/15 17:20,42,94,-52,12143
139,2022/7/15 17:30,46,107,-61,13916
139,2022/7/15 17:40,45,74,-29,23479
139,2022/7/15 17:50,44,103,-59,16869
139,2022/7/15 18:00,47,77,-30,12618
139,2022/7/15 18:10,45,106,-61,21690
139,2022/7/15 18:20,40,89,-49,18141
139,2022/7/15 18:30,44,99,-55,7499
139,2022/7/15 18:40,45,102,-57,3016
139,2022/7/15 18:50,35,87,-52,2199
139,2022/7/15 19:00,41,95,-54,717
139,2022/7/15 19:10,34,97,-63,2304
139,2022/7/15 19:20,37,122,-85,2222
139,2022/7/15 19:30,42,84,-42,1575
139,2022/7/15 19:40,35,100,-65,2133
139,2022/7/15 19:50,40,119,-79,1449
139,2022/7/15 20:00,44,88,-44,2639
139,2022/7/15 20:10,49,124,-75,2780
139,2022/7/15 20:20,57,70,-13,2889
139,2022/7/15 20:30,71,106,-35,2115
139,2022/7/15 20:40,63,92,-29,2635
139,2022/7/15 20:50,62,76,-14,2330
139,2022/7/15 21:00,44,75,-31,2459
139,2022/7/15 21:10,49,60,-11,2909
139,2022/7/15 21:20,40,72,-32,2255
139,2022/7/15 21:30,51,72,-21,1580
139,2022/7/15 21:40,39,60,-21,1426
139,2022/7/15 21:50,21,69,-48,546
139,2022/7/15 22:00,0,50,-50,2004
139,2022/7/15 22:10,0,69,-69,846
139,2022/7/15 22:20,0,57,-57,-843
139,2022/7/15 22:30,0,58,-58,-1727
139,2022/7/15 22:40,0,3,-3,-1520
139,2022/7/15 22:50,0,3,-3,-1433
163,2022/7/15 5:00,16,1,15,15
163,2022/7/15 5:10,31,1,30,30
163,2022/7/15 5:20,26,1,25,25
163,2022/7/15 5:30,28,1,27,27
163,2022/7/15 5:40,31,6,25,25
163,2022/7/15 5:50,29,23,6,6
163,2022/7/15 6:00,41,23,18,18
163,2022/7/15 6:10,57,34,23,23
163,2022/7/15 6:20,155,64,91,91
163,2022/7/15 6:30,201,114,87,87
163,2022/7/15 6:40,278,120,158,158
163,2022/7/15 6:50,276,111,165,165
163,2022/7/15 7:00,661,182,479,479
163,2022/7/15 7:10,602,111,491,491
163,2022/7/15 7:20,1382,208,1174,1174
163,2022/7/15 7:30,1574,300,1274,1274
163,2022/7/15 7:40,1981,233,1748,1748
163,2022/7/15 7:50,2000,198,1802,1802
163,2022/7/15 8:00,2058,196,1862,1862
163,2022/7/15 8:10,1984,208,1776,1776
163,2022/7/15 8:20,1975,198,1777,1777
163,2022/7/15 8:30,2059,181,1878,1878
163,2022/7/15 8:40,1175,197,978,978
163,2022/7/15 8:50,822,214,608,608
163,2022/7/15 9:00,1155,178,977,977
163,2022/7/15 9:10,585,181,404,404
163,2022/7/15 9:20,653,150,503,503
163,2022/7/15 9:30,349,151,198,198
163,2022/7/15 9:40,234,119,115,115
163,2022/7/15 9:50,209,118,91,91
163,2022/7/15 10:00,160,123,37,37
163,2022/7/15 10:10,316,110,206,206
163,2022/7/15 10:20,165,108,57,57
163,2022/7/15 10:30,164,107,57,57
163,2022/7/15 10:40,172,118,54,54
163,2022/7/15 10:50,172,122,50,50
163,2022/7/15 11:00,212,120,92,92
163,2022/7/15 11:10,141,121,20,20
163,2022/7/15 11:20,136,120,16,16
163,2022/7/15 11:30,129,117,12,12
163,2022/7/15 11:40,126,110,16,16
163,2022/7/15 11:50,207,106,101,101
163,2022/7/15 12:00,177,118,59,59
163,2022/7/15 12:10,158,117,41,41
163,2022/7/15 12:20,220,114,106,106
163,2022/7/15 12:30,267,152,115,115
163,2022/7/15 12:40,173,140,33,33
163,2022/7/15 12:50,206,149,57,57
163,2022/7/15 13:00,194,126,68,68
163,2022/7/15 13:10,173,103,70,70
163,2022/7/15 13:20,151,166,-15,-15
163,2022/7/15 13:30,198,120,78,78
163,2022/7/15 13:40,110,185,-75,-75
163,2022/7/15 13:50,184,124,60,60
163,2022/7/15 14:00,158,151,7,7
163,2022/7/15 14:10,146,143,3,3
163,2022/7/15 14:20,125,118,7,7
163,2022/7/15 14:30,142,194,-52,-52
163,2022/7/15 14:40,82,149,-67,-67
163,2022/7/15 14:50,125,191,-66,-66
163,2022/7/15 15:00,144,145,-1,-1
163,2022/7/15 15:10,142,206,-64,-64
163,2022/7/15 15:20,130,172,-42,-42
163,2022/7/15 15:30,266,152,114,114
163,2022/7/15 15:40,118,295,-177,-177
163,2022/7/15 15:50,258,197,61,61
163,2022/7/15 16:00,214,263,-49,-49
163,2022/7/15 16:10,253,275,-22,-22
163,2022/7/15 16:20,183,296,-113,-113
163,2022/7/15 16:30,195,303,-108,-108
163,2022/7/15 16:40,268,261,7,7
163,2022/7/15 16:50,267,470,-203,-203
163,2022/7/15 17:00,270,307,-37,-37
163,2022/7/15 17:10,333,484,-151,-151
163,2022/7/15 17:20,264,411,-147,-147
163,2022/7/15 17:30,327,473,-146,-146
163,2022/7/15 17:40,255,582,-327,-327
163,2022/7/15 17:50,237,1142,-905,-905
163,2022/7/15 18:00,274,1567,-1293,-1293
163,2022/7/15 18:10,216,1061,-845,-845
163,2022/7/15 18:20,191,1070,-879,-879
163,2022/7/15 18:30,225,1996,-1771,-1771
163,2022/7/15 18:40,231,1530,-1299,-1299
163,2022/7/15 18:50,146,1071,-925,-925
163,2022/7/15 19:00,149,480,-331,-331
163,2022/7/15 19:10,119,432,-313,-313
163,2022/7/15 19:20,64,432,-368,-368
163,2022/7/15 19:30,79,522,-443,-443
163,2022/7/15 19:40,56,341,-285,-285
163,2022/7/15 19:50,68,327,-259,-259
163,2022/7/15 20:00,54,209,-155,-155
163,2022/7/15 20:10,45,209,-164,-164
163,2022/7/15 20:20,82,198,-116,-116
163,2022/7/15 20:30,57,146,-89,-89
163,2022/7/15 20:40,57,191,-134,-134
163,2022/7/15 20:50,57,178,-121,-121
163,2022/7/15 21:00,97,153,-56,-56
163,2022/7/15 21:10,62,192,-130,-130
163,2022/7/15 21:20,45,128,-83,-83
163,2022/7/15 21:30,37,117,-80,-80
163,2022/7/15 21:40,28,193,-165,-165
163,2022/7/15 21:50,25,117,-92,-92
163,2022/7/15 22:00,25,126,-101,-101
163,2022/7/15 22:10,25,125,-100,-100
163,2022/7/15 22:20,21,115,-94,-94
163,2022/7/15 22:30,13,122,-109,-109
163,2022/7/15 22:40,1,103,-102,-102
163,2022/7/15 22:50,1,111,-110,-110
164,2022/7/15 5:00,0,1,-1,14
164,2022/7/15 5:10,3,1,2,32
164,2022/7/15 5:20,10,1,9,34
164,2022/7/15 5:30,13,1,12,39
164,2022/7/15 5:40,16,1,15,40
164,2022/7/15 5:50,19,1,18,24
164,2022/7/15 6:00,29,1,28,46
164,2022/7/15 6:10,30,6,24,47
164,2022/7/15 6:20,57,12,45,136
164,2022/7/15 6:30,55,51,4,91
164,2022/7/15 6:40,88,84,4,162
164,2022/7/15 6:50,143,88,55,220
164,2022/7/15 7:00,171,91,80,559
164,2022/7/15 7:10,187,134,53,544
164,2022/7/15 7:20,182,109,73,1247
164,2022/7/15 7:30,227,111,116,1390
164,2022/7/15 7:40,276,100,176,1924
164,2022/7/15 7:50,332,102,230,2032
164,2022/7/15 8:00,435,110,325,2187
164,2022/7/15 8:10,392,169,223,1999
164,2022/7/15 8:20,324,104,220,1997
164,2022/7/15 8:30,317,110,207,2085
164,2022/7/15 8:40,280,110,170,1148
164,2022/7/15 8:50,226,109,117,725
164,2022/7/15 9:00,188,121,67,1044
164,2022/7/15 9:10,138,104,34,438
164,2022/7/15 9:20,100,102,-2,501
164,2022/7/15 9:30,68,96,-28,170
164,2022/7/15 9:40,45,87,-42,73
164,2022/7/15 9:50,38,94,-56,35
164,2022/7/15 10:00,37,73,-36,1
164,2022/7/15 10:10,36,57,-21,185
164,2022/7/15 10:20,35,80,-45,12
164,2022/7/15 10:30,29,71,-42,15
164,2022/7/15 10:40,36,65,-29,25
164,2022/7/15 10:50,29,65,-36,14
164,2022/7/15 11:00,33,62,-29,63
164,2022/7/15 11:10,32,77,-45,-25
164,2022/7/15 11:20,27,70,-43,-27
164,2022/7/15 11:30,30,72,-42,-30
164,2022/7/15 11:40,25,60,-35,-19
164,2022/7/15 11:50,28,67,-39,62
164,2022/7/15 12:00,32,68,-36,23
164,2022/7/15 12:10,39,62,-23,18
164,2022/7/15 12:20,32,84,-52,54
164,2022/7/15 12:30,34,66,-32,83
164,2022/7/15 12:40,30,65,-35,-2
164,2022/7/15 12:50,30,81,-51,6
164,2022/7/15 13:00,32,71,-39,29
164,2022/7/15 13:10,31,88,-57,13
164,2022/7/15 13:20,34,59,-25,-40
164,2022/7/15 13:30,31,76,-45,33
164,2022/7/15 13:40,27,73,-46,-121
164,2022/7/15 13:50,32,77,-45,15
164,2022/7/15 14:00,25,72,-47,-40
164,2022/7/15 14:10,35,71,-36,-33
164,2022/7/15 14:20,32,77,-45,-38
164,2022/7/15 14:30,41,68,-27,-79
164,2022/7/15 14:40,44,78,-34,-101
164,2022/7/15 14:50,44,69,-25,-91
164,2022/7/15 15:00,44,64,-20,-21
164,2022/7/15 15:10,42,77,-35,-99
164,2022/7/15 15:20,44,65,-21,-63
164,2022/7/15 15:30,60,82,-22,92
164,2022/7/15 15:40,43,70,-27,-204
164,2022/7/15 15:50,42,97,-55,6
164,2022/7/15 16:00,43,75,-32,-81
164,2022/7/15 16:10,43,77,-34,-56
164,2022/7/15 16:20,52,101,-49,-162
164,2022/7/15 16:30,72,92,-20,-128
164,2022/7/15 16:40,73,91,-18,-11
164,2022/7/15 16:50,67,97,-30,-233
164,2022/7/15 17:00,77,108,-31,-68
164,2022/7/15 17:10,132,111,21,-130
164,2022/7/15 17:20,90,114,-24,-171
164,2022/7/15 17:30,74,123,-49,-195
164,2022/7/15 17:40,102,136,-34,-361
164,2022/7/15 17:50,85,129,-44,-949
164,2022/7/15 18:00,59,214,-155,-1448
164,2022/7/15 18:10,127,184,-57,-902
164,2022/7/15 18:20,89,227,-138,-1017
164,2022/7/15 18:30,66,180,-114,-1885
164,2022/7/15 18:40,45,215,-170,-1469
164,2022/7/15 18:50,33,153,-120,-1045
164,2022/7/15 19:00,33,133,-100,-431
164,2022/7/15 19:10,32,121,-89,-402
164,2022/7/15 19:20,25,126,-101,-469
164,2022/7/15 19:30,26,114,-88,-531
164,2022/7/15 19:40,24,114,-90,-375
164,2022/7/15 19:50,23,95,-72,-331
164,2022/7/15 20:00,23,95,-72,-227
164,2022/7/15 20:10,21,93,-72,-236
164,2022/7/15 20:20,20,77,-57,-173
164,2022/7/15 20:30,19,78,-59,-148
164,2022/7/15 20:40,20,95,-75,-209
164,2022/7/15 20:50,22,79,-57,-178
164,2022/7/15 21:00,18,92,-74,-130
164,2022/7/15 21:10,21,88,-67,-197
164,2022/7/15 21:20,20,66,-46,-129
164,2022/7/15 21:30,15,83,-68,-148
164,2022/7/15 21:40,13,99,-86,-251
164,2022/7/15 21:50,12,73,-61,-153
164,2022/7/15 22:00,10,81,-71,-172
164,2022/7/15 22:10,13,73,-60,-160
164,2022/7/15 22:20,9,69,-60,-154
164,2022/7/15 22:30,2,70,-68,-177
164,2022/7/15 22:40,0,66,-66,-168
164,2022/7/15 22:50,0,35,-35,-145
161,2022/7/15 5:00,0,1,-1,13
161,2022/7/15 5:10,8,1,7,39
161,2022/7/15 5:20,14,1,13,47
161,2022/7/15 5:30,18,5,13,52
161,2022/7/15 5:40,20,1,19,59
161,2022/7/15 5:50,28,1,27,51
161,2022/7/15 6:00,31,1,30,76
161,2022/7/15 6:10,34,1,33,80
161,2022/7/15 6:20,45,69,-24,112
161,2022/7/15 6:30,68,20,48,139
161,2022/7/15 6:40,75,110,-35,127
161,2022/7/15 6:50,140,125,15,235
161,2022/7/15 7:00,199,124,75,634
161,2022/7/15 7:10,205,179,26,570
161,2022/7/15 7:20,278,152,126,1373
161,2022/7/15 7:30,360,208,152,1542
161,2022/7/15 7:40,389,222,167,2091
161,2022/7/15 7:50,642,269,373,2405
161,2022/7/15 8:00,704,253,451,2638
161,2022/7/15 8:10,613,313,300,2299
161,2022/7/15 8:20,661,316,345,2342
161,2022/7/15 8:30,599,253,346,2431
161,2022/7/15 8:40,565,418,147,1295
161,2022/7/15 8:50,357,321,36,761
161,2022/7/15 9:00,278,181,97,1141
161,2022/7/15 9:10,214,122,92,530
161,2022/7/15 9:20,212,150,62,563
161,2022/7/15 9:30,140,105,35,205
161,2022/7/15 9:40,86,104,-18,55
161,2022/7/15 9:50,76,108,-32,3
161,2022/7/15 10:00,67,98,-31,-30
161,2022/7/15 10:10,59,90,-31,154
161,2022/7/15 10:20,50,93,-43,-31
161,2022/7/15 10:30,43,77,-34,-19
161,2022/7/15 10:40,44,93,-49,-24
161,2022/7/15 10:50,44,70,-26,-12
161,2022/7/15 11:00,37,65,-28,35
161,2022/7/15 11:10,41,76,-35,-60
161,2022/7/15 11:20,38,83,-45,-72
161,2022/7/15 11:30,43,78,-35,-65
161,2022/7/15 11:40,42,69,-27,-46
161,2022/7/15 11:50,38,94,-56,6
161,2022/7/15 12:00,45,72,-27,-4
161,2022/7/15 12:10,49,83,-34,-16
161,2022/7/15 12:20,54,96,-42,12
161,2022/7/15 12:30,54,75,-21,62
161,2022/7/15 12:40,49,105,-56,-58
161,2022/7/15 12:50,45,78,-33,-27
161,2022/7/15 13:00,44,108,-64,-35
161,2022/7/15 13:10,45,97,-52,-39
161,2022/7/15 13:20,43,81,-38,-78
161,2022/7/15 13:30,43,93,-50,-17
161,2022/7/15 13:40,37,78,-41,-162
161,2022/7/15 13:50,40,105,-65,-50
161,2022/7/15 14:00,42,75,-33,-73
161,2022/7/15 14:10,40,103,-63,-96
161,2022/7/15 14:20,42,81,-39,-77
161,2022/7/15 14:30,45,73,-28,-107
161,2022/7/15 14:40,47,102,-55,-156
161,2022/7/15 14:50,43,82,-39,-130
161,2022/7/15 15:00,47,93,-46,-67
161,2022/7/15 15:10,45,94,-49,-148
161,2022/7/15 15:20,45,87,-42,-105
161,2022/7/15 15:30,49,98,-49,43
161,2022/7/15 15:40,66,104,-38,-242
161,2022/7/15 15:50,69,93,-24,-18
161,2022/7/15 16:00,70,110,-40,-121
161,2022/7/15 16:10,75,122,-47,-103
161,2022/7/15 16:20,74,93,-19,-181
161,2022/7/15 16:30,136,112,24,-104
161,2022/7/15 16:40,140,112,28,17
161,2022/7/15 16:50,135,105,30,-203
161,2022/7/15 17:00,199,127,72,4
161,2022/7/15 17:10,230,143,87,-43
161,2022/7/15 17:20,164,145,19,-152
161,2022/7/15 17:30,204,232,-28,-223
161,2022/7/15 17:40,217,207,10,-351
161,2022/7/15 17:50,138,333,-195,-1144
161,2022/7/15 18:00,211,333,-122,-1570
161,2022/7/15 18:10,271,318,-47,-949
161,2022/7/15 18:20,217,380,-163,-1180
161,2022/7/15 18:30,175,323,-148,-2033
161,2022/7/15 18:40,110,323,-213,-1682
161,2022/7/15 18:50,58,319,-261,-1306
161,2022/7/15 19:00,43,256,-213,-644
161,2022/7/15 19:10,48,179,-131,-533
161,2022/7/15 19:20,36,192,-156,-625
161,2022/7/15 19:30,35,151,-116,-647
161,2022/7/15 19:40,27,119,-92,-467
161,2022/7/15 19:50,33,124,-91,-422
161,2022/7/15 20:00,33,114,-81,-308
161,2022/7/15 20:10,33,124,-91,-327
161,2022/7/15 20:20,29,121,-92,-265
161,2022/7/15 20:30,38,105,-67,-215
161,2022/7/15 20:40,35,88,-53,-262
161,2022/7/15 20:50,28,113,-85,-263
161,2022/7/15 21:00,30,121,-91,-221
161,2022/7/15 21:10,29,105,-76,-273
161,2022/7/15 21:20,27,122,-95,-224
161,2022/7/15 21:30,26,125,-99,-247
161,2022/7/15 21:40,22,114,-92,-343
161,2022/7/15 21:50,19,107,-88,-241
161,2022/7/15 22:00,25,125,-100,-272
161,2022/7/15 22:10,20,106,-86,-246
161,2022/7/15 22:20,12,77,-65,-219
161,2022/7/15 22:30,2,115,-113,-290
161,2022/7/15 22:40,1,88,-87,-255
161,2022/7/15 22:50,0,66,-66,-211
152,2022/7/15 5:00,0,1,-1,12
152,2022/7/15 5:10,1,1,0,39
152,2022/7/15 5:20,4,1,3,50
152,2022/7/15 5:30,2,1,1,53
152,2022/7/15 5:40,5,1,4,63
152,2022/7/15 5:50,8,1,7,58
152,2022/7/15 6:00,9,2,7,83
152,2022/7/15 6:10,21,1,20,100
152,2022/7/15 6:20,20,38,-18,94
152,2022/7/15 6:30,23,6,17,156
152,2022/7/15 6:40,24,67,-43,84
152,2022/7/15 6:50,34,69,-35,200
152,2022/7/15 7:00,36,69,-33,601
152,2022/7/15 7:10,38,76,-38,532
152,2022/7/15 7:20,52,71,-19,1354
152,2022/7/15 7:30,55,93,-38,1504
152,2022/7/15 7:40,76,90,-14,2077
152,2022/7/15 7:50,95,120,-25,2380
152,2022/7/15 8:00,151,119,32,2670
152,2022/7/15 8:10,156,144,12,2311
152,2022/7/15 8:20,149,282,-133,2209
152,2022/7/15 8:30,103,317,-214,2217
152,2022/7/15 8:40,80,490,-410,885
152,2022/7/15 8:50,65,334,-269,492
152,2022/7/15 9:00,49,191,-142,999
152,2022/7/15 9:10,48,180,-132,398
152,2022/7/15 9:20,35,115,-80,483
152,2022/7/15 9:30,35,104,-69,136
152,2022/7/15 9:40,29,108,-79,-24
152,2022/7/15 9:50,34,105,-71,-68
152,2022/7/15 10:00,26,97,-71,-101
152,2022/7/15 10:10,27,80,-53,101
152,2022/7/15 10:20,27,71,-44,-75
152,2022/7/15 10:30,27,72,-45,-64
152,2022/7/15 10:40,24,69,-45,-69
152,2022/7/15 10:50,28,65,-37,-49
152,2022/7/15 11:00,28,75,-47,-12
152,2022/7/15 11:10,29,52,-23,-83
152,2022/7/15 11:20,28,76,-48,-120
152,2022/7/15 11:30,27,59,-32,-97
152,2022/7/15 11:40,30,65,-35,-81
152,2022/7/15 11:50,30,71,-41,-35
152,2022/7/15 12:00,28,57,-29,-33
152,2022/7/15 12:10,31,77,-46,-62
152,2022/7/15 12:20,32,62,-30,-18
152,2022/7/15 12:30,25,81,-56,6
152,2022/7/15 12:40,35,68,-33,-91
152,2022/7/15 12:50,29,69,-40,-67
152,2022/7/15 13:00,26,75,-49,-84
152,2022/7/15 13:10,29,71,-42,-81
152,2022/7/15 13:20,35,77,-42,-120
152,2022/7/15 13:30,32,68,-36,-53
152,2022/7/15 13:40,25,93,-68,-230
152,2022/7/15 13:50,26,60,-34,-84
152,2022/7/15 14:00,26,62,-36,-109
152,2022/7/15 14:10,25,77,-52,-148
152,2022/7/15 14:20,24,71,-47,-124
152,2022/7/15 14:30,28,75,-47,-154
152,2022/7/15 14:40,31,64,-33,-189
152,2022/7/15 14:50,28,76,-48,-178
152,2022/7/15 15:00,29,62,-33,-100
152,2022/7/15 15:10,35,69,-34,-182
152,2022/7/15 15:20,27,84,-57,-162
152,2022/7/15 15:30,29,69,-40,3
152,2022/7/15 15:40,37,80,-43,-285
152,2022/7/15 15:50,33,64,-31,-49
152,2022/7/15 16:00,37,91,-54,-175
152,2022/7/15 16:10,47,64,-17,-120
152,2022/7/15 16:20,38,72,-34,-215
152,2022/7/15 16:30,44,77,-33,-137
152,2022/7/15 16:40,45,81,-36,-19
152,2022/7/15 16:50,44,87,-43,-246
152,2022/7/15 17:00,64,87,-23,-19
152,2022/7/15 17:10,215,93,122,79
152,2022/7/15 17:20,130,93,37,-115
152,2022/7/15 17:30,140,108,32,-191
152,2022/7/15 17:40,233,103,130,-221
152,2022/7/15 17:50,198,106,92,-1052
152,2022/7/15 18:00,177,125,52,-1518
152,2022/7/15 18:10,552,100,452,-497
152,2022/7/15 18:20,270,107,163,-1017
152,2022/7/15 18:30,213,111,102,-1931
152,2022/7/15 18:40,187,126,61,-1621
152,2022/7/15 18:50,94,122,-28,-1334
152,2022/7/15 19:00,61,105,-44,-688
152,2022/7/15 19:10,54,112,-58,-591
152,2022/7/15 19:20,41,92,-51,-676
152,2022/7/15 19:30,38,92,-54,-701
152,2022/7/15 19:40,33,71,-38,-505
152,2022/7/15 19:50,30,69,-39,-461
152,2022/7/15 20:00,29,74,-45,-353
152,2022/7/15 20:10,39,62,-23,-350
152,2022/7/15 20:20,31,63,-32,-297
152,2022/7/15 20:30,29,72,-43,-258
152,2022/7/15 20:40,29,46,-17,-279
152,2022/7/15 20:50,26,67,-41,-304
152,2022/7/15 21:00,29,65,-36,-257
152,2022/7/15 21:10,40,52,-12,-285
152,2022/7/15 21:20,28,75,-47,-271
152,2022/7/15 21:30,28,55,-27,-274
152,2022/7/15 21:40,28,55,-27,-370
152,2022/7/15 21:50,19,62,-43,-284
152,2022/7/15 22:00,29,49,-20,-292
152,2022/7/15 22:10,28,52,-24,-270
152,2022/7/15 22:20,12,47,-35,-254
152,2022/7/15 22:30,6,38,-32,-322
152,2022/7/15 22:40,2,41,-39,-294
152,2022/7/15 22:50,0,38,-38,-249
170,2022/7/15 5:00,0,1,-1,11
170,2022/7/15 5:10,0,1,-1,38
170,2022/7/15 5:20,4,1,3,53
170,2022/7/15 5:30,5,2,3,56
170,2022/7/15 5:40,6,1,5,68
170,2022/7/15 5:50,7,2,5,63
170,2022/7/15 6:00,9,5,4,87
170,2022/7/15 6:10,15,2,13,113
170,2022/7/15 6:20,20,58,-38,56
170,2022/7/15 6:30,25,48,-23,133
170,2022/7/15 6:40,29,66,-37,47
170,2022/7/15 6:50,30,79,-49,151
170,2022/7/15 7:00,39,90,-51,550
170,2022/7/15 7:10,32,112,-80,452
170,2022/7/15 7:20,37,119,-82,1272
170,2022/7/15 7:30,39,109,-70,1434
170,2022/7/15 7:40,47,170,-123,1954
170,2022/7/15 7:50,53,197,-144,2236
170,2022/7/15 8:00,60,297,-237,2433
170,2022/7/15 8:10,55,316,-261,2050
170,2022/7/15 8:20,54,318,-264,1945
170,2022/7/15 8:30,54,504,-450,1767
170,2022/7/15 8:40,50,481,-431,454
170,2022/7/15 8:50,42,426,-384,108
170,2022/7/15 9:00,37,327,-290,709
170,2022/7/15 9:10,35,218,-183,215
170,2022/7/15 9:20,29,214,-185,298
170,2022/7/15 9:30,32,105,-73,63
170,2022/7/15 9:40,30,152,-122,-146
170,2022/7/15 9:50,30,124,-94,-162
170,2022/7/15 10:00,26,105,-79,-180
170,2022/7/15 10:10,27,104,-77,24
170,2022/7/15 10:20,27,106,-79,-154
170,2022/7/15 10:30,26,91,-65,-129
170,2022/7/15 10:40,28,69,-41,-110
170,2022/7/15 10:50,28,93,-65,-114
170,2022/7/15 11:00,28,68,-40,-52
170,2022/7/15 11:10,28,71,-43,-126
170,2022/7/15 11:20,30,87,-57,-177
170,2022/7/15 11:30,29,67,-38,-135
170,2022/7/15 11:40,35,81,-46,-127
170,2022/7/15 11:50,33,73,-40,-75
170,2022/7/15 12:00,27,72,-45,-78
170,2022/7/15 12:10,40,83,-43,-105
170,2022/7/15 12:20,36,77,-41,-59
170,2022/7/15 12:30,34,100,-66,-60
170,2022/7/15 12:40,33,92,-59,-150
170,2022/7/15 12:50,33,93,-60,-127
170,2022/7/15 13:00,31,73,-42,-126
170,2022/7/15 13:10,29,94,-65,-146
170,2022/7/15 13:20,27,87,-60,-180
170,2022/7/15 13:30,31,80,-49,-102
170,2022/7/15 13:40,29,82,-53,-283
170,2022/7/15 13:50,30,75,-45,-129
170,2022/7/15 14:00,30,76,-46,-155
170,2022/7/15 14:10,31,74,-43,-191
170,2022/7/15 14:20,39,91,-52,-176
170,2022/7/15 14:30,31,76,-45,-199
170,2022/7/15 14:40,33,70,-37,-226
170,2022/7/15 14:50,34,83,-49,-227
170,2022/7/15 15:00,46,65,-19,-119
170,2022/7/15 15:10,52,79,-27,-209
170,2022/7/15 15:20,44,70,-26,-188
170,2022/7/15 15:30,38,81,-43,-40
170,2022/7/15 15:40,42,73,-31,-316
170,2022/7/15 15:50,46,69,-23,-72
170,2022/7/15 16:00,44,80,-36,-211
170,2022/7/15 16:10,45,69,-24,-144
170,2022/7/15 16:20,47,92,-45,-260
170,2022/7/15 16:30,47,60,-13,-150
170,2022/7/15 16:40,57,83,-26,-45
170,2022/7/15 16:50,64,69,-5,-251
170,2022/7/15 17:00,114,93,21,2
170,2022/7/15 17:10,188,105,83,162
170,2022/7/15 17:20,168,103,65,-50
170,2022/7/15 17:30,214,105,109,-82
170,2022/7/15 17:40,428,105,323,102
170,2022/7/15 17:50,223,106,117,-935
170,2022/7/15 18:00,234,111,123,-1395
170,2022/7/15 18:10,361,112,249,-248
170,2022/7/15 18:20,274,120,154,-863
170,2022/7/15 18:30,205,110,95,-1836
170,2022/7/15 18:40,162,107,55,-1566
170,2022/7/15 18:50,87,104,-17,-1351
170,2022/7/15 19:00,59,82,-23,-711
170,2022/7/15 19:10,58,76,-18,-609
170,2022/7/15 19:20,47,72,-25,-701
170,2022/7/15 19:30,41,70,-29,-730
170,2022/7/15 19:40,43,64,-21,-526
170,2022/7/15 19:50,36,67,-31,-492
170,2022/7/15 20:00,31,58,-27,-380
170,2022/7/15 20:10,35,62,-27,-377
170,2022/7/15 20:20,33,62,-29,-326
170,2022/7/15 20:30,29,51,-22,-280
170,2022/7/15 20:40,27,60,-33,-312
170,2022/7/15 20:50,27,63,-36,-340
170,2022/7/15 21:00,28,40,-12,-269
170,2022/7/15 21:10,37,62,-25,-310
170,2022/7/15 21:20,30,52,-22,-293
170,2022/7/15 21:30,31,51,-20,-294
170,2022/7/15 21:40,30,63,-33,-403
170,2022/7/15 21:50,25,51,-26,-310
170,2022/7/15 22:00,23,43,-20,-312
170,2022/7/15 22:10,22,50,-28,-298
170,2022/7/15 22:20,22,46,-24,-278
170,2022/7/15 22:30,14,36,-22,-344
170,2022/7/15 22:40,3,71,-68,-362
170,2022/7/15 22:50,1,38,-37,-286
157,2022/7/15 5:00,0,1,-1,10
157,2022/7/15 5:10,2,1,1,39
157,2022/7/15 5:20,10,1,9,62
157,2022/7/15 5:30,5,5,0,56
157,2022/7/15 5:40,10,1,9,77
157,2022/7/15 5:50,13,5,8,71
157,2022/7/15 6:00,20,2,18,105
157,2022/7/15 6:10,25,5,20,133
157,2022/7/15 6:20,35,59,-24,32
157,2022/7/15 6:30,47,61,-14,119
157,2022/7/15 6:40,62,75,-13,34
157,2022/7/15 6:50,61,90,-29,122
157,2022/7/15 7:00,80,111,-31,519
157,2022/7/15 7:10,129,107,22,474
157,2022/7/15 7:20,152,130,22,1294
157,2022/7/15 7:30,175,178,-3,1431
157,2022/7/15 7:40,226,298,-72,1882
157,2022/7/15 7:50,266,381,-115,2121
157,2022/7/15 8:00,276,429,-153,2280
157,2022/7/15 8:10,330,580,-250,1800
157,2022/7/15 8:20,279,577,-298,1647
157,2022/7/15 8:30,275,1558,-1283,484
157,2022/7/15 8:40,240,1983,-1743,-1289
157,2022/7/15 8:50,206,1588,-1382,-1274
157,2022/7/15 9:00,178,489,-311,398
157,2022/7/15 9:10,162,492,-330,-115
157,2022/7/15 9:20,91,332,-241,57
157,2022/7/15 9:30,72,231,-159,-96
157,2022/7/15 9:40,58,177,-119,-265
157,2022/7/15 9:50,50,138,-88,-250
157,2022/7/15 10:00,46,104,-58,-238
157,2022/7/15 10:10,44,127,-83,-59
157,2022/7/15 10:20,42,87,-45,-199
157,2022/7/15 10:30,44,106,-62,-191
157,2022/7/15 10:40,41,105,-64,-174
157,2022/7/15 10:50,36,101,-65,-179
157,2022/7/15 11:00,40,108,-68,-120
157,2022/7/15 11:10,41,90,-49,-175
157,2022/7/15 11:20,35,93,-58,-235
157,2022/7/15 11:30,35,108,-73,-208
157,2022/7/15 11:40,44,96,-52,-179
157,2022/7/15 11:50,46,109,-63,-138
157,2022/7/15 12:00,45,113,-68,-146
157,2022/7/15 12:10,65,94,-29,-134
157,2022/7/15 12:20,58,112,-54,-113
157,2022/7/15 12:30,54,99,-45,-105
157,2022/7/15 12:40,53,109,-56,-206
157,2022/7/15 12:50,50,106,-56,-183
157,2022/7/15 13:00,47,100,-53,-179
157,2022/7/15 13:10,63,109,-46,-192
157,2022/7/15 13:20,60,111,-51,-231
157,2022/7/15 13:30,44,112,-68,-170
157,2022/7/15 13:40,43,92,-49,-332
157,2022/7/15 13:50,45,105,-60,-189
157,2022/7/15 14:00,45,100,-55,-210
157,2022/7/15 14:10,56,93,-37,-228
157,2022/7/15 14:20,53,111,-58,-234
157,2022/7/15 14:30,46,90,-44,-243
157,2022/7/15 14:40,47,106,-59,-285
157,2022/7/15 14:50,60,93,-33,-260
157,2022/7/15 15:00,68,104,-36,-155
157,2022/7/15 15:10,98,93,5,-204
157,2022/7/15 15:20,73,102,-29,-217
157,2022/7/15 15:30,59,109,-50,-90
157,2022/7/15 15:40,63,100,-37,-353
157,2022/7/15 15:50,68,103,-35,-107
157,2022/7/15 16:00,77,108,-31,-242
157,2022/7/15 16:10,109,100,9,-135
157,2022/7/15 16:20,97,100,-3,-263
157,2022/7/15 16:30,132,97,35,-115
157,2022/7/15 16:40,205,112,93,48
157,2022/7/15 16:50,222,124,98,-153
157,2022/7/15 17:00,269,121,148,150
157,2022/7/15 17:10,610,100,510,672
157,2022/7/15 17:20,428,122,306,256
157,2022/7/15 17:30,462,144,318,236
157,2022/7/15 17:40,1039,149,890,992
157,2022/7/15 17:50,715,159,556,-379
157,2022/7/15 18:00,658,192,466,-929
157,2022/7/15 18:10,1200,198,1002,754
157,2022/7/15 18:20,1030,178,852,-11
157,2022/7/15 18:30,608,178,430,-1406
157,2022/7/15 18:40,349,184,165,-1401
157,2022/7/15 18:50,305,184,121,-1230
157,2022/7/15 19:00,222,128,94,-617
157,2022/7/15 19:10,185,110,75,-534
157,2022/7/15 19:20,151,105,46,-655
157,2022/7/15 19:30,111,112,-1,-731
157,2022/7/15 19:40,76,114,-38,-564
157,2022/7/15 19:50,65,95,-30,-522
157,2022/7/15 20:00,64,95,-31,-411
157,2022/7/15 20:10,68,97,-29,-406
157,2022/7/15 20:20,64,88,-24,-350
157,2022/7/15 20:30,45,90,-45,-325
157,2022/7/15 20:40,61,95,-34,-346
157,2022/7/15 20:50,46,99,-53,-393
157,2022/7/15 21:00,47,92,-45,-314
157,2022/7/15 21:10,67,95,-28,-338
157,2022/7/15 21:20,43,95,-52,-345
157,2022/7/15 21:30,41,93,-52,-346
157,2022/7/15 21:40,35,92,-57,-460
157,2022/7/15 21:50,36,75,-39,-349
157,2022/7/15 22:00,27,72,-45,-357
157,2022/7/15 22:10,33,92,-59,-357
157,2022/7/15 22:20,27,75,-48,-326
157,2022/7/15 22:30,17,70,-53,-397
157,2022/7/15 22:40,10,71,-61,-423
157,2022/7/15 22:50,3,48,-45,-331
169,2022/7/15 5:00,0,1,-1,9
169,2022/7/15 5:10,1,1,0,39
169,2022/7/15 5:20,8,1,7,69
169,2022/7/15 5:30,10,5,5,61
169,2022/7/15 5:40,13,6,7,84
169,2022/7/15 5:50,14,2,12,83
169,2022/7/15 6:00,26,16,10,115
169,2022/7/15 6:10,32,22,10,143
169,2022/7/15 6:20,45,69,-24,8
169,2022/7/15 6:30,55,105,-50,69
169,2022/7/15 6:40,65,110,-45,-11
169,2022/7/15 6:50,84,109,-25,97
169,2022/7/15 7:00,164,107,57,576
169,2022/7/15 7:10,208,108,100,574
169,2022/7/15 7:20,217,220,-3,1291
169,2022/7/15 7:30,227,254,-27,1404
169,2022/7/15 7:40,281,504,-223,1659
169,2022/7/15 7:50,325,438,-113,2008
169,2022/7/15 8:00,475,1164,-689,1591
169,2022/7/15 8:10,597,1924,-1327,473
169,2022/7/15 8:20,574,2038,-1464,183
169,2022/7/15 8:30,392,2233,-1841,-1357
169,2022/7/15 8:40,345,3834,-3489,-4778
169,2022/7/15 8:50,282,1898,-1616,-2890
169,2022/7/15 9:00,239,1993,-1754,-1356
169,2022/7/15 9:10,220,1571,-1351,-1466
169,2022/7/15 9:20,206,586,-380,-323
169,2022/7/15 9:30,172,415,-243,-339
169,2022/7/15 9:40,140,493,-353,-618
169,2022/7/15 9:50,122,348,-226,-476
169,2022/7/15 10:00,82,256,-174,-412
169,2022/7/15 10:10,94,180,-86,-145
169,2022/7/15 10:20,82,180,-98,-297
169,2022/7/15 10:30,89,128,-39,-230
169,2022/7/15 10:40,74,105,-31,-205
169,2022/7/15 10:50,73,121,-48,-227
169,2022/7/15 11:00,71,129,-58,-178
169,2022/7/15 11:10,67,122,-55,-230
169,2022/7/15 11:20,72,122,-50,-285
169,2022/7/15 11:30,84,107,-23,-231
169,2022/7/15 11:40,83,100,-17,-196
169,2022/7/15 11:50,93,117,-24,-162
169,2022/7/15 12:00,102,118,-16,-162
169,2022/7/15 12:10,156,125,31,-103
169,2022/7/15 12:20,142,113,29,-84
169,2022/7/15 12:30,137,121,16,-89
169,2022/7/15 12:40,113,131,-18,-224
169,2022/7/15 12:50,96,108,-12,-195
169,2022/7/15 13:00,131,121,10,-169
169,2022/7/15 13:10,132,108,24,-168
169,2022/7/15 13:20,174,108,66,-165
169,2022/7/15 13:30,128,125,3,-167
169,2022/7/15 13:40,113,108,5,-327
169,2022/7/15 13:50,94,119,-25,-214
169,2022/7/15 14:00,110,109,1,-209
169,2022/7/15 14:10,139,110,29,-199
169,2022/7/15 14:20,149,102,47,-187
169,2022/7/15 14:30,133,113,20,-223
169,2022/7/15 14:40,140,121,19,-266
169,2022/7/15 14:50,156,116,40,-220
169,2022/7/15 15:00,170,118,52,-103
169,2022/7/15 15:10,216,124,92,-112
169,2022/7/15 15:20,179,116,63,-154
169,2022/7/15 15:30,195,116,79,-11
169,2022/7/15 15:40,198,112,86,-267
169,2022/7/15 15:50,204,118,86,-21
169,2022/7/15 16:00,216,103,113,-129
169,2022/7/15 16:10,263,109,154,19
169,2022/7/15 16:20,223,110,113,-150
169,2022/7/15 16:30,270,125,145,30
169,2022/7/15 16:40,336,122,214,262
169,2022/7/15 16:50,343,139,204,51
169,2022/7/15 17:00,692,108,584,734
169,2022/7/15 17:10,1033,149,884,1556
169,2022/7/15 17:20,790,190,600,856
169,2022/7/15 17:30,787,217,570,806
169,2022/7/15 17:40,1626,233,1393,2385
169,2022/7/15 17:50,1588,268,1320,941
169,2022/7/15 18:00,1202,301,901,-28
169,2022/7/15 18:10,1997,328,1669,2423
169,2022/7/15 18:20,1998,299,1699,1688
169,2022/7/15 18:30,1155,329,826,-580
169,2022/7/15 18:40,710,327,383,-1018
169,2022/7/15 18:50,608,286,322,-908
169,2022/7/15 19:00,375,180,195,-422
169,2022/7/15 19:10,336,145,191,-343
169,2022/7/15 19:20,271,116,155,-500
169,2022/7/15 19:30,244,111,133,-598
169,2022/7/15 19:40,217,89,128,-436
169,2022/7/15 19:50,199,115,84,-438
169,2022/7/15 20:00,187,99,88,-323
169,2022/7/15 20:10,203,104,99,-307
169,2022/7/15 20:20,205,102,103,-247
169,2022/7/15 20:30,190,107,83,-242
169,2022/7/15 20:40,161,108,53,-293
169,2022/7/15 20:50,157,116,41,-352
169,2022/7/15 21:00,175,108,67,-247
169,2022/7/15 21:10,207,112,95,-243
169,2022/7/15 21:20,110,110,0,-345
169,2022/7/15 21:30,127,104,23,-323
169,2022/7/15 21:40,65,110,-45,-505
169,2022/7/15 21:50,61,110,-49,-398
169,2022/7/15 22:00,44,92,-48,-405
169,2022/7/15 22:10,46,105,-59,-416
169,2022/7/15 22:20,33,92,-59,-385
169,2022/7/15 22:30,31,78,-47,-444
169,2022/7/15 22:40,22,61,-39,-462
169,2022/7/15 22:50,4,47,-43,-374
176,2022/7/15 5:00,0,1,-1,8
176,2022/7/15 5:10,1,1,0,39
176,2022/7/15 5:20,2,1,1,70
176,2022/7/15 5:30,8,1,7,68
176,2022/7/15 5:40,11,8,3,87
176,2022/7/15 5:50,16,6,10,93
176,2022/7/15 6:00,29,11,18,133
176,2022/7/15 6:10,40,59,-19,124
176,2022/7/15 6:20,32,41,-9,-1
176,2022/7/15 6:30,50,108,-58,11
176,2022/7/15 6:40,85,102,-17,-28
176,2022/7/15 6:50,150,124,26,123
176,2022/7/15 7:00,181,105,76,652
176,2022/7/15 7:10,231,181,50,624
176,2022/7/15 7:20,254,226,28,1319
176,2022/7/15 7:30,275,196,79,1483
176,2022/7/15 7:40,340,320,20,1679
176,2022/7/15 7:50,469,341,128,2136
176,2022/7/15 8:00,594,404,190,1781
176,2022/7/15 8:10,720,557,163,636
176,2022/7/15 8:20,589,565,24,207
176,2022/7/15 8:30,573,1080,-507,-1864
176,2022/7/15 8:40,346,1784,-1438,-6216
176,2022/7/15 8:50,282,1479,-1197,-4087
176,2022/7/15 9:00,239,1129,-890,-2246
176,2022/7/15 9:10,208,590,-382,-1848
176,2022/7/15 9:20,187,593,-406,-729
176,2022/7/15 9:30,169,427,-258,-597
176,2022/7/15 9:40,95,427,-332,-950
176,2022/7/15 9:50,80,377,-297,-773
176,2022/7/15 10:00,76,256,-180,-592
176,2022/7/15 10:10,64,227,-163,-308
176,2022/7/15 10:20,63,185,-122,-419
176,2022/7/15 10:30,67,181,-114,-344
176,2022/7/15 10:40,58,117,-59,-264
176,2022/7/15 10:50,59,146,-87,-314
176,2022/7/15 11:00,55,127,-72,-250
176,2022/7/15 11:10,58,144,-86,-316
176,2022/7/15 11:20,63,144,-81,-366
176,2022/7/15 11:30,65,119,-54,-285
176,2022/7/15 11:40,73,170,-97,-293
176,2022/7/15 11:50,74,109,-35,-197
176,2022/7/15 12:00,83,128,-45,-207
176,2022/7/15 12:10,129,119,10,-93
176,2022/7/15 12:20,109,110,-1,-85
176,2022/7/15 12:30,109,181,-72,-161
176,2022/7/15 12:40,133,111,22,-202
176,2022/7/15 12:50,132,192,-60,-255
176,2022/7/15 13:00,147,117,30,-139
176,2022/7/15 13:10,149,128,21,-147
176,2022/7/15 13:20,174,170,4,-161
176,2022/7/15 13:30,174,128,46,-121
176,2022/7/15 13:40,175,170,5,-322
176,2022/7/15 13:50,175,109,66,-148
176,2022/7/15 14:00,149,128,21,-188
176,2022/7/15 14:10,156,121,35,-164
176,2022/7/15 14:20,174,110,64,-123
176,2022/7/15 14:30,174,117,57,-166
176,2022/7/15 14:40,174,115,59,-207
176,2022/7/15 14:50,174,129,45,-175
176,2022/7/15 15:00,207,111,96,-7
176,2022/7/15 15:10,197,110,87,-25
176,2022/7/15 15:20,204,134,70,-84
176,2022/7/15 15:30,208,108,100,89
176,2022/7/15 15:40,202,170,32,-235
176,2022/7/15 15:50,206,119,87,66
176,2022/7/15 16:00,224,138,86,-43
176,2022/7/15 16:10,204,127,77,96
176,2022/7/15 16:20,223,181,42,-108
176,2022/7/15 16:30,268,179,89,119
176,2022/7/15 16:40,287,145,142,404
176,2022/7/15 16:50,291,234,57,108
176,2022/7/15 17:00,575,177,398,1132
176,2022/7/15 17:10,713,296,417,1973
176,2022/7/15 17:20,696,316,380,1236
176,2022/7/15 17:30,704,374,330,1136
176,2022/7/15 17:40,1158,491,667,3052
176,2022/7/15 17:50,805,427,378,1319
176,2022/7/15 18:00,836,420,416,388
176,2022/7/15 18:10,1352,421,931,3354
176,2022/7/15 18:20,1154,431,723,2411
176,2022/7/15 18:30,793,433,360,-220
176,2022/7/15 18:40,670,502,168,-850
176,2022/7/15 18:50,575,521,54,-854
176,2022/7/15 19:00,542,329,213,-209
176,2022/7/15 19:10,422,220,202,-141
176,2022/7/15 19:20,346,179,167,-333
176,2022/7/15 19:30,302,126,176,-422
176,2022/7/15 19:40,310,111,199,-237
176,2022/7/15 19:50,300,110,190,-248
176,2022/7/15 20:00,336,108,228,-95
176,2022/7/15 20:10,345,104,241,-66
176,2022/7/15 20:20,335,88,247,0
176,2022/7/15 20:30,344,107,237,-5
176,2022/7/15 20:40,336,108,228,-65
176,2022/7/15 20:50,328,104,224,-128
176,2022/7/15 21:00,318,105,213,-34
176,2022/7/15 21:10,428,111,317,74
176,2022/7/15 21:20,353,97,256,-89
176,2022/7/15 21:30,338,114,224,-99
176,2022/7/15 21:40,305,100,205,-300
176,2022/7/15 21:50,314,92,222,-176
176,2022/7/15 22:00,432,80,352,-53
176,2022/7/15 22:10,205,93,112,-304
176,2022/7/15 22:20,52,79,-27,-412
176,2022/7/15 22:30,28,87,-59,-503
176,2022/7/15 22:40,24,67,-43,-505
176,2022/7/15 22:50,8,70,-62,-436
160,2022/7/15 5:00,0,1,-1,7
160,2022/7/15 5:10,0,1,-1,38
160,2022/7/15 5:20,6,1,5,75
160,2022/7/15 5:30,19,1,18,86
160,2022/7/15 5:40,20,6,14,101
160,2022/7/15 5:50,20,5,15,108
160,2022/7/15 6:00,32,5,27,160
160,2022/7/15 6:10,36,33,3,127
160,2022/7/15 6:20,54,38,16,15
160,2022/7/15 6:30,62,38,24,35
160,2022/7/15 6:40,126,73,53,25
160,2022/7/15 6:50,149,69,80,203
160,2022/7/15 7:00,229,77,152,804
160,2022/7/15 7:10,255,69,186,810
160,2022/7/15 7:20,332,84,248,1567
160,2022/7/15 7:30,327,95,232,1715
160,2022/7/15 7:40,678,108,570,2249
160,2022/7/15 7:50,664,108,556,2692
160,2022/7/15 8:00,864,126,738,2519
160,2022/7/15 8:10,824,109,715,1351
160,2022/7/15 8:20,826,128,698,905
160,2022/7/15 8:30,628,150,478,-1386
160,2022/7/15 8:40,597,226,371,-5845
160,2022/7/15 8:50,328,171,157,-3930
160,2022/7/15 9:00,275,130,145,-2101
160,2022/7/15 9:10,236,129,107,-1741
160,2022/7/15 9:20,190,122,68,-661
160,2022/7/15 9:30,92,106,-14,-611
160,2022/7/15 9:40,71,110,-39,-989
160,2022/7/15 9:50,50,105,-55,-828
160,2022/7/15 10:00,49,92,-43,-635
160,2022/7/15 10:10,43,90,-47,-355
160,2022/7/15 10:20,38,84,-46,-465
160,2022/7/15 10:30,35,76,-41,-385
160,2022/7/15 10:40,35,92,-57,-321
160,2022/7/15 10:50,29,75,-46,-360
160,2022/7/15 11:00,31,86,-55,-305
160,2022/7/15 11:10,29,85,-56,-372
160,2022/7/15 11:20,31,75,-44,-410
160,2022/7/15 11:30,33,84,-51,-336
160,2022/7/15 11:40,34,83,-49,-342
160,2022/7/15 11:50,34,75,-41,-238
160,2022/7/15 12:00,37,91,-54,-261
160,2022/7/15 12:10,37,83,-46,-139
160,2022/7/15 12:20,43,90,-47,-132
160,2022/7/15 12:30,40,77,-37,-198
160,2022/7/15 12:40,42,93,-51,-253
160,2022/7/15 12:50,40,99,-59,-314
160,2022/7/15 13:00,43,96,-53,-192
160,2022/7/15 13:10,43,87,-44,-191
160,2022/7/15 13:20,43,77,-34,-195
160,2022/7/15 13:30,39,76,-37,-158
160,2022/7/15 13:40,40,76,-36,-358
160,2022/7/15 13:50,34,81,-47,-195
160,2022/7/15 14:00,36,90,-54,-242
160,2022/7/15 14:10,37,92,-55,-219
160,2022/7/15 14:20,38,98,-60,-183
160,2022/7/15 14:30,36,78,-42,-208
160,2022/7/15 14:40,39,87,-48,-255
160,2022/7/15 14:50,33,87,-54,-229
160,2022/7/15 15:00,35,107,-72,-79
160,2022/7/15 15:10,37,96,-59,-84
160,2022/7/15 15:20,37,102,-65,-149
160,2022/7/15 15:30,39,103,-64,25
160,2022/7/15 15:40,37,93,-56,-291
160,2022/7/15 15:50,31,106,-75,-9
160,2022/7/15 16:00,45,102,-57,-100
160,2022/7/15 16:10,45,104,-59,37
160,2022/7/15 16:20,43,105,-62,-170
160,2022/7/15 16:30,47,87,-40,79
160,2022/7/15 16:40,72,118,-46,358
160,2022/7/15 16:50,73,115,-42,66
160,2022/7/15 17:00,175,112,63,1195
160,2022/7/15 17:10,163,151,12,1985
160,2022/7/15 17:20,102,168,-66,1170
160,2022/7/15 17:30,131,225,-94,1042
160,2022/7/15 17:40,183,269,-86,2966
160,2022/7/15 17:50,73,298,-225,1094
160,2022/7/15 18:00,92,334,-242,146
160,2022/7/15 18:10,129,323,-194,3160
160,2022/7/15 18:20,97,333,-236,2175
160,2022/7/15 18:30,73,319,-246,-466
160,2022/7/15 18:40,67,334,-267,-1117
160,2022/7/15 18:50,45,299,-254,-1108
160,2022/7/15 19:00,45,223,-178,-387
160,2022/7/15 19:10,40,147,-107,-248
160,2022/7/15 19:20,37,109,-72,-405
160,2022/7/15 19:30,34,105,-71,-493
160,2022/7/15 19:40,27,124,-97,-334
160,2022/7/15 19:50,27,104,-77,-325
160,2022/7/15 20:00,33,104,-71,-166
160,2022/7/15 20:10,32,114,-82,-148
160,2022/7/15 20:20,30,107,-77,-77
160,2022/7/15 20:30,35,103,-68,-73
160,2022/7/15 20:40,37,114,-77,-142
160,2022/7/15 20:50,32,101,-69,-197
160,2022/7/15 21:00,32,112,-80,-114
160,2022/7/15 21:10,42,108,-66,8
160,2022/7/15 21:20,34,102,-68,-157
160,2022/7/15 21:30,34,102,-68,-167
160,2022/7/15 21:40,35,106,-71,-371
160,2022/7/15 21:50,29,94,-65,-241
160,2022/7/15 22:00,31,95,-64,-117
160,2022/7/15 22:10,40,93,-53,-357
160,2022/7/15 22:20,26,94,-68,-480
160,2022/7/15 22:30,16,94,-78,-581
160,2022/7/15 22:40,17,96,-79,-584
160,2022/7/15 22:50,10,73,-63,-499
151,2022/7/15 5:00,0,1,-1,6
151,2022/7/15 5:10,1,1,0,38
151,2022/7/15 5:20,13,1,12,87
151,2022/7/15 5:30,25,1,24,110
151,2022/7/15 5:40,20,16,4,105
151,2022/7/15 5:50,40,12,28,136
151,2022/7/15 6:00,53,11,42,202
151,2022/7/15 6:10,58,60,-2,125
151,2022/7/15 6:20,93,48,45,60
151,2022/7/15 6:30,162,72,90,125
151,2022/7/15 6:40,225,109,116,141
151,2022/7/15 6:50,266,108,158,361
151,2022/7/15 7:00,318,106,212,1016
151,2022/7/15 7:10,365,107,258,1068
151,2022/7/15 7:20,393,144,249,1816
151,2022/7/15 7:30,597,192,405,2120
151,2022/7/15 7:40,693,284,409,2658
151,2022/7/15 7:50,827,331,496,3188
151,2022/7/15 8:00,1041,413,628,3147
151,2022/7/15 8:10,1213,572,641,1992
151,2022/7/15 8:20,1049,1102,-53,852
151,2022/7/15 8:30,862,1115,-253,-1639
151,2022/7/15 8:40,666,1543,-877,-6722
151,2022/7/15 8:50,588,558,30,-3900
151,2022/7/15 9:00,359,501,-142,-2243
151,2022/7/15 9:10,339,532,-193,-1934
151,2022/7/15 9:20,269,330,-61,-722
151,2022/7/15 9:30,230,195,35,-576
151,2022/7/15 9:40,212,254,-42,-1031
151,2022/7/15 9:50,170,190,-20,-848
151,2022/7/15 10:00,162,144,18,-617
151,2022/7/15 10:10,114,111,3,-352
151,2022/7/15 10:20,101,110,-9,-474
151,2022/7/15 10:30,77,127,-50,-435
151,2022/7/15 10:40,76,123,-47,-368
151,2022/7/15 10:50,80,123,-43,-403
151,2022/7/15 11:00,73,104,-31,-336
151,2022/7/15 11:10,72,119,-47,-419
151,2022/7/15 11:20,74,125,-51,-461
151,2022/7/15 11:30,76,116,-40,-376
151,2022/7/15 11:40,80,108,-28,-370
151,2022/7/15 11:50,76,123,-47,-285
151,2022/7/15 12:00,90,120,-30,-291
151,2022/7/15 12:10,113,117,-4,-143
151,2022/7/15 12:20,129,115,14,-118
151,2022/7/15 12:30,110,122,-12,-210
151,2022/7/15 12:40,104,110,-6,-259
151,2022/7/15 12:50,92,124,-32,-346
151,2022/7/15 13:00,112,125,-13,-205
151,2022/7/15 13:10,140,120,20,-171
151,2022/7/15 13:20,128,111,17,-178
151,2022/7/15 13:30,96,123,-27,-185
151,2022/7/15 13:40,93,104,-11,-369
151,2022/7/15 13:50,84,105,-21,-216
151,2022/7/15 14:00,113,123,-10,-252
151,2022/7/15 14:10,102,121,-19,-238
151,2022/7/15 14:20,82,111,-29,-212
151,2022/7/15 14:30,77,109,-32,-240
151,2022/7/15 14:40,92,122,-30,-285
151,2022/7/15 14:50,82,110,-28,-257
151,2022/7/15 15:00,130,104,26,-53
151,2022/7/15 15:10,118,118,0,-84
151,2022/7/15 15:20,126,108,18,-131
151,2022/7/15 15:30,138,125,13,38
151,2022/7/15 15:40,137,133,4,-287
151,2022/7/15 15:50,174,117,57,48
151,2022/7/15 16:00,176,128,48,-52
151,2022/7/15 16:10,199,125,74,111
151,2022/7/15 16:20,201,119,82,-88
151,2022/7/15 16:30,229,153,76,155
151,2022/7/15 16:40,262,181,81,439
151,2022/7/15 16:50,330,159,171,237
151,2022/7/15 17:00,576,176,400,1595
151,2022/7/15 17:10,697,214,483,2468
151,2022/7/15 17:20,569,322,247,1417
151,2022/7/15 17:30,614,377,237,1279
151,2022/7/15 17:40,658,431,227,3193
151,2022/7/15 17:50,618,500,118,1212
151,2022/7/15 18:00,608,501,107,253
151,2022/7/15 18:10,671,431,240,3400
151,2022/7/15 18:20,579,503,76,2251
151,2022/7/15 18:30,338,502,-164,-630
151,2022/7/15 18:40,294,502,-208,-1325
151,2022/7/15 18:50,274,434,-160,-1268
151,2022/7/15 19:00,237,336,-99,-486
151,2022/7/15 19:10,195,209,-14,-262
151,2022/7/15 19:20,180,191,-11,-416
151,2022/7/15 19:30,138,137,1,-492
151,2022/7/15 19:40,114,107,7,-327
151,2022/7/15 19:50,78,111,-33,-358
151,2022/7/15 20:00,74,122,-48,-214
151,2022/7/15 20:10,79,124,-45,-193
151,2022/7/15 20:20,74,119,-45,-122
151,2022/7/15 20:30,72,107,-35,-108
151,2022/7/15 20:40,64,123,-59,-201
151,2022/7/15 20:50,74,110,-36,-233
151,2022/7/15 21:00,85,129,-44,-158
151,2022/7/15 21:10,115,122,-7,1
151,2022/7/15 21:20,71,123,-52,-209
151,2022/7/15 21:30,74,123,-49,-216
151,2022/7/15 21:40,56,101,-45,-416
151,2022/7/15 21:50,42,103,-61,-302
151,2022/7/15 22:00,41,109,-68,-185
151,2022/7/15 22:10,37,110,-73,-430
151,2022/7/15 22:20,24,105,-81,-561
151,2022/7/15 22:30,22,99,-77,-658
151,2022/7/15 22:40,16,77,-61,-645
151,2022/7/15 22:50,11,76,-65,-564
175,2022/7/15 5:00,0,1,-1,5
175,2022/7/15 5:10,0,1,-1,37
175,2022/7/15 5:20,0,1,-1,86
175,2022/7/15 5:30,20,1,19,129
175,2022/7/15 5:40,25,6,19,124
175,2022/7/15 5:50,31,6,25,161
175,2022/7/15 6:00,43,11,32,234
175,2022/7/15 6:10,57,40,17,142
175,2022/7/15 6:20,71,45,26,86
175,2022/7/15 6:30,147,55,92,217
175,2022/7/15 6:40,213,74,139,280
175,2022/7/15 6:50,243,67,176,537
175,2022/7/15 7:00,278,67,211,1227
175,2022/7/15 7:10,337,76,261,1329
175,2022/7/15 7:20,574,90,484,2300
175,2022/7/15 7:30,723,88,635,2755
175,2022/7/15 7:40,818,104,714,3372
175,2022/7/15 7:50,1059,107,952,4140
175,2022/7/15 8:00,1207,224,983,4130
175,2022/7/15 8:10,1361,326,1035,3027
175,2022/7/15 8:20,1213,375,838,1690
175,2022/7/15 8:30,1053,533,520,-1119
175,2022/7/15 8:40,677,507,170,-6552
175,2022/7/15 8:50,590,318,272,-3628
175,2022/7/15 9:00,560,197,363,-1880
175,2022/7/15 9:10,326,159,167,-1767
175,2022/7/15 9:20,280,121,159,-563
175,2022/7/15 9:30,219,122,97,-479
175,2022/7/15 9:40,177,123,54,-977
175,2022/7/15 9:50,145,88,57,-791
175,2022/7/15 10:00,94,109,-15,-632
175,2022/7/15 10:10,76,105,-29,-381
175,2022/7/15 10:20,69,109,-40,-514
175,2022/7/15 10:30,69,106,-37,-472
175,2022/7/15 10:40,49,100,-51,-419
175,2022/7/15 10:50,43,101,-58,-461
175,2022/7/15 11:00,45,108,-63,-399
175,2022/7/15 11:10,50,96,-46,-465
175,2022/7/15 11:20,58,105,-47,-508
175,2022/7/15 11:30,59,101,-42,-418
175,2022/7/15 11:40,62,111,-49,-419
175,2022/7/15 11:50,63,105,-42,-327
175,2022/7/15 12:00,74,105,-31,-322
175,2022/7/15 12:10,74,103,-29,-172
175,2022/7/15 12:20,85,111,-26,-144
175,2022/7/15 12:30,74,105,-31,-241
175,2022/7/15 12:40,73,111,-38,-297
175,2022/7/15 12:50,70,108,-38,-384
175,2022/7/15 13:00,81,108,-27,-232
175,2022/7/15 13:10,75,106,-31,-202
175,2022/7/15 13:20,69,105,-36,-214
175,2022/7/15 13:30,74,111,-37,-222
175,2022/7/15 13:40,60,108,-48,-417
175,2022/7/15 13:50,62,105,-43,-259
175,2022/7/15 14:00,53,108,-55,-307
175,2022/7/15 14:10,51,107,-56,-294
175,2022/7/15 14:20,50,104,-54,-266
175,2022/7/15 14:30,57,106,-49,-289
175,2022/7/15 14:40,47,106,-59,-344
175,2022/7/15 14:50,43,106,-63,-320
175,2022/7/15 15:00,67,108,-41,-94
175,2022/7/15 15:10,71,122,-51,-135
175,2022/7/15 15:20,64,102,-38,-169
175,2022/7/15 15:30,66,127,-61,-23
175,2022/7/15 15:40,76,109,-33,-320
175,2022/7/15 15:50,69,124,-55,-7
175,2022/7/15 16:00,76,110,-34,-86
175,2022/7/15 16:10,92,123,-31,80
175,2022/7/15 16:20,83,105,-22,-110
175,2022/7/15 16:30,133,110,23,178
175,2022/7/15 16:40,174,110,64,503
175,2022/7/15 16:50,148,159,-11,226
175,2022/7/15 17:00,258,189,69,1664
175,2022/7/15 17:10,344,210,134,2602
175,2022/7/15 17:20,244,295,-51,1366
175,2022/7/15 17:30,268,322,-54,1225
175,2022/7/15 17:40,568,531,37,3230
175,2022/7/15 17:50,310,434,-124,1088
175,2022/7/15 18:00,269,418,-149,104
175,2022/7/15 18:10,349,420,-71,3329
175,2022/7/15 18:20,263,440,-177,2074
175,2022/7/15 18:30,220,420,-200,-830
175,2022/7/15 18:40,191,436,-245,-1570
175,2022/7/15 18:50,155,534,-379,-1647
175,2022/7/15 19:00,129,349,-220,-706
175,2022/7/15 19:10,131,322,-191,-453
175,2022/7/15 19:20,77,198,-121,-537
175,2022/7/15 19:30,65,184,-119,-611
175,2022/7/15 19:40,60,143,-83,-410
175,2022/7/15 19:50,54,111,-57,-415
175,2022/7/15 20:00,53,110,-57,-271
175,2022/7/15 20:10,58,110,-52,-245
175,2022/7/15 20:20,46,121,-75,-197
175,2022/7/15 20:30,47,113,-66,-174
175,2022/7/15 20:40,43,114,-71,-272
175,2022/7/15 20:50,46,103,-57,-290
175,2022/7/15 21:00,44,125,-81,-239
175,2022/7/15 21:10,42,126,-84,-83
175,2022/7/15 21:20,38,110,-72,-281
175,2022/7/15 21:30,34,122,-88,-304
175,2022/7/15 21:40,30,122,-92,-508
175,2022/7/15 21:50,27,109,-82,-384
175,2022/7/15 22:00,29,122,-93,-278
175,2022/7/15 22:10,26,102,-76,-506
175,2022/7/15 22:20,24,120,-96,-657
175,2022/7/15 22:30,20,108,-88,-746
175,2022/7/15 22:40,13,93,-80,-725
175,2022/7/15 22:50,8,87,-79,-643
177,2022/7/15 5:00,0,1,-1,4
177,2022/7/15 5:10,1,1,0,37
177,2022/7/15 5:20,4,1,3,89
177,2022/7/15 5:30,13,1,12,141
177,2022/7/15 5:40,18,8,10,134
177,2022/7/15 5:50,25,12,13,174
177,2022/7/15 6:00,31,23,8,242
177,2022/7/15 6:10,45,31,14,156
177,2022/7/15 6:20,61,38,23,109
177,2022/7/15 6:30,98,54,44,261
177,2022/7/15 6:40,194,61,133,413
177,2022/7/15 6:50,234,62,172,709
177,2022/7/15 7:00,278,93,185,1412
177,2022/7/15 7:10,340,105,235,1564
177,2022/7/15 7:20,600,108,492,2792
177,2022/7/15 7:30,698,108,590,3345
177,2022/7/15 7:40,1059,126,933,4305
177,2022/7/15 7:50,1219,110,1109,5249
177,2022/7/15 8:00,1365,112,1253,5383
177,2022/7/15 8:10,1573,128,1445,4472
177,2022/7/15 8:20,1361,184,1177,2867
177,2022/7/15 8:30,1177,256,921,-198
177,2022/7/15 8:40,815,327,488,-6064
177,2022/7/15 8:50,720,208,512,-3116
177,2022/7/15 9:00,583,185,398,-1482
177,2022/7/15 9:10,317,144,173,-1594
177,2022/7/15 9:20,277,121,156,-407
177,2022/7/15 9:30,239,126,113,-366
177,2022/7/15 9:40,186,122,64,-913
177,2022/7/15 9:50,156,109,47,-744
177,2022/7/15 10:00,95,111,-16,-648
177,2022/7/15 10:10,76,105,-29,-410
177,2022/7/15 10:20,69,93,-24,-538
177,2022/7/15 10:30,52,93,-41,-513
177,2022/7/15 10:40,48,80,-32,-451
177,2022/7/15 10:50,47,84,-37,-498
177,2022/7/15 11:00,47,101,-54,-453
177,2022/7/15 11:10,48,91,-43,-508
177,2022/7/15 11:20,45,87,-42,-550
177,2022/7/15 11:30,45,75,-30,-448
177,2022/7/15 11:40,45,93,-48,-467
177,2022/7/15 11:50,45,87,-42,-369
177,2022/7/15 12:00,48,96,-48,-370
177,2022/7/15 12:10,55,88,-33,-205
177,2022/7/15 12:20,70,93,-23,-167
177,2022/7/15 12:30,46,96,-50,-291
177,2022/7/15 12:40,55,91,-36,-333
177,2022/7/15 12:50,56,104,-48,-432
177,2022/7/15 13:00,57,91,-34,-266
177,2022/7/15 13:10,58,106,-48,-250
177,2022/7/15 13:20,48,104,-56,-270
177,2022/7/15 13:30,43,99,-56,-278
177,2022/7/15 13:40,46,99,-53,-470
177,2022/7/15 13:50,45,93,-48,-307
177,2022/7/15 14:00,45,105,-60,-367
177,2022/7/15 14:10,44,97,-53,-347
177,2022/7/15 14:20,44,102,-58,-324
177,2022/7/15 14:30,44,114,-70,-359
177,2022/7/15 14:40,52,108,-56,-400
177,2022/7/15 14:50,54,105,-51,-371
177,2022/7/15 15:00,45,108,-63,-157
177,2022/7/15 15:10,50,87,-37,-172
177,2022/7/15 15:20,47,102,-55,-224
177,2022/7/15 15:30,58,122,-64,-87
177,2022/7/15 15:40,46,125,-79,-399
177,2022/7/15 15:50,47,122,-75,-82
177,2022/7/15 16:00,49,123,-74,-160
177,2022/7/15 16:10,76,106,-30,50
177,2022/7/15 16:20,67,125,-58,-168
177,2022/7/15 16:30,70,110,-40,138
177,2022/7/15 16:40,97,154,-57,446
177,2022/7/15 16:50,74,110,-36,190
177,2022/7/15 17:00,181,229,-48,1616
177,2022/7/15 17:10,244,220,24,2626
177,2022/7/15 17:20,220,316,-96,1270
177,2022/7/15 17:30,216,376,-160,1065
177,2022/7/15 17:40,268,534,-266,2964
177,2022/7/15 17:50,237,499,-262,826
177,2022/7/15 18:00,197,430,-233,-129
177,2022/7/15 18:10,234,434,-200,3129
177,2022/7/15 18:20,179,432,-253,1821
177,2022/7/15 18:30,157,435,-278,-1108
177,2022/7/15 18:40,176,428,-252,-1822
177,2022/7/15 18:50,131,429,-298,-1945
177,2022/7/15 19:00,72,380,-308,-1014
177,2022/7/15 19:10,68,326,-258,-711
177,2022/7/15 19:20,46,232,-186,-723
177,2022/7/15 19:30,44,178,-134,-745
177,2022/7/15 19:40,41,184,-143,-553
177,2022/7/15 19:50,39,115,-76,-491
177,2022/7/15 20:00,39,116,-77,-348
177,2022/7/15 20:10,39,111,-72,-317
177,2022/7/15 20:20,38,121,-83,-280
177,2022/7/15 20:30,32,111,-79,-253
177,2022/7/15 20:40,35,124,-89,-361
177,2022/7/15 20:50,39,119,-80,-370
177,2022/7/15 21:00,38,104,-66,-305
177,2022/7/15 21:10,33,113,-80,-163
177,2022/7/15 21:20,35,134,-99,-380
177,2022/7/15 21:30,32,124,-92,-396
177,2022/7/15 21:40,33,116,-83,-591
177,2022/7/15 21:50,24,123,-99,-483
177,2022/7/15 22:00,27,113,-86,-364
177,2022/7/15 22:10,25,106,-81,-587
177,2022/7/15 22:20,19,121,-102,-759
177,2022/7/15 22:30,18,105,-87,-833
177,2022/7/15 22:40,14,93,-79,-804
177,2022/7/15 22:50,8,72,-64,-707
162,2022/7/15 5:00,0,1,-1,3
162,2022/7/15 5:10,0,1,-1,36
162,2022/7/15 5:20,0,1,-1,88
162,2022/7/15 5:30,64,1,63,204
162,2022/7/15 5:40,53,37,16,150
162,2022/7/15 5:50,32,31,1,175
162,2022/7/15 6:00,54,97,-43,199
162,2022/7/15 6:10,54,121,-67,89
162,2022/7/15 6:20,67,100,-33,76
162,2022/7/15 6:30,147,182,-35,226
162,2022/7/15 6:40,175,282,-107,306
162,2022/7/15 6:50,247,312,-65,644
162,2022/7/15 7:00,288,376,-88,1324
162,2022/7/15 7:10,326,441,-115,1449
162,2022/7/15 7:20,655,464,191,2983
162,2022/7/15 7:30,732,582,150,3495
162,2022/7/15 7:40,1469,1124,345,4650
162,2022/7/15 7:50,2011,1555,456,5705
162,2022/7/15 8:00,1968,1822,146,5529
162,2022/7/15 8:10,1981,2548,-567,3905
162,2022/7/15 8:20,2006,2185,-179,2688
162,2022/7/15 8:30,1999,2370,-371,-569
162,2022/7/15 8:40,1645,2157,-512,-6576
162,2022/7/15 8:50,1220,2487,-1267,-4383
162,2022/7/15 9:00,1145,1651,-506,-1988
162,2022/7/15 9:10,672,1108,-436,-2030
162,2022/7/15 9:20,668,587,81,-326
162,2022/7/15 9:30,579,404,175,-191
162,2022/7/15 9:40,587,411,176,-737
162,2022/7/15 9:50,381,522,-141,-885
162,2022/7/15 10:00,335,487,-152,-800
162,2022/7/15 10:10,315,368,-53,-463
162,2022/7/15 10:20,434,336,98,-440
162,2022/7/15 10:30,370,325,45,-468
162,2022/7/15 10:40,343,337,6,-445
162,2022/7/15 10:50,311,260,51,-447
162,2022/7/15 11:00,348,324,24,-429
162,2022/7/15 11:10,264,321,-57,-565
162,2022/7/15 11:20,267,290,-23,-573
162,2022/7/15 11:30,267,274,-7,-455
162,2022/7/15 11:40,343,232,111,-356
162,2022/7/15 11:50,334,275,59,-310
162,2022/7/15 12:00,291,268,23,-347
162,2022/7/15 12:10,327,296,31,-174
162,2022/7/15 12:20,325,311,14,-153
162,2022/7/15 12:30,306,307,-1,-292
162,2022/7/15 12:40,357,469,-112,-445
162,2022/7/15 12:50,312,292,20,-412
162,2022/7/15 13:00,261,367,-106,-372
162,2022/7/15 13:10,307,304,3,-247
162,2022/7/15 13:20,318,273,45,-225
162,2022/7/15 13:30,270,313,-43,-321
162,2022/7/15 13:40,300,304,-4,-474
162,2022/7/15 13:50,461,274,187,-120
162,2022/7/15 14:00,290,276,14,-353
162,2022/7/15 14:10,265,297,-32,-379
162,2022/7/15 14:20,329,291,38,-286
162,2022/7/15 14:30,272,300,-28,-387
162,2022/7/15 14:40,313,289,24,-376
162,2022/7/15 14:50,333,293,40,-331
162,2022/7/15 15:00,269,296,-27,-184
162,2022/7/15 15:10,334,288,46,-126
162,2022/7/15 15:20,550,359,191,-33
162,2022/7/15 15:30,368,291,77,-10
162,2022/7/15 15:40,458,273,185,-214
162,2022/7/15 15:50,589,468,121,39
162,2022/7/15 16:00,546,307,239,79
162,2022/7/15 16:10,455,315,140,190
162,2022/7/15 16:20,462,463,-1,-169
162,2022/7/15 16:30,591,469,122,260
162,2022/7/15 16:40,656,478,178,624
162,2022/7/15 16:50,663,460,203,393
162,2022/7/15 17:00,708,479,229,1845
162,2022/7/15 17:10,1139,480,659,3285
162,2022/7/15 17:20,1195,570,625,1895
162,2022/7/15 17:30,1152,1365,-213,852
162,2022/7/15 17:40,1364,1368,-4,2960
162,2022/7/15 17:50,1591,1467,124,950
162,2022/7/15 18:00,1360,1847,-487,-616
162,2022/7/15 18:10,1564,1839,-275,2854
162,2022/7/15 18:20,1360,1683,-323,1498
162,2022/7/15 18:30,1560,1806,-246,-1354
162,2022/7/15 18:40,1210,1759,-549,-2371
162,2022/7/15 18:50,1019,931,88,-1857
162,2022/7/15 19:00,638,568,70,-944
162,2022/7/15 19:10,661,415,246,-465
162,2022/7/15 19:20,577,474,103,-620
162,2022/7/15 19:30,573,322,251,-494
162,2022/7/15 19:40,350,320,30,-523
162,2022/7/15 19:50,570,242,328,-163
162,2022/7/15 20:00,267,214,53,-295
162,2022/7/15 20:10,248,292,-44,-361
162,2022/7/15 20:20,205,176,29,-251
162,2022/7/15 20:30,263,198,65,-188
162,2022/7/15 20:40,254,198,56,-305
162,2022/7/15 20:50,267,181,86,-284
162,2022/7/15 21:00,170,186,-16,-321
162,2022/7/15 21:10,212,234,-22,-185
162,2022/7/15 21:20,172,208,-36,-416
162,2022/7/15 21:30,167,155,12,-384
162,2022/7/15 21:40,145,234,-89,-680
162,2022/7/15 21:50,167,147,20,-463
162,2022/7/15 22:00,120,108,12,-352
162,2022/7/15 22:10,77,146,-69,-656
162,2022/7/15 22:20,62,149,-87,-846
162,2022/7/15 22:30,49,119,-70,-903
162,2022/7/15 22:40,34,98,-64,-868
162,2022/7/15 22:50,25,72,-47,-754
149,2022/7/15 5:00,0,1,-1,2
149,2022/7/15 5:10,0,1,-1,35
149,2022/7/15 5:20,2,1,1,89
149,2022/7/15 5:30,7,1,6,210
149,2022/7/15 5:40,22,1,21,171
149,2022/7/15 5:50,32,23,9,184
149,2022/7/15 6:00,27,51,-24,175
149,2022/7/15 6:10,34,38,-4,85
149,2022/7/15 6:20,37,50,-13,63
149,2022/7/15 6:30,48,62,-14,212
149,2022/7/15 6:40,59,73,-14,292
149,2022/7/15 6:50,86,99,-13,631
149,2022/7/15 7:00,92,113,-21,1303
149,2022/7/15 7:10,124,105,19,1468
149,2022/7/15 7:20,166,120,46,3029
149,2022/7/15 7:30,217,197,20,3515
149,2022/7/15 7:40,242,256,-14,4636
149,2022/7/15 7:50,276,299,-23,5682
149,2022/7/15 8:00,277,230,47,5576
149,2022/7/15 8:10,332,317,15,3920
149,2022/7/15 8:20,279,297,-18,2670
149,2022/7/15 8:30,253,334,-81,-650
149,2022/7/15 8:40,221,346,-125,-6701
149,2022/7/15 8:50,187,298,-111,-4494
149,2022/7/15 9:00,105,198,-93,-2081
149,2022/7/15 9:10,79,128,-49,-2079
149,2022/7/15 9:20,68,127,-59,-385
149,2022/7/15 9:30,56,109,-53,-244
149,2022/7/15 9:40,51,114,-63,-800
149,2022/7/15 9:50,48,108,-60,-945
149,2022/7/15 10:00,45,106,-61,-861
149,2022/7/15 10:10,44,117,-73,-536
149,2022/7/15 10:20,46,105,-59,-499
149,2022/7/15 10:30,42,104,-62,-530
149,2022/7/15 10:40,43,103,-60,-505
149,2022/7/15 10:50,43,105,-62,-509
149,2022/7/15 11:00,43,110,-67,-496
149,2022/7/15 11:10,46,99,-53,-618
149,2022/7/15 11:20,45,105,-60,-633
149,2022/7/15 11:30,44,98,-54,-509
149,2022/7/15 11:40,41,101,-60,-416
149,2022/7/15 11:50,47,92,-45,-355
149,2022/7/15 12:00,48,100,-52,-399
149,2022/7/15 12:10,49,99,-50,-224
149,2022/7/15 12:20,47,105,-58,-211
149,2022/7/15 12:30,48,112,-64,-356
149,2022/7/15 12:40,54,101,-47,-492
149,2022/7/15 12:50,47,106,-59,-471
149,2022/7/15 13:00,45,110,-65,-437
149,2022/7/15 13:10,52,108,-56,-303
149,2022/7/15 13:20,49,105,-56,-281
149,2022/7/15 13:30,51,104,-53,-374
149,2022/7/15 13:40,56,88,-32,-506
149,2022/7/15 13:50,51,99,-48,-168
149,2022/7/15 14:00,55,110,-55,-408
149,2022/7/15 14:10,47,101,-54,-433
149,2022/7/15 14:20,57,106,-49,-335
149,2022/7/15 14:30,56,104,-48,-435
149,2022/7/15 14:40,54,112,-58,-434
149,2022/7/15 14:50,54,112,-58,-389
149,2022/7/15 15:00,59,96,-37,-221
149,2022/7/15 15:10,70,111,-41,-167
149,2022/7/15 15:20,62,99,-37,-70
149,2022/7/15 15:30,75,110,-35,-45
149,2022/7/15 15:40,73,105,-32,-246
149,2022/7/15 15:50,68,97,-29,10
149,2022/7/15 16:00,76,102,-26,53
149,2022/7/15 16:10,77,112,-35,155
149,2022/7/15 16:20,74,103,-29,-198
149,2022/7/15 16:30,91,112,-21,239
149,2022/7/15 16:40,179,108,71,695
149,2022/7/15 16:50,197,105,92,485
149,2022/7/15 17:00,269,109,160,2005
149,2022/7/15 17:10,330,102,228,3513
149,2022/7/15 17:20,269,123,146,2041
149,2022/7/15 17:30,232,120,112,964
149,2022/7/15 17:40,270,108,162,3122
149,2022/7/15 17:50,272,118,154,1104
149,2022/7/15 18:00,235,151,84,-532
149,2022/7/15 18:10,243,182,61,2915
149,2022/7/15 18:20,215,116,99,1597
149,2022/7/15 18:30,143,119,24,-1330
149,2022/7/15 18:40,97,128,-31,-2402
149,2022/7/15 18:50,77,125,-48,-1905
149,2022/7/15 19:00,49,100,-51,-995
149,2022/7/15 19:10,55,107,-52,-517
149,2022/7/15 19:20,41,100,-59,-679
149,2022/7/15 19:30,43,101,-58,-552
149,2022/7/15 19:40,38,91,-53,-576
149,2022/7/15 19:50,38,89,-51,-214
149,2022/7/15 20:00,35,78,-43,-338
149,2022/7/15 20:10,36,74,-38,-399
149,2022/7/15 20:20,33,72,-39,-290
149,2022/7/15 20:30,28,78,-50,-238
149,2022/7/15 20:40,27,87,-60,-365
149,2022/7/15 20:50,25,77,-52,-336
149,2022/7/15 21:00,26,76,-50,-371
149,2022/7/15 21:10,28,79,-51,-236
149,2022/7/15 21:20,27,79,-52,-468
149,2022/7/15 21:30,26,79,-53,-437
149,2022/7/15 21:40,27,75,-48,-728
149,2022/7/15 21:50,22,75,-53,-516
149,2022/7/15 22:00,22,70,-48,-400
149,2022/7/15 22:10,16,73,-57,-713
149,2022/7/15 22:20,15,53,-38,-884
149,2022/7/15 22:30,11,71,-60,-963
149,2022/7/15 22:40,10,62,-52,-920
149,2022/7/15 22:50,6,40,-34,-788
155,2022/7/15 5:00,0,1,-1,1
155,2022/7/15 5:10,0,1,-1,34
155,2022/7/15 5:20,0,1,-1,88
155,2022/7/15 5:30,1,1,0,210
155,2022/7/15 5:40,9,1,8,179
155,2022/7/15 5:50,28,8,20,204
155,2022/7/15 6:00,27,15,12,187
155,2022/7/15 6:10,27,21,6,91
155,2022/7/15 6:20,36,39,-3,60
155,2022/7/15 6:30,53,49,4,216
155,2022/7/15 6:40,57,86,-29,263
155,2022/7/15 6:50,79,89,-10,621
155,2022/7/15 7:00,101,108,-7,1296
155,2022/7/15 7:10,92,123,-31,1437
155,2022/7/15 7:20,169,129,40,3069
155,2022/7/15 7:30,180,133,47,3562
155,2022/7/15 7:40,191,169,22,4658
155,2022/7/15 7:50,215,144,71,5753
155,2022/7/15 8:00,238,179,59,5635
155,2022/7/15 8:10,246,253,-7,3913
155,2022/7/15 8:20,224,324,-100,2570
155,2022/7/15 8:30,191,382,-191,-841
155,2022/7/15 8:40,185,428,-243,-6944
155,2022/7/15 8:50,151,422,-271,-4765
155,2022/7/15 9:00,89,314,-225,-2306
155,2022/7/15 9:10,77,297,-220,-2299
155,2022/7/15 9:20,58,232,-174,-559
155,2022/7/15 9:30,47,133,-86,-330
155,2022/7/15 9:40,40,97,-57,-857
155,2022/7/15 9:50,38,108,-70,-1015
155,2022/7/15 10:00,37,104,-67,-928
155,2022/7/15 10:10,36,108,-72,-608
155,2022/7/15 10:20,36,77,-41,-540
155,2022/7/15 10:30,35,92,-57,-587
155,2022/7/15 10:40,28,91,-63,-568
155,2022/7/15 10:50,36,92,-56,-565
155,2022/7/15 11:00,29,68,-39,-535
155,2022/7/15 11:10,36,93,-57,-675
155,2022/7/15 11:20,35,93,-58,-691
155,2022/7/15 11:30,29,84,-55,-564
155,2022/7/15 11:40,35,79,-44,-460
155,2022/7/15 11:50,37,79,-42,-397
155,2022/7/15 12:00,31,73,-42,-441
155,2022/7/15 12:10,35,90,-55,-279
155,2022/7/15 12:20,38,69,-31,-242
155,2022/7/15 12:30,39,101,-62,-418
155,2022/7/15 12:40,38,83,-45,-537
155,2022/7/15 12:50,40,91,-51,-522
155,2022/7/15 13:00,40,91,-51,-488
155,2022/7/15 13:10,43,97,-54,-357
155,2022/7/15 13:20,38,98,-60,-341
155,2022/7/15 13:30,38,83,-45,-419
155,2022/7/15 13:40,37,110,-73,-579
155,2022/7/15 13:50,38,74,-36,-204
155,2022/7/15 14:00,35,83,-48,-456
155,2022/7/15 14:10,41,90,-49,-482
155,2022/7/15 14:20,45,76,-31,-366
155,2022/7/15 14:30,43,97,-54,-489
155,2022/7/15 14:40,34,76,-42,-476
155,2022/7/15 14:50,43,109,-66,-455
155,2022/7/15 15:00,43,76,-33,-254
155,2022/7/15 15:10,54,91,-37,-204
155,2022/7/15 15:20,52,87,-35,-105
155,2022/7/15 15:30,47,91,-44,-89
155,2022/7/15 15:40,47,97,-50,-296
155,2022/7/15 15:50,57,81,-24,-14
155,2022/7/15 16:00,59,105,-46,7
155,2022/7/15 16:10,94,90,4,159
155,2022/7/15 16:20,133,89,44,-154
155,2022/7/15 16:30,136,103,33,272
155,2022/7/15 16:40,194,92,102,797
155,2022/7/15 16:50,141,102,39,524
155,2022/7/15 17:00,338,97,241,2246
155,2022/7/15 17:10,286,123,163,3676
155,2022/7/15 17:20,234,113,121,2162
155,2022/7/15 17:30,336,110,226,1190
155,2022/7/15 17:40,576,118,458,3580
155,2022/7/15 17:50,291,115,176,1280
155,2022/7/15 18:00,267,111,156,-376
155,2022/7/15 18:10,378,116,262,3177
155,2022/7/15 18:20,257,150,107,1704
155,2022/7/15 18:30,177,133,44,-1286
155,2022/7/15 18:40,138,104,34,-2368
155,2022/7/15 18:50,101,137,-36,-1941
155,2022/7/15 19:00,72,121,-49,-1044
155,2022/7/15 19:10,67,107,-40,-557
155,2022/7/15 19:20,57,104,-47,-726
155,2022/7/15 19:30,46,111,-65,-617
155,2022/7/15 19:40,48,85,-37,-613
155,2022/7/15 19:50,42,83,-41,-255
155,2022/7/15 20:00,45,75,-30,-368
155,2022/7/15 20:10,47,71,-24,-423
155,2022/7/15 20:20,44,71,-27,-317
155,2022/7/15 20:30,49,82,-33,-271
155,2022/7/15 20:40,45,74,-29,-394
155,2022/7/15 20:50,44,78,-34,-370
155,2022/7/15 21:00,48,72,-24,-395
155,2022/7/15 21:10,46,62,-16,-252
155,2022/7/15 21:20,43,71,-28,-496
155,2022/7/15 21:30,37,85,-48,-485
155,2022/7/15 21:40,35,72,-37,-765
155,2022/7/15 21:50,38,72,-34,-550
155,2022/7/15 22:00,41,71,-30,-430
155,2022/7/15 22:10,38,69,-31,-744
155,2022/7/15 22:20,22,63,-41,-925
155,2022/7/15 22:30,22,67,-45,-1008
155,2022/7/15 22:40,15,62,-47,-967
155,2022/7/15 22:50,8,33,-25,-813
156,2022/7/15 5:00,0,1,-1,0
156,2022/7/15 5:10,0,1,-1,33
156,2022/7/15 5:20,0,1,-1,87
156,2022/7/15 5:30,4,1,3,213
156,2022/7/15 5:40,12,1,11,190
156,2022/7/15 5:50,19,14,5,209
156,2022/7/15 6:00,17,21,-4,183
156,2022/7/15 6:10,19,27,-8,83
156,2022/7/15 6:20,27,49,-22,38
156,2022/7/15 6:30,32,63,-31,185
156,2022/7/15 6:40,35,66,-31,232
156,2022/7/15 6:50,47,67,-20,601
156,2022/7/15 7:00,58,76,-18,1278
156,2022/7/15 7:10,62,106,-44,1393
156,2022/7/15 7:20,65,101,-36,3033
156,2022/7/15 7:30,87,110,-23,3539
156,2022/7/15 7:40,153,114,39,4697
156,2022/7/15 7:50,181,120,61,5814
156,2022/7/15 8:00,186,168,18,5653
156,2022/7/15 8:10,183,206,-23,3890
156,2022/7/15 8:20,155,295,-140,2430
156,2022/7/15 8:30,111,317,-206,-1047
156,2022/7/15 8:40,88,494,-406,-7350
156,2022/7/15 8:50,68,324,-256,-5021
156,2022/7/15 9:00,48,290,-242,-2548
156,2022/7/15 9:10,47,268,-221,-2520
156,2022/7/15 9:20,42,169,-127,-686
156,2022/7/15 9:30,36,128,-92,-422
156,2022/7/15 9:40,28,108,-80,-937
156,2022/7/15 9:50,30,126,-96,-1111
156,2022/7/15 10:00,31,90,-59,-987
156,2022/7/15 10:10,28,97,-69,-677
156,2022/7/15 10:20,30,96,-66,-606
156,2022/7/15 10:30,31,76,-45,-632
156,2022/7/15 10:40,29,74,-45,-613
156,2022/7/15 10:50,32,91,-59,-624
156,2022/7/15 11:00,28,65,-37,-572
156,2022/7/15 11:10,29,74,-45,-720
156,2022/7/15 11:20,28,76,-48,-739
156,2022/7/15 11:30,29,76,-47,-611
156,2022/7/15 11:40,29,69,-40,-500
156,2022/7/15 11:50,28,78,-50,-447
156,2022/7/15 12:00,27,69,-42,-483
156,2022/7/15 12:10,32,93,-61,-340
156,2022/7/15 12:20,28,62,-34,-276
156,2022/7/15 12:30,36,68,-32,-450
156,2022/7/15 12:40,35,93,-58,-595
156,2022/7/15 12:50,33,77,-44,-566
156,2022/7/15 13:00,31,101,-70,-558
156,2022/7/15 13:10,33,77,-44,-401
156,2022/7/15 13:20,35,90,-55,-396
156,2022/7/15 13:30,30,71,-41,-460
156,2022/7/15 13:40,32,90,-58,-637
156,2022/7/15 13:50,31,92,-61,-265
156,2022/7/15 14:00,30,69,-39,-495
156,2022/7/15 14:10,33,76,-43,-525
156,2022/7/15 14:20,31,73,-42,-408
156,2022/7/15 14:30,36,80,-44,-533
156,2022/7/15 14:40,38,70,-32,-508
156,2022/7/15 14:50,38,75,-37,-492
156,2022/7/15 15:00,35,78,-43,-297
156,2022/7/15 15:10,38,68,-30,-234
156,2022/7/15 15:20,35,80,-45,-150
156,2022/7/15 15:30,34,85,-51,-140
156,2022/7/15 15:40,40,75,-35,-331
156,2022/7/15 15:50,41,72,-31,-45
156,2022/7/15 16:00,41,80,-39,-32
156,2022/7/15 16:10,45,72,-27,132
156,2022/7/15 16:20,41,91,-50,-204
156,2022/7/15 16:30,45,84,-39,233
156,2022/7/15 16:40,50,75,-25,772
156,2022/7/15 16:50,47,101,-54,470
156,2022/7/15 17:00,68,89,-21,2225
156,2022/7/15 17:10,128,105,23,3699
156,2022/7/15 17:20,77,104,-27,2135
156,2022/7/15 17:30,109,100,9,1199
156,2022/7/15 17:40,149,99,50,3630
156,2022/7/15 17:50,86,109,-23,1257
156,2022/7/15 18:00,132,111,21,-355
156,2022/7/15 18:10,176,111,65,3242
156,2022/7/15 18:20,136,119,17,1721
156,2022/7/15 18:30,66,121,-55,-1341
156,2022/7/15 18:40,76,115,-39,-2407
156,2022/7/15 18:50,52,111,-59,-2000
156,2022/7/15 19:00,49,107,-58,-1102
156,2022/7/15 19:10,43,104,-61,-618
156,2022/7/15 19:20,43,101,-58,-784
156,2022/7/15 19:30,42,80,-38,-655
156,2022/7/15 19:40,43,69,-26,-639
156,2022/7/15 19:50,37,83,-46,-301
156,2022/7/15 20:00,39,71,-32,-400
156,2022/7/15 20:10,47,66,-19,-442
156,2022/7/15 20:20,41,49,-8,-325
156,2022/7/15 20:30,43,76,-33,-304
156,2022/7/15 20:40,51,68,-17,-411
156,2022/7/15 20:50,42,52,-10,-380
156,2022/7/15 21:00,42,65,-23,-418
156,2022/7/15 21:10,55,62,-7,-259
156,2022/7/15 21:20,39,47,-8,-504
156,2022/7/15 21:30,36,61,-25,-510
156,2022/7/15 21:40,34,49,-15,-780
156,2022/7/15 21:50,29,52,-23,-573
156,2022/7/15 22:00,51,66,-15,-445
156,2022/7/15 22:10,44,61,-17,-761
156,2022/7/15 22:20,25,66,-41,-966
156,2022/7/15 22:30,23,58,-35,-1043
156,2022/7/15 22:40,16,47,-31,-998
156,2022/7/15 22:50,11,45,-34,-847
153,2022/7/15 5:00,0,1,-1,-1
153,2022/7/15 5:10,0,1,-1,32
153,2022/7/15 5:20,0,1,-1,86
153,2022/7/15 5:30,5,1,4,217
153,2022/7/15 5:40,18,1,17,207
153,2022/7/15 5:50,24,19,5,214
153,2022/7/15 6:00,32,25,7,190
153,2022/7/15 6:10,40,23,17,100
153,2022/7/15 6:20,43,38,5,43
153,2022/7/15 6:30,61,63,-2,183
153,2022/7/15 6:40,154,90,64,296
153,2022/7/15 6:50,186,127,59,660
153,2022/7/15 7:00,217,106,111,1389
153,2022/7/15 7:10,271,117,154,1547
153,2022/7/15 7:20,328,121,207,3240
153,2022/7/15 7:30,351,152,199,3738
153,2022/7/15 7:40,361,192,169,4866
153,2022/7/15 7:50,361,213,148,5962
153,2022/7/15 8:00,277,154,123,5776
153,2022/7/15 8:10,280,197,83,3973
153,2022/7/15 8:20,277,197,80,2510
153,2022/7/15 8:30,239,208,31,-1016
153,2022/7/15 8:40,237,214,23,-7327
153,2022/7/15 8:50,222,150,72,-4949
153,2022/7/15 9:00,187,129,58,-2490
153,2022/7/15 9:10,174,121,53,-2467
153,2022/7/15 9:20,100,107,-7,-693
153,2022/7/15 9:30,75,104,-29,-451
153,2022/7/15 9:40,68,104,-36,-973
153,2022/7/15 9:50,57,112,-55,-1166
153,2022/7/15 10:00,46,76,-30,-1017
153,2022/7/15 10:10,44,98,-54,-731
153,2022/7/15 10:20,43,87,-44,-650
153,2022/7/15 10:30,43,75,-32,-664
153,2022/7/15 10:40,41,81,-40,-653
153,2022/7/15 10:50,38,92,-54,-678
153,2022/7/15 11:00,40,61,-21,-593
153,2022/7/15 11:10,42,87,-45,-765
153,2022/7/15 11:20,44,77,-33,-772
153,2022/7/15 11:30,56,76,-20,-631
153,2022/7/15 11:40,53,93,-40,-540
153,2022/7/15 11:50,47,62,-15,-462
153,2022/7/15 12:00,54,101,-47,-530
153,2022/7/15 12:10,52,70,-18,-358
153,2022/7/15 12:20,53,100,-47,-323
153,2022/7/15 12:30,52,74,-22,-472
153,2022/7/15 12:40,47,97,-50,-645
153,2022/7/15 12:50,56,105,-49,-615
153,2022/7/15 13:00,47,80,-33,-591
153,2022/7/15 13:10,43,100,-57,-458
153,2022/7/15 13:20,40,78,-38,-434
153,2022/7/15 13:30,46,103,-57,-517
153,2022/7/15 13:40,42,84,-42,-679
153,2022/7/15 13:50,42,102,-60,-325
153,2022/7/15 14:00,41,90,-49,-544
153,2022/7/15 14:10,41,75,-34,-559
153,2022/7/15 14:20,45,102,-57,-465
153,2022/7/15 14:30,40,94,-54,-587
153,2022/7/15 14:40,42,104,-62,-570
153,2022/7/15 14:50,52,90,-38,-530
153,2022/7/15 15:00,53,108,-55,-352
153,2022/7/15 15:10,65,104,-39,-273
153,2022/7/15 15:20,64,92,-28,-178
153,2022/7/15 15:30,60,123,-63,-203
153,2022/7/15 15:40,59,108,-49,-380
153,2022/7/15 15:50,61,110,-49,-94
153,2022/7/15 16:00,157,98,59,27
153,2022/7/15 16:10,273,106,167,299
153,2022/7/15 16:20,180,108,72,-132
153,2022/7/15 16:30,183,122,61,294
153,2022/7/15 16:40,196,98,98,870
153,2022/7/15 16:50,213,123,90,560
153,2022/7/15 17:00,264,138,126,2351
153,2022/7/15 17:10,315,118,197,3896
153,2022/7/15 17:20,272,153,119,2254
153,2022/7/15 17:30,213,212,1,1200
153,2022/7/15 17:40,270,283,-13,3617
153,2022/7/15 17:50,244,196,48,1305
153,2022/7/15 18:00,205,283,-78,-433
153,2022/7/15 18:10,174,300,-126,3116
153,2022/7/15 18:20,154,294,-140,1581
153,2022/7/15 18:30,89,213,-124,-1465
153,2022/7/15 18:40,71,285,-214,-2621
153,2022/7/15 18:50,69,279,-210,-2210
153,2022/7/15 19:00,53,214,-161,-1263
153,2022/7/15 19:10,52,191,-139,-757
153,2022/7/15 19:20,45,111,-66,-850
153,2022/7/15 19:30,42,105,-63,-718
153,2022/7/15 19:40,39,104,-65,-704
153,2022/7/15 19:50,39,124,-85,-386
153,2022/7/15 20:00,35,108,-73,-473
153,2022/7/15 20:10,33,103,-70,-512
153,2022/7/15 20:20,38,124,-86,-411
153,2022/7/15 20:30,48,98,-50,-354
153,2022/7/15 20:40,57,85,-28,-439
153,2022/7/15 20:50,46,106,-60,-440
153,2022/7/15 21:00,35,106,-71,-489
153,2022/7/15 21:10,35,104,-69,-328
153,2022/7/15 21:20,34,114,-80,-584
153,2022/7/15 21:30,29,100,-71,-581
153,2022/7/15 21:40,29,100,-71,-851
153,2022/7/15 21:50,24,108,-84,-657
153,2022/7/15 22:00,27,98,-71,-516
153,2022/7/15 22:10,24,85,-61,-822
153,2022/7/15 22:20,21,97,-76,-1042
153,2022/7/15 22:30,14,85,-71,-1114
153,2022/7/15 22:40,12,82,-70,-1068
153,2022/7/15 22:50,8,99,-91,-938
154,2022/7/15 5:00,0,1,-1,-2
154,2022/7/15 5:10,0,1,-1,31
154,2022/7/15 5:20,0,1,-1,85
154,2022/7/15 5:30,14,1,13,230
154,2022/7/15 5:40,30,1,29,236
154,2022/7/15 5:50,31,8,23,237
154,2022/7/15 6:00,33,38,-5,185
154,2022/7/15 6:10,54,23,31,131
154,2022/7/15 6:20,77,33,44,87
154,2022/7/15 6:30,150,60,90,273
154,2022/7/15 6:40,244,97,147,443
154,2022/7/15 6:50,299,100,199,859
154,2022/7/15 7:00,367,110,257,1646
154,2022/7/15 7:10,633,122,511,2058
154,2022/7/15 7:20,688,111,577,3817
154,2022/7/15 7:30,689,184,505,4243
154,2022/7/15 7:40,733,179,554,5420
154,2022/7/15 7:50,699,292,407,6369
154,2022/7/15 8:00,702,320,382,6158
154,2022/7/15 8:10,687,338,349,4322
154,2022/7/15 8:20,631,474,157,2667
154,2022/7/15 8:30,475,497,-22,-1038
154,2022/7/15 8:40,393,563,-170,-7497
154,2022/7/15 8:50,327,476,-149,-5098
154,2022/7/15 9:00,271,425,-154,-2644
154,2022/7/15 9:10,231,297,-66,-2533
154,2022/7/15 9:20,177,268,-91,-784
154,2022/7/15 9:30,149,169,-20,-471
154,2022/7/15 9:40,100,117,-17,-990
154,2022/7/15 9:50,78,99,-21,-1187
154,2022/7/15 10:00,76,111,-35,-1052
154,2022/7/15 10:10,56,121,-65,-796
154,2022/7/15 10:20,59,112,-53,-703
154,2022/7/15 10:30,43,105,-62,-726
154,2022/7/15 10:40,45,73,-28,-681
154,2022/7/15 10:50,48,105,-57,-735
154,2022/7/15 11:00,50,93,-43,-636
154,2022/7/15 11:10,45,93,-48,-813
154,2022/7/15 11:20,58,91,-33,-805
154,2022/7/15 11:30,55,71,-16,-647
154,2022/7/15 11:40,55,106,-51,-591
154,2022/7/15 11:50,58,80,-22,-484
154,2022/7/15 12:00,70,98,-28,-558
154,2022/7/15 12:10,76,97,-21,-379
154,2022/7/15 12:20,67,87,-20,-343
154,2022/7/15 12:30,67,107,-40,-512
154,2022/7/15 12:40,63,114,-51,-696
154,2022/7/15 12:50,58,123,-65,-680
154,2022/7/15 13:00,54,111,-57,-648
154,2022/7/15 13:10,65,106,-41,-499
154,2022/7/15 13:20,54,102,-48,-482
154,2022/7/15 13:30,53,96,-43,-560
154,2022/7/15 13:40,46,114,-68,-747
154,2022/7/15 13:50,45,93,-48,-373
154,2022/7/15 14:00,49,124,-75,-619
154,2022/7/15 14:10,54,98,-44,-603
154,2022/7/15 14:20,47,103,-56,-521
154,2022/7/15 14:30,51,103,-52,-639
154,2022/7/15 14:40,65,91,-26,-596
154,2022/7/15 14:50,69,121,-52,-582
154,2022/7/15 15:00,128,94,34,-318
154,2022/7/15 15:10,113,117,-4,-277
154,2022/7/15 15:20,69,102,-33,-211
154,2022/7/15 15:30,72,108,-36,-239
154,2022/7/15 15:40,73,114,-41,-421
154,2022/7/15 15:50,72,108,-36,-130
154,2022/7/15 16:00,82,108,-26,1
154,2022/7/15 16:10,111,114,-3,296
154,2022/7/15 16:20,113,102,11,-121
154,2022/7/15 16:30,175,123,52,346
154,2022/7/15 16:40,206,126,80,950
154,2022/7/15 16:50,212,125,87,647
154,2022/7/15 17:00,271,189,82,2433
154,2022/7/15 17:10,429,105,324,4220
154,2022/7/15 17:20,342,295,47,2301
154,2022/7/15 17:30,456,266,190,1390
154,2022/7/15 17:40,569,323,246,3863
154,2022/7/15 17:50,334,364,-30,1275
154,2022/7/15 18:00,268,320,-52,-485
154,2022/7/15 18:10,350,370,-20,3096
154,2022/7/15 18:20,264,315,-51,1530
154,2022/7/15 18:30,222,319,-97,-1562
154,2022/7/15 18:40,216,316,-100,-2721
154,2022/7/15 18:50,158,341,-183,-2393
154,2022/7/15 19:00,79,342,-263,-1526
154,2022/7/15 19:10,73,257,-184,-941
154,2022/7/15 19:20,57,227,-170,-1020
154,2022/7/15 19:30,42,149,-107,-825
154,2022/7/15 19:40,45,126,-81,-785
154,2022/7/15 19:50,40,120,-80,-466
154,2022/7/15 20:00,41,123,-82,-555
154,2022/7/15 20:10,45,106,-61,-573
154,2022/7/15 20:20,35,110,-75,-486
154,2022/7/15 20:30,41,106,-65,-419
154,2022/7/15 20:40,44,106,-62,-501
154,2022/7/15 20:50,38,111,-73,-513
154,2022/7/15 21:00,37,112,-75,-564
154,2022/7/15 21:10,35,92,-57,-385
154,2022/7/15 21:20,36,110,-74,-658
154,2022/7/15 21:30,38,101,-63,-644
154,2022/7/15 21:40,31,97,-66,-917
154,2022/7/15 21:50,28,111,-83,-740
154,2022/7/15 22:00,35,107,-72,-588
154,2022/7/15 22:10,26,78,-52,-874
154,2022/7/15 22:20,24,95,-71,-1113
154,2022/7/15 22:30,15,92,-77,-1191
154,2022/7/15 22:40,12,83,-71,-1139
154,2022/7/15 22:50,10,105,-95,-1033
158,2022/7/15 5:00,0,1,-1,-3
158,2022/7/15 5:10,0,1,-1,30
158,2022/7/15 5:20,1,1,0,85
158,2022/7/15 5:30,29,1,28,258
158,2022/7/15 5:40,45,1,44,280
158,2022/7/15 5:50,45,16,29,266
158,2022/7/15 6:00,54,47,7,192
158,2022/7/15 6:10,85,32,53,184
158,2022/7/15 6:20,185,50,135,222
158,2022/7/15 6:30,226,66,160,433
158,2022/7/15 6:40,324,77,247,690
158,2022/7/15 6:50,590,107,483,1342
158,2022/7/15 7:00,685,110,575,2221
158,2022/7/15 7:10,860,108,752,2810
158,2022/7/15 7:20,1223,159,1064,4881
158,2022/7/15 7:30,1360,111,1249,5492
158,2022/7/15 7:40,1362,125,1237,6657
158,2022/7/15 7:50,1206,150,1056,7425
158,2022/7/15 8:00,1170,180,990,7148
158,2022/7/15 8:10,1178,116,1062,5384
158,2022/7/15 8:20,1152,169,983,3650
158,2022/7/15 8:30,833,153,680,-358
158,2022/7/15 8:40,717,108,609,-6888
158,2022/7/15 8:50,592,129,463,-4635
158,2022/7/15 9:00,434,108,326,-2318
158,2022/7/15 9:10,324,100,224,-2309
158,2022/7/15 9:20,263,83,180,-604
158,2022/7/15 9:30,217,103,114,-357
158,2022/7/15 9:40,157,105,52,-938
158,2022/7/15 9:50,136,75,61,-1126
158,2022/7/15 10:00,101,120,-19,-1071
158,2022/7/15 10:10,74,89,-15,-811
158,2022/7/15 10:20,69,106,-37,-740
158,2022/7/15 10:30,58,87,-29,-755
158,2022/7/15 10:40,55,94,-39,-720
158,2022/7/15 10:50,60,96,-36,-771
158,2022/7/15 11:00,59,92,-33,-669
158,2022/7/15 11:10,55,67,-12,-825
158,2022/7/15 11:20,47,107,-60,-865
158,2022/7/15 11:30,59,99,-40,-687
158,2022/7/15 11:40,63,92,-29,-620
158,2022/7/15 11:50,68,112,-44,-528
158,2022/7/15 12:00,73,77,-4,-562
158,2022/7/15 12:10,75,108,-33,-412
158,2022/7/15 12:20,76,98,-22,-365
158,2022/7/15 12:30,70,112,-42,-554
158,2022/7/15 12:40,73,100,-27,-723
158,2022/7/15 12:50,68,114,-46,-726
158,2022/7/15 13:00,64,106,-42,-690
158,2022/7/15 13:10,59,109,-50,-549
158,2022/7/15 13:20,62,123,-61,-543
158,2022/7/15 13:30,54,93,-39,-599
158,2022/7/15 13:40,47,109,-62,-809
158,2022/7/15 13:50,48,107,-59,-432
158,2022/7/15 14:00,49,105,-56,-675
158,2022/7/15 14:10,53,120,-67,-670
158,2022/7/15 14:20,41,96,-55,-576
158,2022/7/15 14:30,60,111,-51,-690
158,2022/7/15 14:40,77,102,-25,-621
158,2022/7/15 14:50,59,102,-43,-625
158,2022/7/15 15:00,58,124,-66,-384
158,2022/7/15 15:10,88,100,-12,-289
158,2022/7/15 15:20,85,109,-24,-235
158,2022/7/15 15:30,74,100,-26,-265
158,2022/7/15 15:40,93,142,-49,-470
158,2022/7/15 15:50,91,121,-30,-160
158,2022/7/15 16:00,77,133,-56,-55
158,2022/7/15 16:10,84,118,-34,262
158,2022/7/15 16:20,83,144,-61,-182
158,2022/7/15 16:30,140,109,31,377
158,2022/7/15 16:40,167,269,-102,848
158,2022/7/15 16:50,135,183,-48,599
158,2022/7/15 17:00,204,182,22,2455
158,2022/7/15 17:10,214,214,0,4220
158,2022/7/15 17:20,213,489,-276,2025
158,2022/7/15 17:30,194,376,-182,1208
158,2022/7/15 17:40,231,423,-192,3671
158,2022/7/15 17:50,219,484,-265,1010
158,2022/7/15 18:00,150,417,-267,-752
158,2022/7/15 18:10,168,425,-257,2839
158,2022/7/15 18:20,128,414,-286,1244
158,2022/7/15 18:30,90,581,-491,-2053
158,2022/7/15 18:40,70,417,-347,-3068
158,2022/7/15 18:50,53,400,-347,-2740
158,2022/7/15 19:00,49,577,-528,-2054
158,2022/7/15 19:10,46,489,-443,-1384
158,2022/7/15 19:20,44,319,-275,-1295
158,2022/7/15 19:30,38,314,-276,-1101
158,2022/7/15 19:40,40,219,-179,-964
158,2022/7/15 19:50,34,190,-156,-622
158,2022/7/15 20:00,41,178,-137,-692
158,2022/7/15 20:10,38,112,-74,-647
158,2022/7/15 20:20,36,117,-81,-567
158,2022/7/15 20:30,37,137,-100,-519
158,2022/7/15 20:40,33,109,-76,-577
158,2022/7/15 20:50,33,107,-74,-587
158,2022/7/15 21:00,29,192,-163,-727
158,2022/7/15 21:10,27,114,-87,-472
158,2022/7/15 21:20,27,115,-88,-746
158,2022/7/15 21:30,26,150,-124,-768
158,2022/7/15 21:40,25,120,-95,-1012
158,2022/7/15 21:50,25,124,-99,-839
158,2022/7/15 22:00,25,109,-84,-672
158,2022/7/15 22:10,21,108,-87,-961
158,2022/7/15 22:20,16,109,-93,-1206
158,2022/7/15 22:30,13,103,-90,-1281
158,2022/7/15 22:40,13,106,-93,-1232
158,2022/7/15 22:50,11,106,-95,-1128
171,2022/7/15 5:00,0,1,-1,-4
171,2022/7/15 5:10,0,1,-1,29
171,2022/7/15 5:20,0,1,-1,84
171,2022/7/15 5:30,33,1,32,290
171,2022/7/15 5:40,32,5,27,307
171,2022/7/15 5:50,54,1,53,319
171,2022/7/15 6:00,54,6,48,240
171,2022/7/15 6:10,73,30,43,227
171,2022/7/15 6:20,185,23,162,384
171,2022/7/15 6:30,267,65,202,635
171,2022/7/15 6:40,348,63,285,975
171,2022/7/15 6:50,596,91,505,1847
171,2022/7/15 7:00,685,109,576,2797
171,2022/7/15 7:10,863,98,765,3575
171,2022/7/15 7:20,841,75,766,5647
171,2022/7/15 7:30,862,79,783,6275
171,2022/7/15 7:40,1055,93,962,7619
171,2022/7/15 7:50,1049,79,970,8395
171,2022/7/15 8:00,869,105,764,7912
171,2022/7/15 8:10,851,107,744,6128
171,2022/7/15 8:20,826,108,718,4368
171,2022/7/15 8:30,740,115,625,267
171,2022/7/15 8:40,599,96,503,-6385
171,2022/7/15 8:50,323,110,213,-4422
171,2022/7/15 9:00,340,112,228,-2090
171,2022/7/15 9:10,227,85,142,-2167
171,2022/7/15 9:20,199,97,102,-502
171,2022/7/15 9:30,143,96,47,-310
171,2022/7/15 9:40,97,76,21,-917
171,2022/7/15 9:50,67,81,-14,-1140
171,2022/7/15 10:00,45,90,-45,-1116
171,2022/7/15 10:10,47,68,-21,-832
171,2022/7/15 10:20,44,72,-28,-768
171,2022/7/15 10:30,41,77,-36,-791
171,2022/7/15 10:40,39,77,-38,-758
171,2022/7/15 10:50,43,72,-29,-800
171,2022/7/15 11:00,40,72,-32,-701
171,2022/7/15 11:10,43,62,-19,-844
171,2022/7/15 11:20,42,92,-50,-915
171,2022/7/15 11:30,42,85,-43,-730
171,2022/7/15 11:40,43,73,-30,-650
171,2022/7/15 11:50,43,72,-29,-557
171,2022/7/15 12:00,48,92,-44,-606
171,2022/7/15 12:10,42,65,-23,-435
171,2022/7/15 12:20,45,98,-53,-418
171,2022/7/15 12:30,44,77,-33,-587
171,2022/7/15 12:40,42,90,-48,-771
171,2022/7/15 12:50,45,75,-30,-756
171,2022/7/15 13:00,44,68,-24,-714
171,2022/7/15 13:10,37,104,-67,-616
171,2022/7/15 13:20,45,70,-25,-568
171,2022/7/15 13:30,37,96,-59,-658
171,2022/7/15 13:40,39,83,-44,-853
171,2022/7/15 13:50,35,87,-52,-484
171,2022/7/15 14:00,41,76,-35,-710
171,2022/7/15 14:10,34,78,-44,-714
171,2022/7/15 14:20,39,106,-67,-643
171,2022/7/15 14:30,28,79,-51,-741
171,2022/7/15 14:40,30,107,-77,-698
171,2022/7/15 14:50,41,92,-51,-676
171,2022/7/15 15:00,39,101,-62,-446
171,2022/7/15 15:10,44,94,-50,-339
171,2022/7/15 15:20,32,93,-61,-296
171,2022/7/15 15:30,35,118,-83,-348
171,2022/7/15 15:40,34,87,-53,-523
171,2022/7/15 15:50,40,104,-64,-224
171,2022/7/15 16:00,42,102,-60,-115
171,2022/7/15 16:10,45,118,-73,189
171,2022/7/15 16:20,38,83,-45,-227
171,2022/7/15 16:30,46,125,-79,298
171,2022/7/15 16:40,67,121,-54,794
171,2022/7/15 16:50,66,111,-45,554
171,2022/7/15 17:00,77,112,-35,2420
171,2022/7/15 17:10,89,204,-115,4105
171,2022/7/15 17:20,70,227,-157,1868
171,2022/7/15 17:30,71,279,-208,1000
171,2022/7/15 17:40,129,327,-198,3473
171,2022/7/15 17:50,57,418,-361,649
171,2022/7/15 18:00,51,426,-375,-1127
171,2022/7/15 18:10,54,504,-450,2389
171,2022/7/15 18:20,41,431,-390,854
171,2022/7/15 18:30,36,415,-379,-2432
171,2022/7/15 18:40,30,494,-464,-3532
171,2022/7/15 18:50,27,423,-396,-3136
171,2022/7/15 19:00,24,434,-410,-2464
171,2022/7/15 19:10,28,324,-296,-1680
171,2022/7/15 19:20,26,330,-304,-1599
171,2022/7/15 19:30,22,219,-197,-1298
171,2022/7/15 19:40,27,178,-151,-1115
171,2022/7/15 19:50,22,125,-103,-725
171,2022/7/15 20:00,21,116,-95,-787
171,2022/7/15 20:10,23,112,-89,-736
171,2022/7/15 20:20,23,121,-98,-665
171,2022/7/15 20:30,22,109,-87,-606
171,2022/7/15 20:40,20,182,-162,-739
171,2022/7/15 20:50,21,116,-95,-682
171,2022/7/15 21:00,20,87,-67,-794
171,2022/7/15 21:10,23,116,-93,-565
171,2022/7/15 21:20,22,100,-78,-824
171,2022/7/15 21:30,20,111,-91,-859
171,2022/7/15 21:40,15,104,-89,-1101
171,2022/7/15 21:50,16,102,-86,-925
171,2022/7/15 22:00,13,107,-94,-766
171,2022/7/15 22:10,12,112,-100,-1061
171,2022/7/15 22:20,9,97,-88,-1294
171,2022/7/15 22:30,9,107,-98,-1379
171,2022/7/15 22:40,4,114,-110,-1342
171,2022/7/15 22:50,2,99,-97,-1225
174,2022/7/15 5:00,0,1,-1,-5
174,2022/7/15 5:10,0,1,-1,28
174,2022/7/15 5:20,0,1,-1,83
174,2022/7/15 5:30,38,1,37,327
174,2022/7/15 5:40,29,6,23,330
174,2022/7/15 5:50,45,2,43,362
174,2022/7/15 6:00,53,2,51,291
174,2022/7/15 6:10,80,23,57,284
174,2022/7/15 6:20,185,23,162,546
174,2022/7/15 6:30,280,38,242,877
174,2022/7/15 6:40,346,46,300,1275
174,2022/7/15 6:50,654,47,607,2454
174,2022/7/15 7:00,823,77,746,3543
174,2022/7/15 7:10,854,75,779,4354
174,2022/7/15 7:20,850,73,777,6424
174,2022/7/15 7:30,858,93,765,7040
174,2022/7/15 7:40,869,90,779,8398
174,2022/7/15 7:50,850,76,774,9169
174,2022/7/15 8:00,834,108,726,8638
174,2022/7/15 8:10,825,120,705,6833
174,2022/7/15 8:20,730,128,602,4970
174,2022/7/15 8:30,617,152,465,732
174,2022/7/15 8:40,442,197,245,-6140
174,2022/7/15 8:50,346,108,238,-4184
174,2022/7/15 9:00,273,117,156,-1934
174,2022/7/15 9:10,184,109,75,-2092
174,2022/7/15 9:20,148,101,47,-455
174,2022/7/15 9:30,76,103,-27,-337
174,2022/7/15 9:40,64,90,-26,-943
174,2022/7/15 9:50,51,76,-25,-1165
174,2022/7/15 10:00,47,70,-23,-1139
174,2022/7/15 10:10,43,65,-22,-854
174,2022/7/15 10:20,38,75,-37,-805
174,2022/7/15 10:30,36,71,-35,-826
174,2022/7/15 10:40,37,64,-27,-785
174,2022/7/15 10:50,34,69,-35,-835
174,2022/7/15 11:00,33,75,-42,-743
174,2022/7/15 11:10,28,58,-30,-874
174,2022/7/15 11:20,31,69,-38,-953
174,2022/7/15 11:30,37,70,-33,-763
174,2022/7/15 11:40,33,63,-30,-680
174,2022/7/15 11:50,39,65,-26,-583
174,2022/7/15 12:00,37,64,-27,-633
174,2022/7/15 12:10,37,87,-50,-485
174,2022/7/15 12:20,42,59,-17,-435
174,2022/7/15 12:30,38,79,-41,-628
174,2022/7/15 12:40,43,74,-31,-802
174,2022/7/15 12:50,38,79,-41,-797
174,2022/7/15 13:00,39,72,-33,-747
174,2022/7/15 13:10,36,62,-26,-642
174,2022/7/15 13:20,34,92,-58,-626
174,2022/7/15 13:30,36,66,-30,-688
174,2022/7/15 13:40,28,97,-69,-922
174,2022/7/15 13:50,29,69,-40,-524
174,2022/7/15 14:00,29,84,-55,-765
174,2022/7/15 14:10,27,81,-54,-768
174,2022/7/15 14:20,29,63,-34,-677
174,2022/7/15 14:30,33,90,-57,-798
174,2022/7/15 14:40,28,77,-49,-747
174,2022/7/15 14:50,27,97,-70,-746
174,2022/7/15 15:00,26,75,-49,-495
174,2022/7/15 15:10,29,81,-52,-391
174,2022/7/15 15:20,33,99,-66,-362
174,2022/7/15 15:30,31,93,-62,-410
174,2022/7/15 15:40,33,101,-68,-591
174,2022/7/15 15:50,26,76,-50,-274
174,2022/7/15 16:00,32,117,-85,-200
174,2022/7/15 16:10,38,98,-60,129
174,2022/7/15 16:20,41,123,-82,-309
174,2022/7/15 16:30,37,110,-73,225
174,2022/7/15 16:40,43,110,-67,727
174,2022/7/15 16:50,41,106,-65,489
174,2022/7/15 17:00,55,118,-63,2357
174,2022/7/15 17:10,77,230,-153,3952
174,2022/7/15 17:20,49,178,-129,1739
174,2022/7/15 17:30,77,254,-177,823
174,2022/7/15 17:40,153,254,-101,3372
174,2022/7/15 17:50,71,332,-261,388
174,2022/7/15 18:00,58,375,-317,-1444
174,2022/7/15 18:10,208,364,-156,2233
174,2022/7/15 18:20,132,489,-357,497
174,2022/7/15 18:30,66,425,-359,-2791
174,2022/7/15 18:40,58,315,-257,-3789
174,2022/7/15 18:50,43,495,-452,-3588
174,2022/7/15 19:00,36,518,-482,-2946
174,2022/7/15 19:10,34,330,-296,-1976
174,2022/7/15 19:20,33,314,-281,-1880
174,2022/7/15 19:30,25,213,-188,-1486
174,2022/7/15 19:40,29,180,-151,-1266
174,2022/7/15 19:50,25,117,-92,-817
174,2022/7/15 20:00,24,129,-105,-892
174,2022/7/15 20:10,26,108,-82,-818
174,2022/7/15 20:20,22,98,-76,-741
174,2022/7/15 20:30,22,110,-88,-694
174,2022/7/15 20:40,19,104,-85,-824
174,2022/7/15 20:50,22,103,-81,-763
174,2022/7/15 21:00,20,122,-102,-896
174,2022/7/15 21:10,26,114,-88,-653
174,2022/7/15 21:20,27,109,-82,-906
174,2022/7/15 21:30,20,110,-90,-949
174,2022/7/15 21:40,16,112,-96,-1197
174,2022/7/15 21:50,12,123,-111,-1036
174,2022/7/15 22:00,14,106,-92,-858
174,2022/7/15 22:10,13,100,-87,-1148
174,2022/7/15 22:20,10,77,-67,-1361
174,2022/7/15 22:30,8,99,-91,-1470
174,2022/7/15 22:40,3,92,-89,-1431
174,2022/7/15 22:50,1,107,-106,-1331
167,2022/7/15 5:00,0,1,-1,-6
167,2022/7/15 5:10,0,1,-1,27
167,2022/7/15 5:20,6,1,5,88
167,2022/7/15 5:30,24,1,23,350
167,2022/7/15 5:40,16,1,15,345
167,2022/7/15 5:50,20,5,15,377
167,2022/7/15 6:00,29,1,28,319
167,2022/7/15 6:10,32,19,13,297
167,2022/7/15 6:20,53,14,39,585
167,2022/7/15 6:30,55,19,36,913
167,2022/7/15 6:40,52,32,20,1295
167,2022/7/15 6:50,101,14,87,2541
167,2022/7/15 7:00,156,46,110,3653
167,2022/7/15 7:10,87,84,3,4357
167,2022/7/15 7:20,180,64,116,6540
167,2022/7/15 7:30,199,39,160,7200
167,2022/7/15 7:40,146,77,69,8467
167,2022/7/15 7:50,149,61,88,9257
167,2022/7/15 8:00,162,20,142,8780
167,2022/7/15 8:10,69,66,3,6836
167,2022/7/15 8:20,71,48,23,4993
167,2022/7/15 8:30,57,68,-11,721
167,2022/7/15 8:40,32,77,-45,-6185
167,2022/7/15 8:50,40,29,11,-4173
167,2022/7/15 9:00,30,66,-36,-1970
167,2022/7/15 9:10,26,63,-37,-2129
167,2022/7/15 9:20,26,16,10,-445
167,2022/7/15 9:30,19,50,-31,-368
167,2022/7/15 9:40,21,46,-25,-968
167,2022/7/15 9:50,18,19,-1,-1166
167,2022/7/15 10:00,16,45,-29,-1168
167,2022/7/15 10:10,14,32,-18,-872
167,2022/7/15 10:20,15,38,-23,-828
167,2022/7/15 10:30,16,38,-22,-848
167,2022/7/15 10:40,14,25,-11,-796
167,2022/7/15 10:50,16,12,4,-831
167,2022/7/15 11:00,15,38,-23,-766
167,2022/7/15 11:10,16,35,-19,-893
167,2022/7/15 11:20,13,10,3,-950
167,2022/7/15 11:30,15,38,-23,-786
167,2022/7/15 11:40,17,33,-16,-696
167,2022/7/15 11:50,15,29,-14,-597
167,2022/7/15 12:00,15,18,-3,-636
167,2022/7/15 12:10,18,38,-20,-505
167,2022/7/15 12:20,17,37,-20,-455
167,2022/7/15 12:30,16,7,9,-619
167,2022/7/15 12:40,15,38,-23,-825
167,2022/7/15 12:50,15,44,-29,-826
167,2022/7/15 13:00,15,31,-16,-763
167,2022/7/15 13:10,15,20,-5,-647
167,2022/7/15 13:20,14,44,-30,-656
167,2022/7/15 13:30,12,40,-28,-716
167,2022/7/15 13:40,18,8,10,-912
167,2022/7/15 13:50,19,47,-28,-552
167,2022/7/15 14:00,18,44,-26,-791
167,2022/7/15 14:10,13,33,-20,-788
167,2022/7/15 14:20,12,21,-9,-686
167,2022/7/15 14:30,13,45,-32,-830
167,2022/7/15 14:40,13,44,-31,-778
167,2022/7/15 14:50,11,17,-6,-752
167,2022/7/15 15:00,12,45,-33,-528
167,2022/7/15 15:10,15,50,-35,-426
167,2022/7/15 15:20,25,32,-7,-369
167,2022/7/15 15:30,28,35,-7,-417
167,2022/7/15 15:40,21,69,-48,-639
167,2022/7/15 15:50,17,65,-48,-322
167,2022/7/15 16:00,22,5,17,-183
167,2022/7/15 16:10,22,73,-51,78
167,2022/7/15 16:20,21,71,-50,-359
167,2022/7/15 16:30,22,71,-49,176
167,2022/7/15 16:40,16,31,-15,712
167,2022/7/15 16:50,18,69,-51,438
167,2022/7/15 17:00,20,76,-56,2301
167,2022/7/15 17:10,20,40,-20,3932
167,2022/7/15 17:20,24,76,-52,1687
167,2022/7/15 17:30,17,99,-82,741
167,2022/7/15 17:40,26,20,6,3378
167,2022/7/15 17:50,24,103,-79,309
167,2022/7/15 18:00,15,122,-107,-1551
167,2022/7/15 18:10,20,19,1,2234
167,2022/7/15 18:20,28,105,-77,420
167,2022/7/15 18:30,16,110,-94,-2885
167,2022/7/15 18:40,17,25,-8,-3797
167,2022/7/15 18:50,17,110,-93,-3681
167,2022/7/15 19:00,11,111,-100,-3046
167,2022/7/15 19:10,10,27,-17,-1993
167,2022/7/15 19:20,9,114,-105,-1985
167,2022/7/15 19:30,11,110,-99,-1585
167,2022/7/15 19:40,6,43,-37,-1303
167,2022/7/15 19:50,9,78,-69,-886
167,2022/7/15 20:00,7,71,-64,-956
167,2022/7/15 20:10,7,59,-52,-870
167,2022/7/15 20:20,7,77,-70,-811
167,2022/7/15 20:30,7,69,-62,-756
167,2022/7/15 20:40,6,21,-15,-839
167,2022/7/15 20:50,5,85,-80,-843
167,2022/7/15 21:00,6,73,-67,-963
167,2022/7/15 21:10,6,13,-7,-660
167,2022/7/15 21:20,5,71,-66,-972
167,2022/7/15 21:30,5,67,-62,-1011
167,2022/7/15 21:40,6,15,-9,-1206
167,2022/7/15 21:50,5,74,-69,-1105
167,2022/7/15 22:00,5,66,-61,-919
167,2022/7/15 22:10,2,13,-11,-1159
167,2022/7/15 22:20,3,70,-67,-1428
167,2022/7/15 22:30,1,48,-47,-1517
167,2022/7/15 22:40,1,50,-49,-1480
167,2022/7/15 22:50,0,66,-66,-1397
173,2022/7/15 5:00,0,1,-1,-7
173,2022/7/15 5:10,0,1,-1,26
173,2022/7/15 5:20,0,1,-1,87
173,2022/7/15 5:30,7,1,6,356
173,2022/7/15 5:40,6,5,1,346
173,2022/7/15 5:50,9,1,8,385
173,2022/7/15 6:00,11,1,10,329
173,2022/7/15 6:10,10,23,-13,284
173,2022/7/15 6:20,17,5,12,597
173,2022/7/15 6:30,16,19,-3,910
173,2022/7/15 6:40,18,33,-15,1280
173,2022/7/15 6:50,27,8,19,2560
173,2022/7/15 7:00,26,38,-12,3641
173,2022/7/15 7:10,32,62,-30,4327
173,2022/7/15 7:20,32,23,9,6549
173,2022/7/15 7:30,29,72,-43,7157
173,2022/7/15 7:40,33,68,-35,8432
173,2022/7/15 7:50,31,19,12,9269
173,2022/7/15 8:00,35,70,-35,8745
173,2022/7/15 8:10,24,66,-42,6794
173,2022/7/15 8:20,21,30,-9,4984
173,2022/7/15 8:30,24,62,-38,683
173,2022/7/15 8:40,15,50,-35,-6220
173,2022/7/15 8:50,15,16,-1,-4174
173,2022/7/15 9:00,13,46,-33,-2003
173,2022/7/15 9:10,9,25,-16,-2145
173,2022/7/15 9:20,11,16,-5,-450
173,2022/7/15 9:30,7,25,-18,-386
173,2022/7/15 9:40,8,25,-17,-985
173,2022/7/15 9:50,7,7,0,-1166
173,2022/7/15 10:00,6,23,-17,-1185
173,2022/7/15 10:10,5,19,-14,-886
173,2022/7/15 10:20,6,23,-17,-845
173,2022/7/15 10:30,8,12,-4,-852
173,2022/7/15 10:40,6,22,-16,-812
173,2022/7/15 10:50,6,14,-8,-839
173,2022/7/15 11:00,6,19,-13,-779
173,2022/7/15 11:10,6,14,-8,-901
173,2022/7/15 11:20,6,8,-2,-952
173,2022/7/15 11:30,6,23,-17,-803
173,2022/7/15 11:40,7,19,-12,-708
173,2022/7/15 11:50,9,7,2,-595
173,2022/7/15 12:00,8,16,-8,-644
173,2022/7/15 12:10,7,23,-16,-521
173,2022/7/15 12:20,8,19,-11,-466
173,2022/7/15 12:30,8,8,0,-619
173,2022/7/15 12:40,8,23,-15,-840
173,2022/7/15 12:50,7,21,-14,-840
173,2022/7/15 13:00,8,2,6,-757
173,2022/7/15 13:10,9,19,-10,-657
173,2022/7/15 13:20,7,21,-14,-670
173,2022/7/15 13:30,9,21,-12,-728
173,2022/7/15 13:40,8,7,1,-911
173,2022/7/15 13:50,7,23,-16,-568
173,2022/7/15 14:00,7,21,-14,-805
173,2022/7/15 14:10,7,2,5,-783
173,2022/7/15 14:20,7,21,-14,-700
173,2022/7/15 14:30,7,21,-14,-844
173,2022/7/15 14:40,7,18,-11,-789
173,2022/7/15 14:50,9,12,-3,-755
173,2022/7/15 15:00,7,21,-14,-542
173,2022/7/15 15:10,12,19,-7,-433
173,2022/7/15 15:20,9,6,3,-366
173,2022/7/15 15:30,12,19,-7,-424
173,2022/7/15 15:40,10,23,-13,-652
173,2022/7/15 15:50,11,23,-12,-334
173,2022/7/15 16:00,11,15,-4,-187
173,2022/7/15 16:10,14,23,-9,69
173,2022/7/15 16:20,18,30,-12,-371
173,2022/7/15 16:30,29,32,-3,173
173,2022/7/15 16:40,22,18,4,716
173,2022/7/15 16:50,15,23,-8,430
173,2022/7/15 17:00,29,46,-17,2284
173,2022/7/15 17:10,16,31,-15,3917
173,2022/7/15 17:20,18,29,-11,1676
173,2022/7/15 17:30,12,62,-50,691
173,2022/7/15 17:40,12,30,-18,3360
173,2022/7/15 17:50,12,37,-25,284
173,2022/7/15 18:00,11,63,-52,-1603
173,2022/7/15 18:10,11,21,-10,2224
173,2022/7/15 18:20,10,56,-46,374
173,2022/7/15 18:30,7,46,-39,-2924
173,2022/7/15 18:40,6,21,-15,-3812
173,2022/7/15 18:50,7,56,-49,-3730
173,2022/7/15 19:00,6,38,-32,-3078
173,2022/7/15 19:10,7,41,-34,-2027
173,2022/7/15 19:20,6,68,-62,-2047
173,2022/7/15 19:30,5,56,-51,-1636
173,2022/7/15 19:40,5,16,-11,-1314
173,2022/7/15 19:50,3,49,-46,-932
173,2022/7/15 20:00,4,36,-32,-988
173,2022/7/15 20:10,3,34,-31,-901
173,2022/7/15 20:20,5,36,-31,-842
173,2022/7/15 20:30,2,7,-5,-761
173,2022/7/15 20:40,3,34,-31,-870
173,2022/7/15 20:50,3,34,-31,-874
173,2022/7/15 21:00,2,7,-5,-968
173,2022/7/15 21:10,2,25,-23,-683
173,2022/7/15 21:20,1,33,-32,-1004
173,2022/7/15 21:30,2,4,-2,-1013
173,2022/7/15 21:40,2,25,-23,-1229
173,2022/7/15 21:50,1,31,-30,-1135
173,2022/7/15 22:00,1,7,-6,-925
173,2022/7/15 22:10,1,32,-31,-1190
173,2022/7/15 22:20,1,24,-23,-1451
173,2022/7/15 22:30,1,21,-20,-1537
173,2022/7/15 22:40,0,21,-21,-1501
173,2022/7/15 22:50,0,18,-18,-1415
165,2022/7/15 5:00,0,1,-1,-8
165,2022/7/15 5:10,0,1,-1,25
165,2022/7/15 5:20,22,1,21,108
165,2022/7/15 5:30,16,1,15,371
165,2022/7/15 5:40,27,1,26,372
165,2022/7/15 5:50,30,1,29,414
165,2022/7/15 6:00,32,1,31,360
165,2022/7/15 6:10,36,6,30,314
165,2022/7/15 6:20,49,45,4,601
165,2022/7/15 6:30,47,40,7,917
165,2022/7/15 6:40,87,2,85,1365
165,2022/7/15 6:50,106,61,45,2605
165,2022/7/15 7:00,106,72,34,3675
165,2022/7/15 7:10,254,13,241,4568
165,2022/7/15 7:20,215,87,128,6677
165,2022/7/15 7:30,222,100,122,7279
165,2022/7/15 7:40,254,35,219,8651
165,2022/7/15 7:50,233,112,121,9390
165,2022/7/15 8:00,103,112,-9,8736
165,2022/7/15 8:10,151,48,103,6897
165,2022/7/15 8:20,73,120,-47,4937
165,2022/7/15 8:30,48,105,-57,626
165,2022/7/15 8:40,56,15,41,-6179
165,2022/7/15 8:50,31,82,-51,-4225
165,2022/7/15 9:00,28,70,-42,-2045
165,2022/7/15 9:10,31,32,-1,-2146
165,2022/7/15 9:20,25,84,-59,-509
165,2022/7/15 9:30,28,70,-42,-428
165,2022/7/15 9:40,28,12,16,-969
165,2022/7/15 9:50,20,74,-54,-1220
165,2022/7/15 10:00,23,59,-36,-1221
165,2022/7/15 10:10,22,60,-38,-924
165,2022/7/15 10:20,20,27,-7,-852
165,2022/7/15 10:30,21,34,-13,-865
165,2022/7/15 10:40,21,57,-36,-848
165,2022/7/15 10:50,17,48,-31,-870
165,2022/7/15 11:00,19,44,-25,-804
165,2022/7/15 11:10,21,31,-10,-911
165,2022/7/15 11:20,24,52,-28,-980
165,2022/7/15 11:30,22,31,-9,-812
165,2022/7/15 11:40,22,36,-14,-722
165,2022/7/15 11:50,28,51,-23,-618
165,2022/7/15 12:00,26,57,-31,-675
165,2022/7/15 12:10,23,22,1,-520
165,2022/7/15 12:20,27,50,-23,-489
165,2022/7/15 12:30,24,61,-37,-656
165,2022/7/15 12:40,25,59,-34,-874
165,2022/7/15 12:50,24,18,6,-834
165,2022/7/15 13:00,23,65,-42,-799
165,2022/7/15 13:10,22,61,-39,-696
165,2022/7/15 13:20,26,23,3,-667
165,2022/7/15 13:30,21,53,-32,-760
165,2022/7/15 13:40,21,62,-41,-952
165,2022/7/15 13:50,21,68,-47,-615
165,2022/7/15 14:00,19,12,7,-798
165,2022/7/15 14:10,19,68,-49,-832
165,2022/7/15 14:20,21,70,-49,-749
165,2022/7/15 14:30,25,19,6,-838
165,2022/7/15 14:40,22,63,-41,-830
165,2022/7/15 14:50,25,66,-41,-796
165,2022/7/15 15:00,24,60,-36,-578
165,2022/7/15 15:10,25,20,5,-428
165,2022/7/15 15:20,26,69,-43,-409
165,2022/7/15 15:30,21,77,-56,-480
165,2022/7/15 15:40,23,62,-39,-691
165,2022/7/15 15:50,25,47,-22,-356
165,2022/7/15 16:00,26,78,-52,-239
165,2022/7/15 16:10,27,81,-54,15
165,2022/7/15 16:20,30,19,11,-360
165,2022/7/15 16:30,40,82,-42,131
165,2022/7/15 16:40,34,77,-43,673
165,2022/7/15 16:50,36,87,-51,379
165,2022/7/15 17:00,105,25,80,2364
165,2022/7/15 17:10,38,108,-70,3847
165,2022/7/15 17:20,46,109,-63,1613
165,2022/7/15 17:30,32,7,25,716
165,2022/7/15 17:40,29,119,-90,3270
165,2022/7/15 17:50,28,100,-72,212
165,2022/7/15 18:00,26,30,-4,-1607
165,2022/7/15 18:10,25,119,-94,2130
165,2022/7/15 18:20,22,103,-81,293
165,2022/7/15 18:30,18,53,-35,-2959
165,2022/7/15 18:40,17,143,-126,-3938
165,2022/7/15 18:50,20,103,-83,-3813
165,2022/7/15 19:00,13,66,-53,-3131
165,2022/7/15 19:10,14,116,-102,-2129
165,2022/7/15 19:20,12,102,-90,-2137
165,2022/7/15 19:30,11,51,-40,-1676
165,2022/7/15 19:40,13,107,-94,-1408
165,2022/7/15 19:50,13,92,-79,-1011
165,2022/7/15 20:00,13,83,-70,-1058
165,2022/7/15 20:10,10,73,-63,-964
165,2022/7/15 20:20,14,10,4,-838
165,2022/7/15 20:30,11,79,-68,-829
165,2022/7/15 20:40,14,87,-73,-943
165,2022/7/15 20:50,13,6,7,-867
165,2022/7/15 21:00,10,80,-70,-1038
165,2022/7/15 21:10,11,77,-66,-749
165,2022/7/15 21:20,9,13,-4,-1008
165,2022/7/15 21:30,9,72,-63,-1076
165,2022/7/15 21:40,11,69,-58,-1287
165,2022/7/15 21:50,19,7,12,-1123
165,2022/7/15 22:00,12,75,-63,-988
165,2022/7/15 22:10,8,71,-63,-1253
165,2022/7/15 22:20,6,4,2,-1449
165,2022/7/15 22:30,3,67,-64,-1601
165,2022/7/15 22:40,2,55,-53,-1554
165,2022/7/15 22:50,0,35,-35,-1450
150,2022/7/15 5:00,0,1,-1,-9
150,2022/7/15 5:10,7,1,6,31
150,2022/7/15 5:20,12,1,11,119
150,2022/7/15 5:30,7,1,6,377
150,2022/7/15 5:40,13,1,12,384
150,2022/7/15 5:50,22,1,21,435
150,2022/7/15 6:00,27,1,26,386
150,2022/7/15 6:10,41,1,40,354
150,2022/7/15 6:20,43,21,22,623
150,2022/7/15 6:30,37,21,16,933
150,2022/7/15 6:40,58,6,52,1417
150,2022/7/15 6:50,79,38,41,2646
150,2022/7/15 7:00,83,47,36,3711
150,2022/7/15 7:10,147,23,124,4692
150,2022/7/15 7:20,193,68,125,6802
150,2022/7/15 7:30,145,58,87,7366
150,2022/7/15 7:40,108,69,39,8690
150,2022/7/15 7:50,155,93,62,9452
150,2022/7/15 8:00,80,94,-14,8722
150,2022/7/15 8:10,72,72,0,6897
150,2022/7/15 8:20,68,105,-37,4900
150,2022/7/15 8:30,44,55,-11,615
150,2022/7/15 8:40,35,75,-40,-6219
150,2022/7/15 8:50,45,76,-31,-4256
150,2022/7/15 9:00,20,16,4,-2041
150,2022/7/15 9:10,25,66,-41,-2187
150,2022/7/15 9:20,21,62,-41,-550
150,2022/7/15 9:30,23,35,-12,-440
150,2022/7/15 9:40,24,60,-36,-1005
150,2022/7/15 9:50,21,61,-40,-1260
150,2022/7/15 10:00,24,40,-16,-1237
150,2022/7/15 10:10,19,51,-32,-956
150,2022/7/15 10:20,22,38,-16,-868
150,2022/7/15 10:30,23,62,-39,-904
150,2022/7/15 10:40,20,57,-37,-885
150,2022/7/15 10:50,25,47,-22,-892
150,2022/7/15 11:00,23,10,13,-791
150,2022/7/15 11:10,23,57,-34,-945
150,2022/7/15 11:20,24,50,-26,-1006
150,2022/7/15 11:30,25,18,7,-805
150,2022/7/15 11:40,23,60,-37,-759
150,2022/7/15 11:50,26,48,-22,-640
150,2022/7/15 12:00,21,47,-26,-701
150,2022/7/15 12:10,25,18,7,-513
150,2022/7/15 12:20,22,58,-36,-525
150,2022/7/15 12:30,21,62,-41,-697
150,2022/7/15 12:40,18,12,6,-868
150,2022/7/15 12:50,24,65,-41,-875
150,2022/7/15 13:00,24,71,-47,-846
150,2022/7/15 13:10,22,51,-29,-725
150,2022/7/15 13:20,17,37,-20,-687
150,2022/7/15 13:30,16,64,-48,-808
150,2022/7/15 13:40,22,64,-42,-994
150,2022/7/15 13:50,24,14,10,-605
150,2022/7/15 14:00,23,57,-34,-832
150,2022/7/15 14:10,22,63,-41,-873
150,2022/7/15 14:20,21,59,-38,-787
150,2022/7/15 14:30,23,19,4,-834
150,2022/7/15 14:40,18,68,-50,-880
150,2022/7/15 14:50,26,60,-34,-830
150,2022/7/15 15:00,24,8,16,-562
150,2022/7/15 15:10,26,70,-44,-472
150,2022/7/15 15:20,25,69,-44,-453
150,2022/7/15 15:30,28,61,-33,-513
150,2022/7/15 15:40,26,33,-7,-698
150,2022/7/15 15:50,31,68,-37,-393
150,2022/7/15 16:00,24,64,-40,-279
150,2022/7/15 16:10,30,11,19,34
150,2022/7/15 16:20,33,72,-39,-399
150,2022/7/15 16:30,39,63,-24,107
150,2022/7/15 16:40,35,70,-35,638
150,2022/7/15 16:50,38,22,16,395
150,2022/7/15 17:00,39,64,-25,2339
150,2022/7/15 17:10,43,91,-48,3799
150,2022/7/15 17:20,28,63,-35,1578
150,2022/7/15 17:30,26,58,-32,684
150,2022/7/15 17:40,23,105,-82,3188
150,2022/7/15 17:50,25,42,-17,195
150,2022/7/15 18:00,22,97,-75,-1682
150,2022/7/15 18:10,22,127,-105,2025
150,2022/7/15 18:20,20,27,-7,286
150,2022/7/15 18:30,18,105,-87,-3046
150,2022/7/15 18:40,16,106,-90,-4028
150,2022/7/15 18:50,13,36,-23,-3836
150,2022/7/15 19:00,12,110,-98,-3229
150,2022/7/15 19:10,13,105,-92,-2221
150,2022/7/15 19:20,8,39,-31,-2168
150,2022/7/15 19:30,10,95,-85,-1761
150,2022/7/15 19:40,10,77,-67,-1475
150,2022/7/15 19:50,11,60,-49,-1060
150,2022/7/15 20:00,8,78,-70,-1128
150,2022/7/15 20:10,12,50,-38,-1002
150,2022/7/15 20:20,8,33,-25,-863
150,2022/7/15 20:30,9,67,-58,-887
150,2022/7/15 20:40,8,64,-56,-999
150,2022/7/15 20:50,9,8,1,-866
150,2022/7/15 21:00,8,69,-61,-1099
150,2022/7/15 21:10,7,61,-54,-803
150,2022/7/15 21:20,6,8,-2,-1010
150,2022/7/15 21:30,5,62,-57,-1133
150,2022/7/15 21:40,2,59,-57,-1344
150,2022/7/15 21:50,4,10,-6,-1129
150,2022/7/15 22:00,4,63,-59,-1047
150,2022/7/15 22:10,3,53,-50,-1303
150,2022/7/15 22:20,2,8,-6,-1455
150,2022/7/15 22:30,2,49,-47,-1648
150,2022/7/15 22:40,0,40,-40,-1594
150,2022/7/15 22:50,0,36,-36,-1486
172,2022/7/15 5:00,0,1,-1,-10
172,2022/7/15 5:10,10,1,9,40
172,2022/7/15 5:20,19,1,18,137
172,2022/7/15 5:30,12,1,11,388
172,2022/7/15 5:40,19,1,18,402
172,2022/7/15 5:50,32,1,31,466
172,2022/7/15 6:00,32,1,31,417
172,2022/7/15 6:10,49,1,48,402
172,2022/7/15 6:20,80,36,44,667
172,2022/7/15 6:30,54,5,49,982
172,2022/7/15 6:40,87,47,40,1457
172,2022/7/15 6:50,157,64,93,2739
172,2022/7/15 7:00,156,19,137,3848
172,2022/7/15 7:10,215,75,140,4832
172,2022/7/15 7:20,274,121,153,6955
172,2022/7/15 7:30,254,17,237,7603
172,2022/7/15 7:40,174,104,70,8760
172,2022/7/15 7:50,225,117,108,9560
172,2022/7/15 8:00,158,46,112,8834
172,2022/7/15 8:10,82,178,-96,6801
172,2022/7/15 8:20,90,117,-27,4873
172,2022/7/15 8:30,56,25,31,646
172,2022/7/15 8:40,54,133,-79,-6298
172,2022/7/15 8:50,46,108,-62,-4318
172,2022/7/15 9:00,32,13,19,-2022
172,2022/7/15 9:10,32,105,-73,-2260
172,2022/7/15 9:20,32,73,-41,-591
172,2022/7/15 9:30,27,30,-3,-443
172,2022/7/15 9:40,27,76,-49,-1054
172,2022/7/15 9:50,27,68,-41,-1301
172,2022/7/15 10:00,27,12,15,-1222
172,2022/7/15 10:10,25,76,-51,-1007
172,2022/7/15 10:20,26,65,-39,-907
172,2022/7/15 10:30,27,63,-36,-940
172,2022/7/15 10:40,25,69,-44,-929
172,2022/7/15 10:50,29,47,-18,-910
172,2022/7/15 11:00,26,39,-13,-804
172,2022/7/15 11:10,24,71,-47,-992
172,2022/7/15 11:20,26,46,-20,-1026
172,2022/7/15 11:30,28,37,-9,-814
172,2022/7/15 11:40,27,71,-44,-803
172,2022/7/15 11:50,31,67,-36,-676
172,2022/7/15 12:00,28,28,0,-701
172,2022/7/15 12:10,28,50,-22,-535
172,2022/7/15 12:20,27,64,-37,-562
172,2022/7/15 12:30,26,62,-36,-733
172,2022/7/15 12:40,28,28,0,-868
172,2022/7/15 12:50,29,62,-33,-908
172,2022/7/15 13:00,26,82,-56,-902
172,2022/7/15 13:10,27,15,12,-713
172,2022/7/15 13:20,22,83,-61,-748
172,2022/7/15 13:30,26,82,-56,-864
172,2022/7/15 13:40,24,71,-47,-1041
172,2022/7/15 13:50,26,19,7,-598
172,2022/7/15 14:00,22,72,-50,-882
172,2022/7/15 14:10,28,81,-53,-926
172,2022/7/15 14:20,26,15,11,-776
172,2022/7/15 14:30,28,70,-42,-876
172,2022/7/15 14:40,25,72,-47,-927
172,2022/7/15 14:50,28,62,-34,-864
172,2022/7/15 15:00,25,33,-8,-570
172,2022/7/15 15:10,29,78,-49,-521
172,2022/7/15 15:20,27,72,-45,-498
172,2022/7/15 15:30,27,14,13,-500
172,2022/7/15 15:40,29,81,-52,-750
172,2022/7/15 15:50,32,79,-47,-440
172,2022/7/15 16:00,33,68,-35,-314
172,2022/7/15 16:10,40,33,7,41
172,2022/7/15 16:20,45,92,-47,-446
172,2022/7/15 16:30,46,73,-27,80
172,2022/7/15 16:40,45,85,-40,598
172,2022/7/15 16:50,61,35,26,421
172,2022/7/15 17:00,74,108,-34,2305
172,2022/7/15 17:10,137,105,32,3831
172,2022/7/15 17:20,62,25,37,1615
172,2022/7/15 17:30,47,99,-52,632
172,2022/7/15 17:40,37,111,-74,3114
172,2022/7/15 17:50,30,23,7,202
172,2022/7/15 18:00,26,109,-83,-1765
172,2022/7/15 18:10,27,147,-120,1905
172,2022/7/15 18:20,22,29,-7,279
172,2022/7/15 18:30,22,192,-170,-3216
172,2022/7/15 18:40,18,121,-103,-4131
172,2022/7/15 18:50,18,88,-70,-3906
172,2022/7/15 19:00,16,154,-138,-3367
172,2022/7/15 19:10,17,98,-81,-2302
172,2022/7/15 19:20,16,98,-82,-2250
172,2022/7/15 19:30,13,110,-97,-1858
172,2022/7/15 19:40,13,123,-110,-1585
172,2022/7/15 19:50,13,22,-9,-1069
172,2022/7/15 20:00,14,113,-99,-1227
172,2022/7/15 20:10,19,79,-60,-1062
172,2022/7/15 20:20,17,82,-65,-928
172,2022/7/15 20:30,14,80,-66,-953
172,2022/7/15 20:40,14,31,-17,-1016
172,2022/7/15 20:50,11,70,-59,-925
172,2022/7/15 21:00,13,78,-65,-1164
172,2022/7/15 21:10,13,21,-8,-811
172,2022/7/15 21:20,8,87,-79,-1089
172,2022/7/15 21:30,7,86,-79,-1212
172,2022/7/15 21:40,8,13,-5,-1349
172,2022/7/15 21:50,9,79,-70,-1199
172,2022/7/15 22:00,5,78,-73,-1120
172,2022/7/15 22:10,5,21,-16,-1319
172,2022/7/15 22:20,4,70,-66,-1521
172,2022/7/15 22:30,1,75,-74,-1722
172,2022/7/15 22:40,0,55,-55,-1649
172,2022/7/15 22:50,0,53,-53,-1539
168,2022/7/15 5:00,0,1,-1,-11
168,2022/7/15 5:10,3,1,2,42
168,2022/7/15 5:20,4,1,3,140
168,2022/7/15 5:30,5,1,4,392
168,2022/7/15 5:40,4,1,3,405
168,2022/7/15 5:50,6,1,5,471
168,2022/7/15 6:00,5,1,4,421
168,2022/7/15 6:10,16,1,15,417
168,2022/7/15 6:20,17,5,12,679
168,2022/7/15 6:30,20,55,-35,947
168,2022/7/15 6:40,27,69,-42,1415
168,2022/7/15 6:50,34,101,-67,2672
168,2022/7/15 7:00,39,18,21,3869
168,2022/7/15 7:10,29,87,-58,4774
168,2022/7/15 7:20,36,102,-66,6889
168,2022/7/15 7:30,36,102,-66,7537
168,2022/7/15 7:40,28,198,-170,8590
168,2022/7/15 7:50,32,106,-74,9486
168,2022/7/15 8:00,32,94,-62,8772
168,2022/7/15 8:10,24,299,-275,6526
168,2022/7/15 8:20,29,105,-76,4797
168,2022/7/15 8:30,24,52,-28,618
168,2022/7/15 8:40,21,93,-72,-6370
168,2022/7/15 8:50,22,58,-36,-4354
168,2022/7/15 9:00,14,18,-4,-2026
168,2022/7/15 9:10,15,65,-50,-2310
168,2022/7/15 9:20,14,31,-17,-608
168,2022/7/15 9:30,13,27,-14,-457
168,2022/7/15 9:40,13,46,-33,-1087
168,2022/7/15 9:50,11,33,-22,-1323
168,2022/7/15 10:00,10,15,-5,-1227
168,2022/7/15 10:10,14,29,-15,-1022
168,2022/7/15 10:20,10,32,-22,-929
168,2022/7/15 10:30,15,28,-13,-953
168,2022/7/15 10:40,13,1,12,-917
168,2022/7/15 10:50,12,25,-13,-923
168,2022/7/15 11:00,15,23,-8,-812
168,2022/7/15 11:10,20,33,-13,-1005
168,2022/7/15 11:20,20,1,19,-1007
168,2022/7/15 11:30,19,34,-15,-829
168,2022/7/15 11:40,19,37,-18,-821
168,2022/7/15 11:50,18,23,-5,-681
168,2022/7/15 12:00,17,1,16,-685
168,2022/7/15 12:10,18,36,-18,-553
168,2022/7/15 12:20,17,35,-18,-580
168,2022/7/15 12:30,16,1,15,-718
168,2022/7/15 12:40,19,35,-16,-884
168,2022/7/15 12:50,17,29,-12,-920
168,2022/7/15 13:00,16,30,-14,-916
168,2022/7/15 13:10,17,5,12,-701
168,2022/7/15 13:20,12,34,-22,-770
168,2022/7/15 13:30,13,33,-20,-884
168,2022/7/15 13:40,11,1,10,-1031
168,2022/7/15 13:50,15,29,-14,-612
168,2022/7/15 14:00,12,25,-13,-895
168,2022/7/15 14:10,12,25,-13,-939
168,2022/7/15 14:20,12,2,10,-766
168,2022/7/15 14:30,16,23,-7,-883
168,2022/7/15 14:40,20,31,-11,-938
168,2022/7/15 14:50,20,1,19,-845
168,2022/7/15 15:00,18,29,-11,-581
168,2022/7/15 15:10,16,30,-14,-535
168,2022/7/15 15:20,19,23,-4,-502
168,2022/7/15 15:30,22,12,10,-490
168,2022/7/15 15:40,23,32,-9,-759
168,2022/7/15 15:50,26,38,-12,-452
168,2022/7/15 16:00,32,2,30,-284
168,2022/7/15 16:10,32,33,-1,40
168,2022/7/15 16:20,31,35,-4,-450
168,2022/7/15 16:30,33,35,-2,78
168,2022/7/15 16:40,70,10,60,658
168,2022/7/15 16:50,179,33,146,567
168,2022/7/15 17:00,268,38,230,2535
168,2022/7/15 17:10,243,42,201,4032
168,2022/7/15 17:20,49,10,39,1654
168,2022/7/15 17:30,43,46,-3,629
168,2022/7/15 17:40,31,49,-18,3096
168,2022/7/15 17:50,25,10,15,217
168,2022/7/15 18:00,23,55,-32,-1797
168,2022/7/15 18:10,22,44,-22,1883
168,2022/7/15 18:20,18,46,-28,251
168,2022/7/15 18:30,17,73,-56,-3272
168,2022/7/15 18:40,17,14,3,-4128
168,2022/7/15 18:50,14,68,-54,-3960
168,2022/7/15 19:00,12,83,-71,-3438
168,2022/7/15 19:10,11,6,5,-2297
168,2022/7/15 19:20,9,75,-66,-2316
168,2022/7/15 19:30,8,56,-48,-1906
168,2022/7/15 19:40,8,40,-32,-1617
168,2022/7/15 19:50,11,19,-8,-1077
168,2022/7/15 20:00,19,40,-21,-1248
168,2022/7/15 20:10,21,36,-15,-1077
168,2022/7/15 20:20,23,33,-10,-938
168,2022/7/15 20:30,15,36,-21,-974
168,2022/7/15 20:40,13,3,10,-1006
168,2022/7/15 20:50,8,41,-33,-958
168,2022/7/15 21:00,4,34,-30,-1194
168,2022/7/15 21:10,4,3,1,-810
168,2022/7/15 21:20,2,39,-37,-1126
168,2022/7/15 21:30,1,27,-26,-1238
168,2022/7/15 21:40,4,7,-3,-1352
168,2022/7/15 21:50,2,40,-38,-1237
168,2022/7/15 22:00,2,34,-32,-1152
168,2022/7/15 22:10,2,7,-5,-1324
168,2022/7/15 22:20,2,34,-32,-1553
168,2022/7/15 22:30,0,30,-30,-1752
168,2022/7/15 22:40,0,21,-21,-1670
168,2022/7/15 22:50,0,21,-21,-1560
159,2022/7/15 5:00,0,1,-1,-12
159,2022/7/15 5:10,19,1,18,60
159,2022/7/15 5:20,18,1,17,157
159,2022/7/15 5:30,20,1,19,411
159,2022/7/15 5:40,26,1,25,430
159,2022/7/15 5:50,34,1,33,504
159,2022/7/15 6:00,47,1,46,467
159,2022/7/15 6:10,57,1,56,473
159,2022/7/15 6:20,86,1,85,764
159,2022/7/15 6:30,149,65,84,1031
159,2022/7/15 6:40,216,70,146,1561
159,2022/7/15 6:50,232,6,226,2898
159,2022/7/15 7:00,280,79,201,4070
159,2022/7/15 7:10,282,96,186,4960
159,2022/7/15 7:20,283,13,270,7159
159,2022/7/15 7:30,280,109,171,7708
159,2022/7/15 7:40,302,100,202,8792
159,2022/7/15 7:50,253,19,234,9720
159,2022/7/15 8:00,270,90,180,8952
159,2022/7/15 8:10,227,69,158,6684
159,2022/7/15 8:20,144,16,128,4925
159,2022/7/15 8:30,143,67,76,694
159,2022/7/15 8:40,60,60,0,-6370
159,2022/7/15 8:50,53,21,32,-4322
159,2022/7/15 9:00,41,65,-24,-2050
159,2022/7/15 9:10,29,48,-19,-2329
159,2022/7/15 9:20,28,25,3,-605
159,2022/7/15 9:30,32,64,-32,-489
159,2022/7/15 9:40,28,50,-22,-1109
159,2022/7/15 9:50,29,19,10,-1313
159,2022/7/15 10:00,28,61,-33,-1260
159,2022/7/15 10:10,23,58,-35,-1057
159,2022/7/15 10:20,24,47,-23,-952
159,2022/7/15 10:30,21,22,-1,-954
159,2022/7/15 10:40,28,49,-21,-938
159,2022/7/15 10:50,26,55,-29,-952
159,2022/7/15 11:00,25,50,-25,-837
159,2022/7/15 11:10,24,24,0,-1005
159,2022/7/15 11:20,27,48,-21,-1028
159,2022/7/15 11:30,25,61,-36,-865
159,2022/7/15 11:40,25,7,18,-803
159,2022/7/15 11:50,28,57,-29,-710
159,2022/7/15 12:00,25,51,-26,-711
159,2022/7/15 12:10,27,54,-27,-580
159,2022/7/15 12:20,27,7,20,-560
159,2022/7/15 12:30,26,60,-34,-752
159,2022/7/15 12:40,28,60,-32,-916
159,2022/7/15 12:50,26,44,-18,-938
159,2022/7/15 13:00,23,34,-11,-927
159,2022/7/15 13:10,25,68,-43,-744
159,2022/7/15 13:20,22,62,-40,-810
159,2022/7/15 13:30,22,5,17,-867
159,2022/7/15 13:40,22,62,-40,-1071
159,2022/7/15 13:50,16,64,-48,-660
159,2022/7/15 14:00,22,68,-46,-941
159,2022/7/15 14:10,23,17,6,-933
159,2022/7/15 14:20,22,67,-45,-811
159,2022/7/15 14:30,17,68,-51,-934
159,2022/7/15 14:40,20,5,15,-923
159,2022/7/15 14:50,18,63,-45,-890
159,2022/7/15 15:00,18,71,-53,-634
159,2022/7/15 15:10,24,57,-33,-568
159,2022/7/15 15:20,27,43,-16,-518
159,2022/7/15 15:30,28,84,-56,-546
159,2022/7/15 15:40,21,87,-66,-825
159,2022/7/15 15:50,21,47,-26,-478
159,2022/7/15 16:00,27,75,-48,-332
159,2022/7/15 16:10,28,109,-81,-41
159,2022/7/15 16:20,26,93,-67,-517
159,2022/7/15 16:30,27,42,-15,63
159,2022/7/15 16:40,27,105,-78,580
159,2022/7/15 16:50,27,105,-78,489
159,2022/7/15 17:00,33,102,-69,2466
159,2022/7/15 17:10,38,33,5,4037
159,2022/7/15 17:20,32,123,-91,1563
159,2022/7/15 17:30,28,109,-81,548
159,2022/7/15 17:40,28,14,14,3110
159,2022/7/15 17:50,25,143,-118,99
159,2022/7/15 18:00,17,138,-121,-1918
159,2022/7/15 18:10,19,49,-30,1853
159,2022/7/15 18:20,15,197,-182,69
159,2022/7/15 18:30,13,107,-94,-3366
159,2022/7/15 18:40,15,97,-82,-4210
159,2022/7/15 18:50,12,198,-186,-4146
159,2022/7/15 19:00,9,81,-72,-3510
159,2022/7/15 19:10,10,105,-95,-2392
159,2022/7/15 19:20,10,179,-169,-2485
159,2022/7/15 19:30,11,99,-88,-1994
159,2022/7/15 19:40,9,80,-71,-1688
159,2022/7/15 19:50,7,123,-116,-1193
159,2022/7/15 20:00,9,115,-106,-1354
159,2022/7/15 20:10,12,92,-80,-1157
159,2022/7/15 20:20,12,92,-80,-1018
159,2022/7/15 20:30,12,8,4,-970
159,2022/7/15 20:40,12,98,-86,-1092
159,2022/7/15 20:50,8,97,-89,-1047
159,2022/7/15 21:00,6,4,2,-1192
159,2022/7/15 21:10,6,98,-92,-902
159,2022/7/15 21:20,7,103,-96,-1222
159,2022/7/15 21:30,8,3,5,-1233
159,2022/7/15 21:40,7,91,-84,-1436
159,2022/7/15 21:50,4,95,-91,-1328
159,2022/7/15 22:00,2,3,-1,-1153
159,2022/7/15 22:10,3,95,-92,-1416
159,2022/7/15 22:20,2,80,-78,-1631
159,2022/7/15 22:30,0,3,-3,-1755
159,2022/7/15 22:40,0,86,-86,-1756
159,2022/7/15 22:50,0,61,-61,-1621
166,2022/7/15 5:00,0,1,-1,-13
166,2022/7/15 5:10,0,1,-1,59
166,2022/7/15 5:20,21,1,20,177
166,2022/7/15 5:30,21,2,19,430
166,2022/7/15 5:40,27,1,26,456
166,2022/7/15 5:50,27,1,26,530
166,2022/7/15 6:00,33,5,28,495
166,2022/7/15 6:10,32,5,27,500
166,2022/7/15 6:20,54,41,13,777
166,2022/7/15 6:30,67,42,25,1056
166,2022/7/15 6:40,79,47,32,1593
166,2022/7/15 6:50,98,38,60,2958
166,2022/7/15 7:00,215,93,122,4192
166,2022/7/15 7:10,247,55,192,5152
166,2022/7/15 7:20,199,75,124,7283
166,2022/7/15 7:30,236,107,129,7837
166,2022/7/15 7:40,285,88,197,8989
166,2022/7/15 7:50,222,57,165,9885
166,2022/7/15 8:00,176,117,59,9011
166,2022/7/15 8:10,188,81,107,6791
166,2022/7/15 8:20,79,105,-26,4899
166,2022/7/15 8:30,80,119,-39,655
166,2022/7/15 8:40,61,71,-10,-6380
166,2022/7/15 8:50,45,102,-57,-4379
166,2022/7/15 9:00,46,111,-65,-2115
166,2022/7/15 9:10,29,59,-30,-2359
166,2022/7/15 9:20,36,93,-57,-662
166,2022/7/15 9:30,27,91,-64,-553
166,2022/7/15 9:40,32,58,-26,-1135
166,2022/7/15 9:50,26,74,-48,-1361
166,2022/7/15 10:00,32,75,-43,-1303
166,2022/7/15 10:10,27,73,-46,-1103
166,2022/7/15 10:20,27,71,-44,-996
166,2022/7/15 10:30,27,21,6,-948
166,2022/7/15 10:40,28,85,-57,-995
166,2022/7/15 10:50,27,67,-40,-992
166,2022/7/15 11:00,30,77,-47,-884
166,2022/7/15 11:10,27,15,12,-993
166,2022/7/15 11:20,25,85,-60,-1088
166,2022/7/15 11:30,30,71,-41,-906
166,2022/7/15 11:40,32,51,-19,-822
166,2022/7/15 11:50,29,48,-19,-729
166,2022/7/15 12:00,29,65,-36,-747
166,2022/7/15 12:10,31,69,-38,-618
166,2022/7/15 12:20,25,19,6,-554
166,2022/7/15 12:30,29,82,-53,-805
166,2022/7/15 12:40,24,77,-53,-969
166,2022/7/15 12:50,25,39,-14,-952
166,2022/7/15 13:00,24,84,-60,-987
166,2022/7/15 13:10,27,77,-50,-794
166,2022/7/15 13:20,30,78,-48,-858
166,2022/7/15 13:30,28,21,7,-860
166,2022/7/15 13:40,28,79,-51,-1122
166,2022/7/15 13:50,27,80,-53,-713
166,2022/7/15 14:00,32,39,-7,-948
166,2022/7/15 14:10,27,81,-54,-987
166,2022/7/15 14:20,27,97,-70,-881
166,2022/7/15 14:30,25,76,-51,-985
166,2022/7/15 14:40,24,27,-3,-926
166,2022/7/15 14:50,26,90,-64,-954
166,2022/7/15 15:00,29,75,-46,-680
166,2022/7/15 15:10,22,37,-15,-583
166,2022/7/15 15:20,25,75,-50,-568
166,2022/7/15 15:30,35,90,-55,-601
166,2022/7/15 15:40,28,96,-68,-893
166,2022/7/15 15:50,26,19,7,-471
166,2022/7/15 16:00,36,99,-63,-395
166,2022/7/15 16:10,35,108,-73,-114
166,2022/7/15 16:20,38,72,-34,-551
166,2022/7/15 16:30,41,45,-4,59
166,2022/7/15 16:40,45,101,-56,524
166,2022/7/15 16:50,40,104,-64,425
166,2022/7/15 17:00,48,67,-19,2447
166,2022/7/15 17:10,44,107,-63,3974
166,2022/7/15 17:20,47,118,-71,1492
166,2022/7/15 17:30,42,68,-26,522
166,2022/7/15 17:40,38,124,-86,3024
166,2022/7/15 17:50,36,110,-74,25
166,2022/7/15 18:00,34,68,-34,-1952
166,2022/7/15 18:10,31,180,-149,1704
166,2022/7/15 18:20,32,215,-183,-114
166,2022/7/15 18:30,24,31,-7,-3373
166,2022/7/15 18:40,26,219,-193,-4403
166,2022/7/15 18:50,27,209,-182,-4328
166,2022/7/15 19:00,23,23,0,-3510
166,2022/7/15 19:10,23,234,-211,-2603
166,2022/7/15 19:20,21,128,-107,-2592
166,2022/7/15 19:30,17,67,-50,-2044
166,2022/7/15 19:40,16,122,-106,-1794
166,2022/7/15 19:50,17,125,-108,-1301
166,2022/7/15 20:00,19,83,-64,-1418
166,2022/7/15 20:10,17,94,-77,-1234
166,2022/7/15 20:20,17,78,-61,-1079
166,2022/7/15 20:30,14,46,-32,-1002
166,2022/7/15 20:40,17,100,-83,-1175
166,2022/7/15 20:50,16,95,-79,-1126
166,2022/7/15 21:00,16,13,3,-1189
166,2022/7/15 21:10,16,100,-84,-986
166,2022/7/15 21:20,15,76,-61,-1283
166,2022/7/15 21:30,15,14,1,-1232
166,2022/7/15 21:40,12,97,-85,-1521
166,2022/7/15 21:50,10,76,-66,-1394
166,2022/7/15 22:00,12,33,-21,-1174
166,2022/7/15 22:10,10,93,-83,-1499
166,2022/7/15 22:20,7,75,-68,-1699
166,2022/7/15 22:30,3,62,-59,-1814
166,2022/7/15 22:40,2,70,-68,-1824
166,2022/7/15 22:50,0,70,-70,-1691
181,2022/7/15 5:00,0,1,-1,-1
181,2022/7/15 5:10,0,1,-1,-1
181,2022/7/15 5:20,0,1,-1,-1
181,2022/7/15 5:30,1,1,0,0
181,2022/7/15 5:40,15,1,14,14
181,2022/7/15 5:50,21,12,9,9
181,2022/7/15 6:00,27,6,21,21
181,2022/7/15 6:10,26,17,9,9
181,2022/7/15 6:20,37,29,8,8
181,2022/7/15 6:30,47,38,9,9
181,2022/7/15 6:40,55,29,26,26
181,2022/7/15 6:50,59,51,8,8
181,2022/7/15 7:00,72,67,5,5
181,2022/7/15 7:10,103,72,31,31
181,2022/7/15 7:20,96,84,12,12
181,2022/7/15 7:30,123,95,28,28
181,2022/7/15 7:40,180,103,77,77
181,2022/7/15 7:50,234,101,133,133
181,2022/7/15 8:00,243,86,157,157
181,2022/7/15 8:10,254,110,144,144
181,2022/7/15 8:20,244,111,133,133
181,2022/7/15 8:30,214,146,68,68
181,2022/7/15 8:40,187,297,-110,-110
181,2022/7/15 8:50,151,180,-29,-29
181,2022/7/15 9:00,76,116,-40,-40
181,2022/7/15 9:10,57,110,-53,-53
181,2022/7/15 9:20,50,133,-83,-83
181,2022/7/15 9:30,41,123,-82,-82
181,2022/7/15 9:40,31,99,-68,-68
181,2022/7/15 9:50,28,112,-84,-84
181,2022/7/15 10:00,29,99,-70,-70
181,2022/7/15 10:10,39,73,-34,-34
181,2022/7/15 10:20,30,84,-54,-54
181,2022/7/15 10:30,30,73,-43,-43
181,2022/7/15 10:40,28,73,-45,-45
181,2022/7/15 10:50,28,69,-41,-41
181,2022/7/15 11:00,28,71,-43,-43
181,2022/7/15 11:10,29,66,-37,-37
181,2022/7/15 11:20,27,59,-32,-32
181,2022/7/15 11:30,27,73,-46,-46
181,2022/7/15 11:40,29,66,-37,-37
181,2022/7/15 11:50,27,72,-45,-45
181,2022/7/15 12:00,30,67,-37,-37
181,2022/7/15 12:10,32,55,-23,-23
181,2022/7/15 12:20,27,77,-50,-50
181,2022/7/15 12:30,28,58,-30,-30
181,2022/7/15 12:40,33,79,-46,-46
181,2022/7/15 12:50,30,73,-43,-43
181,2022/7/15 13:00,24,71,-47,-47
181,2022/7/15 13:10,29,78,-49,-49
181,2022/7/15 13:20,27,70,-43,-43
181,2022/7/15 13:30,30,93,-63,-63
181,2022/7/15 13:40,28,67,-39,-39
181,2022/7/15 13:50,28,77,-49,-49
181,2022/7/15 14:00,28,72,-44,-44
181,2022/7/15 14:10,31,70,-39,-39
181,2022/7/15 14:20,28,69,-41,-41
181,2022/7/15 14:30,23,67,-44,-44
181,2022/7/15 14:40,24,83,-59,-59
181,2022/7/15 14:50,26,67,-41,-41
181,2022/7/15 15:00,31,77,-46,-46
181,2022/7/15 15:10,29,72,-43,-43
181,2022/7/15 15:20,28,69,-41,-41
181,2022/7/15 15:30,32,88,-56,-56
181,2022/7/15 15:40,26,71,-45,-45
181,2022/7/15 15:50,30,81,-51,-51
181,2022/7/15 16:00,37,66,-29,-29
181,2022/7/15 16:10,45,77,-32,-32
181,2022/7/15 16:20,42,91,-49,-49
181,2022/7/15 16:30,46,85,-39,-39
181,2022/7/15 16:40,45,87,-42,-42
181,2022/7/15 16:50,42,105,-63,-63
181,2022/7/15 17:00,167,113,54,54
181,2022/7/15 17:10,186,105,81,81
181,2022/7/15 17:20,93,99,-6,-6
181,2022/7/15 17:30,96,123,-27,-27
181,2022/7/15 17:40,224,117,107,107
181,2022/7/15 17:50,156,109,47,47
181,2022/7/15 18:00,143,119,24,24
181,2022/7/15 18:10,223,111,112,112
181,2022/7/15 18:20,174,111,63,63
181,2022/7/15 18:30,102,124,-22,-22
181,2022/7/15 18:40,77,128,-51,-51
181,2022/7/15 18:50,49,111,-62,-62
181,2022/7/15 19:00,46,125,-79,-79
181,2022/7/15 19:10,50,107,-57,-57
181,2022/7/15 19:20,39,115,-76,-76
181,2022/7/15 19:30,32,95,-63,-63
181,2022/7/15 19:40,29,78,-49,-49
181,2022/7/15 19:50,28,77,-49,-49
181,2022/7/15 20:00,29,71,-42,-42
181,2022/7/15 20:10,25,87,-62,-62
181,2022/7/15 20:20,27,66,-39,-39
181,2022/7/15 20:30,27,74,-47,-47
181,2022/7/15 20:40,29,78,-49,-49
181,2022/7/15 20:50,29,77,-48,-48
181,2022/7/15 21:00,25,74,-49,-49
181,2022/7/15 21:10,27,78,-51,-51
181,2022/7/15 21:20,21,68,-47,-47
181,2022/7/15 21:30,22,83,-61,-61
181,2022/7/15 21:40,22,78,-56,-56
181,2022/7/15 21:50,23,70,-47,-47
181,2022/7/15 22:00,23,76,-53,-53
181,2022/7/15 22:10,19,67,-48,-48
181,2022/7/15 22:20,10,66,-56,-56
181,2022/7/15 22:30,11,67,-56,-56
181,2022/7/15 22:40,8,56,-48,-48
181,2022/7/15 22:50,5,62,-57,-57
183,2022/7/15 5:00,0,1,-1,-2
183,2022/7/15 5:10,0,1,-1,-2
183,2022/7/15 5:20,0,1,-1,-2
183,2022/7/15 5:30,5,1,4,4
183,2022/7/15 5:40,22,1,21,35
183,2022/7/15 5:50,44,8,36,45
183,2022/7/15 6:00,38,11,27,48
183,2022/7/15 6:10,51,23,28,37
183,2022/7/15 6:20,58,38,20,28
183,2022/7/15 6:30,84,45,39,48
183,2022/7/15 6:40,87,40,47,73
183,2022/7/15 6:50,226,82,144,152
183,2022/7/15 7:00,240,75,165,170
183,2022/7/15 7:10,281,110,171,202
183,2022/7/15 7:20,317,113,204,216
183,2022/7/15 7:30,567,106,461,489
183,2022/7/15 7:40,654,122,532,609
183,2022/7/15 7:50,685,133,552,685
183,2022/7/15 8:00,740,152,588,745
183,2022/7/15 8:10,741,267,474,618
183,2022/7/15 8:20,699,215,484,617
183,2022/7/15 8:30,631,231,400,468
183,2022/7/15 8:40,598,378,220,110
183,2022/7/15 8:50,349,321,28,-1
183,2022/7/15 9:00,275,192,83,43
183,2022/7/15 9:10,236,146,90,37
183,2022/7/15 9:20,215,111,104,21
183,2022/7/15 9:30,166,109,57,-25
183,2022/7/15 9:40,115,108,7,-61
183,2022/7/15 9:50,71,122,-51,-135
183,2022/7/15 10:00,62,93,-31,-101
183,2022/7/15 10:10,54,108,-54,-88
183,2022/7/15 10:20,53,81,-28,-82
183,2022/7/15 10:30,47,92,-45,-88
183,2022/7/15 10:40,44,84,-40,-85
183,2022/7/15 10:50,45,91,-46,-87
183,2022/7/15 11:00,45,99,-54,-97
183,2022/7/15 11:10,43,69,-26,-63
183,2022/7/15 11:20,44,110,-66,-98
183,2022/7/15 11:30,43,76,-33,-79
183,2022/7/15 11:40,41,102,-61,-98
183,2022/7/15 11:50,41,99,-58,-103
183,2022/7/15 12:00,46,88,-42,-79
183,2022/7/15 12:10,45,106,-61,-84
183,2022/7/15 12:20,48,75,-27,-77
183,2022/7/15 12:30,48,112,-64,-94
183,2022/7/15 12:40,49,93,-44,-90
183,2022/7/15 12:50,48,106,-58,-101
183,2022/7/15 13:00,54,105,-51,-98
183,2022/7/15 13:10,48,93,-45,-94
183,2022/7/15 13:20,44,108,-64,-107
183,2022/7/15 13:30,47,84,-37,-100
183,2022/7/15 13:40,43,97,-54,-93
183,2022/7/15 13:50,42,93,-51,-100
183,2022/7/15 14:00,45,104,-59,-103
183,2022/7/15 14:10,42,105,-63,-102
183,2022/7/15 14:20,44,93,-49,-90
183,2022/7/15 14:30,46,105,-59,-103
183,2022/7/15 14:40,44,87,-43,-102
183,2022/7/15 14:50,43,100,-57,-98
183,2022/7/15 15:00,46,100,-54,-100
183,2022/7/15 15:10,60,104,-44,-87
183,2022/7/15 15:20,59,107,-48,-89
183,2022/7/15 15:30,53,106,-53,-109
183,2022/7/15 15:40,57,118,-61,-106
183,2022/7/15 15:50,55,103,-48,-99
183,2022/7/15 16:00,76,121,-45,-74
183,2022/7/15 16:10,64,121,-57,-89
183,2022/7/15 16:20,67,118,-51,-100
183,2022/7/15 16:30,74,108,-34,-73
183,2022/7/15 16:40,133,107,26,-16
183,2022/7/15 16:50,160,154,6,-57
183,2022/7/15 17:00,207,115,92,146
183,2022/7/15 17:10,269,182,87,168
183,2022/7/15 17:20,216,221,-5,-11
183,2022/7/15 17:30,224,296,-72,-99
183,2022/7/15 17:40,375,317,58,165
183,2022/7/15 17:50,273,330,-57,-10
183,2022/7/15 18:00,214,378,-164,-140
183,2022/7/15 18:10,293,380,-87,25
183,2022/7/15 18:20,243,429,-186,-123
183,2022/7/15 18:30,177,381,-204,-226
183,2022/7/15 18:40,157,319,-162,-213
183,2022/7/15 18:50,138,319,-181,-243
183,2022/7/15 19:00,77,198,-121,-200
183,2022/7/15 19:10,55,223,-168,-225
183,2022/7/15 19:20,47,146,-99,-175
183,2022/7/15 19:30,42,119,-77,-140
183,2022/7/15 19:40,44,111,-67,-116
183,2022/7/15 19:50,39,126,-87,-136
183,2022/7/15 20:00,41,113,-72,-114
183,2022/7/15 20:10,43,113,-70,-132
183,2022/7/15 20:20,37,129,-92,-131
183,2022/7/15 20:30,41,104,-63,-110
183,2022/7/15 20:40,36,126,-90,-139
183,2022/7/15 20:50,38,110,-72,-120
183,2022/7/15 21:00,37,111,-74,-123
183,2022/7/15 21:10,42,109,-67,-118
183,2022/7/15 21:20,35,122,-87,-134
183,2022/7/15 21:30,33,106,-73,-134
183,2022/7/15 21:40,31,113,-82,-138
183,2022/7/15 21:50,31,115,-84,-131
183,2022/7/15 22:00,28,106,-78,-131
183,2022/7/15 22:10,24,110,-86,-134
183,2022/7/15 22:20,22,94,-72,-128
183,2022/7/15 22:30,13,108,-95,-151
183,2022/7/15 22:40,10,90,-80,-128
183,2022/7/15 22:50,4,67,-63,-120
178,2022/7/15 5:00,0,1,-1,-3
178,2022/7/15 5:10,0,1,-1,-3
178,2022/7/15 5:20,0,1,-1,-3
178,2022/7/15 5:30,10,1,9,13
178,2022/7/15 5:40,23,1,22,57
178,2022/7/15 5:50,42,5,37,82
178,2022/7/15 6:00,33,29,4,52
178,2022/7/15 6:10,53,25,28,65
178,2022/7/15 6:20,53,45,8,36
178,2022/7/15 6:30,65,64,1,49
178,2022/7/15 6:40,101,77,24,97
178,2022/7/15 6:50,176,102,74,226
178,2022/7/15 7:00,215,101,114,284
178,2022/7/15 7:10,244,118,126,328
178,2022/7/15 7:20,300,110,190,406
178,2022/7/15 7:30,347,192,155,644
178,2022/7/15 7:40,598,298,300,909
178,2022/7/15 7:50,596,327,269,954
178,2022/7/15 8:00,663,424,239,984
178,2022/7/15 8:10,664,470,194,812
178,2022/7/15 8:20,664,564,100,717
178,2022/7/15 8:30,474,1085,-611,-143
178,2022/7/15 8:40,367,1507,-1140,-1030
178,2022/7/15 8:50,361,1671,-1310,-1311
178,2022/7/15 9:00,273,1136,-863,-820
178,2022/7/15 9:10,220,571,-351,-314
178,2022/7/15 9:20,200,479,-279,-258
178,2022/7/15 9:30,179,498,-319,-344
178,2022/7/15 9:40,136,431,-295,-356
178,2022/7/15 9:50,108,254,-146,-281
178,2022/7/15 10:00,76,146,-70,-171
178,2022/7/15 10:10,75,124,-49,-137
178,2022/7/15 10:20,72,108,-36,-118
178,2022/7/15 10:30,63,116,-53,-141
178,2022/7/15 10:40,60,112,-52,-137
178,2022/7/15 10:50,52,124,-72,-159
178,2022/7/15 11:00,66,114,-48,-145
178,2022/7/15 11:10,66,99,-33,-96
178,2022/7/15 11:20,68,100,-32,-130
178,2022/7/15 11:30,71,105,-34,-113
178,2022/7/15 11:40,69,114,-45,-143
178,2022/7/15 11:50,76,102,-26,-129
178,2022/7/15 12:00,92,108,-16,-95
178,2022/7/15 12:10,86,121,-35,-119
178,2022/7/15 12:20,92,105,-13,-90
178,2022/7/15 12:30,74,119,-45,-139
178,2022/7/15 12:40,78,125,-47,-137
178,2022/7/15 12:50,71,115,-44,-145
178,2022/7/15 13:00,76,123,-47,-145
178,2022/7/15 13:10,77,116,-39,-133
178,2022/7/15 13:20,77,124,-47,-154
178,2022/7/15 13:30,86,103,-17,-117
178,2022/7/15 13:40,78,112,-34,-127
178,2022/7/15 13:50,76,106,-30,-130
178,2022/7/15 14:00,75,114,-39,-142
178,2022/7/15 14:10,89,123,-34,-136
178,2022/7/15 14:20,77,113,-36,-126
178,2022/7/15 14:30,75,122,-47,-150
178,2022/7/15 14:40,75,108,-33,-135
178,2022/7/15 14:50,73,124,-51,-149
178,2022/7/15 15:00,103,106,-3,-103
178,2022/7/15 15:10,128,125,3,-84
178,2022/7/15 15:20,126,120,6,-83
178,2022/7/15 15:30,113,124,-11,-120
178,2022/7/15 15:40,138,126,12,-94
178,2022/7/15 15:50,132,123,9,-90
178,2022/7/15 16:00,175,126,49,-25
178,2022/7/15 16:10,194,107,87,-2
178,2022/7/15 16:20,200,105,95,-5
178,2022/7/15 16:30,235,107,128,55
178,2022/7/15 16:40,221,109,112,96
178,2022/7/15 16:50,289,144,145,88
178,2022/7/15 17:00,674,137,537,683
178,2022/7/15 17:10,713,151,562,730
178,2022/7/15 17:20,637,216,421,410
178,2022/7/15 17:30,837,195,642,543
178,2022/7/15 17:40,1158,254,904,1069
178,2022/7/15 17:50,667,322,345,335
178,2022/7/15 18:00,668,336,332,192
178,2022/7/15 18:10,1158,336,822,847
178,2022/7/15 18:20,711,328,383,260
178,2022/7/15 18:30,577,335,242,16
178,2022/7/15 18:40,422,301,121,-92
178,2022/7/15 18:50,314,301,13,-230
178,2022/7/15 19:00,273,209,64,-136
178,2022/7/15 19:10,226,184,42,-183
178,2022/7/15 19:20,209,144,65,-110
178,2022/7/15 19:30,175,111,64,-76
178,2022/7/15 19:40,149,117,32,-84
178,2022/7/15 19:50,129,124,5,-131
178,2022/7/15 20:00,102,108,-6,-120
178,2022/7/15 20:10,129,102,27,-105
178,2022/7/15 20:20,73,112,-39,-170
178,2022/7/15 20:30,75,124,-49,-159
178,2022/7/15 20:40,74,102,-28,-167
178,2022/7/15 20:50,73,106,-33,-153
178,2022/7/15 21:00,69,124,-55,-178
178,2022/7/15 21:10,86,106,-20,-138
178,2022/7/15 21:20,63,107,-44,-178
178,2022/7/15 21:30,48,124,-76,-210
178,2022/7/15 21:40,47,112,-65,-203
178,2022/7/15 21:50,39,99,-60,-191
178,2022/7/15 22:00,40,107,-67,-198
178,2022/7/15 22:10,35,91,-56,-190
178,2022/7/15 22:20,31,92,-61,-189
178,2022/7/15 22:30,24,123,-99,-250
178,2022/7/15 22:40,15,103,-88,-216
178,2022/7/15 22:50,11,70,-59,-179
192,2022/7/15 5:00,0,1,-1,-4
192,2022/7/15 5:10,0,1,-1,-4
192,2022/7/15 5:20,0,1,-1,-4
192,2022/7/15 5:30,1,1,0,13
192,2022/7/15 5:40,36,1,35,92
192,2022/7/15 5:50,54,21,33,115
192,2022/7/15 6:00,47,19,28,80
192,2022/7/15 6:10,66,33,33,98
192,2022/7/15 6:20,87,64,23,59
192,2022/7/15 6:30,120,59,61,110
192,2022/7/15 6:40,186,76,110,207
192,2022/7/15 6:50,215,105,110,336
192,2022/7/15 7:00,268,115,153,437
192,2022/7/15 7:10,346,122,224,552
192,2022/7/15 7:20,383,133,250,656
192,2022/7/15 7:30,593,178,415,1059
192,2022/7/15 7:40,662,219,443,1352
192,2022/7/15 7:50,741,346,395,1349
192,2022/7/15 8:00,1043,419,624,1608
192,2022/7/15 8:10,859,478,381,1193
192,2022/7/15 8:20,862,577,285,1002
192,2022/7/15 8:30,678,422,256,113
192,2022/7/15 8:40,599,420,179,-851
192,2022/7/15 8:50,435,421,14,-1297
192,2022/7/15 9:00,347,364,-17,-837
192,2022/7/15 9:10,261,207,54,-260
192,2022/7/15 9:20,222,191,31,-227
192,2022/7/15 9:30,182,133,49,-295
192,2022/7/15 9:40,103,109,-6,-362
192,2022/7/15 9:50,104,118,-14,-295
192,2022/7/15 10:00,73,98,-25,-196
192,2022/7/15 10:10,63,87,-24,-161
192,2022/7/15 10:20,67,117,-50,-168
192,2022/7/15 10:30,62,92,-30,-171
192,2022/7/15 10:40,44,97,-53,-190
192,2022/7/15 10:50,47,104,-57,-216
192,2022/7/15 11:00,45,97,-52,-197
192,2022/7/15 11:10,43,105,-62,-158
192,2022/7/15 11:20,54,82,-28,-158
192,2022/7/15 11:30,54,103,-49,-162
192,2022/7/15 11:40,51,85,-34,-177
192,2022/7/15 11:50,62,88,-26,-155
192,2022/7/15 12:00,59,105,-46,-141
192,2022/7/15 12:10,70,77,-7,-126
192,2022/7/15 12:20,63,108,-45,-135
192,2022/7/15 12:30,64,93,-29,-168
192,2022/7/15 12:40,65,100,-35,-172
192,2022/7/15 12:50,48,91,-43,-188
192,2022/7/15 13:00,47,109,-62,-207
192,2022/7/15 13:10,50,97,-47,-180
192,2022/7/15 13:20,59,88,-29,-183
192,2022/7/15 13:30,45,102,-57,-174
192,2022/7/15 13:40,57,88,-31,-158
192,2022/7/15 13:50,41,123,-82,-212
192,2022/7/15 14:00,52,76,-24,-166
192,2022/7/15 14:10,47,106,-59,-195
192,2022/7/15 14:20,45,105,-60,-186
192,2022/7/15 14:30,47,90,-43,-193
192,2022/7/15 14:40,44,104,-60,-195
192,2022/7/15 14:50,52,87,-35,-184
192,2022/7/15 15:00,59,106,-47,-150
192,2022/7/15 15:10,64,94,-30,-114
192,2022/7/15 15:20,64,110,-46,-129
192,2022/7/15 15:30,64,118,-54,-174
192,2022/7/15 15:40,64,97,-33,-127
192,2022/7/15 15:50,83,121,-38,-128
192,2022/7/15 16:00,83,95,-12,-37
192,2022/7/15 16:10,175,124,51,49
192,2022/7/15 16:20,197,102,95,90
192,2022/7/15 16:30,198,108,90,145
192,2022/7/15 16:40,238,103,135,231
192,2022/7/15 16:50,237,121,116,204
192,2022/7/15 17:00,315,138,177,860
192,2022/7/15 17:10,352,138,214,944
192,2022/7/15 17:20,347,212,135,545
192,2022/7/15 17:30,577,233,344,887
192,2022/7/15 17:40,1032,197,835,1904
192,2022/7/15 17:50,621,326,295,630
192,2022/7/15 18:00,335,327,8,200
192,2022/7/15 18:10,462,347,115,962
192,2022/7/15 18:20,271,348,-77,183
192,2022/7/15 18:30,224,348,-124,-108
192,2022/7/15 18:40,181,326,-145,-237
192,2022/7/15 18:50,144,322,-178,-408
192,2022/7/15 19:00,74,234,-160,-296
192,2022/7/15 19:10,67,199,-132,-315
192,2022/7/15 19:20,59,137,-78,-188
192,2022/7/15 19:30,46,116,-70,-146
192,2022/7/15 19:40,45,110,-65,-149
192,2022/7/15 19:50,40,110,-70,-201
192,2022/7/15 20:00,40,123,-83,-203
192,2022/7/15 20:10,33,113,-80,-185
192,2022/7/15 20:20,34,115,-81,-251
192,2022/7/15 20:30,37,121,-84,-243
192,2022/7/15 20:40,32,111,-79,-246
192,2022/7/15 20:50,26,108,-82,-235
192,2022/7/15 21:00,27,118,-91,-269
192,2022/7/15 21:10,29,103,-74,-212
192,2022/7/15 21:20,25,125,-100,-278
192,2022/7/15 21:30,24,122,-98,-308
192,2022/7/15 21:40,25,108,-83,-286
192,2022/7/15 21:50,21,102,-81,-272
192,2022/7/15 22:00,20,120,-100,-298
192,2022/7/15 22:10,17,103,-86,-276
192,2022/7/15 22:20,15,85,-70,-259
192,2022/7/15 22:30,9,122,-113,-363
192,2022/7/15 22:40,6,102,-96,-312
192,2022/7/15 22:50,3,77,-74,-253
187,2022/7/15 5:00,0,1,-1,-5
187,2022/7/15 5:10,0,1,-1,-5
187,2022/7/15 5:20,0,1,-1,-5
187,2022/7/15 5:30,7,1,6,19
187,2022/7/15 5:40,23,1,22,114
187,2022/7/15 5:50,32,16,16,131
187,2022/7/15 6:00,31,38,-7,73
187,2022/7/15 6:10,35,38,-3,95
187,2022/7/15 6:20,45,59,-14,45
187,2022/7/15 6:30,54,70,-16,94
187,2022/7/15 6:40,76,126,-50,157
187,2022/7/15 6:50,108,110,-2,334
187,2022/7/15 7:00,182,143,39,476
187,2022/7/15 7:10,191,144,47,599
187,2022/7/15 7:20,226,158,68,724
187,2022/7/15 7:30,280,196,84,1143
187,2022/7/15 7:40,324,324,0,1352
187,2022/7/15 7:50,475,426,49,1398
187,2022/7/15 8:00,630,1038,-408,1200
187,2022/7/15 8:10,598,1429,-831,362
187,2022/7/15 8:20,600,1570,-970,32
187,2022/7/15 8:30,475,1569,-1094,-981
187,2022/7/15 8:40,315,1408,-1093,-1944
187,2022/7/15 8:50,318,1912,-1594,-2891
187,2022/7/15 9:00,292,1558,-1266,-2103
187,2022/7/15 9:10,240,617,-377,-637
187,2022/7/15 9:20,210,394,-184,-411
187,2022/7/15 9:30,144,333,-189,-484
187,2022/7/15 9:40,148,252,-104,-466
187,2022/7/15 9:50,106,190,-84,-379
187,2022/7/15 10:00,66,99,-33,-229
187,2022/7/15 10:10,64,110,-46,-207
187,2022/7/15 10:20,67,109,-42,-210
187,2022/7/15 10:30,58,100,-42,-213
187,2022/7/15 10:40,55,105,-50,-240
187,2022/7/15 10:50,58,112,-54,-270
187,2022/7/15 11:00,51,105,-54,-251
187,2022/7/15 11:10,64,105,-41,-199
187,2022/7/15 11:20,60,98,-38,-196
187,2022/7/15 11:30,62,108,-46,-208
187,2022/7/15 11:40,65,103,-38,-215
187,2022/7/15 11:50,68,106,-38,-193
187,2022/7/15 12:00,62,111,-49,-190
187,2022/7/15 12:10,74,105,-31,-157
187,2022/7/15 12:20,77,106,-29,-164
187,2022/7/15 12:30,72,108,-36,-204
187,2022/7/15 12:40,65,105,-40,-212
187,2022/7/15 12:50,72,120,-48,-236
187,2022/7/15 13:00,68,104,-36,-243
187,2022/7/15 13:10,68,97,-29,-209
187,2022/7/15 13:20,65,126,-61,-244
187,2022/7/15 13:30,64,105,-41,-215
187,2022/7/15 13:40,70,104,-34,-192
187,2022/7/15 13:50,62,106,-44,-256
187,2022/7/15 14:00,66,108,-42,-208
187,2022/7/15 14:10,62,118,-56,-251
187,2022/7/15 14:20,65,108,-43,-229
187,2022/7/15 14:30,58,109,-51,-244
187,2022/7/15 14:40,65,108,-43,-238
187,2022/7/15 14:50,72,103,-31,-215
187,2022/7/15 15:00,74,105,-31,-181
187,2022/7/15 15:10,113,113,0,-114
187,2022/7/15 15:20,94,109,-15,-144
187,2022/7/15 15:30,99,108,-9,-183
187,2022/7/15 15:40,79,124,-45,-172
187,2022/7/15 15:50,85,105,-20,-148
187,2022/7/15 16:00,111,101,10,-27
187,2022/7/15 16:10,133,108,25,74
187,2022/7/15 16:20,170,103,67,157
187,2022/7/15 16:30,206,111,95,240
187,2022/7/15 16:40,238,106,132,363
187,2022/7/15 16:50,262,113,149,353
187,2022/7/15 17:00,423,115,308,1168
187,2022/7/15 17:10,804,124,680,1624
187,2022/7/15 17:20,788,152,636,1181
187,2022/7/15 17:30,842,178,664,1551
187,2022/7/15 17:40,1353,190,1163,3067
187,2022/7/15 17:50,1156,207,949,1579
187,2022/7/15 18:00,813,255,558,758
187,2022/7/15 18:10,1198,226,972,1934
187,2022/7/15 18:20,837,285,552,735
187,2022/7/15 18:30,639,257,382,274
187,2022/7/15 18:40,568,218,350,113
187,2022/7/15 18:50,311,208,103,-305
187,2022/7/15 19:00,269,224,45,-251
187,2022/7/15 19:10,265,127,138,-177
187,2022/7/15 19:20,208,116,92,-96
187,2022/7/15 19:30,162,111,51,-95
187,2022/7/15 19:40,177,126,51,-98
187,2022/7/15 19:50,133,100,33,-168
187,2022/7/15 20:00,109,78,31,-172
187,2022/7/15 20:10,109,106,3,-182
187,2022/7/15 20:20,80,103,-23,-274
187,2022/7/15 20:30,80,82,-2,-245
187,2022/7/15 20:40,84,123,-39,-285
187,2022/7/15 20:50,77,110,-33,-268
187,2022/7/15 21:00,71,102,-31,-300
187,2022/7/15 21:10,74,104,-30,-242
187,2022/7/15 21:20,56,107,-51,-329
187,2022/7/15 21:30,53,101,-48,-356
187,2022/7/15 21:40,43,123,-80,-366
187,2022/7/15 21:50,39,102,-63,-335
187,2022/7/15 22:00,39,93,-54,-352
187,2022/7/15 22:10,25,113,-88,-364
187,2022/7/15 22:20,26,102,-76,-335
187,2022/7/15 22:30,25,79,-54,-417
187,2022/7/15 22:40,19,78,-59,-371
187,2022/7/15 22:50,8,66,-58,-311
190,2022/7/15 5:00,5,1,4,-1
190,2022/7/15 5:10,11,1,10,5
190,2022/7/15 5:20,20,1,19,14
190,2022/7/15 5:30,24,2,22,41
190,2022/7/15 5:40,30,11,19,133
190,2022/7/15 5:50,36,16,20,151
190,2022/7/15 6:00,45,48,-3,70
190,2022/7/15 6:10,53,74,-21,74
190,2022/7/15 6:20,66,98,-32,13
190,2022/7/15 6:30,112,107,5,99
190,2022/7/15 6:40,184,110,74,231
190,2022/7/15 6:50,231,197,34,368
190,2022/7/15 7:00,281,342,-61,415
190,2022/7/15 7:10,319,378,-59,540
190,2022/7/15 7:20,566,436,130,854
190,2022/7/15 7:30,686,557,129,1272
190,2022/7/15 7:40,1059,1590,-531,821
190,2022/7/15 7:50,1366,1821,-455,943
190,2022/7/15 8:00,1577,2818,-1241,-41
190,2022/7/15 8:10,1979,4730,-2751,-2389
190,2022/7/15 8:20,1577,3610,-2033,-2001
190,2022/7/15 8:30,1572,6277,-4705,-5686
190,2022/7/15 8:40,1213,6301,-5088,-7032
190,2022/7/15 8:50,865,3497,-2632,-5523
190,2022/7/15 9:00,726,2594,-1868,-3971
190,2022/7/15 9:10,673,1504,-831,-1468
190,2022/7/15 9:20,582,554,28,-383
190,2022/7/15 9:30,467,428,39,-445
190,2022/7/15 9:40,330,374,-44,-510
190,2022/7/15 9:50,320,322,-2,-381
190,2022/7/15 10:00,269,268,1,-228
190,2022/7/15 10:10,253,227,26,-181
190,2022/7/15 10:20,240,181,59,-151
190,2022/7/15 10:30,240,179,61,-152
190,2022/7/15 10:40,216,192,24,-216
190,2022/7/15 10:50,212,147,65,-205
190,2022/7/15 11:00,216,192,24,-227
190,2022/7/15 11:10,225,150,75,-124
190,2022/7/15 11:20,224,192,32,-164
190,2022/7/15 11:30,223,192,31,-177
190,2022/7/15 11:40,238,214,24,-191
190,2022/7/15 11:50,232,192,40,-153
190,2022/7/15 12:00,227,154,73,-117
190,2022/7/15 12:10,242,192,50,-107
190,2022/7/15 12:20,222,180,42,-122
190,2022/7/15 12:30,260,178,82,-122
190,2022/7/15 12:40,257,214,43,-169
190,2022/7/15 12:50,269,179,90,-146
190,2022/7/15 13:00,271,198,73,-170
190,2022/7/15 13:10,272,213,59,-150
190,2022/7/15 13:20,269,233,36,-208
190,2022/7/15 13:30,274,180,94,-121
190,2022/7/15 13:40,272,219,53,-139
190,2022/7/15 13:50,275,180,95,-161
190,2022/7/15 14:00,270,198,72,-136
190,2022/7/15 14:10,272,226,46,-205
190,2022/7/15 14:20,267,180,87,-142
190,2022/7/15 14:30,267,213,54,-190
190,2022/7/15 14:40,271,214,57,-181
190,2022/7/15 14:50,274,197,77,-138
190,2022/7/15 15:00,267,198,69,-112
190,2022/7/15 15:10,330,180,150,36
190,2022/7/15 15:20,331,208,123,-21
190,2022/7/15 15:30,343,179,164,-19
190,2022/7/15 15:40,428,198,230,58
190,2022/7/15 15:50,335,214,121,-27
190,2022/7/15 16:00,309,232,77,50
190,2022/7/15 16:10,350,180,170,244
190,2022/7/15 16:20,351,231,120,277
190,2022/7/15 16:30,554,218,336,576
190,2022/7/15 16:40,648,196,452,815
190,2022/7/15 16:50,661,300,361,714
190,2022/7/15 17:00,1147,330,817,1985
190,2022/7/15 17:10,1977,376,1601,3225
190,2022/7/15 17:20,1341,415,926,2107
190,2022/7/15 17:30,1583,423,1160,2711
190,2022/7/15 17:40,3341,484,2857,5924
190,2022/7/15 17:50,2528,622,1906,3485
190,2022/7/15 18:00,1979,1126,853,1611
190,2022/7/15 18:10,3311,1138,2173,4107
190,2022/7/15 18:20,2513,1130,1383,2118
190,2022/7/15 18:30,1560,1134,426,700
190,2022/7/15 18:40,1190,1140,50,163
190,2022/7/15 18:50,822,568,254,-51
190,2022/7/15 19:00,702,430,272,21
190,2022/7/15 19:10,637,501,136,-41
190,2022/7/15 19:20,575,320,255,159
190,2022/7/15 19:30,462,321,141,46
190,2022/7/15 19:40,369,256,113,15
190,2022/7/15 19:50,376,207,169,1
190,2022/7/15 20:00,358,184,174,2
190,2022/7/15 20:10,320,159,161,-21
190,2022/7/15 20:20,354,154,200,-74
190,2022/7/15 20:30,350,152,198,-47
190,2022/7/15 20:40,427,150,277,-8
190,2022/7/15 20:50,554,153,401,133
190,2022/7/15 21:00,558,117,441,141
190,2022/7/15 21:10,579,153,426,184
190,2022/7/15 21:20,434,141,293,-36
190,2022/7/15 21:30,357,184,173,-183
190,2022/7/15 21:40,265,169,96,-270
190,2022/7/15 21:50,223,126,97,-238
190,2022/7/15 22:00,200,119,81,-271
190,2022/7/15 22:10,130,123,7,-357
190,2022/7/15 22:20,62,113,-51,-386
190,2022/7/15 22:30,43,112,-69,-486
190,2022/7/15 22:40,26,99,-73,-444
190,2022/7/15 22:50,26,100,-74,-385
186,2022/7/15 5:00,0,1,-1,-2
186,2022/7/15 5:10,0,1,-1,4
186,2022/7/15 5:20,0,1,-1,13
186,2022/7/15 5:30,2,1,1,42
186,2022/7/15 5:40,7,1,6,139
186,2022/7/15 5:50,9,14,-5,146
186,2022/7/15 6:00,8,33,-25,45
186,2022/7/15 6:10,11,46,-35,39
186,2022/7/15 6:20,15,47,-32,-19
186,2022/7/15 6:30,18,71,-53,46
186,2022/7/15 6:40,20,73,-53,178
186,2022/7/15 6:50,24,70,-46,322
186,2022/7/15 7:00,26,107,-81,334
186,2022/7/15 7:10,29,122,-93,447
186,2022/7/15 7:20,32,158,-126,728
186,2022/7/15 7:30,47,297,-250,1022
186,2022/7/15 7:40,56,415,-359,462
186,2022/7/15 7:50,59,1635,-1576,-633
186,2022/7/15 8:00,83,2125,-2042,-2083
186,2022/7/15 8:10,91,4412,-4321,-6710
186,2022/7/15 8:20,77,4257,-4180,-6181
186,2022/7/15 8:30,75,5743,-5668,-11354
186,2022/7/15 8:40,69,3843,-3774,-10806
186,2022/7/15 8:50,66,4893,-4827,-10350
186,2022/7/15 9:00,44,4317,-4273,-8244
186,2022/7/15 9:10,56,3276,-3220,-4688
186,2022/7/15 9:20,64,1447,-1383,-1766
186,2022/7/15 9:30,51,632,-581,-1026
186,2022/7/15 9:40,47,518,-471,-981
186,2022/7/15 9:50,51,373,-322,-703
186,2022/7/15 10:00,48,299,-251,-479
186,2022/7/15 10:10,60,109,-49,-230
186,2022/7/15 10:20,54,198,-144,-295
186,2022/7/15 10:30,59,109,-50,-202
186,2022/7/15 10:40,59,142,-83,-299
186,2022/7/15 10:50,71,122,-51,-256
186,2022/7/15 11:00,75,105,-30,-257
186,2022/7/15 11:10,67,128,-61,-185
186,2022/7/15 11:20,69,93,-24,-188
186,2022/7/15 11:30,86,120,-34,-211
186,2022/7/15 11:40,107,111,-4,-195
186,2022/7/15 11:50,76,107,-31,-184
186,2022/7/15 12:00,82,112,-30,-147
186,2022/7/15 12:10,89,99,-10,-117
186,2022/7/15 12:20,69,125,-56,-178
186,2022/7/15 12:30,69,109,-40,-162
186,2022/7/15 12:40,67,170,-103,-272
186,2022/7/15 12:50,70,107,-37,-183
186,2022/7/15 13:00,75,135,-60,-230
186,2022/7/15 13:10,84,121,-37,-187
186,2022/7/15 13:20,88,104,-16,-224
186,2022/7/15 13:30,97,180,-83,-204
186,2022/7/15 13:40,91,121,-30,-169
186,2022/7/15 13:50,85,146,-61,-222
186,2022/7/15 14:00,88,106,-18,-154
186,2022/7/15 14:10,132,105,27,-178
186,2022/7/15 14:20,92,99,-7,-149
186,2022/7/15 14:30,110,106,4,-186
186,2022/7/15 14:40,129,120,9,-172
186,2022/7/15 14:50,133,106,27,-111
186,2022/7/15 15:00,155,121,34,-78
186,2022/7/15 15:10,194,101,93,129
186,2022/7/15 15:20,179,121,58,37
186,2022/7/15 15:30,173,107,66,47
186,2022/7/15 15:40,144,105,39,97
186,2022/7/15 15:50,179,112,67,40
186,2022/7/15 16:00,207,95,112,162
186,2022/7/15 16:10,216,118,98,342
186,2022/7/15 16:20,225,97,128,405
186,2022/7/15 16:30,270,93,177,753
186,2022/7/15 16:40,345,105,240,1055
186,2022/7/15 16:50,338,101,237,951
186,2022/7/15 17:00,1021,112,909,2894
186,2022/7/15 17:10,1605,105,1500,4725
186,2022/7/15 17:20,1198,109,1089,3196
186,2022/7/15 17:30,1606,120,1486,4197
186,2022/7/15 17:40,2550,127,2423,8347
186,2022/7/15 17:50,1974,107,1867,5352
186,2022/7/15 18:00,2004,123,1881,3492
186,2022/7/15 18:10,3328,122,3206,7313
186,2022/7/15 18:20,2472,124,2348,4466
186,2022/7/15 18:30,1560,110,1450,2150
186,2022/7/15 18:40,1146,105,1041,1204
186,2022/7/15 18:50,799,109,690,639
186,2022/7/15 19:00,686,104,582,603
186,2022/7/15 19:10,569,80,489,448
186,2022/7/15 19:20,326,78,248,407
186,2022/7/15 19:30,277,73,204,250
186,2022/7/15 19:40,235,74,161,176
186,2022/7/15 19:50,197,62,135,136
186,2022/7/15 20:00,205,67,138,140
186,2022/7/15 20:10,193,53,140,119
186,2022/7/15 20:20,175,51,124,50
186,2022/7/15 20:30,174,62,112,65
186,2022/7/15 20:40,149,42,107,99
186,2022/7/15 20:50,102,46,56,189
186,2022/7/15 21:00,96,60,36,177
186,2022/7/15 21:10,175,47,128,312
186,2022/7/15 21:20,116,39,77,41
186,2022/7/15 21:30,65,63,2,-181
186,2022/7/15 21:40,50,39,11,-259
186,2022/7/15 21:50,37,40,-3,-241
186,2022/7/15 22:00,35,59,-24,-295
186,2022/7/15 22:10,36,37,-1,-358
186,2022/7/15 22:20,28,34,-6,-392
186,2022/7/15 22:30,18,35,-17,-503
186,2022/7/15 22:40,17,35,-18,-462
186,2022/7/15 22:50,3,23,-20,-405
182,2022/7/15 5:00,0,1,-1,-3
182,2022/7/15 5:10,0,1,-1,3
182,2022/7/15 5:20,0,1,-1,12
182,2022/7/15 5:30,7,1,6,48
182,2022/7/15 5:40,11,1,10,149
182,2022/7/15 5:50,20,16,4,150
182,2022/7/15 6:00,24,11,13,58
182,2022/7/15 6:10,31,38,-7,32
182,2022/7/15 6:20,31,32,-1,-20
182,2022/7/15 6:30,54,38,16,62
182,2022/7/15 6:40,87,58,29,207
182,2022/7/15 6:50,89,75,14,336
182,2022/7/15 7:00,105,87,18,352
182,2022/7/15 7:10,196,111,85,532
182,2022/7/15 7:20,222,110,112,840
182,2022/7/15 7:30,281,155,126,1148
182,2022/7/15 7:40,327,112,215,677
182,2022/7/15 7:50,573,179,394,-239
182,2022/7/15 8:00,589,214,375,-1708
182,2022/7/15 8:10,629,504,125,-6585
182,2022/7/15 8:20,594,430,164,-6017
182,2022/7/15 8:30,356,1143,-787,-12141
182,2022/7/15 8:40,325,1143,-818,-11624
182,2022/7/15 8:50,283,596,-313,-10663
182,2022/7/15 9:00,239,425,-186,-8430
182,2022/7/15 9:10,177,490,-313,-5001
182,2022/7/15 9:20,155,330,-175,-1941
182,2022/7/15 9:30,85,221,-136,-1162
182,2022/7/15 9:40,66,169,-103,-1084
182,2022/7/15 9:50,68,131,-63,-766
182,2022/7/15 10:00,46,103,-57,-536
182,2022/7/15 10:10,47,103,-56,-286
182,2022/7/15 10:20,46,97,-51,-346
182,2022/7/15 10:30,38,104,-66,-268
182,2022/7/15 10:40,42,92,-50,-349
182,2022/7/15 10:50,36,93,-57,-313
182,2022/7/15 11:00,41,76,-35,-292
182,2022/7/15 11:10,42,93,-51,-236
182,2022/7/15 11:20,44,83,-39,-227
182,2022/7/15 11:30,38,96,-58,-269
182,2022/7/15 11:40,41,96,-55,-250
182,2022/7/15 11:50,42,87,-45,-229
182,2022/7/15 12:00,43,92,-49,-196
182,2022/7/15 12:10,43,87,-44,-161
182,2022/7/15 12:20,43,93,-50,-228
182,2022/7/15 12:30,46,99,-53,-215
182,2022/7/15 12:40,47,110,-63,-335
182,2022/7/15 12:50,44,106,-62,-245
182,2022/7/15 13:00,46,93,-47,-277
182,2022/7/15 13:10,49,106,-57,-244
182,2022/7/15 13:20,46,106,-60,-284
182,2022/7/15 13:30,41,101,-60,-264
182,2022/7/15 13:40,40,102,-62,-231
182,2022/7/15 13:50,46,101,-55,-277
182,2022/7/15 14:00,46,109,-63,-217
182,2022/7/15 14:10,56,101,-45,-223
182,2022/7/15 14:20,44,100,-56,-205
182,2022/7/15 14:30,45,93,-48,-234
182,2022/7/15 14:40,43,96,-53,-225
182,2022/7/15 14:50,47,108,-61,-172
182,2022/7/15 15:00,46,93,-47,-125
182,2022/7/15 15:10,48,111,-63,66
182,2022/7/15 15:20,55,97,-42,-5
182,2022/7/15 15:30,55,112,-57,-10
182,2022/7/15 15:40,55,102,-47,50
182,2022/7/15 15:50,54,109,-55,-15
182,2022/7/15 16:00,68,106,-38,124
182,2022/7/15 16:10,91,97,-6,336
182,2022/7/15 16:20,76,110,-34,371
182,2022/7/15 16:30,86,85,1,754
182,2022/7/15 16:40,132,103,29,1084
182,2022/7/15 16:50,109,122,-13,938
182,2022/7/15 17:00,237,118,119,3013
182,2022/7/15 17:10,319,115,204,4929
182,2022/7/15 17:20,257,125,132,3328
182,2022/7/15 17:30,291,181,110,4307
182,2022/7/15 17:40,682,190,492,8839
182,2022/7/15 17:50,576,177,399,5751
182,2022/7/15 18:00,426,227,199,3691
182,2022/7/15 18:10,655,213,442,7755
182,2022/7/15 18:20,668,213,455,4921
182,2022/7/15 18:30,551,180,371,2521
182,2022/7/15 18:40,350,215,135,1339
182,2022/7/15 18:50,275,146,129,768
182,2022/7/15 19:00,214,111,103,706
182,2022/7/15 19:10,176,123,53,501
182,2022/7/15 19:20,103,119,-16,391
182,2022/7/15 19:30,69,102,-33,217
182,2022/7/15 19:40,66,106,-40,136
182,2022/7/15 19:50,55,106,-51,85
182,2022/7/15 20:00,46,92,-46,94
182,2022/7/15 20:10,54,95,-41,78
182,2022/7/15 20:20,42,82,-40,10
182,2022/7/15 20:30,45,86,-41,24
182,2022/7/15 20:40,47,95,-48,51
182,2022/7/15 20:50,44,99,-55,134
182,2022/7/15 21:00,43,71,-28,149
182,2022/7/15 21:10,48,95,-47,265
182,2022/7/15 21:20,38,96,-58,-17
182,2022/7/15 21:30,34,75,-41,-222
182,2022/7/15 21:40,31,93,-62,-321
182,2022/7/15 21:50,30,83,-53,-294
182,2022/7/15 22:00,25,79,-54,-349
182,2022/7/15 22:10,27,78,-51,-409
182,2022/7/15 22:20,17,73,-56,-448
182,2022/7/15 22:30,16,65,-49,-552
182,2022/7/15 22:40,12,52,-40,-502
182,2022/7/15 22:50,4,54,-50,-455
191,2022/7/15 5:00,0,1,-1,-4
191,2022/7/15 5:10,0,1,-1,2
191,2022/7/15 5:20,3,1,2,14
191,2022/7/15 5:30,13,1,12,60
191,2022/7/15 5:40,16,16,0,149
191,2022/7/15 5:50,22,2,20,170
191,2022/7/15 6:00,32,8,24,82
191,2022/7/15 6:10,36,60,-24,8
191,2022/7/15 6:20,48,41,7,-13
191,2022/7/15 6:30,65,76,-11,51
191,2022/7/15 6:40,85,85,0,207
191,2022/7/15 6:50,153,121,32,368
191,2022/7/15 7:00,156,133,23,375
191,2022/7/15 7:10,207,192,15,547
191,2022/7/15 7:20,250,209,41,881
191,2022/7/15 7:30,302,234,68,1216
191,2022/7/15 7:40,599,298,301,978
191,2022/7/15 7:50,596,300,296,57
191,2022/7/15 8:00,703,318,385,-1323
191,2022/7/15 8:10,736,492,244,-6341
191,2022/7/15 8:20,690,425,265,-5752
191,2022/7/15 8:30,721,426,295,-11846
191,2022/7/15 8:40,573,582,-9,-11633
191,2022/7/15 8:50,324,482,-158,-10821
191,2022/7/15 9:00,312,413,-101,-8531
191,2022/7/15 9:10,275,313,-38,-5039
191,2022/7/15 9:20,227,316,-89,-2030
191,2022/7/15 9:30,209,231,-22,-1184
191,2022/7/15 9:40,173,190,-17,-1101
191,2022/7/15 9:50,141,179,-38,-804
191,2022/7/15 10:00,131,109,22,-514
191,2022/7/15 10:10,108,121,-13,-299
191,2022/7/15 10:20,89,124,-35,-381
191,2022/7/15 10:30,91,120,-29,-297
191,2022/7/15 10:40,80,121,-41,-390
191,2022/7/15 10:50,76,120,-44,-357
191,2022/7/15 11:00,83,86,-3,-295
191,2022/7/15 11:10,76,108,-32,-268
191,2022/7/15 11:20,81,103,-22,-249
191,2022/7/15 11:30,74,111,-37,-306
191,2022/7/15 11:40,71,121,-50,-300
191,2022/7/15 11:50,76,101,-25,-254
191,2022/7/15 12:00,85,114,-29,-225
191,2022/7/15 12:10,134,113,21,-140
191,2022/7/15 12:20,114,114,0,-228
191,2022/7/15 12:30,101,117,-16,-231
191,2022/7/15 12:40,103,103,0,-335
191,2022/7/15 12:50,103,112,-9,-254
191,2022/7/15 13:00,88,126,-38,-315
191,2022/7/15 13:10,110,86,24,-220
191,2022/7/15 13:20,101,111,-10,-294
191,2022/7/15 13:30,84,102,-18,-282
191,2022/7/15 13:40,88,181,-93,-324
191,2022/7/15 13:50,88,114,-26,-303
191,2022/7/15 14:00,123,128,-5,-222
191,2022/7/15 14:10,134,104,30,-193
191,2022/7/15 14:20,116,105,11,-194
191,2022/7/15 14:30,96,105,-9,-243
191,2022/7/15 14:40,102,98,4,-221
191,2022/7/15 14:50,128,128,0,-172
191,2022/7/15 15:00,132,105,27,-98
191,2022/7/15 15:10,143,128,15,81
191,2022/7/15 15:20,136,120,16,11
191,2022/7/15 15:30,154,121,33,23
191,2022/7/15 15:40,156,125,31,81
191,2022/7/15 15:50,133,125,8,-7
191,2022/7/15 16:00,177,144,33,157
191,2022/7/15 16:10,210,107,103,439
191,2022/7/15 16:20,205,121,84,455
191,2022/7/15 16:30,269,108,161,915
191,2022/7/15 16:40,269,111,158,1242
191,2022/7/15 16:50,262,153,109,1047
191,2022/7/15 17:00,326,108,218,3231
191,2022/7/15 17:10,459,210,249,5178
191,2022/7/15 17:20,347,280,67,3395
191,2022/7/15 17:30,336,296,40,4347
191,2022/7/15 17:40,571,337,234,9073
191,2022/7/15 17:50,348,378,-30,5721
191,2022/7/15 18:00,334,322,12,3703
191,2022/7/15 18:10,609,494,115,7870
191,2022/7/15 18:20,335,377,-42,4879
191,2022/7/15 18:30,266,507,-241,2280
191,2022/7/15 18:40,223,434,-211,1128
191,2022/7/15 18:50,176,325,-149,619
191,2022/7/15 19:00,156,301,-145,561
191,2022/7/15 19:10,161,209,-48,453
191,2022/7/15 19:20,77,192,-115,276
191,2022/7/15 19:30,74,151,-77,140
191,2022/7/15 19:40,70,110,-40,96
191,2022/7/15 19:50,61,127,-66,19
191,2022/7/15 20:00,60,125,-65,29
191,2022/7/15 20:10,66,115,-49,29
191,2022/7/15 20:20,61,105,-44,-34
191,2022/7/15 20:30,62,110,-48,-24
191,2022/7/15 20:40,57,122,-65,-14
191,2022/7/15 20:50,56,106,-50,84
191,2022/7/15 21:00,68,107,-39,110
191,2022/7/15 21:10,62,103,-41,224
191,2022/7/15 21:20,45,111,-66,-83
191,2022/7/15 21:30,42,111,-69,-291
191,2022/7/15 21:40,38,124,-86,-407
191,2022/7/15 21:50,31,110,-79,-373
191,2022/7/15 22:00,37,100,-63,-412
191,2022/7/15 22:10,44,107,-63,-472
191,2022/7/15 22:20,22,105,-83,-531
191,2022/7/15 22:30,16,92,-76,-628
191,2022/7/15 22:40,8,59,-51,-553
191,2022/7/15 22:50,6,55,-49,-504
185,2022/7/15 5:00,0,1,-1,-5
185,2022/7/15 5:10,0,1,-1,1
185,2022/7/15 5:20,2,1,1,15
185,2022/7/15 5:30,7,1,6,66
185,2022/7/15 5:40,8,1,7,156
185,2022/7/15 5:50,13,1,12,182
185,2022/7/15 6:00,22,21,1,83
185,2022/7/15 6:10,25,40,-15,-7
185,2022/7/15 6:20,32,45,-13,-26
185,2022/7/15 6:30,39,69,-30,21
185,2022/7/15 6:40,46,83,-37,170
185,2022/7/15 6:50,57,90,-33,335
185,2022/7/15 7:00,51,90,-39,336
185,2022/7/15 7:10,72,93,-21,526
185,2022/7/15 7:20,79,105,-26,855
185,2022/7/15 7:30,98,119,-21,1195
185,2022/7/15 7:40,183,111,72,1050
185,2022/7/15 7:50,232,139,93,150
185,2022/7/15 8:00,234,267,-33,-1356
185,2022/7/15 8:10,243,334,-91,-6432
185,2022/7/15 8:20,244,381,-137,-5889
185,2022/7/15 8:30,206,433,-227,-12073
185,2022/7/15 8:40,155,432,-277,-11910
185,2022/7/15 8:50,92,379,-287,-11108
185,2022/7/15 9:00,70,255,-185,-8716
185,2022/7/15 9:10,70,207,-137,-5176
185,2022/7/15 9:20,58,154,-96,-2126
185,2022/7/15 9:30,46,119,-73,-1257
185,2022/7/15 9:40,41,108,-67,-1168
185,2022/7/15 9:50,38,104,-66,-870
185,2022/7/15 10:00,38,111,-73,-587
185,2022/7/15 10:10,33,98,-65,-364
185,2022/7/15 10:20,35,97,-62,-443
185,2022/7/15 10:30,37,92,-55,-352
185,2022/7/15 10:40,32,97,-65,-455
185,2022/7/15 10:50,35,90,-55,-412
185,2022/7/15 11:00,38,76,-38,-333
185,2022/7/15 11:10,34,92,-58,-326
185,2022/7/15 11:20,37,68,-31,-280
185,2022/7/15 11:30,37,87,-50,-356
185,2022/7/15 11:40,36,70,-34,-334
185,2022/7/15 11:50,38,76,-38,-292
185,2022/7/15 12:00,38,76,-38,-263
185,2022/7/15 12:10,38,68,-30,-170
185,2022/7/15 12:20,37,110,-73,-301
185,2022/7/15 12:30,38,72,-34,-265
185,2022/7/15 12:40,37,105,-68,-403
185,2022/7/15 12:50,37,74,-37,-291
185,2022/7/15 13:00,38,93,-55,-370
185,2022/7/15 13:10,41,103,-62,-282
185,2022/7/15 13:20,36,74,-38,-332
185,2022/7/15 13:30,37,96,-59,-341
185,2022/7/15 13:40,44,84,-40,-364
185,2022/7/15 13:50,39,106,-67,-370
185,2022/7/15 14:00,39,81,-42,-264
185,2022/7/15 14:10,45,83,-38,-231
185,2022/7/15 14:20,40,100,-60,-254
185,2022/7/15 14:30,38,76,-38,-281
185,2022/7/15 14:40,45,102,-57,-278
185,2022/7/15 14:50,43,78,-35,-207
185,2022/7/15 15:00,44,103,-59,-157
185,2022/7/15 15:10,53,84,-31,50
185,2022/7/15 15:20,49,82,-33,-22
185,2022/7/15 15:30,50,94,-44,-21
185,2022/7/15 15:40,67,91,-24,57
185,2022/7/15 15:50,57,100,-43,-50
185,2022/7/15 16:00,83,76,7,164
185,2022/7/15 16:10,96,101,-5,434
185,2022/7/15 16:20,74,77,-3,452
185,2022/7/15 16:30,114,90,24,939
185,2022/7/15 16:40,148,103,45,1287
185,2022/7/15 16:50,169,81,88,1135
185,2022/7/15 17:00,277,103,174,3405
185,2022/7/15 17:10,273,107,166,5344
185,2022/7/15 17:20,217,123,94,3489
185,2022/7/15 17:30,319,111,208,4555
185,2022/7/15 17:40,607,102,505,9578
185,2022/7/15 17:50,265,106,159,5880
185,2022/7/15 18:00,218,126,92,3795
185,2022/7/15 18:10,291,107,184,8054
185,2022/7/15 18:20,221,112,109,4988
185,2022/7/15 18:30,170,128,42,2322
185,2022/7/15 18:40,167,126,41,1169
185,2022/7/15 18:50,75,123,-48,571
185,2022/7/15 19:00,57,109,-52,509
185,2022/7/15 19:10,46,107,-61,392
185,2022/7/15 19:20,46,110,-64,212
185,2022/7/15 19:30,34,90,-56,84
185,2022/7/15 19:40,31,87,-56,40
185,2022/7/15 19:50,31,74,-43,-24
185,2022/7/15 20:00,30,79,-49,-20
185,2022/7/15 20:10,27,69,-42,-13
185,2022/7/15 20:20,29,69,-40,-74
185,2022/7/15 20:30,25,95,-70,-94
185,2022/7/15 20:40,28,67,-39,-53
185,2022/7/15 20:50,29,72,-43,41
185,2022/7/15 21:00,26,95,-69,41
185,2022/7/15 21:10,23,73,-50,174
185,2022/7/15 21:20,29,68,-39,-122
185,2022/7/15 21:30,27,100,-73,-364
185,2022/7/15 21:40,23,73,-50,-457
185,2022/7/15 21:50,22,67,-45,-418
185,2022/7/15 22:00,22,85,-63,-475
185,2022/7/15 22:10,18,62,-44,-516
185,2022/7/15 22:20,11,69,-58,-589
185,2022/7/15 22:30,8,68,-60,-688
185,2022/7/15 22:40,1,48,-47,-600
185,2022/7/15 22:50,1,25,-24,-528
184,2022/7/15 5:00,0,1,-1,-6
184,2022/7/15 5:10,0,1,-1,0
184,2022/7/15 5:20,3,1,2,17
184,2022/7/15 5:30,11,1,10,76
184,2022/7/15 5:40,13,2,11,167
184,2022/7/15 5:50,19,2,17,199
184,2022/7/15 6:00,26,11,15,98
184,2022/7/15 6:10,38,20,18,11
184,2022/7/15 6:20,50,46,4,-22
184,2022/7/15 6:30,63,63,0,21
184,2022/7/15 6:40,87,62,25,195
184,2022/7/15 6:50,157,87,70,405
184,2022/7/15 7:00,186,105,81,417
184,2022/7/15 7:10,207,150,57,583
184,2022/7/15 7:20,244,217,27,882
184,2022/7/15 7:30,275,325,-50,1145
184,2022/7/15 7:40,359,324,35,1085
184,2022/7/15 7:50,437,298,139,289
184,2022/7/15 8:00,475,523,-48,-1404
184,2022/7/15 8:10,598,431,167,-6265
184,2022/7/15 8:20,598,472,126,-5763
184,2022/7/15 8:30,390,1092,-702,-12775
184,2022/7/15 8:40,299,1131,-832,-12742
184,2022/7/15 8:50,246,418,-172,-11280
184,2022/7/15 9:00,216,479,-263,-8979
184,2022/7/15 9:10,177,414,-237,-5413
184,2022/7/15 9:20,167,434,-267,-2393
184,2022/7/15 9:30,104,326,-222,-1479
184,2022/7/15 9:40,77,298,-221,-1389
184,2022/7/15 9:50,65,191,-126,-996
184,2022/7/15 10:00,65,159,-94,-681
184,2022/7/15 10:10,59,128,-69,-433
184,2022/7/15 10:20,53,116,-63,-506
184,2022/7/15 10:30,53,108,-55,-407
184,2022/7/15 10:40,49,123,-74,-529
184,2022/7/15 10:50,47,104,-57,-469
184,2022/7/15 11:00,44,112,-68,-401
184,2022/7/15 11:10,48,101,-53,-379
184,2022/7/15 11:20,54,87,-33,-313
184,2022/7/15 11:30,50,98,-48,-404
184,2022/7/15 11:40,54,122,-68,-402
184,2022/7/15 11:50,56,112,-56,-348
184,2022/7/15 12:00,66,107,-41,-304
184,2022/7/15 12:10,68,109,-41,-211
184,2022/7/15 12:20,66,108,-42,-343
184,2022/7/15 12:30,73,116,-43,-308
184,2022/7/15 12:40,68,126,-58,-461
184,2022/7/15 12:50,58,117,-59,-350
184,2022/7/15 13:00,67,88,-21,-391
184,2022/7/15 13:10,66,118,-52,-334
184,2022/7/15 13:20,57,116,-59,-391
184,2022/7/15 13:30,72,102,-30,-371
184,2022/7/15 13:40,67,125,-58,-422
184,2022/7/15 13:50,62,125,-63,-433
184,2022/7/15 14:00,64,119,-55,-319
184,2022/7/15 14:10,67,120,-53,-284
184,2022/7/15 14:20,64,102,-38,-292
184,2022/7/15 14:30,97,121,-24,-305
184,2022/7/15 14:40,96,109,-13,-291
184,2022/7/15 14:50,88,96,-8,-215
184,2022/7/15 15:00,109,126,-17,-174
184,2022/7/15 15:10,132,121,11,61
184,2022/7/15 15:20,128,121,7,-15
184,2022/7/15 15:30,110,116,-6,-27
184,2022/7/15 15:40,110,126,-16,41
184,2022/7/15 15:50,109,124,-15,-65
184,2022/7/15 16:00,190,123,67,231
184,2022/7/15 16:10,268,119,149,583
184,2022/7/15 16:20,275,121,154,606
184,2022/7/15 16:30,289,119,170,1109
184,2022/7/15 16:40,329,117,212,1499
184,2022/7/15 16:50,271,110,161,1296
184,2022/7/15 17:00,552,127,425,3830
184,2022/7/15 17:10,621,213,408,5752
184,2022/7/15 17:20,353,169,184,3673
184,2022/7/15 17:30,590,283,307,4862
184,2022/7/15 17:40,659,283,376,9954
184,2022/7/15 17:50,579,298,281,6161
184,2022/7/15 18:00,422,300,122,3917
184,2022/7/15 18:10,692,319,373,8427
184,2022/7/15 18:20,584,300,284,5272
184,2022/7/15 18:30,349,335,14,2336
184,2022/7/15 18:40,270,285,-15,1154
184,2022/7/15 18:50,229,222,7,578
184,2022/7/15 19:00,224,191,33,542
184,2022/7/15 19:10,185,180,5,397
184,2022/7/15 19:20,154,111,43,255
184,2022/7/15 19:30,129,120,9,93
184,2022/7/15 19:40,80,126,-46,-6
184,2022/7/15 19:50,73,110,-37,-61
184,2022/7/15 20:00,72,103,-31,-51
184,2022/7/15 20:10,70,109,-39,-52
184,2022/7/15 20:20,64,114,-50,-124
184,2022/7/15 20:30,68,77,-9,-103
184,2022/7/15 20:40,63,111,-48,-101
184,2022/7/15 20:50,62,115,-53,-12
184,2022/7/15 21:00,58,95,-37,4
184,2022/7/15 21:10,56,106,-50,124
184,2022/7/15 21:20,59,109,-50,-172
184,2022/7/15 21:30,43,92,-49,-413
184,2022/7/15 21:40,48,112,-64,-521
184,2022/7/15 21:50,43,101,-58,-476
184,2022/7/15 22:00,35,79,-44,-519
184,2022/7/15 22:10,31,84,-53,-569
184,2022/7/15 22:20,22,112,-90,-679
184,2022/7/15 22:30,16,77,-61,-749
184,2022/7/15 22:40,4,86,-82,-682
184,2022/7/15 22:50,2,3,-1,-529
179,2022/7/15 5:00,0,1,-1,-7
179,2022/7/15 5:10,1,1,0,0
179,2022/7/15 5:20,6,1,5,22
179,2022/7/15 5:30,10,1,9,85
179,2022/7/15 5:40,7,1,6,173
179,2022/7/15 5:50,12,5,7,206
179,2022/7/15 6:00,21,5,16,114
179,2022/7/15 6:10,38,11,27,38
179,2022/7/15 6:20,43,46,-3,-25
179,2022/7/15 6:30,59,54,5,26
179,2022/7/15 6:40,78,75,3,198
179,2022/7/15 6:50,146,100,46,451
179,2022/7/15 7:00,152,118,34,451
179,2022/7/15 7:10,170,103,67,650
179,2022/7/15 7:20,234,89,145,1027
179,2022/7/15 7:30,273,124,149,1294
179,2022/7/15 7:40,281,127,154,1239
179,2022/7/15 7:50,324,197,127,416
179,2022/7/15 8:00,339,331,8,-1396
179,2022/7/15 8:10,392,435,-43,-6308
179,2022/7/15 8:20,385,432,-47,-5810
179,2022/7/15 8:30,349,362,-13,-12788
179,2022/7/15 8:40,270,339,-69,-12811
179,2022/7/15 8:50,239,280,-41,-11321
179,2022/7/15 9:00,199,233,-34,-9013
179,2022/7/15 9:10,167,152,15,-5398
179,2022/7/15 9:20,120,117,3,-2390
179,2022/7/15 9:30,82,102,-20,-1499
179,2022/7/15 9:40,67,126,-59,-1448
179,2022/7/15 9:50,49,86,-37,-1033
179,2022/7/15 10:00,57,95,-38,-719
179,2022/7/15 10:10,47,96,-49,-482
179,2022/7/15 10:20,48,101,-53,-559
179,2022/7/15 10:30,44,75,-31,-438
179,2022/7/15 10:40,46,101,-55,-584
179,2022/7/15 10:50,44,66,-22,-491
179,2022/7/15 11:00,43,69,-26,-427
179,2022/7/15 11:10,41,82,-41,-420
179,2022/7/15 11:20,42,67,-25,-338
179,2022/7/15 11:30,43,93,-50,-454
179,2022/7/15 11:40,43,74,-31,-433
179,2022/7/15 11:50,46,75,-29,-377
179,2022/7/15 12:00,46,87,-41,-345
179,2022/7/15 12:10,43,62,-19,-230
179,2022/7/15 12:20,44,112,-68,-411
179,2022/7/15 12:30,47,77,-30,-338
179,2022/7/15 12:40,45,124,-79,-540
179,2022/7/15 12:50,45,91,-46,-396
179,2022/7/15 13:00,42,101,-59,-450
179,2022/7/15 13:10,45,104,-59,-393
179,2022/7/15 13:20,43,77,-34,-425
179,2022/7/15 13:30,43,109,-66,-437
179,2022/7/15 13:40,43,77,-34,-456
179,2022/7/15 13:50,45,102,-57,-490
179,2022/7/15 14:00,45,76,-31,-350
179,2022/7/15 14:10,47,97,-50,-334
179,2022/7/15 14:20,43,105,-62,-354
179,2022/7/15 14:30,48,76,-28,-333
179,2022/7/15 14:40,45,88,-43,-334
179,2022/7/15 14:50,48,72,-24,-239
179,2022/7/15 15:00,57,111,-54,-228
179,2022/7/15 15:10,70,73,-3,58
179,2022/7/15 15:20,52,91,-39,-54
179,2022/7/15 15:30,58,103,-45,-72
179,2022/7/15 15:40,63,87,-24,17
179,2022/7/15 15:50,64,102,-38,-103
179,2022/7/15 16:00,73,81,-8,223
179,2022/7/15 16:10,75,112,-37,546
179,2022/7/15 16:20,78,92,-14,592
179,2022/7/15 16:30,163,114,49,1158
179,2022/7/15 16:40,208,105,103,1602
179,2022/7/15 16:50,206,100,106,1402
179,2022/7/15 17:00,278,100,178,4008
179,2022/7/15 17:10,312,127,185,5937
179,2022/7/15 17:20,216,108,108,3781
179,2022/7/15 17:30,204,190,14,4876
179,2022/7/15 17:40,334,221,113,10067
179,2022/7/15 17:50,224,177,47,6208
179,2022/7/15 18:00,178,218,-40,3877
179,2022/7/15 18:10,264,214,50,8477
179,2022/7/15 18:20,233,193,40,5312
179,2022/7/15 18:30,170,198,-28,2308
179,2022/7/15 18:40,114,180,-66,1088
179,2022/7/15 18:50,73,150,-77,501
179,2022/7/15 19:00,55,126,-71,471
179,2022/7/15 19:10,49,112,-63,334
179,2022/7/15 19:20,43,104,-61,194
179,2022/7/15 19:30,45,122,-77,16
179,2022/7/15 19:40,44,99,-55,-61
179,2022/7/15 19:50,39,95,-56,-117
179,2022/7/15 20:00,37,114,-77,-128
179,2022/7/15 20:10,36,85,-49,-101
179,2022/7/15 20:20,36,92,-56,-180
179,2022/7/15 20:30,35,103,-68,-171
179,2022/7/15 20:40,39,83,-44,-145
179,2022/7/15 20:50,35,102,-67,-79
179,2022/7/15 21:00,35,103,-68,-64
179,2022/7/15 21:10,38,82,-44,80
179,2022/7/15 21:20,29,107,-78,-250
179,2022/7/15 21:30,30,104,-74,-487
179,2022/7/15 21:40,27,94,-67,-588
179,2022/7/15 21:50,25,95,-70,-546
179,2022/7/15 22:00,21,97,-76,-595
179,2022/7/15 22:10,16,86,-70,-639
179,2022/7/15 22:20,13,89,-76,-755
179,2022/7/15 22:30,5,83,-78,-827
179,2022/7/15 22:40,2,7,-5,-687
179,2022/7/15 22:50,1,31,-30,-559
180,2022/7/15 5:00,0,1,-1,-8
180,2022/7/15 5:10,0,1,-1,-1
180,2022/7/15 5:20,4,1,3,25
180,2022/7/15 5:30,5,1,4,89
180,2022/7/15 5:40,11,1,10,183
180,2022/7/15 5:50,15,22,-7,199
180,2022/7/15 6:00,22,36,-14,100
180,2022/7/15 6:10,31,41,-10,28
180,2022/7/15 6:20,33,74,-41,-66
180,2022/7/15 6:30,45,76,-31,-5
180,2022/7/15 6:40,57,123,-66,132
180,2022/7/15 6:50,60,111,-51,400
180,2022/7/15 7:00,84,297,-213,238
180,2022/7/15 7:10,99,342,-243,407
180,2022/7/15 7:20,108,298,-190,837
180,2022/7/15 7:30,191,323,-132,1162
180,2022/7/15 7:40,217,328,-111,1128
180,2022/7/15 7:50,238,318,-80,336
180,2022/7/15 8:00,284,267,17,-1379
180,2022/7/15 8:10,329,318,11,-6297
180,2022/7/15 8:20,315,298,17,-5793
180,2022/7/15 8:30,276,283,-7,-12795
180,2022/7/15 8:40,274,268,6,-12805
180,2022/7/15 8:50,243,217,26,-11295
180,2022/7/15 9:00,220,208,12,-9001
180,2022/7/15 9:10,211,178,33,-5365
180,2022/7/15 9:20,183,161,22,-2368
180,2022/7/15 9:30,177,159,18,-1481
180,2022/7/15 9:40,146,117,29,-1419
180,2022/7/15 9:50,105,110,-5,-1038
180,2022/7/15 10:00,82,120,-38,-757
180,2022/7/15 10:10,80,109,-29,-511
180,2022/7/15 10:20,76,105,-29,-588
180,2022/7/15 10:30,81,109,-28,-466
180,2022/7/15 10:40,69,109,-40,-624
180,2022/7/15 10:50,74,98,-24,-515
180,2022/7/15 11:00,77,96,-19,-446
180,2022/7/15 11:10,75,90,-15,-435
180,2022/7/15 11:20,69,93,-24,-362
180,2022/7/15 11:30,70,97,-27,-481
180,2022/7/15 11:40,76,79,-3,-436
180,2022/7/15 11:50,65,96,-31,-408
180,2022/7/15 12:00,63,91,-28,-373
180,2022/7/15 12:10,63,110,-47,-277
180,2022/7/15 12:20,53,108,-55,-466
180,2022/7/15 12:30,54,100,-46,-384
180,2022/7/15 12:40,52,121,-69,-609
180,2022/7/15 12:50,44,125,-81,-477
180,2022/7/15 13:00,46,121,-75,-525
180,2022/7/15 13:10,50,105,-55,-448
180,2022/7/15 13:20,52,118,-66,-491
180,2022/7/15 13:30,65,106,-41,-478
180,2022/7/15 13:40,66,106,-40,-496
180,2022/7/15 13:50,64,102,-38,-528
180,2022/7/15 14:00,77,103,-26,-376
180,2022/7/15 14:10,77,105,-28,-362
180,2022/7/15 14:20,78,102,-24,-378
180,2022/7/15 14:30,74,103,-29,-362
180,2022/7/15 14:40,73,100,-27,-361
180,2022/7/15 14:50,77,109,-32,-271
180,2022/7/15 15:00,109,111,-2,-230
180,2022/7/15 15:10,132,105,27,85
180,2022/7/15 15:20,128,110,18,-36
180,2022/7/15 15:30,110,112,-2,-74
180,2022/7/15 15:40,117,102,15,32
180,2022/7/15 15:50,125,106,19,-84
180,2022/7/15 16:00,171,110,61,284
180,2022/7/15 16:10,182,99,83,629
180,2022/7/15 16:20,168,101,67,659
180,2022/7/15 16:30,235,106,129,1287
180,2022/7/15 16:40,310,114,196,1798
180,2022/7/15 16:50,265,103,162,1564
180,2022/7/15 17:00,334,112,222,4230
180,2022/7/15 17:10,310,127,183,6120
180,2022/7/15 17:20,291,116,175,3956
180,2022/7/15 17:30,263,109,154,5030
180,2022/7/15 17:40,228,142,86,10153
180,2022/7/15 17:50,186,115,71,6279
180,2022/7/15 18:00,182,117,65,3942
180,2022/7/15 18:10,216,143,73,8550
180,2022/7/15 18:20,137,111,26,5338
180,2022/7/15 18:30,70,117,-47,2261
180,2022/7/15 18:40,73,171,-98,990
180,2022/7/15 18:50,60,109,-49,452
180,2022/7/15 19:00,48,122,-74,397
180,2022/7/15 19:10,47,104,-57,277
180,2022/7/15 19:20,48,105,-57,137
180,2022/7/15 19:30,40,107,-67,-51
180,2022/7/15 19:40,39,95,-56,-117
180,2022/7/15 19:50,35,102,-67,-184
180,2022/7/15 20:00,35,76,-41,-169
180,2022/7/15 20:10,40,86,-46,-147
180,2022/7/15 20:20,32,76,-44,-224
180,2022/7/15 20:30,30,78,-48,-219
180,2022/7/15 20:40,33,87,-54,-199
180,2022/7/15 20:50,37,90,-53,-132
180,2022/7/15 21:00,28,76,-48,-112
180,2022/7/15 21:10,29,71,-42,38
180,2022/7/15 21:20,29,94,-65,-315
180,2022/7/15 21:30,27,94,-67,-554
180,2022/7/15 21:40,28,87,-59,-647
180,2022/7/15 21:50,23,78,-55,-601
180,2022/7/15 22:00,21,87,-66,-661
180,2022/7/15 22:10,21,72,-51,-690
180,2022/7/15 22:20,14,71,-57,-812
180,2022/7/15 22:30,8,87,-79,-906
180,2022/7/15 22:40,10,57,-47,-734
180,2022/7/15 22:50,4,43,-39,-598
188,2022/7/15 5:00,0,1,-1,-9
188,2022/7/15 5:10,1,1,0,-1
188,2022/7/15 5:20,7,1,6,31
188,2022/7/15 5:30,7,1,6,95
188,2022/7/15 5:40,8,1,7,190
188,2022/7/15 5:50,14,5,9,208
188,2022/7/15 6:00,16,13,3,103
188,2022/7/15 6:10,28,8,20,48
188,2022/7/15 6:20,32,60,-28,-94
188,2022/7/15 6:30,33,69,-36,-41
188,2022/7/15 6:40,57,83,-26,106
188,2022/7/15 6:50,71,113,-42,358
188,2022/7/15 7:00,145,102,43,281
188,2022/7/15 7:10,157,103,54,461
188,2022/7/15 7:20,196,120,76,913
188,2022/7/15 7:30,239,160,79,1241
188,2022/7/15 7:40,282,179,103,1231
188,2022/7/15 7:50,328,319,9,345
188,2022/7/15 8:00,339,323,16,-1363
188,2022/7/15 8:10,367,430,-63,-6360
188,2022/7/15 8:20,375,430,-55,-5848
188,2022/7/15 8:30,357,577,-220,-13015
188,2022/7/15 8:40,282,1162,-880,-13685
188,2022/7/15 8:50,223,612,-389,-11684
188,2022/7/15 9:00,217,490,-273,-9274
188,2022/7/15 9:10,182,424,-242,-5607
188,2022/7/15 9:20,155,491,-336,-2704
188,2022/7/15 9:30,105,317,-212,-1693
188,2022/7/15 9:40,77,318,-241,-1660
188,2022/7/15 9:50,75,223,-148,-1186
188,2022/7/15 10:00,65,111,-46,-803
188,2022/7/15 10:10,63,214,-151,-662
188,2022/7/15 10:20,57,109,-52,-640
188,2022/7/15 10:30,52,119,-67,-533
188,2022/7/15 10:40,52,118,-66,-690
188,2022/7/15 10:50,48,111,-63,-578
188,2022/7/15 11:00,50,104,-54,-500
188,2022/7/15 11:10,48,100,-52,-487
188,2022/7/15 11:20,45,108,-63,-425
188,2022/7/15 11:30,50,93,-43,-524
188,2022/7/15 11:40,52,114,-62,-498
188,2022/7/15 11:50,59,124,-65,-473
188,2022/7/15 12:00,59,88,-29,-402
188,2022/7/15 12:10,69,122,-53,-330
188,2022/7/15 12:20,71,96,-25,-491
188,2022/7/15 12:30,75,128,-53,-437
188,2022/7/15 12:40,74,106,-32,-641
188,2022/7/15 12:50,70,110,-40,-517
188,2022/7/15 13:00,83,125,-42,-567
188,2022/7/15 13:10,76,104,-28,-476
188,2022/7/15 13:20,88,108,-20,-511
188,2022/7/15 13:30,78,106,-28,-506
188,2022/7/15 13:40,72,117,-45,-541
188,2022/7/15 13:50,75,101,-26,-554
188,2022/7/15 14:00,77,122,-45,-421
188,2022/7/15 14:10,72,113,-41,-403
188,2022/7/15 14:20,73,119,-46,-424
188,2022/7/15 14:30,76,121,-45,-407
188,2022/7/15 14:40,67,112,-45,-406
188,2022/7/15 14:50,74,108,-34,-305
188,2022/7/15 15:00,98,104,-6,-236
188,2022/7/15 15:10,130,121,9,94
188,2022/7/15 15:20,131,122,9,-27
188,2022/7/15 15:30,119,123,-4,-78
188,2022/7/15 15:40,135,109,26,58
188,2022/7/15 15:50,109,113,-4,-88
188,2022/7/15 16:00,134,123,11,295
188,2022/7/15 16:10,164,108,56,685
188,2022/7/15 16:20,170,130,40,699
188,2022/7/15 16:30,214,113,101,1388
188,2022/7/15 16:40,236,121,115,1913
188,2022/7/15 16:50,223,192,31,1595
188,2022/7/15 17:00,344,127,217,4447
188,2022/7/15 17:10,578,170,408,6528
188,2022/7/15 17:20,325,212,113,4069
188,2022/7/15 17:30,620,212,408,5438
188,2022/7/15 17:40,703,333,370,10523
188,2022/7/15 17:50,576,298,278,6557
188,2022/7/15 18:00,607,337,270,4212
188,2022/7/15 18:10,813,381,432,8982
188,2022/7/15 18:20,579,378,201,5539
188,2022/7/15 18:30,332,342,-10,2251
188,2022/7/15 18:40,339,327,12,1002
188,2022/7/15 18:50,269,321,-52,400
188,2022/7/15 19:00,240,257,-17,380
188,2022/7/15 19:10,215,184,31,308
188,2022/7/15 19:20,190,138,52,189
188,2022/7/15 19:30,175,111,64,13
188,2022/7/15 19:40,137,105,32,-85
188,2022/7/15 19:50,135,104,31,-153
188,2022/7/15 20:00,136,103,33,-136
188,2022/7/15 20:10,161,112,49,-98
188,2022/7/15 20:20,135,100,35,-189
188,2022/7/15 20:30,138,97,41,-178
188,2022/7/15 20:40,174,129,45,-154
188,2022/7/15 20:50,138,94,44,-88
188,2022/7/15 21:00,177,95,82,-30
188,2022/7/15 21:10,176,103,73,111
188,2022/7/15 21:20,130,105,25,-290
188,2022/7/15 21:30,129,80,49,-505
188,2022/7/15 21:40,160,104,56,-591
188,2022/7/15 21:50,71,95,-24,-625
188,2022/7/15 22:00,56,79,-23,-684
188,2022/7/15 22:10,35,101,-66,-756
188,2022/7/15 22:20,25,84,-59,-871
188,2022/7/15 22:30,13,86,-73,-979
188,2022/7/15 22:40,0,48,-48,-782
188,2022/7/15 22:50,1,40,-39,-637
189,2022/7/15 5:00,0,1,-1,-10
189,2022/7/15 5:10,2,1,1,0
189,2022/7/15 5:20,7,1,6,37
189,2022/7/15 5:30,9,1,8,103
189,2022/7/15 5:40,13,5,8,198
189,2022/7/15 5:50,15,1,14,222
189,2022/7/15 6:00,21,5,16,119
189,2022/7/15 6:10,33,2,31,79
189,2022/7/15 6:20,35,30,5,-89
189,2022/7/15 6:30,46,39,7,-34
189,2022/7/15 6:40,53,51,2,108
189,2022/7/15 6:50,77,52,25,383
189,2022/7/15 7:00,88,70,18,299
189,2022/7/15 7:10,105,68,37,498
189,2022/7/15 7:20,105,88,17,930
189,2022/7/15 7:30,169,93,76,1317
189,2022/7/15 7:40,215,101,114,1345
189,2022/7/15 7:50,251,104,147,492
189,2022/7/15 8:00,280,103,177,-1186
189,2022/7/15 8:10,281,224,57,-6303
189,2022/7/15 8:20,276,178,98,-5750
189,2022/7/15 8:30,235,253,-18,-13033
189,2022/7/15 8:40,220,328,-108,-13793
189,2022/7/15 8:50,197,373,-176,-11860
189,2022/7/15 9:00,167,233,-66,-9340
189,2022/7/15 9:10,180,231,-51,-5658
189,2022/7/15 9:20,116,185,-69,-2773
189,2022/7/15 9:30,91,108,-17,-1710
189,2022/7/15 9:40,76,125,-49,-1709
189,2022/7/15 9:50,68,124,-56,-1242
189,2022/7/15 10:00,61,104,-43,-846
189,2022/7/15 10:10,62,101,-39,-701
189,2022/7/15 10:20,56,101,-45,-685
189,2022/7/15 10:30,54,75,-21,-554
189,2022/7/15 10:40,44,87,-43,-733
189,2022/7/15 10:50,47,83,-36,-614
189,2022/7/15 11:00,42,75,-33,-533
189,2022/7/15 11:10,44,79,-35,-522
189,2022/7/15 11:20,45,80,-35,-460
189,2022/7/15 11:30,46,84,-38,-562
189,2022/7/15 11:40,55,73,-18,-516
189,2022/7/15 11:50,57,87,-30,-503
189,2022/7/15 12:00,57,77,-20,-422
189,2022/7/15 12:10,71,72,-1,-331
189,2022/7/15 12:20,77,93,-16,-507
189,2022/7/15 12:30,73,77,-4,-441
189,2022/7/15 12:40,77,91,-14,-655
189,2022/7/15 12:50,76,80,-4,-521
189,2022/7/15 13:00,90,73,17,-550
189,2022/7/15 13:10,72,91,-19,-495
189,2022/7/15 13:20,74,73,1,-510
189,2022/7/15 13:30,73,101,-28,-534
189,2022/7/15 13:40,75,85,-10,-551
189,2022/7/15 13:50,75,98,-23,-577
189,2022/7/15 14:00,67,74,-7,-428
189,2022/7/15 14:10,76,74,2,-401
189,2022/7/15 14:20,82,87,-5,-429
189,2022/7/15 14:30,74,70,4,-403
189,2022/7/15 14:40,79,92,-13,-419
189,2022/7/15 14:50,76,69,7,-298
189,2022/7/15 15:00,103,76,27,-209
189,2022/7/15 15:10,113,82,31,125
189,2022/7/15 15:20,111,76,35,8
189,2022/7/15 15:30,141,76,65,-13
189,2022/7/15 15:40,171,78,93,151
189,2022/7/15 15:50,136,93,43,-45
189,2022/7/15 16:00,157,77,80,375
189,2022/7/15 16:10,153,78,75,760
189,2022/7/15 16:20,175,76,99,798
189,2022/7/15 16:30,214,76,138,1526
189,2022/7/15 16:40,264,87,177,2090
189,2022/7/15 16:50,223,87,136,1731
189,2022/7/15 17:00,379,111,268,4715
189,2022/7/15 17:10,552,93,459,6987
189,2022/7/15 17:20,331,108,223,4292
189,2022/7/15 17:30,552,111,441,5879
189,2022/7/15 17:40,676,122,554,11077
189,2022/7/15 17:50,376,126,250,6807
189,2022/7/15 18:00,577,122,455,4667
189,2022/7/15 18:10,715,116,599,9581
189,2022/7/15 18:20,578,108,470,6009
189,2022/7/15 18:30,328,110,218,2469
189,2022/7/15 18:40,272,126,146,1148
189,2022/7/15 18:50,265,106,159,559
189,2022/7/15 19:00,212,100,112,492
189,2022/7/15 19:10,216,98,118,426
189,2022/7/15 19:20,157,87,70,259
189,2022/7/15 19:30,151,75,76,89
189,2022/7/15 19:40,129,72,57,-28
189,2022/7/15 19:50,129,64,65,-88
189,2022/7/15 20:00,143,66,77,-59
189,2022/7/15 20:10,130,68,62,-36
189,2022/7/15 20:20,114,51,63,-126
189,2022/7/15 20:30,134,56,78,-100
189,2022/7/15 20:40,131,62,69,-85
189,2022/7/15 20:50,68,63,5,-83
189,2022/7/15 21:00,85,51,34,4
189,2022/7/15 21:10,102,51,51,162
189,2022/7/15 21:20,74,56,18,-272
189,2022/7/15 21:30,68,48,20,-485
189,2022/7/15 21:40,64,52,12,-579
189,2022/7/15 21:50,58,49,9,-616
189,2022/7/15 22:00,271,42,229,-455
189,2022/7/15 22:10,40,40,0,-756
189,2022/7/15 22:20,23,39,-16,-887
189,2022/7/15 22:30,21,40,-19,-998
189,2022/7/15 22:40,13,26,-13,-795
189,2022/7/15 22:50,5,23,-18,-655
193,2022/7/15 5:00,0,1,-1,-11
193,2022/7/15 5:10,4,1,3,3
193,2022/7/15 5:20,5,1,4,41
193,2022/7/15 5:30,7,1,6,109
193,2022/7/15 5:40,7,1,6,204
193,2022/7/15 5:50,12,1,11,233
193,2022/7/15 6:00,18,1,17,136
193,2022/7/15 6:10,17,1,16,95
193,2022/7/15 6:20,25,20,5,-84
193,2022/7/15 6:30,31,65,-34,-68
193,2022/7/15 6:40,39,70,-31,77
193,2022/7/15 6:50,44,76,-32,351
193,2022/7/15 7:00,58,99,-41,258
193,2022/7/15 7:10,56,105,-49,449
193,2022/7/15 7:20,84,101,-17,913
193,2022/7/15 7:30,87,109,-22,1295
193,2022/7/15 7:40,187,180,7,1352
193,2022/7/15 7:50,224,218,6,498
193,2022/7/15 8:00,243,380,-137,-1323
193,2022/7/15 8:10,274,405,-131,-6434
193,2022/7/15 8:20,259,593,-334,-6084
193,2022/7/15 8:30,222,1932,-1710,-14743
193,2022/7/15 8:40,150,1936,-1786,-15579
193,2022/7/15 8:50,100,1537,-1437,-13297
193,2022/7/15 9:00,75,483,-408,-9748
193,2022/7/15 9:10,77,489,-412,-6070
193,2022/7/15 9:20,65,378,-313,-3086
193,2022/7/15 9:30,51,324,-273,-1983
193,2022/7/15 9:40,47,231,-184,-1893
193,2022/7/15 9:50,48,157,-109,-1351
193,2022/7/15 10:00,44,105,-61,-907
193,2022/7/15 10:10,43,123,-80,-781
193,2022/7/15 10:20,42,114,-72,-757
193,2022/7/15 10:30,38,88,-50,-604
193,2022/7/15 10:40,46,101,-55,-788
193,2022/7/15 10:50,43,112,-69,-683
193,2022/7/15 11:00,35,90,-55,-588
193,2022/7/15 11:10,41,96,-55,-577
193,2022/7/15 11:20,38,93,-55,-515
193,2022/7/15 11:30,35,75,-40,-602
193,2022/7/15 11:40,41,93,-52,-568
193,2022/7/15 11:50,45,97,-52,-555
193,2022/7/15 12:00,44,91,-47,-469
193,2022/7/15 12:10,44,95,-51,-382
193,2022/7/15 12:20,48,77,-29,-536
193,2022/7/15 12:30,46,112,-66,-507
193,2022/7/15 12:40,48,90,-42,-697
193,2022/7/15 12:50,46,105,-59,-580
193,2022/7/15 13:00,46,112,-66,-616
193,2022/7/15 13:10,50,93,-43,-538
193,2022/7/15 13:20,40,103,-63,-573
193,2022/7/15 13:30,45,90,-45,-579
193,2022/7/15 13:40,47,111,-64,-615
193,2022/7/15 13:50,46,97,-51,-628
193,2022/7/15 14:00,45,105,-60,-488
193,2022/7/15 14:10,48,101,-53,-454
193,2022/7/15 14:20,46,93,-47,-476
193,2022/7/15 14:30,47,105,-58,-461
193,2022/7/15 14:40,49,78,-29,-448
193,2022/7/15 14:50,53,108,-55,-353
193,2022/7/15 15:00,69,76,-7,-216
193,2022/7/15 15:10,94,103,-9,116
193,2022/7/15 15:20,75,104,-29,-21
193,2022/7/15 15:30,62,76,-14,-27
193,2022/7/15 15:40,72,103,-31,120
193,2022/7/15 15:50,70,82,-12,-57
193,2022/7/15 16:00,75,105,-30,345
193,2022/7/15 16:10,95,91,4,764
193,2022/7/15 16:20,92,114,-22,776
193,2022/7/15 16:30,137,97,40,1566
193,2022/7/15 16:40,187,102,85,2175
193,2022/7/15 16:50,185,123,62,1793
193,2022/7/15 17:00,262,102,160,4875
193,2022/7/15 17:10,324,102,222,7209
193,2022/7/15 17:20,314,110,204,4496
193,2022/7/15 17:30,462,125,337,6216
193,2022/7/15 17:40,1158,106,1052,12129
193,2022/7/15 17:50,653,138,515,7322
193,2022/7/15 18:00,645,143,502,5169
193,2022/7/15 18:10,1561,150,1411,10992
193,2022/7/15 18:20,821,184,637,6646
193,2022/7/15 18:30,570,151,419,2888
193,2022/7/15 18:40,354,181,173,1321
193,2022/7/15 18:50,256,130,126,685
193,2022/7/15 19:00,210,103,107,599
193,2022/7/15 19:10,211,125,86,512
193,2022/7/15 19:20,148,104,44,303
193,2022/7/15 19:30,96,92,4,93
193,2022/7/15 19:40,163,92,71,43
193,2022/7/15 19:50,81,84,-3,-91
193,2022/7/15 20:00,67,76,-9,-68
193,2022/7/15 20:10,71,82,-11,-47
193,2022/7/15 20:20,57,67,-10,-136
193,2022/7/15 20:30,55,77,-22,-122
193,2022/7/15 20:40,59,73,-14,-99
193,2022/7/15 20:50,45,70,-25,-108
193,2022/7/15 21:00,73,88,-15,-11
193,2022/7/15 21:10,97,67,30,192
193,2022/7/15 21:20,44,63,-19,-291
193,2022/7/15 21:30,42,88,-46,-531
193,2022/7/15 21:40,37,70,-33,-612
193,2022/7/15 21:50,33,65,-32,-648
193,2022/7/15 22:00,33,78,-45,-500
193,2022/7/15 22:10,29,67,-38,-794
193,2022/7/15 22:20,17,62,-45,-932
193,2022/7/15 22:30,0,74,-74,-1072
193,2022/7/15 22:40,0,79,-79,-874
193,2022/7/15 22:50,0,50,-50,-705
195,2022/7/15 5:00,0,1,-1,-1
195,2022/7/15 5:10,0,1,-1,-1
195,2022/7/15 5:20,0,1,-1,-1
195,2022/7/15 5:30,0,1,-1,-1
195,2022/7/15 5:40,1,1,0,0
195,2022/7/15 5:50,3,1,2,2
195,2022/7/15 6:00,8,1,7,7
195,2022/7/15 6:10,19,5,14,14
195,2022/7/15 6:20,32,29,3,3
195,2022/7/15 6:30,42,41,1,1
195,2022/7/15 6:40,46,29,17,17
195,2022/7/15 6:50,56,51,5,5
195,2022/7/15 7:00,77,63,14,14
195,2022/7/15 7:10,100,63,37,37
195,2022/7/15 7:20,168,61,107,107
195,2022/7/15 7:30,215,62,153,153
195,2022/7/15 7:40,223,69,154,154
195,2022/7/15 7:50,224,72,152,152
195,2022/7/15 8:00,183,76,107,107
195,2022/7/15 8:10,190,105,85,85
195,2022/7/15 8:20,175,91,84,84
195,2022/7/15 8:30,110,80,30,30
195,2022/7/15 8:40,84,83,1,1
195,2022/7/15 8:50,63,76,-13,-13
195,2022/7/15 9:00,46,67,-21,-21
195,2022/7/15 9:10,33,51,-18,-18
195,2022/7/15 9:20,30,50,-20,-20
195,2022/7/15 9:30,28,48,-20,-20
195,2022/7/15 9:40,28,41,-13,-13
195,2022/7/15 9:50,23,33,-10,-10
195,2022/7/15 10:00,22,31,-9,-9
195,2022/7/15 10:10,21,34,-13,-13
195,2022/7/15 10:20,19,34,-15,-15
195,2022/7/15 10:30,18,37,-19,-19
195,2022/7/15 10:40,16,23,-7,-7
195,2022/7/15 10:50,17,32,-15,-15
195,2022/7/15 11:00,15,33,-18,-18
195,2022/7/15 11:10,18,23,-5,-5
195,2022/7/15 11:20,19,39,-20,-20
195,2022/7/15 11:30,14,33,-19,-19
195,2022/7/15 11:40,17,23,-6,-6
195,2022/7/15 11:50,17,40,-23,-23
195,2022/7/15 12:00,17,37,-20,-20
195,2022/7/15 12:10,16,25,-9,-9
195,2022/7/15 12:20,17,41,-24,-24
195,2022/7/15 12:30,16,41,-25,-25
195,2022/7/15 12:40,16,31,-15,-15
195,2022/7/15 12:50,18,46,-28,-28
195,2022/7/15 13:00,17,42,-25,-25
195,2022/7/15 13:10,20,32,-12,-12
195,2022/7/15 13:20,15,51,-36,-36
195,2022/7/15 13:30,16,38,-22,-22
195,2022/7/15 13:40,19,32,-13,-13
195,2022/7/15 13:50,16,45,-29,-29
195,2022/7/15 14:00,15,38,-23,-23
195,2022/7/15 14:10,18,33,-15,-15
195,2022/7/15 14:20,15,38,-23,-23
195,2022/7/15 14:30,16,44,-28,-28
195,2022/7/15 14:40,17,29,-12,-12
195,2022/7/15 14:50,16,48,-32,-32
195,2022/7/15 15:00,15,40,-25,-25
195,2022/7/15 15:10,21,35,-14,-14
195,2022/7/15 15:20,16,47,-31,-31
195,2022/7/15 15:30,22,51,-29,-29
195,2022/7/15 15:40,21,35,-14,-14
195,2022/7/15 15:50,19,54,-35,-35
195,2022/7/15 16:00,19,51,-32,-32
195,2022/7/15 16:10,25,41,-16,-16
195,2022/7/15 16:20,24,62,-38,-38
195,2022/7/15 16:30,28,71,-43,-43
195,2022/7/15 16:40,35,53,-18,-18
195,2022/7/15 16:50,36,79,-43,-43
195,2022/7/15 17:00,27,79,-52,-52
195,2022/7/15 17:10,35,83,-48,-48
195,2022/7/15 17:20,47,90,-43,-43
195,2022/7/15 17:30,41,102,-61,-61
195,2022/7/15 17:40,39,105,-66,-66
195,2022/7/15 17:50,37,102,-65,-65
195,2022/7/15 18:00,30,121,-91,-91
195,2022/7/15 18:10,34,108,-74,-74
195,2022/7/15 18:20,28,112,-84,-84
195,2022/7/15 18:30,22,89,-67,-67
195,2022/7/15 18:40,25,111,-86,-86
195,2022/7/15 18:50,22,104,-82,-82
195,2022/7/15 19:00,17,113,-96,-96
195,2022/7/15 19:10,18,107,-89,-89
195,2022/7/15 19:20,13,101,-88,-88
195,2022/7/15 19:30,12,99,-87,-87
195,2022/7/15 19:40,16,77,-61,-61
195,2022/7/15 19:50,10,80,-70,-70
195,2022/7/15 20:00,11,64,-53,-53
195,2022/7/15 20:10,13,68,-55,-55
195,2022/7/15 20:20,12,70,-58,-58
195,2022/7/15 20:30,12,62,-50,-50
195,2022/7/15 20:40,11,61,-50,-50
195,2022/7/15 20:50,9,46,-37,-37
195,2022/7/15 21:00,11,64,-53,-53
195,2022/7/15 21:10,11,67,-56,-56
195,2022/7/15 21:20,11,46,-35,-35
195,2022/7/15 21:30,10,62,-52,-52
195,2022/7/15 21:40,5,66,-61,-61
195,2022/7/15 21:50,7,40,-33,-33
195,2022/7/15 22:00,4,59,-55,-55
195,2022/7/15 22:10,4,43,-39,-39
195,2022/7/15 22:20,2,52,-50,-50
195,2022/7/15 22:30,0,32,-32,-32
195,2022/7/15 22:40,0,3,-3,-3
195,2022/7/15 22:50,0,3,-3,-3
202,2022/7/15 5:00,0,1,-1,-2
202,2022/7/15 5:10,0,1,-1,-2
202,2022/7/15 5:20,0,1,-1,-2
202,2022/7/15 5:30,0,1,-1,-2
202,2022/7/15 5:40,0,1,-1,-1
202,2022/7/15 5:50,4,1,3,5
202,2022/7/15 6:00,4,1,3,10
202,2022/7/15 6:10,18,6,12,26
202,2022/7/15 6:20,32,21,11,14
202,2022/7/15 6:30,41,21,20,21
202,2022/7/15 6:40,56,23,33,50
202,2022/7/15 6:50,59,45,14,19
202,2022/7/15 7:00,56,62,-6,8
202,2022/7/15 7:10,91,85,6,43
202,2022/7/15 7:20,156,93,63,170
202,2022/7/15 7:30,163,108,55,208
202,2022/7/15 7:40,217,126,91,245
202,2022/7/15 7:50,189,139,50,202
202,2022/7/15 8:00,205,267,-62,45
202,2022/7/15 8:10,183,332,-149,-64
202,2022/7/15 8:20,145,268,-123,-39
202,2022/7/15 8:30,83,197,-114,-84
202,2022/7/15 8:40,75,268,-193,-192
202,2022/7/15 8:50,53,116,-63,-76
202,2022/7/15 9:00,39,76,-37,-58
202,2022/7/15 9:10,35,105,-70,-88
202,2022/7/15 9:20,29,84,-55,-75
202,2022/7/15 9:30,28,81,-53,-73
202,2022/7/15 9:40,28,76,-48,-61
202,2022/7/15 9:50,26,67,-41,-51
202,2022/7/15 10:00,23,63,-40,-49
202,2022/7/15 10:10,26,69,-43,-56
202,2022/7/15 10:20,23,36,-13,-28
202,2022/7/15 10:30,24,67,-43,-62
202,2022/7/15 10:40,25,48,-23,-30
202,2022/7/15 10:50,23,41,-18,-33
202,2022/7/15 11:00,24,55,-31,-49
202,2022/7/15 11:10,24,45,-21,-26
202,2022/7/15 11:20,28,32,-4,-24
202,2022/7/15 11:30,28,45,-17,-36
202,2022/7/15 11:40,25,43,-18,-24
202,2022/7/15 11:50,26,38,-12,-35
202,2022/7/15 12:00,27,48,-21,-41
202,2022/7/15 12:10,26,45,-19,-28
202,2022/7/15 12:20,21,38,-17,-41
202,2022/7/15 12:30,27,61,-34,-59
202,2022/7/15 12:40,21,49,-28,-43
202,2022/7/15 12:50,22,42,-20,-48
202,2022/7/15 13:00,20,65,-45,-70
202,2022/7/15 13:10,21,49,-28,-40
202,2022/7/15 13:20,22,38,-16,-52
202,2022/7/15 13:30,18,64,-46,-68
202,2022/7/15 13:40,18,51,-33,-46
202,2022/7/15 13:50,20,45,-25,-54
202,2022/7/15 14:00,23,64,-41,-64
202,2022/7/15 14:10,20,54,-34,-49
202,2022/7/15 14:20,20,37,-17,-40
202,2022/7/15 14:30,20,52,-32,-60
202,2022/7/15 14:40,23,49,-26,-38
202,2022/7/15 14:50,22,37,-15,-47
202,2022/7/15 15:00,22,51,-29,-54
202,2022/7/15 15:10,21,50,-29,-43
202,2022/7/15 15:20,25,41,-16,-47
202,2022/7/15 15:30,21,57,-36,-65
202,2022/7/15 15:40,24,67,-43,-57
202,2022/7/15 15:50,26,45,-19,-54
202,2022/7/15 16:00,27,61,-34,-66
202,2022/7/15 16:10,25,69,-44,-60
202,2022/7/15 16:20,29,63,-34,-72
202,2022/7/15 16:30,33,70,-37,-80
202,2022/7/15 16:40,58,62,-4,-22
202,2022/7/15 16:50,88,71,17,-26
202,2022/7/15 17:00,132,76,56,4
202,2022/7/15 17:10,175,75,100,52
202,2022/7/15 17:20,175,87,88,45
202,2022/7/15 17:30,175,103,72,11
202,2022/7/15 17:40,227,105,122,56
202,2022/7/15 17:50,206,105,101,36
202,2022/7/15 18:00,129,110,19,-72
202,2022/7/15 18:10,174,101,73,-1
202,2022/7/15 18:20,72,110,-38,-122
202,2022/7/15 18:30,46,107,-61,-128
202,2022/7/15 18:40,30,89,-59,-145
202,2022/7/15 18:50,33,109,-76,-158
202,2022/7/15 19:00,28,106,-78,-174
202,2022/7/15 19:10,28,105,-77,-166
202,2022/7/15 19:20,23,111,-88,-176
202,2022/7/15 19:30,22,95,-73,-160
202,2022/7/15 19:40,17,77,-60,-121
202,2022/7/15 19:50,17,71,-54,-124
202,2022/7/15 20:00,15,74,-59,-112
202,2022/7/15 20:10,21,63,-42,-97
202,2022/7/15 20:20,20,62,-42,-100
202,2022/7/15 20:30,18,66,-48,-98
202,2022/7/15 20:40,17,53,-36,-86
202,2022/7/15 20:50,14,64,-50,-87
202,2022/7/15 21:00,11,48,-37,-90
202,2022/7/15 21:10,15,61,-46,-102
202,2022/7/15 21:20,13,65,-52,-87
202,2022/7/15 21:30,13,45,-32,-84
202,2022/7/15 21:40,10,48,-38,-99
202,2022/7/15 21:50,7,47,-40,-73
202,2022/7/15 22:00,9,40,-31,-86
202,2022/7/15 22:10,4,51,-47,-86
202,2022/7/15 22:20,2,40,-38,-88
202,2022/7/15 22:30,0,40,-40,-72
202,2022/7/15 22:40,0,3,-3,-6
202,2022/7/15 22:50,0,3,-3,-6
203,2022/7/15 5:00,0,1,-1,-3
203,2022/7/15 5:10,0,1,-1,-3
203,2022/7/15 5:20,0,1,-1,-3
203,2022/7/15 5:30,0,1,-1,-3
203,2022/7/15 5:40,0,1,-1,-2
203,2022/7/15 5:50,9,1,8,13
203,2022/7/15 6:00,26,1,25,35
203,2022/7/15 6:10,47,32,15,41
203,2022/7/15 6:20,62,41,21,35
203,2022/7/15 6:30,147,53,94,115
203,2022/7/15 6:40,199,64,135,185
203,2022/7/15 6:50,253,87,166,185
203,2022/7/15 7:00,279,116,163,171
203,2022/7/15 7:10,349,178,171,214
203,2022/7/15 7:20,576,267,309,479
203,2022/7/15 7:30,598,332,266,474
203,2022/7/15 7:40,598,333,265,510
203,2022/7/15 7:50,390,196,194,396
203,2022/7/15 8:00,436,318,118,163
203,2022/7/15 8:10,357,195,162,98
203,2022/7/15 8:20,330,216,114,75
203,2022/7/15 8:30,280,318,-38,-122
203,2022/7/15 8:40,215,207,8,-184
203,2022/7/15 8:50,174,107,67,-9
203,2022/7/15 9:00,100,105,-5,-63
203,2022/7/15 9:10,74,108,-34,-122
203,2022/7/15 9:20,62,108,-46,-121
203,2022/7/15 9:30,47,97,-50,-123
203,2022/7/15 9:40,44,72,-28,-89
203,2022/7/15 9:50,36,93,-57,-108
203,2022/7/15 10:00,35,73,-38,-87
203,2022/7/15 10:10,35,70,-35,-91
203,2022/7/15 10:20,35,77,-42,-70
203,2022/7/15 10:30,37,68,-31,-93
203,2022/7/15 10:40,32,66,-34,-64
203,2022/7/15 10:50,30,76,-46,-79
203,2022/7/15 11:00,30,66,-36,-85
203,2022/7/15 11:10,36,66,-30,-56
203,2022/7/15 11:20,33,72,-39,-63
203,2022/7/15 11:30,30,69,-39,-75
203,2022/7/15 11:40,35,68,-33,-57
203,2022/7/15 11:50,34,75,-41,-76
203,2022/7/15 12:00,36,67,-31,-72
203,2022/7/15 12:10,33,64,-31,-59
203,2022/7/15 12:20,38,84,-46,-87
203,2022/7/15 12:30,32,73,-41,-100
203,2022/7/15 12:40,35,70,-35,-78
203,2022/7/15 12:50,31,82,-51,-99
203,2022/7/15 13:00,28,68,-40,-110
203,2022/7/15 13:10,33,60,-27,-67
203,2022/7/15 13:20,33,87,-54,-106
203,2022/7/15 13:30,29,74,-45,-113
203,2022/7/15 13:40,32,67,-35,-81
203,2022/7/15 13:50,26,85,-59,-113
203,2022/7/15 14:00,35,84,-49,-113
203,2022/7/15 14:10,28,63,-35,-84
203,2022/7/15 14:20,29,83,-54,-94
203,2022/7/15 14:30,32,82,-50,-110
203,2022/7/15 14:40,32,67,-35,-73
203,2022/7/15 14:50,27,91,-64,-111
203,2022/7/15 15:00,31,77,-46,-100
203,2022/7/15 15:10,28,67,-39,-82
203,2022/7/15 15:20,35,93,-58,-105
203,2022/7/15 15:30,35,79,-44,-109
203,2022/7/15 15:40,35,84,-49,-106
203,2022/7/15 15:50,34,106,-72,-126
203,2022/7/15 16:00,43,96,-53,-119
203,2022/7/15 16:10,61,87,-26,-86
203,2022/7/15 16:20,45,108,-63,-135
203,2022/7/15 16:30,93,105,-12,-92
203,2022/7/15 16:40,316,108,208,186
203,2022/7/15 16:50,334,102,232,206
203,2022/7/15 17:00,165,125,40,44
203,2022/7/15 17:10,274,122,152,204
203,2022/7/15 17:20,234,118,116,161
203,2022/7/15 17:30,198,127,71,82
203,2022/7/15 17:40,268,149,119,175
203,2022/7/15 17:50,276,190,86,122
203,2022/7/15 18:00,208,178,30,-42
203,2022/7/15 18:10,105,198,-93,-94
203,2022/7/15 18:20,76,214,-138,-260
203,2022/7/15 18:30,50,223,-173,-301
203,2022/7/15 18:40,48,215,-167,-312
203,2022/7/15 18:50,40,228,-188,-346
203,2022/7/15 19:00,29,223,-194,-368
203,2022/7/15 19:10,35,178,-143,-309
203,2022/7/15 19:20,30,192,-162,-338
203,2022/7/15 19:30,25,109,-84,-244
203,2022/7/15 19:40,35,121,-86,-207
203,2022/7/15 19:50,24,125,-101,-225
203,2022/7/15 20:00,26,102,-76,-188
203,2022/7/15 20:10,27,106,-79,-176
203,2022/7/15 20:20,25,107,-82,-182
203,2022/7/15 20:30,25,98,-73,-171
203,2022/7/15 20:40,27,94,-67,-153
203,2022/7/15 20:50,20,92,-72,-159
203,2022/7/15 21:00,23,106,-83,-173
203,2022/7/15 21:10,23,103,-80,-182
203,2022/7/15 21:20,17,75,-58,-145
203,2022/7/15 21:30,19,100,-81,-165
203,2022/7/15 21:40,18,91,-73,-172
203,2022/7/15 21:50,11,71,-60,-133
203,2022/7/15 22:00,10,110,-100,-186
203,2022/7/15 22:10,6,79,-73,-159
203,2022/7/15 22:20,4,84,-80,-168
203,2022/7/15 22:30,1,77,-76,-148
203,2022/7/15 22:40,0,10,-10,-16
203,2022/7/15 22:50,0,3,-3,-9
194,2022/7/15 5:00,0,1,-1,-4
194,2022/7/15 5:10,0,1,-1,-4
194,2022/7/15 5:20,0,1,-1,-4
194,2022/7/15 5:30,0,1,-1,-4
194,2022/7/15 5:40,0,1,-1,-3
194,2022/7/15 5:50,17,1,16,29
194,2022/7/15 6:00,33,1,32,67
194,2022/7/15 6:10,57,23,34,75
194,2022/7/15 6:20,77,33,44,79
194,2022/7/15 6:30,127,36,91,206
194,2022/7/15 6:40,183,43,140,325
194,2022/7/15 6:50,201,63,138,323
194,2022/7/15 7:00,280,65,215,386
194,2022/7/15 7:10,300,77,223,437
194,2022/7/15 7:20,365,104,261,740
194,2022/7/15 7:30,390,105,285,759
194,2022/7/15 7:40,365,108,257,767
194,2022/7/15 7:50,364,97,267,663
194,2022/7/15 8:00,336,122,214,377
194,2022/7/15 8:10,343,126,217,315
194,2022/7/15 8:20,317,125,192,267
194,2022/7/15 8:30,269,111,158,36
194,2022/7/15 8:40,187,105,82,-102
194,2022/7/15 8:50,106,105,1,-8
194,2022/7/15 9:00,100,77,23,-40
194,2022/7/15 9:10,67,76,-9,-131
194,2022/7/15 9:20,48,63,-15,-136
194,2022/7/15 9:30,48,61,-13,-136
194,2022/7/15 9:40,40,72,-32,-121
194,2022/7/15 9:50,39,64,-25,-133
194,2022/7/15 10:00,33,60,-27,-114
194,2022/7/15 10:10,37,63,-26,-117
194,2022/7/15 10:20,31,62,-31,-101
194,2022/7/15 10:30,30,65,-35,-128
194,2022/7/15 10:40,27,64,-37,-101
194,2022/7/15 10:50,29,46,-17,-96
194,2022/7/15 11:00,26,67,-41,-126
194,2022/7/15 11:10,31,66,-35,-91
194,2022/7/15 11:20,31,54,-23,-86
194,2022/7/15 11:30,26,70,-44,-119
194,2022/7/15 11:40,26,63,-37,-94
194,2022/7/15 11:50,36,48,-12,-88
194,2022/7/15 12:00,32,63,-31,-103
194,2022/7/15 12:10,35,63,-28,-87
194,2022/7/15 12:20,29,49,-20,-107
194,2022/7/15 12:30,35,60,-25,-125
194,2022/7/15 12:40,26,61,-35,-113
194,2022/7/15 12:50,35,47,-12,-111
194,2022/7/15 13:00,26,64,-38,-148
194,2022/7/15 13:10,23,64,-41,-108
194,2022/7/15 13:20,28,54,-26,-132
194,2022/7/15 13:30,26,71,-45,-158
194,2022/7/15 13:40,25,61,-36,-117
194,2022/7/15 13:50,26,49,-23,-136
194,2022/7/15 14:00,27,70,-43,-156
194,2022/7/15 14:10,25,69,-44,-128
194,2022/7/15 14:20,31,50,-19,-113
194,2022/7/15 14:30,24,63,-39,-149
194,2022/7/15 14:40,25,66,-41,-114
194,2022/7/15 14:50,29,58,-29,-140
194,2022/7/15 15:00,23,74,-51,-151
194,2022/7/15 15:10,26,64,-38,-120
194,2022/7/15 15:20,24,60,-36,-141
194,2022/7/15 15:30,31,75,-44,-153
194,2022/7/15 15:40,28,73,-45,-151
194,2022/7/15 15:50,31,61,-30,-156
194,2022/7/15 16:00,28,76,-48,-167
194,2022/7/15 16:10,30,93,-63,-149
194,2022/7/15 16:20,36,78,-42,-177
194,2022/7/15 16:30,42,91,-49,-141
194,2022/7/15 16:40,47,105,-58,128
194,2022/7/15 16:50,40,93,-53,153
194,2022/7/15 17:00,44,103,-59,-15
194,2022/7/15 17:10,74,101,-27,177
194,2022/7/15 17:20,67,121,-54,107
194,2022/7/15 17:30,88,123,-35,47
194,2022/7/15 17:40,169,127,42,217
194,2022/7/15 17:50,71,118,-47,75
194,2022/7/15 18:00,51,145,-94,-136
194,2022/7/15 18:10,48,144,-96,-190
194,2022/7/15 18:20,40,182,-142,-402
194,2022/7/15 18:30,28,139,-111,-412
194,2022/7/15 18:40,26,169,-143,-455
194,2022/7/15 18:50,27,181,-154,-500
194,2022/7/15 19:00,26,147,-121,-489
194,2022/7/15 19:10,27,144,-117,-426
194,2022/7/15 19:20,25,116,-91,-429
194,2022/7/15 19:30,27,105,-78,-322
194,2022/7/15 19:40,23,109,-86,-293
194,2022/7/15 19:50,20,109,-89,-314
194,2022/7/15 20:00,22,107,-85,-273
194,2022/7/15 20:10,21,100,-79,-255
194,2022/7/15 20:20,15,102,-87,-269
194,2022/7/15 20:30,20,95,-75,-246
194,2022/7/15 20:40,17,82,-65,-218
194,2022/7/15 20:50,13,94,-81,-240
194,2022/7/15 21:00,22,74,-52,-225
194,2022/7/15 21:10,13,99,-86,-268
194,2022/7/15 21:20,16,85,-69,-214
194,2022/7/15 21:30,10,75,-65,-230
194,2022/7/15 21:40,10,77,-67,-239
194,2022/7/15 21:50,10,77,-67,-200
194,2022/7/15 22:00,6,64,-58,-244
194,2022/7/15 22:10,2,94,-92,-251
194,2022/7/15 22:20,1,67,-66,-234
194,2022/7/15 22:30,1,69,-68,-216
194,2022/7/15 22:40,0,38,-38,-54
194,2022/7/15 22:50,0,3,-3,-12
198,2022/7/15 5:00,0,1,-1,-5
198,2022/7/15 5:10,0,1,-1,-5
198,2022/7/15 5:20,0,1,-1,-5
198,2022/7/15 5:30,0,1,-1,-5
198,2022/7/15 5:40,0,1,-1,-4
198,2022/7/15 5:50,13,1,12,41
198,2022/7/15 6:00,29,1,28,95
198,2022/7/15 6:10,31,21,10,85
198,2022/7/15 6:20,36,28,8,87
198,2022/7/15 6:30,53,37,16,222
198,2022/7/15 6:40,86,41,45,370
198,2022/7/15 6:50,113,62,51,374
198,2022/7/15 7:00,149,72,77,463
198,2022/7/15 7:10,224,87,137,574
198,2022/7/15 7:20,232,104,128,868
198,2022/7/15 7:30,283,102,181,940
198,2022/7/15 7:40,286,120,166,933
198,2022/7/15 7:50,235,123,112,775
198,2022/7/15 8:00,220,127,93,470
198,2022/7/15 8:10,207,118,89,404
198,2022/7/15 8:20,166,107,59,326
198,2022/7/15 8:30,123,105,18,54
198,2022/7/15 8:40,67,95,-28,-130
198,2022/7/15 8:50,51,106,-55,-63
198,2022/7/15 9:00,39,75,-36,-76
198,2022/7/15 9:10,32,49,-17,-148
198,2022/7/15 9:20,34,74,-40,-176
198,2022/7/15 9:30,27,61,-34,-170
198,2022/7/15 9:40,26,69,-43,-164
198,2022/7/15 9:50,25,72,-47,-180
198,2022/7/15 10:00,24,60,-36,-150
198,2022/7/15 10:10,23,49,-26,-143
198,2022/7/15 10:20,22,65,-43,-144
198,2022/7/15 10:30,21,46,-25,-153
198,2022/7/15 10:40,22,51,-29,-130
198,2022/7/15 10:50,19,65,-46,-142
198,2022/7/15 11:00,17,61,-44,-170
198,2022/7/15 11:10,21,50,-29,-120
198,2022/7/15 11:20,19,63,-44,-130
198,2022/7/15 11:30,22,45,-23,-142
198,2022/7/15 11:40,24,61,-37,-131
198,2022/7/15 11:50,19,62,-43,-131
198,2022/7/15 12:00,22,59,-37,-140
198,2022/7/15 12:10,21,48,-27,-114
198,2022/7/15 12:20,21,62,-41,-148
198,2022/7/15 12:30,22,51,-29,-154
198,2022/7/15 12:40,22,61,-39,-152
198,2022/7/15 12:50,19,62,-43,-154
198,2022/7/15 13:00,21,52,-31,-179
198,2022/7/15 13:10,22,64,-42,-150
198,2022/7/15 13:20,26,68,-42,-174
198,2022/7/15 13:30,22,51,-29,-187
198,2022/7/15 13:40,22,54,-32,-149
198,2022/7/15 13:50,24,61,-37,-173
198,2022/7/15 14:00,22,51,-29,-185
198,2022/7/15 14:10,23,52,-29,-157
198,2022/7/15 14:20,22,73,-51,-164
198,2022/7/15 14:30,21,53,-32,-181
198,2022/7/15 14:40,23,66,-43,-157
198,2022/7/15 14:50,21,67,-46,-186
198,2022/7/15 15:00,22,55,-33,-184
198,2022/7/15 15:10,24,65,-41,-161
198,2022/7/15 15:20,20,70,-50,-191
198,2022/7/15 15:30,22,60,-38,-191
198,2022/7/15 15:40,23,60,-37,-188
198,2022/7/15 15:50,25,82,-57,-213
198,2022/7/15 16:00,35,63,-28,-195
198,2022/7/15 16:10,32,71,-39,-188
198,2022/7/15 16:20,24,93,-69,-246
198,2022/7/15 16:30,28,77,-49,-190
198,2022/7/15 16:40,34,76,-42,86
198,2022/7/15 16:50,27,93,-66,87
198,2022/7/15 17:00,35,105,-70,-85
198,2022/7/15 17:10,67,108,-41,136
198,2022/7/15 17:20,54,105,-51,56
198,2022/7/15 17:30,40,107,-67,-20
198,2022/7/15 17:40,53,109,-56,161
198,2022/7/15 17:50,41,97,-56,19
198,2022/7/15 18:00,36,121,-85,-221
198,2022/7/15 18:10,35,111,-76,-266
198,2022/7/15 18:20,26,110,-84,-486
198,2022/7/15 18:30,27,109,-82,-494
198,2022/7/15 18:40,26,121,-95,-550
198,2022/7/15 18:50,23,124,-101,-601
198,2022/7/15 19:00,25,119,-94,-583
198,2022/7/15 19:10,18,133,-115,-541
198,2022/7/15 19:20,21,107,-86,-515
198,2022/7/15 19:30,14,122,-108,-430
198,2022/7/15 19:40,20,126,-106,-399
198,2022/7/15 19:50,15,102,-87,-401
198,2022/7/15 20:00,13,99,-86,-359
198,2022/7/15 20:10,16,100,-84,-339
198,2022/7/15 20:20,14,98,-84,-353
198,2022/7/15 20:30,14,76,-62,-308
198,2022/7/15 20:40,15,79,-64,-282
198,2022/7/15 20:50,14,64,-50,-290
198,2022/7/15 21:00,16,95,-79,-304
198,2022/7/15 21:10,12,79,-67,-335
198,2022/7/15 21:20,10,67,-57,-271
198,2022/7/15 21:30,8,92,-84,-314
198,2022/7/15 21:40,8,63,-55,-294
198,2022/7/15 21:50,7,62,-55,-255
198,2022/7/15 22:00,4,77,-73,-317
198,2022/7/15 22:10,2,71,-69,-320
198,2022/7/15 22:20,1,72,-71,-305
198,2022/7/15 22:30,1,72,-71,-287
198,2022/7/15 22:40,0,49,-49,-103
198,2022/7/15 22:50,0,3,-3,-15
196,2022/7/15 5:00,0,1,-1,-6
196,2022/7/15 5:10,0,1,-1,-6
196,2022/7/15 5:20,0,1,-1,-6
196,2022/7/15 5:30,0,1,-1,-6
196,2022/7/15 5:40,0,1,-1,-5
196,2022/7/15 5:50,25,1,24,65
196,2022/7/15 6:00,53,5,48,143
196,2022/7/15 6:10,58,33,25,110
196,2022/7/15 6:20,91,38,53,140
196,2022/7/15 6:30,147,76,71,293
196,2022/7/15 6:40,225,77,148,518
196,2022/7/15 6:50,281,108,173,547
196,2022/7/15 7:00,348,93,255,718
196,2022/7/15 7:10,596,114,482,1056
196,2022/7/15 7:20,629,123,506,1374
196,2022/7/15 7:30,722,146,576,1516
196,2022/7/15 7:40,722,184,538,1471
196,2022/7/15 7:50,722,145,577,1352
196,2022/7/15 8:00,599,144,455,925
196,2022/7/15 8:10,601,179,422,826
196,2022/7/15 8:20,376,153,223,549
196,2022/7/15 8:30,279,153,126,180
196,2022/7/15 8:40,227,121,106,-24
196,2022/7/15 8:50,177,116,61,-2
196,2022/7/15 9:00,142,87,55,-21
196,2022/7/15 9:10,72,103,-31,-179
196,2022/7/15 9:20,63,100,-37,-213
196,2022/7/15 9:30,55,93,-38,-208
196,2022/7/15 9:40,40,90,-50,-214
196,2022/7/15 9:50,39,72,-33,-213
196,2022/7/15 10:00,41,96,-55,-205
196,2022/7/15 10:10,27,92,-65,-208
196,2022/7/15 10:20,35,76,-41,-185
196,2022/7/15 10:30,28,75,-47,-200
196,2022/7/15 10:40,35,90,-55,-185
196,2022/7/15 10:50,26,78,-52,-194
196,2022/7/15 11:00,37,72,-35,-205
196,2022/7/15 11:10,36,87,-51,-171
196,2022/7/15 11:20,38,77,-39,-169
196,2022/7/15 11:30,36,84,-48,-190
196,2022/7/15 11:40,41,91,-50,-181
196,2022/7/15 11:50,43,76,-33,-164
196,2022/7/15 12:00,48,77,-29,-169
196,2022/7/15 12:10,40,90,-50,-164
196,2022/7/15 12:20,51,75,-24,-172
196,2022/7/15 12:30,52,73,-21,-175
196,2022/7/15 12:40,40,96,-56,-208
196,2022/7/15 12:50,42,77,-35,-189
196,2022/7/15 13:00,42,73,-31,-210
196,2022/7/15 13:10,41,98,-57,-207
196,2022/7/15 13:20,38,84,-46,-220
196,2022/7/15 13:30,34,81,-47,-234
196,2022/7/15 13:40,42,101,-59,-208
196,2022/7/15 13:50,29,81,-52,-225
196,2022/7/15 14:00,32,75,-43,-228
196,2022/7/15 14:10,28,101,-73,-230
196,2022/7/15 14:20,31,79,-48,-212
196,2022/7/15 14:30,33,76,-43,-224
196,2022/7/15 14:40,26,106,-80,-237
196,2022/7/15 14:50,33,79,-46,-232
196,2022/7/15 15:00,37,92,-55,-239
196,2022/7/15 15:10,32,110,-78,-239
196,2022/7/15 15:20,43,86,-43,-234
196,2022/7/15 15:30,40,97,-57,-248
196,2022/7/15 15:40,43,109,-66,-254
196,2022/7/15 15:50,42,109,-67,-280
196,2022/7/15 16:00,47,98,-51,-246
196,2022/7/15 16:10,53,122,-69,-257
196,2022/7/15 16:20,78,99,-21,-267
196,2022/7/15 16:30,106,99,7,-183
196,2022/7/15 16:40,195,108,87,173
196,2022/7/15 16:50,123,129,-6,81
196,2022/7/15 17:00,183,149,34,-51
196,2022/7/15 17:10,211,143,68,204
196,2022/7/15 17:20,261,178,83,139
196,2022/7/15 17:30,208,213,-5,-25
196,2022/7/15 17:40,205,197,8,169
196,2022/7/15 17:50,198,232,-34,-15
196,2022/7/15 18:00,157,208,-51,-272
196,2022/7/15 18:10,206,218,-12,-278
196,2022/7/15 18:20,170,217,-47,-533
196,2022/7/15 18:30,103,234,-131,-625
196,2022/7/15 18:40,76,233,-157,-707
196,2022/7/15 18:50,45,256,-211,-812
196,2022/7/15 19:00,35,219,-184,-767
196,2022/7/15 19:10,36,198,-162,-703
196,2022/7/15 19:20,27,208,-181,-696
196,2022/7/15 19:30,31,179,-148,-578
196,2022/7/15 19:40,25,158,-133,-532
196,2022/7/15 19:50,33,128,-95,-496
196,2022/7/15 20:00,29,111,-82,-441
196,2022/7/15 20:10,29,100,-71,-410
196,2022/7/15 20:20,28,127,-99,-452
196,2022/7/15 20:30,27,104,-77,-385
196,2022/7/15 20:40,25,107,-82,-364
196,2022/7/15 20:50,30,106,-76,-366
196,2022/7/15 21:00,24,104,-80,-384
196,2022/7/15 21:10,23,114,-91,-426
196,2022/7/15 21:20,22,123,-101,-372
196,2022/7/15 21:30,24,108,-84,-398
196,2022/7/15 21:40,18,99,-81,-375
196,2022/7/15 21:50,14,124,-110,-365
196,2022/7/15 22:00,12,103,-91,-408
196,2022/7/15 22:10,7,96,-89,-409
196,2022/7/15 22:20,2,108,-106,-411
196,2022/7/15 22:30,1,63,-62,-349
196,2022/7/15 22:40,0,102,-102,-205
196,2022/7/15 22:50,0,3,-3,-18
199,2022/7/15 5:00,0,1,-1,-7
199,2022/7/15 5:10,0,1,-1,-7
199,2022/7/15 5:20,0,1,-1,-7
199,2022/7/15 5:30,0,1,-1,-7
199,2022/7/15 5:40,0,1,-1,-6
199,2022/7/15 5:50,32,1,31,96
199,2022/7/15 6:00,55,1,54,197
199,2022/7/15 6:10,83,6,77,187
199,2022/7/15 6:20,78,25,53,193
199,2022/7/15 6:30,106,21,85,378
199,2022/7/15 6:40,187,52,135,653
199,2022/7/15 6:50,226,49,177,724
199,2022/7/15 7:00,267,81,186,904
199,2022/7/15 7:10,358,102,256,1312
199,2022/7/15 7:20,328,106,222,1596
199,2022/7/15 7:30,567,102,465,1981
199,2022/7/15 7:40,447,70,377,1848
199,2022/7/15 7:50,324,68,256,1608
199,2022/7/15 8:00,317,57,260,1185
199,2022/7/15 8:10,280,69,211,1037
199,2022/7/15 8:20,246,63,183,732
199,2022/7/15 8:30,207,72,135,315
199,2022/7/15 8:40,146,66,80,56
199,2022/7/15 8:50,83,68,15,13
199,2022/7/15 9:00,61,59,2,-19
199,2022/7/15 9:10,48,57,-9,-188
199,2022/7/15 9:20,43,52,-9,-222
199,2022/7/15 9:30,33,65,-32,-240
199,2022/7/15 9:40,30,57,-27,-241
199,2022/7/15 9:50,32,60,-28,-241
199,2022/7/15 10:00,30,62,-32,-237
199,2022/7/15 10:10,27,50,-23,-231
199,2022/7/15 10:20,28,62,-34,-219
199,2022/7/15 10:30,27,64,-37,-237
199,2022/7/15 10:40,28,54,-26,-211
199,2022/7/15 10:50,26,52,-26,-220
199,2022/7/15 11:00,28,66,-38,-243
199,2022/7/15 11:10,29,58,-29,-200
199,2022/7/15 11:20,28,51,-23,-192
199,2022/7/15 11:30,26,65,-39,-229
199,2022/7/15 11:40,28,51,-23,-204
199,2022/7/15 11:50,29,53,-24,-188
199,2022/7/15 12:00,31,62,-31,-200
199,2022/7/15 12:10,31,53,-22,-186
199,2022/7/15 12:20,33,45,-12,-184
199,2022/7/15 12:30,31,65,-34,-209
199,2022/7/15 12:40,26,50,-24,-232
199,2022/7/15 12:50,25,60,-35,-224
199,2022/7/15 13:00,26,63,-37,-247
199,2022/7/15 13:10,29,50,-21,-228
199,2022/7/15 13:20,29,61,-32,-252
199,2022/7/15 13:30,27,66,-39,-273
199,2022/7/15 13:40,27,59,-32,-240
199,2022/7/15 13:50,24,64,-40,-265
199,2022/7/15 14:00,22,63,-41,-269
199,2022/7/15 14:10,27,61,-34,-264
199,2022/7/15 14:20,22,64,-42,-254
199,2022/7/15 14:30,25,72,-47,-271
199,2022/7/15 14:40,22,53,-31,-268
199,2022/7/15 14:50,27,66,-39,-271
199,2022/7/15 15:00,28,75,-47,-286
199,2022/7/15 15:10,28,64,-36,-275
199,2022/7/15 15:20,29,65,-36,-270
199,2022/7/15 15:30,24,74,-50,-298
199,2022/7/15 15:40,24,78,-54,-308
199,2022/7/15 15:50,25,76,-51,-331
199,2022/7/15 16:00,29,87,-58,-304
199,2022/7/15 16:10,28,83,-55,-312
199,2022/7/15 16:20,26,80,-54,-321
199,2022/7/15 16:30,41,99,-58,-241
199,2022/7/15 16:40,163,112,51,224
199,2022/7/15 16:50,41,100,-59,22
199,2022/7/15 17:00,43,108,-65,-116
199,2022/7/15 17:10,41,127,-86,118
199,2022/7/15 17:20,37,110,-73,66
199,2022/7/15 17:30,30,118,-88,-113
199,2022/7/15 17:40,31,118,-87,82
199,2022/7/15 17:50,29,132,-103,-118
199,2022/7/15 18:00,24,107,-83,-355
199,2022/7/15 18:10,24,149,-125,-403
199,2022/7/15 18:20,26,128,-102,-635
199,2022/7/15 18:30,24,119,-95,-720
199,2022/7/15 18:40,22,146,-124,-831
199,2022/7/15 18:50,21,112,-91,-903
199,2022/7/15 19:00,19,109,-90,-857
199,2022/7/15 19:10,23,109,-86,-789
199,2022/7/15 19:20,19,121,-102,-798
199,2022/7/15 19:30,22,120,-98,-676
199,2022/7/15 19:40,21,114,-93,-625
199,2022/7/15 19:50,19,113,-94,-590
199,2022/7/15 20:00,21,90,-69,-510
199,2022/7/15 20:10,20,91,-71,-481
199,2022/7/15 20:20,20,82,-62,-514
199,2022/7/15 20:30,26,77,-51,-436
199,2022/7/15 20:40,20,78,-58,-422
199,2022/7/15 20:50,19,73,-54,-420
199,2022/7/15 21:00,20,69,-49,-433
199,2022/7/15 21:10,18,91,-73,-499
199,2022/7/15 21:20,18,73,-55,-427
199,2022/7/15 21:30,16,69,-53,-451
199,2022/7/15 21:40,12,77,-65,-440
199,2022/7/15 21:50,9,77,-68,-433
199,2022/7/15 22:00,7,63,-56,-464
199,2022/7/15 22:10,2,78,-76,-485
199,2022/7/15 22:20,1,55,-54,-465
199,2022/7/15 22:30,2,71,-69,-418
199,2022/7/15 22:40,0,67,-67,-272
199,2022/7/15 22:50,0,17,-17,-35
197,2022/7/15 5:00,0,1,-1,-8
197,2022/7/15 5:10,0,1,-1,-8
197,2022/7/15 5:20,0,1,-1,-8
197,2022/7/15 5:30,0,1,-1,-8
197,2022/7/15 5:40,5,1,4,-2
197,2022/7/15 5:50,29,1,28,124
197,2022/7/15 6:00,58,1,57,254
197,2022/7/15 6:10,45,1,44,231
197,2022/7/15 6:20,75,19,56,249
197,2022/7/15 6:30,81,21,60,438
197,2022/7/15 6:40,168,21,147,800
197,2022/7/15 6:50,185,48,137,861
197,2022/7/15 7:00,218,64,154,1058
197,2022/7/15 7:10,274,99,175,1487
197,2022/7/15 7:20,305,106,199,1795
197,2022/7/15 7:30,281,109,172,2153
197,2022/7/15 7:40,276,198,78,1926
197,2022/7/15 7:50,273,138,135,1743
197,2022/7/15 8:00,226,122,104,1289
197,2022/7/15 8:10,212,93,119,1156
197,2022/7/15 8:20,149,76,73,805
197,2022/7/15 8:30,78,60,18,333
197,2022/7/15 8:40,57,65,-8,48
197,2022/7/15 8:50,54,56,-2,11
197,2022/7/15 9:00,32,49,-17,-36
197,2022/7/15 9:10,28,47,-19,-207
197,2022/7/15 9:20,27,51,-24,-246
197,2022/7/15 9:30,28,49,-21,-261
197,2022/7/15 9:40,24,50,-26,-267
197,2022/7/15 9:50,26,51,-25,-266
197,2022/7/15 10:00,25,38,-13,-250
197,2022/7/15 10:10,21,40,-19,-250
197,2022/7/15 10:20,18,50,-32,-251
197,2022/7/15 10:30,22,31,-9,-246
197,2022/7/15 10:40,15,40,-25,-236
197,2022/7/15 10:50,20,46,-26,-246
197,2022/7/15 11:00,19,32,-13,-256
197,2022/7/15 11:10,17,48,-31,-231
197,2022/7/15 11:20,28,48,-20,-212
197,2022/7/15 11:30,23,38,-15,-244
197,2022/7/15 11:40,27,50,-23,-227
197,2022/7/15 11:50,25,48,-23,-211
197,2022/7/15 12:00,25,29,-4,-204
197,2022/7/15 12:10,23,45,-22,-208
197,2022/7/15 12:20,25,42,-17,-201
197,2022/7/15 12:30,23,35,-12,-221
197,2022/7/15 12:40,24,45,-21,-253
197,2022/7/15 12:50,21,49,-28,-252
197,2022/7/15 13:00,24,38,-14,-261
197,2022/7/15 13:10,20,41,-21,-249
197,2022/7/15 13:20,21,46,-25,-277
197,2022/7/15 13:30,22,37,-15,-288
197,2022/7/15 13:40,19,50,-31,-271
197,2022/7/15 13:50,22,49,-27,-292
197,2022/7/15 14:00,21,38,-17,-286
197,2022/7/15 14:10,20,45,-25,-289
197,2022/7/15 14:20,23,45,-22,-276
197,2022/7/15 14:30,22,37,-15,-286
197,2022/7/15 14:40,24,54,-30,-298
197,2022/7/15 14:50,22,54,-32,-303
197,2022/7/15 15:00,23,45,-22,-308
197,2022/7/15 15:10,24,65,-41,-316
197,2022/7/15 15:20,26,65,-39,-309
197,2022/7/15 15:30,25,48,-23,-321
197,2022/7/15 15:40,25,62,-37,-345
197,2022/7/15 15:50,62,62,0,-331
197,2022/7/15 16:00,76,57,19,-285
197,2022/7/15 16:10,33,65,-32,-344
197,2022/7/15 16:20,28,84,-56,-377
197,2022/7/15 16:30,53,62,-9,-250
197,2022/7/15 16:40,149,63,86,310
197,2022/7/15 16:50,75,77,-2,20
197,2022/7/15 17:00,46,80,-34,-150
197,2022/7/15 17:10,44,93,-49,69
197,2022/7/15 17:20,41,100,-59,7
197,2022/7/15 17:30,44,102,-58,-171
197,2022/7/15 17:40,40,108,-68,14
197,2022/7/15 17:50,27,112,-85,-203
197,2022/7/15 18:00,30,90,-60,-415
197,2022/7/15 18:10,34,101,-67,-470
197,2022/7/15 18:20,24,108,-84,-719
197,2022/7/15 18:30,26,123,-97,-817
197,2022/7/15 18:40,23,122,-99,-930
197,2022/7/15 18:50,20,128,-108,-1011
197,2022/7/15 19:00,22,124,-102,-959
197,2022/7/15 19:10,16,89,-73,-862
197,2022/7/15 19:20,16,124,-108,-906
197,2022/7/15 19:30,14,105,-91,-767
197,2022/7/15 19:40,16,103,-87,-712
197,2022/7/15 19:50,14,97,-83,-673
197,2022/7/15 20:00,16,88,-72,-582
197,2022/7/15 20:10,16,77,-61,-542
197,2022/7/15 20:20,11,79,-68,-582
197,2022/7/15 20:30,16,71,-55,-491
197,2022/7/15 20:40,10,66,-56,-478
197,2022/7/15 20:50,9,70,-61,-481
197,2022/7/15 21:00,8,71,-63,-496
197,2022/7/15 21:10,7,50,-43,-542
197,2022/7/15 21:20,9,76,-67,-494
197,2022/7/15 21:30,5,69,-64,-515
197,2022/7/15 21:40,7,68,-61,-501
197,2022/7/15 21:50,4,63,-59,-492
197,2022/7/15 22:00,1,72,-71,-535
197,2022/7/15 22:10,0,49,-49,-534
197,2022/7/15 22:20,0,68,-68,-533
197,2022/7/15 22:30,0,64,-64,-482
197,2022/7/15 22:40,0,49,-49,-321
197,2022/7/15 22:50,0,25,-25,-60
201,2022/7/15 5:00,0,1,-1,-9
201,2022/7/15 5:10,0,1,-1,-9
201,2022/7/15 5:20,0,1,-1,-9
201,2022/7/15 5:30,0,1,-1,-9
201,2022/7/15 5:40,1,1,0,-2
201,2022/7/15 5:50,8,1,7,131
201,2022/7/15 6:00,5,1,4,258
201,2022/7/15 6:10,7,1,6,237
201,2022/7/15 6:20,8,23,-15,234
201,2022/7/15 6:30,14,35,-21,417
201,2022/7/15 6:40,17,21,-4,796
201,2022/7/15 6:50,14,38,-24,837
201,2022/7/15 7:00,20,41,-21,1037
201,2022/7/15 7:10,27,76,-49,1438
201,2022/7/15 7:20,29,76,-47,1748
201,2022/7/15 7:30,30,111,-81,2072
201,2022/7/15 7:40,26,115,-89,1837
201,2022/7/15 7:50,26,108,-82,1661
201,2022/7/15 8:00,24,120,-96,1193
201,2022/7/15 8:10,17,150,-133,1023
201,2022/7/15 8:20,15,109,-94,711
201,2022/7/15 8:30,13,106,-93,240
201,2022/7/15 8:40,17,104,-87,-39
201,2022/7/15 8:50,10,103,-93,-82
201,2022/7/15 9:00,6,93,-87,-123
201,2022/7/15 9:10,5,74,-69,-276
201,2022/7/15 9:20,5,70,-65,-311
201,2022/7/15 9:30,5,77,-72,-333
201,2022/7/15 9:40,6,51,-45,-312
201,2022/7/15 9:50,9,42,-33,-299
201,2022/7/15 10:00,7,45,-38,-288
201,2022/7/15 10:10,9,38,-29,-279
201,2022/7/15 10:20,8,23,-15,-266
201,2022/7/15 10:30,9,37,-28,-274
201,2022/7/15 10:40,10,31,-21,-257
201,2022/7/15 10:50,10,19,-9,-255
201,2022/7/15 11:00,9,25,-16,-272
201,2022/7/15 11:10,13,31,-18,-249
201,2022/7/15 11:20,9,23,-14,-226
201,2022/7/15 11:30,11,23,-12,-256
201,2022/7/15 11:40,13,23,-10,-237
201,2022/7/15 11:50,16,21,-5,-216
201,2022/7/15 12:00,14,24,-10,-214
201,2022/7/15 12:10,14,32,-18,-226
201,2022/7/15 12:20,15,21,-6,-207
201,2022/7/15 12:30,15,25,-10,-231
201,2022/7/15 12:40,15,29,-14,-267
201,2022/7/15 12:50,11,21,-10,-262
201,2022/7/15 13:00,13,32,-19,-280
201,2022/7/15 13:10,11,28,-17,-266
201,2022/7/15 13:20,10,21,-11,-288
201,2022/7/15 13:30,13,23,-10,-298
201,2022/7/15 13:40,13,33,-20,-291
201,2022/7/15 13:50,11,23,-12,-304
201,2022/7/15 14:00,13,23,-10,-296
201,2022/7/15 14:10,13,30,-17,-306
201,2022/7/15 14:20,10,13,-3,-279
201,2022/7/15 14:30,13,23,-10,-296
201,2022/7/15 14:40,15,23,-8,-306
201,2022/7/15 14:50,12,19,-7,-310
201,2022/7/15 15:00,14,23,-9,-317
201,2022/7/15 15:10,17,21,-4,-320
201,2022/7/15 15:20,14,15,-1,-310
201,2022/7/15 15:30,16,21,-5,-326
201,2022/7/15 15:40,14,23,-9,-354
201,2022/7/15 15:50,19,14,5,-326
201,2022/7/15 16:00,26,23,3,-282
201,2022/7/15 16:10,33,21,12,-332
201,2022/7/15 16:20,22,14,8,-369
201,2022/7/15 16:30,45,21,24,-226
201,2022/7/15 16:40,46,23,23,333
201,2022/7/15 16:50,49,23,26,46
201,2022/7/15 17:00,141,19,122,-28
201,2022/7/15 17:10,174,23,151,220
201,2022/7/15 17:20,198,23,175,182
201,2022/7/15 17:30,69,29,40,-131
201,2022/7/15 17:40,43,23,20,34
201,2022/7/15 17:50,31,33,-2,-205
201,2022/7/15 18:00,26,27,-1,-416
201,2022/7/15 18:10,22,38,-16,-486
201,2022/7/15 18:20,20,36,-16,-735
201,2022/7/15 18:30,20,33,-13,-830
201,2022/7/15 18:40,18,32,-14,-944
201,2022/7/15 18:50,14,31,-17,-1028
201,2022/7/15 19:00,15,33,-18,-977
201,2022/7/15 19:10,15,45,-30,-892
201,2022/7/15 19:20,14,33,-19,-925
201,2022/7/15 19:30,12,33,-21,-788
201,2022/7/15 19:40,12,33,-21,-733
201,2022/7/15 19:50,11,31,-20,-693
201,2022/7/15 20:00,18,32,-14,-596
201,2022/7/15 20:10,25,22,3,-539
201,2022/7/15 20:20,10,21,-11,-593
201,2022/7/15 20:30,7,23,-16,-507
201,2022/7/15 20:40,6,21,-15,-493
201,2022/7/15 20:50,7,23,-16,-497
201,2022/7/15 21:00,11,10,1,-495
201,2022/7/15 21:10,6,23,-17,-559
201,2022/7/15 21:20,3,22,-19,-513
201,2022/7/15 21:30,2,15,-13,-528
201,2022/7/15 21:40,1,23,-22,-523
201,2022/7/15 21:50,1,23,-22,-514
201,2022/7/15 22:00,1,13,-12,-547
201,2022/7/15 22:10,0,19,-19,-553
201,2022/7/15 22:20,0,25,-25,-558
201,2022/7/15 22:30,0,18,-18,-500
201,2022/7/15 22:40,0,23,-23,-344
201,2022/7/15 22:50,0,7,-7,-67
200,2022/7/15 5:00,0,1,-1,-10
200,2022/7/15 5:10,0,1,-1,-10
200,2022/7/15 5:20,0,1,-1,-10
200,2022/7/15 5:30,0,1,-1,-10
200,2022/7/15 5:40,19,1,18,16
200,2022/7/15 5:50,37,1,36,167
200,2022/7/15 6:00,26,1,25,283
200,2022/7/15 6:10,32,1,31,268
200,2022/7/15 6:20,34,21,13,247
200,2022/7/15 6:30,38,23,15,432
200,2022/7/15 6:40,47,49,-2,794
200,2022/7/15 6:50,59,61,-2,835
200,2022/7/15 7:00,79,108,-29,1008
200,2022/7/15 7:10,145,69,76,1514
200,2022/7/15 7:20,149,93,56,1804
200,2022/7/15 7:30,128,121,7,2079
200,2022/7/15 7:40,128,96,32,1869
200,2022/7/15 7:50,83,105,-22,1639
200,2022/7/15 8:00,86,124,-38,1155
200,2022/7/15 8:10,60,105,-45,978
200,2022/7/15 8:20,55,110,-55,656
200,2022/7/15 8:30,44,108,-64,176
200,2022/7/15 8:40,31,120,-89,-128
200,2022/7/15 8:50,25,97,-72,-154
200,2022/7/15 9:00,27,87,-60,-183
200,2022/7/15 9:10,24,83,-59,-335
200,2022/7/15 9:20,26,70,-44,-355
200,2022/7/15 9:30,23,78,-55,-388
200,2022/7/15 9:40,23,69,-46,-358
200,2022/7/15 9:50,20,67,-47,-346
200,2022/7/15 10:00,20,67,-47,-335
200,2022/7/15 10:10,22,55,-33,-312
200,2022/7/15 10:20,25,65,-40,-306
200,2022/7/15 10:30,17,54,-37,-311
200,2022/7/15 10:40,23,42,-19,-276
200,2022/7/15 10:50,22,54,-32,-287
200,2022/7/15 11:00,22,49,-27,-299
200,2022/7/15 11:10,20,33,-13,-262
200,2022/7/15 11:20,21,46,-25,-251
200,2022/7/15 11:30,22,41,-19,-275
200,2022/7/15 11:40,21,32,-11,-248
200,2022/7/15 11:50,23,47,-24,-240
200,2022/7/15 12:00,21,47,-26,-240
200,2022/7/15 12:10,24,25,-1,-227
200,2022/7/15 12:20,24,45,-21,-228
200,2022/7/15 12:30,20,42,-22,-253
200,2022/7/15 12:40,25,31,-6,-273
200,2022/7/15 12:50,21,45,-24,-286
200,2022/7/15 13:00,22,41,-19,-299
200,2022/7/15 13:10,20,28,-8,-274
200,2022/7/15 13:20,20,41,-21,-309
200,2022/7/15 13:30,15,44,-29,-327
200,2022/7/15 13:40,17,29,-12,-303
200,2022/7/15 13:50,16,41,-25,-329
200,2022/7/15 14:00,15,38,-23,-319
200,2022/7/15 14:10,16,31,-15,-321
200,2022/7/15 14:20,18,42,-24,-303
200,2022/7/15 14:30,15,40,-25,-321
200,2022/7/15 14:40,14,23,-9,-315
200,2022/7/15 14:50,18,47,-29,-339
200,2022/7/15 15:00,16,46,-30,-347
200,2022/7/15 15:10,17,35,-18,-338
200,2022/7/15 15:20,20,44,-24,-334
200,2022/7/15 15:30,23,44,-21,-347
200,2022/7/15 15:40,21,31,-10,-364
200,2022/7/15 15:50,25,51,-26,-352
200,2022/7/15 16:00,68,61,7,-275
200,2022/7/15 16:10,32,47,-15,-347
200,2022/7/15 16:20,35,62,-27,-396
200,2022/7/15 16:30,35,42,-7,-233
200,2022/7/15 16:40,46,74,-28,305
200,2022/7/15 16:50,64,62,2,48
200,2022/7/15 17:00,45,68,-23,-51
200,2022/7/15 17:10,47,73,-26,194
200,2022/7/15 17:20,37,73,-36,146
200,2022/7/15 17:30,53,76,-23,-154
200,2022/7/15 17:40,42,80,-38,-4
200,2022/7/15 17:50,26,81,-55,-260
200,2022/7/15 18:00,29,92,-63,-479
200,2022/7/15 18:10,29,95,-66,-552
200,2022/7/15 18:20,24,95,-71,-806
200,2022/7/15 18:30,20,80,-60,-890
200,2022/7/15 18:40,17,91,-74,-1018
200,2022/7/15 18:50,13,93,-80,-1108
200,2022/7/15 19:00,17,78,-61,-1038
200,2022/7/15 19:10,13,99,-86,-978
200,2022/7/15 19:20,13,81,-68,-993
200,2022/7/15 19:30,12,76,-64,-852
200,2022/7/15 19:40,8,77,-69,-802
200,2022/7/15 19:50,9,75,-66,-759
200,2022/7/15 20:00,9,73,-64,-660
200,2022/7/15 20:10,11,67,-56,-595
200,2022/7/15 20:20,8,67,-59,-652
200,2022/7/15 20:30,13,55,-42,-549
200,2022/7/15 20:40,7,59,-52,-545
200,2022/7/15 20:50,4,64,-60,-557
200,2022/7/15 21:00,12,64,-52,-547
200,2022/7/15 21:10,7,63,-56,-615
200,2022/7/15 21:20,5,50,-45,-558
200,2022/7/15 21:30,4,62,-58,-586
200,2022/7/15 21:40,4,64,-60,-583
200,2022/7/15 21:50,2,39,-37,-551
200,2022/7/15 22:00,0,51,-51,-598
200,2022/7/15 22:10,0,63,-63,-616
200,2022/7/15 22:20,0,47,-47,-605
200,2022/7/15 22:30,0,52,-52,-552
200,2022/7/15 22:40,0,39,-39,-383
200,2022/7/15 22:50,0,49,-49,-116
210,2022/7/15 5:00,0,1,-1,-1
210,2022/7/15 5:10,7,1,6,6
210,2022/7/15 5:20,16,1,15,15
210,2022/7/15 5:30,16,1,15,15
210,2022/7/15 5:40,17,1,16,16
210,2022/7/15 5:50,24,1,23,23
210,2022/7/15 6:00,30,1,29,29
210,2022/7/15 6:10,34,1,33,33
210,2022/7/15 6:20,40,1,39,39
210,2022/7/15 6:30,47,13,34,34
210,2022/7/15 6:40,56,13,43,43
210,2022/7/15 6:50,55,19,36,36
210,2022/7/15 7:00,76,23,53,53
210,2022/7/15 7:10,93,21,72,72
210,2022/7/15 7:20,180,29,151,151
210,2022/7/15 7:30,224,23,201,201
210,2022/7/15 7:40,222,51,171,171
210,2022/7/15 7:50,216,35,181,181
210,2022/7/15 8:00,180,49,131,131
210,2022/7/15 8:10,83,68,15,15
210,2022/7/15 8:20,58,48,10,10
210,2022/7/15 8:30,45,67,-22,-22
210,2022/7/15 8:40,32,49,-17,-17
210,2022/7/15 8:50,30,38,-8,-8
210,2022/7/15 9:00,26,49,-23,-23
210,2022/7/15 9:10,24,47,-23,-23
210,2022/7/15 9:20,20,38,-18,-18
210,2022/7/15 9:30,19,46,-27,-27
210,2022/7/15 9:40,16,38,-22,-22
210,2022/7/15 9:50,16,46,-30,-30
210,2022/7/15 10:00,18,30,-12,-12
210,2022/7/15 10:10,12,35,-23,-23
210,2022/7/15 10:20,18,33,-15,-15
210,2022/7/15 10:30,15,35,-20,-20
210,2022/7/15 10:40,16,41,-25,-25
210,2022/7/15 10:50,16,38,-22,-22
210,2022/7/15 11:00,17,30,-13,-13
210,2022/7/15 11:10,16,34,-18,-18
210,2022/7/15 11:20,16,32,-16,-16
210,2022/7/15 11:30,17,25,-8,-8
210,2022/7/15 11:40,16,23,-7,-7
210,2022/7/15 11:50,16,30,-14,-14
210,2022/7/15 12:00,14,32,-18,-18
210,2022/7/15 12:10,16,48,-32,-32
210,2022/7/15 12:20,16,38,-22,-22
210,2022/7/15 12:30,15,32,-17,-17
210,2022/7/15 12:40,16,34,-18,-18
210,2022/7/15 12:50,13,37,-24,-24
210,2022/7/15 13:00,12,32,-20,-20
210,2022/7/15 13:10,14,34,-20,-20
210,2022/7/15 13:20,14,35,-21,-21
210,2022/7/15 13:30,14,39,-25,-25
210,2022/7/15 13:40,15,44,-29,-29
210,2022/7/15 13:50,12,38,-26,-26
210,2022/7/15 14:00,14,33,-19,-19
210,2022/7/15 14:10,14,38,-24,-24
210,2022/7/15 14:20,13,38,-25,-25
210,2022/7/15 14:30,13,32,-19,-19
210,2022/7/15 14:40,15,38,-23,-23
210,2022/7/15 14:50,11,31,-20,-20
210,2022/7/15 15:00,15,38,-23,-23
210,2022/7/15 15:10,16,64,-48,-48
210,2022/7/15 15:20,13,48,-35,-35
210,2022/7/15 15:30,12,45,-33,-33
210,2022/7/15 15:40,19,38,-19,-19
210,2022/7/15 15:50,15,38,-23,-23
210,2022/7/15 16:00,17,40,-23,-23
210,2022/7/15 16:10,19,47,-28,-28
210,2022/7/15 16:20,20,47,-27,-27
210,2022/7/15 16:30,19,58,-39,-39
210,2022/7/15 16:40,19,82,-63,-63
210,2022/7/15 16:50,20,55,-35,-35
210,2022/7/15 17:00,17,56,-39,-39
210,2022/7/15 17:10,29,58,-29,-29
210,2022/7/15 17:20,20,70,-50,-50
210,2022/7/15 17:30,16,76,-60,-60
210,2022/7/15 17:40,24,93,-69,-69
210,2022/7/15 17:50,20,77,-57,-57
210,2022/7/15 18:00,13,95,-82,-82
210,2022/7/15 18:10,12,77,-65,-65
210,2022/7/15 18:20,11,78,-67,-67
210,2022/7/15 18:30,10,78,-68,-68
210,2022/7/15 18:40,11,99,-88,-88
210,2022/7/15 18:50,10,101,-91,-91
210,2022/7/15 19:00,9,94,-85,-85
210,2022/7/15 19:10,7,124,-117,-117
210,2022/7/15 19:20,7,89,-82,-82
210,2022/7/15 19:30,6,78,-72,-72
210,2022/7/15 19:40,7,81,-74,-74
210,2022/7/15 19:50,4,78,-74,-74
210,2022/7/15 20:00,7,71,-64,-64
210,2022/7/15 20:10,4,69,-65,-65
210,2022/7/15 20:20,4,64,-60,-60
210,2022/7/15 20:30,5,72,-67,-67
210,2022/7/15 20:40,5,62,-57,-57
210,2022/7/15 20:50,4,53,-49,-49
210,2022/7/15 21:00,5,49,-44,-44
210,2022/7/15 21:10,4,49,-45,-45
210,2022/7/15 21:20,4,56,-52,-52
210,2022/7/15 21:30,4,51,-47,-47
210,2022/7/15 21:40,2,66,-64,-64
210,2022/7/15 21:50,2,47,-45,-45
210,2022/7/15 22:00,1,56,-55,-55
210,2022/7/15 22:10,1,34,-33,-33
210,2022/7/15 22:20,2,52,-50,-50
210,2022/7/15 22:30,0,49,-49,-49
210,2022/7/15 22:40,0,33,-33,-33
210,2022/7/15 22:50,0,46,-46,-46
224,2022/7/15 5:00,0,1,-1,-2
224,2022/7/15 5:10,3,1,2,8
224,2022/7/15 5:20,14,1,13,28
224,2022/7/15 5:30,16,2,14,29
224,2022/7/15 5:40,18,1,17,33
224,2022/7/15 5:50,20,1,19,42
224,2022/7/15 6:00,25,1,24,53
224,2022/7/15 6:10,33,1,32,65
224,2022/7/15 6:20,35,1,34,73
224,2022/7/15 6:30,38,45,-7,27
224,2022/7/15 6:40,45,72,-27,16
224,2022/7/15 6:50,49,97,-48,-12
224,2022/7/15 7:00,69,112,-43,10
224,2022/7/15 7:10,85,76,9,81
224,2022/7/15 7:20,104,71,33,184
224,2022/7/15 7:30,155,63,92,293
224,2022/7/15 7:40,162,71,91,262
224,2022/7/15 7:50,152,68,84,265
224,2022/7/15 8:00,90,95,-5,126
224,2022/7/15 8:10,59,105,-46,-31
224,2022/7/15 8:20,52,115,-63,-53
224,2022/7/15 8:30,50,126,-76,-98
224,2022/7/15 8:40,36,104,-68,-85
224,2022/7/15 8:50,29,119,-90,-98
224,2022/7/15 9:00,23,109,-86,-109
224,2022/7/15 9:10,21,112,-91,-114
224,2022/7/15 9:20,23,88,-65,-83
224,2022/7/15 9:30,23,75,-52,-79
224,2022/7/15 9:40,20,68,-48,-70
224,2022/7/15 9:50,21,57,-36,-66
224,2022/7/15 10:00,19,60,-41,-53
224,2022/7/15 10:10,21,69,-48,-71
224,2022/7/15 10:20,17,51,-34,-49
224,2022/7/15 10:30,18,54,-36,-56
224,2022/7/15 10:40,21,45,-24,-49
224,2022/7/15 10:50,19,38,-19,-41
224,2022/7/15 11:00,20,40,-20,-33
224,2022/7/15 11:10,23,46,-23,-41
224,2022/7/15 11:20,20,40,-20,-36
224,2022/7/15 11:30,22,47,-25,-33
224,2022/7/15 11:40,21,51,-30,-37
224,2022/7/15 11:50,20,38,-18,-32
224,2022/7/15 12:00,25,39,-14,-32
224,2022/7/15 12:10,25,42,-17,-49
224,2022/7/15 12:20,21,38,-17,-39
224,2022/7/15 12:30,21,45,-24,-41
224,2022/7/15 12:40,20,41,-21,-39
224,2022/7/15 12:50,16,46,-30,-54
224,2022/7/15 13:00,17,50,-33,-53
224,2022/7/15 13:10,23,73,-50,-70
224,2022/7/15 13:20,20,52,-32,-53
224,2022/7/15 13:30,23,49,-26,-51
224,2022/7/15 13:40,20,50,-30,-59
224,2022/7/15 13:50,23,48,-25,-51
224,2022/7/15 14:00,21,51,-30,-49
224,2022/7/15 14:10,24,47,-23,-47
224,2022/7/15 14:20,23,50,-27,-52
224,2022/7/15 14:30,25,59,-34,-53
224,2022/7/15 14:40,22,59,-37,-60
224,2022/7/15 14:50,25,51,-26,-46
224,2022/7/15 15:00,27,47,-20,-43
224,2022/7/15 15:10,28,41,-13,-61
224,2022/7/15 15:20,25,48,-23,-58
224,2022/7/15 15:30,28,51,-23,-56
224,2022/7/15 15:40,22,49,-27,-46
224,2022/7/15 15:50,26,41,-15,-38
224,2022/7/15 16:00,28,65,-37,-60
224,2022/7/15 16:10,35,59,-24,-52
224,2022/7/15 16:20,46,42,4,-23
224,2022/7/15 16:30,55,61,-6,-45
224,2022/7/15 16:40,64,54,10,-53
224,2022/7/15 16:50,76,57,19,-16
224,2022/7/15 17:00,84,65,19,-20
224,2022/7/15 17:10,87,61,26,-3
224,2022/7/15 17:20,64,97,-33,-83
224,2022/7/15 17:30,79,70,9,-51
224,2022/7/15 17:40,113,79,34,-35
224,2022/7/15 17:50,71,77,-6,-63
224,2022/7/15 18:00,39,75,-36,-118
224,2022/7/15 18:10,37,78,-41,-106
224,2022/7/15 18:20,30,108,-78,-145
224,2022/7/15 18:30,27,107,-80,-148
224,2022/7/15 18:40,24,92,-68,-156
224,2022/7/15 18:50,21,76,-55,-146
224,2022/7/15 19:00,20,95,-75,-160
224,2022/7/15 19:10,18,78,-60,-177
224,2022/7/15 19:20,16,77,-61,-143
224,2022/7/15 19:30,14,77,-63,-135
224,2022/7/15 19:40,14,67,-53,-127
224,2022/7/15 19:50,12,73,-61,-135
224,2022/7/15 20:00,10,71,-61,-125
224,2022/7/15 20:10,10,63,-53,-118
224,2022/7/15 20:20,12,54,-42,-102
224,2022/7/15 20:30,12,48,-36,-103
224,2022/7/15 20:40,10,50,-40,-97
224,2022/7/15 20:50,10,49,-39,-88
224,2022/7/15 21:00,8,48,-40,-84
224,2022/7/15 21:10,9,40,-31,-76
224,2022/7/15 21:20,6,62,-56,-108
224,2022/7/15 21:30,7,55,-48,-95
224,2022/7/15 21:40,4,49,-45,-109
224,2022/7/15 21:50,2,41,-39,-84
224,2022/7/15 22:00,3,51,-48,-103
224,2022/7/15 22:10,3,47,-44,-77
224,2022/7/15 22:20,2,40,-38,-88
224,2022/7/15 22:30,0,51,-51,-100
224,2022/7/15 22:40,0,41,-41,-74
224,2022/7/15 22:50,0,26,-26,-72
213,2022/7/15 5:00,0,1,-1,-3
213,2022/7/15 5:10,6,1,5,13
213,2022/7/15 5:20,18,1,17,45
213,2022/7/15 5:30,16,1,15,44
213,2022/7/15 5:40,19,1,18,51
213,2022/7/15 5:50,32,1,31,73
213,2022/7/15 6:00,33,1,32,85
213,2022/7/15 6:10,43,1,42,107
213,2022/7/15 6:20,54,1,53,126
213,2022/7/15 6:30,58,32,26,53
213,2022/7/15 6:40,61,31,30,46
213,2022/7/15 6:50,72,54,18,6
213,2022/7/15 7:00,92,51,41,51
213,2022/7/15 7:10,151,76,75,156
213,2022/7/15 7:20,177,72,105,289
213,2022/7/15 7:30,230,67,163,456
213,2022/7/15 7:40,224,98,126,388
213,2022/7/15 7:50,200,109,91,356
213,2022/7/15 8:00,144,110,34,160
213,2022/7/15 8:10,84,118,-34,-65
213,2022/7/15 8:20,60,120,-60,-113
213,2022/7/15 8:30,54,183,-129,-227
213,2022/7/15 8:40,42,312,-270,-355
213,2022/7/15 8:50,31,132,-101,-199
213,2022/7/15 9:00,29,104,-75,-184
213,2022/7/15 9:10,27,106,-79,-193
213,2022/7/15 9:20,26,90,-64,-147
213,2022/7/15 9:30,27,92,-65,-144
213,2022/7/15 9:40,27,75,-48,-118
213,2022/7/15 9:50,24,70,-46,-112
213,2022/7/15 10:00,23,71,-48,-101
213,2022/7/15 10:10,25,61,-36,-107
213,2022/7/15 10:20,24,60,-36,-85
213,2022/7/15 10:30,25,60,-35,-91
213,2022/7/15 10:40,22,62,-40,-89
213,2022/7/15 10:50,25,53,-28,-69
213,2022/7/15 11:00,25,72,-47,-80
213,2022/7/15 11:10,26,63,-37,-78
213,2022/7/15 11:20,27,47,-20,-56
213,2022/7/15 11:30,26,50,-24,-57
213,2022/7/15 11:40,28,59,-31,-68
213,2022/7/15 11:50,25,48,-23,-55
213,2022/7/15 12:00,24,54,-30,-62
213,2022/7/15 12:10,29,52,-23,-72
213,2022/7/15 12:20,31,53,-22,-61
213,2022/7/15 12:30,27,68,-41,-82
213,2022/7/15 12:40,25,70,-45,-84
213,2022/7/15 12:50,20,60,-40,-94
213,2022/7/15 13:00,25,61,-36,-89
213,2022/7/15 13:10,28,57,-29,-99
213,2022/7/15 13:20,28,60,-32,-85
213,2022/7/15 13:30,25,60,-35,-86
213,2022/7/15 13:40,25,59,-34,-93
213,2022/7/15 13:50,27,58,-31,-82
213,2022/7/15 14:00,25,70,-45,-94
213,2022/7/15 14:10,26,69,-43,-90
213,2022/7/15 14:20,23,59,-36,-88
213,2022/7/15 14:30,23,54,-31,-84
213,2022/7/15 14:40,23,58,-35,-95
213,2022/7/15 14:50,25,57,-32,-78
213,2022/7/15 15:00,26,61,-35,-78
213,2022/7/15 15:10,22,63,-41,-102
213,2022/7/15 15:20,24,61,-37,-95
213,2022/7/15 15:30,25,71,-46,-102
213,2022/7/15 15:40,30,72,-42,-88
213,2022/7/15 15:50,34,69,-35,-73
213,2022/7/15 16:00,35,65,-30,-90
213,2022/7/15 16:10,39,70,-31,-83
213,2022/7/15 16:20,44,72,-28,-51
213,2022/7/15 16:30,46,71,-25,-70
213,2022/7/15 16:40,45,70,-25,-78
213,2022/7/15 16:50,47,95,-48,-64
213,2022/7/15 17:00,85,86,-1,-21
213,2022/7/15 17:10,112,87,25,22
213,2022/7/15 17:20,70,74,-4,-87
213,2022/7/15 17:30,90,94,-4,-55
213,2022/7/15 17:40,217,93,124,89
213,2022/7/15 17:50,70,97,-27,-90
213,2022/7/15 18:00,48,106,-58,-176
213,2022/7/15 18:10,45,108,-63,-169
213,2022/7/15 18:20,30,111,-81,-226
213,2022/7/15 18:30,25,125,-100,-248
213,2022/7/15 18:40,28,109,-81,-237
213,2022/7/15 18:50,25,108,-83,-229
213,2022/7/15 19:00,20,110,-90,-250
213,2022/7/15 19:10,19,88,-69,-246
213,2022/7/15 19:20,18,107,-89,-232
213,2022/7/15 19:30,17,110,-93,-228
213,2022/7/15 19:40,14,98,-84,-211
213,2022/7/15 19:50,16,87,-71,-206
213,2022/7/15 20:00,15,79,-64,-189
213,2022/7/15 20:10,14,83,-69,-187
213,2022/7/15 20:20,14,72,-58,-160
213,2022/7/15 20:30,12,75,-63,-166
213,2022/7/15 20:40,11,63,-52,-149
213,2022/7/15 20:50,11,72,-61,-149
213,2022/7/15 21:00,12,78,-66,-150
213,2022/7/15 21:10,14,60,-46,-122
213,2022/7/15 21:20,12,71,-59,-167
213,2022/7/15 21:30,12,62,-50,-145
213,2022/7/15 21:40,4,60,-56,-165
213,2022/7/15 21:50,6,63,-57,-141
213,2022/7/15 22:00,4,56,-52,-155
213,2022/7/15 22:10,5,47,-42,-119
213,2022/7/15 22:20,2,64,-62,-150
213,2022/7/15 22:30,0,43,-43,-143
213,2022/7/15 22:40,0,48,-48,-122
213,2022/7/15 22:50,0,53,-53,-125
225,2022/7/15 5:00,0,1,-1,-4
225,2022/7/15 5:10,0,1,-1,12
225,2022/7/15 5:20,5,1,4,49
225,2022/7/15 5:30,10,1,9,53
225,2022/7/15 5:40,11,1,10,61
225,2022/7/15 5:50,12,1,11,84
225,2022/7/15 6:00,16,1,15,100
225,2022/7/15 6:10,20,1,19,126
225,2022/7/15 6:20,32,14,18,144
225,2022/7/15 6:30,31,16,15,68
225,2022/7/15 6:40,35,32,3,49
225,2022/7/15 6:50,45,21,24,30
225,2022/7/15 7:00,54,35,19,70
225,2022/7/15 7:10,67,62,5,161
225,2022/7/15 7:20,77,50,27,316
225,2022/7/15 7:30,101,90,11,467
225,2022/7/15 7:40,147,104,43,431
225,2022/7/15 7:50,124,120,4,360
225,2022/7/15 8:00,113,181,-68,92
225,2022/7/15 8:10,67,190,-123,-188
225,2022/7/15 8:20,45,296,-251,-364
225,2022/7/15 8:30,42,329,-287,-514
225,2022/7/15 8:40,32,327,-295,-650
225,2022/7/15 8:50,29,190,-161,-360
225,2022/7/15 9:00,26,108,-82,-266
225,2022/7/15 9:10,21,106,-85,-278
225,2022/7/15 9:20,19,102,-83,-230
225,2022/7/15 9:30,16,91,-75,-219
225,2022/7/15 9:40,20,78,-58,-176
225,2022/7/15 9:50,19,80,-61,-173
225,2022/7/15 10:00,15,70,-55,-156
225,2022/7/15 10:10,22,61,-39,-146
225,2022/7/15 10:20,19,63,-44,-129
225,2022/7/15 10:30,18,80,-62,-153
225,2022/7/15 10:40,21,69,-48,-137
225,2022/7/15 10:50,25,49,-24,-93
225,2022/7/15 11:00,24,50,-26,-106
225,2022/7/15 11:10,26,46,-20,-98
225,2022/7/15 11:20,23,47,-24,-80
225,2022/7/15 11:30,26,44,-18,-75
225,2022/7/15 11:40,28,48,-20,-88
225,2022/7/15 11:50,25,42,-17,-72
225,2022/7/15 12:00,27,57,-30,-92
225,2022/7/15 12:10,28,61,-33,-105
225,2022/7/15 12:20,26,50,-24,-85
225,2022/7/15 12:30,26,48,-22,-104
225,2022/7/15 12:40,26,50,-24,-108
225,2022/7/15 12:50,26,50,-24,-118
225,2022/7/15 13:00,22,51,-29,-118
225,2022/7/15 13:10,23,55,-32,-131
225,2022/7/15 13:20,23,59,-36,-121
225,2022/7/15 13:30,22,72,-50,-136
225,2022/7/15 13:40,24,60,-36,-129
225,2022/7/15 13:50,22,50,-28,-110
225,2022/7/15 14:00,22,47,-25,-119
225,2022/7/15 14:10,25,45,-20,-110
225,2022/7/15 14:20,25,47,-22,-110
225,2022/7/15 14:30,26,47,-21,-105
225,2022/7/15 14:40,23,40,-17,-112
225,2022/7/15 14:50,24,49,-25,-103
225,2022/7/15 15:00,27,65,-38,-116
225,2022/7/15 15:10,24,52,-28,-130
225,2022/7/15 15:20,30,47,-17,-112
225,2022/7/15 15:30,28,46,-18,-120
225,2022/7/15 15:40,26,45,-19,-107
225,2022/7/15 15:50,27,40,-13,-86
225,2022/7/15 16:00,26,40,-14,-104
225,2022/7/15 16:10,38,47,-9,-92
225,2022/7/15 16:20,29,44,-15,-66
225,2022/7/15 16:30,34,63,-29,-99
225,2022/7/15 16:40,46,49,-3,-81
225,2022/7/15 16:50,47,52,-5,-69
225,2022/7/15 17:00,77,45,32,11
225,2022/7/15 17:10,160,50,110,132
225,2022/7/15 17:20,77,50,27,-60
225,2022/7/15 17:30,235,69,166,111
225,2022/7/15 17:40,261,78,183,272
225,2022/7/15 17:50,139,64,75,-15
225,2022/7/15 18:00,55,75,-20,-196
225,2022/7/15 18:10,60,72,-12,-181
225,2022/7/15 18:20,45,75,-30,-256
225,2022/7/15 18:30,30,78,-48,-296
225,2022/7/15 18:40,22,83,-61,-298
225,2022/7/15 18:50,26,93,-67,-296
225,2022/7/15 19:00,27,104,-77,-327
225,2022/7/15 19:10,33,107,-74,-320
225,2022/7/15 19:20,35,79,-44,-276
225,2022/7/15 19:30,35,71,-36,-264
225,2022/7/15 19:40,30,82,-52,-263
225,2022/7/15 19:50,29,74,-45,-251
225,2022/7/15 20:00,24,74,-50,-239
225,2022/7/15 20:10,28,71,-43,-230
225,2022/7/15 20:20,20,75,-55,-215
225,2022/7/15 20:30,20,81,-61,-227
225,2022/7/15 20:40,18,63,-45,-194
225,2022/7/15 20:50,16,68,-52,-201
225,2022/7/15 21:00,16,55,-39,-189
225,2022/7/15 21:10,15,62,-47,-169
225,2022/7/15 21:20,11,62,-51,-218
225,2022/7/15 21:30,10,69,-59,-204
225,2022/7/15 21:40,12,46,-34,-199
225,2022/7/15 21:50,6,63,-57,-198
225,2022/7/15 22:00,6,52,-46,-201
225,2022/7/15 22:10,7,51,-44,-163
225,2022/7/15 22:20,4,40,-36,-186
225,2022/7/15 22:30,2,49,-47,-190
225,2022/7/15 22:40,0,40,-40,-162
225,2022/7/15 22:50,0,33,-33,-158
230,2022/7/15 5:00,0,1,-1,-5
230,2022/7/15 5:10,0,1,-1,11
230,2022/7/15 5:20,3,1,2,51
230,2022/7/15 5:30,12,1,11,64
230,2022/7/15 5:40,6,1,5,66
230,2022/7/15 5:50,13,1,12,96
230,2022/7/15 6:00,15,1,14,114
230,2022/7/15 6:10,22,1,21,147
230,2022/7/15 6:20,24,8,16,160
230,2022/7/15 6:30,29,8,21,89
230,2022/7/15 6:40,51,25,26,75
230,2022/7/15 6:50,47,33,14,44
230,2022/7/15 7:00,57,38,19,89
230,2022/7/15 7:10,67,38,29,190
230,2022/7/15 7:20,55,56,-1,315
230,2022/7/15 7:30,86,61,25,492
230,2022/7/15 7:40,196,63,133,564
230,2022/7/15 7:50,187,54,133,493
230,2022/7/15 8:00,123,83,40,132
230,2022/7/15 8:10,74,64,10,-178
230,2022/7/15 8:20,55,61,-6,-370
230,2022/7/15 8:30,52,60,-8,-522
230,2022/7/15 8:40,40,65,-25,-675
230,2022/7/15 8:50,30,65,-35,-395
230,2022/7/15 9:00,26,48,-22,-288
230,2022/7/15 9:10,25,49,-24,-302
230,2022/7/15 9:20,21,51,-30,-260
230,2022/7/15 9:30,16,50,-34,-253
230,2022/7/15 9:40,18,48,-30,-206
230,2022/7/15 9:50,12,41,-29,-202
230,2022/7/15 10:00,17,39,-22,-178
230,2022/7/15 10:10,11,37,-26,-172
230,2022/7/15 10:20,17,34,-17,-146
230,2022/7/15 10:30,13,34,-21,-174
230,2022/7/15 10:40,16,37,-21,-158
230,2022/7/15 10:50,13,30,-17,-110
230,2022/7/15 11:00,17,33,-16,-122
230,2022/7/15 11:10,13,33,-20,-118
230,2022/7/15 11:20,17,34,-17,-97
230,2022/7/15 11:30,13,48,-35,-110
230,2022/7/15 11:40,17,38,-21,-109
230,2022/7/15 11:50,12,37,-25,-97
230,2022/7/15 12:00,14,33,-19,-111
230,2022/7/15 12:10,16,33,-17,-122
230,2022/7/15 12:20,19,33,-14,-99
230,2022/7/15 12:30,14,32,-18,-122
230,2022/7/15 12:40,15,37,-22,-130
230,2022/7/15 12:50,14,38,-24,-142
230,2022/7/15 13:00,13,63,-50,-168
230,2022/7/15 13:10,13,44,-31,-162
230,2022/7/15 13:20,13,38,-25,-146
230,2022/7/15 13:30,12,40,-28,-164
230,2022/7/15 13:40,18,37,-19,-148
230,2022/7/15 13:50,16,36,-20,-130
230,2022/7/15 14:00,15,38,-23,-142
230,2022/7/15 14:10,13,37,-24,-134
230,2022/7/15 14:20,13,36,-23,-133
230,2022/7/15 14:30,15,55,-40,-145
230,2022/7/15 14:40,18,46,-28,-140
230,2022/7/15 14:50,13,51,-38,-141
230,2022/7/15 15:00,17,45,-28,-144
230,2022/7/15 15:10,16,42,-26,-156
230,2022/7/15 15:20,23,51,-28,-140
230,2022/7/15 15:30,17,47,-30,-150
230,2022/7/15 15:40,17,45,-28,-135
230,2022/7/15 15:50,17,51,-34,-120
230,2022/7/15 16:00,17,65,-48,-152
230,2022/7/15 16:10,16,51,-35,-127
230,2022/7/15 16:20,23,57,-34,-100
230,2022/7/15 16:30,24,56,-32,-131
230,2022/7/15 16:40,32,60,-28,-109
230,2022/7/15 16:50,24,68,-44,-113
230,2022/7/15 17:00,35,64,-29,-18
230,2022/7/15 17:10,30,87,-57,75
230,2022/7/15 17:20,23,67,-44,-104
230,2022/7/15 17:30,28,78,-50,61
230,2022/7/15 17:40,23,82,-59,213
230,2022/7/15 17:50,19,93,-74,-89
230,2022/7/15 18:00,19,89,-70,-266
230,2022/7/15 18:10,26,91,-65,-246
230,2022/7/15 18:20,22,104,-82,-338
230,2022/7/15 18:30,22,98,-76,-372
230,2022/7/15 18:40,16,104,-88,-386
230,2022/7/15 18:50,15,96,-81,-377
230,2022/7/15 19:00,13,76,-63,-390
230,2022/7/15 19:10,14,75,-61,-381
230,2022/7/15 19:20,10,64,-54,-330
230,2022/7/15 19:30,13,65,-52,-316
230,2022/7/15 19:40,13,61,-48,-311
230,2022/7/15 19:50,12,65,-53,-304
230,2022/7/15 20:00,16,72,-56,-295
230,2022/7/15 20:10,12,52,-40,-270
230,2022/7/15 20:20,13,44,-31,-246
230,2022/7/15 20:30,13,39,-26,-253
230,2022/7/15 20:40,8,42,-34,-228
230,2022/7/15 20:50,12,41,-29,-230
230,2022/7/15 21:00,10,41,-31,-220
230,2022/7/15 21:10,12,49,-37,-206
230,2022/7/15 21:20,11,54,-43,-261
230,2022/7/15 21:30,10,49,-39,-243
230,2022/7/15 21:40,8,41,-33,-232
230,2022/7/15 21:50,7,40,-33,-231
230,2022/7/15 22:00,10,40,-30,-231
230,2022/7/15 22:10,7,25,-18,-181
230,2022/7/15 22:20,3,40,-37,-223
230,2022/7/15 22:30,2,23,-21,-211
230,2022/7/15 22:40,1,41,-40,-202
230,2022/7/15 22:50,0,34,-34,-192
227,2022/7/15 5:00,0,1,-1,-6
227,2022/7/15 5:10,0,1,-1,10
227,2022/7/15 5:20,3,1,2,53
227,2022/7/15 5:30,7,1,6,70
227,2022/7/15 5:40,8,13,-5,61
227,2022/7/15 5:50,10,1,9,105
227,2022/7/15 6:00,15,2,13,127
227,2022/7/15 6:10,18,5,13,160
227,2022/7/15 6:20,24,59,-35,125
227,2022/7/15 6:30,28,49,-21,68
227,2022/7/15 6:40,25,52,-27,48
227,2022/7/15 6:50,29,60,-31,13
227,2022/7/15 7:00,55,50,5,94
227,2022/7/15 7:10,43,52,-9,181
227,2022/7/15 7:20,67,57,10,325
227,2022/7/15 7:30,86,56,30,522
227,2022/7/15 7:40,69,70,-1,563
227,2022/7/15 7:50,55,70,-15,478
227,2022/7/15 8:00,51,62,-11,121
227,2022/7/15 8:10,55,51,4,-174
227,2022/7/15 8:20,51,65,-14,-384
227,2022/7/15 8:30,43,66,-23,-545
227,2022/7/15 8:40,34,48,-14,-689
227,2022/7/15 8:50,26,67,-41,-436
227,2022/7/15 9:00,27,60,-33,-321
227,2022/7/15 9:10,23,54,-31,-333
227,2022/7/15 9:20,23,52,-29,-289
227,2022/7/15 9:30,17,54,-37,-290
227,2022/7/15 9:40,24,44,-20,-226
227,2022/7/15 9:50,20,45,-25,-227
227,2022/7/15 10:00,16,46,-30,-208
227,2022/7/15 10:10,12,40,-28,-200
227,2022/7/15 10:20,23,42,-19,-165
227,2022/7/15 10:30,9,40,-31,-205
227,2022/7/15 10:40,11,36,-25,-183
227,2022/7/15 10:50,21,38,-17,-127
227,2022/7/15 11:00,17,46,-29,-151
227,2022/7/15 11:10,9,40,-31,-149
227,2022/7/15 11:20,27,44,-17,-114
227,2022/7/15 11:30,8,45,-37,-147
227,2022/7/15 11:40,13,34,-21,-130
227,2022/7/15 11:50,19,37,-18,-115
227,2022/7/15 12:00,9,35,-26,-137
227,2022/7/15 12:10,24,40,-16,-138
227,2022/7/15 12:20,10,40,-30,-129
227,2022/7/15 12:30,12,46,-34,-156
227,2022/7/15 12:40,23,56,-33,-163
227,2022/7/15 12:50,11,43,-32,-174
227,2022/7/15 13:00,11,50,-39,-207
227,2022/7/15 13:10,24,45,-21,-183
227,2022/7/15 13:20,16,38,-22,-168
227,2022/7/15 13:30,12,43,-31,-195
227,2022/7/15 13:40,19,44,-25,-173
227,2022/7/15 13:50,20,42,-22,-152
227,2022/7/15 14:00,23,52,-29,-171
227,2022/7/15 14:10,11,63,-52,-186
227,2022/7/15 14:20,22,45,-23,-156
227,2022/7/15 14:30,18,53,-35,-180
227,2022/7/15 14:40,19,53,-34,-174
227,2022/7/15 14:50,25,57,-32,-173
227,2022/7/15 15:00,14,51,-37,-181
227,2022/7/15 15:10,19,60,-41,-197
227,2022/7/15 15:20,27,52,-25,-165
227,2022/7/15 15:30,22,61,-39,-189
227,2022/7/15 15:40,21,57,-36,-171
227,2022/7/15 15:50,20,56,-36,-156
227,2022/7/15 16:00,19,61,-42,-194
227,2022/7/15 16:10,25,56,-31,-158
227,2022/7/15 16:20,20,60,-40,-140
227,2022/7/15 16:30,25,61,-36,-167
227,2022/7/15 16:40,23,63,-40,-149
227,2022/7/15 16:50,23,66,-43,-156
227,2022/7/15 17:00,28,66,-38,-56
227,2022/7/15 17:10,23,70,-47,28
227,2022/7/15 17:20,28,59,-31,-135
227,2022/7/15 17:30,26,82,-56,5
227,2022/7/15 17:40,24,71,-47,166
227,2022/7/15 17:50,23,73,-50,-139
227,2022/7/15 18:00,22,89,-67,-333
227,2022/7/15 18:10,25,101,-76,-322
227,2022/7/15 18:20,12,76,-64,-402
227,2022/7/15 18:30,24,80,-56,-428
227,2022/7/15 18:40,21,74,-53,-439
227,2022/7/15 18:50,19,61,-42,-419
227,2022/7/15 19:00,13,66,-53,-443
227,2022/7/15 19:10,16,57,-41,-422
227,2022/7/15 19:20,7,58,-51,-381
227,2022/7/15 19:30,24,66,-42,-358
227,2022/7/15 19:40,8,67,-59,-370
227,2022/7/15 19:50,9,48,-39,-343
227,2022/7/15 20:00,13,45,-32,-327
227,2022/7/15 20:10,4,38,-34,-304
227,2022/7/15 20:20,10,39,-29,-275
227,2022/7/15 20:30,6,38,-32,-285
227,2022/7/15 20:40,6,33,-27,-255
227,2022/7/15 20:50,8,27,-19,-249
227,2022/7/15 21:00,3,40,-37,-257
227,2022/7/15 21:10,5,34,-29,-235
227,2022/7/15 21:20,5,25,-20,-281
227,2022/7/15 21:30,4,22,-18,-261
227,2022/7/15 21:40,2,25,-23,-255
227,2022/7/15 21:50,2,21,-19,-250
227,2022/7/15 22:00,1,25,-24,-255
227,2022/7/15 22:10,2,23,-21,-202
227,2022/7/15 22:20,2,21,-19,-242
227,2022/7/15 22:30,0,21,-21,-232
227,2022/7/15 22:40,0,18,-18,-220
227,2022/7/15 22:50,0,10,-10,-202
208,2022/7/15 5:00,0,1,-1,-7
208,2022/7/15 5:10,0,1,-1,9
208,2022/7/15 5:20,1,1,0,53
208,2022/7/15 5:30,15,1,14,84
208,2022/7/15 5:40,20,1,19,80
208,2022/7/15 5:50,23,1,22,127
208,2022/7/15 6:00,26,1,25,152
208,2022/7/15 6:10,33,1,32,192
208,2022/7/15 6:20,37,14,23,148
208,2022/7/15 6:30,57,23,34,102
208,2022/7/15 6:40,66,23,43,91
208,2022/7/15 6:50,78,38,40,53
208,2022/7/15 7:00,93,50,43,137
208,2022/7/15 7:10,187,64,123,304
208,2022/7/15 7:20,226,63,163,488
208,2022/7/15 7:30,280,63,217,739
208,2022/7/15 7:40,375,50,325,888
208,2022/7/15 7:50,573,51,522,1000
208,2022/7/15 8:00,599,47,552,673
208,2022/7/15 8:10,375,63,312,138
208,2022/7/15 8:20,279,51,228,-156
208,2022/7/15 8:30,223,50,173,-372
208,2022/7/15 8:40,152,52,100,-589
208,2022/7/15 8:50,87,51,36,-400
208,2022/7/15 9:00,52,52,0,-321
208,2022/7/15 9:10,36,38,-2,-335
208,2022/7/15 9:20,30,33,-3,-292
208,2022/7/15 9:30,31,35,-4,-294
208,2022/7/15 9:40,26,32,-6,-232
208,2022/7/15 9:50,28,34,-6,-233
208,2022/7/15 10:00,23,35,-12,-220
208,2022/7/15 10:10,24,38,-14,-214
208,2022/7/15 10:20,22,34,-12,-177
208,2022/7/15 10:30,22,37,-15,-220
208,2022/7/15 10:40,20,46,-26,-209
208,2022/7/15 10:50,22,37,-15,-142
208,2022/7/15 11:00,19,36,-17,-168
208,2022/7/15 11:10,21,32,-11,-160
208,2022/7/15 11:20,19,36,-17,-131
208,2022/7/15 11:30,24,39,-15,-162
208,2022/7/15 11:40,22,38,-16,-146
208,2022/7/15 11:50,19,35,-16,-131
208,2022/7/15 12:00,21,42,-21,-158
208,2022/7/15 12:10,26,47,-21,-159
208,2022/7/15 12:20,25,36,-11,-140
208,2022/7/15 12:30,21,40,-19,-175
208,2022/7/15 12:40,25,38,-13,-176
208,2022/7/15 12:50,23,37,-14,-188
208,2022/7/15 13:00,22,38,-16,-223
208,2022/7/15 13:10,20,38,-18,-201
208,2022/7/15 13:20,22,40,-18,-186
208,2022/7/15 13:30,20,46,-26,-221
208,2022/7/15 13:40,23,44,-21,-194
208,2022/7/15 13:50,22,47,-25,-177
208,2022/7/15 14:00,20,38,-18,-189
208,2022/7/15 14:10,21,42,-21,-207
208,2022/7/15 14:20,16,41,-25,-181
208,2022/7/15 14:30,14,42,-28,-208
208,2022/7/15 14:40,19,40,-21,-195
208,2022/7/15 14:50,17,47,-30,-203
208,2022/7/15 15:00,16,51,-35,-216
208,2022/7/15 15:10,17,66,-49,-246
208,2022/7/15 15:20,20,53,-33,-198
208,2022/7/15 15:30,16,50,-34,-223
208,2022/7/15 15:40,16,54,-38,-209
208,2022/7/15 15:50,14,67,-53,-209
208,2022/7/15 16:00,17,63,-46,-240
208,2022/7/15 16:10,19,66,-47,-205
208,2022/7/15 16:20,18,68,-50,-190
208,2022/7/15 16:30,26,77,-51,-218
208,2022/7/15 16:40,27,75,-48,-197
208,2022/7/15 16:50,27,82,-55,-211
208,2022/7/15 17:00,28,74,-46,-102
208,2022/7/15 17:10,23,75,-52,-24
208,2022/7/15 17:20,27,93,-66,-201
208,2022/7/15 17:30,26,107,-81,-76
208,2022/7/15 17:40,21,108,-87,79
208,2022/7/15 17:50,18,110,-92,-231
208,2022/7/15 18:00,21,117,-96,-429
208,2022/7/15 18:10,22,114,-92,-414
208,2022/7/15 18:20,19,110,-91,-493
208,2022/7/15 18:30,15,128,-113,-541
208,2022/7/15 18:40,16,104,-88,-527
208,2022/7/15 18:50,15,119,-104,-523
208,2022/7/15 19:00,12,109,-97,-540
208,2022/7/15 19:10,12,161,-149,-571
208,2022/7/15 19:20,14,150,-136,-517
208,2022/7/15 19:30,10,123,-113,-471
208,2022/7/15 19:40,11,106,-95,-465
208,2022/7/15 19:50,10,107,-97,-440
208,2022/7/15 20:00,12,106,-94,-421
208,2022/7/15 20:10,12,89,-77,-381
208,2022/7/15 20:20,9,94,-85,-360
208,2022/7/15 20:30,8,98,-90,-375
208,2022/7/15 20:40,6,99,-93,-348
208,2022/7/15 20:50,6,95,-89,-338
208,2022/7/15 21:00,8,84,-76,-333
208,2022/7/15 21:10,7,89,-82,-317
208,2022/7/15 21:20,7,78,-71,-352
208,2022/7/15 21:30,6,77,-71,-332
208,2022/7/15 21:40,5,78,-73,-328
208,2022/7/15 21:50,2,88,-86,-336
208,2022/7/15 22:00,1,72,-71,-326
208,2022/7/15 22:10,2,89,-87,-289
208,2022/7/15 22:20,2,78,-76,-318
208,2022/7/15 22:30,2,62,-60,-292
208,2022/7/15 22:40,0,78,-78,-298
208,2022/7/15 22:50,0,65,-65,-267
216,2022/7/15 5:00,0,1,-1,-8
216,2022/7/15 5:10,0,1,-1,8
216,2022/7/15 5:20,0,1,-1,52
216,2022/7/15 5:30,17,1,16,100
216,2022/7/15 5:40,29,1,28,108
216,2022/7/15 5:50,20,1,19,146
216,2022/7/15 6:00,34,1,33,185
216,2022/7/15 6:10,37,21,16,208
216,2022/7/15 6:20,43,31,12,160
216,2022/7/15 6:30,69,23,46,148
216,2022/7/15 6:40,75,23,52,143
216,2022/7/15 6:50,88,38,50,103
216,2022/7/15 7:00,152,47,105,242
216,2022/7/15 7:10,227,47,180,484
216,2022/7/15 7:20,244,57,187,675
216,2022/7/15 7:30,303,59,244,983
216,2022/7/15 7:40,339,68,271,1159
216,2022/7/15 7:50,324,72,252,1252
216,2022/7/15 8:00,337,77,260,933
216,2022/7/15 8:10,356,72,284,422
216,2022/7/15 8:20,277,85,192,36
216,2022/7/15 8:30,233,72,161,-211
216,2022/7/15 8:40,189,61,128,-461
216,2022/7/15 8:50,109,52,57,-343
216,2022/7/15 9:00,66,52,14,-307
216,2022/7/15 9:10,52,50,2,-333
216,2022/7/15 9:20,40,47,-7,-299
216,2022/7/15 9:30,28,47,-19,-313
216,2022/7/15 9:40,32,41,-9,-241
216,2022/7/15 9:50,31,39,-8,-241
216,2022/7/15 10:00,27,37,-10,-230
216,2022/7/15 10:10,25,42,-17,-231
216,2022/7/15 10:20,24,45,-21,-198
216,2022/7/15 10:30,23,32,-9,-229
216,2022/7/15 10:40,23,41,-18,-227
216,2022/7/15 10:50,20,44,-24,-166
216,2022/7/15 11:00,22,49,-27,-195
216,2022/7/15 11:10,24,46,-22,-182
216,2022/7/15 11:20,21,45,-24,-155
216,2022/7/15 11:30,20,45,-25,-187
216,2022/7/15 11:40,21,47,-26,-172
216,2022/7/15 11:50,27,47,-20,-151
216,2022/7/15 12:00,23,41,-18,-176
216,2022/7/15 12:10,25,45,-20,-179
216,2022/7/15 12:20,26,48,-22,-162
216,2022/7/15 12:30,26,54,-28,-203
216,2022/7/15 12:40,25,48,-23,-199
216,2022/7/15 12:50,26,45,-19,-207
216,2022/7/15 13:00,21,47,-26,-249
216,2022/7/15 13:10,23,50,-27,-228
216,2022/7/15 13:20,23,45,-22,-208
216,2022/7/15 13:30,20,44,-24,-245
216,2022/7/15 13:40,22,45,-23,-217
216,2022/7/15 13:50,18,47,-29,-206
216,2022/7/15 14:00,20,51,-31,-220
216,2022/7/15 14:10,20,49,-29,-236
216,2022/7/15 14:20,21,44,-23,-204
216,2022/7/15 14:30,20,51,-31,-239
216,2022/7/15 14:40,20,65,-45,-240
216,2022/7/15 14:50,17,60,-43,-246
216,2022/7/15 15:00,19,57,-38,-254
216,2022/7/15 15:10,18,65,-47,-293
216,2022/7/15 15:20,18,57,-39,-237
216,2022/7/15 15:30,22,78,-56,-279
216,2022/7/15 15:40,21,70,-49,-258
216,2022/7/15 15:50,22,71,-49,-258
216,2022/7/15 16:00,24,83,-59,-299
216,2022/7/15 16:10,23,75,-52,-257
216,2022/7/15 16:20,27,75,-48,-238
216,2022/7/15 16:30,27,77,-50,-268
216,2022/7/15 16:40,28,77,-49,-246
216,2022/7/15 16:50,35,98,-63,-274
216,2022/7/15 17:00,38,113,-75,-177
216,2022/7/15 17:10,39,98,-59,-83
216,2022/7/15 17:20,42,119,-77,-278
216,2022/7/15 17:30,38,122,-84,-160
216,2022/7/15 17:40,33,115,-82,-3
216,2022/7/15 17:50,57,122,-65,-296
216,2022/7/15 18:00,67,104,-37,-466
216,2022/7/15 18:10,28,152,-124,-538
216,2022/7/15 18:20,24,116,-92,-585
216,2022/7/15 18:30,26,107,-81,-622
216,2022/7/15 18:40,22,121,-99,-626
216,2022/7/15 18:50,22,116,-94,-617
216,2022/7/15 19:00,21,128,-107,-647
216,2022/7/15 19:10,20,110,-90,-661
216,2022/7/15 19:20,18,119,-101,-618
216,2022/7/15 19:30,16,105,-89,-560
216,2022/7/15 19:40,14,102,-88,-553
216,2022/7/15 19:50,16,92,-76,-516
216,2022/7/15 20:00,19,81,-62,-483
216,2022/7/15 20:10,15,94,-79,-460
216,2022/7/15 20:20,14,89,-75,-435
216,2022/7/15 20:30,16,75,-59,-434
216,2022/7/15 20:40,15,85,-70,-418
216,2022/7/15 20:50,15,85,-70,-408
216,2022/7/15 21:00,15,71,-56,-389
216,2022/7/15 21:10,17,77,-60,-377
216,2022/7/15 21:20,12,77,-65,-417
216,2022/7/15 21:30,12,68,-56,-388
216,2022/7/15 21:40,11,80,-69,-397
216,2022/7/15 21:50,10,63,-53,-389
216,2022/7/15 22:00,9,78,-69,-395
216,2022/7/15 22:10,9,73,-64,-353
216,2022/7/15 22:20,5,70,-65,-383
216,2022/7/15 22:30,5,73,-68,-360
216,2022/7/15 22:40,2,69,-67,-365
216,2022/7/15 22:50,0,78,-78,-345
226,2022/7/15 5:00,0,1,-1,-9
226,2022/7/15 5:10,0,1,-1,7
226,2022/7/15 5:20,0,1,-1,51
226,2022/7/15 5:30,13,1,12,112
226,2022/7/15 5:40,28,1,27,135
226,2022/7/15 5:50,27,2,25,171
226,2022/7/15 6:00,37,5,32,217
226,2022/7/15 6:10,47,21,26,234
226,2022/7/15 6:20,57,19,38,198
226,2022/7/15 6:30,88,35,53,201
226,2022/7/15 6:40,174,42,132,275
226,2022/7/15 6:50,183,54,129,232
226,2022/7/15 7:00,228,55,173,415
226,2022/7/15 7:10,278,69,209,693
226,2022/7/15 7:20,351,71,280,955
226,2022/7/15 7:30,598,73,525,1508
226,2022/7/15 7:40,630,60,570,1729
226,2022/7/15 7:50,724,69,655,1907
226,2022/7/15 8:00,635,59,576,1509
226,2022/7/15 8:10,629,72,557,979
226,2022/7/15 8:20,446,62,384,420
226,2022/7/15 8:30,276,60,216,5
226,2022/7/15 8:40,236,70,166,-295
226,2022/7/15 8:50,186,70,116,-227
226,2022/7/15 9:00,99,64,35,-272
226,2022/7/15 9:10,72,75,-3,-336
226,2022/7/15 9:20,51,72,-21,-320
226,2022/7/15 9:30,47,61,-14,-327
226,2022/7/15 9:40,35,61,-26,-267
226,2022/7/15 9:50,26,66,-40,-281
226,2022/7/15 10:00,30,71,-41,-271
226,2022/7/15 10:10,32,67,-35,-266
226,2022/7/15 10:20,29,65,-36,-234
226,2022/7/15 10:30,28,71,-43,-272
226,2022/7/15 10:40,28,74,-46,-273
226,2022/7/15 10:50,27,68,-41,-207
226,2022/7/15 11:00,27,63,-36,-231
226,2022/7/15 11:10,29,63,-34,-216
226,2022/7/15 11:20,29,71,-42,-197
226,2022/7/15 11:30,29,69,-40,-227
226,2022/7/15 11:40,29,68,-39,-211
226,2022/7/15 11:50,27,74,-47,-198
226,2022/7/15 12:00,36,68,-32,-208
226,2022/7/15 12:10,32,72,-40,-219
226,2022/7/15 12:20,35,65,-30,-192
226,2022/7/15 12:30,29,70,-41,-244
226,2022/7/15 12:40,33,70,-37,-236
226,2022/7/15 12:50,30,85,-55,-262
226,2022/7/15 13:00,27,76,-49,-298
226,2022/7/15 13:10,26,56,-30,-258
226,2022/7/15 13:20,33,73,-40,-248
226,2022/7/15 13:30,28,77,-49,-294
226,2022/7/15 13:40,26,62,-36,-253
226,2022/7/15 13:50,25,70,-45,-251
226,2022/7/15 14:00,26,69,-43,-263
226,2022/7/15 14:10,27,77,-50,-286
226,2022/7/15 14:20,25,93,-68,-272
226,2022/7/15 14:30,28,77,-49,-288
226,2022/7/15 14:40,26,73,-47,-287
226,2022/7/15 14:50,30,80,-50,-296
226,2022/7/15 15:00,20,91,-71,-325
226,2022/7/15 15:10,27,93,-66,-359
226,2022/7/15 15:20,22,87,-65,-302
226,2022/7/15 15:30,26,97,-71,-350
226,2022/7/15 15:40,26,105,-79,-337
226,2022/7/15 15:50,30,104,-74,-332
226,2022/7/15 16:00,26,102,-76,-375
226,2022/7/15 16:10,33,102,-69,-326
226,2022/7/15 16:20,24,103,-79,-317
226,2022/7/15 16:30,31,119,-88,-356
226,2022/7/15 16:40,36,104,-68,-314
226,2022/7/15 16:50,42,120,-78,-352
226,2022/7/15 17:00,37,123,-86,-263
226,2022/7/15 17:10,34,111,-77,-160
226,2022/7/15 17:20,37,152,-115,-393
226,2022/7/15 17:30,42,158,-116,-276
226,2022/7/15 17:40,37,207,-170,-173
226,2022/7/15 17:50,37,298,-261,-557
226,2022/7/15 18:00,32,301,-269,-735
226,2022/7/15 18:10,36,299,-263,-801
226,2022/7/15 18:20,27,336,-309,-894
226,2022/7/15 18:30,31,286,-255,-877
226,2022/7/15 18:40,29,321,-292,-918
226,2022/7/15 18:50,26,335,-309,-926
226,2022/7/15 19:00,28,208,-180,-827
226,2022/7/15 19:10,26,224,-198,-859
226,2022/7/15 19:20,25,159,-134,-752
226,2022/7/15 19:30,26,104,-78,-638
226,2022/7/15 19:40,25,111,-86,-639
226,2022/7/15 19:50,25,126,-101,-617
226,2022/7/15 20:00,26,103,-77,-560
226,2022/7/15 20:10,24,113,-89,-549
226,2022/7/15 20:20,28,104,-76,-511
226,2022/7/15 20:30,27,101,-74,-508
226,2022/7/15 20:40,22,105,-83,-501
226,2022/7/15 20:50,24,105,-81,-489
226,2022/7/15 21:00,26,94,-68,-457
226,2022/7/15 21:10,26,102,-76,-453
226,2022/7/15 21:20,24,92,-68,-485
226,2022/7/15 21:30,22,89,-67,-455
226,2022/7/15 21:40,17,89,-72,-469
226,2022/7/15 21:50,16,95,-79,-468
226,2022/7/15 22:00,34,76,-42,-437
226,2022/7/15 22:10,15,92,-77,-430
226,2022/7/15 22:20,7,70,-63,-446
226,2022/7/15 22:30,4,78,-74,-434
226,2022/7/15 22:40,3,79,-76,-441
226,2022/7/15 22:50,1,66,-65,-410
205,2022/7/15 5:00,0,1,-1,-10
205,2022/7/15 5:10,0,1,-1,6
205,2022/7/15 5:20,1,1,0,51
205,2022/7/15 5:30,11,1,10,122
205,2022/7/15 5:40,31,1,30,165
205,2022/7/15 5:50,32,1,31,202
205,2022/7/15 6:00,54,2,52,269
205,2022/7/15 6:10,59,14,45,279
205,2022/7/15 6:20,89,19,70,268
205,2022/7/15 6:30,189,40,149,350
205,2022/7/15 6:40,243,50,193,468
205,2022/7/15 6:50,266,62,204,436
205,2022/7/15 7:00,301,72,229,644
205,2022/7/15 7:10,436,69,367,1060
205,2022/7/15 7:20,655,79,576,1531
205,2022/7/15 7:30,867,93,774,2282
205,2022/7/15 7:40,1170,83,1087,2816
205,2022/7/15 7:50,1216,75,1141,3048
205,2022/7/15 8:00,1227,99,1128,2637
205,2022/7/15 8:10,1051,73,978,1957
205,2022/7/15 8:20,702,93,609,1029
205,2022/7/15 8:30,596,98,498,503
205,2022/7/15 8:40,374,77,297,2
205,2022/7/15 8:50,280,81,199,-28
205,2022/7/15 9:00,231,62,169,-103
205,2022/7/15 9:10,182,66,116,-220
205,2022/7/15 9:20,90,69,21,-299
205,2022/7/15 9:30,71,66,5,-322
205,2022/7/15 9:40,51,60,-9,-276
205,2022/7/15 9:50,46,47,-1,-282
205,2022/7/15 10:00,36,66,-30,-301
205,2022/7/15 10:10,33,54,-21,-287
205,2022/7/15 10:20,31,54,-23,-257
205,2022/7/15 10:30,32,54,-22,-294
205,2022/7/15 10:40,31,52,-21,-294
205,2022/7/15 10:50,30,64,-34,-241
205,2022/7/15 11:00,26,57,-31,-262
205,2022/7/15 11:10,32,54,-22,-238
205,2022/7/15 11:20,27,57,-30,-227
205,2022/7/15 11:30,28,66,-38,-265
205,2022/7/15 11:40,28,71,-43,-254
205,2022/7/15 11:50,29,65,-36,-234
205,2022/7/15 12:00,31,59,-28,-236
205,2022/7/15 12:10,30,62,-32,-251
205,2022/7/15 12:20,31,71,-40,-232
205,2022/7/15 12:30,29,70,-41,-285
205,2022/7/15 12:40,30,62,-32,-268
205,2022/7/15 12:50,28,66,-38,-300
205,2022/7/15 13:00,33,67,-34,-332
205,2022/7/15 13:10,29,63,-34,-292
205,2022/7/15 13:20,26,71,-45,-293
205,2022/7/15 13:30,26,58,-32,-326
205,2022/7/15 13:40,29,69,-40,-293
205,2022/7/15 13:50,25,65,-40,-291
205,2022/7/15 14:00,29,70,-41,-304
205,2022/7/15 14:10,25,70,-45,-331
205,2022/7/15 14:20,28,71,-43,-315
205,2022/7/15 14:30,27,77,-50,-338
205,2022/7/15 14:40,24,76,-52,-339
205,2022/7/15 14:50,21,76,-55,-351
205,2022/7/15 15:00,27,74,-47,-372
205,2022/7/15 15:10,25,78,-53,-412
205,2022/7/15 15:20,23,93,-70,-372
205,2022/7/15 15:30,24,97,-73,-423
205,2022/7/15 15:40,27,92,-65,-402
205,2022/7/15 15:50,24,90,-66,-398
205,2022/7/15 16:00,29,102,-73,-448
205,2022/7/15 16:10,33,112,-79,-405
205,2022/7/15 16:20,29,104,-75,-392
205,2022/7/15 16:30,37,112,-75,-431
205,2022/7/15 16:40,33,122,-89,-403
205,2022/7/15 16:50,28,110,-82,-434
205,2022/7/15 17:00,43,116,-73,-336
205,2022/7/15 17:10,42,127,-85,-245
205,2022/7/15 17:20,43,212,-169,-562
205,2022/7/15 17:30,42,196,-154,-430
205,2022/7/15 17:40,46,268,-222,-395
205,2022/7/15 17:50,51,333,-282,-839
205,2022/7/15 18:00,45,381,-336,-1071
205,2022/7/15 18:10,43,385,-342,-1143
205,2022/7/15 18:20,39,510,-471,-1365
205,2022/7/15 18:30,30,382,-352,-1229
205,2022/7/15 18:40,29,373,-344,-1262
205,2022/7/15 18:50,32,535,-503,-1429
205,2022/7/15 19:00,24,350,-326,-1153
205,2022/7/15 19:10,26,269,-243,-1102
205,2022/7/15 19:20,25,234,-209,-961
205,2022/7/15 19:30,21,145,-124,-762
205,2022/7/15 19:40,23,117,-94,-733
205,2022/7/15 19:50,20,104,-84,-701
205,2022/7/15 20:00,25,125,-100,-660
205,2022/7/15 20:10,20,123,-103,-652
205,2022/7/15 20:20,18,110,-92,-603
205,2022/7/15 20:30,20,89,-69,-577
205,2022/7/15 20:40,20,105,-85,-586
205,2022/7/15 20:50,18,103,-85,-574
205,2022/7/15 21:00,22,107,-85,-542
205,2022/7/15 21:10,17,107,-90,-543
205,2022/7/15 21:20,18,112,-94,-579
205,2022/7/15 21:30,12,107,-95,-550
205,2022/7/15 21:40,11,110,-99,-568
205,2022/7/15 21:50,12,112,-100,-568
205,2022/7/15 22:00,8,113,-105,-542
205,2022/7/15 22:10,9,93,-84,-514
205,2022/7/15 22:20,5,104,-99,-545
205,2022/7/15 22:30,3,98,-95,-529
205,2022/7/15 22:40,4,76,-72,-513
205,2022/7/15 22:50,0,85,-85,-495
215,2022/7/15 5:00,0,1,-1,-11
215,2022/7/15 5:10,0,1,-1,5
215,2022/7/15 5:20,0,1,-1,50
215,2022/7/15 5:30,11,1,10,132
215,2022/7/15 5:40,22,1,21,186
215,2022/7/15 5:50,27,5,22,224
215,2022/7/15 6:00,38,6,32,301
215,2022/7/15 6:10,39,38,1,280
215,2022/7/15 6:20,54,29,25,293
215,2022/7/15 6:30,69,63,6,356
215,2022/7/15 6:40,87,77,10,478
215,2022/7/15 6:50,99,93,6,442
215,2022/7/15 7:00,194,90,104,748
215,2022/7/15 7:10,236,105,131,1191
215,2022/7/15 7:20,278,123,155,1686
215,2022/7/15 7:30,393,110,283,2565
215,2022/7/15 7:40,596,120,476,3292
215,2022/7/15 7:50,662,144,518,3566
215,2022/7/15 8:00,654,193,461,3098
215,2022/7/15 8:10,664,233,431,2388
215,2022/7/15 8:20,389,223,166,1195
215,2022/7/15 8:30,276,233,43,546
215,2022/7/15 8:40,283,234,49,51
215,2022/7/15 8:50,216,180,36,8
215,2022/7/15 9:00,177,112,65,-38
215,2022/7/15 9:10,140,133,7,-213
215,2022/7/15 9:20,71,125,-54,-353
215,2022/7/15 9:30,58,126,-68,-390
215,2022/7/15 9:40,49,112,-63,-339
215,2022/7/15 9:50,45,105,-60,-342
215,2022/7/15 10:00,41,94,-53,-354
215,2022/7/15 10:10,36,90,-54,-341
215,2022/7/15 10:20,33,93,-60,-317
215,2022/7/15 10:30,39,91,-52,-346
215,2022/7/15 10:40,38,98,-60,-354
215,2022/7/15 10:50,37,87,-50,-291
215,2022/7/15 11:00,34,76,-42,-304
215,2022/7/15 11:10,37,87,-50,-288
215,2022/7/15 11:20,38,100,-62,-289
215,2022/7/15 11:30,35,93,-58,-323
215,2022/7/15 11:40,36,77,-41,-295
215,2022/7/15 11:50,38,75,-37,-271
215,2022/7/15 12:00,44,93,-49,-285
215,2022/7/15 12:10,40,97,-57,-308
215,2022/7/15 12:20,43,99,-56,-288
215,2022/7/15 12:30,44,90,-46,-331
215,2022/7/15 12:40,45,99,-54,-322
215,2022/7/15 12:50,43,108,-65,-365
215,2022/7/15 13:00,43,101,-58,-390
215,2022/7/15 13:10,45,93,-48,-340
215,2022/7/15 13:20,35,91,-56,-349
215,2022/7/15 13:30,41,93,-52,-378
215,2022/7/15 13:40,41,109,-68,-361
215,2022/7/15 13:50,37,97,-60,-351
215,2022/7/15 14:00,37,90,-53,-357
215,2022/7/15 14:10,41,101,-60,-391
215,2022/7/15 14:20,42,101,-59,-374
215,2022/7/15 14:30,38,93,-55,-393
215,2022/7/15 14:40,32,97,-65,-404
215,2022/7/15 14:50,41,93,-52,-403
215,2022/7/15 15:00,42,101,-59,-431
215,2022/7/15 15:10,47,111,-64,-476
215,2022/7/15 15:20,42,102,-60,-432
215,2022/7/15 15:30,43,96,-53,-476
215,2022/7/15 15:40,59,103,-44,-446
215,2022/7/15 15:50,46,108,-62,-460
215,2022/7/15 16:00,63,102,-39,-487
215,2022/7/15 16:10,41,101,-60,-465
215,2022/7/15 16:20,54,101,-47,-439
215,2022/7/15 16:30,69,123,-54,-485
215,2022/7/15 16:40,70,125,-55,-458
215,2022/7/15 16:50,77,113,-36,-470
215,2022/7/15 17:00,140,124,16,-320
215,2022/7/15 17:10,174,107,67,-178
215,2022/7/15 17:20,137,108,29,-533
215,2022/7/15 17:30,143,177,-34,-464
215,2022/7/15 17:40,175,212,-37,-432
215,2022/7/15 17:50,160,207,-47,-886
215,2022/7/15 18:00,150,268,-118,-1189
215,2022/7/15 18:10,176,327,-151,-1294
215,2022/7/15 18:20,175,326,-151,-1516
215,2022/7/15 18:30,109,335,-226,-1455
215,2022/7/15 18:40,128,320,-192,-1454
215,2022/7/15 18:50,64,269,-205,-1634
215,2022/7/15 19:00,57,270,-213,-1366
215,2022/7/15 19:10,54,234,-180,-1282
215,2022/7/15 19:20,45,192,-147,-1108
215,2022/7/15 19:30,39,170,-131,-893
215,2022/7/15 19:40,39,108,-69,-802
215,2022/7/15 19:50,41,124,-83,-784
215,2022/7/15 20:00,45,123,-78,-738
215,2022/7/15 20:10,44,124,-80,-732
215,2022/7/15 20:20,39,116,-77,-680
215,2022/7/15 20:30,40,109,-69,-646
215,2022/7/15 20:40,39,115,-76,-662
215,2022/7/15 20:50,43,107,-64,-638
215,2022/7/15 21:00,44,106,-62,-604
215,2022/7/15 21:10,43,112,-69,-612
215,2022/7/15 21:20,31,105,-74,-653
215,2022/7/15 21:30,32,107,-75,-625
215,2022/7/15 21:40,29,107,-78,-646
215,2022/7/15 21:50,25,82,-57,-625
215,2022/7/15 22:00,29,106,-77,-619
215,2022/7/15 22:10,25,103,-78,-592
215,2022/7/15 22:20,14,76,-62,-607
215,2022/7/15 22:30,11,104,-93,-622
215,2022/7/15 22:40,5,76,-71,-584
215,2022/7/15 22:50,2,70,-68,-563
229,2022/7/15 5:00,0,1,-1,-12
229,2022/7/15 5:10,0,1,-1,4
229,2022/7/15 5:20,0,1,-1,49
229,2022/7/15 5:30,4,1,3,135
229,2022/7/15 5:40,18,1,17,203
229,2022/7/15 5:50,32,2,30,254
229,2022/7/15 6:00,42,19,23,324
229,2022/7/15 6:10,36,11,25,305
229,2022/7/15 6:20,58,25,33,326
229,2022/7/15 6:30,84,31,53,409
229,2022/7/15 6:40,116,41,75,553
229,2022/7/15 6:50,169,48,121,563
229,2022/7/15 7:00,186,60,126,874
229,2022/7/15 7:10,265,64,201,1392
229,2022/7/15 7:20,318,78,240,1926
229,2022/7/15 7:30,597,92,505,3070
229,2022/7/15 7:40,722,105,617,3909
229,2022/7/15 7:50,723,113,610,4176
229,2022/7/15 8:00,688,109,579,3677
229,2022/7/15 8:10,629,105,524,2912
229,2022/7/15 8:20,390,86,304,1499
229,2022/7/15 8:30,319,126,193,739
229,2022/7/15 8:40,272,120,152,203
229,2022/7/15 8:50,226,105,121,129
229,2022/7/15 9:00,173,97,76,38
229,2022/7/15 9:10,143,90,53,-160
229,2022/7/15 9:20,76,76,0,-353
229,2022/7/15 9:30,50,64,-14,-404
229,2022/7/15 9:40,46,78,-32,-371
229,2022/7/15 9:50,37,67,-30,-372
229,2022/7/15 10:00,37,65,-28,-382
229,2022/7/15 10:10,36,70,-34,-375
229,2022/7/15 10:20,29,61,-32,-349
229,2022/7/15 10:30,31,63,-32,-378
229,2022/7/15 10:40,29,61,-32,-386
229,2022/7/15 10:50,25,66,-41,-332
229,2022/7/15 11:00,32,68,-36,-340
229,2022/7/15 11:10,30,61,-31,-319
229,2022/7/15 11:20,28,61,-33,-322
229,2022/7/15 11:30,30,66,-36,-359
229,2022/7/15 11:40,29,72,-43,-338
229,2022/7/15 11:50,30,69,-39,-310
229,2022/7/15 12:00,28,61,-33,-318
229,2022/7/15 12:10,34,59,-25,-333
229,2022/7/15 12:20,29,70,-41,-329
229,2022/7/15 12:30,34,64,-30,-361
229,2022/7/15 12:40,34,74,-40,-362
229,2022/7/15 12:50,37,62,-25,-390
229,2022/7/15 13:00,30,76,-46,-436
229,2022/7/15 13:10,31,83,-52,-392
229,2022/7/15 13:20,30,69,-39,-388
229,2022/7/15 13:30,25,67,-42,-420
229,2022/7/15 13:40,27,66,-39,-400
229,2022/7/15 13:50,27,77,-50,-401
229,2022/7/15 14:00,30,69,-39,-396
229,2022/7/15 14:10,29,64,-35,-426
229,2022/7/15 14:20,30,72,-42,-416
229,2022/7/15 14:30,25,70,-45,-438
229,2022/7/15 14:40,26,75,-49,-453
229,2022/7/15 14:50,30,78,-48,-451
229,2022/7/15 15:00,31,81,-50,-481
229,2022/7/15 15:10,32,85,-53,-529
229,2022/7/15 15:20,22,91,-69,-501
229,2022/7/15 15:30,28,84,-56,-532
229,2022/7/15 15:40,27,87,-60,-506
229,2022/7/15 15:50,31,97,-66,-526
229,2022/7/15 16:00,34,90,-56,-543
229,2022/7/15 16:10,38,103,-65,-530
229,2022/7/15 16:20,34,93,-59,-498
229,2022/7/15 16:30,46,93,-47,-532
229,2022/7/15 16:40,38,100,-62,-520
229,2022/7/15 16:50,44,126,-82,-552
229,2022/7/15 17:00,42,107,-65,-385
229,2022/7/15 17:10,71,127,-56,-234
229,2022/7/15 17:20,64,115,-51,-584
229,2022/7/15 17:30,46,177,-131,-595
229,2022/7/15 17:40,65,196,-131,-563
229,2022/7/15 17:50,65,221,-156,-1042
229,2022/7/15 18:00,42,218,-176,-1365
229,2022/7/15 18:10,45,300,-255,-1549
229,2022/7/15 18:20,44,257,-213,-1729
229,2022/7/15 18:30,44,233,-189,-1644
229,2022/7/15 18:40,44,257,-213,-1667
229,2022/7/15 18:50,33,255,-222,-1856
229,2022/7/15 19:00,30,222,-192,-1558
229,2022/7/15 19:10,30,234,-204,-1486
229,2022/7/15 19:20,26,116,-90,-1198
229,2022/7/15 19:30,26,113,-87,-980
229,2022/7/15 19:40,24,121,-97,-899
229,2022/7/15 19:50,22,110,-88,-872
229,2022/7/15 20:00,26,107,-81,-819
229,2022/7/15 20:10,28,104,-76,-808
229,2022/7/15 20:20,24,111,-87,-767
229,2022/7/15 20:30,27,110,-83,-729
229,2022/7/15 20:40,23,107,-84,-746
229,2022/7/15 20:50,26,92,-66,-704
229,2022/7/15 21:00,22,95,-73,-677
229,2022/7/15 21:10,27,108,-81,-693
229,2022/7/15 21:20,22,78,-56,-709
229,2022/7/15 21:30,17,114,-97,-722
229,2022/7/15 21:40,18,93,-75,-721
229,2022/7/15 21:50,14,110,-96,-721
229,2022/7/15 22:00,13,74,-61,-680
229,2022/7/15 22:10,10,107,-97,-689
229,2022/7/15 22:20,6,80,-74,-681
229,2022/7/15 22:30,6,86,-80,-702
229,2022/7/15 22:40,3,77,-74,-658
229,2022/7/15 22:50,1,78,-77,-640
206,2022/7/15 5:00,0,1,-1,-13
206,2022/7/15 5:10,0,1,-1,3
206,2022/7/15 5:20,0,1,-1,48
206,2022/7/15 5:30,2,1,1,136
206,2022/7/15 5:40,16,1,15,218
206,2022/7/15 5:50,28,6,22,276
206,2022/7/15 6:00,33,13,20,344
206,2022/7/15 6:10,45,19,26,331
206,2022/7/15 6:20,45,23,22,348
206,2022/7/15 6:30,82,46,36,445
206,2022/7/15 6:40,115,74,41,594
206,2022/7/15 6:50,156,75,81,644
206,2022/7/15 7:00,192,93,99,973
206,2022/7/15 7:10,245,113,132,1524
206,2022/7/15 7:20,281,96,185,2111
206,2022/7/15 7:30,384,106,278,3348
206,2022/7/15 7:40,721,90,631,4540
206,2022/7/15 7:50,630,100,530,4706
206,2022/7/15 8:00,589,111,478,4155
206,2022/7/15 8:10,442,96,346,3258
206,2022/7/15 8:20,361,102,259,1758
206,2022/7/15 8:30,275,107,168,907
206,2022/7/15 8:40,266,104,162,365
206,2022/7/15 8:50,227,133,94,223
206,2022/7/15 9:00,193,109,84,122
206,2022/7/15 9:10,149,103,46,-114
206,2022/7/15 9:20,93,93,0,-353
206,2022/7/15 9:30,65,76,-11,-415
206,2022/7/15 9:40,54,88,-34,-405
206,2022/7/15 9:50,45,92,-47,-419
206,2022/7/15 10:00,46,73,-27,-409
206,2022/7/15 10:10,40,70,-30,-405
206,2022/7/15 10:20,37,72,-35,-384
206,2022/7/15 10:30,41,74,-33,-411
206,2022/7/15 10:40,35,72,-37,-423
206,2022/7/15 10:50,37,60,-23,-355
206,2022/7/15 11:00,37,62,-25,-365
206,2022/7/15 11:10,39,69,-30,-349
206,2022/7/15 11:20,38,66,-28,-350
206,2022/7/15 11:30,37,66,-29,-388
206,2022/7/15 11:40,33,66,-33,-371
206,2022/7/15 11:50,34,68,-34,-344
206,2022/7/15 12:00,37,66,-29,-347
206,2022/7/15 12:10,35,65,-30,-363
206,2022/7/15 12:20,33,76,-43,-372
206,2022/7/15 12:30,36,69,-33,-394
206,2022/7/15 12:40,32,87,-55,-417
206,2022/7/15 12:50,32,95,-63,-453
206,2022/7/15 13:00,33,90,-57,-493
206,2022/7/15 13:10,27,73,-46,-438
206,2022/7/15 13:20,30,78,-48,-436
206,2022/7/15 13:30,35,75,-40,-460
206,2022/7/15 13:40,37,76,-39,-439
206,2022/7/15 13:50,31,74,-43,-444
206,2022/7/15 14:00,36,76,-40,-436
206,2022/7/15 14:10,35,77,-42,-468
206,2022/7/15 14:20,37,83,-46,-462
206,2022/7/15 14:30,37,80,-43,-481
206,2022/7/15 14:40,35,77,-42,-495
206,2022/7/15 14:50,33,76,-43,-494
206,2022/7/15 15:00,40,76,-36,-517
206,2022/7/15 15:10,31,83,-52,-581
206,2022/7/15 15:20,40,74,-34,-535
206,2022/7/15 15:30,43,75,-32,-564
206,2022/7/15 15:40,44,97,-53,-559
206,2022/7/15 15:50,48,109,-61,-587
206,2022/7/15 16:00,45,104,-59,-602
206,2022/7/15 16:10,45,93,-48,-578
206,2022/7/15 16:20,44,102,-58,-556
206,2022/7/15 16:30,47,116,-69,-601
206,2022/7/15 16:40,77,104,-27,-547
206,2022/7/15 16:50,72,123,-51,-603
206,2022/7/15 17:00,92,116,-24,-409
206,2022/7/15 17:10,70,132,-62,-296
206,2022/7/15 17:20,67,168,-101,-685
206,2022/7/15 17:30,52,192,-140,-735
206,2022/7/15 17:40,45,179,-134,-697
206,2022/7/15 17:50,42,255,-213,-1255
206,2022/7/15 18:00,77,218,-141,-1506
206,2022/7/15 18:10,76,217,-141,-1690
206,2022/7/15 18:20,45,300,-255,-1984
206,2022/7/15 18:30,43,218,-175,-1819
206,2022/7/15 18:40,36,235,-199,-1866
206,2022/7/15 18:50,31,256,-225,-2081
206,2022/7/15 19:00,24,224,-200,-1758
206,2022/7/15 19:10,24,184,-160,-1646
206,2022/7/15 19:20,24,144,-120,-1318
206,2022/7/15 19:30,25,116,-91,-1071
206,2022/7/15 19:40,25,109,-84,-983
206,2022/7/15 19:50,23,108,-85,-957
206,2022/7/15 20:00,28,109,-81,-900
206,2022/7/15 20:10,24,113,-89,-897
206,2022/7/15 20:20,22,106,-84,-851
206,2022/7/15 20:30,22,107,-85,-814
206,2022/7/15 20:40,22,105,-83,-829
206,2022/7/15 20:50,22,109,-87,-791
206,2022/7/15 21:00,21,100,-79,-756
206,2022/7/15 21:10,23,107,-84,-777
206,2022/7/15 21:20,19,106,-87,-796
206,2022/7/15 21:30,14,105,-91,-813
206,2022/7/15 21:40,16,97,-81,-802
206,2022/7/15 21:50,11,92,-81,-802
206,2022/7/15 22:00,12,106,-94,-774
206,2022/7/15 22:10,8,78,-70,-759
206,2022/7/15 22:20,6,98,-92,-773
206,2022/7/15 22:30,6,91,-85,-787
206,2022/7/15 22:40,4,66,-62,-720
206,2022/7/15 22:50,2,71,-69,-709
204,2022/7/15 5:00,0,1,-1,-14
204,2022/7/15 5:10,0,1,-1,2
204,2022/7/15 5:20,0,1,-1,47
204,2022/7/15 5:30,0,1,-1,135
204,2022/7/15 5:40,7,1,6,224
204,2022/7/15 5:50,16,1,15,291
204,2022/7/15 6:00,19,16,3,347
204,2022/7/15 6:10,24,19,5,336
204,2022/7/15 6:20,29,25,4,352
204,2022/7/15 6:30,38,46,-8,437
204,2022/7/15 6:40,45,74,-29,565
204,2022/7/15 6:50,55,76,-21,623
204,2022/7/15 7:00,57,93,-36,937
204,2022/7/15 7:10,62,99,-37,1487
204,2022/7/15 7:20,83,83,0,2111
204,2022/7/15 7:30,180,112,68,3416
204,2022/7/15 7:40,224,105,119,4659
204,2022/7/15 7:50,226,90,136,4842
204,2022/7/15 8:00,205,93,112,4267
204,2022/7/15 8:10,188,97,91,3349
204,2022/7/15 8:20,150,104,46,1804
204,2022/7/15 8:30,90,92,-2,905
204,2022/7/15 8:40,78,113,-35,330
204,2022/7/15 8:50,66,93,-27,196
204,2022/7/15 9:00,50,77,-27,95
204,2022/7/15 9:10,48,77,-29,-143
204,2022/7/15 9:20,38,61,-23,-376
204,2022/7/15 9:30,39,69,-30,-445
204,2022/7/15 9:40,28,65,-37,-442
204,2022/7/15 9:50,31,69,-38,-457
204,2022/7/15 10:00,25,68,-43,-452
204,2022/7/15 10:10,30,65,-35,-440
204,2022/7/15 10:20,32,58,-26,-410
204,2022/7/15 10:30,26,67,-41,-452
204,2022/7/15 10:40,25,64,-39,-462
204,2022/7/15 10:50,27,60,-33,-388
204,2022/7/15 11:00,25,52,-27,-392
204,2022/7/15 11:10,28,57,-29,-378
204,2022/7/15 11:20,28,51,-23,-373
204,2022/7/15 11:30,26,64,-38,-426
204,2022/7/15 11:40,25,48,-23,-394
204,2022/7/15 11:50,25,48,-23,-367
204,2022/7/15 12:00,24,47,-23,-370
204,2022/7/15 12:10,28,54,-26,-389
204,2022/7/15 12:20,27,62,-35,-407
204,2022/7/15 12:30,29,57,-28,-422
204,2022/7/15 12:40,24,62,-38,-455
204,2022/7/15 12:50,27,62,-35,-488
204,2022/7/15 13:00,28,66,-38,-531
204,2022/7/15 13:10,29,61,-32,-470
204,2022/7/15 13:20,27,63,-36,-472
204,2022/7/15 13:30,27,60,-33,-493
204,2022/7/15 13:40,26,73,-47,-486
204,2022/7/15 13:50,26,72,-46,-490
204,2022/7/15 14:00,27,64,-37,-473
204,2022/7/15 14:10,26,57,-31,-499
204,2022/7/15 14:20,27,57,-30,-492
204,2022/7/15 14:30,26,71,-45,-526
204,2022/7/15 14:40,24,69,-45,-540
204,2022/7/15 14:50,28,74,-46,-540
204,2022/7/15 15:00,23,59,-36,-553
204,2022/7/15 15:10,30,74,-44,-625
204,2022/7/15 15:20,32,72,-40,-575
204,2022/7/15 15:30,26,72,-46,-610
204,2022/7/15 15:40,33,73,-40,-599
204,2022/7/15 15:50,26,69,-43,-630
204,2022/7/15 16:00,31,77,-46,-648
204,2022/7/15 16:10,28,64,-36,-614
204,2022/7/15 16:20,29,72,-43,-599
204,2022/7/15 16:30,38,82,-44,-645
204,2022/7/15 16:40,77,80,-3,-550
204,2022/7/15 16:50,65,93,-28,-631
204,2022/7/15 17:00,108,92,16,-393
204,2022/7/15 17:10,63,100,-37,-333
204,2022/7/15 17:20,49,121,-72,-757
204,2022/7/15 17:30,43,123,-80,-815
204,2022/7/15 17:40,41,114,-73,-770
204,2022/7/15 17:50,31,119,-88,-1343
204,2022/7/15 18:00,33,106,-73,-1579
204,2022/7/15 18:10,30,115,-85,-1775
204,2022/7/15 18:20,31,111,-80,-2064
204,2022/7/15 18:30,24,110,-86,-1905
204,2022/7/15 18:40,26,123,-97,-1963
204,2022/7/15 18:50,24,124,-100,-2181
204,2022/7/15 19:00,21,125,-104,-1862
204,2022/7/15 19:10,21,106,-85,-1731
204,2022/7/15 19:20,20,113,-93,-1411
204,2022/7/15 19:30,22,92,-70,-1141
204,2022/7/15 19:40,18,80,-62,-1045
204,2022/7/15 19:50,15,79,-64,-1021
204,2022/7/15 20:00,18,63,-45,-945
204,2022/7/15 20:10,23,72,-49,-946
204,2022/7/15 20:20,19,73,-54,-905
204,2022/7/15 20:30,15,69,-54,-868
204,2022/7/15 20:40,19,71,-52,-881
204,2022/7/15 20:50,14,76,-62,-853
204,2022/7/15 21:00,16,72,-56,-812
204,2022/7/15 21:10,18,70,-52,-829
204,2022/7/15 21:20,12,67,-55,-851
204,2022/7/15 21:30,11,73,-62,-875
204,2022/7/15 21:40,12,66,-54,-856
204,2022/7/15 21:50,10,70,-60,-862
204,2022/7/15 22:00,9,60,-51,-825
204,2022/7/15 22:10,8,68,-60,-819
204,2022/7/15 22:20,5,51,-46,-819
204,2022/7/15 22:30,3,59,-56,-843
204,2022/7/15 22:40,2,51,-49,-769
204,2022/7/15 22:50,2,38,-36,-745
220,2022/7/15 5:00,0,1,-1,-15
220,2022/7/15 5:10,0,1,-1,1
220,2022/7/15 5:20,0,1,-1,46
220,2022/7/15 5:30,0,1,-1,134
220,2022/7/15 5:40,6,1,5,229
220,2022/7/15 5:50,15,1,14,305
220,2022/7/15 6:00,21,11,10,357
220,2022/7/15 6:10,31,10,21,357
220,2022/7/15 6:20,32,21,11,363
220,2022/7/15 6:30,41,47,-6,431
220,2022/7/15 6:40,41,63,-22,543
220,2022/7/15 6:50,57,93,-36,587
220,2022/7/15 7:00,58,115,-57,880
220,2022/7/15 7:10,69,158,-89,1398
220,2022/7/15 7:20,76,197,-121,1990
220,2022/7/15 7:30,147,109,38,3454
220,2022/7/15 7:40,206,110,96,4755
220,2022/7/15 7:50,223,111,112,4954
220,2022/7/15 8:00,206,114,92,4359
220,2022/7/15 8:10,186,198,-12,3337
220,2022/7/15 8:20,151,192,-41,1763
220,2022/7/15 8:30,149,109,40,945
220,2022/7/15 8:40,91,128,-37,293
220,2022/7/15 8:50,70,119,-49,147
220,2022/7/15 9:00,61,126,-65,30
220,2022/7/15 9:10,49,108,-59,-202
220,2022/7/15 9:20,44,93,-49,-425
220,2022/7/15 9:30,39,80,-41,-486
220,2022/7/15 9:40,33,77,-44,-486
220,2022/7/15 9:50,31,62,-31,-488
220,2022/7/15 10:00,29,66,-37,-489
220,2022/7/15 10:10,35,66,-31,-471
220,2022/7/15 10:20,27,65,-38,-448
220,2022/7/15 10:30,29,60,-31,-483
220,2022/7/15 10:40,29,63,-34,-496
220,2022/7/15 10:50,27,62,-35,-423
220,2022/7/15 11:00,28,55,-27,-419
220,2022/7/15 11:10,29,64,-35,-413
220,2022/7/15 11:20,28,55,-27,-400
220,2022/7/15 11:30,29,52,-23,-449
220,2022/7/15 11:40,27,55,-28,-422
220,2022/7/15 11:50,27,66,-39,-406
220,2022/7/15 12:00,26,59,-33,-403
220,2022/7/15 12:10,28,68,-40,-429
220,2022/7/15 12:20,27,61,-34,-441
220,2022/7/15 12:30,25,69,-44,-466
220,2022/7/15 12:40,23,67,-44,-499
220,2022/7/15 12:50,21,68,-47,-535
220,2022/7/15 13:00,25,73,-48,-579
220,2022/7/15 13:10,31,68,-37,-507
220,2022/7/15 13:20,24,61,-37,-509
220,2022/7/15 13:30,29,72,-43,-536
220,2022/7/15 13:40,26,67,-41,-527
220,2022/7/15 13:50,22,69,-47,-537
220,2022/7/15 14:00,22,66,-44,-517
220,2022/7/15 14:10,21,71,-50,-549
220,2022/7/15 14:20,25,72,-47,-539
220,2022/7/15 14:30,25,67,-42,-568
220,2022/7/15 14:40,57,64,-7,-547
220,2022/7/15 14:50,45,71,-26,-566
220,2022/7/15 15:00,35,68,-33,-586
220,2022/7/15 15:10,41,72,-31,-656
220,2022/7/15 15:20,31,71,-40,-615
220,2022/7/15 15:30,36,68,-32,-642
220,2022/7/15 15:40,45,75,-30,-629
220,2022/7/15 15:50,69,76,-7,-637
220,2022/7/15 16:00,63,76,-13,-661
220,2022/7/15 16:10,76,76,0,-614
220,2022/7/15 16:20,45,97,-52,-651
220,2022/7/15 16:30,43,97,-54,-699
220,2022/7/15 16:40,72,76,-4,-554
220,2022/7/15 16:50,56,93,-37,-668
220,2022/7/15 17:00,210,102,108,-285
220,2022/7/15 17:10,221,104,117,-216
220,2022/7/15 17:20,162,109,53,-704
220,2022/7/15 17:30,148,122,26,-789
220,2022/7/15 17:40,176,110,66,-704
220,2022/7/15 17:50,70,120,-50,-1393
220,2022/7/15 18:00,74,110,-36,-1615
220,2022/7/15 18:10,71,121,-50,-1825
220,2022/7/15 18:20,44,113,-69,-2133
220,2022/7/15 18:30,38,116,-78,-1983
220,2022/7/15 18:40,30,104,-74,-2037
220,2022/7/15 18:50,31,113,-82,-2263
220,2022/7/15 19:00,34,110,-76,-1938
220,2022/7/15 19:10,27,122,-95,-1826
220,2022/7/15 19:20,28,103,-75,-1486
220,2022/7/15 19:30,28,106,-78,-1219
220,2022/7/15 19:40,28,95,-67,-1112
220,2022/7/15 19:50,25,78,-53,-1074
220,2022/7/15 20:00,26,83,-57,-1002
220,2022/7/15 20:10,25,79,-54,-1000
220,2022/7/15 20:20,23,78,-55,-960
220,2022/7/15 20:30,27,79,-52,-920
220,2022/7/15 20:40,26,64,-38,-919
220,2022/7/15 20:50,25,84,-59,-912
220,2022/7/15 21:00,27,76,-49,-861
220,2022/7/15 21:10,26,75,-49,-878
220,2022/7/15 21:20,20,79,-59,-910
220,2022/7/15 21:30,22,83,-61,-936
220,2022/7/15 21:40,15,62,-47,-903
220,2022/7/15 21:50,15,83,-68,-930
220,2022/7/15 22:00,14,65,-51,-876
220,2022/7/15 22:10,10,83,-73,-892
220,2022/7/15 22:20,10,63,-53,-872
220,2022/7/15 22:30,6,49,-43,-886
220,2022/7/15 22:40,4,55,-51,-820
220,2022/7/15 22:50,1,46,-45,-790
228,2022/7/15 5:00,0,1,-1,-16
228,2022/7/15 5:10,0,1,-1,0
228,2022/7/15 5:20,0,1,-1,45
228,2022/7/15 5:30,1,1,0,134
228,2022/7/15 5:40,2,1,1,230
228,2022/7/15 5:50,6,6,0,305
228,2022/7/15 6:00,9,11,-2,355
228,2022/7/15 6:10,13,16,-3,354
228,2022/7/15 6:20,20,37,-17,346
228,2022/7/15 6:30,27,55,-28,403
228,2022/7/15 6:40,29,106,-77,466
228,2022/7/15 6:50,30,110,-80,507
228,2022/7/15 7:00,35,324,-289,591
228,2022/7/15 7:10,33,324,-291,1107
228,2022/7/15 7:20,37,297,-260,1730
228,2022/7/15 7:30,43,319,-276,3178
228,2022/7/15 7:40,52,196,-144,4611
228,2022/7/15 7:50,58,196,-138,4816
228,2022/7/15 8:00,58,253,-195,4164
228,2022/7/15 8:10,56,194,-138,3199
228,2022/7/15 8:20,51,332,-281,1482
228,2022/7/15 8:30,45,324,-279,666
228,2022/7/15 8:40,44,381,-337,-44
228,2022/7/15 8:50,43,297,-254,-107
228,2022/7/15 9:00,39,154,-115,-85
228,2022/7/15 9:10,32,125,-93,-295
228,2022/7/15 9:20,31,121,-90,-515
228,2022/7/15 9:30,28,105,-77,-563
228,2022/7/15 9:40,31,105,-74,-560
228,2022/7/15 9:50,31,114,-83,-571
228,2022/7/15 10:00,29,90,-61,-550
228,2022/7/15 10:10,26,75,-49,-520
228,2022/7/15 10:20,26,75,-49,-497
228,2022/7/15 10:30,23,69,-46,-529
228,2022/7/15 10:40,28,69,-41,-537
228,2022/7/15 10:50,27,66,-39,-462
228,2022/7/15 11:00,24,63,-39,-458
228,2022/7/15 11:10,25,62,-37,-450
228,2022/7/15 11:20,23,60,-37,-437
228,2022/7/15 11:30,29,60,-31,-480
228,2022/7/15 11:40,24,73,-49,-471
228,2022/7/15 11:50,22,70,-48,-454
228,2022/7/15 12:00,35,70,-35,-438
228,2022/7/15 12:10,36,65,-29,-458
228,2022/7/15 12:20,32,65,-33,-474
228,2022/7/15 12:30,33,71,-38,-504
228,2022/7/15 12:40,30,70,-40,-539
228,2022/7/15 12:50,25,64,-39,-574
228,2022/7/15 13:00,26,73,-47,-626
228,2022/7/15 13:10,27,76,-49,-556
228,2022/7/15 13:20,27,84,-57,-566
228,2022/7/15 13:30,27,68,-41,-577
228,2022/7/15 13:40,24,67,-43,-570
228,2022/7/15 13:50,23,75,-52,-589
228,2022/7/15 14:00,30,68,-38,-555
228,2022/7/15 14:10,35,65,-30,-579
228,2022/7/15 14:20,38,70,-32,-571
228,2022/7/15 14:30,32,66,-34,-602
228,2022/7/15 14:40,114,80,34,-513
228,2022/7/15 14:50,124,70,54,-512
228,2022/7/15 15:00,57,68,-11,-597
228,2022/7/15 15:10,65,71,-6,-662
228,2022/7/15 15:20,119,68,51,-564
228,2022/7/15 15:30,132,69,63,-579
228,2022/7/15 15:40,164,81,83,-546
228,2022/7/15 15:50,172,70,102,-535
228,2022/7/15 16:00,164,75,89,-572
228,2022/7/15 16:10,190,77,113,-501
228,2022/7/15 16:20,154,76,78,-573
228,2022/7/15 16:30,174,70,104,-595
228,2022/7/15 16:40,191,76,115,-439
228,2022/7/15 16:50,174,74,100,-568
228,2022/7/15 17:00,187,93,94,-191
228,2022/7/15 17:10,243,91,152,-64
228,2022/7/15 17:20,204,111,93,-611
228,2022/7/15 17:30,244,105,139,-650
228,2022/7/15 17:40,335,86,249,-455
228,2022/7/15 17:50,264,103,161,-1232
228,2022/7/15 18:00,273,110,163,-1452
228,2022/7/15 18:10,294,109,185,-1640
228,2022/7/15 18:20,198,109,89,-2044
228,2022/7/15 18:30,149,105,44,-1939
228,2022/7/15 18:40,85,108,-23,-2060
228,2022/7/15 18:50,51,110,-59,-2322
228,2022/7/15 19:00,47,113,-66,-2004
228,2022/7/15 19:10,47,107,-60,-1886
228,2022/7/15 19:20,44,81,-37,-1523
228,2022/7/15 19:30,39,77,-38,-1257
228,2022/7/15 19:40,39,79,-40,-1152
228,2022/7/15 19:50,39,72,-33,-1107
228,2022/7/15 20:00,36,64,-28,-1030
228,2022/7/15 20:10,39,70,-31,-1031
228,2022/7/15 20:20,33,59,-26,-986
228,2022/7/15 20:30,35,65,-30,-950
228,2022/7/15 20:40,38,68,-30,-949
228,2022/7/15 20:50,35,63,-28,-940
228,2022/7/15 21:00,34,66,-32,-893
228,2022/7/15 21:10,32,54,-22,-900
228,2022/7/15 21:20,32,66,-34,-944
228,2022/7/15 21:30,25,62,-37,-973
228,2022/7/15 21:40,28,59,-31,-934
228,2022/7/15 21:50,26,55,-29,-959
228,2022/7/15 22:00,29,62,-33,-909
228,2022/7/15 22:10,21,40,-19,-911
228,2022/7/15 22:20,13,63,-50,-922
228,2022/7/15 22:30,9,50,-41,-927
228,2022/7/15 22:40,9,49,-40,-860
228,2022/7/15 22:50,2,32,-30,-820
221,2022/7/15 5:00,0,1,-1,-17
221,2022/7/15 5:10,0,1,-1,-1
221,2022/7/15 5:20,0,1,-1,44
221,2022/7/15 5:30,1,1,0,134
221,2022/7/15 5:40,8,1,7,237
221,2022/7/15 5:50,10,14,-4,301
221,2022/7/15 6:00,19,6,13,368
221,2022/7/15 6:10,20,23,-3,351
221,2022/7/15 6:20,25,47,-22,324
221,2022/7/15 6:30,32,40,-8,395
221,2022/7/15 6:40,43,55,-12,454
221,2022/7/15 6:50,46,63,-17,490
221,2022/7/15 7:00,46,77,-31,560
221,2022/7/15 7:10,54,92,-38,1069
221,2022/7/15 7:20,58,101,-43,1687
221,2022/7/15 7:30,86,125,-39,3139
221,2022/7/15 7:40,128,145,-17,4594
221,2022/7/15 7:50,185,284,-99,4717
221,2022/7/15 8:00,188,497,-309,3855
221,2022/7/15 8:10,188,581,-393,2806
221,2022/7/15 8:20,224,1510,-1286,196
221,2022/7/15 8:30,193,2839,-2646,-1980
221,2022/7/15 8:40,126,3008,-2882,-2926
221,2022/7/15 8:50,85,3300,-3215,-3322
221,2022/7/15 9:00,70,638,-568,-653
221,2022/7/15 9:10,51,422,-371,-666
221,2022/7/15 9:20,47,326,-279,-794
221,2022/7/15 9:30,40,282,-242,-805
221,2022/7/15 9:40,29,231,-202,-762
221,2022/7/15 9:50,33,132,-99,-670
221,2022/7/15 10:00,31,102,-71,-621
221,2022/7/15 10:10,29,99,-70,-590
221,2022/7/15 10:20,33,80,-47,-544
221,2022/7/15 10:30,30,93,-63,-592
221,2022/7/15 10:40,33,83,-50,-587
221,2022/7/15 10:50,28,83,-55,-517
221,2022/7/15 11:00,32,67,-35,-493
221,2022/7/15 11:10,30,80,-50,-500
221,2022/7/15 11:20,27,61,-34,-471
221,2022/7/15 11:30,31,83,-52,-532
221,2022/7/15 11:40,37,64,-27,-498
221,2022/7/15 11:50,37,67,-30,-484
221,2022/7/15 12:00,39,75,-36,-474
221,2022/7/15 12:10,35,70,-35,-493
221,2022/7/15 12:20,35,73,-38,-512
221,2022/7/15 12:30,39,83,-44,-548
221,2022/7/15 12:40,37,90,-53,-592
221,2022/7/15 12:50,37,81,-44,-618
221,2022/7/15 13:00,37,75,-38,-664
221,2022/7/15 13:10,37,83,-46,-602
221,2022/7/15 13:20,32,76,-44,-610
221,2022/7/15 13:30,31,93,-62,-639
221,2022/7/15 13:40,35,75,-40,-610
221,2022/7/15 13:50,31,77,-46,-635
221,2022/7/15 14:00,32,71,-39,-594
221,2022/7/15 14:10,33,76,-43,-622
221,2022/7/15 14:20,31,83,-52,-623
221,2022/7/15 14:30,37,81,-44,-646
221,2022/7/15 14:40,38,71,-33,-546
221,2022/7/15 14:50,31,66,-35,-547
221,2022/7/15 15:00,36,74,-38,-635
221,2022/7/15 15:10,43,68,-25,-687
221,2022/7/15 15:20,42,71,-29,-593
221,2022/7/15 15:30,47,68,-21,-600
221,2022/7/15 15:40,35,77,-42,-588
221,2022/7/15 15:50,37,74,-37,-572
221,2022/7/15 16:00,42,82,-40,-612
221,2022/7/15 16:10,54,65,-11,-512
221,2022/7/15 16:20,41,78,-37,-610
221,2022/7/15 16:30,56,93,-37,-632
221,2022/7/15 16:40,90,73,17,-422
221,2022/7/15 16:50,76,76,0,-568
221,2022/7/15 17:00,269,96,173,-18
221,2022/7/15 17:10,379,108,271,207
221,2022/7/15 17:20,314,104,210,-401
221,2022/7/15 17:30,544,101,443,-207
221,2022/7/15 17:40,845,126,719,264
221,2022/7/15 17:50,616,105,511,-721
221,2022/7/15 18:00,713,127,586,-866
221,2022/7/15 18:10,1568,125,1443,-197
221,2022/7/15 18:20,1031,110,921,-1123
221,2022/7/15 18:30,697,121,576,-1363
221,2022/7/15 18:40,581,125,456,-1604
221,2022/7/15 18:50,353,108,245,-2077
221,2022/7/15 19:00,309,110,199,-1805
221,2022/7/15 19:10,272,104,168,-1718
221,2022/7/15 19:20,235,113,122,-1401
221,2022/7/15 19:30,186,80,106,-1151
221,2022/7/15 19:40,170,79,91,-1061
221,2022/7/15 19:50,116,77,39,-1068
221,2022/7/15 20:00,85,69,16,-1014
221,2022/7/15 20:10,151,63,88,-943
221,2022/7/15 20:20,79,70,9,-977
221,2022/7/15 20:30,84,69,15,-935
221,2022/7/15 20:40,86,62,24,-925
221,2022/7/15 20:50,68,75,-7,-947
221,2022/7/15 21:00,69,69,0,-893
221,2022/7/15 21:10,87,68,19,-881
221,2022/7/15 21:20,60,74,-14,-958
221,2022/7/15 21:30,44,67,-23,-996
221,2022/7/15 21:40,35,63,-28,-962
221,2022/7/15 21:50,29,67,-38,-997
221,2022/7/15 22:00,44,68,-24,-933
221,2022/7/15 22:10,33,62,-29,-940
221,2022/7/15 22:20,25,69,-44,-966
221,2022/7/15 22:30,18,45,-27,-954
221,2022/7/15 22:40,16,55,-39,-899
221,2022/7/15 22:50,7,25,-18,-838
217,2022/7/15 5:00,0,1,-1,-18
217,2022/7/15 5:10,0,1,-1,-2
217,2022/7/15 5:20,0,1,-1,43
217,2022/7/15 5:30,4,1,3,137
217,2022/7/15 5:40,8,1,7,244
217,2022/7/15 5:50,13,2,11,312
217,2022/7/15 6:00,20,1,19,387
217,2022/7/15 6:10,26,19,7,358
217,2022/7/15 6:20,32,19,13,337
217,2022/7/15 6:30,31,31,0,395
217,2022/7/15 6:40,41,50,-9,445
217,2022/7/15 6:50,57,72,-15,475
217,2022/7/15 7:00,60,93,-33,527
217,2022/7/15 7:10,58,75,-17,1052
217,2022/7/15 7:20,78,71,7,1694
217,2022/7/15 7:30,108,70,38,3177
217,2022/7/15 7:40,186,75,111,4705
217,2022/7/15 7:50,226,75,151,4868
217,2022/7/15 8:00,244,80,164,4019
217,2022/7/15 8:10,269,98,171,2977
217,2022/7/15 8:20,254,99,155,351
217,2022/7/15 8:30,244,112,132,-1848
217,2022/7/15 8:40,170,108,62,-2864
217,2022/7/15 8:50,108,104,4,-3318
217,2022/7/15 9:00,66,92,-26,-679
217,2022/7/15 9:10,50,83,-33,-699
217,2022/7/15 9:20,50,68,-18,-812
217,2022/7/15 9:30,41,64,-23,-828
217,2022/7/15 9:40,29,58,-29,-791
217,2022/7/15 9:50,28,50,-22,-692
217,2022/7/15 10:00,26,45,-19,-640
217,2022/7/15 10:10,26,52,-26,-616
217,2022/7/15 10:20,23,42,-19,-563
217,2022/7/15 10:30,23,45,-22,-614
217,2022/7/15 10:40,20,49,-29,-616
217,2022/7/15 10:50,19,46,-27,-544
217,2022/7/15 11:00,18,38,-20,-513
217,2022/7/15 11:10,20,40,-20,-520
217,2022/7/15 11:20,22,45,-23,-494
217,2022/7/15 11:30,22,51,-29,-561
217,2022/7/15 11:40,23,55,-32,-530
217,2022/7/15 11:50,25,50,-25,-509
217,2022/7/15 12:00,27,50,-23,-497
217,2022/7/15 12:10,29,50,-21,-514
217,2022/7/15 12:20,29,54,-25,-537
217,2022/7/15 12:30,28,66,-38,-586
217,2022/7/15 12:40,25,64,-39,-631
217,2022/7/15 12:50,28,67,-39,-657
217,2022/7/15 13:00,29,51,-22,-686
217,2022/7/15 13:10,28,61,-33,-635
217,2022/7/15 13:20,25,51,-26,-636
217,2022/7/15 13:30,26,42,-16,-655
217,2022/7/15 13:40,25,48,-23,-633
217,2022/7/15 13:50,23,59,-36,-671
217,2022/7/15 14:00,22,50,-28,-622
217,2022/7/15 14:10,23,51,-28,-650
217,2022/7/15 14:20,20,52,-32,-655
217,2022/7/15 14:30,20,50,-30,-676
217,2022/7/15 14:40,22,51,-29,-575
217,2022/7/15 14:50,21,54,-33,-580
217,2022/7/15 15:00,26,57,-31,-666
217,2022/7/15 15:10,24,52,-28,-715
217,2022/7/15 15:20,24,57,-33,-626
217,2022/7/15 15:30,25,60,-35,-635
217,2022/7/15 15:40,25,72,-47,-635
217,2022/7/15 15:50,24,60,-36,-608
217,2022/7/15 16:00,27,72,-45,-657
217,2022/7/15 16:10,25,70,-45,-557
217,2022/7/15 16:20,27,71,-44,-654
217,2022/7/15 16:30,28,65,-37,-669
217,2022/7/15 16:40,25,69,-44,-466
217,2022/7/15 16:50,25,81,-56,-624
217,2022/7/15 17:00,29,93,-64,-82
217,2022/7/15 17:10,43,112,-69,138
217,2022/7/15 17:20,44,104,-60,-461
217,2022/7/15 17:30,40,104,-64,-271
217,2022/7/15 17:40,34,107,-73,191
217,2022/7/15 17:50,31,115,-84,-805
217,2022/7/15 18:00,29,111,-82,-948
217,2022/7/15 18:10,38,133,-95,-292
217,2022/7/15 18:20,37,111,-74,-1197
217,2022/7/15 18:30,30,110,-80,-1443
217,2022/7/15 18:40,31,124,-93,-1697
217,2022/7/15 18:50,31,125,-94,-2171
217,2022/7/15 19:00,26,129,-103,-1908
217,2022/7/15 19:10,27,110,-83,-1801
217,2022/7/15 19:20,26,108,-82,-1483
217,2022/7/15 19:30,26,95,-69,-1220
217,2022/7/15 19:40,25,82,-57,-1118
217,2022/7/15 19:50,28,77,-49,-1117
217,2022/7/15 20:00,29,73,-44,-1058
217,2022/7/15 20:10,27,79,-52,-995
217,2022/7/15 20:20,26,75,-49,-1026
217,2022/7/15 20:30,20,65,-45,-980
217,2022/7/15 20:40,21,85,-64,-989
217,2022/7/15 20:50,23,72,-49,-996
217,2022/7/15 21:00,26,75,-49,-942
217,2022/7/15 21:10,24,79,-55,-936
217,2022/7/15 21:20,18,79,-61,-1019
217,2022/7/15 21:30,22,74,-52,-1048
217,2022/7/15 21:40,21,87,-66,-1028
217,2022/7/15 21:50,13,74,-61,-1058
217,2022/7/15 22:00,14,68,-54,-987
217,2022/7/15 22:10,11,64,-53,-993
217,2022/7/15 22:20,9,55,-46,-1012
217,2022/7/15 22:30,4,68,-64,-1018
217,2022/7/15 22:40,5,41,-36,-935
217,2022/7/15 22:50,4,41,-37,-875
222,2022/7/15 5:00,0,1,-1,-19
222,2022/7/15 5:10,0,1,-1,-3
222,2022/7/15 5:20,0,1,-1,42
222,2022/7/15 5:30,2,1,1,138
222,2022/7/15 5:40,6,5,1,245
222,2022/7/15 5:50,7,8,-1,311
222,2022/7/15 6:00,10,6,4,391
222,2022/7/15 6:10,15,46,-31,327
222,2022/7/15 6:20,25,29,-4,333
222,2022/7/15 6:30,32,50,-18,377
222,2022/7/15 6:40,38,48,-10,435
222,2022/7/15 6:50,37,75,-38,437
222,2022/7/15 7:00,57,93,-36,491
222,2022/7/15 7:10,58,101,-43,1009
222,2022/7/15 7:20,84,109,-25,1669
222,2022/7/15 7:30,87,121,-34,3143
222,2022/7/15 7:40,180,104,76,4781
222,2022/7/15 7:50,198,133,65,4933
222,2022/7/15 8:00,189,111,78,4097
222,2022/7/15 8:10,224,110,114,3091
222,2022/7/15 8:20,186,124,62,413
222,2022/7/15 8:30,183,108,75,-1773
222,2022/7/15 8:40,156,108,48,-2816
222,2022/7/15 8:50,114,120,-6,-3324
222,2022/7/15 9:00,74,106,-32,-711
222,2022/7/15 9:10,58,112,-54,-753
222,2022/7/15 9:20,48,105,-57,-869
222,2022/7/15 9:30,42,82,-40,-868
222,2022/7/15 9:40,38,92,-54,-845
222,2022/7/15 9:50,33,92,-59,-751
222,2022/7/15 10:00,30,73,-43,-683
222,2022/7/15 10:10,29,65,-36,-652
222,2022/7/15 10:20,28,66,-38,-601
222,2022/7/15 10:30,32,76,-44,-658
222,2022/7/15 10:40,33,67,-34,-650
222,2022/7/15 10:50,29,65,-36,-580
222,2022/7/15 11:00,29,66,-37,-550
222,2022/7/15 11:10,29,64,-35,-555
222,2022/7/15 11:20,27,63,-36,-530
222,2022/7/15 11:30,27,64,-37,-598
222,2022/7/15 11:40,27,62,-35,-565
222,2022/7/15 11:50,28,52,-24,-533
222,2022/7/15 12:00,31,59,-28,-525
222,2022/7/15 12:10,27,67,-40,-554
222,2022/7/15 12:20,27,62,-35,-572
222,2022/7/15 12:30,29,67,-38,-624
222,2022/7/15 12:40,25,72,-47,-678
222,2022/7/15 12:50,24,78,-54,-711
222,2022/7/15 13:00,28,80,-52,-738
222,2022/7/15 13:10,28,69,-41,-676
222,2022/7/15 13:20,30,73,-43,-679
222,2022/7/15 13:30,28,62,-34,-689
222,2022/7/15 13:40,27,71,-44,-677
222,2022/7/15 13:50,26,69,-43,-714
222,2022/7/15 14:00,27,62,-35,-657
222,2022/7/15 14:10,27,67,-40,-690
222,2022/7/15 14:20,27,71,-44,-699
222,2022/7/15 14:30,30,64,-34,-710
222,2022/7/15 14:40,30,61,-31,-606
222,2022/7/15 14:50,28,63,-35,-615
222,2022/7/15 15:00,29,82,-53,-719
222,2022/7/15 15:10,27,72,-45,-760
222,2022/7/15 15:20,27,70,-43,-669
222,2022/7/15 15:30,36,67,-31,-666
222,2022/7/15 15:40,34,72,-38,-673
222,2022/7/15 15:50,29,83,-54,-662
222,2022/7/15 16:00,37,70,-33,-690
222,2022/7/15 16:10,38,66,-28,-585
222,2022/7/15 16:20,43,82,-39,-693
222,2022/7/15 16:30,46,77,-31,-700
222,2022/7/15 16:40,48,64,-16,-482
222,2022/7/15 16:50,46,96,-50,-674
222,2022/7/15 17:00,58,93,-35,-117
222,2022/7/15 17:10,74,106,-32,106
222,2022/7/15 17:20,50,106,-56,-517
222,2022/7/15 17:30,46,119,-73,-344
222,2022/7/15 17:40,62,113,-51,140
222,2022/7/15 17:50,45,124,-79,-884
222,2022/7/15 18:00,37,125,-88,-1036
222,2022/7/15 18:10,54,107,-53,-345
222,2022/7/15 18:20,43,107,-64,-1261
222,2022/7/15 18:30,36,123,-87,-1530
222,2022/7/15 18:40,27,99,-72,-1769
222,2022/7/15 18:50,28,103,-75,-2246
222,2022/7/15 19:00,27,110,-83,-1991
222,2022/7/15 19:10,29,100,-71,-1872
222,2022/7/15 19:20,24,90,-66,-1549
222,2022/7/15 19:30,25,90,-65,-1285
222,2022/7/15 19:40,21,85,-64,-1182
222,2022/7/15 19:50,20,71,-51,-1168
222,2022/7/15 20:00,22,64,-42,-1100
222,2022/7/15 20:10,26,69,-43,-1038
222,2022/7/15 20:20,22,64,-42,-1068
222,2022/7/15 20:30,21,74,-53,-1033
222,2022/7/15 20:40,23,64,-41,-1030
222,2022/7/15 20:50,21,57,-36,-1032
222,2022/7/15 21:00,19,72,-53,-995
222,2022/7/15 21:10,16,64,-48,-984
222,2022/7/15 21:20,15,67,-52,-1071
222,2022/7/15 21:30,14,67,-53,-1101
222,2022/7/15 21:40,13,60,-47,-1075
222,2022/7/15 21:50,11,55,-44,-1102
222,2022/7/15 22:00,9,62,-53,-1040
222,2022/7/15 22:10,8,42,-34,-1027
222,2022/7/15 22:20,6,52,-46,-1058
222,2022/7/15 22:30,4,46,-42,-1060
222,2022/7/15 22:40,2,40,-38,-973
222,2022/7/15 22:50,2,25,-23,-898
218,2022/7/15 5:00,0,1,-1,-20
218,2022/7/15 5:10,0,1,-1,-4
218,2022/7/15 5:20,0,1,-1,41
218,2022/7/15 5:30,12,1,11,149
218,2022/7/15 5:40,13,6,7,252
218,2022/7/15 5:50,18,6,12,323
218,2022/7/15 6:00,22,8,14,405
218,2022/7/15 6:10,30,21,9,336
218,2022/7/15 6:20,38,22,16,349
218,2022/7/15 6:30,38,31,7,384
218,2022/7/15 6:40,61,60,1,436
218,2022/7/15 6:50,66,67,-1,436
218,2022/7/15 7:00,68,99,-31,460
218,2022/7/15 7:10,89,90,-1,1008
218,2022/7/15 7:20,149,101,48,1717
218,2022/7/15 7:30,199,125,74,3217
218,2022/7/15 7:40,246,138,108,4889
218,2022/7/15 7:50,282,192,90,5023
218,2022/7/15 8:00,285,119,166,4263
218,2022/7/15 8:10,317,137,180,3271
218,2022/7/15 8:20,277,232,45,458
218,2022/7/15 8:30,280,297,-17,-1790
218,2022/7/15 8:40,238,383,-145,-2961
218,2022/7/15 8:50,181,317,-136,-3460
218,2022/7/15 9:00,86,180,-94,-805
218,2022/7/15 9:10,52,144,-92,-845
218,2022/7/15 9:20,51,126,-75,-944
218,2022/7/15 9:30,37,112,-75,-943
218,2022/7/15 9:40,25,87,-62,-907
218,2022/7/15 9:50,33,71,-38,-789
218,2022/7/15 10:00,28,72,-44,-727
218,2022/7/15 10:10,28,71,-43,-695
218,2022/7/15 10:20,27,59,-32,-633
218,2022/7/15 10:30,26,59,-33,-691
218,2022/7/15 10:40,24,59,-35,-685
218,2022/7/15 10:50,26,64,-38,-618
218,2022/7/15 11:00,25,67,-42,-592
218,2022/7/15 11:10,27,48,-21,-576
218,2022/7/15 11:20,26,63,-37,-567
218,2022/7/15 11:30,25,51,-26,-624
218,2022/7/15 11:40,29,62,-33,-598
218,2022/7/15 11:50,28,62,-34,-567
218,2022/7/15 12:00,29,55,-26,-551
218,2022/7/15 12:10,27,58,-31,-585
218,2022/7/15 12:20,28,63,-35,-607
218,2022/7/15 12:30,29,62,-33,-657
218,2022/7/15 12:40,26,69,-43,-721
218,2022/7/15 12:50,26,75,-49,-760
218,2022/7/15 13:00,25,73,-48,-786
218,2022/7/15 13:10,22,71,-49,-725
218,2022/7/15 13:20,26,72,-46,-725
218,2022/7/15 13:30,27,69,-42,-731
218,2022/7/15 13:40,28,65,-37,-714
218,2022/7/15 13:50,25,62,-37,-751
218,2022/7/15 14:00,27,67,-40,-697
218,2022/7/15 14:10,29,61,-32,-722
218,2022/7/15 14:20,24,61,-37,-736
218,2022/7/15 14:30,27,64,-37,-747
218,2022/7/15 14:40,26,72,-46,-652
218,2022/7/15 14:50,26,71,-45,-660
218,2022/7/15 15:00,28,66,-38,-757
218,2022/7/15 15:10,27,64,-37,-797
218,2022/7/15 15:20,28,65,-37,-706
218,2022/7/15 15:30,30,77,-47,-713
218,2022/7/15 15:40,26,73,-47,-720
218,2022/7/15 15:50,27,62,-35,-697
218,2022/7/15 16:00,27,71,-44,-734
218,2022/7/15 16:10,30,77,-47,-632
218,2022/7/15 16:20,28,70,-42,-735
218,2022/7/15 16:30,30,96,-66,-766
218,2022/7/15 16:40,37,77,-40,-522
218,2022/7/15 16:50,29,104,-75,-749
218,2022/7/15 17:00,220,109,111,-6
218,2022/7/15 17:10,268,109,159,265
218,2022/7/15 17:20,137,102,35,-482
218,2022/7/15 17:30,274,117,157,-187
218,2022/7/15 17:40,265,116,149,289
218,2022/7/15 17:50,143,123,20,-864
218,2022/7/15 18:00,168,109,59,-977
218,2022/7/15 18:10,206,137,69,-276
218,2022/7/15 18:20,137,145,-8,-1269
218,2022/7/15 18:30,85,152,-67,-1597
218,2022/7/15 18:40,72,121,-49,-1818
218,2022/7/15 18:50,39,118,-79,-2325
218,2022/7/15 19:00,38,111,-73,-2064
218,2022/7/15 19:10,39,122,-83,-1955
218,2022/7/15 19:20,34,89,-55,-1604
218,2022/7/15 19:30,28,102,-74,-1359
218,2022/7/15 19:40,30,92,-62,-1244
218,2022/7/15 19:50,26,92,-66,-1234
218,2022/7/15 20:00,28,77,-49,-1149
218,2022/7/15 20:10,27,78,-51,-1089
218,2022/7/15 20:20,29,69,-40,-1108
218,2022/7/15 20:30,29,77,-48,-1081
218,2022/7/15 20:40,37,76,-39,-1069
218,2022/7/15 20:50,31,79,-48,-1080
218,2022/7/15 21:00,25,72,-47,-1042
218,2022/7/15 21:10,35,79,-44,-1028
218,2022/7/15 21:20,33,83,-50,-1121
218,2022/7/15 21:30,38,72,-34,-1135
218,2022/7/15 21:40,28,77,-49,-1124
218,2022/7/15 21:50,22,77,-55,-1157
218,2022/7/15 22:00,21,74,-53,-1093
218,2022/7/15 22:10,18,71,-53,-1080
218,2022/7/15 22:20,12,75,-63,-1121
218,2022/7/15 22:30,7,59,-52,-1112
218,2022/7/15 22:40,2,68,-66,-1039
218,2022/7/15 22:50,2,29,-27,-925
211,2022/7/15 5:00,0,1,-1,-21
211,2022/7/15 5:10,0,1,-1,-5
211,2022/7/15 5:20,6,1,5,46
211,2022/7/15 5:30,15,1,14,163
211,2022/7/15 5:40,10,2,8,260
211,2022/7/15 5:50,16,1,15,338
211,2022/7/15 6:00,24,2,22,427
211,2022/7/15 6:10,35,2,33,369
211,2022/7/15 6:20,47,32,15,364
211,2022/7/15 6:30,57,24,33,417
211,2022/7/15 6:40,70,49,21,457
211,2022/7/15 6:50,88,74,14,450
211,2022/7/15 7:00,163,104,59,519
211,2022/7/15 7:10,177,122,55,1063
211,2022/7/15 7:20,213,126,87,1804
211,2022/7/15 7:30,282,119,163,3380
211,2022/7/15 7:40,348,91,257,5146
211,2022/7/15 7:50,444,98,346,5369
211,2022/7/15 8:00,468,105,363,4626
211,2022/7/15 8:10,572,104,468,3739
211,2022/7/15 8:20,390,151,239,697
211,2022/7/15 8:30,318,326,-8,-1798
211,2022/7/15 8:40,282,321,-39,-3000
211,2022/7/15 8:50,231,324,-93,-3553
211,2022/7/15 9:00,148,213,-65,-870
211,2022/7/15 9:10,86,128,-42,-887
211,2022/7/15 9:20,67,106,-39,-983
211,2022/7/15 9:30,49,109,-60,-1003
211,2022/7/15 9:40,37,97,-60,-967
211,2022/7/15 9:50,31,83,-52,-841
211,2022/7/15 10:00,32,70,-38,-765
211,2022/7/15 10:10,28,65,-37,-732
211,2022/7/15 10:20,29,60,-31,-664
211,2022/7/15 10:30,29,54,-25,-716
211,2022/7/15 10:40,27,55,-28,-713
211,2022/7/15 10:50,26,50,-24,-642
211,2022/7/15 11:00,27,55,-28,-620
211,2022/7/15 11:10,24,54,-30,-606
211,2022/7/15 11:20,29,51,-22,-589
211,2022/7/15 11:30,28,51,-23,-647
211,2022/7/15 11:40,29,54,-25,-623
211,2022/7/15 11:50,28,54,-26,-593
211,2022/7/15 12:00,29,61,-32,-583
211,2022/7/15 12:10,27,60,-33,-618
211,2022/7/15 12:20,29,60,-31,-638
211,2022/7/15 12:30,29,60,-31,-688
211,2022/7/15 12:40,23,70,-47,-768
211,2022/7/15 12:50,25,68,-43,-803
211,2022/7/15 13:00,28,64,-36,-822
211,2022/7/15 13:10,25,68,-43,-768
211,2022/7/15 13:20,28,69,-41,-766
211,2022/7/15 13:30,29,61,-32,-763
211,2022/7/15 13:40,26,61,-35,-749
211,2022/7/15 13:50,28,67,-39,-790
211,2022/7/15 14:00,28,61,-33,-730
211,2022/7/15 14:10,23,65,-42,-764
211,2022/7/15 14:20,28,59,-31,-767
211,2022/7/15 14:30,28,62,-34,-781
211,2022/7/15 14:40,28,71,-43,-695
211,2022/7/15 14:50,27,67,-40,-700
211,2022/7/15 15:00,27,70,-43,-800
211,2022/7/15 15:10,29,68,-39,-836
211,2022/7/15 15:20,29,68,-39,-745
211,2022/7/15 15:30,25,76,-51,-764
211,2022/7/15 15:40,26,74,-48,-768
211,2022/7/15 15:50,28,78,-50,-747
211,2022/7/15 16:00,32,77,-45,-779
211,2022/7/15 16:10,32,77,-45,-677
211,2022/7/15 16:20,39,93,-54,-789
211,2022/7/15 16:30,61,92,-31,-797
211,2022/7/15 16:40,85,96,-11,-533
211,2022/7/15 16:50,177,105,72,-677
211,2022/7/15 17:00,207,109,98,92
211,2022/7/15 17:10,198,115,83,348
211,2022/7/15 17:20,106,110,-4,-486
211,2022/7/15 17:30,77,118,-41,-228
211,2022/7/15 17:40,213,127,86,375
211,2022/7/15 17:50,77,177,-100,-964
211,2022/7/15 18:00,98,152,-54,-1031
211,2022/7/15 18:10,275,226,49,-227
211,2022/7/15 18:20,174,158,16,-1253
211,2022/7/15 18:30,77,224,-147,-1744
211,2022/7/15 18:40,136,224,-88,-1906
211,2022/7/15 18:50,72,171,-99,-2424
211,2022/7/15 19:00,44,119,-75,-2139
211,2022/7/15 19:10,37,122,-85,-2040
211,2022/7/15 19:20,35,88,-53,-1657
211,2022/7/15 19:30,29,110,-81,-1440
211,2022/7/15 19:40,24,110,-86,-1330
211,2022/7/15 19:50,23,92,-69,-1303
211,2022/7/15 20:00,29,78,-49,-1198
211,2022/7/15 20:10,35,95,-60,-1149
211,2022/7/15 20:20,25,82,-57,-1165
211,2022/7/15 20:30,28,82,-54,-1135
211,2022/7/15 20:40,28,90,-62,-1131
211,2022/7/15 20:50,25,88,-63,-1143
211,2022/7/15 21:00,26,76,-50,-1092
211,2022/7/15 21:10,32,94,-62,-1090
211,2022/7/15 21:20,29,79,-50,-1171
211,2022/7/15 21:30,28,83,-55,-1190
211,2022/7/15 21:40,28,78,-50,-1174
211,2022/7/15 21:50,28,76,-48,-1205
211,2022/7/15 22:00,17,68,-51,-1144
211,2022/7/15 22:10,21,83,-62,-1142
211,2022/7/15 22:20,13,75,-62,-1183
211,2022/7/15 22:30,11,67,-56,-1168
211,2022/7/15 22:40,4,62,-58,-1097
211,2022/7/15 22:50,2,59,-57,-982
209,2022/7/15 5:00,0,1,-1,-22
209,2022/7/15 5:10,0,1,-1,-6
209,2022/7/15 5:20,5,1,4,50
209,2022/7/15 5:30,13,1,12,175
209,2022/7/15 5:40,14,1,13,273
209,2022/7/15 5:50,20,1,19,357
209,2022/7/15 6:00,26,1,25,452
209,2022/7/15 6:10,32,1,31,400
209,2022/7/15 6:20,39,19,20,384
209,2022/7/15 6:30,59,33,26,443
209,2022/7/15 6:40,81,31,50,507
209,2022/7/15 6:50,81,41,40,490
209,2022/7/15 7:00,150,48,102,621
209,2022/7/15 7:10,187,55,132,1195
209,2022/7/15 7:20,231,50,181,1985
209,2022/7/15 7:30,275,60,215,3595
209,2022/7/15 7:40,336,63,273,5419
209,2022/7/15 7:50,360,79,281,5650
209,2022/7/15 8:00,375,77,298,4924
209,2022/7/15 8:10,474,76,398,4137
209,2022/7/15 8:20,392,90,302,999
209,2022/7/15 8:30,326,113,213,-1585
209,2022/7/15 8:40,243,103,140,-2860
209,2022/7/15 8:50,195,105,90,-3463
209,2022/7/15 9:00,139,75,64,-806
209,2022/7/15 9:10,86,72,14,-873
209,2022/7/15 9:20,64,50,14,-969
209,2022/7/15 9:30,44,69,-25,-1028
209,2022/7/15 9:40,38,60,-22,-989
209,2022/7/15 9:50,29,52,-23,-864
209,2022/7/15 10:00,31,49,-18,-783
209,2022/7/15 10:10,27,52,-25,-757
209,2022/7/15 10:20,28,65,-37,-701
209,2022/7/15 10:30,29,48,-19,-735
209,2022/7/15 10:40,28,48,-20,-733
209,2022/7/15 10:50,24,51,-27,-669
209,2022/7/15 11:00,25,57,-32,-652
209,2022/7/15 11:10,24,50,-26,-632
209,2022/7/15 11:20,25,45,-20,-609
209,2022/7/15 11:30,23,47,-24,-671
209,2022/7/15 11:40,24,52,-28,-651
209,2022/7/15 11:50,27,53,-26,-619
209,2022/7/15 12:00,26,51,-25,-608
209,2022/7/15 12:10,28,50,-22,-640
209,2022/7/15 12:20,31,50,-19,-657
209,2022/7/15 12:30,28,55,-27,-715
209,2022/7/15 12:40,25,60,-35,-803
209,2022/7/15 12:50,27,51,-24,-827
209,2022/7/15 13:00,26,51,-25,-847
209,2022/7/15 13:10,27,57,-30,-798
209,2022/7/15 13:20,29,60,-31,-797
209,2022/7/15 13:30,27,50,-23,-786
209,2022/7/15 13:40,22,49,-27,-776
209,2022/7/15 13:50,22,57,-35,-825
209,2022/7/15 14:00,24,67,-43,-773
209,2022/7/15 14:10,27,60,-33,-797
209,2022/7/15 14:20,22,57,-35,-802
209,2022/7/15 14:30,22,61,-39,-820
209,2022/7/15 14:40,23,62,-39,-734
209,2022/7/15 14:50,22,69,-47,-747
209,2022/7/15 15:00,22,58,-36,-836
209,2022/7/15 15:10,28,64,-36,-872
209,2022/7/15 15:20,25,67,-42,-787
209,2022/7/15 15:30,25,75,-50,-814
209,2022/7/15 15:40,27,78,-51,-819
209,2022/7/15 15:50,25,76,-51,-798
209,2022/7/15 16:00,28,72,-44,-823
209,2022/7/15 16:10,26,79,-53,-730
209,2022/7/15 16:20,29,75,-46,-835
209,2022/7/15 16:30,28,76,-48,-845
209,2022/7/15 16:40,28,98,-70,-603
209,2022/7/15 16:50,30,96,-66,-743
209,2022/7/15 17:00,43,106,-63,29
209,2022/7/15 17:10,48,100,-52,296
209,2022/7/15 17:20,31,106,-75,-561
209,2022/7/15 17:30,31,110,-79,-307
209,2022/7/15 17:40,36,118,-82,293
209,2022/7/15 17:50,32,151,-119,-1083
209,2022/7/15 18:00,25,144,-119,-1150
209,2022/7/15 18:10,32,181,-149,-376
209,2022/7/15 18:20,27,227,-200,-1453
209,2022/7/15 18:30,26,153,-127,-1871
209,2022/7/15 18:40,23,180,-157,-2063
209,2022/7/15 18:50,22,184,-162,-2586
209,2022/7/15 19:00,20,107,-87,-2226
209,2022/7/15 19:10,17,104,-87,-2127
209,2022/7/15 19:20,15,109,-94,-1751
209,2022/7/15 19:30,15,114,-99,-1539
209,2022/7/15 19:40,17,106,-89,-1419
209,2022/7/15 19:50,16,94,-78,-1381
209,2022/7/15 20:00,14,89,-75,-1273
209,2022/7/15 20:10,14,93,-79,-1228
209,2022/7/15 20:20,15,86,-71,-1236
209,2022/7/15 20:30,14,84,-70,-1205
209,2022/7/15 20:40,16,92,-76,-1207
209,2022/7/15 20:50,14,79,-65,-1208
209,2022/7/15 21:00,14,77,-63,-1155
209,2022/7/15 21:10,15,89,-74,-1164
209,2022/7/15 21:20,10,80,-70,-1241
209,2022/7/15 21:30,11,79,-68,-1258
209,2022/7/15 21:40,12,79,-67,-1241
209,2022/7/15 21:50,9,76,-67,-1272
209,2022/7/15 22:00,10,72,-62,-1206
209,2022/7/15 22:10,7,74,-67,-1209
209,2022/7/15 22:20,4,70,-66,-1249
209,2022/7/15 22:30,2,64,-62,-1230
209,2022/7/15 22:40,0,71,-71,-1168
209,2022/7/15 22:50,0,51,-51,-1033
212,2022/7/15 5:00,0,1,-1,-23
212,2022/7/15 5:10,0,1,-1,-7
212,2022/7/15 5:20,4,1,3,53
212,2022/7/15 5:30,14,1,13,188
212,2022/7/15 5:40,16,1,15,288
212,2022/7/15 5:50,18,1,17,374
212,2022/7/15 6:00,23,1,22,474
212,2022/7/15 6:10,31,1,30,430
212,2022/7/15 6:20,41,21,20,404
212,2022/7/15 6:30,58,16,42,485
212,2022/7/15 6:40,78,23,55,562
212,2022/7/15 6:50,124,23,101,591
212,2022/7/15 7:00,163,23,140,761
212,2022/7/15 7:10,222,38,184,1379
212,2022/7/15 7:20,267,48,219,2204
212,2022/7/15 7:30,346,55,291,3886
212,2022/7/15 7:40,598,66,532,5951
212,2022/7/15 7:50,590,69,521,6171
212,2022/7/15 8:00,716,69,647,5571
212,2022/7/15 8:10,688,82,606,4743
212,2022/7/15 8:20,721,79,642,1641
212,2022/7/15 8:30,474,90,384,-1201
212,2022/7/15 8:40,347,96,251,-2609
212,2022/7/15 8:50,245,86,159,-3304
212,2022/7/15 9:00,191,76,115,-691
212,2022/7/15 9:10,116,83,33,-840
212,2022/7/15 9:20,60,65,-5,-974
212,2022/7/15 9:30,43,66,-23,-1051
212,2022/7/15 9:40,37,62,-25,-1014
212,2022/7/15 9:50,27,66,-39,-903
212,2022/7/15 10:00,33,67,-34,-817
212,2022/7/15 10:10,27,54,-27,-784
212,2022/7/15 10:20,29,51,-22,-723
212,2022/7/15 10:30,25,54,-29,-764
212,2022/7/15 10:40,28,50,-22,-755
212,2022/7/15 10:50,25,58,-33,-702
212,2022/7/15 11:00,21,52,-31,-683
212,2022/7/15 11:10,28,54,-26,-658
212,2022/7/15 11:20,27,52,-25,-634
212,2022/7/15 11:30,23,51,-28,-699
212,2022/7/15 11:40,24,55,-31,-682
212,2022/7/15 11:50,27,48,-21,-640
212,2022/7/15 12:00,28,50,-22,-630
212,2022/7/15 12:10,27,49,-22,-662
212,2022/7/15 12:20,27,53,-26,-683
212,2022/7/15 12:30,28,57,-29,-744
212,2022/7/15 12:40,27,65,-38,-841
212,2022/7/15 12:50,28,48,-20,-847
212,2022/7/15 13:00,27,61,-34,-881
212,2022/7/15 13:10,26,61,-35,-833
212,2022/7/15 13:20,27,52,-25,-822
212,2022/7/15 13:30,22,52,-30,-816
212,2022/7/15 13:40,26,54,-28,-804
212,2022/7/15 13:50,23,64,-41,-866
212,2022/7/15 14:00,21,54,-33,-806
212,2022/7/15 14:10,26,67,-41,-838
212,2022/7/15 14:20,23,62,-39,-841
212,2022/7/15 14:30,22,63,-41,-861
212,2022/7/15 14:40,21,69,-48,-782
212,2022/7/15 14:50,22,61,-39,-786
212,2022/7/15 15:00,21,65,-44,-880
212,2022/7/15 15:10,24,67,-43,-915
212,2022/7/15 15:20,23,71,-48,-835
212,2022/7/15 15:30,22,65,-43,-857
212,2022/7/15 15:40,22,77,-55,-874
212,2022/7/15 15:50,23,77,-54,-852
212,2022/7/15 16:00,24,91,-67,-890
212,2022/7/15 16:10,24,76,-52,-782
212,2022/7/15 16:20,27,69,-42,-877
212,2022/7/15 16:30,24,74,-50,-895
212,2022/7/15 16:40,27,114,-87,-690
212,2022/7/15 16:50,30,92,-62,-805
212,2022/7/15 17:00,34,120,-86,-57
212,2022/7/15 17:10,37,101,-64,232
212,2022/7/15 17:20,31,107,-76,-637
212,2022/7/15 17:30,34,110,-76,-383
212,2022/7/15 17:40,45,149,-104,189
212,2022/7/15 17:50,31,152,-121,-1204
212,2022/7/15 18:00,29,226,-197,-1347
212,2022/7/15 18:10,33,232,-199,-575
212,2022/7/15 18:20,31,218,-187,-1640
212,2022/7/15 18:30,28,232,-204,-2075
212,2022/7/15 18:40,28,285,-257,-2320
212,2022/7/15 18:50,23,233,-210,-2796
212,2022/7/15 19:00,22,191,-169,-2395
212,2022/7/15 19:10,20,145,-125,-2252
212,2022/7/15 19:20,20,109,-89,-1840
212,2022/7/15 19:30,18,123,-105,-1644
212,2022/7/15 19:40,17,125,-108,-1527
212,2022/7/15 19:50,17,114,-97,-1478
212,2022/7/15 20:00,18,106,-88,-1361
212,2022/7/15 20:10,17,104,-87,-1315
212,2022/7/15 20:20,14,93,-79,-1315
212,2022/7/15 20:30,17,78,-61,-1266
212,2022/7/15 20:40,18,104,-86,-1293
212,2022/7/15 20:50,16,95,-79,-1287
212,2022/7/15 21:00,11,83,-72,-1227
212,2022/7/15 21:10,15,108,-93,-1257
212,2022/7/15 21:20,15,93,-78,-1319
212,2022/7/15 21:30,10,89,-79,-1337
212,2022/7/15 21:40,10,97,-87,-1328
212,2022/7/15 21:50,8,78,-70,-1342
212,2022/7/15 22:00,10,78,-68,-1274
212,2022/7/15 22:10,8,78,-70,-1279
212,2022/7/15 22:20,6,67,-61,-1310
212,2022/7/15 22:30,4,86,-82,-1312
212,2022/7/15 22:40,1,64,-63,-1231
212,2022/7/15 22:50,0,53,-53,-1086
214,2022/7/15 5:00,0,1,-1,-24
214,2022/7/15 5:10,1,1,0,-7
214,2022/7/15 5:20,5,1,4,57
214,2022/7/15 5:30,10,1,9,197
214,2022/7/15 5:40,7,1,6,294
214,2022/7/15 5:50,13,1,12,386
214,2022/7/15 6:00,18,1,17,491
214,2022/7/15 6:10,24,1,23,453
214,2022/7/15 6:20,37,19,18,422
214,2022/7/15 6:30,48,23,25,510
214,2022/7/15 6:40,68,29,39,601
214,2022/7/15 6:50,58,49,9,600
214,2022/7/15 7:00,81,51,30,791
214,2022/7/15 7:10,152,73,79,1458
214,2022/7/15 7:20,162,81,81,2285
214,2022/7/15 7:30,206,106,100,3986
214,2022/7/15 7:40,188,105,83,6034
214,2022/7/15 7:50,279,105,174,6345
214,2022/7/15 8:00,345,71,274,5845
214,2022/7/15 8:10,271,76,195,4938
214,2022/7/15 8:20,241,72,169,1810
214,2022/7/15 8:30,267,73,194,-1007
214,2022/7/15 8:40,186,69,117,-2492
214,2022/7/15 8:50,93,72,21,-3283
214,2022/7/15 9:00,62,56,6,-685
214,2022/7/15 9:10,48,71,-23,-863
214,2022/7/15 9:20,44,51,-7,-981
214,2022/7/15 9:30,31,60,-29,-1080
214,2022/7/15 9:40,33,45,-12,-1026
214,2022/7/15 9:50,27,47,-20,-923
214,2022/7/15 10:00,28,44,-16,-833
214,2022/7/15 10:10,25,44,-19,-803
214,2022/7/15 10:20,23,42,-19,-742
214,2022/7/15 10:30,24,41,-17,-781
214,2022/7/15 10:40,20,50,-30,-785
214,2022/7/15 10:50,23,45,-22,-724
214,2022/7/15 11:00,24,42,-18,-701
214,2022/7/15 11:10,22,32,-10,-668
214,2022/7/15 11:20,20,33,-13,-647
214,2022/7/15 11:30,20,37,-17,-716
214,2022/7/15 11:40,22,37,-15,-697
214,2022/7/15 11:50,20,46,-26,-666
214,2022/7/15 12:00,20,41,-21,-651
214,2022/7/15 12:10,22,54,-32,-694
214,2022/7/15 12:20,23,45,-22,-705
214,2022/7/15 12:30,24,44,-20,-764
214,2022/7/15 12:40,20,47,-27,-868
214,2022/7/15 12:50,22,51,-29,-876
214,2022/7/15 13:00,19,48,-29,-910
214,2022/7/15 13:10,22,46,-24,-857
214,2022/7/15 13:20,18,45,-27,-849
214,2022/7/15 13:30,24,56,-32,-848
214,2022/7/15 13:40,16,65,-49,-853
214,2022/7/15 13:50,20,53,-33,-899
214,2022/7/15 14:00,17,49,-32,-838
214,2022/7/15 14:10,21,48,-27,-865
214,2022/7/15 14:20,18,51,-33,-874
214,2022/7/15 14:30,21,47,-26,-887
214,2022/7/15 14:40,20,52,-32,-814
214,2022/7/15 14:50,25,50,-25,-811
214,2022/7/15 15:00,25,59,-34,-914
214,2022/7/15 15:10,26,63,-37,-952
214,2022/7/15 15:20,19,57,-38,-873
214,2022/7/15 15:30,26,62,-36,-893
214,2022/7/15 15:40,20,60,-40,-914
214,2022/7/15 15:50,21,64,-43,-895
214,2022/7/15 16:00,29,60,-31,-921
214,2022/7/15 16:10,30,69,-39,-821
214,2022/7/15 16:20,28,93,-65,-942
214,2022/7/15 16:30,30,85,-55,-950
214,2022/7/15 16:40,28,75,-47,-737
214,2022/7/15 16:50,25,84,-59,-864
214,2022/7/15 17:00,32,75,-43,-100
214,2022/7/15 17:10,27,105,-78,154
214,2022/7/15 17:20,26,103,-77,-714
214,2022/7/15 17:30,28,105,-77,-460
214,2022/7/15 17:40,29,122,-93,96
214,2022/7/15 17:50,24,123,-99,-1303
214,2022/7/15 18:00,25,124,-99,-1446
214,2022/7/15 18:10,25,142,-117,-692
214,2022/7/15 18:20,24,192,-168,-1808
214,2022/7/15 18:30,18,107,-89,-2164
214,2022/7/15 18:40,15,122,-107,-2427
214,2022/7/15 18:50,15,114,-99,-2895
214,2022/7/15 19:00,14,110,-96,-2491
214,2022/7/15 19:10,12,111,-99,-2351
214,2022/7/15 19:20,13,92,-79,-1919
214,2022/7/15 19:30,12,102,-90,-1734
214,2022/7/15 19:40,12,94,-82,-1609
214,2022/7/15 19:50,8,66,-58,-1536
214,2022/7/15 20:00,12,69,-57,-1418
214,2022/7/15 20:10,11,59,-48,-1363
214,2022/7/15 20:20,10,53,-43,-1358
214,2022/7/15 20:30,9,63,-54,-1320
214,2022/7/15 20:40,11,61,-50,-1343
214,2022/7/15 20:50,10,75,-65,-1352
214,2022/7/15 21:00,9,62,-53,-1280
214,2022/7/15 21:10,9,63,-54,-1311
214,2022/7/15 21:20,5,56,-51,-1370
214,2022/7/15 21:30,5,53,-48,-1385
214,2022/7/15 21:40,4,53,-49,-1377
214,2022/7/15 21:50,4,55,-51,-1393
214,2022/7/15 22:00,4,49,-45,-1319
214,2022/7/15 22:10,2,41,-39,-1318
214,2022/7/15 22:20,2,53,-51,-1361
214,2022/7/15 22:30,1,40,-39,-1351
214,2022/7/15 22:40,0,46,-46,-1277
214,2022/7/15 22:50,0,40,-40,-1126
223,2022/7/15 5:00,0,1,-1,-25
223,2022/7/15 5:10,2,1,1,-6
223,2022/7/15 5:20,11,1,10,67
223,2022/7/15 5:30,12,1,11,208
223,2022/7/15 5:40,13,1,12,306
223,2022/7/15 5:50,19,1,18,404
223,2022/7/15 6:00,24,1,23,514
223,2022/7/15 6:10,32,2,30,483
223,2022/7/15 6:20,53,6,47,469
223,2022/7/15 6:30,63,38,25,535
223,2022/7/15 6:40,77,45,32,633
223,2022/7/15 6:50,85,41,44,644
223,2022/7/15 7:00,170,49,121,912
223,2022/7/15 7:10,174,67,107,1565
223,2022/7/15 7:20,185,65,120,2405
223,2022/7/15 7:30,256,71,185,4171
223,2022/7/15 7:40,278,91,187,6221
223,2022/7/15 7:50,349,73,276,6621
223,2022/7/15 8:00,345,69,276,6121
223,2022/7/15 8:10,475,87,388,5326
223,2022/7/15 8:20,357,75,282,2092
223,2022/7/15 8:30,280,65,215,-792
223,2022/7/15 8:40,215,83,132,-2360
223,2022/7/15 8:50,152,67,85,-3198
223,2022/7/15 9:00,75,50,25,-660
223,2022/7/15 9:10,57,65,-8,-871
223,2022/7/15 9:20,45,45,0,-981
223,2022/7/15 9:30,34,49,-15,-1095
223,2022/7/15 9:40,31,46,-15,-1041
223,2022/7/15 9:50,30,45,-15,-938
223,2022/7/15 10:00,30,46,-16,-849
223,2022/7/15 10:10,29,47,-18,-821
223,2022/7/15 10:20,25,49,-24,-766
223,2022/7/15 10:30,25,46,-21,-802
223,2022/7/15 10:40,22,48,-26,-811
223,2022/7/15 10:50,22,57,-35,-759
223,2022/7/15 11:00,23,45,-22,-723
223,2022/7/15 11:10,23,45,-22,-690
223,2022/7/15 11:20,22,47,-25,-672
223,2022/7/15 11:30,19,38,-19,-735
223,2022/7/15 11:40,24,45,-21,-718
223,2022/7/15 11:50,25,51,-26,-692
223,2022/7/15 12:00,29,47,-18,-669
223,2022/7/15 12:10,29,51,-22,-716
223,2022/7/15 12:20,28,62,-34,-739
223,2022/7/15 12:30,29,48,-19,-783
223,2022/7/15 12:40,28,46,-18,-886
223,2022/7/15 12:50,26,48,-22,-898
223,2022/7/15 13:00,24,42,-18,-928
223,2022/7/15 13:10,24,48,-24,-881
223,2022/7/15 13:20,23,49,-26,-875
223,2022/7/15 13:30,24,47,-23,-871
223,2022/7/15 13:40,23,45,-22,-875
223,2022/7/15 13:50,22,56,-34,-933
223,2022/7/15 14:00,20,52,-32,-870
223,2022/7/15 14:10,20,50,-30,-895
223,2022/7/15 14:20,20,47,-27,-901
223,2022/7/15 14:30,23,48,-25,-912
223,2022/7/15 14:40,19,54,-35,-849
223,2022/7/15 14:50,23,51,-28,-839
223,2022/7/15 15:00,23,59,-36,-950
223,2022/7/15 15:10,21,64,-43,-995
223,2022/7/15 15:20,22,66,-44,-917
223,2022/7/15 15:30,23,69,-46,-939
223,2022/7/15 15:40,22,60,-38,-952
223,2022/7/15 15:50,21,72,-51,-946
223,2022/7/15 16:00,23,68,-45,-966
223,2022/7/15 16:10,27,67,-40,-861
223,2022/7/15 16:20,26,93,-67,-1009
223,2022/7/15 16:30,29,60,-31,-981
223,2022/7/15 16:40,28,91,-63,-800
223,2022/7/15 16:50,28,92,-64,-928
223,2022/7/15 17:00,36,76,-40,-140
223,2022/7/15 17:10,44,105,-61,93
223,2022/7/15 17:20,45,113,-68,-782
223,2022/7/15 17:30,43,107,-64,-524
223,2022/7/15 17:40,57,110,-53,43
223,2022/7/15 17:50,45,117,-72,-1375
223,2022/7/15 18:00,46,109,-63,-1509
223,2022/7/15 18:10,48,110,-62,-754
223,2022/7/15 18:20,40,150,-110,-1918
223,2022/7/15 18:30,29,150,-121,-2285
223,2022/7/15 18:40,31,154,-123,-2550
223,2022/7/15 18:50,28,133,-105,-3000
223,2022/7/15 19:00,19,109,-90,-2581
223,2022/7/15 19:10,19,118,-99,-2450
223,2022/7/15 19:20,14,116,-102,-2021
223,2022/7/15 19:30,15,113,-98,-1832
223,2022/7/15 19:40,16,77,-61,-1670
223,2022/7/15 19:50,16,107,-91,-1627
223,2022/7/15 20:00,15,77,-62,-1480
223,2022/7/15 20:10,15,68,-53,-1416
223,2022/7/15 20:20,15,72,-57,-1415
223,2022/7/15 20:30,15,73,-58,-1378
223,2022/7/15 20:40,15,85,-70,-1413
223,2022/7/15 20:50,13,82,-69,-1421
223,2022/7/15 21:00,13,77,-64,-1344
223,2022/7/15 21:10,13,75,-62,-1373
223,2022/7/15 21:20,12,72,-60,-1430
223,2022/7/15 21:30,11,78,-67,-1452
223,2022/7/15 21:40,9,69,-60,-1437
223,2022/7/15 21:50,5,66,-61,-1454
223,2022/7/15 22:00,8,74,-66,-1385
223,2022/7/15 22:10,7,71,-64,-1382
223,2022/7/15 22:20,3,62,-59,-1420
223,2022/7/15 22:30,1,62,-61,-1412
223,2022/7/15 22:40,1,64,-63,-1340
223,2022/7/15 22:50,0,36,-36,-1162
219,2022/7/15 5:00,0,1,-1,-26
219,2022/7/15 5:10,1,1,0,-6
219,2022/7/15 5:20,7,1,6,73
219,2022/7/15 5:30,13,1,12,220
219,2022/7/15 5:40,10,1,9,315
219,2022/7/15 5:50,16,1,15,419
219,2022/7/15 6:00,25,1,24,538
219,2022/7/15 6:10,35,1,34,517
219,2022/7/15 6:20,57,11,46,515
219,2022/7/15 6:30,68,45,23,558
219,2022/7/15 6:40,85,93,-8,625
219,2022/7/15 6:50,128,111,17,661
219,2022/7/15 7:00,174,110,64,976
219,2022/7/15 7:10,188,85,103,1668
219,2022/7/15 7:20,244,45,199,2604
219,2022/7/15 7:30,278,38,240,4411
219,2022/7/15 7:40,327,63,264,6485
219,2022/7/15 7:50,386,50,336,6957
219,2022/7/15 8:00,597,41,556,6677
219,2022/7/15 8:10,597,63,534,5860
219,2022/7/15 8:20,339,55,284,2376
219,2022/7/15 8:30,279,63,216,-576
219,2022/7/15 8:40,241,74,167,-2193
219,2022/7/15 8:50,179,72,107,-3091
219,2022/7/15 9:00,76,66,10,-650
219,2022/7/15 9:10,66,62,4,-867
219,2022/7/15 9:20,50,57,-7,-988
219,2022/7/15 9:30,41,45,-4,-1099
219,2022/7/15 9:40,36,58,-22,-1063
219,2022/7/15 9:50,25,56,-31,-969
219,2022/7/15 10:00,29,54,-25,-874
219,2022/7/15 10:10,26,45,-19,-840
219,2022/7/15 10:20,23,47,-24,-790
219,2022/7/15 10:30,24,42,-18,-820
219,2022/7/15 10:40,23,48,-25,-836
219,2022/7/15 10:50,19,41,-22,-781
219,2022/7/15 11:00,21,50,-29,-752
219,2022/7/15 11:10,23,46,-23,-713
219,2022/7/15 11:20,20,50,-30,-702
219,2022/7/15 11:30,17,51,-34,-769
219,2022/7/15 11:40,21,41,-20,-738
219,2022/7/15 11:50,23,47,-24,-716
219,2022/7/15 12:00,23,38,-15,-684
219,2022/7/15 12:10,27,47,-20,-736
219,2022/7/15 12:20,25,38,-13,-752
219,2022/7/15 12:30,28,50,-22,-805
219,2022/7/15 12:40,23,51,-28,-914
219,2022/7/15 12:50,25,62,-37,-935
219,2022/7/15 13:00,25,60,-35,-963
219,2022/7/15 13:10,24,45,-21,-902
219,2022/7/15 13:20,22,45,-23,-898
219,2022/7/15 13:30,18,42,-24,-895
219,2022/7/15 13:40,22,48,-26,-901
219,2022/7/15 13:50,21,48,-27,-960
219,2022/7/15 14:00,23,46,-23,-893
219,2022/7/15 14:10,20,51,-31,-926
219,2022/7/15 14:20,14,69,-55,-956
219,2022/7/15 14:30,16,59,-43,-955
219,2022/7/15 14:40,19,63,-44,-893
219,2022/7/15 14:50,22,56,-34,-873
219,2022/7/15 15:00,20,61,-41,-991
219,2022/7/15 15:10,21,65,-44,-1039
219,2022/7/15 15:20,23,70,-47,-964
219,2022/7/15 15:30,21,73,-52,-991
219,2022/7/15 15:40,23,70,-47,-999
219,2022/7/15 15:50,23,79,-56,-1002
219,2022/7/15 16:00,23,80,-57,-1023
219,2022/7/15 16:10,22,68,-46,-907
219,2022/7/15 16:20,24,82,-58,-1067
219,2022/7/15 16:30,37,79,-42,-1023
219,2022/7/15 16:40,68,90,-22,-822
219,2022/7/15 16:50,67,106,-39,-967
219,2022/7/15 17:00,40,93,-53,-193
219,2022/7/15 17:10,33,105,-72,21
219,2022/7/15 17:20,30,109,-79,-861
219,2022/7/15 17:30,26,125,-99,-623
219,2022/7/15 17:40,48,103,-55,-12
219,2022/7/15 17:50,29,118,-89,-1464
219,2022/7/15 18:00,28,150,-122,-1631
219,2022/7/15 18:10,28,146,-118,-872
219,2022/7/15 18:20,21,159,-138,-2056
219,2022/7/15 18:30,21,150,-129,-2414
219,2022/7/15 18:40,16,180,-164,-2714
219,2022/7/15 18:50,15,329,-314,-3314
219,2022/7/15 19:00,14,180,-166,-2747
219,2022/7/15 19:10,14,110,-96,-2546
219,2022/7/15 19:20,12,117,-105,-2126
219,2022/7/15 19:30,14,112,-98,-1930
219,2022/7/15 19:40,16,95,-79,-1749
219,2022/7/15 19:50,11,95,-84,-1711
219,2022/7/15 20:00,11,81,-70,-1550
219,2022/7/15 20:10,13,95,-82,-1498
219,2022/7/15 20:20,13,112,-99,-1514
219,2022/7/15 20:30,13,80,-67,-1445
219,2022/7/15 20:40,12,75,-63,-1476
219,2022/7/15 20:50,13,85,-72,-1493
219,2022/7/15 21:00,13,79,-66,-1410
219,2022/7/15 21:10,13,91,-78,-1451
219,2022/7/15 21:20,8,77,-69,-1499
219,2022/7/15 21:30,8,69,-61,-1513
219,2022/7/15 21:40,10,77,-67,-1504
219,2022/7/15 21:50,8,79,-71,-1525
219,2022/7/15 22:00,6,67,-61,-1446
219,2022/7/15 22:10,6,71,-65,-1447
219,2022/7/15 22:20,4,66,-62,-1482
219,2022/7/15 22:30,2,64,-62,-1474
219,2022/7/15 22:40,0,40,-40,-1380
219,2022/7/15 22:50,0,47,-47,-1209
207,2022/7/15 5:00,0,1,-1,-27
207,2022/7/15 5:10,1,1,0,-6
207,2022/7/15 5:20,3,1,2,75
207,2022/7/15 5:30,5,1,4,224
207,2022/7/15 5:40,10,1,9,324
207,2022/7/15 5:50,12,1,11,430
207,2022/7/15 6:00,16,1,15,553
207,2022/7/15 6:10,18,2,16,533
207,2022/7/15 6:20,23,11,12,527
207,2022/7/15 6:30,33,14,19,577
207,2022/7/15 6:40,31,33,-2,623
207,2022/7/15 6:50,37,49,-12,649
207,2022/7/15 7:00,44,62,-18,958
207,2022/7/15 7:10,53,60,-7,1661
207,2022/7/15 7:20,66,65,1,2605
207,2022/7/15 7:30,78,68,10,4421
207,2022/7/15 7:40,91,77,14,6499
207,2022/7/15 7:50,122,97,25,6982
207,2022/7/15 8:00,158,116,42,6719
207,2022/7/15 8:10,144,109,35,5895
207,2022/7/15 8:20,144,124,20,2396
207,2022/7/15 8:30,71,102,-31,-607
207,2022/7/15 8:40,53,76,-23,-2216
207,2022/7/15 8:50,50,67,-17,-3108
207,2022/7/15 9:00,31,49,-18,-668
207,2022/7/15 9:10,33,46,-13,-880
207,2022/7/15 9:20,27,44,-17,-1005
207,2022/7/15 9:30,21,32,-11,-1110
207,2022/7/15 9:40,20,35,-15,-1078
207,2022/7/15 9:50,14,32,-18,-987
207,2022/7/15 10:00,12,30,-18,-892
207,2022/7/15 10:10,13,29,-16,-856
207,2022/7/15 10:20,12,23,-11,-801
207,2022/7/15 10:30,11,23,-12,-832
207,2022/7/15 10:40,13,31,-18,-854
207,2022/7/15 10:50,11,23,-12,-793
207,2022/7/15 11:00,14,21,-7,-759
207,2022/7/15 11:10,12,23,-11,-724
207,2022/7/15 11:20,11,25,-14,-716
207,2022/7/15 11:30,11,23,-12,-781
207,2022/7/15 11:40,9,23,-14,-752
207,2022/7/15 11:50,13,24,-11,-727
207,2022/7/15 12:00,12,30,-18,-702
207,2022/7/15 12:10,11,32,-21,-757
207,2022/7/15 12:20,13,31,-18,-770
207,2022/7/15 12:30,14,23,-9,-814
207,2022/7/15 12:40,10,38,-28,-942
207,2022/7/15 12:50,13,32,-19,-954
207,2022/7/15 13:00,11,37,-26,-989
207,2022/7/15 13:10,9,36,-27,-929
207,2022/7/15 13:20,9,38,-29,-927
207,2022/7/15 13:30,11,33,-22,-917
207,2022/7/15 13:40,11,37,-26,-927
207,2022/7/15 13:50,10,38,-28,-988
207,2022/7/15 14:00,11,33,-22,-915
207,2022/7/15 14:10,10,32,-22,-948
207,2022/7/15 14:20,12,36,-24,-980
207,2022/7/15 14:30,10,37,-27,-982
207,2022/7/15 14:40,12,38,-26,-919
207,2022/7/15 14:50,12,30,-18,-891
207,2022/7/15 15:00,17,38,-21,-1012
207,2022/7/15 15:10,16,36,-20,-1059
207,2022/7/15 15:20,14,45,-31,-995
207,2022/7/15 15:30,14,36,-22,-1013
207,2022/7/15 15:40,21,46,-25,-1024
207,2022/7/15 15:50,15,45,-30,-1032
207,2022/7/15 16:00,18,62,-44,-1067
207,2022/7/15 16:10,17,65,-48,-955
207,2022/7/15 16:20,25,52,-27,-1094
207,2022/7/15 16:30,21,57,-36,-1059
207,2022/7/15 16:40,33,61,-28,-850
207,2022/7/15 16:50,24,52,-28,-995
207,2022/7/15 17:00,37,59,-22,-215
207,2022/7/15 17:10,53,60,-7,14
207,2022/7/15 17:20,27,72,-45,-906
207,2022/7/15 17:30,24,84,-60,-683
207,2022/7/15 17:40,50,81,-31,-43
207,2022/7/15 17:50,40,92,-52,-1516
207,2022/7/15 18:00,27,110,-83,-1714
207,2022/7/15 18:10,45,106,-61,-933
207,2022/7/15 18:20,43,115,-72,-2128
207,2022/7/15 18:30,32,102,-70,-2484
207,2022/7/15 18:40,47,107,-60,-2774
207,2022/7/15 18:50,28,95,-67,-3381
207,2022/7/15 19:00,19,92,-73,-2820
207,2022/7/15 19:10,24,78,-54,-2600
207,2022/7/15 19:20,15,73,-58,-2184
207,2022/7/15 19:30,14,66,-52,-1982
207,2022/7/15 19:40,17,66,-49,-1798
207,2022/7/15 19:50,12,52,-40,-1751
207,2022/7/15 20:00,10,49,-39,-1589
207,2022/7/15 20:10,18,40,-22,-1520
207,2022/7/15 20:20,15,47,-32,-1546
207,2022/7/15 20:30,15,40,-25,-1470
207,2022/7/15 20:40,24,47,-23,-1499
207,2022/7/15 20:50,16,42,-26,-1519
207,2022/7/15 21:00,16,47,-31,-1441
207,2022/7/15 21:10,11,37,-26,-1477
207,2022/7/15 21:20,13,34,-21,-1520
207,2022/7/15 21:30,6,40,-34,-1547
207,2022/7/15 21:40,6,37,-31,-1535
207,2022/7/15 21:50,4,39,-35,-1560
207,2022/7/15 22:00,4,41,-37,-1483
207,2022/7/15 22:10,5,40,-35,-1482
207,2022/7/15 22:20,2,40,-38,-1520
207,2022/7/15 22:30,1,41,-40,-1514
207,2022/7/15 22:40,0,52,-52,-1432
207,2022/7/15 22:50,0,44,-44,-1253
240,2022/7/15 5:00,0,1,-1,-1
240,2022/7/15 5:10,2,1,1,1
240,2022/7/15 5:20,2,1,1,1
240,2022/7/15 5:30,3,1,2,2
240,2022/7/15 5:40,3,1,2,2
240,2022/7/15 5:50,2,1,1,1
240,2022/7/15 6:00,2,1,1,1
240,2022/7/15 6:10,4,1,3,3
240,2022/7/15 6:20,6,1,5,5
240,2022/7/15 6:30,10,71,-61,-61
240,2022/7/15 6:40,10,47,-37,-37
240,2022/7/15 6:50,10,51,-41,-41
240,2022/7/15 7:00,21,66,-45,-45
240,2022/7/15 7:10,27,72,-45,-45
240,2022/7/15 7:20,25,95,-70,-70
240,2022/7/15 7:30,27,103,-76,-76
240,2022/7/15 7:40,32,112,-80,-80
240,2022/7/15 7:50,32,128,-96,-96
240,2022/7/15 8:00,30,211,-181,-181
240,2022/7/15 8:10,29,295,-266,-266
240,2022/7/15 8:20,30,424,-394,-394
240,2022/7/15 8:30,26,401,-375,-375
240,2022/7/15 8:40,24,589,-565,-565
240,2022/7/15 8:50,21,689,-668,-668
240,2022/7/15 9:00,21,482,-461,-461
240,2022/7/15 9:10,20,412,-392,-392
240,2022/7/15 9:20,20,405,-385,-385
240,2022/7/15 9:30,18,429,-411,-411
240,2022/7/15 9:40,16,231,-215,-215
240,2022/7/15 9:50,16,301,-285,-285
240,2022/7/15 10:00,19,221,-202,-202
240,2022/7/15 10:10,22,150,-128,-128
240,2022/7/15 10:20,21,108,-87,-87
240,2022/7/15 10:30,23,119,-96,-96
240,2022/7/15 10:40,25,108,-83,-83
240,2022/7/15 10:50,26,118,-92,-92
240,2022/7/15 11:00,25,103,-78,-78
240,2022/7/15 11:10,27,96,-69,-69
240,2022/7/15 11:20,26,85,-59,-59
240,2022/7/15 11:30,27,99,-72,-72
240,2022/7/15 11:40,34,106,-72,-72
240,2022/7/15 11:50,31,94,-63,-63
240,2022/7/15 12:00,36,76,-40,-40
240,2022/7/15 12:10,40,84,-44,-44
240,2022/7/15 12:20,35,86,-51,-51
240,2022/7/15 12:30,29,104,-75,-75
240,2022/7/15 12:40,36,107,-71,-71
240,2022/7/15 12:50,38,102,-64,-64
240,2022/7/15 13:00,39,96,-57,-57
240,2022/7/15 13:10,44,89,-45,-45
240,2022/7/15 13:20,42,96,-54,-54
240,2022/7/15 13:30,45,98,-53,-53
240,2022/7/15 13:40,45,96,-51,-51
240,2022/7/15 13:50,45,96,-51,-51
240,2022/7/15 14:00,46,81,-35,-35
240,2022/7/15 14:10,48,95,-47,-47
240,2022/7/15 14:20,49,90,-41,-41
240,2022/7/15 14:30,53,94,-41,-41
240,2022/7/15 14:40,55,84,-29,-29
240,2022/7/15 14:50,56,82,-26,-26
240,2022/7/15 15:00,60,62,-2,-2
240,2022/7/15 15:10,70,72,-2,-2
240,2022/7/15 15:20,88,78,10,10
240,2022/7/15 15:30,80,65,15,15
240,2022/7/15 15:40,114,84,30,30
240,2022/7/15 15:50,72,63,9,9
240,2022/7/15 16:00,99,70,29,29
240,2022/7/15 16:10,119,71,48,48
240,2022/7/15 16:20,115,61,54,54
240,2022/7/15 16:30,138,68,70,70
240,2022/7/15 16:40,171,62,109,109
240,2022/7/15 16:50,142,71,71,71
240,2022/7/15 17:00,273,69,204,204
240,2022/7/15 17:10,355,77,278,278
240,2022/7/15 17:20,329,71,258,258
240,2022/7/15 17:30,629,74,555,555
240,2022/7/15 17:40,594,76,518,518
240,2022/7/15 17:50,346,91,255,255
240,2022/7/15 18:00,590,91,499,499
240,2022/7/15 18:10,630,92,538,538
240,2022/7/15 18:20,374,95,279,279
240,2022/7/15 18:30,289,92,197,197
240,2022/7/15 18:40,268,90,178,178
240,2022/7/15 18:50,218,87,131,131
240,2022/7/15 19:00,175,77,98,98
240,2022/7/15 19:10,141,72,69,69
240,2022/7/15 19:20,89,82,7,7
240,2022/7/15 19:30,76,74,2,2
240,2022/7/15 19:40,71,61,10,10
240,2022/7/15 19:50,55,50,5,5
240,2022/7/15 20:00,71,40,31,31
240,2022/7/15 20:10,77,47,30,30
240,2022/7/15 20:20,56,39,17,17
240,2022/7/15 20:30,55,27,28,28
240,2022/7/15 20:40,46,33,13,13
240,2022/7/15 20:50,44,36,8,8
240,2022/7/15 21:00,60,25,35,35
240,2022/7/15 21:10,58,27,31,31
240,2022/7/15 21:20,44,32,12,12
240,2022/7/15 21:30,51,33,18,18
240,2022/7/15 21:40,42,32,10,10
240,2022/7/15 21:50,41,25,16,16
240,2022/7/15 22:00,138,25,113,113
240,2022/7/15 22:10,50,25,25,25
240,2022/7/15 22:20,27,23,4,4
240,2022/7/15 22:30,0,21,-21,-21
240,2022/7/15 22:40,0,25,-25,-25
240,2022/7/15 22:50,0,18,-18,-18
246,2022/7/15 5:00,0,1,-1,-2
246,2022/7/15 5:10,3,1,2,3
246,2022/7/15 5:20,12,1,11,12
246,2022/7/15 5:30,14,1,13,15
246,2022/7/15 5:40,15,1,14,16
246,2022/7/15 5:50,17,1,16,17
246,2022/7/15 6:00,22,1,21,22
246,2022/7/15 6:10,21,1,20,23
246,2022/7/15 6:20,26,8,18,23
246,2022/7/15 6:30,36,64,-28,-89
246,2022/7/15 6:40,29,73,-44,-81
246,2022/7/15 6:50,50,82,-32,-73
246,2022/7/15 7:00,47,104,-57,-102
246,2022/7/15 7:10,56,87,-31,-76
246,2022/7/15 7:20,78,111,-33,-103
246,2022/7/15 7:30,70,133,-63,-139
246,2022/7/15 7:40,149,152,-3,-83
246,2022/7/15 7:50,171,112,59,-37
246,2022/7/15 8:00,184,110,74,-107
246,2022/7/15 8:10,147,121,26,-240
246,2022/7/15 8:20,151,107,44,-350
246,2022/7/15 8:30,121,110,11,-364
246,2022/7/15 8:40,71,185,-114,-679
246,2022/7/15 8:50,69,144,-75,-743
246,2022/7/15 9:00,38,123,-85,-546
246,2022/7/15 9:10,36,106,-70,-462
246,2022/7/15 9:20,31,104,-73,-458
246,2022/7/15 9:30,35,82,-47,-458
246,2022/7/15 9:40,24,76,-52,-267
246,2022/7/15 9:50,25,76,-51,-336
246,2022/7/15 10:00,27,63,-36,-238
246,2022/7/15 10:10,24,69,-45,-173
246,2022/7/15 10:20,26,65,-39,-126
246,2022/7/15 10:30,21,51,-30,-126
246,2022/7/15 10:40,18,64,-46,-129
246,2022/7/15 10:50,26,45,-19,-111
246,2022/7/15 11:00,25,62,-37,-115
246,2022/7/15 11:10,24,54,-30,-99
246,2022/7/15 11:20,24,57,-33,-92
246,2022/7/15 11:30,25,41,-16,-88
246,2022/7/15 11:40,25,58,-33,-105
246,2022/7/15 11:50,29,64,-35,-98
246,2022/7/15 12:00,28,60,-32,-72
246,2022/7/15 12:10,26,65,-39,-83
246,2022/7/15 12:20,26,54,-28,-79
246,2022/7/15 12:30,23,51,-28,-103
246,2022/7/15 12:40,35,48,-13,-84
246,2022/7/15 12:50,27,62,-35,-99
246,2022/7/15 13:00,25,66,-41,-98
246,2022/7/15 13:10,26,55,-29,-74
246,2022/7/15 13:20,27,57,-30,-84
246,2022/7/15 13:30,27,50,-23,-76
246,2022/7/15 13:40,28,52,-24,-75
246,2022/7/15 13:50,26,62,-36,-87
246,2022/7/15 14:00,28,64,-36,-71
246,2022/7/15 14:10,26,65,-39,-86
246,2022/7/15 14:20,26,63,-37,-78
246,2022/7/15 14:30,25,50,-25,-66
246,2022/7/15 14:40,28,63,-35,-64
246,2022/7/15 14:50,28,65,-37,-63
246,2022/7/15 15:00,27,63,-36,-38
246,2022/7/15 15:10,31,57,-26,-28
246,2022/7/15 15:20,27,51,-24,-14
246,2022/7/15 15:30,25,50,-25,-10
246,2022/7/15 15:40,32,59,-27,3
246,2022/7/15 15:50,26,65,-39,-30
246,2022/7/15 16:00,30,64,-34,-5
246,2022/7/15 16:10,37,66,-29,19
246,2022/7/15 16:20,43,53,-10,44
246,2022/7/15 16:30,60,69,-9,61
246,2022/7/15 16:40,135,71,64,173
246,2022/7/15 16:50,101,66,35,106
246,2022/7/15 17:00,177,70,107,311
246,2022/7/15 17:10,270,72,198,476
246,2022/7/15 17:20,234,77,157,415
246,2022/7/15 17:30,227,76,151,706
246,2022/7/15 17:40,336,92,244,762
246,2022/7/15 17:50,316,81,235,490
246,2022/7/15 18:00,270,99,171,670
246,2022/7/15 18:10,584,77,507,1045
246,2022/7/15 18:20,266,106,160,439
246,2022/7/15 18:30,167,95,72,269
246,2022/7/15 18:40,191,106,85,263
246,2022/7/15 18:50,75,102,-27,104
246,2022/7/15 19:00,41,78,-37,61
246,2022/7/15 19:10,42,81,-39,30
246,2022/7/15 19:20,34,67,-33,-26
246,2022/7/15 19:30,29,63,-34,-32
246,2022/7/15 19:40,30,70,-40,-30
246,2022/7/15 19:50,28,53,-25,-20
246,2022/7/15 20:00,33,50,-17,14
246,2022/7/15 20:10,32,46,-14,16
246,2022/7/15 20:20,29,43,-14,3
246,2022/7/15 20:30,44,40,4,32
246,2022/7/15 20:40,27,47,-20,-7
246,2022/7/15 20:50,32,40,-8,0
246,2022/7/15 21:00,35,36,-1,34
246,2022/7/15 21:10,27,27,0,31
246,2022/7/15 21:20,28,41,-13,-1
246,2022/7/15 21:30,29,33,-4,14
246,2022/7/15 21:40,21,31,-10,0
246,2022/7/15 21:50,17,38,-21,-5
246,2022/7/15 22:00,15,34,-19,94
246,2022/7/15 22:10,13,34,-21,4
246,2022/7/15 22:20,6,34,-28,-24
246,2022/7/15 22:30,5,34,-29,-50
246,2022/7/15 22:40,1,25,-24,-49
246,2022/7/15 22:50,1,25,-24,-42
237,2022/7/15 5:00,2,1,1,-1
237,2022/7/15 5:10,7,1,6,9
237,2022/7/15 5:20,19,1,18,30
237,2022/7/15 5:30,25,1,24,39
237,2022/7/15 5:40,29,2,27,43
237,2022/7/15 5:50,32,2,30,47
237,2022/7/15 6:00,45,5,40,62
237,2022/7/15 6:10,54,5,49,72
237,2022/7/15 6:20,91,51,40,63
237,2022/7/15 6:30,168,55,113,24
237,2022/7/15 6:40,228,64,164,83
237,2022/7/15 6:50,251,77,174,101
237,2022/7/15 7:00,356,107,249,147
237,2022/7/15 7:10,366,104,262,186
237,2022/7/15 7:20,642,99,543,440
237,2022/7/15 7:30,687,110,577,438
237,2022/7/15 7:40,1049,139,910,827
237,2022/7/15 7:50,1215,128,1087,1050
237,2022/7/15 8:00,1209,144,1065,958
237,2022/7/15 8:10,1360,128,1232,992
237,2022/7/15 8:20,1169,104,1065,715
237,2022/7/15 8:30,1036,109,927,563
237,2022/7/15 8:40,831,125,706,27
237,2022/7/15 8:50,720,110,610,-133
237,2022/7/15 9:00,584,112,472,-74
237,2022/7/15 9:10,435,106,329,-133
237,2022/7/15 9:20,319,112,207,-251
237,2022/7/15 9:30,236,97,139,-319
237,2022/7/15 9:40,197,89,108,-159
237,2022/7/15 9:50,117,96,21,-315
237,2022/7/15 10:00,82,105,-23,-261
237,2022/7/15 10:10,72,69,3,-170
237,2022/7/15 10:20,59,92,-33,-159
237,2022/7/15 10:30,66,93,-27,-153
237,2022/7/15 10:40,56,93,-37,-166
237,2022/7/15 10:50,66,77,-11,-122
237,2022/7/15 11:00,45,77,-32,-147
237,2022/7/15 11:10,55,77,-22,-121
237,2022/7/15 11:20,50,64,-14,-106
237,2022/7/15 11:30,46,87,-41,-129
237,2022/7/15 11:40,50,77,-27,-132
237,2022/7/15 11:50,55,76,-21,-119
237,2022/7/15 12:00,54,74,-20,-92
237,2022/7/15 12:10,52,82,-30,-113
237,2022/7/15 12:20,51,92,-41,-120
237,2022/7/15 12:30,57,90,-33,-136
237,2022/7/15 12:40,46,90,-44,-128
237,2022/7/15 12:50,45,108,-63,-162
237,2022/7/15 13:00,46,109,-63,-161
237,2022/7/15 13:10,45,76,-31,-105
237,2022/7/15 13:20,42,111,-69,-153
237,2022/7/15 13:30,47,93,-46,-122
237,2022/7/15 13:40,45,92,-47,-122
237,2022/7/15 13:50,41,104,-63,-150
237,2022/7/15 14:00,41,92,-51,-122
237,2022/7/15 14:10,44,93,-49,-135
237,2022/7/15 14:20,44,105,-61,-139
237,2022/7/15 14:30,38,99,-61,-127
237,2022/7/15 14:40,39,105,-66,-130
237,2022/7/15 14:50,43,104,-61,-124
237,2022/7/15 15:00,39,76,-37,-75
237,2022/7/15 15:10,43,104,-61,-89
237,2022/7/15 15:20,40,109,-69,-83
237,2022/7/15 15:30,46,104,-58,-68
237,2022/7/15 15:40,44,106,-62,-59
237,2022/7/15 15:50,47,111,-64,-94
237,2022/7/15 16:00,52,100,-48,-53
237,2022/7/15 16:10,46,101,-55,-36
237,2022/7/15 16:20,48,121,-73,-29
237,2022/7/15 16:30,68,106,-38,23
237,2022/7/15 16:40,61,108,-47,126
237,2022/7/15 16:50,66,139,-73,33
237,2022/7/15 17:00,103,119,-16,295
237,2022/7/15 17:10,140,127,13,489
237,2022/7/15 17:20,160,157,3,418
237,2022/7/15 17:30,89,196,-107,599
237,2022/7/15 17:40,136,376,-240,522
237,2022/7/15 17:50,115,332,-217,273
237,2022/7/15 18:00,75,282,-207,463
237,2022/7/15 18:10,48,508,-460,585
237,2022/7/15 18:20,44,534,-490,-51
237,2022/7/15 18:30,42,502,-460,-191
237,2022/7/15 18:40,35,432,-397,-134
237,2022/7/15 18:50,38,502,-464,-360
237,2022/7/15 19:00,25,533,-508,-447
237,2022/7/15 19:10,34,381,-347,-317
237,2022/7/15 19:20,31,301,-270,-296
237,2022/7/15 19:30,26,176,-150,-182
237,2022/7/15 19:40,24,190,-166,-196
237,2022/7/15 19:50,27,177,-150,-170
237,2022/7/15 20:00,27,152,-125,-111
237,2022/7/15 20:10,28,121,-93,-77
237,2022/7/15 20:20,23,121,-98,-95
237,2022/7/15 20:30,27,117,-90,-58
237,2022/7/15 20:40,28,125,-97,-104
237,2022/7/15 20:50,22,116,-94,-94
237,2022/7/15 21:00,27,110,-83,-49
237,2022/7/15 21:10,26,144,-118,-87
237,2022/7/15 21:20,26,120,-94,-95
237,2022/7/15 21:30,25,104,-79,-65
237,2022/7/15 21:40,22,119,-97,-97
237,2022/7/15 21:50,16,110,-94,-99
237,2022/7/15 22:00,17,122,-105,-11
237,2022/7/15 22:10,13,125,-112,-108
237,2022/7/15 22:20,9,110,-101,-125
237,2022/7/15 22:30,4,105,-101,-151
237,2022/7/15 22:40,1,95,-94,-143
237,2022/7/15 22:50,1,112,-111,-153
241,2022/7/15 5:00,0,1,-1,-2
241,2022/7/15 5:10,0,1,-1,8
241,2022/7/15 5:20,13,1,12,42
241,2022/7/15 5:30,21,1,20,59
241,2022/7/15 5:40,16,1,15,58
241,2022/7/15 5:50,30,1,29,76
241,2022/7/15 6:00,33,2,31,93
241,2022/7/15 6:10,46,2,44,116
241,2022/7/15 6:20,65,33,32,95
241,2022/7/15 6:30,94,36,58,82
241,2022/7/15 6:40,170,54,116,199
241,2022/7/15 6:50,213,67,146,247
241,2022/7/15 7:00,277,70,207,354
241,2022/7/15 7:10,347,74,273,459
241,2022/7/15 7:20,568,90,478,918
241,2022/7/15 7:30,693,97,596,1034
241,2022/7/15 7:40,1052,95,957,1784
241,2022/7/15 7:50,1221,98,1123,2173
241,2022/7/15 8:00,1385,115,1270,2228
241,2022/7/15 8:10,1578,122,1456,2448
241,2022/7/15 8:20,1172,104,1068,1783
241,2022/7/15 8:30,1040,110,930,1493
241,2022/7/15 8:40,735,108,627,654
241,2022/7/15 8:50,664,95,569,436
241,2022/7/15 9:00,436,93,343,269
241,2022/7/15 9:10,273,92,181,48
241,2022/7/15 9:20,240,83,157,-94
241,2022/7/15 9:30,183,75,108,-211
241,2022/7/15 9:40,76,73,3,-156
241,2022/7/15 9:50,72,74,-2,-317
241,2022/7/15 10:00,48,70,-22,-283
241,2022/7/15 10:10,46,67,-21,-191
241,2022/7/15 10:20,41,65,-24,-183
241,2022/7/15 10:30,37,68,-31,-184
241,2022/7/15 10:40,36,62,-26,-192
241,2022/7/15 10:50,29,66,-37,-159
241,2022/7/15 11:00,35,73,-38,-185
241,2022/7/15 11:10,31,69,-38,-159
241,2022/7/15 11:20,33,67,-34,-140
241,2022/7/15 11:30,36,73,-37,-166
241,2022/7/15 11:40,26,70,-44,-176
241,2022/7/15 11:50,36,70,-34,-153
241,2022/7/15 12:00,36,74,-38,-130
241,2022/7/15 12:10,44,82,-38,-151
241,2022/7/15 12:20,38,73,-35,-155
241,2022/7/15 12:30,39,74,-35,-171
241,2022/7/15 12:40,37,69,-32,-160
241,2022/7/15 12:50,37,84,-47,-209
241,2022/7/15 13:00,36,80,-44,-205
241,2022/7/15 13:10,36,70,-34,-139
241,2022/7/15 13:20,39,82,-43,-196
241,2022/7/15 13:30,31,73,-42,-164
241,2022/7/15 13:40,31,73,-42,-164
241,2022/7/15 13:50,32,83,-51,-201
241,2022/7/15 14:00,28,84,-56,-178
241,2022/7/15 14:10,22,84,-62,-197
241,2022/7/15 14:20,26,77,-51,-190
241,2022/7/15 14:30,27,73,-46,-173
241,2022/7/15 14:40,28,76,-48,-178
241,2022/7/15 14:50,30,81,-51,-175
241,2022/7/15 15:00,30,92,-62,-137
241,2022/7/15 15:10,36,75,-39,-128
241,2022/7/15 15:20,33,89,-56,-139
241,2022/7/15 15:30,31,93,-62,-130
241,2022/7/15 15:40,30,102,-72,-131
241,2022/7/15 15:50,39,105,-66,-160
241,2022/7/15 16:00,37,101,-64,-117
241,2022/7/15 16:10,57,104,-47,-83
241,2022/7/15 16:20,42,96,-54,-83
241,2022/7/15 16:30,43,118,-75,-52
241,2022/7/15 16:40,49,108,-59,67
241,2022/7/15 16:50,46,122,-76,-43
241,2022/7/15 17:00,64,124,-60,235
241,2022/7/15 17:10,78,158,-80,409
241,2022/7/15 17:20,72,153,-81,337
241,2022/7/15 17:30,57,225,-168,431
241,2022/7/15 17:40,74,212,-138,384
241,2022/7/15 17:50,73,333,-260,13
241,2022/7/15 18:00,55,334,-279,184
241,2022/7/15 18:10,49,510,-461,124
241,2022/7/15 18:20,56,433,-377,-428
241,2022/7/15 18:30,43,438,-395,-586
241,2022/7/15 18:40,37,432,-395,-529
241,2022/7/15 18:50,30,440,-410,-770
241,2022/7/15 19:00,31,382,-351,-798
241,2022/7/15 19:10,29,321,-292,-609
241,2022/7/15 19:20,32,232,-200,-496
241,2022/7/15 19:30,27,271,-244,-426
241,2022/7/15 19:40,29,126,-97,-293
241,2022/7/15 19:50,29,118,-89,-259
241,2022/7/15 20:00,32,110,-78,-189
241,2022/7/15 20:10,30,113,-83,-160
241,2022/7/15 20:20,29,110,-81,-176
241,2022/7/15 20:30,28,124,-96,-154
241,2022/7/15 20:40,24,115,-91,-195
241,2022/7/15 20:50,26,122,-96,-190
241,2022/7/15 21:00,22,122,-100,-149
241,2022/7/15 21:10,26,119,-93,-180
241,2022/7/15 21:20,26,127,-101,-196
241,2022/7/15 21:30,21,124,-103,-168
241,2022/7/15 21:40,18,123,-105,-202
241,2022/7/15 21:50,14,123,-109,-208
241,2022/7/15 22:00,14,114,-100,-111
241,2022/7/15 22:10,16,110,-94,-202
241,2022/7/15 22:20,12,103,-91,-216
241,2022/7/15 22:30,6,107,-101,-252
241,2022/7/15 22:40,1,102,-101,-244
241,2022/7/15 22:50,1,70,-69,-222
256,2022/7/15 5:00,0,1,-1,-3
256,2022/7/15 5:10,0,1,-1,7
256,2022/7/15 5:20,8,1,7,49
256,2022/7/15 5:30,18,1,17,76
256,2022/7/15 5:40,19,1,18,76
256,2022/7/15 5:50,23,1,22,98
256,2022/7/15 6:00,31,1,30,123
256,2022/7/15 6:10,43,5,38,154
256,2022/7/15 6:20,59,45,14,109
256,2022/7/15 6:30,74,45,29,111
256,2022/7/15 6:40,146,74,72,271
256,2022/7/15 6:50,205,93,112,359
256,2022/7/15 7:00,249,121,128,482
256,2022/7/15 7:10,352,112,240,699
256,2022/7/15 7:20,593,91,502,1420
256,2022/7/15 7:30,693,93,600,1634
256,2022/7/15 7:40,1060,105,955,2739
256,2022/7/15 7:50,1061,113,948,3121
256,2022/7/15 8:00,1210,122,1088,3316
256,2022/7/15 8:10,1385,119,1266,3714
256,2022/7/15 8:20,1215,101,1114,2897
256,2022/7/15 8:30,858,109,749,2242
256,2022/7/15 8:40,689,119,570,1224
256,2022/7/15 8:50,630,104,526,962
256,2022/7/15 9:00,384,115,269,538
256,2022/7/15 9:10,298,111,187,235
256,2022/7/15 9:20,238,92,146,52
256,2022/7/15 9:30,178,72,106,-105
256,2022/7/15 9:40,93,75,18,-138
256,2022/7/15 9:50,61,83,-22,-339
256,2022/7/15 10:00,47,85,-38,-321
256,2022/7/15 10:10,46,47,-1,-192
256,2022/7/15 10:20,41,71,-30,-213
256,2022/7/15 10:30,38,66,-28,-212
256,2022/7/15 10:40,36,69,-33,-225
256,2022/7/15 10:50,34,73,-39,-198
256,2022/7/15 11:00,34,67,-33,-218
256,2022/7/15 11:10,28,51,-23,-182
256,2022/7/15 11:20,30,69,-39,-179
256,2022/7/15 11:30,28,65,-37,-203
256,2022/7/15 11:40,32,75,-43,-219
256,2022/7/15 11:50,33,70,-37,-190
256,2022/7/15 12:00,38,63,-25,-155
256,2022/7/15 12:10,37,70,-33,-184
256,2022/7/15 12:20,35,72,-37,-192
256,2022/7/15 12:30,39,77,-38,-209
256,2022/7/15 12:40,39,75,-36,-196
256,2022/7/15 12:50,36,75,-39,-248
256,2022/7/15 13:00,37,75,-38,-243
256,2022/7/15 13:10,33,63,-30,-169
256,2022/7/15 13:20,29,76,-47,-243
256,2022/7/15 13:30,31,84,-53,-217
256,2022/7/15 13:40,28,78,-50,-214
256,2022/7/15 13:50,23,62,-39,-240
256,2022/7/15 14:00,30,69,-39,-217
256,2022/7/15 14:10,32,78,-46,-243
256,2022/7/15 14:20,31,76,-45,-235
256,2022/7/15 14:30,28,77,-49,-222
256,2022/7/15 14:40,27,76,-49,-227
256,2022/7/15 14:50,36,77,-41,-216
256,2022/7/15 15:00,29,85,-56,-193
256,2022/7/15 15:10,19,98,-79,-207
256,2022/7/15 15:20,38,91,-53,-192
256,2022/7/15 15:30,39,99,-60,-190
256,2022/7/15 15:40,30,106,-76,-207
256,2022/7/15 15:50,29,80,-51,-211
256,2022/7/15 16:00,33,111,-78,-195
256,2022/7/15 16:10,35,105,-70,-153
256,2022/7/15 16:20,36,101,-65,-148
256,2022/7/15 16:30,47,101,-54,-106
256,2022/7/15 16:40,103,119,-16,51
256,2022/7/15 16:50,170,121,49,6
256,2022/7/15 17:00,99,127,-28,207
256,2022/7/15 17:10,131,118,13,422
256,2022/7/15 17:20,83,138,-55,282
256,2022/7/15 17:30,81,283,-202,229
256,2022/7/15 17:40,174,322,-148,236
256,2022/7/15 17:50,73,268,-195,-182
256,2022/7/15 18:00,65,317,-252,-68
256,2022/7/15 18:10,62,501,-439,-315
256,2022/7/15 18:20,64,504,-440,-868
256,2022/7/15 18:30,47,496,-449,-1035
256,2022/7/15 18:40,41,431,-390,-919
256,2022/7/15 18:50,37,421,-384,-1154
256,2022/7/15 19:00,30,380,-350,-1148
256,2022/7/15 19:10,33,512,-479,-1088
256,2022/7/15 19:20,26,217,-191,-687
256,2022/7/15 19:30,26,183,-157,-583
256,2022/7/15 19:40,28,157,-129,-422
256,2022/7/15 19:50,27,191,-164,-423
256,2022/7/15 20:00,25,139,-114,-303
256,2022/7/15 20:10,28,114,-86,-246
256,2022/7/15 20:20,27,111,-84,-260
256,2022/7/15 20:30,26,100,-74,-228
256,2022/7/15 20:40,24,182,-158,-353
256,2022/7/15 20:50,22,109,-87,-277
256,2022/7/15 21:00,25,109,-84,-233
256,2022/7/15 21:10,22,110,-88,-268
256,2022/7/15 21:20,22,114,-92,-288
256,2022/7/15 21:30,20,111,-91,-259
256,2022/7/15 21:40,18,128,-110,-312
256,2022/7/15 21:50,14,124,-110,-318
256,2022/7/15 22:00,13,105,-92,-203
256,2022/7/15 22:10,12,111,-99,-301
256,2022/7/15 22:20,9,95,-86,-302
256,2022/7/15 22:30,6,112,-106,-358
256,2022/7/15 22:40,1,106,-105,-349
256,2022/7/15 22:50,1,72,-71,-293
257,2022/7/15 5:00,0,1,-1,-4
257,2022/7/15 5:10,0,1,-1,6
257,2022/7/15 5:20,1,1,0,49
257,2022/7/15 5:30,7,1,6,82
257,2022/7/15 5:40,10,1,9,85
257,2022/7/15 5:50,15,6,9,107
257,2022/7/15 6:00,20,2,18,141
257,2022/7/15 6:10,35,13,22,176
257,2022/7/15 6:20,42,23,19,128
257,2022/7/15 6:30,58,31,27,138
257,2022/7/15 6:40,79,29,50,321
257,2022/7/15 6:50,84,42,42,401
257,2022/7/15 7:00,89,51,38,520
257,2022/7/15 7:10,155,64,91,790
257,2022/7/15 7:20,200,74,126,1546
257,2022/7/15 7:30,246,86,160,1794
257,2022/7/15 7:40,351,87,264,3003
257,2022/7/15 7:50,326,77,249,3370
257,2022/7/15 8:00,325,90,235,3551
257,2022/7/15 8:10,395,98,297,4011
257,2022/7/15 8:20,326,113,213,3110
257,2022/7/15 8:30,346,117,229,2471
257,2022/7/15 8:40,277,119,158,1382
257,2022/7/15 8:50,253,123,130,1092
257,2022/7/15 9:00,199,96,103,641
257,2022/7/15 9:10,178,90,88,323
257,2022/7/15 9:20,116,77,39,91
257,2022/7/15 9:30,64,74,-10,-115
257,2022/7/15 9:40,48,75,-27,-165
257,2022/7/15 9:50,43,76,-33,-372
257,2022/7/15 10:00,38,61,-23,-344
257,2022/7/15 10:10,39,68,-29,-221
257,2022/7/15 10:20,31,63,-32,-245
257,2022/7/15 10:30,32,69,-37,-249
257,2022/7/15 10:40,32,65,-33,-258
257,2022/7/15 10:50,28,65,-37,-235
257,2022/7/15 11:00,33,57,-24,-242
257,2022/7/15 11:10,29,49,-20,-202
257,2022/7/15 11:20,27,65,-38,-217
257,2022/7/15 11:30,27,52,-25,-228
257,2022/7/15 11:40,27,67,-40,-259
257,2022/7/15 11:50,28,62,-34,-224
257,2022/7/15 12:00,30,45,-15,-170
257,2022/7/15 12:10,25,69,-44,-228
257,2022/7/15 12:20,32,62,-30,-222
257,2022/7/15 12:30,27,73,-46,-255
257,2022/7/15 12:40,30,68,-38,-234
257,2022/7/15 12:50,29,61,-32,-280
257,2022/7/15 13:00,29,61,-32,-275
257,2022/7/15 13:10,30,66,-36,-205
257,2022/7/15 13:20,29,85,-56,-299
257,2022/7/15 13:30,33,72,-39,-256
257,2022/7/15 13:40,31,85,-54,-268
257,2022/7/15 13:50,24,64,-40,-280
257,2022/7/15 14:00,32,65,-33,-250
257,2022/7/15 14:10,32,76,-44,-287
257,2022/7/15 14:20,31,77,-46,-281
257,2022/7/15 14:30,29,71,-42,-264
257,2022/7/15 14:40,34,68,-34,-261
257,2022/7/15 14:50,28,69,-41,-257
257,2022/7/15 15:00,30,81,-51,-244
257,2022/7/15 15:10,35,74,-39,-246
257,2022/7/15 15:20,23,77,-54,-246
257,2022/7/15 15:30,30,80,-50,-240
257,2022/7/15 15:40,27,75,-48,-255
257,2022/7/15 15:50,29,74,-45,-256
257,2022/7/15 16:00,29,93,-64,-259
257,2022/7/15 16:10,39,90,-51,-204
257,2022/7/15 16:20,42,88,-46,-194
257,2022/7/15 16:30,56,94,-38,-144
257,2022/7/15 16:40,47,99,-52,-1
257,2022/7/15 16:50,38,114,-76,-70
257,2022/7/15 17:00,49,108,-59,148
257,2022/7/15 17:10,49,107,-58,364
257,2022/7/15 17:20,40,106,-66,216
257,2022/7/15 17:30,87,144,-57,172
257,2022/7/15 17:40,83,127,-44,192
257,2022/7/15 17:50,45,151,-106,-288
257,2022/7/15 18:00,35,182,-147,-215
257,2022/7/15 18:10,33,184,-151,-466
257,2022/7/15 18:20,32,198,-166,-1034
257,2022/7/15 18:30,29,184,-155,-1190
257,2022/7/15 18:40,28,191,-163,-1082
257,2022/7/15 18:50,26,155,-129,-1283
257,2022/7/15 19:00,27,107,-80,-1228
257,2022/7/15 19:10,25,124,-99,-1187
257,2022/7/15 19:20,22,108,-86,-773
257,2022/7/15 19:30,17,110,-93,-676
257,2022/7/15 19:40,16,106,-90,-512
257,2022/7/15 19:50,17,115,-98,-521
257,2022/7/15 20:00,18,91,-73,-376
257,2022/7/15 20:10,18,77,-59,-305
257,2022/7/15 20:20,19,83,-64,-324
257,2022/7/15 20:30,19,86,-67,-295
257,2022/7/15 20:40,23,93,-70,-423
257,2022/7/15 20:50,16,79,-63,-340
257,2022/7/15 21:00,22,92,-70,-303
257,2022/7/15 21:10,23,77,-54,-322
257,2022/7/15 21:20,16,78,-62,-350
257,2022/7/15 21:30,17,99,-82,-341
257,2022/7/15 21:40,15,78,-63,-375
257,2022/7/15 21:50,12,85,-73,-391
257,2022/7/15 22:00,11,83,-72,-275
257,2022/7/15 22:10,12,73,-61,-362
257,2022/7/15 22:20,8,68,-60,-362
257,2022/7/15 22:30,7,65,-58,-416
257,2022/7/15 22:40,1,68,-67,-416
257,2022/7/15 22:50,0,45,-45,-338
258,2022/7/15 5:00,0,1,-1,-5
258,2022/7/15 5:10,0,1,-1,5
258,2022/7/15 5:20,1,1,0,49
258,2022/7/15 5:30,10,1,9,91
258,2022/7/15 5:40,24,1,23,108
258,2022/7/15 5:50,22,1,21,128
258,2022/7/15 6:00,32,6,26,167
258,2022/7/15 6:10,40,23,17,193
258,2022/7/15 6:20,55,22,33,161
258,2022/7/15 6:30,86,41,45,183
258,2022/7/15 6:40,174,51,123,444
258,2022/7/15 6:50,227,71,156,557
258,2022/7/15 7:00,233,77,156,676
258,2022/7/15 7:10,281,93,188,978
258,2022/7/15 7:20,352,105,247,1793
258,2022/7/15 7:30,477,98,379,2173
258,2022/7/15 7:40,691,102,589,3592
258,2022/7/15 7:50,693,109,584,3954
258,2022/7/15 8:00,733,111,622,4173
258,2022/7/15 8:10,869,111,758,4769
258,2022/7/15 8:20,827,106,721,3831
258,2022/7/15 8:30,695,113,582,3053
258,2022/7/15 8:40,631,121,510,1892
258,2022/7/15 8:50,478,108,370,1462
258,2022/7/15 9:00,330,94,236,877
258,2022/7/15 9:10,273,92,181,504
258,2022/7/15 9:20,228,62,166,257
258,2022/7/15 9:30,178,76,102,-13
258,2022/7/15 9:40,137,82,55,-110
258,2022/7/15 9:50,69,62,7,-365
258,2022/7/15 10:00,45,71,-26,-370
258,2022/7/15 10:10,44,72,-28,-249
258,2022/7/15 10:20,41,68,-27,-272
258,2022/7/15 10:30,39,59,-20,-269
258,2022/7/15 10:40,31,68,-37,-295
258,2022/7/15 10:50,27,63,-36,-271
258,2022/7/15 11:00,30,67,-37,-279
258,2022/7/15 11:10,31,65,-34,-236
258,2022/7/15 11:20,28,62,-34,-251
258,2022/7/15 11:30,37,72,-35,-263
258,2022/7/15 11:40,33,61,-28,-287
258,2022/7/15 11:50,27,66,-39,-263
258,2022/7/15 12:00,31,72,-41,-211
258,2022/7/15 12:10,38,65,-27,-255
258,2022/7/15 12:20,37,72,-35,-257
258,2022/7/15 12:30,39,70,-31,-286
258,2022/7/15 12:40,35,74,-39,-273
258,2022/7/15 12:50,39,67,-28,-308
258,2022/7/15 13:00,28,66,-38,-313
258,2022/7/15 13:10,29,69,-40,-245
258,2022/7/15 13:20,31,70,-39,-338
258,2022/7/15 13:30,36,67,-31,-287
258,2022/7/15 13:40,25,71,-46,-314
258,2022/7/15 13:50,28,63,-35,-315
258,2022/7/15 14:00,32,70,-38,-288
258,2022/7/15 14:10,27,73,-46,-333
258,2022/7/15 14:20,29,74,-45,-326
258,2022/7/15 14:30,28,71,-43,-307
258,2022/7/15 14:40,26,85,-59,-320
258,2022/7/15 14:50,29,83,-54,-311
258,2022/7/15 15:00,30,78,-48,-292
258,2022/7/15 15:10,31,76,-45,-291
258,2022/7/15 15:20,32,90,-58,-304
258,2022/7/15 15:30,33,75,-42,-282
258,2022/7/15 15:40,30,103,-73,-328
258,2022/7/15 15:50,35,106,-71,-327
258,2022/7/15 16:00,38,93,-55,-314
258,2022/7/15 16:10,40,105,-65,-269
258,2022/7/15 16:20,32,108,-76,-270
258,2022/7/15 16:30,45,104,-59,-203
258,2022/7/15 16:40,46,124,-78,-79
258,2022/7/15 16:50,46,109,-63,-133
258,2022/7/15 17:00,66,107,-41,107
258,2022/7/15 17:10,77,108,-31,333
258,2022/7/15 17:20,47,191,-144,72
258,2022/7/15 17:30,45,217,-172,0
258,2022/7/15 17:40,47,326,-279,-87
258,2022/7/15 17:50,45,255,-210,-498
258,2022/7/15 18:00,47,335,-288,-503
258,2022/7/15 18:10,57,325,-268,-734
258,2022/7/15 18:20,35,326,-291,-1325
258,2022/7/15 18:30,30,348,-318,-1508
258,2022/7/15 18:40,35,347,-312,-1394
258,2022/7/15 18:50,23,328,-305,-1588
258,2022/7/15 19:00,30,197,-167,-1395
258,2022/7/15 19:10,26,219,-193,-1380
258,2022/7/15 19:20,23,170,-147,-920
258,2022/7/15 19:30,25,119,-94,-770
258,2022/7/15 19:40,27,103,-76,-588
258,2022/7/15 19:50,21,103,-82,-603
258,2022/7/15 20:00,22,119,-97,-473
258,2022/7/15 20:10,22,106,-84,-389
258,2022/7/15 20:20,24,104,-80,-404
258,2022/7/15 20:30,22,124,-102,-397
258,2022/7/15 20:40,27,109,-82,-505
258,2022/7/15 20:50,22,123,-101,-441
258,2022/7/15 21:00,21,110,-89,-392
258,2022/7/15 21:10,23,117,-94,-416
258,2022/7/15 21:20,23,115,-92,-442
258,2022/7/15 21:30,17,127,-110,-451
258,2022/7/15 21:40,15,103,-88,-463
258,2022/7/15 21:50,14,102,-88,-479
258,2022/7/15 22:00,13,106,-93,-368
258,2022/7/15 22:10,12,94,-82,-444
258,2022/7/15 22:20,9,95,-86,-448
258,2022/7/15 22:30,7,103,-96,-512
258,2022/7/15 22:40,3,82,-79,-495
258,2022/7/15 22:50,2,50,-48,-386
239,2022/7/15 5:00,0,1,-1,-6
239,2022/7/15 5:10,0,1,-1,4
239,2022/7/15 5:20,0,1,-1,48
239,2022/7/15 5:30,0,1,-1,90
239,2022/7/15 5:40,1,1,0,108
239,2022/7/15 5:50,1,5,-4,124
239,2022/7/15 6:00,3,1,2,169
239,2022/7/15 6:10,3,8,-5,188
239,2022/7/15 6:20,5,6,-1,160
239,2022/7/15 6:30,12,14,-2,181
239,2022/7/15 6:40,8,19,-11,433
239,2022/7/15 6:50,12,21,-9,548
239,2022/7/15 7:00,19,21,-2,674
239,2022/7/15 7:10,17,23,-6,972
239,2022/7/15 7:20,18,33,-15,1778
239,2022/7/15 7:30,21,39,-18,2155
239,2022/7/15 7:40,25,46,-21,3571
239,2022/7/15 7:50,32,62,-30,3924
239,2022/7/15 8:00,31,75,-44,4129
239,2022/7/15 8:10,31,98,-67,4702
239,2022/7/15 8:20,29,105,-76,3755
239,2022/7/15 8:30,30,107,-77,2976
239,2022/7/15 8:40,28,122,-94,1798
239,2022/7/15 8:50,25,116,-91,1371
239,2022/7/15 9:00,23,86,-63,814
239,2022/7/15 9:10,18,68,-50,454
239,2022/7/15 9:20,15,61,-46,211
239,2022/7/15 9:30,10,62,-52,-65
239,2022/7/15 9:40,8,73,-65,-175
239,2022/7/15 9:50,6,61,-55,-420
239,2022/7/15 10:00,9,41,-32,-402
239,2022/7/15 10:10,9,34,-25,-274
239,2022/7/15 10:20,7,32,-25,-297
239,2022/7/15 10:30,8,23,-15,-284
239,2022/7/15 10:40,9,23,-14,-309
239,2022/7/15 10:50,8,23,-15,-286
239,2022/7/15 11:00,7,23,-16,-295
239,2022/7/15 11:10,5,16,-11,-247
239,2022/7/15 11:20,7,23,-16,-267
239,2022/7/15 11:30,9,23,-14,-277
239,2022/7/15 11:40,8,19,-11,-298
239,2022/7/15 11:50,7,21,-14,-277
239,2022/7/15 12:00,7,19,-12,-223
239,2022/7/15 12:10,9,19,-10,-265
239,2022/7/15 12:20,8,19,-11,-268
239,2022/7/15 12:30,11,21,-10,-296
239,2022/7/15 12:40,9,19,-10,-283
239,2022/7/15 12:50,7,23,-16,-324
239,2022/7/15 13:00,8,29,-21,-334
239,2022/7/15 13:10,9,14,-5,-250
239,2022/7/15 13:20,7,23,-16,-354
239,2022/7/15 13:30,8,29,-21,-308
239,2022/7/15 13:40,6,23,-17,-331
239,2022/7/15 13:50,9,23,-14,-329
239,2022/7/15 14:00,8,22,-14,-302
239,2022/7/15 14:10,9,22,-13,-346
239,2022/7/15 14:20,6,25,-19,-345
239,2022/7/15 14:30,8,23,-15,-322
239,2022/7/15 14:40,8,23,-15,-335
239,2022/7/15 14:50,8,19,-11,-322
239,2022/7/15 15:00,10,12,-2,-294
239,2022/7/15 15:10,11,25,-14,-305
239,2022/7/15 15:20,8,23,-15,-319
239,2022/7/15 15:30,8,23,-15,-297
239,2022/7/15 15:40,10,19,-9,-337
239,2022/7/15 15:50,11,21,-10,-337
239,2022/7/15 16:00,13,23,-10,-324
239,2022/7/15 16:10,10,23,-13,-282
239,2022/7/15 16:20,13,23,-10,-280
239,2022/7/15 16:30,11,31,-20,-223
239,2022/7/15 16:40,13,21,-8,-87
239,2022/7/15 16:50,17,23,-6,-139
239,2022/7/15 17:00,21,25,-4,103
239,2022/7/15 17:10,28,38,-10,323
239,2022/7/15 17:20,29,52,-23,49
239,2022/7/15 17:30,38,45,-7,-7
239,2022/7/15 17:40,43,45,-2,-89
239,2022/7/15 17:50,27,51,-24,-522
239,2022/7/15 18:00,29,50,-21,-524
239,2022/7/15 18:10,33,53,-20,-754
239,2022/7/15 18:20,37,49,-12,-1337
239,2022/7/15 18:30,36,49,-13,-1521
239,2022/7/15 18:40,37,52,-15,-1409
239,2022/7/15 18:50,29,50,-21,-1609
239,2022/7/15 19:00,23,41,-18,-1413
239,2022/7/15 19:10,12,25,-13,-1393
239,2022/7/15 19:20,18,25,-7,-927
239,2022/7/15 19:30,18,25,-7,-777
239,2022/7/15 19:40,10,25,-15,-603
239,2022/7/15 19:50,12,23,-11,-614
239,2022/7/15 20:00,10,21,-11,-484
239,2022/7/15 20:10,14,22,-8,-397
239,2022/7/15 20:20,11,21,-10,-414
239,2022/7/15 20:30,12,21,-9,-406
239,2022/7/15 20:40,7,21,-14,-519
239,2022/7/15 20:50,7,15,-8,-449
239,2022/7/15 21:00,7,18,-11,-403
239,2022/7/15 21:10,6,18,-12,-428
239,2022/7/15 21:20,6,19,-13,-455
239,2022/7/15 21:30,5,15,-10,-461
239,2022/7/15 21:40,2,15,-13,-476
239,2022/7/15 21:50,2,18,-16,-495
239,2022/7/15 22:00,2,15,-13,-381
239,2022/7/15 22:10,2,7,-5,-449
239,2022/7/15 22:20,2,18,-16,-464
239,2022/7/15 22:30,1,8,-7,-519
239,2022/7/15 22:40,2,13,-11,-506
239,2022/7/15 22:50,1,8,-7,-393
245,2022/7/15 5:00,0,1,-1,-7
245,2022/7/15 5:10,0,1,-1,3
245,2022/7/15 5:20,0,1,-1,47
245,2022/7/15 5:30,1,1,0,90
245,2022/7/15 5:40,6,1,5,113
245,2022/7/15 5:50,13,5,8,132
245,2022/7/15 6:00,16,23,-7,162
245,2022/7/15 6:10,18,23,-5,183
245,2022/7/15 6:20,21,34,-13,147
245,2022/7/15 6:30,24,52,-28,153
245,2022/7/15 6:40,36,62,-26,407
245,2022/7/15 6:50,38,51,-13,535
245,2022/7/15 7:00,38,79,-41,633
245,2022/7/15 7:10,48,80,-32,940
245,2022/7/15 7:20,59,93,-34,1744
245,2022/7/15 7:30,83,110,-27,2128
245,2022/7/15 7:40,78,109,-31,3540
245,2022/7/15 7:50,113,123,-10,3914
245,2022/7/15 8:00,181,230,-49,4080
245,2022/7/15 8:10,163,267,-104,4598
245,2022/7/15 8:20,127,206,-79,3676
245,2022/7/15 8:30,102,322,-220,2756
245,2022/7/15 8:40,86,493,-407,1391
245,2022/7/15 8:50,82,378,-296,1075
245,2022/7/15 9:00,60,284,-224,590
245,2022/7/15 9:10,52,184,-132,322
245,2022/7/15 9:20,46,284,-238,-27
245,2022/7/15 9:30,40,140,-100,-165
245,2022/7/15 9:40,28,109,-81,-256
245,2022/7/15 9:50,34,105,-71,-491
245,2022/7/15 10:00,31,106,-75,-477
245,2022/7/15 10:10,30,96,-66,-340
245,2022/7/15 10:20,27,82,-55,-352
245,2022/7/15 10:30,26,77,-51,-335
245,2022/7/15 10:40,28,78,-50,-359
245,2022/7/15 10:50,25,82,-57,-343
245,2022/7/15 11:00,27,65,-38,-333
245,2022/7/15 11:10,29,64,-35,-282
245,2022/7/15 11:20,26,65,-39,-306
245,2022/7/15 11:30,30,67,-37,-314
245,2022/7/15 11:40,26,69,-43,-341
245,2022/7/15 11:50,32,66,-34,-311
245,2022/7/15 12:00,31,70,-39,-262
245,2022/7/15 12:10,31,74,-43,-308
245,2022/7/15 12:20,31,76,-45,-313
245,2022/7/15 12:30,32,82,-50,-346
245,2022/7/15 12:40,30,77,-47,-330
245,2022/7/15 12:50,25,67,-42,-366
245,2022/7/15 13:00,32,73,-41,-375
245,2022/7/15 13:10,32,82,-50,-300
245,2022/7/15 13:20,28,76,-48,-402
245,2022/7/15 13:30,31,82,-51,-359
245,2022/7/15 13:40,32,78,-46,-377
245,2022/7/15 13:50,32,65,-33,-362
245,2022/7/15 14:00,32,85,-53,-355
245,2022/7/15 14:10,32,73,-41,-387
245,2022/7/15 14:20,30,84,-54,-399
245,2022/7/15 14:30,26,82,-56,-378
245,2022/7/15 14:40,33,61,-28,-363
245,2022/7/15 14:50,37,62,-25,-347
245,2022/7/15 15:00,36,69,-33,-327
245,2022/7/15 15:10,40,76,-36,-341
245,2022/7/15 15:20,37,68,-31,-350
245,2022/7/15 15:30,39,69,-30,-327
245,2022/7/15 15:40,42,71,-29,-366
245,2022/7/15 15:50,38,73,-35,-372
245,2022/7/15 16:00,45,76,-31,-355
245,2022/7/15 16:10,45,70,-25,-307
245,2022/7/15 16:20,45,84,-39,-319
245,2022/7/15 16:30,45,75,-30,-253
245,2022/7/15 16:40,60,90,-30,-117
245,2022/7/15 16:50,66,90,-24,-163
245,2022/7/15 17:00,213,90,123,226
245,2022/7/15 17:10,346,92,254,577
245,2022/7/15 17:20,208,105,103,152
245,2022/7/15 17:30,214,123,91,84
245,2022/7/15 17:40,267,119,148,59
245,2022/7/15 17:50,176,123,53,-469
245,2022/7/15 18:00,214,116,98,-426
245,2022/7/15 18:10,378,104,274,-480
245,2022/7/15 18:20,232,124,108,-1229
245,2022/7/15 18:30,169,104,65,-1456
245,2022/7/15 18:40,175,123,52,-1357
245,2022/7/15 18:50,118,111,7,-1602
245,2022/7/15 19:00,76,125,-49,-1462
245,2022/7/15 19:10,61,92,-31,-1424
245,2022/7/15 19:20,44,80,-36,-963
245,2022/7/15 19:30,44,85,-41,-818
245,2022/7/15 19:40,37,76,-39,-642
245,2022/7/15 19:50,38,75,-37,-651
245,2022/7/15 20:00,35,68,-33,-517
245,2022/7/15 20:10,41,57,-16,-413
245,2022/7/15 20:20,32,68,-36,-450
245,2022/7/15 20:30,32,64,-32,-438
245,2022/7/15 20:40,30,66,-36,-555
245,2022/7/15 20:50,30,74,-44,-493
245,2022/7/15 21:00,32,62,-30,-433
245,2022/7/15 21:10,34,60,-26,-454
245,2022/7/15 21:20,34,67,-33,-488
245,2022/7/15 21:30,25,70,-45,-506
245,2022/7/15 21:40,33,62,-29,-505
245,2022/7/15 21:50,37,65,-28,-523
245,2022/7/15 22:00,34,55,-21,-402
245,2022/7/15 22:10,28,52,-24,-473
245,2022/7/15 22:20,16,49,-33,-497
245,2022/7/15 22:30,13,50,-37,-556
245,2022/7/15 22:40,7,51,-44,-550
245,2022/7/15 22:50,3,27,-24,-417
236,2022/7/15 5:00,0,1,-1,-8
236,2022/7/15 5:10,0,1,-1,2
236,2022/7/15 5:20,1,1,0,47
236,2022/7/15 5:30,2,1,1,91
236,2022/7/15 5:40,3,1,2,115
236,2022/7/15 5:50,4,21,-17,115
236,2022/7/15 6:00,6,38,-32,130
236,2022/7/15 6:10,8,31,-23,160
236,2022/7/15 6:20,14,60,-46,101
236,2022/7/15 6:30,18,72,-54,99
236,2022/7/15 6:40,18,99,-81,326
236,2022/7/15 6:50,20,110,-90,445
236,2022/7/15 7:00,28,126,-98,535
236,2022/7/15 7:10,31,111,-80,860
236,2022/7/15 7:20,33,110,-77,1667
236,2022/7/15 7:30,37,119,-82,2046
236,2022/7/15 7:40,44,182,-138,3402
236,2022/7/15 7:50,46,148,-102,3812
236,2022/7/15 8:00,52,144,-92,3988
236,2022/7/15 8:10,53,169,-116,4482
236,2022/7/15 8:20,57,104,-47,3629
236,2022/7/15 8:30,60,109,-49,2707
236,2022/7/15 8:40,53,109,-56,1335
236,2022/7/15 8:50,68,108,-40,1035
236,2022/7/15 9:00,57,110,-53,537
236,2022/7/15 9:10,59,102,-43,279
236,2022/7/15 9:20,49,125,-76,-103
236,2022/7/15 9:30,60,104,-44,-209
236,2022/7/15 9:40,54,85,-31,-287
236,2022/7/15 9:50,56,104,-48,-539
236,2022/7/15 10:00,44,101,-57,-534
236,2022/7/15 10:10,53,106,-53,-393
236,2022/7/15 10:20,54,87,-33,-385
236,2022/7/15 10:30,48,91,-43,-378
236,2022/7/15 10:40,51,87,-36,-395
236,2022/7/15 10:50,43,77,-34,-377
236,2022/7/15 11:00,54,63,-9,-342
236,2022/7/15 11:10,44,67,-23,-305
236,2022/7/15 11:20,50,64,-14,-320
236,2022/7/15 11:30,43,73,-30,-344
236,2022/7/15 11:40,46,69,-23,-364
236,2022/7/15 11:50,43,76,-33,-344
236,2022/7/15 12:00,41,73,-32,-294
236,2022/7/15 12:10,40,73,-33,-341
236,2022/7/15 12:20,37,74,-37,-350
236,2022/7/15 12:30,37,91,-54,-400
236,2022/7/15 12:40,33,92,-59,-389
236,2022/7/15 12:50,29,96,-67,-433
236,2022/7/15 13:00,37,93,-56,-431
236,2022/7/15 13:10,29,90,-61,-361
236,2022/7/15 13:20,37,104,-67,-469
236,2022/7/15 13:30,35,90,-55,-414
236,2022/7/15 13:40,39,90,-51,-428
236,2022/7/15 13:50,43,87,-44,-406
236,2022/7/15 14:00,44,85,-41,-396
236,2022/7/15 14:10,47,84,-37,-424
236,2022/7/15 14:20,47,85,-38,-437
236,2022/7/15 14:30,46,92,-46,-424
236,2022/7/15 14:40,54,77,-23,-386
236,2022/7/15 14:50,47,70,-23,-370
236,2022/7/15 15:00,63,64,-1,-328
236,2022/7/15 15:10,53,74,-21,-362
236,2022/7/15 15:20,62,69,-7,-357
236,2022/7/15 15:30,59,75,-16,-343
236,2022/7/15 15:40,61,63,-2,-368
236,2022/7/15 15:50,59,60,-1,-373
236,2022/7/15 16:00,73,74,-1,-356
236,2022/7/15 16:10,62,62,0,-307
236,2022/7/15 16:20,68,70,-2,-321
236,2022/7/15 16:30,70,64,6,-247
236,2022/7/15 16:40,74,64,10,-107
236,2022/7/15 16:50,73,64,9,-154
236,2022/7/15 17:00,133,67,66,292
236,2022/7/15 17:10,156,62,94,671
236,2022/7/15 17:20,76,77,-1,151
236,2022/7/15 17:30,67,76,-9,75
236,2022/7/15 17:40,65,88,-23,36
236,2022/7/15 17:50,48,77,-29,-498
236,2022/7/15 18:00,43,95,-52,-478
236,2022/7/15 18:10,38,106,-68,-548
236,2022/7/15 18:20,36,89,-53,-1282
236,2022/7/15 18:30,31,93,-62,-1518
236,2022/7/15 18:40,35,91,-56,-1413
236,2022/7/15 18:50,31,90,-59,-1661
236,2022/7/15 19:00,28,77,-49,-1511
236,2022/7/15 19:10,28,70,-42,-1466
236,2022/7/15 19:20,29,66,-37,-1000
236,2022/7/15 19:30,28,67,-39,-857
236,2022/7/15 19:40,29,55,-26,-668
236,2022/7/15 19:50,26,63,-37,-688
236,2022/7/15 20:00,29,59,-30,-547
236,2022/7/15 20:10,30,53,-23,-436
236,2022/7/15 20:20,29,54,-25,-475
236,2022/7/15 20:30,30,54,-24,-462
236,2022/7/15 20:40,28,50,-22,-577
236,2022/7/15 20:50,25,63,-38,-531
236,2022/7/15 21:00,22,55,-33,-466
236,2022/7/15 21:10,22,46,-24,-478
236,2022/7/15 21:20,22,56,-34,-522
236,2022/7/15 21:30,15,57,-42,-548
236,2022/7/15 21:40,16,52,-36,-541
236,2022/7/15 21:50,13,52,-39,-562
236,2022/7/15 22:00,16,43,-27,-429
236,2022/7/15 22:10,13,48,-35,-508
236,2022/7/15 22:20,10,40,-30,-527
236,2022/7/15 22:30,6,43,-37,-593
236,2022/7/15 22:40,4,25,-21,-571
236,2022/7/15 22:50,2,23,-21,-438
260,2022/7/15 5:00,0,1,-1,-9
260,2022/7/15 5:10,0,1,-1,1
260,2022/7/15 5:20,1,1,0,47
260,2022/7/15 5:30,3,1,2,93
260,2022/7/15 5:40,9,1,8,123
260,2022/7/15 5:50,17,19,-2,113
260,2022/7/15 6:00,19,50,-31,99
260,2022/7/15 6:10,21,62,-41,119
260,2022/7/15 6:20,27,93,-66,35
260,2022/7/15 6:30,36,112,-76,23
260,2022/7/15 6:40,40,152,-112,214
260,2022/7/15 6:50,49,153,-104,341
260,2022/7/15 7:00,63,230,-167,368
260,2022/7/15 7:10,75,297,-222,638
260,2022/7/15 7:20,84,321,-237,1430
260,2022/7/15 7:30,148,502,-354,1692
260,2022/7/15 7:40,184,497,-313,3089
260,2022/7/15 7:50,234,586,-352,3460
260,2022/7/15 8:00,244,1104,-860,3128
260,2022/7/15 8:10,265,1618,-1353,3129
260,2022/7/15 8:20,282,1555,-1273,2356
260,2022/7/15 8:30,283,1832,-1549,1158
260,2022/7/15 8:40,239,2834,-2595,-1260
260,2022/7/15 8:50,234,2622,-2388,-1353
260,2022/7/15 9:00,240,1663,-1423,-886
260,2022/7/15 9:10,220,615,-395,-116
260,2022/7/15 9:20,219,563,-344,-447
260,2022/7/15 9:30,211,503,-292,-501
260,2022/7/15 9:40,192,326,-134,-421
260,2022/7/15 9:50,180,385,-205,-744
260,2022/7/15 10:00,174,256,-82,-616
260,2022/7/15 10:10,173,222,-49,-442
260,2022/7/15 10:20,169,192,-23,-408
260,2022/7/15 10:30,150,119,31,-347
260,2022/7/15 10:40,161,117,44,-351
260,2022/7/15 10:50,174,121,53,-324
260,2022/7/15 11:00,173,108,65,-277
260,2022/7/15 11:10,173,122,51,-254
260,2022/7/15 11:20,180,105,75,-245
260,2022/7/15 11:30,187,117,70,-274
260,2022/7/15 11:40,184,122,62,-302
260,2022/7/15 11:50,174,123,51,-293
260,2022/7/15 12:00,170,109,61,-233
260,2022/7/15 12:10,159,88,71,-270
260,2022/7/15 12:20,141,128,13,-337
260,2022/7/15 12:30,129,108,21,-379
260,2022/7/15 12:40,112,152,-40,-429
260,2022/7/15 12:50,103,178,-75,-508
260,2022/7/15 13:00,138,193,-55,-486
260,2022/7/15 13:10,143,144,-1,-362
260,2022/7/15 13:20,147,153,-6,-475
260,2022/7/15 13:30,154,180,-26,-440
260,2022/7/15 13:40,176,179,-3,-431
260,2022/7/15 13:50,169,140,29,-377
260,2022/7/15 14:00,175,108,67,-329
260,2022/7/15 14:10,185,109,76,-348
260,2022/7/15 14:20,199,108,91,-346
260,2022/7/15 14:30,207,119,88,-336
260,2022/7/15 14:40,207,125,82,-304
260,2022/7/15 14:50,207,109,98,-272
260,2022/7/15 15:00,223,113,110,-218
260,2022/7/15 15:10,262,127,135,-227
260,2022/7/15 15:20,267,118,149,-208
260,2022/7/15 15:30,265,122,143,-200
260,2022/7/15 15:40,258,105,153,-215
260,2022/7/15 15:50,273,109,164,-209
260,2022/7/15 16:00,274,125,149,-207
260,2022/7/15 16:10,271,124,147,-160
260,2022/7/15 16:20,336,124,212,-109
260,2022/7/15 16:30,355,122,233,-14
260,2022/7/15 16:40,378,123,255,148
260,2022/7/15 16:50,312,121,191,37
260,2022/7/15 17:00,805,125,680,972
260,2022/7/15 17:10,1350,123,1227,1898
260,2022/7/15 17:20,1028,118,910,1061
260,2022/7/15 17:30,1031,149,882,957
260,2022/7/15 17:40,1356,178,1178,1214
260,2022/7/15 17:50,831,158,673,175
260,2022/7/15 18:00,800,179,621,143
260,2022/7/15 18:10,1206,226,980,432
260,2022/7/15 18:20,711,170,541,-741
260,2022/7/15 18:30,578,178,400,-1118
260,2022/7/15 18:40,352,153,199,-1214
260,2022/7/15 18:50,294,117,177,-1484
260,2022/7/15 19:00,225,114,111,-1400
260,2022/7/15 19:10,231,104,127,-1339
260,2022/7/15 19:20,192,106,86,-914
260,2022/7/15 19:30,176,114,62,-795
260,2022/7/15 19:40,159,99,60,-608
260,2022/7/15 19:50,172,99,73,-615
260,2022/7/15 20:00,157,91,66,-481
260,2022/7/15 20:10,166,77,89,-347
260,2022/7/15 20:20,164,79,85,-390
260,2022/7/15 20:30,133,88,45,-417
260,2022/7/15 20:40,113,77,36,-541
260,2022/7/15 20:50,74,86,-12,-543
260,2022/7/15 21:00,103,79,24,-442
260,2022/7/15 21:10,85,85,0,-478
260,2022/7/15 21:20,77,86,-9,-531
260,2022/7/15 21:30,70,77,-7,-555
260,2022/7/15 21:40,66,75,-9,-550
260,2022/7/15 21:50,44,82,-38,-600
260,2022/7/15 22:00,44,72,-28,-457
260,2022/7/15 22:10,38,71,-33,-541
260,2022/7/15 22:20,30,76,-46,-573
260,2022/7/15 22:30,31,64,-33,-626
260,2022/7/15 22:40,28,51,-23,-594
260,2022/7/15 22:50,8,64,-56,-494
232,2022/7/15 5:00,0,1,-1,-10
232,2022/7/15 5:10,0,1,-1,0
232,2022/7/15 5:20,0,1,-1,46
232,2022/7/15 5:30,3,1,2,95
232,2022/7/15 5:40,3,2,1,124
232,2022/7/15 5:50,12,6,6,119
232,2022/7/15 6:00,12,61,-49,50
232,2022/7/15 6:10,15,62,-47,72
232,2022/7/15 6:20,22,70,-48,-13
232,2022/7/15 6:30,23,76,-53,-30
232,2022/7/15 6:40,30,110,-80,134
232,2022/7/15 6:50,34,123,-89,252
232,2022/7/15 7:00,46,150,-104,264
232,2022/7/15 7:10,44,211,-167,471
232,2022/7/15 7:20,45,297,-252,1178
232,2022/7/15 7:30,45,327,-282,1410
232,2022/7/15 7:40,57,441,-384,2705
232,2022/7/15 7:50,79,507,-428,3032
232,2022/7/15 8:00,84,414,-330,2798
232,2022/7/15 8:10,82,591,-509,2620
232,2022/7/15 8:20,128,478,-350,2006
232,2022/7/15 8:30,93,591,-498,660
232,2022/7/15 8:40,112,1725,-1613,-2873
232,2022/7/15 8:50,93,1677,-1584,-2937
232,2022/7/15 9:00,82,1186,-1104,-1990
232,2022/7/15 9:10,79,486,-407,-523
232,2022/7/15 9:20,79,424,-345,-792
232,2022/7/15 9:30,73,425,-352,-853
232,2022/7/15 9:40,71,428,-357,-778
232,2022/7/15 9:50,68,345,-277,-1021
232,2022/7/15 10:00,73,318,-245,-861
232,2022/7/15 10:10,75,223,-148,-590
232,2022/7/15 10:20,69,171,-102,-510
232,2022/7/15 10:30,82,179,-97,-444
232,2022/7/15 10:40,75,139,-64,-415
232,2022/7/15 10:50,66,122,-56,-380
232,2022/7/15 11:00,70,111,-41,-318
232,2022/7/15 11:10,67,105,-38,-292
232,2022/7/15 11:20,66,114,-48,-293
232,2022/7/15 11:30,75,105,-30,-304
232,2022/7/15 11:40,73,111,-38,-340
232,2022/7/15 11:50,73,87,-14,-307
232,2022/7/15 12:00,71,105,-34,-267
232,2022/7/15 12:10,74,105,-31,-301
232,2022/7/15 12:20,68,105,-37,-374
232,2022/7/15 12:30,67,118,-51,-430
232,2022/7/15 12:40,55,101,-46,-475
232,2022/7/15 12:50,44,117,-73,-581
232,2022/7/15 13:00,46,121,-75,-561
232,2022/7/15 13:10,46,108,-62,-424
232,2022/7/15 13:20,47,110,-63,-538
232,2022/7/15 13:30,55,104,-49,-489
232,2022/7/15 13:40,62,109,-47,-478
232,2022/7/15 13:50,70,122,-52,-429
232,2022/7/15 14:00,71,109,-38,-367
232,2022/7/15 14:10,94,123,-29,-377
232,2022/7/15 14:20,131,103,28,-318
232,2022/7/15 14:30,116,105,11,-325
232,2022/7/15 14:40,139,111,28,-276
232,2022/7/15 14:50,135,112,23,-249
232,2022/7/15 15:00,136,103,33,-185
232,2022/7/15 15:10,176,102,74,-153
232,2022/7/15 15:20,190,112,78,-130
232,2022/7/15 15:30,163,110,53,-147
232,2022/7/15 15:40,184,99,85,-130
232,2022/7/15 15:50,188,105,83,-126
232,2022/7/15 16:00,223,101,122,-85
232,2022/7/15 16:10,227,90,137,-23
232,2022/7/15 16:20,244,101,143,34
232,2022/7/15 16:30,255,93,162,148
232,2022/7/15 16:40,336,93,243,391
232,2022/7/15 16:50,378,93,285,322
232,2022/7/15 17:00,568,100,468,1440
232,2022/7/15 17:10,658,106,552,2450
232,2022/7/15 17:20,571,105,466,1527
232,2022/7/15 17:30,696,105,591,1548
232,2022/7/15 17:40,1038,125,913,2127
232,2022/7/15 17:50,608,121,487,662
232,2022/7/15 18:00,639,111,528,671
232,2022/7/15 18:10,1034,117,917,1349
232,2022/7/15 18:20,714,104,610,-131
232,2022/7/15 18:30,615,105,510,-608
232,2022/7/15 18:40,551,110,441,-773
232,2022/7/15 18:50,350,105,245,-1239
232,2022/7/15 19:00,273,120,153,-1247
232,2022/7/15 19:10,262,111,151,-1188
232,2022/7/15 19:20,212,95,117,-797
232,2022/7/15 19:30,176,98,78,-717
232,2022/7/15 19:40,138,79,59,-549
232,2022/7/15 19:50,111,87,24,-591
232,2022/7/15 20:00,88,72,16,-465
232,2022/7/15 20:10,142,73,69,-278
232,2022/7/15 20:20,86,74,12,-378
232,2022/7/15 20:30,79,74,5,-412
232,2022/7/15 20:40,73,70,3,-538
232,2022/7/15 20:50,70,68,2,-541
232,2022/7/15 21:00,70,67,3,-439
232,2022/7/15 21:10,80,70,10,-468
232,2022/7/15 21:20,62,70,-8,-539
232,2022/7/15 21:30,68,61,7,-548
232,2022/7/15 21:40,64,67,-3,-553
232,2022/7/15 21:50,47,59,-12,-612
232,2022/7/15 22:00,44,53,-9,-466
232,2022/7/15 22:10,53,66,-13,-554
232,2022/7/15 22:20,39,58,-19,-592
232,2022/7/15 22:30,23,47,-24,-650
232,2022/7/15 22:40,35,49,-14,-608
232,2022/7/15 22:50,19,35,-16,-510
242,2022/7/15 5:00,0,1,-1,-11
242,2022/7/15 5:10,0,1,-1,-1
242,2022/7/15 5:20,0,1,-1,45
242,2022/7/15 5:30,6,1,5,100
242,2022/7/15 5:40,8,1,7,131
242,2022/7/15 5:50,16,2,14,133
242,2022/7/15 6:00,15,47,-32,18
242,2022/7/15 6:10,15,65,-50,22
242,2022/7/15 6:20,16,68,-52,-65
242,2022/7/15 6:30,20,82,-62,-92
242,2022/7/15 6:40,25,106,-81,53
242,2022/7/15 6:50,27,116,-89,163
242,2022/7/15 7:00,32,115,-83,181
242,2022/7/15 7:10,42,267,-225,246
242,2022/7/15 7:20,37,253,-216,962
242,2022/7/15 7:30,35,298,-263,1147
242,2022/7/15 7:40,43,334,-291,2414
242,2022/7/15 7:50,45,534,-489,2543
242,2022/7/15 8:00,54,682,-628,2170
242,2022/7/15 8:10,61,1803,-1742,878
242,2022/7/15 8:20,66,3188,-3122,-1116
242,2022/7/15 8:30,57,3046,-2989,-2329
242,2022/7/15 8:40,52,8117,-8065,-10938
242,2022/7/15 8:50,50,6447,-6397,-9334
242,2022/7/15 9:00,45,2963,-2918,-4908
242,2022/7/15 9:10,46,3536,-3490,-4013
242,2022/7/15 9:20,43,3313,-3270,-4062
242,2022/7/15 9:30,38,2224,-2186,-3039
242,2022/7/15 9:40,38,811,-773,-1551
242,2022/7/15 9:50,37,576,-539,-1560
242,2022/7/15 10:00,36,385,-349,-1210
242,2022/7/15 10:10,43,297,-254,-844
242,2022/7/15 10:20,40,297,-257,-767
242,2022/7/15 10:30,43,179,-136,-580
242,2022/7/15 10:40,45,143,-98,-513
242,2022/7/15 10:50,43,183,-140,-520
242,2022/7/15 11:00,45,182,-137,-455
242,2022/7/15 11:10,47,118,-71,-363
242,2022/7/15 11:20,43,111,-68,-361
242,2022/7/15 11:30,54,109,-55,-359
242,2022/7/15 11:40,57,143,-86,-426
242,2022/7/15 11:50,61,110,-49,-356
242,2022/7/15 12:00,65,112,-47,-314
242,2022/7/15 12:10,73,105,-32,-333
242,2022/7/15 12:20,74,122,-48,-422
242,2022/7/15 12:30,64,120,-56,-486
242,2022/7/15 12:40,70,152,-82,-557
242,2022/7/15 12:50,69,181,-112,-693
242,2022/7/15 13:00,74,139,-65,-626
242,2022/7/15 13:10,103,121,-18,-442
242,2022/7/15 13:20,79,110,-31,-569
242,2022/7/15 13:30,79,128,-49,-538
242,2022/7/15 13:40,82,144,-62,-540
242,2022/7/15 13:50,85,117,-32,-461
242,2022/7/15 14:00,110,110,0,-367
242,2022/7/15 14:10,132,119,13,-364
242,2022/7/15 14:20,135,107,28,-290
242,2022/7/15 14:30,128,120,8,-317
242,2022/7/15 14:40,94,114,-20,-296
242,2022/7/15 14:50,129,122,7,-242
242,2022/7/15 15:00,149,109,40,-145
242,2022/7/15 15:10,157,101,56,-97
242,2022/7/15 15:20,172,123,49,-81
242,2022/7/15 15:30,183,102,81,-66
242,2022/7/15 15:40,200,119,81,-49
242,2022/7/15 15:50,202,126,76,-50
242,2022/7/15 16:00,224,108,116,31
242,2022/7/15 16:10,262,103,159,136
242,2022/7/15 16:20,263,103,160,194
242,2022/7/15 16:30,263,98,165,313
242,2022/7/15 16:40,336,118,218,609
242,2022/7/15 16:50,335,107,228,550
242,2022/7/15 17:00,610,119,491,1931
242,2022/7/15 17:10,1035,121,914,3364
242,2022/7/15 17:20,719,122,597,2124
242,2022/7/15 17:30,828,107,721,2269
242,2022/7/15 17:40,1568,127,1441,3568
242,2022/7/15 17:50,1352,191,1161,1823
242,2022/7/15 18:00,1559,158,1401,2072
242,2022/7/15 18:10,2500,159,2341,3690
242,2022/7/15 18:20,1986,146,1840,1709
242,2022/7/15 18:30,1360,199,1161,553
242,2022/7/15 18:40,1348,181,1167,394
242,2022/7/15 18:50,1163,115,1048,-191
242,2022/7/15 19:00,806,124,682,-565
242,2022/7/15 19:10,655,117,538,-650
242,2022/7/15 19:20,578,105,473,-324
242,2022/7/15 19:30,458,112,346,-371
242,2022/7/15 19:40,355,95,260,-289
242,2022/7/15 19:50,350,82,268,-323
242,2022/7/15 20:00,337,80,257,-208
242,2022/7/15 20:10,325,81,244,-34
242,2022/7/15 20:20,307,79,228,-150
242,2022/7/15 20:30,273,73,200,-212
242,2022/7/15 20:40,266,68,198,-340
242,2022/7/15 20:50,272,64,208,-333
242,2022/7/15 21:00,269,67,202,-237
242,2022/7/15 21:10,336,66,270,-198
242,2022/7/15 21:20,289,69,220,-319
242,2022/7/15 21:30,269,63,206,-342
242,2022/7/15 21:40,273,62,211,-342
242,2022/7/15 21:50,244,60,184,-428
242,2022/7/15 22:00,390,57,333,-133
242,2022/7/15 22:10,617,50,567,13
242,2022/7/15 22:20,222,50,172,-420
242,2022/7/15 22:30,66,49,17,-633
242,2022/7/15 22:40,37,42,-5,-613
242,2022/7/15 22:50,25,25,0,-510
231,2022/7/15 5:00,0,1,-1,-12
231,2022/7/15 5:10,0,1,-1,-2
231,2022/7/15 5:20,0,1,-1,44
231,2022/7/15 5:30,3,1,2,102
231,2022/7/15 5:40,15,1,14,145
231,2022/7/15 5:50,24,12,12,145
231,2022/7/15 6:00,26,35,-9,9
231,2022/7/15 6:10,33,53,-20,2
231,2022/7/15 6:20,40,59,-19,-84
231,2022/7/15 6:30,52,74,-22,-114
231,2022/7/15 6:40,61,91,-30,23
231,2022/7/15 6:50,80,109,-29,134
231,2022/7/15 7:00,112,181,-69,112
231,2022/7/15 7:10,152,267,-115,131
231,2022/7/15 7:20,216,253,-37,925
231,2022/7/15 7:30,215,268,-53,1094
231,2022/7/15 7:40,245,345,-100,2314
231,2022/7/15 7:50,266,434,-168,2375
231,2022/7/15 8:00,347,582,-235,1935
231,2022/7/15 8:10,366,1126,-760,118
231,2022/7/15 8:20,347,1134,-787,-1903
231,2022/7/15 8:30,278,1122,-844,-3173
231,2022/7/15 8:40,282,1643,-1361,-12299
231,2022/7/15 8:50,246,1549,-1303,-10637
231,2022/7/15 9:00,208,489,-281,-5189
231,2022/7/15 9:10,178,631,-453,-4466
231,2022/7/15 9:20,148,423,-275,-4337
231,2022/7/15 9:30,115,431,-316,-3355
231,2022/7/15 9:40,85,382,-297,-1848
231,2022/7/15 9:50,70,282,-212,-1772
231,2022/7/15 10:00,68,233,-165,-1375
231,2022/7/15 10:10,64,119,-55,-899
231,2022/7/15 10:20,59,123,-64,-831
231,2022/7/15 10:30,53,117,-64,-644
231,2022/7/15 10:40,45,115,-70,-583
231,2022/7/15 10:50,50,120,-70,-590
231,2022/7/15 11:00,52,99,-47,-502
231,2022/7/15 11:10,55,110,-55,-418
231,2022/7/15 11:20,55,104,-49,-410
231,2022/7/15 11:30,59,113,-54,-413
231,2022/7/15 11:40,69,102,-33,-459
231,2022/7/15 11:50,58,108,-50,-406
231,2022/7/15 12:00,70,97,-27,-341
231,2022/7/15 12:10,72,122,-50,-383
231,2022/7/15 12:20,59,107,-48,-470
231,2022/7/15 12:30,61,119,-58,-544
231,2022/7/15 12:40,63,102,-39,-596
231,2022/7/15 12:50,66,105,-39,-732
231,2022/7/15 13:00,68,117,-49,-675
231,2022/7/15 13:10,60,124,-64,-506
231,2022/7/15 13:20,62,117,-55,-624
231,2022/7/15 13:30,58,116,-58,-596
231,2022/7/15 13:40,67,123,-56,-596
231,2022/7/15 13:50,67,105,-38,-499
231,2022/7/15 14:00,62,118,-56,-423
231,2022/7/15 14:10,65,122,-57,-421
231,2022/7/15 14:20,62,121,-59,-349
231,2022/7/15 14:30,76,101,-25,-342
231,2022/7/15 14:40,69,98,-29,-325
231,2022/7/15 14:50,102,88,14,-228
231,2022/7/15 15:00,131,105,26,-119
231,2022/7/15 15:10,158,107,51,-46
231,2022/7/15 15:20,172,125,47,-34
231,2022/7/15 15:30,174,114,60,-6
231,2022/7/15 15:40,149,108,41,-8
231,2022/7/15 15:50,137,102,35,-15
231,2022/7/15 16:00,181,108,73,104
231,2022/7/15 16:10,218,118,100,236
231,2022/7/15 16:20,227,121,106,300
231,2022/7/15 16:30,293,123,170,483
231,2022/7/15 16:40,332,107,225,834
231,2022/7/15 16:50,333,124,209,759
231,2022/7/15 17:00,697,111,586,2517
231,2022/7/15 17:10,830,118,712,4076
231,2022/7/15 17:20,675,196,479,2603
231,2022/7/15 17:30,698,212,486,2755
231,2022/7/15 17:40,796,177,619,4187
231,2022/7/15 17:50,630,178,452,2275
231,2022/7/15 18:00,631,218,413,2485
231,2022/7/15 18:10,1202,301,901,4591
231,2022/7/15 18:20,801,284,517,2226
231,2022/7/15 18:30,572,284,288,841
231,2022/7/15 18:40,463,190,273,667
231,2022/7/15 18:50,333,178,155,-36
231,2022/7/15 19:00,274,145,129,-436
231,2022/7/15 19:10,230,128,102,-548
231,2022/7/15 19:20,191,109,82,-242
231,2022/7/15 19:30,175,103,72,-299
231,2022/7/15 19:40,144,110,34,-255
231,2022/7/15 19:50,87,111,-24,-347
231,2022/7/15 20:00,89,95,-6,-214
231,2022/7/15 20:10,82,92,-10,-44
231,2022/7/15 20:20,83,100,-17,-167
231,2022/7/15 20:30,67,114,-47,-259
231,2022/7/15 20:40,85,95,-10,-350
231,2022/7/15 20:50,83,95,-12,-345
231,2022/7/15 21:00,106,106,0,-237
231,2022/7/15 21:10,84,108,-24,-222
231,2022/7/15 21:20,62,91,-29,-348
231,2022/7/15 21:30,67,106,-39,-381
231,2022/7/15 21:40,49,92,-43,-385
231,2022/7/15 21:50,40,97,-57,-485
231,2022/7/15 22:00,34,92,-58,-191
231,2022/7/15 22:10,37,82,-45,-32
231,2022/7/15 22:20,31,85,-54,-474
231,2022/7/15 22:30,24,78,-54,-687
231,2022/7/15 22:40,20,73,-53,-666
231,2022/7/15 22:50,9,64,-55,-565
259,2022/7/15 5:00,0,1,-1,-13
259,2022/7/15 5:10,0,1,-1,-3
259,2022/7/15 5:20,1,1,0,44
259,2022/7/15 5:30,8,1,7,109
259,2022/7/15 5:40,17,1,16,161
259,2022/7/15 5:50,26,8,18,163
259,2022/7/15 6:00,31,29,2,11
259,2022/7/15 6:10,37,45,-8,-6
259,2022/7/15 6:20,45,72,-27,-111
259,2022/7/15 6:30,57,75,-18,-132
259,2022/7/15 6:40,77,106,-29,-6
259,2022/7/15 6:50,99,137,-38,96
259,2022/7/15 7:00,193,195,-2,110
259,2022/7/15 7:10,223,196,27,158
259,2022/7/15 7:20,227,118,109,1034
259,2022/7/15 7:30,255,224,31,1125
259,2022/7/15 7:40,319,333,-14,2300
259,2022/7/15 7:50,327,534,-207,2168
259,2022/7/15 8:00,599,615,-16,1919
259,2022/7/15 8:10,595,1933,-1338,-1220
259,2022/7/15 8:20,599,1890,-1291,-3194
259,2022/7/15 8:30,478,4581,-4103,-7276
259,2022/7/15 8:40,351,5187,-4836,-17135
259,2022/7/15 8:50,331,1968,-1637,-12274
259,2022/7/15 9:00,277,2804,-2527,-7716
259,2022/7/15 9:10,229,1961,-1732,-6198
259,2022/7/15 9:20,217,1576,-1359,-5696
259,2022/7/15 9:30,216,460,-244,-3599
259,2022/7/15 9:40,200,469,-269,-2117
259,2022/7/15 9:50,183,399,-216,-1988
259,2022/7/15 10:00,162,344,-182,-1557
259,2022/7/15 10:10,154,231,-77,-976
259,2022/7/15 10:20,140,268,-128,-959
259,2022/7/15 10:30,141,212,-71,-715
259,2022/7/15 10:40,136,151,-15,-598
259,2022/7/15 10:50,127,177,-50,-640
259,2022/7/15 11:00,136,180,-44,-546
259,2022/7/15 11:10,113,110,3,-415
259,2022/7/15 11:20,147,117,30,-380
259,2022/7/15 11:30,135,125,10,-403
259,2022/7/15 11:40,162,152,10,-449
259,2022/7/15 11:50,161,152,9,-397
259,2022/7/15 12:00,177,151,26,-315
259,2022/7/15 12:10,173,144,29,-354
259,2022/7/15 12:20,174,110,64,-406
259,2022/7/15 12:30,179,128,51,-493
259,2022/7/15 12:40,175,193,-18,-614
259,2022/7/15 12:50,191,185,6,-726
259,2022/7/15 13:00,183,180,3,-672
259,2022/7/15 13:10,204,117,87,-419
259,2022/7/15 13:20,205,127,78,-546
259,2022/7/15 13:30,213,180,33,-563
259,2022/7/15 13:40,205,180,25,-571
259,2022/7/15 13:50,196,159,37,-462
259,2022/7/15 14:00,196,151,45,-378
259,2022/7/15 14:10,185,110,75,-346
259,2022/7/15 14:20,200,171,29,-320
259,2022/7/15 14:30,203,183,20,-322
259,2022/7/15 14:40,212,170,42,-283
259,2022/7/15 14:50,238,139,99,-129
259,2022/7/15 15:00,231,121,110,-9
259,2022/7/15 15:10,243,110,133,87
259,2022/7/15 15:20,238,112,126,92
259,2022/7/15 15:30,263,146,117,111
259,2022/7/15 15:40,262,159,103,95
259,2022/7/15 15:50,270,139,131,116
259,2022/7/15 16:00,269,145,124,228
259,2022/7/15 16:10,294,121,173,409
259,2022/7/15 16:20,269,181,88,388
259,2022/7/15 16:30,327,146,181,664
259,2022/7/15 16:40,457,214,243,1077
259,2022/7/15 16:50,430,197,233,992
259,2022/7/15 17:00,800,195,605,3122
259,2022/7/15 17:10,1197,229,968,5044
259,2022/7/15 17:20,1025,296,729,3332
259,2022/7/15 17:30,1207,315,892,3647
259,2022/7/15 17:40,1981,337,1644,5831
259,2022/7/15 17:50,1347,527,820,3095
259,2022/7/15 18:00,1196,506,690,3175
259,2022/7/15 18:10,1974,508,1466,6057
259,2022/7/15 18:20,1615,501,1114,3340
259,2022/7/15 18:30,1148,421,727,1568
259,2022/7/15 18:40,1163,508,655,1322
259,2022/7/15 18:50,660,324,336,300
259,2022/7/15 19:00,643,326,317,-119
259,2022/7/15 19:10,570,300,270,-278
259,2022/7/15 19:20,432,180,252,10
259,2022/7/15 19:30,340,159,181,-118
259,2022/7/15 19:40,334,111,223,-32
259,2022/7/15 19:50,267,110,157,-190
259,2022/7/15 20:00,306,133,173,-41
259,2022/7/15 20:10,339,114,225,181
259,2022/7/15 20:20,306,120,186,19
259,2022/7/15 20:30,314,106,208,-51
259,2022/7/15 20:40,313,110,203,-147
259,2022/7/15 20:50,274,106,168,-177
259,2022/7/15 21:00,336,123,213,-24
259,2022/7/15 21:10,269,114,155,-67
259,2022/7/15 21:20,256,126,130,-218
259,2022/7/15 21:30,209,99,110,-271
259,2022/7/15 21:40,223,120,103,-282
259,2022/7/15 21:50,167,107,60,-425
259,2022/7/15 22:00,221,105,116,-75
259,2022/7/15 22:10,134,109,25,-7
259,2022/7/15 22:20,44,106,-62,-536
259,2022/7/15 22:30,32,111,-79,-766
259,2022/7/15 22:40,24,99,-75,-741
259,2022/7/15 22:50,15,65,-50,-615
261,2022/7/15 5:00,0,1,-1,-14
261,2022/7/15 5:10,0,1,-1,-4
261,2022/7/15 5:20,0,1,-1,43
261,2022/7/15 5:30,4,1,3,112
261,2022/7/15 5:40,13,1,12,173
261,2022/7/15 5:50,16,5,11,174
261,2022/7/15 6:00,21,19,2,13
261,2022/7/15 6:10,22,33,-11,-17
261,2022/7/15 6:20,32,25,7,-104
261,2022/7/15 6:30,36,51,-15,-147
261,2022/7/15 6:40,47,60,-13,-19
261,2022/7/15 6:50,69,66,3,99
261,2022/7/15 7:00,85,93,-8,102
261,2022/7/15 7:10,87,84,3,161
261,2022/7/15 7:20,152,69,83,1117
261,2022/7/15 7:30,185,100,85,1210
261,2022/7/15 7:40,234,98,136,2436
261,2022/7/15 7:50,277,108,169,2337
261,2022/7/15 8:00,317,109,208,2127
261,2022/7/15 8:10,350,208,142,-1078
261,2022/7/15 8:20,345,208,137,-3057
261,2022/7/15 8:30,282,233,49,-7227
261,2022/7/15 8:40,269,298,-29,-17164
261,2022/7/15 8:50,224,148,76,-12198
261,2022/7/15 9:00,156,103,53,-7663
261,2022/7/15 9:10,96,108,-12,-6210
261,2022/7/15 9:20,79,107,-28,-5724
261,2022/7/15 9:30,76,104,-28,-3627
261,2022/7/15 9:40,50,127,-77,-2194
261,2022/7/15 9:50,45,108,-63,-2051
261,2022/7/15 10:00,39,83,-44,-1601
261,2022/7/15 10:10,39,82,-43,-1019
261,2022/7/15 10:20,33,71,-38,-997
261,2022/7/15 10:30,33,62,-29,-744
261,2022/7/15 10:40,34,85,-51,-649
261,2022/7/15 10:50,29,73,-44,-684
261,2022/7/15 11:00,30,72,-42,-588
261,2022/7/15 11:10,29,65,-36,-451
261,2022/7/15 11:20,30,70,-40,-420
261,2022/7/15 11:30,35,73,-38,-441
261,2022/7/15 11:40,30,67,-37,-486
261,2022/7/15 11:50,32,74,-42,-439
261,2022/7/15 12:00,28,62,-34,-349
261,2022/7/15 12:10,27,67,-40,-394
261,2022/7/15 12:20,30,69,-39,-445
261,2022/7/15 12:30,32,82,-50,-543
261,2022/7/15 12:40,31,79,-48,-662
261,2022/7/15 12:50,29,64,-35,-761
261,2022/7/15 13:00,28,61,-33,-705
261,2022/7/15 13:10,33,77,-44,-463
261,2022/7/15 13:20,28,84,-56,-602
261,2022/7/15 13:30,28,76,-48,-611
261,2022/7/15 13:40,29,78,-49,-620
261,2022/7/15 13:50,32,64,-32,-494
261,2022/7/15 14:00,29,70,-41,-419
261,2022/7/15 14:10,30,77,-47,-393
261,2022/7/15 14:20,25,85,-60,-380
261,2022/7/15 14:30,25,84,-59,-381
261,2022/7/15 14:40,25,69,-44,-327
261,2022/7/15 14:50,30,73,-43,-172
261,2022/7/15 15:00,39,76,-37,-46
261,2022/7/15 15:10,36,77,-41,46
261,2022/7/15 15:20,30,97,-67,25
261,2022/7/15 15:30,29,76,-47,64
261,2022/7/15 15:40,36,90,-54,41
261,2022/7/15 15:50,37,83,-46,70
261,2022/7/15 16:00,42,76,-34,194
261,2022/7/15 16:10,44,90,-46,363
261,2022/7/15 16:20,40,96,-56,332
261,2022/7/15 16:30,44,100,-56,608
261,2022/7/15 16:40,52,104,-52,1025
261,2022/7/15 16:50,46,101,-55,937
261,2022/7/15 17:00,129,104,25,3147
261,2022/7/15 17:10,176,118,58,5102
261,2022/7/15 17:20,138,125,13,3345
261,2022/7/15 17:30,161,115,46,3693
261,2022/7/15 17:40,259,118,141,5972
261,2022/7/15 17:50,175,127,48,3143
261,2022/7/15 18:00,102,152,-50,3125
261,2022/7/15 18:10,199,179,20,6077
261,2022/7/15 18:20,137,158,-21,3319
261,2022/7/15 18:30,77,184,-107,1461
261,2022/7/15 18:40,62,192,-130,1192
261,2022/7/15 18:50,48,124,-76,224
261,2022/7/15 19:00,43,109,-66,-185
261,2022/7/15 19:10,48,111,-63,-341
261,2022/7/15 19:20,45,112,-67,-57
261,2022/7/15 19:30,39,110,-71,-189
261,2022/7/15 19:40,36,113,-77,-109
261,2022/7/15 19:50,31,99,-68,-258
261,2022/7/15 20:00,30,92,-62,-103
261,2022/7/15 20:10,29,79,-50,131
261,2022/7/15 20:20,25,83,-58,-39
261,2022/7/15 20:30,29,95,-66,-117
261,2022/7/15 20:40,25,94,-69,-216
261,2022/7/15 20:50,28,83,-55,-232
261,2022/7/15 21:00,22,82,-60,-84
261,2022/7/15 21:10,28,81,-53,-120
261,2022/7/15 21:20,22,93,-71,-289
261,2022/7/15 21:30,23,78,-55,-326
261,2022/7/15 21:40,20,74,-54,-336
261,2022/7/15 21:50,19,74,-55,-480
261,2022/7/15 22:00,16,78,-62,-137
261,2022/7/15 22:10,16,77,-61,-68
261,2022/7/15 22:20,15,69,-54,-590
261,2022/7/15 22:30,14,86,-72,-838
261,2022/7/15 22:40,9,72,-63,-804
261,2022/7/15 22:50,5,61,-56,-671
243,2022/7/15 5:00,0,1,-1,-15
243,2022/7/15 5:10,0,1,-1,-5
243,2022/7/15 5:20,1,1,0,43
243,2022/7/15 5:30,9,1,8,120
243,2022/7/15 5:40,23,5,18,191
243,2022/7/15 5:50,27,6,21,195
243,2022/7/15 6:00,30,16,14,27
243,2022/7/15 6:10,35,39,-4,-21
243,2022/7/15 6:20,44,38,6,-98
243,2022/7/15 6:30,59,47,12,-135
243,2022/7/15 6:40,88,66,22,3
243,2022/7/15 6:50,164,72,92,191
243,2022/7/15 7:00,187,66,121,223
243,2022/7/15 7:10,227,73,154,315
243,2022/7/15 7:20,225,93,132,1249
243,2022/7/15 7:30,223,88,135,1345
243,2022/7/15 7:40,244,103,141,2577
243,2022/7/15 7:50,317,120,197,2534
243,2022/7/15 8:00,301,119,182,2309
243,2022/7/15 8:10,282,192,90,-988
243,2022/7/15 8:20,277,184,93,-2964
243,2022/7/15 8:30,279,234,45,-7182
243,2022/7/15 8:40,277,298,-21,-17185
243,2022/7/15 8:50,228,318,-90,-12288
243,2022/7/15 9:00,167,320,-153,-7816
243,2022/7/15 9:10,150,226,-76,-6286
243,2022/7/15 9:20,122,155,-33,-5757
243,2022/7/15 9:30,77,117,-40,-3667
243,2022/7/15 9:40,65,105,-40,-2234
243,2022/7/15 9:50,53,124,-71,-2122
243,2022/7/15 10:00,45,108,-63,-1664
243,2022/7/15 10:10,44,111,-67,-1086
243,2022/7/15 10:20,39,87,-48,-1045
243,2022/7/15 10:30,37,96,-59,-803
243,2022/7/15 10:40,37,87,-50,-699
243,2022/7/15 10:50,35,72,-37,-721
243,2022/7/15 11:00,35,82,-47,-635
243,2022/7/15 11:10,35,77,-42,-493
243,2022/7/15 11:20,35,85,-50,-470
243,2022/7/15 11:30,35,71,-36,-477
243,2022/7/15 11:40,39,70,-31,-517
243,2022/7/15 11:50,38,77,-39,-478
243,2022/7/15 12:00,42,77,-35,-384
243,2022/7/15 12:10,43,77,-34,-428
243,2022/7/15 12:20,43,77,-34,-479
243,2022/7/15 12:30,43,62,-19,-562
243,2022/7/15 12:40,43,77,-34,-696
243,2022/7/15 12:50,42,82,-40,-801
243,2022/7/15 13:00,37,87,-50,-755
243,2022/7/15 13:10,39,91,-52,-515
243,2022/7/15 13:20,40,76,-36,-638
243,2022/7/15 13:30,37,69,-32,-643
243,2022/7/15 13:40,37,91,-54,-674
243,2022/7/15 13:50,35,91,-56,-550
243,2022/7/15 14:00,33,96,-63,-482
243,2022/7/15 14:10,39,98,-59,-452
243,2022/7/15 14:20,37,70,-33,-413
243,2022/7/15 14:30,29,93,-64,-445
243,2022/7/15 14:40,33,97,-64,-391
243,2022/7/15 14:50,29,92,-63,-235
243,2022/7/15 15:00,31,95,-64,-110
243,2022/7/15 15:10,38,77,-39,7
243,2022/7/15 15:20,37,77,-40,-15
243,2022/7/15 15:30,33,98,-65,-1
243,2022/7/15 15:40,35,109,-74,-33
243,2022/7/15 15:50,38,113,-75,-5
243,2022/7/15 16:00,44,106,-62,132
243,2022/7/15 16:10,46,112,-66,297
243,2022/7/15 16:20,46,85,-39,293
243,2022/7/15 16:30,68,105,-37,571
243,2022/7/15 16:40,52,120,-68,957
243,2022/7/15 16:50,60,123,-63,874
243,2022/7/15 17:00,215,124,91,3238
243,2022/7/15 17:10,206,112,94,5196
243,2022/7/15 17:20,131,127,4,3349
243,2022/7/15 17:30,264,110,154,3847
243,2022/7/15 17:40,207,151,56,6028
243,2022/7/15 17:50,177,212,-35,3108
243,2022/7/15 18:00,247,224,23,3148
243,2022/7/15 18:10,270,184,86,6163
243,2022/7/15 18:20,191,235,-44,3275
243,2022/7/15 18:30,223,183,40,1501
243,2022/7/15 18:40,205,271,-66,1126
243,2022/7/15 18:50,88,181,-93,131
243,2022/7/15 19:00,70,170,-100,-285
243,2022/7/15 19:10,67,152,-85,-426
243,2022/7/15 19:20,57,110,-53,-110
243,2022/7/15 19:30,46,122,-76,-265
243,2022/7/15 19:40,40,119,-79,-188
243,2022/7/15 19:50,37,112,-75,-333
243,2022/7/15 20:00,37,109,-72,-175
243,2022/7/15 20:10,41,125,-84,47
243,2022/7/15 20:20,38,115,-77,-116
243,2022/7/15 20:30,34,107,-73,-190
243,2022/7/15 20:40,34,101,-67,-283
243,2022/7/15 20:50,33,111,-78,-310
243,2022/7/15 21:00,36,113,-77,-161
243,2022/7/15 21:10,28,112,-84,-204
243,2022/7/15 21:20,32,105,-73,-362
243,2022/7/15 21:30,25,106,-81,-407
243,2022/7/15 21:40,29,107,-78,-414
243,2022/7/15 21:50,25,108,-83,-563
243,2022/7/15 22:00,24,98,-74,-211
243,2022/7/15 22:10,21,92,-71,-139
243,2022/7/15 22:20,16,99,-83,-673
243,2022/7/15 22:30,15,107,-92,-930
243,2022/7/15 22:40,10,81,-71,-875
243,2022/7/15 22:50,2,73,-71,-742
254,2022/7/15 5:00,0,1,-1,-16
254,2022/7/15 5:10,0,1,-1,-6
254,2022/7/15 5:20,0,1,-1,42
254,2022/7/15 5:30,18,1,17,137
254,2022/7/15 5:40,27,2,25,216
254,2022/7/15 5:50,30,1,29,224
254,2022/7/15 6:00,44,22,22,49
254,2022/7/15 6:10,57,45,12,-9
254,2022/7/15 6:20,76,45,31,-67
254,2022/7/15 6:30,182,50,132,-3
254,2022/7/15 6:40,237,59,178,181
254,2022/7/15 6:50,350,73,277,468
254,2022/7/15 7:00,327,86,241,464
254,2022/7/15 7:10,593,76,517,832
254,2022/7/15 7:20,666,110,556,1805
254,2022/7/15 7:30,667,126,541,1886
254,2022/7/15 7:40,735,109,626,3203
254,2022/7/15 7:50,1175,104,1071,3605
254,2022/7/15 8:00,1180,120,1060,3369
254,2022/7/15 8:10,1059,121,938,-50
254,2022/7/15 8:20,826,111,715,-2249
254,2022/7/15 8:30,731,153,578,-6604
254,2022/7/15 8:40,688,180,508,-16677
254,2022/7/15 8:50,477,160,317,-11971
254,2022/7/15 9:00,337,109,228,-7588
254,2022/7/15 9:10,295,125,170,-6116
254,2022/7/15 9:20,268,117,151,-5606
254,2022/7/15 9:30,227,116,111,-3556
254,2022/7/15 9:40,180,109,71,-2163
254,2022/7/15 9:50,138,107,31,-2091
254,2022/7/15 10:00,95,108,-13,-1677
254,2022/7/15 10:10,73,105,-32,-1118
254,2022/7/15 10:20,73,90,-17,-1062
254,2022/7/15 10:30,59,74,-15,-818
254,2022/7/15 10:40,46,101,-55,-754
254,2022/7/15 10:50,45,99,-54,-775
254,2022/7/15 11:00,48,99,-51,-686
254,2022/7/15 11:10,46,91,-45,-538
254,2022/7/15 11:20,44,76,-32,-502
254,2022/7/15 11:30,47,101,-54,-531
254,2022/7/15 11:40,48,99,-51,-568
254,2022/7/15 11:50,45,103,-58,-536
254,2022/7/15 12:00,46,101,-55,-439
254,2022/7/15 12:10,53,81,-28,-456
254,2022/7/15 12:20,57,102,-45,-524
254,2022/7/15 12:30,48,104,-56,-618
254,2022/7/15 12:40,47,100,-53,-749
254,2022/7/15 12:50,45,105,-60,-861
254,2022/7/15 13:00,49,105,-56,-811
254,2022/7/15 13:10,57,88,-31,-546
254,2022/7/15 13:20,46,106,-60,-698
254,2022/7/15 13:30,48,104,-56,-699
254,2022/7/15 13:40,45,105,-60,-734
254,2022/7/15 13:50,46,109,-63,-613
254,2022/7/15 14:00,40,97,-57,-539
254,2022/7/15 14:10,49,102,-53,-505
254,2022/7/15 14:20,47,107,-60,-473
254,2022/7/15 14:30,41,103,-62,-507
254,2022/7/15 14:40,38,86,-48,-439
254,2022/7/15 14:50,38,111,-73,-308
254,2022/7/15 15:00,40,105,-65,-175
254,2022/7/15 15:10,45,105,-60,-53
254,2022/7/15 15:20,45,122,-77,-92
254,2022/7/15 15:30,46,125,-79,-80
254,2022/7/15 15:40,44,109,-65,-98
254,2022/7/15 15:50,41,120,-79,-84
254,2022/7/15 16:00,44,114,-70,62
254,2022/7/15 16:10,54,107,-53,244
254,2022/7/15 16:20,54,120,-66,227
254,2022/7/15 16:30,65,133,-68,503
254,2022/7/15 16:40,69,171,-102,855
254,2022/7/15 16:50,73,159,-86,788
254,2022/7/15 17:00,137,106,31,3269
254,2022/7/15 17:10,175,210,-35,5161
254,2022/7/15 17:20,170,317,-147,3202
254,2022/7/15 17:30,115,437,-322,3525
254,2022/7/15 17:40,174,383,-209,5819
254,2022/7/15 17:50,134,531,-397,2711
254,2022/7/15 18:00,115,432,-317,2831
254,2022/7/15 18:10,179,432,-253,5910
254,2022/7/15 18:20,87,478,-391,2884
254,2022/7/15 18:30,65,432,-367,1134
254,2022/7/15 18:40,69,427,-358,768
254,2022/7/15 18:50,60,335,-275,-144
254,2022/7/15 19:00,48,387,-339,-624
254,2022/7/15 19:10,39,326,-287,-713
254,2022/7/15 19:20,41,335,-294,-404
254,2022/7/15 19:30,34,255,-221,-486
254,2022/7/15 19:40,32,169,-137,-325
254,2022/7/15 19:50,35,180,-145,-478
254,2022/7/15 20:00,30,106,-76,-251
254,2022/7/15 20:10,28,128,-100,-53
254,2022/7/15 20:20,30,129,-99,-215
254,2022/7/15 20:30,37,132,-95,-285
254,2022/7/15 20:40,27,109,-82,-365
254,2022/7/15 20:50,33,124,-91,-401
254,2022/7/15 21:00,29,124,-95,-256
254,2022/7/15 21:10,31,107,-76,-280
254,2022/7/15 21:20,29,112,-83,-445
254,2022/7/15 21:30,29,110,-81,-488
254,2022/7/15 21:40,28,111,-83,-497
254,2022/7/15 21:50,25,104,-79,-642
254,2022/7/15 22:00,22,104,-82,-293
254,2022/7/15 22:10,21,122,-101,-240
254,2022/7/15 22:20,20,102,-82,-755
254,2022/7/15 22:30,12,107,-95,-1025
254,2022/7/15 22:40,7,109,-102,-977
254,2022/7/15 22:50,2,78,-76,-818
235,2022/7/15 5:00,0,1,-1,-17
235,2022/7/15 5:10,1,1,0,-6
235,2022/7/15 5:20,10,1,9,51
235,2022/7/15 5:30,22,1,21,158
235,2022/7/15 5:40,35,1,34,250
235,2022/7/15 5:50,31,1,30,254
235,2022/7/15 6:00,51,16,35,84
235,2022/7/15 6:10,83,23,60,51
235,2022/7/15 6:20,125,28,97,30
235,2022/7/15 6:30,228,34,194,191
235,2022/7/15 6:40,302,50,252,433
235,2022/7/15 6:50,330,65,265,733
235,2022/7/15 7:00,593,73,520,984
235,2022/7/15 7:10,722,84,638,1470
235,2022/7/15 7:20,729,76,653,2458
235,2022/7/15 7:30,859,99,760,2646
235,2022/7/15 7:40,1213,100,1113,4316
235,2022/7/15 7:50,1586,112,1474,5079
235,2022/7/15 8:00,1588,120,1468,4837
235,2022/7/15 8:10,1573,109,1464,1414
235,2022/7/15 8:20,1364,87,1277,-972
235,2022/7/15 8:30,1212,122,1090,-5514
235,2022/7/15 8:40,1054,123,931,-15746
235,2022/7/15 8:50,723,110,613,-11358
235,2022/7/15 9:00,586,101,485,-7103
235,2022/7/15 9:10,374,104,270,-5846
235,2022/7/15 9:20,277,109,168,-5438
235,2022/7/15 9:30,231,90,141,-3415
235,2022/7/15 9:40,224,91,133,-2030
235,2022/7/15 9:50,182,104,78,-2013
235,2022/7/15 10:00,130,93,37,-1640
235,2022/7/15 10:10,95,76,19,-1099
235,2022/7/15 10:20,73,76,-3,-1065
235,2022/7/15 10:30,62,68,-6,-824
235,2022/7/15 10:40,48,98,-50,-804
235,2022/7/15 10:50,45,92,-47,-822
235,2022/7/15 11:00,42,73,-31,-717
235,2022/7/15 11:10,44,83,-39,-577
235,2022/7/15 11:20,47,93,-46,-548
235,2022/7/15 11:30,44,93,-49,-580
235,2022/7/15 11:40,47,94,-47,-615
235,2022/7/15 11:50,44,77,-33,-569
235,2022/7/15 12:00,47,100,-53,-492
235,2022/7/15 12:10,58,104,-46,-502
235,2022/7/15 12:20,59,114,-55,-579
235,2022/7/15 12:30,58,111,-53,-671
235,2022/7/15 12:40,56,96,-40,-789
235,2022/7/15 12:50,59,77,-18,-879
235,2022/7/15 13:00,56,109,-53,-864
235,2022/7/15 13:10,48,91,-43,-589
235,2022/7/15 13:20,49,105,-56,-754
235,2022/7/15 13:30,54,103,-49,-748
235,2022/7/15 13:40,45,74,-29,-763
235,2022/7/15 13:50,41,105,-64,-677
235,2022/7/15 14:00,44,103,-59,-598
235,2022/7/15 14:10,41,104,-63,-568
235,2022/7/15 14:20,40,102,-62,-535
235,2022/7/15 14:30,36,100,-64,-571
235,2022/7/15 14:40,39,100,-61,-500
235,2022/7/15 14:50,38,121,-83,-391
235,2022/7/15 15:00,37,122,-85,-260
235,2022/7/15 15:10,42,124,-82,-135
235,2022/7/15 15:20,44,125,-81,-173
235,2022/7/15 15:30,44,94,-50,-130
235,2022/7/15 15:40,39,117,-78,-176
235,2022/7/15 15:50,37,129,-92,-176
235,2022/7/15 16:00,40,117,-77,-15
235,2022/7/15 16:10,42,182,-140,104
235,2022/7/15 16:20,41,183,-142,85
235,2022/7/15 16:30,48,151,-103,400
235,2022/7/15 16:40,49,121,-72,783
235,2022/7/15 16:50,49,235,-186,602
235,2022/7/15 17:00,63,230,-167,3102
235,2022/7/15 17:10,69,295,-226,4935
235,2022/7/15 17:20,82,372,-290,2912
235,2022/7/15 17:30,65,529,-464,3061
235,2022/7/15 17:40,67,498,-431,5388
235,2022/7/15 17:50,66,477,-411,2300
235,2022/7/15 18:00,50,572,-522,2309
235,2022/7/15 18:10,55,431,-376,5534
235,2022/7/15 18:20,48,1214,-1166,1718
235,2022/7/15 18:30,43,429,-386,748
235,2022/7/15 18:40,43,645,-602,166
235,2022/7/15 18:50,39,576,-537,-681
235,2022/7/15 19:00,38,432,-394,-1018
235,2022/7/15 19:10,32,503,-471,-1184
235,2022/7/15 19:20,33,379,-346,-750
235,2022/7/15 19:30,28,218,-190,-676
235,2022/7/15 19:40,32,217,-185,-510
235,2022/7/15 19:50,27,196,-169,-647
235,2022/7/15 20:00,29,159,-130,-381
235,2022/7/15 20:10,36,180,-144,-197
235,2022/7/15 20:20,32,132,-100,-315
235,2022/7/15 20:30,35,117,-82,-367
235,2022/7/15 20:40,28,104,-76,-441
235,2022/7/15 20:50,28,128,-100,-501
235,2022/7/15 21:00,26,192,-166,-422
235,2022/7/15 21:10,29,114,-85,-365
235,2022/7/15 21:20,31,111,-80,-525
235,2022/7/15 21:30,29,109,-80,-568
235,2022/7/15 21:40,26,119,-93,-590
235,2022/7/15 21:50,26,110,-84,-726
235,2022/7/15 22:00,22,109,-87,-380
235,2022/7/15 22:10,18,120,-102,-342
235,2022/7/15 22:20,18,123,-105,-860
235,2022/7/15 22:30,13,123,-110,-1135
235,2022/7/15 22:40,5,122,-117,-1094
235,2022/7/15 22:50,2,95,-93,-911
255,2022/7/15 5:00,0,1,-1,-18
255,2022/7/15 5:10,1,1,0,-6
255,2022/7/15 5:20,10,1,9,60
255,2022/7/15 5:30,24,1,23,181
255,2022/7/15 5:40,25,1,24,274
255,2022/7/15 5:50,25,1,24,278
255,2022/7/15 6:00,40,8,32,116
255,2022/7/15 6:10,55,19,36,87
255,2022/7/15 6:20,71,67,4,34
255,2022/7/15 6:30,155,65,90,281
255,2022/7/15 6:40,225,108,117,550
255,2022/7/15 6:50,281,126,155,888
255,2022/7/15 7:00,361,118,243,1227
255,2022/7/15 7:10,598,127,471,1941
255,2022/7/15 7:20,724,104,620,3078
255,2022/7/15 7:30,825,108,717,3363
255,2022/7/15 7:40,1229,106,1123,5439
255,2022/7/15 7:50,1558,120,1438,6517
255,2022/7/15 8:00,1561,113,1448,6285
255,2022/7/15 8:10,1366,119,1247,2661
255,2022/7/15 8:20,1179,133,1046,74
255,2022/7/15 8:30,859,128,731,-4783
255,2022/7/15 8:40,684,109,575,-15171
255,2022/7/15 8:50,476,126,350,-11008
255,2022/7/15 9:00,354,103,251,-6852
255,2022/7/15 9:10,278,106,172,-5674
255,2022/7/15 9:20,232,111,121,-5317
255,2022/7/15 9:30,183,75,108,-3307
255,2022/7/15 9:40,144,98,46,-1984
255,2022/7/15 9:50,97,83,14,-1999
255,2022/7/15 10:00,64,75,-11,-1651
255,2022/7/15 10:10,63,84,-21,-1120
255,2022/7/15 10:20,42,69,-27,-1092
255,2022/7/15 10:30,44,82,-38,-862
255,2022/7/15 10:40,37,66,-29,-833
255,2022/7/15 10:50,41,85,-44,-866
255,2022/7/15 11:00,38,77,-39,-756
255,2022/7/15 11:10,37,84,-47,-624
255,2022/7/15 11:20,37,78,-41,-589
255,2022/7/15 11:30,42,69,-27,-607
255,2022/7/15 11:40,43,81,-38,-653
255,2022/7/15 11:50,40,76,-36,-605
255,2022/7/15 12:00,44,83,-39,-531
255,2022/7/15 12:10,45,78,-33,-535
255,2022/7/15 12:20,44,64,-20,-599
255,2022/7/15 12:30,48,80,-32,-703
255,2022/7/15 12:40,44,84,-40,-829
255,2022/7/15 12:50,40,80,-40,-919
255,2022/7/15 13:00,44,76,-32,-896
255,2022/7/15 13:10,42,75,-33,-622
255,2022/7/15 13:20,41,69,-28,-782
255,2022/7/15 13:30,43,77,-34,-782
255,2022/7/15 13:40,40,83,-43,-806
255,2022/7/15 13:50,36,99,-63,-740
255,2022/7/15 14:00,39,90,-51,-649
255,2022/7/15 14:10,26,77,-51,-619
255,2022/7/15 14:20,36,96,-60,-595
255,2022/7/15 14:30,30,101,-71,-642
255,2022/7/15 14:40,33,96,-63,-563
255,2022/7/15 14:50,39,108,-69,-460
255,2022/7/15 15:00,33,84,-51,-311
255,2022/7/15 15:10,35,93,-58,-193
255,2022/7/15 15:20,40,103,-63,-236
255,2022/7/15 15:30,35,109,-74,-204
255,2022/7/15 15:40,35,105,-70,-246
255,2022/7/15 15:50,38,104,-66,-242
255,2022/7/15 16:00,42,125,-83,-98
255,2022/7/15 16:10,41,109,-68,36
255,2022/7/15 16:20,45,121,-76,9
255,2022/7/15 16:30,71,106,-35,365
255,2022/7/15 16:40,61,111,-50,733
255,2022/7/15 16:50,70,152,-82,520
255,2022/7/15 17:00,138,142,-4,3098
255,2022/7/15 17:10,190,109,81,5016
255,2022/7/15 17:20,233,264,-31,2881
255,2022/7/15 17:30,175,333,-158,2903
255,2022/7/15 17:40,233,330,-97,5291
255,2022/7/15 17:50,241,345,-104,2196
255,2022/7/15 18:00,126,328,-202,2107
255,2022/7/15 18:10,188,502,-314,5220
255,2022/7/15 18:20,175,425,-250,1468
255,2022/7/15 18:30,92,432,-340,408
255,2022/7/15 18:40,57,432,-375,-209
255,2022/7/15 18:50,50,430,-380,-1061
255,2022/7/15 19:00,36,327,-291,-1309
255,2022/7/15 19:10,35,322,-287,-1471
255,2022/7/15 19:20,30,300,-270,-1020
255,2022/7/15 19:30,28,336,-308,-984
255,2022/7/15 19:40,28,158,-130,-640
255,2022/7/15 19:50,30,110,-80,-727
255,2022/7/15 20:00,27,106,-79,-460
255,2022/7/15 20:10,28,104,-76,-273
255,2022/7/15 20:20,27,121,-94,-409
255,2022/7/15 20:30,30,110,-80,-447
255,2022/7/15 20:40,26,111,-85,-526
255,2022/7/15 20:50,28,124,-96,-597
255,2022/7/15 21:00,27,107,-80,-502
255,2022/7/15 21:10,26,120,-94,-459
255,2022/7/15 21:20,27,113,-86,-611
255,2022/7/15 21:30,27,111,-84,-652
255,2022/7/15 21:40,21,123,-102,-692
255,2022/7/15 21:50,19,125,-106,-832
255,2022/7/15 22:00,18,124,-106,-486
255,2022/7/15 22:10,16,107,-91,-433
255,2022/7/15 22:20,13,112,-99,-959
255,2022/7/15 22:30,10,104,-94,-1229
255,2022/7/15 22:40,4,108,-104,-1198
255,2022/7/15 22:50,2,80,-78,-989
234,2022/7/15 5:00,0,1,-1,-19
234,2022/7/15 5:10,0,1,-1,-7
234,2022/7/15 5:20,3,1,2,62
234,2022/7/15 5:30,9,1,8,189
234,2022/7/15 5:40,10,1,9,283
234,2022/7/15 5:50,12,1,11,289
234,2022/7/15 6:00,21,1,20,136
234,2022/7/15 6:10,20,1,19,106
234,2022/7/15 6:20,25,23,2,36
234,2022/7/15 6:30,26,14,12,293
234,2022/7/15 6:40,32,16,16,566
234,2022/7/15 6:50,34,23,11,899
234,2022/7/15 7:00,40,23,17,1244
234,2022/7/15 7:10,57,33,24,1965
234,2022/7/15 7:20,59,66,-7,3071
234,2022/7/15 7:30,85,46,39,3402
234,2022/7/15 7:40,176,62,114,5553
234,2022/7/15 7:50,221,62,159,6676
234,2022/7/15 8:00,224,76,148,6433
234,2022/7/15 8:10,216,107,109,2770
234,2022/7/15 8:20,179,99,80,154
234,2022/7/15 8:30,106,97,9,-4774
234,2022/7/15 8:40,70,75,-5,-15176
234,2022/7/15 8:50,51,76,-25,-11033
234,2022/7/15 9:00,44,70,-26,-6878
234,2022/7/15 9:10,36,67,-31,-5705
234,2022/7/15 9:20,28,60,-32,-5349
234,2022/7/15 9:30,26,63,-37,-3344
234,2022/7/15 9:40,28,51,-23,-2007
234,2022/7/15 9:50,22,51,-29,-2028
234,2022/7/15 10:00,20,47,-27,-1678
234,2022/7/15 10:10,21,42,-21,-1141
234,2022/7/15 10:20,16,38,-22,-1114
234,2022/7/15 10:30,15,43,-28,-890
234,2022/7/15 10:40,16,35,-19,-852
234,2022/7/15 10:50,13,38,-25,-891
234,2022/7/15 11:00,15,32,-17,-773
234,2022/7/15 11:10,16,33,-17,-641
234,2022/7/15 11:20,16,38,-22,-611
234,2022/7/15 11:30,17,35,-18,-625
234,2022/7/15 11:40,15,38,-23,-676
234,2022/7/15 11:50,16,38,-22,-627
234,2022/7/15 12:00,18,31,-13,-544
234,2022/7/15 12:10,18,38,-20,-555
234,2022/7/15 12:20,15,47,-32,-631
234,2022/7/15 12:30,17,38,-21,-724
234,2022/7/15 12:40,16,45,-29,-858
234,2022/7/15 12:50,16,40,-24,-943
234,2022/7/15 13:00,15,35,-20,-916
234,2022/7/15 13:10,19,47,-28,-650
234,2022/7/15 13:20,16,43,-27,-809
234,2022/7/15 13:30,15,45,-30,-812
234,2022/7/15 13:40,14,47,-33,-839
234,2022/7/15 13:50,16,25,-9,-749
234,2022/7/15 14:00,17,41,-24,-673
234,2022/7/15 14:10,16,47,-31,-650
234,2022/7/15 14:20,15,47,-32,-627
234,2022/7/15 14:30,16,41,-25,-667
234,2022/7/15 14:40,15,31,-16,-579
234,2022/7/15 14:50,17,38,-21,-481
234,2022/7/15 15:00,16,43,-27,-338
234,2022/7/15 15:10,19,45,-26,-219
234,2022/7/15 15:20,17,45,-28,-264
234,2022/7/15 15:30,15,46,-31,-235
234,2022/7/15 15:40,16,37,-21,-267
234,2022/7/15 15:50,17,46,-29,-271
234,2022/7/15 16:00,18,50,-32,-130
234,2022/7/15 16:10,18,51,-33,3
234,2022/7/15 16:20,21,50,-29,-20
234,2022/7/15 16:30,24,55,-31,334
234,2022/7/15 16:40,29,61,-32,701
234,2022/7/15 16:50,25,48,-23,497
234,2022/7/15 17:00,37,64,-27,3071
234,2022/7/15 17:10,60,71,-11,5005
234,2022/7/15 17:20,32,72,-40,2841
234,2022/7/15 17:30,39,70,-31,2872
234,2022/7/15 17:40,46,79,-33,5258
234,2022/7/15 17:50,35,114,-79,2117
234,2022/7/15 18:00,30,95,-65,2042
234,2022/7/15 18:10,31,83,-52,5168
234,2022/7/15 18:20,29,93,-64,1404
234,2022/7/15 18:30,28,110,-82,326
234,2022/7/15 18:40,23,125,-102,-311
234,2022/7/15 18:50,20,89,-69,-1130
234,2022/7/15 19:00,19,97,-78,-1387
234,2022/7/15 19:10,15,106,-91,-1562
234,2022/7/15 19:20,15,95,-80,-1100
234,2022/7/15 19:30,15,94,-79,-1063
234,2022/7/15 19:40,14,79,-65,-705
234,2022/7/15 19:50,15,77,-62,-789
234,2022/7/15 20:00,15,73,-58,-518
234,2022/7/15 20:10,13,74,-61,-334
234,2022/7/15 20:20,10,59,-49,-458
234,2022/7/15 20:30,10,62,-52,-499
234,2022/7/15 20:40,8,62,-54,-580
234,2022/7/15 20:50,10,72,-62,-659
234,2022/7/15 21:00,10,64,-54,-556
234,2022/7/15 21:10,13,42,-29,-488
234,2022/7/15 21:20,10,67,-57,-668
234,2022/7/15 21:30,11,59,-48,-700
234,2022/7/15 21:40,7,63,-56,-748
234,2022/7/15 21:50,9,68,-59,-891
234,2022/7/15 22:00,5,57,-52,-538
234,2022/7/15 22:10,5,67,-62,-495
234,2022/7/15 22:20,10,52,-42,-1001
234,2022/7/15 22:30,2,58,-56,-1285
234,2022/7/15 22:40,2,54,-52,-1250
234,2022/7/15 22:50,1,40,-39,-1028
233,2022/7/15 5:00,0,1,-1,-20
233,2022/7/15 5:10,0,1,-1,-8
233,2022/7/15 5:20,15,1,14,76
233,2022/7/15 5:30,27,1,26,215
233,2022/7/15 5:40,32,1,31,314
233,2022/7/15 5:50,36,8,28,317
233,2022/7/15 6:00,54,5,49,185
233,2022/7/15 6:10,59,11,48,154
233,2022/7/15 6:20,87,38,49,85
233,2022/7/15 6:30,123,38,85,378
233,2022/7/15 6:40,222,49,173,739
233,2022/7/15 6:50,224,61,163,1062
233,2022/7/15 7:00,278,71,207,1451
233,2022/7/15 7:10,282,76,206,2171
233,2022/7/15 7:20,352,76,276,3347
233,2022/7/15 7:30,597,81,516,3918
233,2022/7/15 7:40,681,108,573,6126
233,2022/7/15 7:50,744,100,644,7320
233,2022/7/15 8:00,739,88,651,7084
233,2022/7/15 8:10,693,100,593,3363
233,2022/7/15 8:20,670,93,577,731
233,2022/7/15 8:30,598,93,505,-4269
233,2022/7/15 8:40,347,112,235,-14941
233,2022/7/15 8:50,278,90,188,-10845
233,2022/7/15 9:00,205,94,111,-6767
233,2022/7/15 9:10,187,93,94,-5611
233,2022/7/15 9:20,177,97,80,-5269
233,2022/7/15 9:30,82,74,8,-3336
233,2022/7/15 9:40,70,87,-17,-2024
233,2022/7/15 9:50,59,75,-16,-2044
233,2022/7/15 10:00,46,79,-33,-1711
233,2022/7/15 10:10,44,83,-39,-1180
233,2022/7/15 10:20,41,66,-25,-1139
233,2022/7/15 10:30,36,64,-28,-918
233,2022/7/15 10:40,33,68,-35,-887
233,2022/7/15 10:50,30,60,-30,-921
233,2022/7/15 11:00,30,74,-44,-817
233,2022/7/15 11:10,32,67,-35,-676
233,2022/7/15 11:20,29,67,-38,-649
233,2022/7/15 11:30,31,56,-25,-650
233,2022/7/15 11:40,31,66,-35,-711
233,2022/7/15 11:50,35,70,-35,-662
233,2022/7/15 12:00,38,67,-29,-573
233,2022/7/15 12:10,39,72,-33,-588
233,2022/7/15 12:20,39,67,-28,-659
233,2022/7/15 12:30,38,52,-14,-738
233,2022/7/15 12:40,39,76,-37,-895
233,2022/7/15 12:50,32,82,-50,-993
233,2022/7/15 13:00,35,68,-33,-949
233,2022/7/15 13:10,31,78,-47,-697
233,2022/7/15 13:20,32,66,-34,-843
233,2022/7/15 13:30,32,66,-34,-846
233,2022/7/15 13:40,30,71,-41,-880
233,2022/7/15 13:50,28,82,-54,-803
233,2022/7/15 14:00,33,84,-51,-724
233,2022/7/15 14:10,26,73,-47,-697
233,2022/7/15 14:20,28,65,-37,-664
233,2022/7/15 14:30,28,77,-49,-716
233,2022/7/15 14:40,27,75,-48,-627
233,2022/7/15 14:50,27,93,-66,-547
233,2022/7/15 15:00,29,97,-68,-406
233,2022/7/15 15:10,24,74,-50,-269
233,2022/7/15 15:20,28,93,-65,-329
233,2022/7/15 15:30,25,106,-81,-316
233,2022/7/15 15:40,25,93,-68,-335
233,2022/7/15 15:50,26,112,-86,-357
233,2022/7/15 16:00,28,102,-74,-204
233,2022/7/15 16:10,34,105,-71,-68
233,2022/7/15 16:20,29,90,-61,-81
233,2022/7/15 16:30,33,107,-74,260
233,2022/7/15 16:40,40,124,-84,617
233,2022/7/15 16:50,37,111,-74,423
233,2022/7/15 17:00,46,107,-61,3010
233,2022/7/15 17:10,45,108,-63,4942
233,2022/7/15 17:20,45,120,-75,2766
233,2022/7/15 17:30,46,196,-150,2722
233,2022/7/15 17:40,43,222,-179,5079
233,2022/7/15 17:50,37,178,-141,1976
233,2022/7/15 18:00,43,224,-181,1861
233,2022/7/15 18:10,44,232,-188,4980
233,2022/7/15 18:20,38,325,-287,1117
233,2022/7/15 18:30,38,378,-340,-14
233,2022/7/15 18:40,34,285,-251,-562
233,2022/7/15 18:50,35,348,-313,-1443
233,2022/7/15 19:00,33,256,-223,-1610
233,2022/7/15 19:10,30,224,-194,-1756
233,2022/7/15 19:20,27,180,-153,-1253
233,2022/7/15 19:30,29,184,-155,-1218
233,2022/7/15 19:40,25,107,-82,-787
233,2022/7/15 19:50,27,128,-101,-890
233,2022/7/15 20:00,22,126,-104,-622
233,2022/7/15 20:10,28,113,-85,-419
233,2022/7/15 20:20,22,106,-84,-542
233,2022/7/15 20:30,23,112,-89,-588
233,2022/7/15 20:40,23,120,-97,-677
233,2022/7/15 20:50,23,112,-89,-748
233,2022/7/15 21:00,23,111,-88,-644
233,2022/7/15 21:10,21,110,-89,-577
233,2022/7/15 21:20,20,106,-86,-754
233,2022/7/15 21:30,16,88,-72,-772
233,2022/7/15 21:40,18,98,-80,-828
233,2022/7/15 21:50,13,112,-99,-990
233,2022/7/15 22:00,15,107,-92,-630
233,2022/7/15 22:10,11,103,-92,-587
233,2022/7/15 22:20,10,103,-93,-1094
233,2022/7/15 22:30,5,104,-99,-1384
233,2022/7/15 22:40,5,106,-101,-1351
233,2022/7/15 22:50,2,94,-92,-1120
252,2022/7/15 5:00,0,1,-1,-21
252,2022/7/15 5:10,2,1,1,-7
252,2022/7/15 5:20,13,1,12,88
252,2022/7/15 5:30,16,1,15,230
252,2022/7/15 5:40,20,1,19,333
252,2022/7/15 5:50,28,1,27,344
252,2022/7/15 6:00,24,2,22,207
252,2022/7/15 6:10,33,1,32,186
252,2022/7/15 6:20,47,19,28,113
252,2022/7/15 6:30,60,8,52,430
252,2022/7/15 6:40,68,38,30,769
252,2022/7/15 6:50,87,34,53,1115
252,2022/7/15 7:00,109,40,69,1520
252,2022/7/15 7:10,168,58,110,2281
252,2022/7/15 7:20,170,47,123,3470
252,2022/7/15 7:30,214,60,154,4072
252,2022/7/15 7:40,268,75,193,6319
252,2022/7/15 7:50,284,79,205,7525
252,2022/7/15 8:00,282,92,190,7274
252,2022/7/15 8:10,236,118,118,3481
252,2022/7/15 8:20,210,107,103,834
252,2022/7/15 8:30,184,87,97,-4172
252,2022/7/15 8:40,101,103,-2,-14943
252,2022/7/15 8:50,76,93,-17,-10862
252,2022/7/15 9:00,60,85,-25,-6792
252,2022/7/15 9:10,47,74,-27,-5638
252,2022/7/15 9:20,38,61,-23,-5292
252,2022/7/15 9:30,34,73,-39,-3375
252,2022/7/15 9:40,31,62,-31,-2055
252,2022/7/15 9:50,29,47,-18,-2062
252,2022/7/15 10:00,28,63,-35,-1746
252,2022/7/15 10:10,27,51,-24,-1204
252,2022/7/15 10:20,24,50,-26,-1165
252,2022/7/15 10:30,23,48,-25,-943
252,2022/7/15 10:40,22,32,-10,-897
252,2022/7/15 10:50,27,51,-24,-945
252,2022/7/15 11:00,21,49,-28,-845
252,2022/7/15 11:10,26,38,-12,-688
252,2022/7/15 11:20,25,49,-24,-673
252,2022/7/15 11:30,20,51,-31,-681
252,2022/7/15 11:40,23,48,-25,-736
252,2022/7/15 11:50,22,45,-23,-685
252,2022/7/15 12:00,25,38,-13,-586
252,2022/7/15 12:10,23,50,-27,-615
252,2022/7/15 12:20,26,55,-29,-688
252,2022/7/15 12:30,26,55,-29,-767
252,2022/7/15 12:40,21,55,-34,-929
252,2022/7/15 12:50,23,55,-32,-1025
252,2022/7/15 13:00,23,40,-17,-966
252,2022/7/15 13:10,22,61,-39,-736
252,2022/7/15 13:20,21,55,-34,-877
252,2022/7/15 13:30,20,56,-36,-882
252,2022/7/15 13:40,18,51,-33,-913
252,2022/7/15 13:50,22,40,-18,-821
252,2022/7/15 14:00,22,51,-29,-753
252,2022/7/15 14:10,21,51,-30,-727
252,2022/7/15 14:20,20,59,-39,-703
252,2022/7/15 14:30,19,53,-34,-750
252,2022/7/15 14:40,21,51,-30,-657
252,2022/7/15 14:50,18,42,-24,-571
252,2022/7/15 15:00,23,54,-31,-437
252,2022/7/15 15:10,20,58,-38,-307
252,2022/7/15 15:20,22,61,-39,-368
252,2022/7/15 15:30,21,64,-43,-359
252,2022/7/15 15:40,23,51,-28,-363
252,2022/7/15 15:50,22,69,-47,-404
252,2022/7/15 16:00,22,68,-46,-250
252,2022/7/15 16:10,23,70,-47,-115
252,2022/7/15 16:20,24,70,-46,-127
252,2022/7/15 16:30,25,85,-60,200
252,2022/7/15 16:40,25,75,-50,567
252,2022/7/15 16:50,36,64,-28,395
252,2022/7/15 17:00,37,77,-40,2970
252,2022/7/15 17:10,43,93,-50,4892
252,2022/7/15 17:20,30,96,-66,2700
252,2022/7/15 17:30,33,114,-81,2641
252,2022/7/15 17:40,42,113,-71,5008
252,2022/7/15 17:50,43,113,-70,1906
252,2022/7/15 18:00,47,105,-58,1803
252,2022/7/15 18:10,36,108,-72,4908
252,2022/7/15 18:20,33,110,-77,1040
252,2022/7/15 18:30,29,133,-104,-118
252,2022/7/15 18:40,26,122,-96,-658
252,2022/7/15 18:50,25,122,-97,-1540
252,2022/7/15 19:00,22,127,-105,-1715
252,2022/7/15 19:10,20,106,-86,-1842
252,2022/7/15 19:20,20,107,-87,-1340
252,2022/7/15 19:30,13,102,-89,-1307
252,2022/7/15 19:40,13,83,-70,-857
252,2022/7/15 19:50,13,81,-68,-958
252,2022/7/15 20:00,14,80,-66,-688
252,2022/7/15 20:10,12,79,-67,-486
252,2022/7/15 20:20,12,81,-69,-611
252,2022/7/15 20:30,13,69,-56,-644
252,2022/7/15 20:40,16,64,-48,-725
252,2022/7/15 20:50,13,71,-58,-806
252,2022/7/15 21:00,12,75,-63,-707
252,2022/7/15 21:10,12,71,-59,-636
252,2022/7/15 21:20,9,76,-67,-821
252,2022/7/15 21:30,10,58,-48,-820
252,2022/7/15 21:40,6,73,-67,-895
252,2022/7/15 21:50,7,74,-67,-1057
252,2022/7/15 22:00,5,68,-63,-693
252,2022/7/15 22:10,4,62,-58,-645
252,2022/7/15 22:20,2,68,-66,-1160
252,2022/7/15 22:30,2,63,-61,-1445
252,2022/7/15 22:40,0,64,-64,-1415
252,2022/7/15 22:50,0,59,-59,-1179
249,2022/7/15 5:00,0,1,-1,-22
249,2022/7/15 5:10,1,1,0,-7
249,2022/7/15 5:20,6,1,5,93
249,2022/7/15 5:30,5,1,4,234
249,2022/7/15 5:40,17,1,16,349
249,2022/7/15 5:50,14,1,13,357
249,2022/7/15 6:00,25,1,24,231
249,2022/7/15 6:10,31,1,30,216
249,2022/7/15 6:20,34,14,20,133
249,2022/7/15 6:30,34,8,26,456
249,2022/7/15 6:40,45,16,29,798
249,2022/7/15 6:50,53,22,31,1146
249,2022/7/15 7:00,53,23,30,1550
249,2022/7/15 7:10,71,49,22,2303
249,2022/7/15 7:20,149,62,87,3557
249,2022/7/15 7:30,179,72,107,4179
249,2022/7/15 7:40,238,71,167,6486
249,2022/7/15 7:50,282,83,199,7724
249,2022/7/15 8:00,232,83,149,7423
249,2022/7/15 8:10,235,77,158,3639
249,2022/7/15 8:20,212,77,135,969
249,2022/7/15 8:30,155,71,84,-4088
249,2022/7/15 8:40,73,48,25,-14918
249,2022/7/15 8:50,54,53,1,-10861
249,2022/7/15 9:00,45,50,-5,-6797
249,2022/7/15 9:10,35,42,-7,-5645
249,2022/7/15 9:20,36,57,-21,-5313
249,2022/7/15 9:30,28,50,-22,-3397
249,2022/7/15 9:40,27,58,-31,-2086
249,2022/7/15 9:50,26,54,-28,-2090
249,2022/7/15 10:00,22,47,-25,-1771
249,2022/7/15 10:10,22,35,-13,-1217
249,2022/7/15 10:20,21,38,-17,-1182
249,2022/7/15 10:30,21,24,-3,-946
249,2022/7/15 10:40,19,32,-13,-910
249,2022/7/15 10:50,20,31,-11,-956
249,2022/7/15 11:00,21,40,-19,-864
249,2022/7/15 11:10,22,39,-17,-705
249,2022/7/15 11:20,21,35,-14,-687
249,2022/7/15 11:30,22,37,-15,-696
249,2022/7/15 11:40,20,34,-14,-750
249,2022/7/15 11:50,22,38,-16,-701
249,2022/7/15 12:00,21,36,-15,-601
249,2022/7/15 12:10,22,38,-16,-631
249,2022/7/15 12:20,25,42,-17,-705
249,2022/7/15 12:30,25,38,-13,-780
249,2022/7/15 12:40,23,46,-23,-952
249,2022/7/15 12:50,21,47,-26,-1051
249,2022/7/15 13:00,21,53,-32,-998
249,2022/7/15 13:10,22,51,-29,-765
249,2022/7/15 13:20,23,39,-16,-893
249,2022/7/15 13:30,22,23,-1,-883
249,2022/7/15 13:40,21,40,-19,-932
249,2022/7/15 13:50,20,41,-21,-842
249,2022/7/15 14:00,20,38,-18,-771
249,2022/7/15 14:10,22,38,-16,-743
249,2022/7/15 14:20,20,32,-12,-715
249,2022/7/15 14:30,17,38,-21,-771
249,2022/7/15 14:40,21,41,-20,-677
249,2022/7/15 14:50,23,41,-18,-589
249,2022/7/15 15:00,25,49,-24,-461
249,2022/7/15 15:10,22,38,-16,-323
249,2022/7/15 15:20,20,38,-18,-386
249,2022/7/15 15:30,18,52,-34,-393
249,2022/7/15 15:40,22,48,-26,-389
249,2022/7/15 15:50,23,50,-27,-431
249,2022/7/15 16:00,24,54,-30,-280
249,2022/7/15 16:10,25,53,-28,-143
249,2022/7/15 16:20,26,52,-26,-153
249,2022/7/15 16:30,31,45,-14,186
249,2022/7/15 16:40,30,62,-32,535
249,2022/7/15 16:50,27,71,-44,351
249,2022/7/15 17:00,23,72,-49,2921
249,2022/7/15 17:10,23,69,-46,4846
249,2022/7/15 17:20,16,77,-61,2639
249,2022/7/15 17:30,24,98,-74,2567
249,2022/7/15 17:40,20,99,-79,4929
249,2022/7/15 17:50,18,98,-80,1826
249,2022/7/15 18:00,17,107,-90,1713
249,2022/7/15 18:10,17,126,-109,4799
249,2022/7/15 18:20,15,125,-110,930
249,2022/7/15 18:30,18,84,-66,-184
249,2022/7/15 18:40,15,122,-107,-765
249,2022/7/15 18:50,12,125,-113,-1653
249,2022/7/15 19:00,12,127,-115,-1830
249,2022/7/15 19:10,11,106,-95,-1937
249,2022/7/15 19:20,11,107,-96,-1436
249,2022/7/15 19:30,9,106,-97,-1404
249,2022/7/15 19:40,9,88,-79,-936
249,2022/7/15 19:50,10,75,-65,-1023
249,2022/7/15 20:00,12,85,-73,-761
249,2022/7/15 20:10,13,79,-66,-552
249,2022/7/15 20:20,11,62,-51,-662
249,2022/7/15 20:30,9,82,-73,-717
249,2022/7/15 20:40,12,74,-62,-787
249,2022/7/15 20:50,11,70,-59,-865
249,2022/7/15 21:00,9,66,-57,-764
249,2022/7/15 21:10,6,70,-64,-700
249,2022/7/15 21:20,5,75,-70,-891
249,2022/7/15 21:30,4,71,-67,-887
249,2022/7/15 21:40,5,69,-64,-959
249,2022/7/15 21:50,5,60,-55,-1112
249,2022/7/15 22:00,1,63,-62,-755
249,2022/7/15 22:10,1,68,-67,-712
249,2022/7/15 22:20,2,61,-59,-1219
249,2022/7/15 22:30,1,52,-51,-1496
249,2022/7/15 22:40,0,59,-59,-1474
249,2022/7/15 22:50,0,53,-53,-1232
251,2022/7/15 5:00,0,1,-1,-23
251,2022/7/15 5:10,1,1,0,-7
251,2022/7/15 5:20,3,1,2,95
251,2022/7/15 5:30,5,1,4,238
251,2022/7/15 5:40,6,1,5,354
251,2022/7/15 5:50,7,1,6,363
251,2022/7/15 6:00,9,1,8,239
251,2022/7/15 6:10,18,1,17,233
251,2022/7/15 6:20,19,6,13,146
251,2022/7/15 6:30,26,12,14,470
251,2022/7/15 6:40,32,11,21,819
251,2022/7/15 6:50,32,11,21,1167
251,2022/7/15 7:00,29,13,16,1566
251,2022/7/15 7:10,54,21,33,2336
251,2022/7/15 7:20,43,11,32,3589
251,2022/7/15 7:30,68,8,60,4239
251,2022/7/15 7:40,79,23,56,6542
251,2022/7/15 7:50,59,23,36,7760
251,2022/7/15 8:00,68,30,38,7461
251,2022/7/15 8:10,64,33,31,3670
251,2022/7/15 8:20,52,30,22,991
251,2022/7/15 8:30,38,23,15,-4073
251,2022/7/15 8:40,33,21,12,-14906
251,2022/7/15 8:50,28,23,5,-10856
251,2022/7/15 9:00,24,21,3,-6794
251,2022/7/15 9:10,17,23,-6,-5651
251,2022/7/15 9:20,15,22,-7,-5320
251,2022/7/15 9:30,13,22,-9,-3406
251,2022/7/15 9:40,10,16,-6,-2092
251,2022/7/15 9:50,10,20,-10,-2100
251,2022/7/15 10:00,8,24,-16,-1787
251,2022/7/15 10:10,10,22,-12,-1229
251,2022/7/15 10:20,8,19,-11,-1193
251,2022/7/15 10:30,7,16,-9,-955
251,2022/7/15 10:40,5,23,-18,-928
251,2022/7/15 10:50,7,19,-12,-968
251,2022/7/15 11:00,8,18,-10,-874
251,2022/7/15 11:10,8,19,-11,-716
251,2022/7/15 11:20,9,21,-12,-699
251,2022/7/15 11:30,9,12,-3,-699
251,2022/7/15 11:40,9,14,-5,-755
251,2022/7/15 11:50,8,18,-10,-711
251,2022/7/15 12:00,7,19,-12,-613
251,2022/7/15 12:10,8,17,-9,-640
251,2022/7/15 12:20,8,15,-7,-712
251,2022/7/15 12:30,9,17,-8,-788
251,2022/7/15 12:40,9,14,-5,-957
251,2022/7/15 12:50,10,19,-9,-1060
251,2022/7/15 13:00,8,19,-11,-1009
251,2022/7/15 13:10,5,12,-7,-772
251,2022/7/15 13:20,6,17,-11,-904
251,2022/7/15 13:30,5,21,-16,-899
251,2022/7/15 13:40,8,14,-6,-938
251,2022/7/15 13:50,5,21,-16,-858
251,2022/7/15 14:00,7,21,-14,-785
251,2022/7/15 14:10,4,19,-15,-758
251,2022/7/15 14:20,5,21,-16,-731
251,2022/7/15 14:30,6,13,-7,-778
251,2022/7/15 14:40,6,23,-17,-694
251,2022/7/15 14:50,6,19,-13,-602
251,2022/7/15 15:00,8,23,-15,-476
251,2022/7/15 15:10,5,23,-18,-341
251,2022/7/15 15:20,6,23,-17,-403
251,2022/7/15 15:30,7,21,-14,-407
251,2022/7/15 15:40,7,23,-16,-405
251,2022/7/15 15:50,9,25,-16,-447
251,2022/7/15 16:00,7,21,-14,-294
251,2022/7/15 16:10,9,23,-14,-157
251,2022/7/15 16:20,6,25,-19,-172
251,2022/7/15 16:30,8,32,-24,162
251,2022/7/15 16:40,8,23,-15,520
251,2022/7/15 16:50,8,39,-31,320
251,2022/7/15 17:00,11,37,-26,2895
251,2022/7/15 17:10,7,38,-31,4815
251,2022/7/15 17:20,7,45,-38,2601
251,2022/7/15 17:30,5,46,-41,2526
251,2022/7/15 17:40,7,50,-43,4886
251,2022/7/15 17:50,8,50,-42,1784
251,2022/7/15 18:00,6,63,-57,1656
251,2022/7/15 18:10,6,65,-59,4740
251,2022/7/15 18:20,6,63,-57,873
251,2022/7/15 18:30,4,70,-66,-250
251,2022/7/15 18:40,6,75,-69,-834
251,2022/7/15 18:50,4,59,-55,-1708
251,2022/7/15 19:00,3,80,-77,-1907
251,2022/7/15 19:10,4,74,-70,-2007
251,2022/7/15 19:20,3,62,-59,-1495
251,2022/7/15 19:30,2,53,-51,-1455
251,2022/7/15 19:40,3,54,-51,-987
251,2022/7/15 19:50,2,40,-38,-1061
251,2022/7/15 20:00,2,40,-38,-799
251,2022/7/15 20:10,2,34,-32,-584
251,2022/7/15 20:20,1,35,-34,-696
251,2022/7/15 20:30,1,40,-39,-756
251,2022/7/15 20:40,1,37,-36,-823
251,2022/7/15 20:50,2,35,-33,-898
251,2022/7/15 21:00,1,31,-30,-794
251,2022/7/15 21:10,3,27,-24,-724
251,2022/7/15 21:20,2,25,-23,-914
251,2022/7/15 21:30,1,35,-34,-921
251,2022/7/15 21:40,1,33,-32,-991
251,2022/7/15 21:50,1,32,-31,-1143
251,2022/7/15 22:00,1,39,-38,-793
251,2022/7/15 22:10,0,33,-33,-745
251,2022/7/15 22:20,0,26,-26,-1245
251,2022/7/15 22:30,0,35,-35,-1531
251,2022/7/15 22:40,0,35,-35,-1509
251,2022/7/15 22:50,0,34,-34,-1266
238,2022/7/15 5:00,0,1,-1,-24
238,2022/7/15 5:10,2,1,1,-6
238,2022/7/15 5:20,16,1,15,110
238,2022/7/15 5:30,31,1,30,268
238,2022/7/15 5:40,32,5,27,381
238,2022/7/15 5:50,38,5,33,396
238,2022/7/15 6:00,83,1,82,321
238,2022/7/15 6:10,71,5,66,299
238,2022/7/15 6:20,181,5,176,322
238,2022/7/15 6:30,237,67,170,640
238,2022/7/15 6:40,302,37,265,1084
238,2022/7/15 6:50,275,72,203,1370
238,2022/7/15 7:00,601,66,535,2101
238,2022/7/15 7:10,700,79,621,2957
238,2022/7/15 7:20,850,93,757,4346
238,2022/7/15 7:30,1226,105,1121,5360
238,2022/7/15 7:40,1371,109,1262,7804
238,2022/7/15 7:50,1364,123,1241,9001
238,2022/7/15 8:00,1363,91,1272,8733
238,2022/7/15 8:10,1169,108,1061,4731
238,2022/7/15 8:20,842,123,719,1710
238,2022/7/15 8:30,719,159,560,-3513
238,2022/7/15 8:40,469,110,359,-14547
238,2022/7/15 8:50,361,103,258,-10598
238,2022/7/15 9:00,274,120,154,-6640
238,2022/7/15 9:10,217,118,99,-5552
238,2022/7/15 9:20,182,110,72,-5248
238,2022/7/15 9:30,116,174,-58,-3464
238,2022/7/15 9:40,85,154,-69,-2161
238,2022/7/15 9:50,75,113,-38,-2138
238,2022/7/15 10:00,62,179,-117,-1904
238,2022/7/15 10:10,67,128,-61,-1290
238,2022/7/15 10:20,62,128,-66,-1259
238,2022/7/15 10:30,59,144,-85,-1040
238,2022/7/15 10:40,38,116,-78,-1006
238,2022/7/15 10:50,58,125,-67,-1035
238,2022/7/15 11:00,43,119,-76,-950
238,2022/7/15 11:10,47,85,-38,-754
238,2022/7/15 11:20,44,121,-77,-776
238,2022/7/15 11:30,61,109,-48,-747
238,2022/7/15 11:40,69,108,-39,-794
238,2022/7/15 11:50,74,109,-35,-746
238,2022/7/15 12:00,64,121,-57,-670
238,2022/7/15 12:10,84,112,-28,-668
238,2022/7/15 12:20,69,120,-51,-763
238,2022/7/15 12:30,70,114,-44,-832
238,2022/7/15 12:40,56,97,-41,-998
238,2022/7/15 12:50,115,88,27,-1033
238,2022/7/15 13:00,61,108,-47,-1056
238,2022/7/15 13:10,107,109,-2,-774
238,2022/7/15 13:20,116,107,9,-895
238,2022/7/15 13:30,107,105,2,-897
238,2022/7/15 13:40,119,109,10,-928
238,2022/7/15 13:50,104,109,-5,-863
238,2022/7/15 14:00,104,108,-4,-789
238,2022/7/15 14:10,112,112,0,-758
238,2022/7/15 14:20,102,114,-12,-743
238,2022/7/15 14:30,101,110,-9,-787
238,2022/7/15 14:40,119,77,42,-652
238,2022/7/15 14:50,102,117,-15,-617
238,2022/7/15 15:00,108,124,-16,-492
238,2022/7/15 15:10,119,150,-31,-372
238,2022/7/15 15:20,132,75,57,-346
238,2022/7/15 15:30,121,128,-7,-414
238,2022/7/15 15:40,132,60,72,-333
238,2022/7/15 15:50,130,117,13,-434
238,2022/7/15 16:00,130,144,-14,-308
238,2022/7/15 16:10,130,122,8,-149
238,2022/7/15 16:20,125,120,5,-167
238,2022/7/15 16:30,130,96,34,196
238,2022/7/15 16:40,176,197,-21,499
238,2022/7/15 16:50,169,112,57,377
238,2022/7/15 17:00,136,110,26,2921
238,2022/7/15 17:10,185,145,40,4855
238,2022/7/15 17:20,99,179,-80,2521
238,2022/7/15 17:30,73,218,-145,2381
238,2022/7/15 17:40,74,298,-224,4662
238,2022/7/15 17:50,48,299,-251,1533
238,2022/7/15 18:00,52,335,-283,1373
238,2022/7/15 18:10,58,207,-149,4591
238,2022/7/15 18:20,38,579,-541,332
238,2022/7/15 18:30,42,441,-399,-649
238,2022/7/15 18:40,34,510,-476,-1310
238,2022/7/15 18:50,35,430,-395,-2103
238,2022/7/15 19:00,26,534,-508,-2415
238,2022/7/15 19:10,33,655,-622,-2629
238,2022/7/15 19:20,30,378,-348,-1843
238,2022/7/15 19:30,26,387,-361,-1816
238,2022/7/15 19:40,27,336,-309,-1296
238,2022/7/15 19:50,27,207,-180,-1241
238,2022/7/15 20:00,27,213,-186,-985
238,2022/7/15 20:10,29,100,-71,-655
238,2022/7/15 20:20,27,171,-144,-840
238,2022/7/15 20:30,25,301,-276,-1032
238,2022/7/15 20:40,26,112,-86,-909
238,2022/7/15 20:50,20,119,-99,-997
238,2022/7/15 21:00,26,111,-85,-879
238,2022/7/15 21:10,25,110,-85,-809
238,2022/7/15 21:20,21,150,-129,-1043
238,2022/7/15 21:30,18,107,-89,-1010
238,2022/7/15 21:40,17,109,-92,-1083
238,2022/7/15 21:50,15,106,-91,-1234
238,2022/7/15 22:00,18,111,-93,-886
238,2022/7/15 22:10,15,111,-96,-841
238,2022/7/15 22:20,6,117,-111,-1356
238,2022/7/15 22:30,2,123,-121,-1652
238,2022/7/15 22:40,2,125,-123,-1632
238,2022/7/15 22:50,1,125,-124,-1390
244,2022/7/15 5:00,0,1,-1,-25
244,2022/7/15 5:10,0,1,-1,-7
244,2022/7/15 5:20,17,1,16,126
244,2022/7/15 5:30,30,1,29,297
244,2022/7/15 5:40,31,1,30,411
244,2022/7/15 5:50,49,1,48,444
244,2022/7/15 6:00,70,1,69,390
244,2022/7/15 6:10,59,1,58,357
244,2022/7/15 6:20,75,5,70,392
244,2022/7/15 6:30,70,12,58,698
244,2022/7/15 6:40,73,65,8,1092
244,2022/7/15 6:50,108,38,70,1440
244,2022/7/15 7:00,207,55,152,2253
244,2022/7/15 7:10,254,50,204,3161
244,2022/7/15 7:20,349,54,295,4641
244,2022/7/15 7:30,394,67,327,5687
244,2022/7/15 7:40,600,63,537,8341
244,2022/7/15 7:50,442,60,382,9383
244,2022/7/15 8:00,326,63,263,8996
244,2022/7/15 8:10,360,62,298,5029
244,2022/7/15 8:20,273,73,200,1910
244,2022/7/15 8:30,188,57,131,-3382
244,2022/7/15 8:40,122,37,85,-14462
244,2022/7/15 8:50,81,48,33,-10565
244,2022/7/15 9:00,63,52,11,-6629
244,2022/7/15 9:10,50,54,-4,-5556
244,2022/7/15 9:20,39,50,-11,-5259
244,2022/7/15 9:30,39,49,-10,-3474
244,2022/7/15 9:40,35,64,-29,-2190
244,2022/7/15 9:50,30,45,-15,-2153
244,2022/7/15 10:00,30,37,-7,-1911
244,2022/7/15 10:10,34,50,-16,-1306
244,2022/7/15 10:20,28,50,-22,-1281
244,2022/7/15 10:30,28,44,-16,-1056
244,2022/7/15 10:40,24,50,-26,-1032
244,2022/7/15 10:50,29,42,-13,-1048
244,2022/7/15 11:00,29,38,-9,-959
244,2022/7/15 11:10,30,28,2,-752
244,2022/7/15 11:20,25,45,-20,-796
244,2022/7/15 11:30,28,51,-23,-770
244,2022/7/15 11:40,27,51,-24,-818
244,2022/7/15 11:50,33,48,-15,-761
244,2022/7/15 12:00,29,50,-21,-691
244,2022/7/15 12:10,36,51,-15,-683
244,2022/7/15 12:20,29,18,11,-752
244,2022/7/15 12:30,29,49,-20,-852
244,2022/7/15 12:40,25,65,-40,-1038
244,2022/7/15 12:50,26,67,-41,-1074
244,2022/7/15 13:00,22,61,-39,-1095
244,2022/7/15 13:10,27,55,-28,-802
244,2022/7/15 13:20,25,50,-25,-920
244,2022/7/15 13:30,25,50,-25,-922
244,2022/7/15 13:40,25,54,-29,-957
244,2022/7/15 13:50,25,54,-29,-892
244,2022/7/15 14:00,25,50,-25,-814
244,2022/7/15 14:10,24,18,6,-752
244,2022/7/15 14:20,20,47,-27,-770
244,2022/7/15 14:30,21,65,-44,-831
244,2022/7/15 14:40,26,55,-29,-681
244,2022/7/15 14:50,21,63,-42,-659
244,2022/7/15 15:00,17,61,-44,-536
244,2022/7/15 15:10,20,59,-39,-411
244,2022/7/15 15:20,24,66,-42,-388
244,2022/7/15 15:30,21,73,-52,-466
244,2022/7/15 15:40,23,51,-28,-361
244,2022/7/15 15:50,23,69,-46,-480
244,2022/7/15 16:00,21,83,-62,-370
244,2022/7/15 16:10,26,59,-33,-182
244,2022/7/15 16:20,26,106,-80,-247
244,2022/7/15 16:30,27,60,-33,163
244,2022/7/15 16:40,29,90,-61,438
244,2022/7/15 16:50,29,98,-69,308
244,2022/7/15 17:00,23,108,-85,2836
244,2022/7/15 17:10,27,108,-81,4774
244,2022/7/15 17:20,24,65,-41,2480
244,2022/7/15 17:30,24,99,-75,2306
244,2022/7/15 17:40,25,151,-126,4536
244,2022/7/15 17:50,22,109,-87,1446
244,2022/7/15 18:00,22,160,-138,1235
244,2022/7/15 18:10,19,112,-93,4498
244,2022/7/15 18:20,17,124,-107,225
244,2022/7/15 18:30,17,197,-180,-829
244,2022/7/15 18:40,18,119,-101,-1411
244,2022/7/15 18:50,13,285,-272,-2375
244,2022/7/15 19:00,17,109,-92,-2507
244,2022/7/15 19:10,17,112,-95,-2724
244,2022/7/15 19:20,12,178,-166,-2009
244,2022/7/15 19:30,12,119,-107,-1923
244,2022/7/15 19:40,12,111,-99,-1395
244,2022/7/15 19:50,12,107,-95,-1336
244,2022/7/15 20:00,12,120,-108,-1093
244,2022/7/15 20:10,16,95,-79,-734
244,2022/7/15 20:20,12,110,-98,-938
244,2022/7/15 20:30,12,110,-98,-1130
244,2022/7/15 20:40,8,63,-55,-964
244,2022/7/15 20:50,6,95,-89,-1086
244,2022/7/15 21:00,11,103,-92,-971
244,2022/7/15 21:10,13,108,-95,-904
244,2022/7/15 21:20,7,89,-82,-1125
244,2022/7/15 21:30,7,110,-103,-1113
244,2022/7/15 21:40,8,95,-87,-1170
244,2022/7/15 21:50,7,68,-61,-1295
244,2022/7/15 22:00,15,99,-84,-970
244,2022/7/15 22:10,5,99,-94,-935
244,2022/7/15 22:20,1,99,-98,-1454
244,2022/7/15 22:30,0,78,-78,-1730
244,2022/7/15 22:40,0,78,-78,-1710
244,2022/7/15 22:50,0,83,-83,-1473
250,2022/7/15 5:00,0,1,-1,-26
250,2022/7/15 5:10,2,1,1,-6
250,2022/7/15 5:20,10,1,9,135
250,2022/7/15 5:30,14,1,13,310
250,2022/7/15 5:40,14,1,13,424
250,2022/7/15 5:50,26,1,25,469
250,2022/7/15 6:00,27,1,26,416
250,2022/7/15 6:10,36,1,35,392
250,2022/7/15 6:20,38,1,37,429
250,2022/7/15 6:30,57,1,56,754
250,2022/7/15 6:40,34,27,7,1099
250,2022/7/15 6:50,56,22,34,1474
250,2022/7/15 7:00,54,16,38,2291
250,2022/7/15 7:10,88,14,74,3235
250,2022/7/15 7:20,108,19,89,4730
250,2022/7/15 7:30,121,21,100,5787
250,2022/7/15 7:40,185,24,161,8502
250,2022/7/15 7:50,147,35,112,9495
250,2022/7/15 8:00,79,29,50,9046
250,2022/7/15 8:10,64,29,35,5064
250,2022/7/15 8:20,53,28,25,1935
250,2022/7/15 8:30,33,25,8,-3374
250,2022/7/15 8:40,29,19,10,-14452
250,2022/7/15 8:50,31,23,8,-10557
250,2022/7/15 9:00,26,23,3,-6626
250,2022/7/15 9:10,23,31,-8,-5564
250,2022/7/15 9:20,21,23,-2,-5261
250,2022/7/15 9:30,14,23,-9,-3483
250,2022/7/15 9:40,16,23,-7,-2197
250,2022/7/15 9:50,15,33,-18,-2171
250,2022/7/15 10:00,14,23,-9,-1920
250,2022/7/15 10:10,17,21,-4,-1310
250,2022/7/15 10:20,14,25,-11,-1292
250,2022/7/15 10:30,13,23,-10,-1066
250,2022/7/15 10:40,14,19,-5,-1037
250,2022/7/15 10:50,13,19,-6,-1054
250,2022/7/15 11:00,12,23,-11,-970
250,2022/7/15 11:10,12,19,-7,-759
250,2022/7/15 11:20,15,23,-8,-804
250,2022/7/15 11:30,13,23,-10,-780
250,2022/7/15 11:40,12,23,-11,-829
250,2022/7/15 11:50,15,23,-8,-769
250,2022/7/15 12:00,13,8,5,-686
250,2022/7/15 12:10,13,23,-10,-693
250,2022/7/15 12:20,12,23,-11,-763
250,2022/7/15 12:30,10,23,-13,-865
250,2022/7/15 12:40,11,22,-11,-1049
250,2022/7/15 12:50,10,23,-13,-1087
250,2022/7/15 13:00,14,29,-15,-1110
250,2022/7/15 13:10,10,25,-15,-817
250,2022/7/15 13:20,12,32,-20,-940
250,2022/7/15 13:30,11,23,-12,-934
250,2022/7/15 13:40,8,23,-15,-972
250,2022/7/15 13:50,9,8,1,-891
250,2022/7/15 14:00,7,23,-16,-830
250,2022/7/15 14:10,6,23,-17,-769
250,2022/7/15 14:20,9,29,-20,-790
250,2022/7/15 14:30,7,24,-17,-848
250,2022/7/15 14:40,10,31,-21,-702
250,2022/7/15 14:50,7,31,-24,-683
250,2022/7/15 15:00,5,32,-27,-563
250,2022/7/15 15:10,8,31,-23,-434
250,2022/7/15 15:20,10,32,-22,-410
250,2022/7/15 15:30,5,30,-25,-491
250,2022/7/15 15:40,7,23,-16,-377
250,2022/7/15 15:50,10,38,-28,-508
250,2022/7/15 16:00,9,41,-32,-402
250,2022/7/15 16:10,8,25,-17,-199
250,2022/7/15 16:20,12,38,-26,-273
250,2022/7/15 16:30,5,49,-44,119
250,2022/7/15 16:40,10,49,-39,399
250,2022/7/15 16:50,8,49,-41,267
250,2022/7/15 17:00,7,15,-8,2828
250,2022/7/15 17:10,8,68,-60,4714
250,2022/7/15 17:20,8,39,-31,2449
250,2022/7/15 17:30,9,60,-51,2255
250,2022/7/15 17:40,10,76,-66,4470
250,2022/7/15 17:50,8,38,-30,1416
250,2022/7/15 18:00,7,75,-68,1167
250,2022/7/15 18:10,7,84,-77,4421
250,2022/7/15 18:20,5,81,-76,149
250,2022/7/15 18:30,8,95,-87,-916
250,2022/7/15 18:40,6,52,-46,-1457
250,2022/7/15 18:50,7,110,-103,-2478
250,2022/7/15 19:00,5,91,-86,-2593
250,2022/7/15 19:10,2,64,-62,-2786
250,2022/7/15 19:20,4,99,-95,-2104
250,2022/7/15 19:30,3,75,-72,-1995
250,2022/7/15 19:40,2,74,-72,-1467
250,2022/7/15 19:50,4,39,-35,-1371
250,2022/7/15 20:00,3,71,-68,-1161
250,2022/7/15 20:10,3,53,-50,-784
250,2022/7/15 20:20,2,46,-44,-982
250,2022/7/15 20:30,3,48,-45,-1175
250,2022/7/15 20:40,1,33,-32,-996
250,2022/7/15 20:50,2,41,-39,-1125
250,2022/7/15 21:00,1,40,-39,-1010
250,2022/7/15 21:10,2,46,-44,-948
250,2022/7/15 21:20,2,49,-47,-1172
250,2022/7/15 21:30,2,40,-38,-1151
250,2022/7/15 21:40,2,27,-25,-1195
250,2022/7/15 21:50,1,54,-53,-1348
250,2022/7/15 22:00,1,48,-47,-1017
250,2022/7/15 22:10,2,48,-46,-981
250,2022/7/15 22:20,0,47,-47,-1501
250,2022/7/15 22:30,0,41,-41,-1771
250,2022/7/15 22:40,0,40,-40,-1750
250,2022/7/15 22:50,0,49,-49,-1522
247,2022/7/15 5:00,0,1,-1,-27
247,2022/7/15 5:10,3,1,2,-4
247,2022/7/15 5:20,15,1,14,149
247,2022/7/15 5:30,19,1,18,328
247,2022/7/15 5:40,19,1,18,442
247,2022/7/15 5:50,31,1,30,499
247,2022/7/15 6:00,33,1,32,448
247,2022/7/15 6:10,35,1,34,426
247,2022/7/15 6:20,44,1,43,472
247,2022/7/15 6:30,45,1,44,798
247,2022/7/15 6:40,51,23,28,1127
247,2022/7/15 6:50,71,21,50,1524
247,2022/7/15 7:00,86,32,54,2345
247,2022/7/15 7:10,153,42,111,3346
247,2022/7/15 7:20,222,41,181,4911
247,2022/7/15 7:30,199,71,128,5915
247,2022/7/15 7:40,213,72,141,8643
247,2022/7/15 7:50,184,68,116,9611
247,2022/7/15 8:00,181,74,107,9153
247,2022/7/15 8:10,105,48,57,5121
247,2022/7/15 8:20,76,53,23,1958
247,2022/7/15 8:30,56,62,-6,-3380
247,2022/7/15 8:40,43,76,-33,-14485
247,2022/7/15 8:50,33,66,-33,-10590
247,2022/7/15 9:00,29,58,-29,-6655
247,2022/7/15 9:10,30,46,-16,-5580
247,2022/7/15 9:20,26,54,-28,-5289
247,2022/7/15 9:30,23,52,-29,-3512
247,2022/7/15 9:40,22,44,-22,-2219
247,2022/7/15 9:50,22,53,-31,-2202
247,2022/7/15 10:00,22,38,-16,-1936
247,2022/7/15 10:10,17,57,-40,-1350
247,2022/7/15 10:20,20,41,-21,-1313
247,2022/7/15 10:30,20,54,-34,-1100
247,2022/7/15 10:40,16,41,-25,-1062
247,2022/7/15 10:50,18,29,-11,-1065
247,2022/7/15 11:00,18,45,-27,-997
247,2022/7/15 11:10,19,51,-32,-791
247,2022/7/15 11:20,19,6,13,-791
247,2022/7/15 11:30,20,47,-27,-807
247,2022/7/15 11:40,19,41,-22,-851
247,2022/7/15 11:50,21,46,-25,-794
247,2022/7/15 12:00,18,45,-27,-713
247,2022/7/15 12:10,20,38,-18,-711
247,2022/7/15 12:20,19,38,-19,-782
247,2022/7/15 12:30,19,45,-26,-891
247,2022/7/15 12:40,21,40,-19,-1068
247,2022/7/15 12:50,17,41,-24,-1111
247,2022/7/15 13:00,17,31,-14,-1124
247,2022/7/15 13:10,17,19,-2,-819
247,2022/7/15 13:20,17,47,-30,-970
247,2022/7/15 13:30,20,50,-30,-964
247,2022/7/15 13:40,20,51,-31,-1003
247,2022/7/15 13:50,19,49,-30,-921
247,2022/7/15 14:00,16,51,-35,-865
247,2022/7/15 14:10,18,52,-34,-803
247,2022/7/15 14:20,18,50,-32,-822
247,2022/7/15 14:30,17,50,-33,-881
247,2022/7/15 14:40,16,45,-29,-731
247,2022/7/15 14:50,19,45,-26,-709
247,2022/7/15 15:00,14,21,-7,-570
247,2022/7/15 15:10,17,68,-51,-485
247,2022/7/15 15:20,15,70,-55,-465
247,2022/7/15 15:30,23,41,-18,-509
247,2022/7/15 15:40,19,67,-48,-425
247,2022/7/15 15:50,16,28,-12,-520
247,2022/7/15 16:00,17,56,-39,-441
247,2022/7/15 16:10,21,73,-52,-251
247,2022/7/15 16:20,18,62,-44,-317
247,2022/7/15 16:30,28,61,-33,86
247,2022/7/15 16:40,17,41,-24,375
247,2022/7/15 16:50,29,93,-64,203
247,2022/7/15 17:00,24,59,-35,2793
247,2022/7/15 17:10,28,80,-52,4662
247,2022/7/15 17:20,18,63,-45,2404
247,2022/7/15 17:30,24,77,-53,2202
247,2022/7/15 17:40,27,98,-71,4399
247,2022/7/15 17:50,26,93,-67,1349
247,2022/7/15 18:00,21,106,-85,1082
247,2022/7/15 18:10,13,123,-110,4311
247,2022/7/15 18:20,15,107,-92,57
247,2022/7/15 18:30,14,105,-91,-1007
247,2022/7/15 18:40,12,108,-96,-1553
247,2022/7/15 18:50,10,112,-102,-2580
247,2022/7/15 19:00,8,116,-108,-2701
247,2022/7/15 19:10,10,112,-102,-2888
247,2022/7/15 19:20,9,110,-101,-2205
247,2022/7/15 19:30,8,106,-98,-2093
247,2022/7/15 19:40,9,101,-92,-1559
247,2022/7/15 19:50,8,99,-91,-1462
247,2022/7/15 20:00,6,77,-71,-1232
247,2022/7/15 20:10,6,88,-82,-866
247,2022/7/15 20:20,7,52,-45,-1027
247,2022/7/15 20:30,6,94,-88,-1263
247,2022/7/15 20:40,4,71,-67,-1063
247,2022/7/15 20:50,5,61,-56,-1181
247,2022/7/15 21:00,6,70,-64,-1074
247,2022/7/15 21:10,3,64,-61,-1009
247,2022/7/15 21:20,3,64,-61,-1233
247,2022/7/15 21:30,2,71,-69,-1220
247,2022/7/15 21:40,3,48,-45,-1240
247,2022/7/15 21:50,2,68,-66,-1414
247,2022/7/15 22:00,2,34,-32,-1049
247,2022/7/15 22:10,1,65,-64,-1045
247,2022/7/15 22:20,0,67,-67,-1568
247,2022/7/15 22:30,0,53,-53,-1824
247,2022/7/15 22:40,0,52,-52,-1802
247,2022/7/15 22:50,0,49,-49,-1571
248,2022/7/15 5:00,3,1,2,-25
248,2022/7/15 5:10,8,1,7,3
248,2022/7/15 5:20,20,1,19,168
248,2022/7/15 5:30,15,1,14,342
248,2022/7/15 5:40,25,1,24,466
248,2022/7/15 5:50,42,1,41,540
248,2022/7/15 6:00,45,1,44,492
248,2022/7/15 6:10,55,1,54,480
248,2022/7/15 6:20,60,1,59,531
248,2022/7/15 6:30,83,1,82,880
248,2022/7/15 6:40,163,51,112,1239
248,2022/7/15 6:50,228,68,160,1684
248,2022/7/15 7:00,231,50,181,2526
248,2022/7/15 7:10,327,99,228,3574
248,2022/7/15 7:20,349,76,273,5184
248,2022/7/15 7:30,396,110,286,6201
248,2022/7/15 7:40,365,105,260,8903
248,2022/7/15 7:50,348,89,259,9870
248,2022/7/15 8:00,278,99,179,9332
248,2022/7/15 8:10,282,122,160,5281
248,2022/7/15 8:20,207,103,104,2062
248,2022/7/15 8:30,144,126,18,-3362
248,2022/7/15 8:40,100,96,4,-14481
248,2022/7/15 8:50,94,83,11,-10579
248,2022/7/15 9:00,48,93,-45,-6700
248,2022/7/15 9:10,50,101,-51,-5631
248,2022/7/15 9:20,44,90,-46,-5335
248,2022/7/15 9:30,38,87,-49,-3561
248,2022/7/15 9:40,37,101,-64,-2283
248,2022/7/15 9:50,35,106,-71,-2273
248,2022/7/15 10:00,35,87,-52,-1988
248,2022/7/15 10:10,34,90,-56,-1406
248,2022/7/15 10:20,37,87,-50,-1363
248,2022/7/15 10:30,33,73,-40,-1140
248,2022/7/15 10:40,38,77,-39,-1101
248,2022/7/15 10:50,30,92,-62,-1127
248,2022/7/15 11:00,38,68,-30,-1027
248,2022/7/15 11:10,39,64,-25,-816
248,2022/7/15 11:20,38,51,-13,-804
248,2022/7/15 11:30,40,70,-30,-837
248,2022/7/15 11:40,48,74,-26,-877
248,2022/7/15 11:50,51,65,-14,-808
248,2022/7/15 12:00,43,78,-35,-748
248,2022/7/15 12:10,46,70,-24,-735
248,2022/7/15 12:20,41,74,-33,-815
248,2022/7/15 12:30,43,47,-4,-895
248,2022/7/15 12:40,44,47,-3,-1071
248,2022/7/15 12:50,39,71,-32,-1143
248,2022/7/15 13:00,29,75,-46,-1170
248,2022/7/15 13:10,40,73,-33,-852
248,2022/7/15 13:20,39,70,-31,-1001
248,2022/7/15 13:30,33,76,-43,-1007
248,2022/7/15 13:40,31,76,-45,-1048
248,2022/7/15 13:50,34,73,-39,-960
248,2022/7/15 14:00,28,68,-40,-905
248,2022/7/15 14:10,25,85,-60,-863
248,2022/7/15 14:20,37,44,-7,-829
248,2022/7/15 14:30,29,65,-36,-917
248,2022/7/15 14:40,36,81,-45,-776
248,2022/7/15 14:50,27,77,-50,-759
248,2022/7/15 15:00,29,77,-48,-618
248,2022/7/15 15:10,30,87,-57,-542
248,2022/7/15 15:20,41,81,-40,-505
248,2022/7/15 15:30,29,77,-48,-557
248,2022/7/15 15:40,34,90,-56,-481
248,2022/7/15 15:50,42,62,-20,-540
248,2022/7/15 16:00,44,87,-43,-484
248,2022/7/15 16:10,34,101,-67,-318
248,2022/7/15 16:20,42,75,-33,-350
248,2022/7/15 16:30,38,106,-68,18
248,2022/7/15 16:40,43,70,-27,348
248,2022/7/15 16:50,44,110,-66,137
248,2022/7/15 17:00,42,107,-65,2728
248,2022/7/15 17:10,53,110,-57,4605
248,2022/7/15 17:20,73,126,-53,2351
248,2022/7/15 17:30,43,104,-61,2141
248,2022/7/15 17:40,40,93,-53,4346
248,2022/7/15 17:50,37,106,-69,1280
248,2022/7/15 18:00,29,108,-79,1003
248,2022/7/15 18:10,31,128,-97,4214
248,2022/7/15 18:20,29,101,-72,-15
248,2022/7/15 18:30,28,119,-91,-1098
248,2022/7/15 18:40,26,235,-209,-1762
248,2022/7/15 18:50,23,119,-96,-2676
248,2022/7/15 19:00,23,154,-131,-2832
248,2022/7/15 19:10,23,111,-88,-2976
248,2022/7/15 19:20,17,181,-164,-2369
248,2022/7/15 19:30,19,128,-109,-2202
248,2022/7/15 19:40,20,117,-97,-1656
248,2022/7/15 19:50,18,87,-69,-1531
248,2022/7/15 20:00,15,105,-90,-1322
248,2022/7/15 20:10,13,110,-97,-963
248,2022/7/15 20:20,17,79,-62,-1089
248,2022/7/15 20:30,14,95,-81,-1344
248,2022/7/15 20:40,14,104,-90,-1153
248,2022/7/15 20:50,12,95,-83,-1264
248,2022/7/15 21:00,10,95,-85,-1159
248,2022/7/15 21:10,13,77,-64,-1073
248,2022/7/15 21:20,10,76,-66,-1299
248,2022/7/15 21:30,7,87,-80,-1300
248,2022/7/15 21:40,6,76,-70,-1310
248,2022/7/15 21:50,5,87,-82,-1496
248,2022/7/15 22:00,5,54,-49,-1098
248,2022/7/15 22:10,1,83,-82,-1127
248,2022/7/15 22:20,0,87,-87,-1655
248,2022/7/15 22:30,0,79,-79,-1903
248,2022/7/15 22:40,0,74,-74,-1876
248,2022/7/15 22:50,0,73,-73,-1644
253,2022/7/15 5:00,0,1,-1,-26
253,2022/7/15 5:10,5,1,4,7
253,2022/7/15 5:20,23,1,22,190
253,2022/7/15 5:30,18,1,17,359
253,2022/7/15 5:40,25,8,17,483
253,2022/7/15 5:50,31,5,26,566
253,2022/7/15 6:00,32,2,30,522
253,2022/7/15 6:10,71,19,52,532
253,2022/7/15 6:20,85,16,69,600
253,2022/7/15 6:30,180,47,133,1013
253,2022/7/15 6:40,244,38,206,1445
253,2022/7/15 6:50,277,63,214,1898
253,2022/7/15 7:00,276,76,200,2726
253,2022/7/15 7:10,340,103,237,3811
253,2022/7/15 7:20,595,100,495,5679
253,2022/7/15 7:30,668,146,522,6723
253,2022/7/15 7:40,836,150,686,9589
253,2022/7/15 7:50,1054,146,908,10778
253,2022/7/15 8:00,872,126,746,10078
253,2022/7/15 8:10,820,89,731,6012
253,2022/7/15 8:20,686,118,568,2630
253,2022/7/15 8:30,600,124,476,-2886
253,2022/7/15 8:40,351,108,243,-14238
253,2022/7/15 8:50,283,105,178,-10401
253,2022/7/15 9:00,236,109,127,-6573
253,2022/7/15 9:10,224,93,131,-5500
253,2022/7/15 9:20,145,93,52,-5283
253,2022/7/15 9:30,115,106,9,-3552
253,2022/7/15 9:40,76,99,-23,-2306
253,2022/7/15 9:50,68,97,-29,-2302
253,2022/7/15 10:00,61,76,-15,-2003
253,2022/7/15 10:10,41,91,-50,-1456
253,2022/7/15 10:20,43,90,-47,-1410
253,2022/7/15 10:30,35,84,-49,-1189
253,2022/7/15 10:40,40,77,-37,-1138
253,2022/7/15 10:50,32,67,-35,-1162
253,2022/7/15 11:00,36,93,-57,-1084
253,2022/7/15 11:10,41,79,-38,-854
253,2022/7/15 11:20,39,84,-45,-849
253,2022/7/15 11:30,41,101,-60,-897
253,2022/7/15 11:40,57,97,-40,-917
253,2022/7/15 11:50,53,87,-34,-842
253,2022/7/15 12:00,60,101,-41,-789
253,2022/7/15 12:10,56,83,-27,-762
253,2022/7/15 12:20,58,88,-30,-845
253,2022/7/15 12:30,61,99,-38,-933
253,2022/7/15 12:40,64,93,-29,-1100
253,2022/7/15 12:50,47,104,-57,-1200
253,2022/7/15 13:00,52,90,-38,-1208
253,2022/7/15 13:10,52,64,-12,-864
253,2022/7/15 13:20,47,97,-50,-1051
253,2022/7/15 13:30,42,96,-54,-1061
253,2022/7/15 13:40,42,91,-49,-1097
253,2022/7/15 13:50,38,98,-60,-1020
253,2022/7/15 14:00,51,70,-19,-924
253,2022/7/15 14:10,42,93,-51,-914
253,2022/7/15 14:20,44,100,-56,-885
253,2022/7/15 14:30,32,100,-68,-985
253,2022/7/15 14:40,62,105,-43,-819
253,2022/7/15 14:50,53,94,-41,-800
253,2022/7/15 15:00,46,87,-41,-659
253,2022/7/15 15:10,47,110,-63,-605
253,2022/7/15 15:20,39,106,-67,-572
253,2022/7/15 15:30,52,103,-51,-608
253,2022/7/15 15:40,43,110,-67,-548
253,2022/7/15 15:50,45,96,-51,-591
253,2022/7/15 16:00,57,126,-69,-553
253,2022/7/15 16:10,63,124,-61,-379
253,2022/7/15 16:20,52,105,-53,-403
253,2022/7/15 16:30,70,108,-38,-20
253,2022/7/15 16:40,66,128,-62,286
253,2022/7/15 16:50,138,106,32,169
253,2022/7/15 17:00,94,120,-26,2702
253,2022/7/15 17:10,137,109,28,4633
253,2022/7/15 17:20,156,183,-27,2324
253,2022/7/15 17:30,82,212,-130,2011
253,2022/7/15 17:40,84,211,-127,4219
253,2022/7/15 17:50,79,378,-299,981
253,2022/7/15 18:00,137,326,-189,814
253,2022/7/15 18:10,64,334,-270,3944
253,2022/7/15 18:20,45,326,-281,-296
253,2022/7/15 18:30,41,434,-393,-1491
253,2022/7/15 18:40,39,434,-395,-2157
253,2022/7/15 18:50,41,432,-391,-3067
253,2022/7/15 19:00,31,507,-476,-3308
253,2022/7/15 19:10,31,300,-269,-3245
253,2022/7/15 19:20,25,333,-308,-2677
253,2022/7/15 19:30,30,321,-291,-2493
253,2022/7/15 19:40,25,232,-207,-1863
253,2022/7/15 19:50,25,150,-125,-1656
253,2022/7/15 20:00,28,151,-123,-1445
253,2022/7/15 20:10,28,119,-91,-1054
253,2022/7/15 20:20,25,144,-119,-1208
253,2022/7/15 20:30,26,119,-93,-1437
253,2022/7/15 20:40,33,107,-74,-1227
253,2022/7/15 20:50,28,103,-75,-1339
253,2022/7/15 21:00,26,128,-102,-1261
253,2022/7/15 21:10,27,101,-74,-1147
253,2022/7/15 21:20,27,115,-88,-1387
253,2022/7/15 21:30,25,111,-86,-1386
253,2022/7/15 21:40,26,108,-82,-1392
253,2022/7/15 21:50,22,121,-99,-1595
253,2022/7/15 22:00,16,118,-102,-1200
253,2022/7/15 22:10,14,122,-108,-1235
253,2022/7/15 22:20,10,106,-96,-1751
253,2022/7/15 22:30,6,101,-95,-1998
253,2022/7/15 22:40,2,107,-105,-1981
253,2022/7/15 22:50,2,108,-106,-1750
280,2022/7/15 5:00,0,1,-1,-1
280,2022/7/15 5:10,30,1,29,29
280,2022/7/15 5:20,53,1,52,52
280,2022/7/15 5:30,41,1,40,40
280,2022/7/15 5:40,52,1,51,51
280,2022/7/15 5:50,204,1,203,203
280,2022/7/15 6:00,187,2,185,185
280,2022/7/15 6:10,360,1,359,359
280,2022/7/15 6:20,601,1,600,600
280,2022/7/15 6:30,479,89,390,390
280,2022/7/15 6:40,723,69,654,654
280,2022/7/15 6:50,822,102,720,720
280,2022/7/15 7:00,1160,109,1051,1051
280,2022/7/15 7:10,1378,180,1198,1198
280,2022/7/15 7:20,1964,105,1859,1859
280,2022/7/15 7:30,1999,256,1743,1743
280,2022/7/15 7:40,1968,147,1821,1821
280,2022/7/15 7:50,1971,233,1738,1738
280,2022/7/15 8:00,1996,111,1885,1885
280,2022/7/15 8:10,1968,256,1712,1712
280,2022/7/15 8:20,1405,256,1149,1149
280,2022/7/15 8:30,849,192,657,657
280,2022/7/15 8:40,836,154,682,682
280,2022/7/15 8:50,617,126,491,491
280,2022/7/15 9:00,580,124,456,456
280,2022/7/15 9:10,273,109,164,164
280,2022/7/15 9:20,271,179,92,92
280,2022/7/15 9:30,220,108,112,112
280,2022/7/15 9:40,178,144,34,34
280,2022/7/15 9:50,210,178,32,32
280,2022/7/15 10:00,135,126,9,9
280,2022/7/15 10:10,138,117,21,21
280,2022/7/15 10:20,176,108,68,68
280,2022/7/15 10:30,136,183,-47,-47
280,2022/7/15 10:40,54,109,-55,-55
280,2022/7/15 10:50,204,97,107,107
280,2022/7/15 11:00,47,108,-61,-61
280,2022/7/15 11:10,174,139,35,35
280,2022/7/15 11:20,80,122,-42,-42
280,2022/7/15 11:30,135,110,25,25
280,2022/7/15 11:40,131,106,25,25
280,2022/7/15 11:50,140,120,20,20
280,2022/7/15 12:00,131,102,29,29
280,2022/7/15 12:10,191,109,82,82
280,2022/7/15 12:20,149,106,43,43
280,2022/7/15 12:30,191,121,70,70
280,2022/7/15 12:40,171,100,71,71
280,2022/7/15 12:50,157,104,53,53
280,2022/7/15 13:00,149,103,46,46
280,2022/7/15 13:10,205,144,61,61
280,2022/7/15 13:20,182,102,80,80
280,2022/7/15 13:30,174,99,75,75
280,2022/7/15 13:40,113,106,7,7
280,2022/7/15 13:50,167,142,25,25
280,2022/7/15 14:00,136,117,19,19
280,2022/7/15 14:10,163,108,55,55
280,2022/7/15 14:20,132,105,27,27
280,2022/7/15 14:30,150,154,-4,-4
280,2022/7/15 14:40,85,119,-34,-34
280,2022/7/15 14:50,175,104,71,71
280,2022/7/15 15:00,150,103,47,47
280,2022/7/15 15:10,105,146,-41,-41
280,2022/7/15 15:20,126,122,4,4
280,2022/7/15 15:30,139,124,15,15
280,2022/7/15 15:40,77,110,-33,-33
280,2022/7/15 15:50,147,197,-50,-50
280,2022/7/15 16:00,171,169,2,2
280,2022/7/15 16:10,149,108,41,41
280,2022/7/15 16:20,171,110,61,61
280,2022/7/15 16:30,227,328,-101,-101
280,2022/7/15 16:40,270,223,47,47
280,2022/7/15 16:50,220,184,36,36
280,2022/7/15 17:00,265,156,109,109
280,2022/7/15 17:10,229,430,-201,-201
280,2022/7/15 17:20,258,323,-65,-65
280,2022/7/15 17:30,264,296,-32,-32
280,2022/7/15 17:40,210,427,-217,-217
280,2022/7/15 17:50,196,326,-130,-130
280,2022/7/15 18:00,177,570,-393,-393
280,2022/7/15 18:10,126,383,-257,-257
280,2022/7/15 18:20,145,573,-428,-428
280,2022/7/15 18:30,71,425,-354,-354
280,2022/7/15 18:40,51,1223,-1172,-1172
280,2022/7/15 18:50,58,497,-439,-439
280,2022/7/15 19:00,35,555,-520,-520
280,2022/7/15 19:10,44,398,-354,-354
280,2022/7/15 19:20,36,638,-602,-602
280,2022/7/15 19:30,28,419,-391,-391
280,2022/7/15 19:40,30,503,-473,-473
280,2022/7/15 19:50,28,219,-191,-191
280,2022/7/15 20:00,28,320,-292,-292
280,2022/7/15 20:10,31,208,-177,-177
280,2022/7/15 20:20,30,179,-149,-149
280,2022/7/15 20:30,28,169,-141,-141
280,2022/7/15 20:40,24,209,-185,-185
280,2022/7/15 20:50,24,159,-135,-135
280,2022/7/15 21:00,26,121,-95,-95
280,2022/7/15 21:10,25,215,-190,-190
280,2022/7/15 21:20,22,141,-119,-119
280,2022/7/15 21:30,19,119,-100,-100
280,2022/7/15 21:40,18,150,-132,-132
280,2022/7/15 21:50,15,219,-204,-204
280,2022/7/15 22:00,12,230,-218,-218
280,2022/7/15 22:10,10,108,-98,-98
280,2022/7/15 22:20,6,125,-119,-119
280,2022/7/15 22:30,0,125,-125,-125
280,2022/7/15 22:40,0,114,-114,-114
280,2022/7/15 22:50,0,154,-154,-154
271,2022/7/15 5:00,0,1,-1,-2
271,2022/7/15 5:10,5,1,4,33
271,2022/7/15 5:20,21,1,20,72
271,2022/7/15 5:30,29,1,28,68
271,2022/7/15 5:40,28,1,27,78
271,2022/7/15 5:50,32,1,31,234
271,2022/7/15 6:00,36,1,35,220
271,2022/7/15 6:10,34,1,33,392
271,2022/7/15 6:20,43,1,42,642
271,2022/7/15 6:30,53,25,28,418
271,2022/7/15 6:40,61,25,36,690
271,2022/7/15 6:50,71,35,36,756
271,2022/7/15 7:00,89,36,53,1104
271,2022/7/15 7:10,214,51,163,1361
271,2022/7/15 7:20,239,67,172,2031
271,2022/7/15 7:30,303,114,189,1932
271,2022/7/15 7:40,449,108,341,2162
271,2022/7/15 7:50,575,105,470,2208
271,2022/7/15 8:00,599,124,475,2360
271,2022/7/15 8:10,351,122,229,1941
271,2022/7/15 8:20,277,110,167,1316
271,2022/7/15 8:30,227,144,83,740
271,2022/7/15 8:40,191,226,-35,647
271,2022/7/15 8:50,113,117,-4,487
271,2022/7/15 9:00,64,115,-51,405
271,2022/7/15 9:10,49,106,-57,107
271,2022/7/15 9:20,42,93,-51,41
271,2022/7/15 9:30,29,76,-47,65
271,2022/7/15 9:40,31,64,-33,1
271,2022/7/15 9:50,28,74,-46,-14
271,2022/7/15 10:00,27,69,-42,-33
271,2022/7/15 10:10,28,45,-17,4
271,2022/7/15 10:20,25,62,-37,31
271,2022/7/15 10:30,21,45,-24,-71
271,2022/7/15 10:40,24,44,-20,-75
271,2022/7/15 10:50,23,45,-22,85
271,2022/7/15 11:00,22,59,-37,-98
271,2022/7/15 11:10,23,38,-15,20
271,2022/7/15 11:20,25,38,-13,-55
271,2022/7/15 11:30,24,45,-21,4
271,2022/7/15 11:40,22,58,-36,-11
271,2022/7/15 11:50,28,38,-10,10
271,2022/7/15 12:00,29,40,-11,18
271,2022/7/15 12:10,27,41,-14,68
271,2022/7/15 12:20,29,62,-33,10
271,2022/7/15 12:30,29,46,-17,53
271,2022/7/15 12:40,25,47,-22,49
271,2022/7/15 12:50,25,50,-25,28
271,2022/7/15 13:00,27,68,-41,5
271,2022/7/15 13:10,27,51,-24,37
271,2022/7/15 13:20,25,51,-26,54
271,2022/7/15 13:30,19,48,-29,46
271,2022/7/15 13:40,25,69,-44,-37
271,2022/7/15 13:50,20,49,-29,-4
271,2022/7/15 14:00,23,47,-24,-5
271,2022/7/15 14:10,20,56,-36,19
271,2022/7/15 14:20,23,67,-44,-17
271,2022/7/15 14:30,21,50,-29,-33
271,2022/7/15 14:40,20,54,-34,-68
271,2022/7/15 14:50,23,53,-30,41
271,2022/7/15 15:00,21,70,-49,-2
271,2022/7/15 15:10,20,51,-31,-72
271,2022/7/15 15:20,26,48,-22,-18
271,2022/7/15 15:30,23,54,-31,-16
271,2022/7/15 15:40,25,83,-58,-91
271,2022/7/15 15:50,23,64,-41,-91
271,2022/7/15 16:00,27,66,-39,-37
271,2022/7/15 16:10,25,73,-48,-7
271,2022/7/15 16:20,31,90,-59,2
271,2022/7/15 16:30,39,69,-30,-131
271,2022/7/15 16:40,204,70,134,181
271,2022/7/15 16:50,31,68,-37,-1
271,2022/7/15 17:00,35,106,-71,38
271,2022/7/15 17:10,73,85,-12,-213
271,2022/7/15 17:20,51,79,-28,-93
271,2022/7/15 17:30,85,125,-40,-72
271,2022/7/15 17:40,161,80,81,-136
271,2022/7/15 17:50,43,132,-89,-219
271,2022/7/15 18:00,46,110,-64,-457
271,2022/7/15 18:10,65,151,-86,-343
271,2022/7/15 18:20,43,126,-83,-511
271,2022/7/15 18:30,37,197,-160,-514
271,2022/7/15 18:40,25,104,-79,-1251
271,2022/7/15 18:50,30,182,-152,-591
271,2022/7/15 19:00,24,109,-85,-605
271,2022/7/15 19:10,27,234,-207,-561
271,2022/7/15 19:20,21,117,-96,-698
271,2022/7/15 19:30,16,192,-176,-567
271,2022/7/15 19:40,19,107,-88,-561
271,2022/7/15 19:50,15,113,-98,-289
271,2022/7/15 20:00,18,80,-62,-354
271,2022/7/15 20:10,15,104,-89,-266
271,2022/7/15 20:20,13,84,-71,-220
271,2022/7/15 20:30,13,106,-93,-234
271,2022/7/15 20:40,17,96,-79,-264
271,2022/7/15 20:50,13,73,-60,-195
271,2022/7/15 21:00,12,104,-92,-187
271,2022/7/15 21:10,11,92,-81,-271
271,2022/7/15 21:20,10,78,-68,-187
271,2022/7/15 21:30,7,101,-94,-194
271,2022/7/15 21:40,8,77,-69,-201
271,2022/7/15 21:50,6,76,-70,-274
271,2022/7/15 22:00,7,85,-78,-296
271,2022/7/15 22:10,3,75,-72,-170
271,2022/7/15 22:20,1,73,-72,-191
271,2022/7/15 22:30,1,74,-73,-198
271,2022/7/15 22:40,0,71,-71,-185
271,2022/7/15 22:50,0,94,-94,-248
269,2022/7/15 5:00,0,1,-1,-3
269,2022/7/15 5:10,3,1,2,35
269,2022/7/15 5:20,26,1,25,97
269,2022/7/15 5:30,21,1,20,88
269,2022/7/15 5:40,23,1,22,100
269,2022/7/15 5:50,34,1,33,267
269,2022/7/15 6:00,44,1,43,263
269,2022/7/15 6:10,47,1,46,438
269,2022/7/15 6:20,59,1,58,700
269,2022/7/15 6:30,61,64,-3,415
269,2022/7/15 6:40,86,48,38,728
269,2022/7/15 6:50,174,67,107,863
269,2022/7/15 7:00,163,97,66,1170
269,2022/7/15 7:10,299,98,201,1562
269,2022/7/15 7:20,301,114,187,2218
269,2022/7/15 7:30,368,133,235,2167
269,2022/7/15 7:40,601,213,388,2550
269,2022/7/15 7:50,603,181,422,2630
269,2022/7/15 8:00,593,436,157,2517
269,2022/7/15 8:10,391,224,167,2108
269,2022/7/15 8:20,360,195,165,1481
269,2022/7/15 8:30,256,211,45,785
269,2022/7/15 8:40,228,254,-26,621
269,2022/7/15 8:50,208,115,93,580
269,2022/7/15 9:00,144,114,30,435
269,2022/7/15 9:10,64,106,-42,65
269,2022/7/15 9:20,71,106,-35,6
269,2022/7/15 9:30,56,109,-53,12
269,2022/7/15 9:40,40,100,-60,-59
269,2022/7/15 9:50,41,96,-55,-69
269,2022/7/15 10:00,38,76,-38,-71
269,2022/7/15 10:10,34,91,-57,-53
269,2022/7/15 10:20,34,62,-28,3
269,2022/7/15 10:30,33,72,-39,-110
269,2022/7/15 10:40,30,87,-57,-132
269,2022/7/15 10:50,31,81,-50,35
269,2022/7/15 11:00,33,65,-32,-130
269,2022/7/15 11:10,27,65,-38,-18
269,2022/7/15 11:20,32,81,-49,-104
269,2022/7/15 11:30,29,77,-48,-44
269,2022/7/15 11:40,35,68,-33,-44
269,2022/7/15 11:50,34,74,-40,-30
269,2022/7/15 12:00,34,76,-42,-24
269,2022/7/15 12:10,25,87,-62,6
269,2022/7/15 12:20,45,67,-22,-12
269,2022/7/15 12:30,36,73,-37,16
269,2022/7/15 12:40,36,91,-55,-6
269,2022/7/15 12:50,36,90,-54,-26
269,2022/7/15 13:00,33,70,-37,-32
269,2022/7/15 13:10,27,64,-37,0
269,2022/7/15 13:20,37,96,-59,-5
269,2022/7/15 13:30,24,93,-69,-23
269,2022/7/15 13:40,36,71,-35,-72
269,2022/7/15 13:50,31,61,-30,-34
269,2022/7/15 14:00,27,92,-65,-70
269,2022/7/15 14:10,33,87,-54,-35
269,2022/7/15 14:20,33,82,-49,-66
269,2022/7/15 14:30,28,75,-47,-80
269,2022/7/15 14:40,34,90,-56,-124
269,2022/7/15 14:50,26,100,-74,-33
269,2022/7/15 15:00,28,77,-49,-51
269,2022/7/15 15:10,29,73,-44,-116
269,2022/7/15 15:20,37,100,-63,-81
269,2022/7/15 15:30,27,104,-77,-93
269,2022/7/15 15:40,37,97,-60,-151
269,2022/7/15 15:50,41,87,-46,-137
269,2022/7/15 16:00,32,101,-69,-106
269,2022/7/15 16:10,38,125,-87,-94
269,2022/7/15 16:20,45,96,-51,-49
269,2022/7/15 16:30,268,101,167,36
269,2022/7/15 16:40,115,119,-4,177
269,2022/7/15 16:50,62,119,-57,-58
269,2022/7/15 17:00,244,112,132,170
269,2022/7/15 17:10,213,109,104,-109
269,2022/7/15 17:20,175,190,-15,-108
269,2022/7/15 17:30,143,119,24,-48
269,2022/7/15 17:40,205,206,-1,-137
269,2022/7/15 17:50,171,125,46,-173
269,2022/7/15 18:00,71,283,-212,-669
269,2022/7/15 18:10,54,149,-95,-438
269,2022/7/15 18:20,49,327,-278,-789
269,2022/7/15 18:30,44,179,-135,-649
269,2022/7/15 18:40,28,283,-255,-1506
269,2022/7/15 18:50,31,190,-159,-750
269,2022/7/15 19:00,32,327,-295,-900
269,2022/7/15 19:10,26,217,-191,-752
269,2022/7/15 19:20,23,312,-289,-987
269,2022/7/15 19:30,28,132,-104,-671
269,2022/7/15 19:40,22,184,-162,-723
269,2022/7/15 19:50,24,106,-82,-371
269,2022/7/15 20:00,25,110,-85,-439
269,2022/7/15 20:10,23,95,-72,-338
269,2022/7/15 20:20,22,126,-104,-324
269,2022/7/15 20:30,28,110,-82,-316
269,2022/7/15 20:40,18,104,-86,-350
269,2022/7/15 20:50,22,106,-84,-279
269,2022/7/15 21:00,14,97,-83,-270
269,2022/7/15 21:10,15,103,-88,-359
269,2022/7/15 21:20,20,92,-72,-259
269,2022/7/15 21:30,13,95,-82,-276
269,2022/7/15 21:40,13,93,-80,-281
269,2022/7/15 21:50,14,89,-75,-349
269,2022/7/15 22:00,6,95,-89,-385
269,2022/7/15 22:10,6,85,-79,-249
269,2022/7/15 22:20,7,76,-69,-260
269,2022/7/15 22:30,2,103,-101,-299
269,2022/7/15 22:40,0,94,-94,-279
269,2022/7/15 22:50,1,75,-74,-322
276,2022/7/15 5:00,0,1,-1,-4
276,2022/7/15 5:10,3,1,2,37
276,2022/7/15 5:20,9,1,8,105
276,2022/7/15 5:30,15,1,14,102
276,2022/7/15 5:40,20,2,18,118
276,2022/7/15 5:50,19,1,18,285
276,2022/7/15 6:00,31,1,30,293
276,2022/7/15 6:10,36,2,34,472
276,2022/7/15 6:20,48,23,25,725
276,2022/7/15 6:30,62,24,38,453
276,2022/7/15 6:40,150,38,112,840
276,2022/7/15 6:50,80,40,40,903
276,2022/7/15 7:00,170,47,123,1293
276,2022/7/15 7:10,225,60,165,1727
276,2022/7/15 7:20,276,92,184,2402
276,2022/7/15 7:30,279,87,192,2359
276,2022/7/15 7:40,386,106,280,2830
276,2022/7/15 7:50,445,96,349,2979
276,2022/7/15 8:00,395,120,275,2792
276,2022/7/15 8:10,328,120,208,2316
276,2022/7/15 8:20,265,110,155,1636
276,2022/7/15 8:30,215,178,37,822
276,2022/7/15 8:40,191,218,-27,594
276,2022/7/15 8:50,107,209,-102,478
276,2022/7/15 9:00,71,182,-111,324
276,2022/7/15 9:10,70,182,-112,-47
276,2022/7/15 9:20,42,112,-70,-64
276,2022/7/15 9:30,31,112,-81,-69
276,2022/7/15 9:40,31,99,-68,-127
276,2022/7/15 9:50,31,101,-70,-139
276,2022/7/15 10:00,31,93,-62,-133
276,2022/7/15 10:10,33,67,-34,-87
276,2022/7/15 10:20,28,72,-44,-41
276,2022/7/15 10:30,28,93,-65,-175
276,2022/7/15 10:40,27,69,-42,-174
276,2022/7/15 10:50,26,64,-38,-3
276,2022/7/15 11:00,28,65,-37,-167
276,2022/7/15 11:10,32,73,-41,-59
276,2022/7/15 11:20,27,60,-33,-137
276,2022/7/15 11:30,27,62,-35,-79
276,2022/7/15 11:40,28,65,-37,-81
276,2022/7/15 11:50,29,85,-56,-86
276,2022/7/15 12:00,29,64,-35,-59
276,2022/7/15 12:10,35,65,-30,-24
276,2022/7/15 12:20,30,61,-31,-43
276,2022/7/15 12:30,27,77,-50,-34
276,2022/7/15 12:40,35,63,-28,-34
276,2022/7/15 12:50,30,70,-40,-66
276,2022/7/15 13:00,30,69,-39,-71
276,2022/7/15 13:10,28,91,-63,-63
276,2022/7/15 13:20,26,60,-34,-39
276,2022/7/15 13:30,26,68,-42,-65
276,2022/7/15 13:40,27,67,-40,-112
276,2022/7/15 13:50,31,79,-48,-82
276,2022/7/15 14:00,28,65,-37,-107
276,2022/7/15 14:10,30,61,-31,-66
276,2022/7/15 14:20,27,61,-34,-100
276,2022/7/15 14:30,29,76,-47,-127
276,2022/7/15 14:40,29,68,-39,-163
276,2022/7/15 14:50,28,62,-34,-67
276,2022/7/15 15:00,29,70,-41,-92
276,2022/7/15 15:10,29,90,-61,-177
276,2022/7/15 15:20,26,59,-33,-114
276,2022/7/15 15:30,27,70,-43,-136
276,2022/7/15 15:40,25,72,-47,-198
276,2022/7/15 15:50,30,103,-73,-210
276,2022/7/15 16:00,28,73,-45,-151
276,2022/7/15 16:10,33,82,-49,-143
276,2022/7/15 16:20,35,81,-46,-95
276,2022/7/15 16:30,43,109,-66,-30
276,2022/7/15 16:40,46,91,-45,132
276,2022/7/15 16:50,42,77,-35,-93
276,2022/7/15 17:00,59,93,-34,136
276,2022/7/15 17:10,99,109,-10,-119
276,2022/7/15 17:20,133,112,21,-87
276,2022/7/15 17:30,74,123,-49,-97
276,2022/7/15 17:40,103,123,-20,-157
276,2022/7/15 17:50,67,144,-77,-250
276,2022/7/15 18:00,164,111,53,-616
276,2022/7/15 18:10,227,121,106,-332
276,2022/7/15 18:20,77,149,-72,-861
276,2022/7/15 18:30,85,180,-95,-744
276,2022/7/15 18:40,76,180,-104,-1610
276,2022/7/15 18:50,60,119,-59,-809
276,2022/7/15 19:00,47,181,-134,-1034
276,2022/7/15 19:10,43,146,-103,-855
276,2022/7/15 19:20,36,126,-90,-1077
276,2022/7/15 19:30,30,107,-77,-748
276,2022/7/15 19:40,39,102,-63,-786
276,2022/7/15 19:50,28,105,-77,-448
276,2022/7/15 20:00,25,105,-80,-519
276,2022/7/15 20:10,28,97,-69,-407
276,2022/7/15 20:20,24,85,-61,-385
276,2022/7/15 20:30,29,93,-64,-380
276,2022/7/15 20:40,36,98,-62,-412
276,2022/7/15 20:50,33,70,-37,-316
276,2022/7/15 21:00,34,64,-30,-300
276,2022/7/15 21:10,27,79,-52,-411
276,2022/7/15 21:20,29,70,-41,-300
276,2022/7/15 21:30,26,70,-44,-320
276,2022/7/15 21:40,24,71,-47,-328
276,2022/7/15 21:50,22,71,-49,-398
276,2022/7/15 22:00,24,71,-47,-432
276,2022/7/15 22:10,15,92,-77,-326
276,2022/7/15 22:20,8,65,-57,-317
276,2022/7/15 22:30,5,66,-61,-360
276,2022/7/15 22:40,3,56,-53,-332
276,2022/7/15 22:50,2,72,-70,-392
273,2022/7/15 5:00,0,1,-1,-5
273,2022/7/15 5:10,2,1,1,38
273,2022/7/15 5:20,25,1,24,129
273,2022/7/15 5:30,59,1,58,160
273,2022/7/15 5:40,45,1,44,162
273,2022/7/15 5:50,59,1,58,343
273,2022/7/15 6:00,83,1,82,375
273,2022/7/15 6:10,109,1,108,580
273,2022/7/15 6:20,175,36,139,864
273,2022/7/15 6:30,255,23,232,685
273,2022/7/15 6:40,280,45,235,1075
273,2022/7/15 6:50,349,64,285,1188
273,2022/7/15 7:00,568,66,502,1795
273,2022/7/15 7:10,592,45,547,2274
273,2022/7/15 7:20,684,76,608,3010
273,2022/7/15 7:30,868,69,799,3158
273,2022/7/15 7:40,1051,93,958,3788
273,2022/7/15 7:50,1214,93,1121,4100
273,2022/7/15 8:00,1366,99,1267,4059
273,2022/7/15 8:10,1169,105,1064,3380
273,2022/7/15 8:20,819,117,702,2338
273,2022/7/15 8:30,630,126,504,1326
273,2022/7/15 8:40,599,87,512,1106
273,2022/7/15 8:50,326,105,221,699
273,2022/7/15 9:00,271,101,170,494
273,2022/7/15 9:10,247,83,164,117
273,2022/7/15 9:20,182,82,100,36
273,2022/7/15 9:30,76,73,3,-66
273,2022/7/15 9:40,72,94,-22,-149
273,2022/7/15 9:50,61,71,-10,-149
273,2022/7/15 10:00,47,66,-19,-152
273,2022/7/15 10:10,46,91,-45,-132
273,2022/7/15 10:20,45,71,-26,-67
273,2022/7/15 10:30,43,70,-27,-202
273,2022/7/15 10:40,45,65,-20,-194
273,2022/7/15 10:50,36,76,-40,-43
273,2022/7/15 11:00,39,66,-27,-194
273,2022/7/15 11:10,38,63,-25,-84
273,2022/7/15 11:20,43,60,-17,-154
273,2022/7/15 11:30,38,77,-39,-118
273,2022/7/15 11:40,37,66,-29,-110
273,2022/7/15 11:50,37,62,-25,-111
273,2022/7/15 12:00,45,70,-25,-84
273,2022/7/15 12:10,42,91,-49,-73
273,2022/7/15 12:20,45,62,-17,-60
273,2022/7/15 12:30,41,68,-27,-61
273,2022/7/15 12:40,43,63,-20,-54
273,2022/7/15 12:50,44,88,-44,-110
273,2022/7/15 13:00,36,75,-39,-110
273,2022/7/15 13:10,43,62,-19,-82
273,2022/7/15 13:20,39,67,-28,-67
273,2022/7/15 13:30,36,105,-69,-134
273,2022/7/15 13:40,32,77,-45,-157
273,2022/7/15 13:50,35,70,-35,-117
273,2022/7/15 14:00,31,82,-51,-158
273,2022/7/15 14:10,31,110,-79,-145
273,2022/7/15 14:20,32,80,-48,-148
273,2022/7/15 14:30,35,63,-28,-155
273,2022/7/15 14:40,31,72,-41,-204
273,2022/7/15 14:50,27,112,-85,-152
273,2022/7/15 15:00,29,87,-58,-150
273,2022/7/15 15:10,29,76,-47,-224
273,2022/7/15 15:20,31,76,-45,-159
273,2022/7/15 15:30,29,122,-93,-229
273,2022/7/15 15:40,31,99,-68,-266
273,2022/7/15 15:50,32,98,-66,-276
273,2022/7/15 16:00,33,112,-79,-230
273,2022/7/15 16:10,39,130,-91,-234
273,2022/7/15 16:20,36,96,-60,-155
273,2022/7/15 16:30,45,106,-61,-91
273,2022/7/15 16:40,46,118,-72,60
273,2022/7/15 16:50,41,180,-139,-232
273,2022/7/15 17:00,68,106,-38,98
273,2022/7/15 17:10,74,117,-43,-162
273,2022/7/15 17:20,62,267,-205,-292
273,2022/7/15 17:30,47,178,-131,-228
273,2022/7/15 17:40,64,266,-202,-359
273,2022/7/15 17:50,68,328,-260,-510
273,2022/7/15 18:00,43,333,-290,-906
273,2022/7/15 18:10,45,318,-273,-605
273,2022/7/15 18:20,45,301,-256,-1117
273,2022/7/15 18:30,44,323,-279,-1023
273,2022/7/15 18:40,41,327,-286,-1896
273,2022/7/15 18:50,33,303,-270,-1079
273,2022/7/15 19:00,35,366,-331,-1365
273,2022/7/15 19:10,30,378,-348,-1203
273,2022/7/15 19:20,32,348,-316,-1393
273,2022/7/15 19:30,25,191,-166,-914
273,2022/7/15 19:40,29,221,-192,-978
273,2022/7/15 19:50,29,113,-84,-532
273,2022/7/15 20:00,28,185,-157,-676
273,2022/7/15 20:10,24,106,-82,-489
273,2022/7/15 20:20,21,119,-98,-483
273,2022/7/15 20:30,29,107,-78,-458
273,2022/7/15 20:40,20,109,-89,-501
273,2022/7/15 20:50,21,108,-87,-403
273,2022/7/15 21:00,20,192,-172,-472
273,2022/7/15 21:10,17,90,-73,-484
273,2022/7/15 21:20,14,111,-97,-397
273,2022/7/15 21:30,16,108,-92,-412
273,2022/7/15 21:40,17,160,-143,-471
273,2022/7/15 21:50,12,122,-110,-508
273,2022/7/15 22:00,12,98,-86,-518
273,2022/7/15 22:10,9,102,-93,-419
273,2022/7/15 22:20,7,104,-97,-414
273,2022/7/15 22:30,6,106,-100,-460
273,2022/7/15 22:40,1,116,-115,-447
273,2022/7/15 22:50,1,105,-104,-496
272,2022/7/15 5:00,0,1,-1,-6
272,2022/7/15 5:10,0,1,-1,37
272,2022/7/15 5:20,7,1,6,135
272,2022/7/15 5:30,25,1,24,184
272,2022/7/15 5:40,34,8,26,188
272,2022/7/15 5:50,41,2,39,382
272,2022/7/15 6:00,59,5,54,429
272,2022/7/15 6:10,69,8,61,641
272,2022/7/15 6:20,109,45,64,928
272,2022/7/15 6:30,163,47,116,801
272,2022/7/15 6:40,207,58,149,1224
272,2022/7/15 6:50,217,59,158,1346
272,2022/7/15 7:00,217,77,140,1935
272,2022/7/15 7:10,279,71,208,2482
272,2022/7/15 7:20,334,79,255,3265
272,2022/7/15 7:30,478,83,395,3553
272,2022/7/15 7:40,600,77,523,4311
272,2022/7/15 7:50,705,90,615,4715
272,2022/7/15 8:00,742,83,659,4718
272,2022/7/15 8:10,720,111,609,3989
272,2022/7/15 8:20,577,93,484,2822
272,2022/7/15 8:30,393,105,288,1614
272,2022/7/15 8:40,319,88,231,1337
272,2022/7/15 8:50,281,76,205,904
272,2022/7/15 9:00,207,59,148,642
272,2022/7/15 9:10,179,64,115,232
272,2022/7/15 9:20,139,62,77,113
272,2022/7/15 9:30,66,61,5,-61
272,2022/7/15 9:40,51,66,-15,-164
272,2022/7/15 9:50,48,60,-12,-161
272,2022/7/15 10:00,44,60,-16,-168
272,2022/7/15 10:10,37,48,-11,-143
272,2022/7/15 10:20,31,47,-16,-83
272,2022/7/15 10:30,27,66,-39,-241
272,2022/7/15 10:40,29,50,-21,-215
272,2022/7/15 10:50,35,47,-12,-55
272,2022/7/15 11:00,31,51,-20,-214
272,2022/7/15 11:10,32,68,-36,-120
272,2022/7/15 11:20,29,51,-22,-176
272,2022/7/15 11:30,26,47,-21,-139
272,2022/7/15 11:40,27,54,-27,-137
272,2022/7/15 11:50,30,67,-37,-148
272,2022/7/15 12:00,32,61,-29,-113
272,2022/7/15 12:10,36,62,-26,-99
272,2022/7/15 12:20,35,49,-14,-74
272,2022/7/15 12:30,33,76,-43,-104
272,2022/7/15 12:40,30,52,-22,-76
272,2022/7/15 12:50,28,52,-24,-134
272,2022/7/15 13:00,31,59,-28,-138
272,2022/7/15 13:10,27,70,-43,-125
272,2022/7/15 13:20,29,56,-27,-94
272,2022/7/15 13:30,30,49,-19,-153
272,2022/7/15 13:40,28,61,-33,-190
272,2022/7/15 13:50,25,69,-44,-161
272,2022/7/15 14:00,27,62,-35,-193
272,2022/7/15 14:10,25,66,-41,-186
272,2022/7/15 14:20,27,65,-38,-186
272,2022/7/15 14:30,29,81,-52,-207
272,2022/7/15 14:40,23,67,-44,-248
272,2022/7/15 14:50,25,70,-45,-197
272,2022/7/15 15:00,26,72,-46,-196
272,2022/7/15 15:10,26,90,-64,-288
272,2022/7/15 15:20,24,71,-47,-206
272,2022/7/15 15:30,27,62,-35,-264
272,2022/7/15 15:40,25,70,-45,-311
272,2022/7/15 15:50,27,96,-69,-345
272,2022/7/15 16:00,27,104,-77,-307
272,2022/7/15 16:10,33,74,-41,-275
272,2022/7/15 16:20,30,80,-50,-205
272,2022/7/15 16:30,35,105,-70,-161
272,2022/7/15 16:40,29,106,-77,-17
272,2022/7/15 16:50,33,106,-73,-305
272,2022/7/15 17:00,45,98,-53,45
272,2022/7/15 17:10,46,108,-62,-224
272,2022/7/15 17:20,45,97,-52,-344
272,2022/7/15 17:30,37,184,-147,-375
272,2022/7/15 17:40,36,110,-74,-433
272,2022/7/15 17:50,41,206,-165,-675
272,2022/7/15 18:00,43,108,-65,-971
272,2022/7/15 18:10,39,180,-141,-746
272,2022/7/15 18:20,33,180,-147,-1264
272,2022/7/15 18:30,38,216,-178,-1201
272,2022/7/15 18:40,30,199,-169,-2065
272,2022/7/15 18:50,29,235,-206,-1285
272,2022/7/15 19:00,26,235,-209,-1574
272,2022/7/15 19:10,25,258,-233,-1436
272,2022/7/15 19:20,23,150,-127,-1520
272,2022/7/15 19:30,25,160,-135,-1049
272,2022/7/15 19:40,19,98,-79,-1057
272,2022/7/15 19:50,19,133,-114,-646
272,2022/7/15 20:00,17,105,-88,-764
272,2022/7/15 20:10,19,120,-101,-590
272,2022/7/15 20:20,17,124,-107,-590
272,2022/7/15 20:30,17,115,-98,-556
272,2022/7/15 20:40,20,88,-68,-569
272,2022/7/15 20:50,14,128,-114,-517
272,2022/7/15 21:00,17,105,-88,-560
272,2022/7/15 21:10,15,113,-98,-582
272,2022/7/15 21:20,13,113,-100,-497
272,2022/7/15 21:30,13,89,-76,-488
272,2022/7/15 21:40,13,104,-91,-562
272,2022/7/15 21:50,11,108,-97,-605
272,2022/7/15 22:00,10,104,-94,-612
272,2022/7/15 22:10,9,110,-101,-520
272,2022/7/15 22:20,8,105,-97,-511
272,2022/7/15 22:30,5,153,-148,-608
272,2022/7/15 22:40,2,105,-103,-550
272,2022/7/15 22:50,1,85,-84,-580
287,2022/7/15 5:00,0,1,-1,-7
287,2022/7/15 5:10,0,1,-1,36
287,2022/7/15 5:20,3,1,2,137
287,2022/7/15 5:30,15,1,14,198
287,2022/7/15 5:40,30,2,28,216
287,2022/7/15 5:50,34,5,29,411
287,2022/7/15 6:00,38,2,36,465
287,2022/7/15 6:10,58,23,35,676
287,2022/7/15 6:20,68,21,47,975
287,2022/7/15 6:30,149,38,111,912
287,2022/7/15 6:40,226,62,164,1388
287,2022/7/15 6:50,243,50,193,1539
287,2022/7/15 7:00,265,71,194,2129
287,2022/7/15 7:10,339,69,270,2752
287,2022/7/15 7:20,588,68,520,3785
287,2022/7/15 7:30,703,89,614,4167
287,2022/7/15 7:40,1049,83,966,5277
287,2022/7/15 7:50,1368,97,1271,5986
287,2022/7/15 8:00,1573,108,1465,6183
287,2022/7/15 8:10,1571,108,1463,5452
287,2022/7/15 8:20,1359,111,1248,4070
287,2022/7/15 8:30,1173,121,1052,2666
287,2022/7/15 8:40,831,128,703,2040
287,2022/7/15 8:50,722,107,615,1519
287,2022/7/15 9:00,578,105,473,1115
287,2022/7/15 9:10,342,109,233,465
287,2022/7/15 9:20,276,80,196,309
287,2022/7/15 9:30,225,76,149,88
287,2022/7/15 9:40,167,76,91,-73
287,2022/7/15 9:50,90,72,18,-143
287,2022/7/15 10:00,76,77,-1,-169
287,2022/7/15 10:10,69,68,1,-142
287,2022/7/15 10:20,60,75,-15,-98
287,2022/7/15 10:30,44,70,-26,-267
287,2022/7/15 10:40,46,84,-38,-253
287,2022/7/15 10:50,43,64,-21,-76
287,2022/7/15 11:00,37,80,-43,-257
287,2022/7/15 11:10,40,72,-32,-152
287,2022/7/15 11:20,38,76,-38,-214
287,2022/7/15 11:30,35,69,-34,-173
287,2022/7/15 11:40,38,87,-49,-186
287,2022/7/15 11:50,39,74,-35,-183
287,2022/7/15 12:00,42,93,-51,-164
287,2022/7/15 12:10,47,70,-23,-122
287,2022/7/15 12:20,48,98,-50,-124
287,2022/7/15 12:30,46,82,-36,-140
287,2022/7/15 12:40,44,75,-31,-107
287,2022/7/15 12:50,43,84,-41,-175
287,2022/7/15 13:00,43,93,-50,-188
287,2022/7/15 13:10,45,81,-36,-161
287,2022/7/15 13:20,39,93,-54,-148
287,2022/7/15 13:30,38,81,-43,-196
287,2022/7/15 13:40,39,96,-57,-247
287,2022/7/15 13:50,35,76,-41,-202
287,2022/7/15 14:00,37,90,-53,-246
287,2022/7/15 14:10,28,75,-47,-233
287,2022/7/15 14:20,32,99,-67,-253
287,2022/7/15 14:30,34,87,-53,-260
287,2022/7/15 14:40,32,108,-76,-324
287,2022/7/15 14:50,30,93,-63,-260
287,2022/7/15 15:00,29,112,-83,-279
287,2022/7/15 15:10,36,96,-60,-348
287,2022/7/15 15:20,31,105,-74,-280
287,2022/7/15 15:30,36,103,-67,-331
287,2022/7/15 15:40,31,101,-70,-381
287,2022/7/15 15:50,29,112,-83,-428
287,2022/7/15 16:00,33,106,-73,-380
287,2022/7/15 16:10,36,97,-61,-336
287,2022/7/15 16:20,36,128,-92,-297
287,2022/7/15 16:30,41,124,-83,-244
287,2022/7/15 16:40,37,152,-115,-132
287,2022/7/15 16:50,38,105,-67,-372
287,2022/7/15 17:00,46,177,-131,-86
287,2022/7/15 17:10,77,177,-100,-324
287,2022/7/15 17:20,57,230,-173,-517
287,2022/7/15 17:30,57,324,-267,-642
287,2022/7/15 17:40,96,424,-328,-761
287,2022/7/15 17:50,70,330,-260,-935
287,2022/7/15 18:00,57,429,-372,-1343
287,2022/7/15 18:10,76,428,-352,-1098
287,2022/7/15 18:20,47,420,-373,-1637
287,2022/7/15 18:30,41,402,-361,-1562
287,2022/7/15 18:40,39,413,-374,-2439
287,2022/7/15 18:50,33,419,-386,-1671
287,2022/7/15 19:00,35,440,-405,-1979
287,2022/7/15 19:10,29,375,-346,-1782
287,2022/7/15 19:20,31,330,-299,-1819
287,2022/7/15 19:30,28,224,-196,-1245
287,2022/7/15 19:40,26,207,-181,-1238
287,2022/7/15 19:50,28,167,-139,-785
287,2022/7/15 20:00,27,155,-128,-892
287,2022/7/15 20:10,29,119,-90,-680
287,2022/7/15 20:20,29,107,-78,-668
287,2022/7/15 20:30,28,128,-100,-656
287,2022/7/15 20:40,23,128,-105,-674
287,2022/7/15 20:50,27,116,-89,-606
287,2022/7/15 21:00,28,109,-81,-641
287,2022/7/15 21:10,26,110,-84,-666
287,2022/7/15 21:20,26,117,-91,-588
287,2022/7/15 21:30,27,154,-127,-615
287,2022/7/15 21:40,21,124,-103,-665
287,2022/7/15 21:50,21,110,-89,-694
287,2022/7/15 22:00,23,121,-98,-710
287,2022/7/15 22:10,19,143,-124,-644
287,2022/7/15 22:20,15,116,-101,-612
287,2022/7/15 22:30,12,110,-98,-706
287,2022/7/15 22:40,6,115,-109,-659
287,2022/7/15 22:50,2,105,-103,-683
263,2022/7/15 5:00,0,1,-1,-8
263,2022/7/15 5:10,0,1,-1,35
263,2022/7/15 5:20,2,1,1,138
263,2022/7/15 5:30,15,1,14,212
263,2022/7/15 5:40,38,1,37,253
263,2022/7/15 5:50,36,23,13,424
263,2022/7/15 6:00,55,16,39,504
263,2022/7/15 6:10,76,48,28,704
263,2022/7/15 6:20,197,65,132,1107
263,2022/7/15 6:30,274,60,214,1126
263,2022/7/15 6:40,280,73,207,1595
263,2022/7/15 6:50,339,115,224,1763
263,2022/7/15 7:00,438,108,330,2459
263,2022/7/15 7:10,611,109,502,3254
263,2022/7/15 7:20,723,126,597,4382
263,2022/7/15 7:30,824,111,713,4880
263,2022/7/15 7:40,1172,104,1068,6345
263,2022/7/15 7:50,1367,144,1223,7209
263,2022/7/15 8:00,1573,122,1451,7634
263,2022/7/15 8:10,1597,121,1476,6928
263,2022/7/15 8:20,1360,102,1258,5328
263,2022/7/15 8:30,1212,111,1101,3767
263,2022/7/15 8:40,1047,115,932,2972
263,2022/7/15 8:50,742,120,622,2141
263,2022/7/15 9:00,650,105,545,1660
263,2022/7/15 9:10,468,99,369,834
263,2022/7/15 9:20,329,96,233,542
263,2022/7/15 9:30,278,94,184,272
263,2022/7/15 9:40,226,93,133,60
263,2022/7/15 9:50,173,98,75,-68
263,2022/7/15 10:00,141,77,64,-105
263,2022/7/15 10:10,92,93,-1,-143
263,2022/7/15 10:20,72,76,-4,-102
263,2022/7/15 10:30,69,108,-39,-306
263,2022/7/15 10:40,65,85,-20,-273
263,2022/7/15 10:50,49,101,-52,-128
263,2022/7/15 11:00,48,85,-37,-294
263,2022/7/15 11:10,45,103,-58,-210
263,2022/7/15 11:20,45,74,-29,-243
263,2022/7/15 11:30,50,93,-43,-216
263,2022/7/15 11:40,46,82,-36,-222
263,2022/7/15 11:50,54,106,-52,-235
263,2022/7/15 12:00,65,90,-25,-189
263,2022/7/15 12:10,70,100,-30,-152
263,2022/7/15 12:20,70,83,-13,-137
263,2022/7/15 12:30,73,109,-36,-176
263,2022/7/15 12:40,64,90,-26,-133
263,2022/7/15 12:50,69,105,-36,-211
263,2022/7/15 13:00,62,93,-31,-219
263,2022/7/15 13:10,58,104,-46,-207
263,2022/7/15 13:20,63,77,-14,-162
263,2022/7/15 13:30,61,112,-51,-247
263,2022/7/15 13:40,54,90,-36,-283
263,2022/7/15 13:50,41,109,-68,-270
263,2022/7/15 14:00,43,91,-48,-294
263,2022/7/15 14:10,42,105,-63,-296
263,2022/7/15 14:20,43,89,-46,-299
263,2022/7/15 14:30,43,121,-78,-338
263,2022/7/15 14:40,50,110,-60,-384
263,2022/7/15 14:50,45,118,-73,-333
263,2022/7/15 15:00,43,101,-58,-337
263,2022/7/15 15:10,43,124,-81,-429
263,2022/7/15 15:20,76,106,-30,-310
263,2022/7/15 15:30,58,133,-75,-406
263,2022/7/15 15:40,51,101,-50,-431
263,2022/7/15 15:50,47,150,-103,-531
263,2022/7/15 16:00,55,119,-64,-444
263,2022/7/15 16:10,59,150,-91,-427
263,2022/7/15 16:20,68,110,-42,-339
263,2022/7/15 16:30,81,226,-145,-389
263,2022/7/15 16:40,74,117,-43,-175
263,2022/7/15 16:50,85,197,-112,-484
263,2022/7/15 17:00,134,251,-117,-203
263,2022/7/15 17:10,157,252,-95,-419
263,2022/7/15 17:20,138,375,-237,-754
263,2022/7/15 17:30,179,318,-139,-781
263,2022/7/15 17:40,182,499,-317,-1078
263,2022/7/15 17:50,77,523,-446,-1381
263,2022/7/15 18:00,68,417,-349,-1692
263,2022/7/15 18:10,102,420,-318,-1416
263,2022/7/15 18:20,57,431,-374,-2011
263,2022/7/15 18:30,51,419,-368,-1930
263,2022/7/15 18:40,46,490,-444,-2883
263,2022/7/15 18:50,41,431,-390,-2061
263,2022/7/15 19:00,37,503,-466,-2445
263,2022/7/15 19:10,37,321,-284,-2066
263,2022/7/15 19:20,32,299,-267,-2086
263,2022/7/15 19:30,28,221,-193,-1438
263,2022/7/15 19:40,28,177,-149,-1387
263,2022/7/15 19:50,28,169,-141,-926
263,2022/7/15 20:00,30,111,-81,-973
263,2022/7/15 20:10,35,109,-74,-754
263,2022/7/15 20:20,27,111,-84,-752
263,2022/7/15 20:30,29,110,-81,-737
263,2022/7/15 20:40,27,138,-111,-785
263,2022/7/15 20:50,27,127,-100,-706
263,2022/7/15 21:00,29,191,-162,-803
263,2022/7/15 21:10,35,116,-81,-747
263,2022/7/15 21:20,28,107,-79,-667
263,2022/7/15 21:30,27,111,-84,-699
263,2022/7/15 21:40,24,150,-126,-791
263,2022/7/15 21:50,23,128,-105,-799
263,2022/7/15 22:00,21,119,-98,-808
263,2022/7/15 22:10,17,118,-101,-745
263,2022/7/15 22:20,15,112,-97,-709
263,2022/7/15 22:30,13,109,-96,-802
263,2022/7/15 22:40,11,105,-94,-753
263,2022/7/15 22:50,3,77,-74,-757
288,2022/7/15 5:00,0,1,-1,-9
288,2022/7/15 5:10,0,1,-1,34
288,2022/7/15 5:20,2,1,1,139
288,2022/7/15 5:30,11,1,10,222
288,2022/7/15 5:40,26,2,24,277
288,2022/7/15 5:50,32,24,8,432
288,2022/7/15 6:00,39,16,23,527
288,2022/7/15 6:10,54,52,2,706
288,2022/7/15 6:20,64,51,13,1120
288,2022/7/15 6:30,88,60,28,1154
288,2022/7/15 6:40,152,75,77,1672
288,2022/7/15 6:50,200,95,105,1868
288,2022/7/15 7:00,228,124,104,2563
288,2022/7/15 7:10,257,128,129,3383
288,2022/7/15 7:20,301,112,189,4571
288,2022/7/15 7:30,397,128,269,5149
288,2022/7/15 7:40,656,103,553,6898
288,2022/7/15 7:50,821,123,698,7907
288,2022/7/15 8:00,859,138,721,8355
288,2022/7/15 8:10,870,146,724,7652
288,2022/7/15 8:20,1056,232,824,6152
288,2022/7/15 8:30,824,218,606,4373
288,2022/7/15 8:40,689,234,455,3427
288,2022/7/15 8:50,599,192,407,2548
288,2022/7/15 9:00,380,117,263,1923
288,2022/7/15 9:10,314,109,205,1039
288,2022/7/15 9:20,275,105,170,712
288,2022/7/15 9:30,214,123,91,363
288,2022/7/15 9:40,141,119,22,82
288,2022/7/15 9:50,79,118,-39,-107
288,2022/7/15 10:00,68,97,-29,-134
288,2022/7/15 10:10,63,105,-42,-185
288,2022/7/15 10:20,48,103,-55,-157
288,2022/7/15 10:30,46,97,-51,-357
288,2022/7/15 10:40,45,103,-58,-331
288,2022/7/15 10:50,41,112,-71,-199
288,2022/7/15 11:00,42,108,-66,-360
288,2022/7/15 11:10,44,90,-46,-256
288,2022/7/15 11:20,40,112,-72,-315
288,2022/7/15 11:30,41,104,-63,-279
288,2022/7/15 11:40,43,112,-69,-291
288,2022/7/15 11:50,43,105,-62,-297
288,2022/7/15 12:00,44,106,-62,-251
288,2022/7/15 12:10,48,101,-53,-205
288,2022/7/15 12:20,52,103,-51,-188
288,2022/7/15 12:30,58,105,-47,-223
288,2022/7/15 12:40,51,87,-36,-169
288,2022/7/15 12:50,63,103,-40,-251
288,2022/7/15 13:00,51,119,-68,-287
288,2022/7/15 13:10,63,103,-40,-247
288,2022/7/15 13:20,51,108,-57,-219
288,2022/7/15 13:30,47,104,-57,-304
288,2022/7/15 13:40,52,125,-73,-356
288,2022/7/15 13:50,48,108,-60,-330
288,2022/7/15 14:00,42,102,-60,-354
288,2022/7/15 14:10,53,110,-57,-353
288,2022/7/15 14:20,45,114,-69,-368
288,2022/7/15 14:30,51,118,-67,-405
288,2022/7/15 14:40,57,125,-68,-452
288,2022/7/15 14:50,60,122,-62,-395
288,2022/7/15 15:00,54,123,-69,-406
288,2022/7/15 15:10,71,113,-42,-471
288,2022/7/15 15:20,56,110,-54,-364
288,2022/7/15 15:30,67,114,-47,-453
288,2022/7/15 15:40,71,117,-46,-477
288,2022/7/15 15:50,73,108,-35,-566
288,2022/7/15 16:00,65,119,-54,-498
288,2022/7/15 16:10,110,110,0,-427
288,2022/7/15 16:20,72,144,-72,-411
288,2022/7/15 16:30,149,152,-3,-392
288,2022/7/15 16:40,195,191,4,-171
288,2022/7/15 16:50,151,192,-41,-525
288,2022/7/15 17:00,181,204,-23,-226
288,2022/7/15 17:10,203,265,-62,-481
288,2022/7/15 17:20,205,330,-125,-879
288,2022/7/15 17:30,212,523,-311,-1092
288,2022/7/15 17:40,200,533,-333,-1411
288,2022/7/15 17:50,228,417,-189,-1570
288,2022/7/15 18:00,177,434,-257,-1949
288,2022/7/15 18:10,148,430,-282,-1698
288,2022/7/15 18:20,80,425,-345,-2356
288,2022/7/15 18:30,75,475,-400,-2330
288,2022/7/15 18:40,63,491,-428,-3311
288,2022/7/15 18:50,55,431,-376,-2437
288,2022/7/15 19:00,50,421,-371,-2816
288,2022/7/15 19:10,52,341,-289,-2355
288,2022/7/15 19:20,46,300,-254,-2340
288,2022/7/15 19:30,44,217,-173,-1611
288,2022/7/15 19:40,45,221,-176,-1563
288,2022/7/15 19:50,39,169,-130,-1056
288,2022/7/15 20:00,46,142,-96,-1069
288,2022/7/15 20:10,60,144,-84,-838
288,2022/7/15 20:20,47,128,-81,-833
288,2022/7/15 20:30,54,121,-67,-804
288,2022/7/15 20:40,51,123,-72,-857
288,2022/7/15 20:50,46,133,-87,-793
288,2022/7/15 21:00,51,106,-55,-858
288,2022/7/15 21:10,55,109,-54,-801
288,2022/7/15 21:20,46,116,-70,-737
288,2022/7/15 21:30,44,110,-66,-765
288,2022/7/15 21:40,43,123,-80,-871
288,2022/7/15 21:50,39,119,-80,-879
288,2022/7/15 22:00,139,102,37,-771
288,2022/7/15 22:10,50,128,-78,-823
288,2022/7/15 22:20,23,122,-99,-808
288,2022/7/15 22:30,18,108,-90,-892
288,2022/7/15 22:40,13,109,-96,-849
288,2022/7/15 22:50,6,78,-72,-829
289,2022/7/15 5:00,0,1,-1,-10
289,2022/7/15 5:10,0,1,-1,33
289,2022/7/15 5:20,0,1,-1,138
289,2022/7/15 5:30,0,1,-1,221
289,2022/7/15 5:40,0,1,-1,276
289,2022/7/15 5:50,0,1,-1,431
289,2022/7/15 6:00,3,1,2,529
289,2022/7/15 6:10,9,11,-2,704
289,2022/7/15 6:20,3,19,-16,1104
289,2022/7/15 6:30,4,13,-9,1145
289,2022/7/15 6:40,5,15,-10,1662
289,2022/7/15 6:50,4,29,-25,1843
289,2022/7/15 7:00,4,38,-34,2529
289,2022/7/15 7:10,5,38,-33,3350
289,2022/7/15 7:20,10,47,-37,4534
289,2022/7/15 7:30,12,70,-58,5091
289,2022/7/15 7:40,14,70,-56,6842
289,2022/7/15 7:50,17,85,-68,7839
289,2022/7/15 8:00,18,83,-65,8290
289,2022/7/15 8:10,16,73,-57,7595
289,2022/7/15 8:20,17,75,-58,6094
289,2022/7/15 8:30,15,90,-75,4298
289,2022/7/15 8:40,8,104,-96,3331
289,2022/7/15 8:50,11,110,-99,2449
289,2022/7/15 9:00,10,102,-92,1831
289,2022/7/15 9:10,5,126,-121,918
289,2022/7/15 9:20,7,109,-102,610
289,2022/7/15 9:30,6,105,-99,264
289,2022/7/15 9:40,5,96,-91,-9
289,2022/7/15 9:50,6,90,-84,-191
289,2022/7/15 10:00,7,77,-70,-204
289,2022/7/15 10:10,5,76,-71,-256
289,2022/7/15 10:20,8,74,-66,-223
289,2022/7/15 10:30,11,81,-70,-427
289,2022/7/15 10:40,10,69,-59,-390
289,2022/7/15 10:50,11,69,-58,-257
289,2022/7/15 11:00,12,64,-52,-412
289,2022/7/15 11:10,15,63,-48,-304
289,2022/7/15 11:20,16,60,-44,-359
289,2022/7/15 11:30,14,69,-55,-334
289,2022/7/15 11:40,16,64,-48,-339
289,2022/7/15 11:50,17,62,-45,-342
289,2022/7/15 12:00,16,56,-40,-291
289,2022/7/15 12:10,16,68,-52,-257
289,2022/7/15 12:20,20,64,-44,-232
289,2022/7/15 12:30,17,56,-39,-262
289,2022/7/15 12:40,17,63,-46,-215
289,2022/7/15 12:50,21,68,-47,-298
289,2022/7/15 13:00,22,57,-35,-322
289,2022/7/15 13:10,21,61,-40,-287
289,2022/7/15 13:20,20,61,-41,-260
289,2022/7/15 13:30,25,70,-45,-349
289,2022/7/15 13:40,23,56,-33,-389
289,2022/7/15 13:50,27,68,-41,-371
289,2022/7/15 14:00,25,56,-31,-385
289,2022/7/15 14:10,22,67,-45,-398
289,2022/7/15 14:20,23,59,-36,-404
289,2022/7/15 14:30,25,64,-39,-444
289,2022/7/15 14:40,23,57,-34,-486
289,2022/7/15 14:50,24,70,-46,-441
289,2022/7/15 15:00,23,55,-32,-438
289,2022/7/15 15:10,23,57,-34,-505
289,2022/7/15 15:20,24,57,-33,-397
289,2022/7/15 15:30,27,69,-42,-495
289,2022/7/15 15:40,26,51,-25,-502
289,2022/7/15 15:50,25,60,-35,-601
289,2022/7/15 16:00,29,57,-28,-526
289,2022/7/15 16:10,28,61,-33,-460
289,2022/7/15 16:20,24,64,-40,-451
289,2022/7/15 16:30,34,68,-34,-426
289,2022/7/15 16:40,28,63,-35,-206
289,2022/7/15 16:50,36,72,-36,-561
289,2022/7/15 17:00,43,69,-26,-252
289,2022/7/15 17:10,51,70,-19,-500
289,2022/7/15 17:20,41,81,-40,-919
289,2022/7/15 17:30,34,87,-53,-1145
289,2022/7/15 17:40,44,90,-46,-1457
289,2022/7/15 17:50,30,96,-66,-1636
289,2022/7/15 18:00,31,102,-71,-2020
289,2022/7/15 18:10,28,96,-68,-1766
289,2022/7/15 18:20,28,102,-74,-2430
289,2022/7/15 18:30,29,101,-72,-2402
289,2022/7/15 18:40,26,102,-76,-3387
289,2022/7/15 18:50,20,94,-74,-2511
289,2022/7/15 19:00,21,88,-67,-2883
289,2022/7/15 19:10,26,98,-72,-2427
289,2022/7/15 19:20,25,73,-48,-2388
289,2022/7/15 19:30,23,71,-48,-1659
289,2022/7/15 19:40,24,62,-38,-1601
289,2022/7/15 19:50,25,48,-23,-1079
289,2022/7/15 20:00,29,38,-9,-1078
289,2022/7/15 20:10,32,39,-7,-845
289,2022/7/15 20:20,28,33,-5,-838
289,2022/7/15 20:30,31,32,-1,-805
289,2022/7/15 20:40,27,30,-3,-860
289,2022/7/15 20:50,27,23,4,-789
289,2022/7/15 21:00,36,25,11,-847
289,2022/7/15 21:10,39,25,14,-787
289,2022/7/15 21:20,35,21,14,-723
289,2022/7/15 21:30,45,21,24,-741
289,2022/7/15 21:40,36,21,15,-856
289,2022/7/15 21:50,35,18,17,-862
289,2022/7/15 22:00,109,13,96,-675
289,2022/7/15 22:10,66,13,53,-770
289,2022/7/15 22:20,20,15,5,-803
289,2022/7/15 22:30,14,15,-1,-893
289,2022/7/15 22:40,10,3,7,-842
289,2022/7/15 22:50,7,4,3,-826
284,2022/7/15 5:00,0,1,-1,-11
284,2022/7/15 5:10,0,1,-1,32
284,2022/7/15 5:20,3,1,2,140
284,2022/7/15 5:30,9,1,8,229
284,2022/7/15 5:40,12,8,4,280
284,2022/7/15 5:50,24,38,-14,417
284,2022/7/15 6:00,34,62,-28,501
284,2022/7/15 6:10,47,77,-30,674
284,2022/7/15 6:20,60,106,-46,1058
284,2022/7/15 6:30,88,123,-35,1110
284,2022/7/15 6:40,153,197,-44,1618
284,2022/7/15 6:50,187,383,-196,1647
284,2022/7/15 7:00,234,381,-147,2382
284,2022/7/15 7:10,283,506,-223,3127
284,2022/7/15 7:20,287,508,-221,4313
284,2022/7/15 7:30,302,425,-123,4968
284,2022/7/15 7:40,445,1212,-767,6075
284,2022/7/15 7:50,632,491,141,7980
284,2022/7/15 8:00,689,432,257,8547
284,2022/7/15 8:10,724,428,296,7891
284,2022/7/15 8:20,686,430,256,6350
284,2022/7/15 8:30,665,427,238,4536
284,2022/7/15 8:40,603,1189,-586,2745
284,2022/7/15 8:50,439,575,-136,2313
284,2022/7/15 9:00,319,488,-169,1662
284,2022/7/15 9:10,322,428,-106,812
284,2022/7/15 9:20,275,427,-152,458
284,2022/7/15 9:30,277,344,-67,197
284,2022/7/15 9:40,231,254,-23,-32
284,2022/7/15 9:50,237,281,-44,-235
284,2022/7/15 10:00,213,159,54,-150
284,2022/7/15 10:10,213,179,34,-222
284,2022/7/15 10:20,205,133,72,-151
284,2022/7/15 10:30,190,154,36,-391
284,2022/7/15 10:40,185,110,75,-315
284,2022/7/15 10:50,182,110,72,-185
284,2022/7/15 11:00,184,125,59,-353
284,2022/7/15 11:10,174,125,49,-255
284,2022/7/15 11:20,178,122,56,-303
284,2022/7/15 11:30,185,124,61,-273
284,2022/7/15 11:40,174,115,59,-280
284,2022/7/15 11:50,176,110,66,-276
284,2022/7/15 12:00,163,107,56,-235
284,2022/7/15 12:10,163,120,43,-214
284,2022/7/15 12:20,138,121,17,-215
284,2022/7/15 12:30,137,146,-9,-271
284,2022/7/15 12:40,114,117,-3,-218
284,2022/7/15 12:50,136,197,-61,-359
284,2022/7/15 13:00,93,192,-99,-421
284,2022/7/15 13:10,89,198,-109,-396
284,2022/7/15 13:20,98,180,-82,-342
284,2022/7/15 13:30,102,192,-90,-439
284,2022/7/15 13:40,136,140,-4,-393
284,2022/7/15 13:50,168,159,9,-362
284,2022/7/15 14:00,186,120,66,-319
284,2022/7/15 14:10,206,143,63,-335
284,2022/7/15 14:20,216,105,111,-293
284,2022/7/15 14:30,211,181,30,-414
284,2022/7/15 14:40,223,121,102,-384
284,2022/7/15 14:50,237,110,127,-314
284,2022/7/15 15:00,257,123,134,-304
284,2022/7/15 15:10,265,120,145,-360
284,2022/7/15 15:20,274,110,164,-233
284,2022/7/15 15:30,271,109,162,-333
284,2022/7/15 15:40,335,105,230,-272
284,2022/7/15 15:50,336,119,217,-384
284,2022/7/15 16:00,352,109,243,-283
284,2022/7/15 16:10,310,109,201,-259
284,2022/7/15 16:20,359,119,240,-211
284,2022/7/15 16:30,632,152,480,54
284,2022/7/15 16:40,714,111,603,397
284,2022/7/15 16:50,637,152,485,-76
284,2022/7/15 17:00,800,140,660,408
284,2022/7/15 17:10,1024,176,848,348
284,2022/7/15 17:20,652,221,431,-488
284,2022/7/15 17:30,639,324,315,-830
284,2022/7/15 17:40,791,266,525,-932
284,2022/7/15 17:50,610,332,278,-1358
284,2022/7/15 18:00,579,335,244,-1776
284,2022/7/15 18:10,724,320,404,-1362
284,2022/7/15 18:20,609,300,309,-2121
284,2022/7/15 18:30,370,328,42,-2360
284,2022/7/15 18:40,326,271,55,-3332
284,2022/7/15 18:50,274,233,41,-2470
284,2022/7/15 19:00,224,179,45,-2838
284,2022/7/15 19:10,191,150,41,-2386
284,2022/7/15 19:20,183,133,50,-2338
284,2022/7/15 19:30,138,109,29,-1630
284,2022/7/15 19:40,132,99,33,-1568
284,2022/7/15 19:50,72,122,-50,-1129
284,2022/7/15 20:00,70,106,-36,-1114
284,2022/7/15 20:10,83,109,-26,-871
284,2022/7/15 20:20,70,101,-31,-869
284,2022/7/15 20:30,51,105,-54,-859
284,2022/7/15 20:40,65,99,-34,-894
284,2022/7/15 20:50,54,111,-57,-846
284,2022/7/15 21:00,55,113,-58,-905
284,2022/7/15 21:10,62,108,-46,-833
284,2022/7/15 21:20,44,121,-77,-800
284,2022/7/15 21:30,45,120,-75,-816
284,2022/7/15 21:40,46,106,-60,-916
284,2022/7/15 21:50,37,106,-69,-931
284,2022/7/15 22:00,26,105,-79,-754
284,2022/7/15 22:10,30,102,-72,-842
284,2022/7/15 22:20,26,103,-77,-880
284,2022/7/15 22:30,18,92,-74,-967
284,2022/7/15 22:40,14,77,-63,-905
284,2022/7/15 22:50,9,64,-55,-881
274,2022/7/15 5:00,0,1,-1,-12
274,2022/7/15 5:10,0,1,-1,31
274,2022/7/15 5:20,2,1,1,141
274,2022/7/15 5:30,9,1,8,237
274,2022/7/15 5:40,12,8,4,284
274,2022/7/15 5:50,29,2,27,444
274,2022/7/15 6:00,35,61,-26,475
274,2022/7/15 6:10,37,63,-26,648
274,2022/7/15 6:20,47,83,-36,1022
274,2022/7/15 6:30,76,75,1,1111
274,2022/7/15 6:40,108,110,-2,1616
274,2022/7/15 6:50,163,197,-34,1613
274,2022/7/15 7:00,192,439,-247,2135
274,2022/7/15 7:10,255,419,-164,2963
274,2022/7/15 7:20,260,425,-165,4148
274,2022/7/15 7:30,278,426,-148,4820
274,2022/7/15 7:40,371,500,-129,5946
274,2022/7/15 7:50,631,506,125,8105
274,2022/7/15 8:00,690,425,265,8812
274,2022/7/15 8:10,687,600,87,7978
274,2022/7/15 8:20,725,560,165,6515
274,2022/7/15 8:30,655,601,54,4590
274,2022/7/15 8:40,595,1591,-996,1749
274,2022/7/15 8:50,337,1168,-831,1482
274,2022/7/15 9:00,340,426,-86,1576
274,2022/7/15 9:10,312,426,-114,698
274,2022/7/15 9:20,278,376,-98,360
274,2022/7/15 9:30,270,324,-54,143
274,2022/7/15 9:40,230,325,-95,-127
274,2022/7/15 9:50,219,178,41,-194
274,2022/7/15 10:00,207,186,21,-129
274,2022/7/15 10:10,189,147,42,-180
274,2022/7/15 10:20,194,152,42,-109
274,2022/7/15 10:30,174,105,69,-322
274,2022/7/15 10:40,176,112,64,-251
274,2022/7/15 10:50,163,125,38,-147
274,2022/7/15 11:00,163,108,55,-298
274,2022/7/15 11:10,175,126,49,-206
274,2022/7/15 11:20,156,110,46,-257
274,2022/7/15 11:30,192,119,73,-200
274,2022/7/15 11:40,185,110,75,-205
274,2022/7/15 11:50,272,114,158,-118
274,2022/7/15 12:00,203,119,84,-151
274,2022/7/15 12:10,213,109,104,-110
274,2022/7/15 12:20,175,112,63,-152
274,2022/7/15 12:30,197,110,87,-184
274,2022/7/15 12:40,192,170,22,-196
274,2022/7/15 12:50,177,128,49,-310
274,2022/7/15 13:00,179,192,-13,-434
274,2022/7/15 13:10,211,128,83,-313
274,2022/7/15 13:20,184,185,-1,-343
274,2022/7/15 13:30,174,120,54,-385
274,2022/7/15 13:40,185,181,4,-389
274,2022/7/15 13:50,185,105,80,-282
274,2022/7/15 14:00,192,169,23,-296
274,2022/7/15 14:10,207,111,96,-239
274,2022/7/15 14:20,202,119,83,-210
274,2022/7/15 14:30,231,111,120,-294
274,2022/7/15 14:40,351,119,232,-152
274,2022/7/15 14:50,332,109,223,-91
274,2022/7/15 15:00,269,144,125,-179
274,2022/7/15 15:10,319,109,210,-150
274,2022/7/15 15:20,264,120,144,-89
274,2022/7/15 15:30,303,133,170,-163
274,2022/7/15 15:40,333,170,163,-109
274,2022/7/15 15:50,316,133,183,-201
274,2022/7/15 16:00,349,110,239,-44
274,2022/7/15 16:10,328,110,218,-41
274,2022/7/15 16:20,311,185,126,-85
274,2022/7/15 16:30,314,121,193,247
274,2022/7/15 16:40,361,192,169,566
274,2022/7/15 16:50,380,183,197,121
274,2022/7/15 17:00,707,189,518,926
274,2022/7/15 17:10,833,205,628,976
274,2022/7/15 17:20,634,296,338,-150
274,2022/7/15 17:30,680,341,339,-491
274,2022/7/15 17:40,789,331,458,-474
274,2022/7/15 17:50,574,381,193,-1165
274,2022/7/15 18:00,642,433,209,-1567
274,2022/7/15 18:10,715,378,337,-1025
274,2022/7/15 18:20,571,326,245,-1876
274,2022/7/15 18:30,317,382,-65,-2425
274,2022/7/15 18:40,276,327,-51,-3383
274,2022/7/15 18:50,216,299,-83,-2553
274,2022/7/15 19:00,186,198,-12,-2850
274,2022/7/15 19:10,175,184,-9,-2395
274,2022/7/15 19:20,142,182,-40,-2378
274,2022/7/15 19:30,115,120,-5,-1635
274,2022/7/15 19:40,88,113,-25,-1593
274,2022/7/15 19:50,85,124,-39,-1168
274,2022/7/15 20:00,76,121,-45,-1159
274,2022/7/15 20:10,137,121,16,-855
274,2022/7/15 20:20,83,108,-25,-894
274,2022/7/15 20:30,80,111,-31,-890
274,2022/7/15 20:40,89,127,-38,-932
274,2022/7/15 20:50,84,106,-22,-868
274,2022/7/15 21:00,96,120,-24,-929
274,2022/7/15 21:10,88,125,-37,-870
274,2022/7/15 21:20,54,121,-67,-867
274,2022/7/15 21:30,40,114,-74,-890
274,2022/7/15 21:40,44,101,-57,-973
274,2022/7/15 21:50,40,122,-82,-1013
274,2022/7/15 22:00,43,109,-66,-820
274,2022/7/15 22:10,37,107,-70,-912
274,2022/7/15 22:20,25,123,-98,-978
274,2022/7/15 22:30,21,105,-84,-1051
274,2022/7/15 22:40,13,85,-72,-977
274,2022/7/15 22:50,11,67,-56,-937
270,2022/7/15 5:00,0,1,-1,-13
270,2022/7/15 5:10,1,1,0,31
270,2022/7/15 5:20,1,1,0,141
270,2022/7/15 5:30,8,1,7,244
270,2022/7/15 5:40,19,1,18,302
270,2022/7/15 5:50,36,11,25,469
270,2022/7/15 6:00,35,42,-7,468
270,2022/7/15 6:10,47,51,-4,644
270,2022/7/15 6:20,53,65,-12,1010
270,2022/7/15 6:30,72,76,-4,1107
270,2022/7/15 6:40,70,93,-23,1593
270,2022/7/15 6:50,150,104,46,1659
270,2022/7/15 7:00,165,119,46,2181
270,2022/7/15 7:10,190,109,81,3044
270,2022/7/15 7:20,200,110,90,4238
270,2022/7/15 7:30,216,147,69,4889
270,2022/7/15 7:40,258,235,23,5969
270,2022/7/15 7:50,338,270,68,8173
270,2022/7/15 8:00,369,333,36,8848
270,2022/7/15 8:10,575,501,74,8052
270,2022/7/15 8:20,446,443,3,6518
270,2022/7/15 8:30,481,420,61,4651
270,2022/7/15 8:40,351,630,-279,1470
270,2022/7/15 8:50,278,580,-302,1180
270,2022/7/15 9:00,269,508,-239,1337
270,2022/7/15 9:10,238,324,-86,612
270,2022/7/15 9:20,219,331,-112,248
270,2022/7/15 9:30,177,254,-77,66
270,2022/7/15 9:40,145,217,-72,-199
270,2022/7/15 9:50,108,220,-112,-306
270,2022/7/15 10:00,100,144,-44,-173
270,2022/7/15 10:10,91,139,-48,-228
270,2022/7/15 10:20,76,124,-48,-157
270,2022/7/15 10:30,76,110,-34,-356
270,2022/7/15 10:40,73,124,-51,-302
270,2022/7/15 10:50,67,123,-56,-203
270,2022/7/15 11:00,65,122,-57,-355
270,2022/7/15 11:10,70,101,-31,-237
270,2022/7/15 11:20,76,109,-33,-290
270,2022/7/15 11:30,86,101,-15,-215
270,2022/7/15 11:40,76,119,-43,-248
270,2022/7/15 11:50,108,122,-14,-132
270,2022/7/15 12:00,101,125,-24,-175
270,2022/7/15 12:10,92,110,-18,-128
270,2022/7/15 12:20,102,107,-5,-157
270,2022/7/15 12:30,88,108,-20,-204
270,2022/7/15 12:40,110,115,-5,-201
270,2022/7/15 12:50,82,106,-24,-334
270,2022/7/15 13:00,132,121,11,-423
270,2022/7/15 13:10,92,106,-14,-327
270,2022/7/15 13:20,104,122,-18,-361
270,2022/7/15 13:30,96,109,-13,-398
270,2022/7/15 13:40,114,121,-7,-396
270,2022/7/15 13:50,89,109,-20,-302
270,2022/7/15 14:00,130,122,8,-288
270,2022/7/15 14:10,96,121,-25,-264
270,2022/7/15 14:20,128,104,24,-186
270,2022/7/15 14:30,102,114,-12,-306
270,2022/7/15 14:40,132,117,15,-137
270,2022/7/15 14:50,131,108,23,-68
270,2022/7/15 15:00,128,124,4,-175
270,2022/7/15 15:10,174,109,65,-85
270,2022/7/15 15:20,175,121,54,-35
270,2022/7/15 15:30,164,105,59,-104
270,2022/7/15 15:40,174,121,53,-56
270,2022/7/15 15:50,174,125,49,-152
270,2022/7/15 16:00,210,116,94,50
270,2022/7/15 16:10,218,125,93,52
270,2022/7/15 16:20,205,109,96,11
270,2022/7/15 16:30,265,125,140,387
270,2022/7/15 16:40,269,106,163,729
270,2022/7/15 16:50,265,112,153,274
270,2022/7/15 17:00,546,110,436,1362
270,2022/7/15 17:10,580,191,389,1365
270,2022/7/15 17:20,352,212,140,-10
270,2022/7/15 17:30,609,207,402,-89
270,2022/7/15 17:40,699,233,466,-8
270,2022/7/15 17:50,364,283,81,-1084
270,2022/7/15 18:00,581,269,312,-1255
270,2022/7/15 18:10,641,269,372,-653
270,2022/7/15 18:20,355,322,33,-1843
270,2022/7/15 18:30,292,284,8,-2417
270,2022/7/15 18:40,273,197,76,-3307
270,2022/7/15 18:50,237,196,41,-2512
270,2022/7/15 19:00,227,150,77,-2773
270,2022/7/15 19:10,185,117,68,-2327
270,2022/7/15 19:20,134,110,24,-2354
270,2022/7/15 19:30,114,105,9,-1626
270,2022/7/15 19:40,86,122,-36,-1629
270,2022/7/15 19:50,77,107,-30,-1198
270,2022/7/15 20:00,76,107,-31,-1190
270,2022/7/15 20:10,75,113,-38,-893
270,2022/7/15 20:20,70,114,-44,-938
270,2022/7/15 20:30,70,107,-37,-927
270,2022/7/15 20:40,68,113,-45,-977
270,2022/7/15 20:50,61,110,-49,-917
270,2022/7/15 21:00,77,113,-36,-965
270,2022/7/15 21:10,67,104,-37,-907
270,2022/7/15 21:20,45,126,-81,-948
270,2022/7/15 21:30,43,102,-59,-949
270,2022/7/15 21:40,41,110,-69,-1042
270,2022/7/15 21:50,35,107,-72,-1085
270,2022/7/15 22:00,41,113,-72,-892
270,2022/7/15 22:10,29,110,-81,-993
270,2022/7/15 22:20,28,124,-96,-1074
270,2022/7/15 22:30,19,105,-86,-1137
270,2022/7/15 22:40,13,73,-60,-1037
270,2022/7/15 22:50,8,71,-63,-1000
264,2022/7/15 5:00,0,1,-1,-14
264,2022/7/15 5:10,0,1,-1,30
264,2022/7/15 5:20,1,1,0,141
264,2022/7/15 5:30,7,1,6,250
264,2022/7/15 5:40,15,1,14,316
264,2022/7/15 5:50,26,1,25,494
264,2022/7/15 6:00,24,62,-38,430
264,2022/7/15 6:10,20,56,-36,608
264,2022/7/15 6:20,29,68,-39,971
264,2022/7/15 6:30,27,93,-66,1041
264,2022/7/15 6:40,31,125,-94,1499
264,2022/7/15 6:50,34,109,-75,1584
264,2022/7/15 7:00,45,195,-150,2031
264,2022/7/15 7:10,40,157,-117,2927
264,2022/7/15 7:20,51,115,-64,4174
264,2022/7/15 7:30,45,196,-151,4738
264,2022/7/15 7:40,54,326,-272,5697
264,2022/7/15 7:50,58,534,-476,7697
264,2022/7/15 8:00,73,675,-602,8246
264,2022/7/15 8:10,73,2121,-2048,6004
264,2022/7/15 8:20,69,2164,-2095,4423
264,2022/7/15 8:30,74,3042,-2968,1683
264,2022/7/15 8:40,75,7859,-7784,-6314
264,2022/7/15 8:50,60,5741,-5681,-4501
264,2022/7/15 9:00,53,2109,-2056,-719
264,2022/7/15 9:10,50,2106,-2056,-1444
264,2022/7/15 9:20,51,1126,-1075,-827
264,2022/7/15 9:30,48,477,-429,-363
264,2022/7/15 9:40,47,428,-381,-580
264,2022/7/15 9:50,46,434,-388,-694
264,2022/7/15 10:00,48,324,-276,-449
264,2022/7/15 10:10,47,159,-112,-340
264,2022/7/15 10:20,46,213,-167,-324
264,2022/7/15 10:30,53,144,-91,-447
264,2022/7/15 10:40,45,186,-141,-443
264,2022/7/15 10:50,55,105,-50,-253
264,2022/7/15 11:00,51,120,-69,-424
264,2022/7/15 11:10,47,111,-64,-301
264,2022/7/15 11:20,53,121,-68,-358
264,2022/7/15 11:30,62,108,-46,-261
264,2022/7/15 11:40,71,112,-41,-289
264,2022/7/15 11:50,68,124,-56,-188
264,2022/7/15 12:00,66,120,-54,-229
264,2022/7/15 12:10,72,127,-55,-183
264,2022/7/15 12:20,74,129,-55,-212
264,2022/7/15 12:30,76,109,-33,-237
264,2022/7/15 12:40,73,171,-98,-299
264,2022/7/15 12:50,82,109,-27,-361
264,2022/7/15 13:00,102,128,-26,-449
264,2022/7/15 13:10,93,105,-12,-339
264,2022/7/15 13:20,128,111,17,-344
264,2022/7/15 13:30,136,110,26,-372
264,2022/7/15 13:40,142,144,-2,-398
264,2022/7/15 13:50,135,127,8,-294
264,2022/7/15 14:00,137,109,28,-260
264,2022/7/15 14:10,142,123,19,-245
264,2022/7/15 14:20,133,111,22,-164
264,2022/7/15 14:30,131,88,43,-263
264,2022/7/15 14:40,137,110,27,-110
264,2022/7/15 14:50,133,105,28,-40
264,2022/7/15 15:00,166,121,45,-130
264,2022/7/15 15:10,186,106,80,-5
264,2022/7/15 15:20,164,122,42,7
264,2022/7/15 15:30,157,96,61,-43
264,2022/7/15 15:40,183,119,64,8
264,2022/7/15 15:50,162,102,60,-92
264,2022/7/15 16:00,178,117,61,111
264,2022/7/15 16:10,216,106,110,162
264,2022/7/15 16:20,219,104,115,126
264,2022/7/15 16:30,272,114,158,545
264,2022/7/15 16:40,313,111,202,931
264,2022/7/15 16:50,348,111,237,511
264,2022/7/15 17:00,695,123,572,1934
264,2022/7/15 17:10,806,149,657,2022
264,2022/7/15 17:20,656,190,466,456
264,2022/7/15 17:30,1154,211,943,854
264,2022/7/15 17:40,1609,217,1392,1384
264,2022/7/15 17:50,1149,254,895,-189
264,2022/7/15 18:00,1189,321,868,-387
264,2022/7/15 18:10,2511,284,2227,1574
264,2022/7/15 18:20,1583,314,1269,-574
264,2022/7/15 18:30,822,300,522,-1895
264,2022/7/15 18:40,806,294,512,-2795
264,2022/7/15 18:50,608,226,382,-2130
264,2022/7/15 19:00,558,146,412,-2361
264,2022/7/15 19:10,431,109,322,-2005
264,2022/7/15 19:20,347,122,225,-2129
264,2022/7/15 19:30,265,116,149,-1477
264,2022/7/15 19:40,269,106,163,-1466
264,2022/7/15 19:50,271,103,168,-1030
264,2022/7/15 20:00,269,90,179,-1011
264,2022/7/15 20:10,265,86,179,-714
264,2022/7/15 20:20,265,77,188,-750
264,2022/7/15 20:30,273,95,178,-749
264,2022/7/15 20:40,273,76,197,-780
264,2022/7/15 20:50,242,81,161,-756
264,2022/7/15 21:00,274,80,194,-771
264,2022/7/15 21:10,302,81,221,-686
264,2022/7/15 21:20,273,87,186,-762
264,2022/7/15 21:30,228,75,153,-796
264,2022/7/15 21:40,189,77,112,-930
264,2022/7/15 21:50,192,69,123,-962
264,2022/7/15 22:00,168,71,97,-795
264,2022/7/15 22:10,147,73,74,-919
264,2022/7/15 22:20,63,78,-15,-1089
264,2022/7/15 22:30,44,85,-41,-1178
264,2022/7/15 22:40,33,66,-33,-1070
264,2022/7/15 22:50,25,58,-33,-1033
279,2022/7/15 5:00,3,1,2,-12
279,2022/7/15 5:10,4,6,-2,28
279,2022/7/15 5:20,9,5,4,145
279,2022/7/15 5:30,13,8,5,255
279,2022/7/15 5:40,12,13,-1,315
279,2022/7/15 5:50,16,23,-7,487
279,2022/7/15 6:00,23,115,-92,338
279,2022/7/15 6:10,22,117,-95,513
279,2022/7/15 6:20,32,107,-75,896
279,2022/7/15 6:30,32,126,-94,947
279,2022/7/15 6:40,41,222,-181,1318
279,2022/7/15 6:50,38,218,-180,1404
279,2022/7/15 7:00,57,327,-270,1761
279,2022/7/15 7:10,57,373,-316,2611
279,2022/7/15 7:20,56,403,-347,3827
279,2022/7/15 7:30,57,471,-414,4324
279,2022/7/15 7:40,74,1164,-1090,4607
279,2022/7/15 7:50,88,1924,-1836,5861
279,2022/7/15 8:00,112,4571,-4459,3787
279,2022/7/15 8:10,154,5231,-5077,927
279,2022/7/15 8:20,151,6152,-6001,-1578
279,2022/7/15 8:30,164,7061,-6897,-5214
279,2022/7/15 8:40,156,8263,-8107,-14421
279,2022/7/15 8:50,155,5793,-5638,-10139
279,2022/7/15 9:00,167,8649,-8482,-9201
279,2022/7/15 9:10,181,6146,-5965,-7409
279,2022/7/15 9:20,140,4386,-4246,-5073
279,2022/7/15 9:30,150,2949,-2799,-3162
279,2022/7/15 9:40,179,2322,-2143,-2723
279,2022/7/15 9:50,178,2038,-1860,-2554
279,2022/7/15 10:00,175,1188,-1013,-1462
279,2022/7/15 10:10,187,566,-379,-719
279,2022/7/15 10:20,209,470,-261,-585
279,2022/7/15 10:30,210,620,-410,-857
279,2022/7/15 10:40,215,482,-267,-710
279,2022/7/15 10:50,217,412,-195,-448
279,2022/7/15 11:00,234,420,-186,-610
279,2022/7/15 11:10,224,423,-199,-500
279,2022/7/15 11:20,237,428,-191,-549
279,2022/7/15 11:30,267,415,-148,-409
279,2022/7/15 11:40,267,429,-162,-451
279,2022/7/15 11:50,300,429,-129,-317
279,2022/7/15 12:00,344,412,-68,-297
279,2022/7/15 12:10,336,411,-75,-258
279,2022/7/15 12:20,327,428,-101,-313
279,2022/7/15 12:30,351,414,-63,-300
279,2022/7/15 12:40,424,421,3,-296
279,2022/7/15 12:50,424,422,2,-359
279,2022/7/15 13:00,553,427,126,-323
279,2022/7/15 13:10,557,422,135,-204
279,2022/7/15 13:20,579,422,157,-187
279,2022/7/15 13:30,567,426,141,-231
279,2022/7/15 13:40,573,485,88,-310
279,2022/7/15 13:50,575,428,147,-147
279,2022/7/15 14:00,620,427,193,-67
279,2022/7/15 14:10,592,418,174,-71
279,2022/7/15 14:20,607,418,189,25
279,2022/7/15 14:30,622,427,195,-68
279,2022/7/15 14:40,628,424,204,94
279,2022/7/15 14:50,693,484,209,169
279,2022/7/15 15:00,679,527,152,22
279,2022/7/15 15:10,731,492,239,234
279,2022/7/15 15:20,672,485,187,194
279,2022/7/15 15:30,661,491,170,127
279,2022/7/15 15:40,716,491,225,233
279,2022/7/15 15:50,713,487,226,134
279,2022/7/15 16:00,830,491,339,450
279,2022/7/15 16:10,1022,413,609,771
279,2022/7/15 16:20,823,479,344,470
279,2022/7/15 16:30,1018,487,531,1076
279,2022/7/15 16:40,1196,484,712,1643
279,2022/7/15 16:50,1195,422,773,1284
279,2022/7/15 17:00,1987,389,1598,3532
279,2022/7/15 17:10,2517,397,2120,4142
279,2022/7/15 17:20,2030,463,1567,2023
279,2022/7/15 17:30,2535,593,1942,2796
279,2022/7/15 17:40,3506,1126,2380,3764
279,2022/7/15 17:50,3356,1121,2235,2046
279,2022/7/15 18:00,3257,1538,1719,1332
279,2022/7/15 18:10,3452,1561,1891,3465
279,2022/7/15 18:20,3368,1542,1826,1252
279,2022/7/15 18:30,3278,1529,1749,-146
279,2022/7/15 18:40,2525,1514,1011,-1784
279,2022/7/15 18:50,1985,554,1431,-699
279,2022/7/15 19:00,1974,484,1490,-871
279,2022/7/15 19:10,1576,470,1106,-899
279,2022/7/15 19:20,1352,361,991,-1138
279,2022/7/15 19:30,1199,322,877,-600
279,2022/7/15 19:40,1196,234,962,-504
279,2022/7/15 19:50,1017,226,791,-239
279,2022/7/15 20:00,1135,193,942,-69
279,2022/7/15 20:10,1185,116,1069,355
279,2022/7/15 20:20,1194,116,1078,328
279,2022/7/15 20:30,1237,111,1126,377
279,2022/7/15 20:40,1196,115,1081,301
279,2022/7/15 20:50,1242,114,1128,372
279,2022/7/15 21:00,1589,124,1465,694
279,2022/7/15 21:10,1633,121,1512,826
279,2022/7/15 21:20,1432,105,1327,565
279,2022/7/15 21:30,1278,101,1177,381
279,2022/7/15 21:40,1195,111,1084,154
279,2022/7/15 21:50,1292,112,1180,218
279,2022/7/15 22:00,1992,98,1894,1099
279,2022/7/15 22:10,1403,92,1311,392
279,2022/7/15 22:20,313,95,218,-871
279,2022/7/15 22:30,218,78,140,-1038
279,2022/7/15 22:40,123,71,52,-1018
279,2022/7/15 22:50,54,71,-17,-1050
277,2022/7/15 5:00,0,1,-1,-13
277,2022/7/15 5:10,0,1,-1,27
277,2022/7/15 5:20,1,1,0,145
277,2022/7/15 5:30,3,1,2,257
277,2022/7/15 5:40,15,1,14,329
277,2022/7/15 5:50,17,6,11,498
277,2022/7/15 6:00,19,23,-4,334
277,2022/7/15 6:10,30,21,9,522
277,2022/7/15 6:20,31,44,-13,883
277,2022/7/15 6:30,39,52,-13,934
277,2022/7/15 6:40,45,69,-24,1294
277,2022/7/15 6:50,60,98,-38,1366
277,2022/7/15 7:00,64,102,-38,1723
277,2022/7/15 7:10,66,102,-36,2575
277,2022/7/15 7:20,58,105,-47,3780
277,2022/7/15 7:30,87,107,-20,4304
277,2022/7/15 7:40,88,109,-21,4586
277,2022/7/15 7:50,163,171,-8,5853
277,2022/7/15 8:00,187,223,-36,3751
277,2022/7/15 8:10,186,323,-137,790
277,2022/7/15 8:20,147,339,-192,-1770
277,2022/7/15 8:30,103,501,-398,-5612
277,2022/7/15 8:40,91,437,-346,-14767
277,2022/7/15 8:50,78,431,-353,-10492
277,2022/7/15 9:00,79,346,-267,-9468
277,2022/7/15 9:10,69,299,-230,-7639
277,2022/7/15 9:20,50,233,-183,-5256
277,2022/7/15 9:30,43,152,-109,-3271
277,2022/7/15 9:40,45,129,-84,-2807
277,2022/7/15 9:50,37,108,-71,-2625
277,2022/7/15 10:00,29,102,-73,-1535
277,2022/7/15 10:10,36,108,-72,-791
277,2022/7/15 10:20,38,102,-64,-649
277,2022/7/15 10:30,36,114,-78,-935
277,2022/7/15 10:40,31,93,-62,-772
277,2022/7/15 10:50,31,108,-77,-525
277,2022/7/15 11:00,36,93,-57,-667
277,2022/7/15 11:10,38,96,-58,-558
277,2022/7/15 11:20,33,90,-57,-606
277,2022/7/15 11:30,37,100,-63,-472
277,2022/7/15 11:40,34,105,-71,-522
277,2022/7/15 11:50,39,99,-60,-377
277,2022/7/15 12:00,41,93,-52,-349
277,2022/7/15 12:10,36,99,-63,-321
277,2022/7/15 12:20,46,77,-31,-344
277,2022/7/15 12:30,44,104,-60,-360
277,2022/7/15 12:40,45,93,-48,-344
277,2022/7/15 12:50,46,98,-52,-411
277,2022/7/15 13:00,44,101,-57,-380
277,2022/7/15 13:10,43,100,-57,-261
277,2022/7/15 13:20,46,93,-47,-234
277,2022/7/15 13:30,45,110,-65,-296
277,2022/7/15 13:40,45,113,-68,-378
277,2022/7/15 13:50,44,98,-54,-201
277,2022/7/15 14:00,45,90,-45,-112
277,2022/7/15 14:10,44,113,-69,-140
277,2022/7/15 14:20,43,93,-50,-25
277,2022/7/15 14:30,43,106,-63,-131
277,2022/7/15 14:40,42,88,-46,48
277,2022/7/15 14:50,43,101,-58,111
277,2022/7/15 15:00,45,93,-48,-26
277,2022/7/15 15:10,46,96,-50,184
277,2022/7/15 15:20,46,99,-53,141
277,2022/7/15 15:30,49,105,-56,71
277,2022/7/15 15:40,52,105,-53,180
277,2022/7/15 15:50,69,105,-36,98
277,2022/7/15 16:00,72,98,-26,424
277,2022/7/15 16:10,81,105,-24,747
277,2022/7/15 16:20,77,108,-31,439
277,2022/7/15 16:30,100,97,3,1079
277,2022/7/15 16:40,136,108,28,1671
277,2022/7/15 16:50,144,123,21,1305
277,2022/7/15 17:00,272,126,146,3678
277,2022/7/15 17:10,308,110,198,4340
277,2022/7/15 17:20,216,120,96,2119
277,2022/7/15 17:30,307,127,180,2976
277,2022/7/15 17:40,555,127,428,4192
277,2022/7/15 17:50,288,144,144,2190
277,2022/7/15 18:00,271,192,79,1411
277,2022/7/15 18:10,331,159,172,3637
277,2022/7/15 18:20,269,178,91,1343
277,2022/7/15 18:30,259,192,67,-79
277,2022/7/15 18:40,207,192,15,-1769
277,2022/7/15 18:50,180,109,71,-628
277,2022/7/15 19:00,154,130,24,-847
277,2022/7/15 19:10,133,123,10,-889
277,2022/7/15 19:20,82,107,-25,-1163
277,2022/7/15 19:30,73,105,-32,-632
277,2022/7/15 19:40,77,105,-28,-532
277,2022/7/15 19:50,65,95,-30,-269
277,2022/7/15 20:00,73,94,-21,-90
277,2022/7/15 20:10,77,78,-1,354
277,2022/7/15 20:20,68,92,-24,304
277,2022/7/15 20:30,66,89,-23,354
277,2022/7/15 20:40,67,92,-25,276
277,2022/7/15 20:50,72,79,-7,365
277,2022/7/15 21:00,84,74,10,704
277,2022/7/15 21:10,71,75,-4,822
277,2022/7/15 21:20,71,95,-24,541
277,2022/7/15 21:30,60,77,-17,364
277,2022/7/15 21:40,64,84,-20,134
277,2022/7/15 21:50,50,70,-20,198
277,2022/7/15 22:00,76,85,-9,1090
277,2022/7/15 22:10,37,79,-42,350
277,2022/7/15 22:20,23,78,-55,-926
277,2022/7/15 22:30,22,78,-56,-1094
277,2022/7/15 22:40,13,56,-43,-1061
277,2022/7/15 22:50,9,48,-39,-1089
290,2022/7/15 5:00,0,1,-1,-14
290,2022/7/15 5:10,0,1,-1,26
290,2022/7/15 5:20,1,1,0,145
290,2022/7/15 5:30,6,1,5,262
290,2022/7/15 5:40,24,1,23,352
290,2022/7/15 5:50,25,13,12,510
290,2022/7/15 6:00,32,8,24,358
290,2022/7/15 6:10,42,46,-4,518
290,2022/7/15 6:20,51,33,18,901
290,2022/7/15 6:30,58,50,8,942
290,2022/7/15 6:40,88,66,22,1316
290,2022/7/15 6:50,151,77,74,1440
290,2022/7/15 7:00,182,105,77,1800
290,2022/7/15 7:10,216,117,99,2674
290,2022/7/15 7:20,228,121,107,3887
290,2022/7/15 7:30,254,112,142,4446
290,2022/7/15 7:40,322,183,139,4725
290,2022/7/15 7:50,378,159,219,6072
290,2022/7/15 8:00,438,192,246,3997
290,2022/7/15 8:10,446,226,220,1010
290,2022/7/15 8:20,338,146,192,-1578
290,2022/7/15 8:30,360,144,216,-5396
290,2022/7/15 8:40,278,197,81,-14686
290,2022/7/15 8:50,263,154,109,-10383
290,2022/7/15 9:00,227,125,102,-9366
290,2022/7/15 9:10,192,110,82,-7557
290,2022/7/15 9:20,168,118,50,-5206
290,2022/7/15 9:30,115,116,-1,-3272
290,2022/7/15 9:40,76,104,-28,-2835
290,2022/7/15 9:50,58,98,-40,-2665
290,2022/7/15 10:00,50,81,-31,-1566
290,2022/7/15 10:10,46,83,-37,-828
290,2022/7/15 10:20,45,81,-36,-685
290,2022/7/15 10:30,45,75,-30,-965
290,2022/7/15 10:40,37,77,-40,-812
290,2022/7/15 10:50,39,83,-44,-569
290,2022/7/15 11:00,35,77,-42,-709
290,2022/7/15 11:10,43,62,-19,-577
290,2022/7/15 11:20,39,85,-46,-652
290,2022/7/15 11:30,35,70,-35,-507
290,2022/7/15 11:40,35,77,-42,-564
290,2022/7/15 11:50,37,77,-40,-417
290,2022/7/15 12:00,40,76,-36,-385
290,2022/7/15 12:10,39,68,-29,-350
290,2022/7/15 12:20,38,75,-37,-381
290,2022/7/15 12:30,43,76,-33,-393
290,2022/7/15 12:40,43,93,-50,-394
290,2022/7/15 12:50,45,76,-31,-442
290,2022/7/15 13:00,40,99,-59,-439
290,2022/7/15 13:10,41,76,-35,-296
290,2022/7/15 13:20,40,98,-58,-292
290,2022/7/15 13:30,40,76,-36,-332
290,2022/7/15 13:40,38,93,-55,-433
290,2022/7/15 13:50,37,77,-40,-241
290,2022/7/15 14:00,35,92,-57,-169
290,2022/7/15 14:10,38,75,-37,-177
290,2022/7/15 14:20,39,97,-58,-83
290,2022/7/15 14:30,38,88,-50,-181
290,2022/7/15 14:40,37,93,-56,-8
290,2022/7/15 14:50,37,76,-39,72
290,2022/7/15 15:00,43,106,-63,-89
290,2022/7/15 15:10,44,80,-36,148
290,2022/7/15 15:20,37,110,-73,68
290,2022/7/15 15:30,40,90,-50,21
290,2022/7/15 15:40,45,107,-62,118
290,2022/7/15 15:50,42,96,-54,44
290,2022/7/15 16:00,44,108,-64,360
290,2022/7/15 16:10,53,110,-57,690
290,2022/7/15 16:20,45,110,-65,374
290,2022/7/15 16:30,85,110,-25,1054
290,2022/7/15 16:40,177,119,58,1729
290,2022/7/15 16:50,133,101,32,1337
290,2022/7/15 17:00,235,109,126,3804
290,2022/7/15 17:10,265,116,149,4489
290,2022/7/15 17:20,208,151,57,2176
290,2022/7/15 17:30,206,178,28,3004
290,2022/7/15 17:40,238,224,14,4206
290,2022/7/15 17:50,175,196,-21,2169
290,2022/7/15 18:00,177,219,-42,1369
290,2022/7/15 18:10,205,198,7,3644
290,2022/7/15 18:20,136,198,-62,1281
290,2022/7/15 18:30,68,198,-130,-209
290,2022/7/15 18:40,66,209,-143,-1912
290,2022/7/15 18:50,46,180,-134,-762
290,2022/7/15 19:00,47,152,-105,-952
290,2022/7/15 19:10,49,109,-60,-949
290,2022/7/15 19:20,40,106,-66,-1229
290,2022/7/15 19:30,37,128,-91,-723
290,2022/7/15 19:40,39,118,-79,-611
290,2022/7/15 19:50,33,110,-77,-346
290,2022/7/15 20:00,34,107,-73,-163
290,2022/7/15 20:10,39,110,-71,283
290,2022/7/15 20:20,32,113,-81,223
290,2022/7/15 20:30,25,113,-88,266
290,2022/7/15 20:40,28,111,-83,193
290,2022/7/15 20:50,29,105,-76,289
290,2022/7/15 21:00,28,103,-75,629
290,2022/7/15 21:10,27,112,-85,737
290,2022/7/15 21:20,29,103,-74,467
290,2022/7/15 21:30,30,103,-73,291
290,2022/7/15 21:40,28,118,-90,44
290,2022/7/15 21:50,23,111,-88,110
290,2022/7/15 22:00,23,105,-82,1008
290,2022/7/15 22:10,24,107,-83,267
290,2022/7/15 22:20,13,106,-93,-1019
290,2022/7/15 22:30,14,108,-94,-1188
290,2022/7/15 22:40,8,85,-77,-1138
290,2022/7/15 22:50,4,62,-58,-1147
283,2022/7/15 5:00,0,1,-1,-15
283,2022/7/15 5:10,0,1,-1,25
283,2022/7/15 5:20,3,1,2,147
283,2022/7/15 5:30,7,1,6,268
283,2022/7/15 5:40,24,1,23,375
283,2022/7/15 5:50,26,21,5,515
283,2022/7/15 6:00,35,13,22,380
283,2022/7/15 6:10,45,47,-2,516
283,2022/7/15 6:20,57,38,19,920
283,2022/7/15 6:30,77,42,35,977
283,2022/7/15 6:40,163,68,95,1411
283,2022/7/15 6:50,195,93,102,1542
283,2022/7/15 7:00,273,103,170,1970
283,2022/7/15 7:10,277,108,169,2843
283,2022/7/15 7:20,342,102,240,4127
283,2022/7/15 7:30,576,110,466,4912
283,2022/7/15 7:40,633,125,508,5233
283,2022/7/15 7:50,733,147,586,6658
283,2022/7/15 8:00,827,220,607,4604
283,2022/7/15 8:10,864,332,532,1542
283,2022/7/15 8:20,730,253,477,-1101
283,2022/7/15 8:30,655,324,331,-5065
283,2022/7/15 8:40,592,324,268,-14418
283,2022/7/15 8:50,393,318,75,-10308
283,2022/7/15 9:00,341,227,114,-9252
283,2022/7/15 9:10,262,180,82,-7475
283,2022/7/15 9:20,227,179,48,-5158
283,2022/7/15 9:30,189,120,69,-3203
283,2022/7/15 9:40,157,110,47,-2788
283,2022/7/15 9:50,147,110,37,-2628
283,2022/7/15 10:00,114,86,28,-1538
283,2022/7/15 10:10,76,108,-32,-860
283,2022/7/15 10:20,75,93,-18,-703
283,2022/7/15 10:30,66,112,-46,-1011
283,2022/7/15 10:40,62,79,-17,-829
283,2022/7/15 10:50,59,111,-52,-621
283,2022/7/15 11:00,57,77,-20,-729
283,2022/7/15 11:10,61,106,-45,-622
283,2022/7/15 11:20,54,76,-22,-674
283,2022/7/15 11:30,63,104,-41,-548
283,2022/7/15 11:40,54,75,-21,-585
283,2022/7/15 11:50,52,106,-54,-471
283,2022/7/15 12:00,55,77,-22,-407
283,2022/7/15 12:10,58,108,-50,-400
283,2022/7/15 12:20,63,92,-29,-410
283,2022/7/15 12:30,69,106,-37,-430
283,2022/7/15 12:40,62,97,-35,-429
283,2022/7/15 12:50,64,119,-55,-497
283,2022/7/15 13:00,75,100,-25,-464
283,2022/7/15 13:10,76,118,-42,-338
283,2022/7/15 13:20,62,105,-43,-335
283,2022/7/15 13:30,77,127,-50,-382
283,2022/7/15 13:40,69,93,-24,-457
283,2022/7/15 13:50,65,107,-42,-283
283,2022/7/15 14:00,57,105,-48,-217
283,2022/7/15 14:10,52,104,-52,-229
283,2022/7/15 14:20,62,109,-47,-130
283,2022/7/15 14:30,69,123,-54,-235
283,2022/7/15 14:40,51,109,-58,-66
283,2022/7/15 14:50,59,124,-65,7
283,2022/7/15 15:00,70,102,-32,-121
283,2022/7/15 15:10,74,121,-47,101
283,2022/7/15 15:20,73,112,-39,29
283,2022/7/15 15:30,79,120,-41,-20
283,2022/7/15 15:40,75,110,-35,83
283,2022/7/15 15:50,63,121,-58,-14
283,2022/7/15 16:00,74,102,-28,332
283,2022/7/15 16:10,76,114,-38,652
283,2022/7/15 16:20,80,105,-25,349
283,2022/7/15 16:30,209,108,101,1155
283,2022/7/15 16:40,190,120,70,1799
283,2022/7/15 16:50,177,117,60,1397
283,2022/7/15 17:00,269,131,138,3942
283,2022/7/15 17:10,272,177,95,4584
283,2022/7/15 17:20,234,231,3,2179
283,2022/7/15 17:30,270,232,38,3042
283,2022/7/15 17:40,339,298,41,4247
283,2022/7/15 17:50,243,322,-79,2090
283,2022/7/15 18:00,216,326,-110,1259
283,2022/7/15 18:10,262,348,-86,3558
283,2022/7/15 18:20,208,335,-127,1154
283,2022/7/15 18:30,157,336,-179,-388
283,2022/7/15 18:40,149,326,-177,-2089
283,2022/7/15 18:50,84,327,-243,-1005
283,2022/7/15 19:00,85,285,-200,-1152
283,2022/7/15 19:10,65,180,-115,-1064
283,2022/7/15 19:20,54,152,-98,-1327
283,2022/7/15 19:30,48,119,-71,-794
283,2022/7/15 19:40,42,107,-65,-676
283,2022/7/15 19:50,35,124,-89,-435
283,2022/7/15 20:00,35,129,-94,-257
283,2022/7/15 20:10,32,117,-85,198
283,2022/7/15 20:20,28,122,-94,129
283,2022/7/15 20:30,29,119,-90,176
283,2022/7/15 20:40,35,124,-89,104
283,2022/7/15 20:50,27,128,-101,188
283,2022/7/15 21:00,33,101,-68,561
283,2022/7/15 21:10,30,110,-80,657
283,2022/7/15 21:20,29,115,-86,381
283,2022/7/15 21:30,28,121,-93,198
283,2022/7/15 21:40,27,99,-72,-28
283,2022/7/15 21:50,28,105,-77,33
283,2022/7/15 22:00,28,99,-71,937
283,2022/7/15 22:10,25,112,-87,180
283,2022/7/15 22:20,22,108,-86,-1105
283,2022/7/15 22:30,14,107,-93,-1281
283,2022/7/15 22:40,14,83,-69,-1207
283,2022/7/15 22:50,4,70,-66,-1213
265,2022/7/15 5:00,0,1,-1,-16
265,2022/7/15 5:10,0,1,-1,24
265,2022/7/15 5:20,3,1,2,149
265,2022/7/15 5:30,8,1,7,275
265,2022/7/15 5:40,22,1,21,396
265,2022/7/15 5:50,24,11,13,528
265,2022/7/15 6:00,35,8,27,407
265,2022/7/15 6:10,36,45,-9,507
265,2022/7/15 6:20,47,47,0,920
265,2022/7/15 6:30,66,62,4,981
265,2022/7/15 6:40,146,69,77,1488
265,2022/7/15 6:50,164,75,89,1631
265,2022/7/15 7:00,218,88,130,2100
265,2022/7/15 7:10,246,111,135,2978
265,2022/7/15 7:20,280,107,173,4300
265,2022/7/15 7:30,439,107,332,5244
265,2022/7/15 7:40,599,128,471,5704
265,2022/7/15 7:50,691,154,537,7195
265,2022/7/15 8:00,741,281,460,5064
265,2022/7/15 8:10,828,535,293,1835
265,2022/7/15 8:20,694,507,187,-914
265,2022/7/15 8:30,724,426,298,-4767
265,2022/7/15 8:40,574,1186,-612,-15030
265,2022/7/15 8:50,383,479,-96,-10404
265,2022/7/15 9:00,313,508,-195,-9447
265,2022/7/15 9:10,276,377,-101,-7576
265,2022/7/15 9:20,225,332,-107,-5265
265,2022/7/15 9:30,201,211,-10,-3213
265,2022/7/15 9:40,144,224,-80,-2868
265,2022/7/15 9:50,90,144,-54,-2682
265,2022/7/15 10:00,94,179,-85,-1623
265,2022/7/15 10:10,74,119,-45,-905
265,2022/7/15 10:20,72,111,-39,-742
265,2022/7/15 10:30,71,122,-51,-1062
265,2022/7/15 10:40,69,128,-59,-888
265,2022/7/15 10:50,70,105,-35,-656
265,2022/7/15 11:00,71,111,-40,-769
265,2022/7/15 11:10,70,111,-41,-663
265,2022/7/15 11:20,65,153,-88,-762
265,2022/7/15 11:30,76,125,-49,-597
265,2022/7/15 11:40,76,159,-83,-668
265,2022/7/15 11:50,70,120,-50,-521
265,2022/7/15 12:00,127,181,-54,-461
265,2022/7/15 12:10,157,128,29,-371
265,2022/7/15 12:20,169,152,17,-393
265,2022/7/15 12:30,198,121,77,-353
265,2022/7/15 12:40,185,180,5,-424
265,2022/7/15 12:50,186,128,58,-439
265,2022/7/15 13:00,206,145,61,-403
265,2022/7/15 13:10,207,121,86,-252
265,2022/7/15 13:20,214,145,69,-266
265,2022/7/15 13:30,205,109,96,-286
265,2022/7/15 13:40,175,146,29,-428
265,2022/7/15 13:50,174,119,55,-228
265,2022/7/15 14:00,176,128,48,-169
265,2022/7/15 14:10,178,108,70,-159
265,2022/7/15 14:20,175,150,25,-105
265,2022/7/15 14:30,176,108,68,-167
265,2022/7/15 14:40,177,117,60,-6
265,2022/7/15 14:50,175,133,42,49
265,2022/7/15 15:00,180,185,-5,-126
265,2022/7/15 15:10,180,132,48,149
265,2022/7/15 15:20,202,198,4,33
265,2022/7/15 15:30,195,169,26,6
265,2022/7/15 15:40,201,213,-12,71
265,2022/7/15 15:50,193,154,39,25
265,2022/7/15 16:00,221,195,26,358
265,2022/7/15 16:10,236,192,44,696
265,2022/7/15 16:20,256,267,-11,338
265,2022/7/15 16:30,271,197,74,1229
265,2022/7/15 16:40,285,269,16,1815
265,2022/7/15 16:50,271,319,-48,1349
265,2022/7/15 17:00,548,375,173,4115
265,2022/7/15 17:10,699,429,270,4854
265,2022/7/15 17:20,579,412,167,2346
265,2022/7/15 17:30,650,422,228,3270
265,2022/7/15 17:40,792,474,318,4565
265,2022/7/15 17:50,610,571,39,2129
265,2022/7/15 18:00,677,614,63,1322
265,2022/7/15 18:10,831,608,223,3781
265,2022/7/15 18:20,641,610,31,1185
265,2022/7/15 18:30,573,609,-36,-424
265,2022/7/15 18:40,546,611,-65,-2154
265,2022/7/15 18:50,312,566,-254,-1259
265,2022/7/15 19:00,328,416,-88,-1240
265,2022/7/15 19:10,347,504,-157,-1221
265,2022/7/15 19:20,315,335,-20,-1347
265,2022/7/15 19:30,290,321,-31,-825
265,2022/7/15 19:40,266,218,48,-628
265,2022/7/15 19:50,284,179,105,-330
265,2022/7/15 20:00,316,169,147,-110
265,2022/7/15 20:10,349,109,240,438
265,2022/7/15 20:20,308,129,179,308
265,2022/7/15 20:30,334,121,213,389
265,2022/7/15 20:40,349,110,239,343
265,2022/7/15 20:50,335,110,225,413
265,2022/7/15 21:00,350,119,231,792
265,2022/7/15 21:10,358,120,238,895
265,2022/7/15 21:20,289,121,168,549
265,2022/7/15 21:30,264,124,140,338
265,2022/7/15 21:40,268,109,159,131
265,2022/7/15 21:50,192,106,86,119
265,2022/7/15 22:00,86,103,-17,920
265,2022/7/15 22:10,58,111,-53,127
265,2022/7/15 22:20,32,111,-79,-1184
265,2022/7/15 22:30,22,106,-84,-1365
265,2022/7/15 22:40,18,98,-80,-1287
265,2022/7/15 22:50,8,75,-67,-1280
278,2022/7/15 5:00,0,1,-1,-17
278,2022/7/15 5:10,0,1,-1,23
278,2022/7/15 5:20,3,1,2,151
278,2022/7/15 5:30,16,1,15,290
278,2022/7/15 5:40,26,1,25,421
278,2022/7/15 5:50,25,2,23,551
278,2022/7/15 6:00,31,6,25,432
278,2022/7/15 6:10,39,23,16,523
278,2022/7/15 6:20,57,25,32,952
278,2022/7/15 6:30,77,41,36,1017
278,2022/7/15 6:40,194,63,131,1619
278,2022/7/15 6:50,199,82,117,1748
278,2022/7/15 7:00,255,100,155,2255
278,2022/7/15 7:10,283,127,156,3134
278,2022/7/15 7:20,369,107,262,4562
278,2022/7/15 7:30,599,118,481,5725
278,2022/7/15 7:40,702,107,595,6299
278,2022/7/15 7:50,872,113,759,7954
278,2022/7/15 8:00,1177,119,1058,6122
278,2022/7/15 8:10,1177,139,1038,2873
278,2022/7/15 8:20,1047,121,926,12
278,2022/7/15 8:30,815,121,694,-4073
278,2022/7/15 8:40,683,109,574,-14456
278,2022/7/15 8:50,591,109,482,-9922
278,2022/7/15 9:00,369,104,265,-9182
278,2022/7/15 9:10,324,112,212,-7364
278,2022/7/15 9:20,217,105,112,-5153
278,2022/7/15 9:30,180,91,89,-3124
278,2022/7/15 9:40,141,96,45,-2823
278,2022/7/15 9:50,78,78,0,-2682
278,2022/7/15 10:00,63,76,-13,-1636
278,2022/7/15 10:10,59,66,-7,-912
278,2022/7/15 10:20,44,82,-38,-780
278,2022/7/15 10:30,41,85,-44,-1106
278,2022/7/15 10:40,43,72,-29,-917
278,2022/7/15 10:50,36,76,-40,-696
278,2022/7/15 11:00,39,68,-29,-798
278,2022/7/15 11:10,39,67,-28,-691
278,2022/7/15 11:20,37,73,-36,-798
278,2022/7/15 11:30,37,82,-45,-642
278,2022/7/15 11:40,44,86,-42,-710
278,2022/7/15 11:50,37,75,-38,-559
278,2022/7/15 12:00,41,69,-28,-489
278,2022/7/15 12:10,48,76,-28,-399
278,2022/7/15 12:20,42,77,-35,-428
278,2022/7/15 12:30,47,83,-36,-389
278,2022/7/15 12:40,44,90,-46,-470
278,2022/7/15 12:50,44,93,-49,-488
278,2022/7/15 13:00,41,79,-38,-441
278,2022/7/15 13:10,48,97,-49,-301
278,2022/7/15 13:20,43,97,-54,-320
278,2022/7/15 13:30,43,90,-47,-333
278,2022/7/15 13:40,37,93,-56,-484
278,2022/7/15 13:50,37,93,-56,-284
278,2022/7/15 14:00,41,93,-52,-221
278,2022/7/15 14:10,35,90,-55,-214
278,2022/7/15 14:20,37,93,-56,-161
278,2022/7/15 14:30,40,88,-48,-215
278,2022/7/15 14:40,40,97,-57,-63
278,2022/7/15 14:50,38,99,-61,-12
278,2022/7/15 15:00,40,96,-56,-182
278,2022/7/15 15:10,58,104,-46,103
278,2022/7/15 15:20,43,105,-62,-29
278,2022/7/15 15:30,43,105,-62,-56
278,2022/7/15 15:40,47,103,-56,15
278,2022/7/15 15:50,44,100,-56,-31
278,2022/7/15 16:00,73,105,-32,326
278,2022/7/15 16:10,76,126,-50,646
278,2022/7/15 16:20,70,119,-49,289
278,2022/7/15 16:30,92,117,-25,1204
278,2022/7/15 16:40,114,114,0,1815
278,2022/7/15 16:50,89,133,-44,1305
278,2022/7/15 17:00,158,115,43,4158
278,2022/7/15 17:10,218,177,41,4895
278,2022/7/15 17:20,195,215,-20,2326
278,2022/7/15 17:30,157,297,-140,3130
278,2022/7/15 17:40,198,332,-134,4431
278,2022/7/15 17:50,176,345,-169,1960
278,2022/7/15 18:00,98,380,-282,1040
278,2022/7/15 18:10,130,379,-249,3532
278,2022/7/15 18:20,72,386,-314,871
278,2022/7/15 18:30,56,527,-471,-895
278,2022/7/15 18:40,56,382,-326,-2480
278,2022/7/15 18:50,41,519,-478,-1737
278,2022/7/15 19:00,40,336,-296,-1536
278,2022/7/15 19:10,43,301,-258,-1479
278,2022/7/15 19:20,34,214,-180,-1527
278,2022/7/15 19:30,31,153,-122,-947
278,2022/7/15 19:40,31,128,-97,-725
278,2022/7/15 19:50,34,116,-82,-412
278,2022/7/15 20:00,28,111,-83,-193
278,2022/7/15 20:10,32,110,-78,360
278,2022/7/15 20:20,27,104,-77,231
278,2022/7/15 20:30,29,109,-80,309
278,2022/7/15 20:40,26,120,-94,249
278,2022/7/15 20:50,27,125,-98,315
278,2022/7/15 21:00,31,119,-88,704
278,2022/7/15 21:10,29,117,-88,807
278,2022/7/15 21:20,23,122,-99,450
278,2022/7/15 21:30,24,116,-92,246
278,2022/7/15 21:40,24,122,-98,33
278,2022/7/15 21:50,20,88,-68,51
278,2022/7/15 22:00,16,99,-83,837
278,2022/7/15 22:10,16,112,-96,31
278,2022/7/15 22:20,13,107,-94,-1278
278,2022/7/15 22:30,12,102,-90,-1455
278,2022/7/15 22:40,6,95,-89,-1376
278,2022/7/15 22:50,2,71,-69,-1349
282,2022/7/15 5:00,0,1,-1,-18
282,2022/7/15 5:10,2,1,1,24
282,2022/7/15 5:20,5,1,4,155
282,2022/7/15 5:30,16,1,15,305
282,2022/7/15 5:40,19,1,18,439
282,2022/7/15 5:50,21,6,15,566
282,2022/7/15 6:00,30,5,25,457
282,2022/7/15 6:10,35,16,19,542
282,2022/7/15 6:20,38,35,3,955
282,2022/7/15 6:30,49,51,-2,1015
282,2022/7/15 6:40,76,68,8,1627
282,2022/7/15 6:50,94,108,-14,1734
282,2022/7/15 7:00,156,193,-37,2218
282,2022/7/15 7:10,197,119,78,3212
282,2022/7/15 7:20,235,104,131,4693
282,2022/7/15 7:30,278,121,157,5882
282,2022/7/15 7:40,325,122,203,6502
282,2022/7/15 7:50,575,124,451,8405
282,2022/7/15 8:00,632,181,451,6573
282,2022/7/15 8:10,723,215,508,3381
282,2022/7/15 8:20,655,296,359,371
282,2022/7/15 8:30,601,332,269,-3804
282,2022/7/15 8:40,369,421,-52,-14508
282,2022/7/15 8:50,280,509,-229,-10151
282,2022/7/15 9:00,227,299,-72,-9254
282,2022/7/15 9:10,209,197,12,-7352
282,2022/7/15 9:20,167,185,-18,-5171
282,2022/7/15 9:30,107,109,-2,-3126
282,2022/7/15 9:40,67,123,-56,-2879
282,2022/7/15 9:50,56,106,-50,-2732
282,2022/7/15 10:00,46,105,-59,-1695
282,2022/7/15 10:10,45,96,-51,-963
282,2022/7/15 10:20,45,97,-52,-832
282,2022/7/15 10:30,43,93,-50,-1156
282,2022/7/15 10:40,41,81,-40,-957
282,2022/7/15 10:50,38,80,-42,-738
282,2022/7/15 11:00,33,77,-44,-842
282,2022/7/15 11:10,35,76,-41,-732
282,2022/7/15 11:20,36,75,-39,-837
282,2022/7/15 11:30,39,77,-38,-680
282,2022/7/15 11:40,41,72,-31,-741
282,2022/7/15 11:50,45,91,-46,-605
282,2022/7/15 12:00,43,76,-33,-522
282,2022/7/15 12:10,54,81,-27,-426
282,2022/7/15 12:20,45,84,-39,-467
282,2022/7/15 12:30,44,93,-49,-438
282,2022/7/15 12:40,42,104,-62,-532
282,2022/7/15 12:50,47,113,-66,-554
282,2022/7/15 13:00,48,105,-57,-498
282,2022/7/15 13:10,46,101,-55,-356
282,2022/7/15 13:20,44,105,-61,-381
282,2022/7/15 13:30,45,98,-53,-386
282,2022/7/15 13:40,44,93,-49,-533
282,2022/7/15 13:50,44,96,-52,-336
282,2022/7/15 14:00,42,94,-52,-273
282,2022/7/15 14:10,41,97,-56,-270
282,2022/7/15 14:20,36,81,-45,-206
282,2022/7/15 14:30,44,93,-49,-264
282,2022/7/15 14:40,39,90,-51,-114
282,2022/7/15 14:50,41,92,-51,-63
282,2022/7/15 15:00,50,93,-43,-225
282,2022/7/15 15:10,118,100,18,121
282,2022/7/15 15:20,66,100,-34,-63
282,2022/7/15 15:30,59,99,-40,-96
282,2022/7/15 15:40,66,104,-38,-23
282,2022/7/15 15:50,81,109,-28,-59
282,2022/7/15 16:00,170,100,70,396
282,2022/7/15 16:10,140,104,36,682
282,2022/7/15 16:20,78,108,-30,259
282,2022/7/15 16:30,136,87,49,1253
282,2022/7/15 16:40,191,97,94,1909
282,2022/7/15 16:50,228,118,110,1415
282,2022/7/15 17:00,333,121,212,4370
282,2022/7/15 17:10,336,108,228,5123
282,2022/7/15 17:20,223,149,74,2400
282,2022/7/15 17:30,270,191,79,3209
282,2022/7/15 17:40,579,179,400,4831
282,2022/7/15 17:50,292,255,37,1997
282,2022/7/15 18:00,308,283,25,1065
282,2022/7/15 18:10,377,284,93,3625
282,2022/7/15 18:20,265,300,-35,836
282,2022/7/15 18:30,189,270,-81,-976
282,2022/7/15 18:40,177,284,-107,-2587
282,2022/7/15 18:50,134,234,-100,-1837
282,2022/7/15 19:00,68,178,-110,-1646
282,2022/7/15 19:10,60,170,-110,-1589
282,2022/7/15 19:20,48,121,-73,-1600
282,2022/7/15 19:30,44,109,-65,-1012
282,2022/7/15 19:40,42,118,-76,-801
282,2022/7/15 19:50,43,106,-63,-475
282,2022/7/15 20:00,39,110,-71,-264
282,2022/7/15 20:10,41,102,-61,299
282,2022/7/15 20:20,36,104,-68,163
282,2022/7/15 20:30,41,100,-59,250
282,2022/7/15 20:40,46,104,-58,191
282,2022/7/15 20:50,46,97,-51,264
282,2022/7/15 21:00,38,108,-70,634
282,2022/7/15 21:10,41,104,-63,744
282,2022/7/15 21:20,39,112,-73,377
282,2022/7/15 21:30,35,103,-68,178
282,2022/7/15 21:40,30,93,-63,-30
282,2022/7/15 21:50,28,102,-74,-23
282,2022/7/15 22:00,24,85,-61,776
282,2022/7/15 22:10,22,96,-74,-43
282,2022/7/15 22:20,19,92,-73,-1351
282,2022/7/15 22:30,13,78,-65,-1520
282,2022/7/15 22:40,6,66,-60,-1436
282,2022/7/15 22:50,3,72,-69,-1418
262,2022/7/15 5:00,0,1,-1,-19
262,2022/7/15 5:10,0,1,-1,23
262,2022/7/15 5:20,8,1,7,162
262,2022/7/15 5:30,21,1,20,325
262,2022/7/15 5:40,22,2,20,459
262,2022/7/15 5:50,20,6,14,580
262,2022/7/15 6:00,27,6,21,478
262,2022/7/15 6:10,41,6,35,577
262,2022/7/15 6:20,54,40,14,969
262,2022/7/15 6:30,75,23,52,1067
262,2022/7/15 6:40,91,32,59,1686
262,2022/7/15 6:50,108,68,40,1774
262,2022/7/15 7:00,187,67,120,2338
262,2022/7/15 7:10,187,112,75,3287
262,2022/7/15 7:20,241,90,151,4844
262,2022/7/15 7:30,302,79,223,6105
262,2022/7/15 7:40,349,104,245,6747
262,2022/7/15 7:50,368,112,256,8661
262,2022/7/15 8:00,575,98,477,7050
262,2022/7/15 8:10,445,109,336,3717
262,2022/7/15 8:20,327,110,217,588
262,2022/7/15 8:30,344,109,235,-3569
262,2022/7/15 8:40,282,151,131,-14377
262,2022/7/15 8:50,232,108,124,-10027
262,2022/7/15 9:00,177,107,70,-9184
262,2022/7/15 9:10,138,102,36,-7316
262,2022/7/15 9:20,79,108,-29,-5200
262,2022/7/15 9:30,63,91,-28,-3154
262,2022/7/15 9:40,50,88,-38,-2917
262,2022/7/15 9:50,45,85,-40,-2772
262,2022/7/15 10:00,36,69,-33,-1728
262,2022/7/15 10:10,36,78,-42,-1005
262,2022/7/15 10:20,34,72,-38,-870
262,2022/7/15 10:30,32,62,-30,-1186
262,2022/7/15 10:40,33,67,-34,-991
262,2022/7/15 10:50,31,66,-35,-773
262,2022/7/15 11:00,33,73,-40,-882
262,2022/7/15 11:10,35,72,-37,-769
262,2022/7/15 11:20,28,69,-41,-878
262,2022/7/15 11:30,31,70,-39,-719
262,2022/7/15 11:40,29,68,-39,-780
262,2022/7/15 11:50,32,68,-36,-641
262,2022/7/15 12:00,31,65,-34,-556
262,2022/7/15 12:10,31,65,-34,-460
262,2022/7/15 12:20,39,70,-31,-498
262,2022/7/15 12:30,32,81,-49,-487
262,2022/7/15 12:40,35,72,-37,-569
262,2022/7/15 12:50,36,81,-45,-599
262,2022/7/15 13:00,37,84,-47,-545
262,2022/7/15 13:10,36,83,-47,-403
262,2022/7/15 13:20,31,75,-44,-425
262,2022/7/15 13:30,35,74,-39,-425
262,2022/7/15 13:40,32,79,-47,-580
262,2022/7/15 13:50,29,75,-46,-382
262,2022/7/15 14:00,32,80,-48,-321
262,2022/7/15 14:10,27,77,-50,-320
262,2022/7/15 14:20,29,73,-44,-250
262,2022/7/15 14:30,31,72,-41,-305
262,2022/7/15 14:40,31,83,-52,-166
262,2022/7/15 14:50,25,78,-53,-116
262,2022/7/15 15:00,33,91,-58,-283
262,2022/7/15 15:10,34,90,-56,65
262,2022/7/15 15:20,28,96,-68,-131
262,2022/7/15 15:30,28,102,-74,-170
262,2022/7/15 15:40,30,108,-78,-101
262,2022/7/15 15:50,29,104,-75,-134
262,2022/7/15 16:00,32,103,-71,325
262,2022/7/15 16:10,35,111,-76,606
262,2022/7/15 16:20,40,96,-56,203
262,2022/7/15 16:30,44,107,-63,1190
262,2022/7/15 16:40,58,119,-61,1848
262,2022/7/15 16:50,60,115,-55,1360
262,2022/7/15 17:00,130,116,14,4384
262,2022/7/15 17:10,156,118,38,5161
262,2022/7/15 17:20,77,181,-104,2296
262,2022/7/15 17:30,86,180,-94,3115
262,2022/7/15 17:40,142,179,-37,4794
262,2022/7/15 17:50,93,217,-124,1873
262,2022/7/15 18:00,71,198,-127,938
262,2022/7/15 18:10,102,198,-96,3529
262,2022/7/15 18:20,77,222,-145,691
262,2022/7/15 18:30,53,235,-182,-1158
262,2022/7/15 18:40,46,224,-178,-2765
262,2022/7/15 18:50,37,209,-172,-2009
262,2022/7/15 19:00,34,192,-158,-1804
262,2022/7/15 19:10,35,109,-74,-1663
262,2022/7/15 19:20,33,109,-76,-1676
262,2022/7/15 19:30,26,105,-79,-1091
262,2022/7/15 19:40,33,106,-73,-874
262,2022/7/15 19:50,29,108,-79,-554
262,2022/7/15 20:00,35,105,-70,-334
262,2022/7/15 20:10,24,104,-80,219
262,2022/7/15 20:20,28,92,-64,99
262,2022/7/15 20:30,29,106,-77,173
262,2022/7/15 20:40,24,111,-87,104
262,2022/7/15 20:50,23,115,-92,172
262,2022/7/15 21:00,31,102,-71,563
262,2022/7/15 21:10,25,105,-80,664
262,2022/7/15 21:20,25,116,-91,286
262,2022/7/15 21:30,34,106,-72,106
262,2022/7/15 21:40,24,105,-81,-111
262,2022/7/15 21:50,16,95,-79,-102
262,2022/7/15 22:00,16,101,-85,691
262,2022/7/15 22:10,17,110,-93,-136
262,2022/7/15 22:20,12,83,-71,-1422
262,2022/7/15 22:30,8,93,-85,-1605
262,2022/7/15 22:40,5,71,-66,-1502
262,2022/7/15 22:50,1,63,-62,-1480
268,2022/7/15 5:00,0,1,-1,-20
268,2022/7/15 5:10,1,1,0,23
268,2022/7/15 5:20,8,1,7,169
268,2022/7/15 5:30,28,1,27,352
268,2022/7/15 5:40,22,21,1,460
268,2022/7/15 5:50,30,13,17,597
268,2022/7/15 6:00,39,13,26,504
268,2022/7/15 6:10,45,21,24,601
268,2022/7/15 6:20,56,60,-4,965
268,2022/7/15 6:30,74,68,6,1073
268,2022/7/15 6:40,83,105,-22,1664
268,2022/7/15 6:50,113,106,7,1781
268,2022/7/15 7:00,158,125,33,2371
268,2022/7/15 7:10,195,153,42,3329
268,2022/7/15 7:20,239,146,93,4937
268,2022/7/15 7:30,280,328,-48,6057
268,2022/7/15 7:40,302,327,-25,6722
268,2022/7/15 7:50,368,320,48,8709
268,2022/7/15 8:00,477,179,298,7348
268,2022/7/15 8:10,568,225,343,4060
268,2022/7/15 8:20,387,225,162,750
268,2022/7/15 8:30,337,255,82,-3487
268,2022/7/15 8:40,277,333,-56,-14433
268,2022/7/15 8:50,260,217,43,-9984
268,2022/7/15 9:00,225,180,45,-9139
268,2022/7/15 9:10,177,139,38,-7278
268,2022/7/15 9:20,162,108,54,-5146
268,2022/7/15 9:30,139,117,22,-3132
268,2022/7/15 9:40,116,115,1,-2916
268,2022/7/15 9:50,90,118,-28,-2800
268,2022/7/15 10:00,73,120,-47,-1775
268,2022/7/15 10:10,82,125,-43,-1048
268,2022/7/15 10:20,70,110,-40,-910
268,2022/7/15 10:30,75,104,-29,-1215
268,2022/7/15 10:40,72,99,-27,-1018
268,2022/7/15 10:50,67,106,-39,-812
268,2022/7/15 11:00,67,92,-25,-907
268,2022/7/15 11:10,66,93,-27,-796
268,2022/7/15 11:20,69,77,-8,-886
268,2022/7/15 11:30,65,102,-37,-756
268,2022/7/15 11:40,69,81,-12,-792
268,2022/7/15 11:50,65,90,-25,-666
268,2022/7/15 12:00,61,83,-22,-578
268,2022/7/15 12:10,69,95,-26,-486
268,2022/7/15 12:20,56,87,-31,-529
268,2022/7/15 12:30,54,102,-48,-535
268,2022/7/15 12:40,45,99,-54,-623
268,2022/7/15 12:50,47,115,-68,-667
268,2022/7/15 13:00,44,102,-58,-603
268,2022/7/15 13:10,47,122,-75,-478
268,2022/7/15 13:20,47,106,-59,-484
268,2022/7/15 13:30,48,112,-64,-489
268,2022/7/15 13:40,60,110,-50,-630
268,2022/7/15 13:50,62,107,-45,-427
268,2022/7/15 14:00,69,100,-31,-352
268,2022/7/15 14:10,74,87,-13,-333
268,2022/7/15 14:20,80,107,-27,-277
268,2022/7/15 14:30,70,106,-36,-341
268,2022/7/15 14:40,70,109,-39,-205
268,2022/7/15 14:50,83,86,-3,-119
268,2022/7/15 15:00,77,108,-31,-314
268,2022/7/15 15:10,73,109,-36,29
268,2022/7/15 15:20,74,102,-28,-159
268,2022/7/15 15:30,75,114,-39,-209
268,2022/7/15 15:40,77,109,-32,-133
268,2022/7/15 15:50,93,100,-7,-141
268,2022/7/15 16:00,133,105,28,353
268,2022/7/15 16:10,139,115,24,630
268,2022/7/15 16:20,164,108,56,259
268,2022/7/15 16:30,257,114,143,1333
268,2022/7/15 16:40,213,108,105,1953
268,2022/7/15 16:50,191,121,70,1430
268,2022/7/15 17:00,222,118,104,4488
268,2022/7/15 17:10,247,103,144,5305
268,2022/7/15 17:20,206,116,90,2386
268,2022/7/15 17:30,227,108,119,3234
268,2022/7/15 17:40,238,153,85,4879
268,2022/7/15 17:50,164,159,5,1878
268,2022/7/15 18:00,177,213,-36,902
268,2022/7/15 18:10,199,180,19,3548
268,2022/7/15 18:20,141,178,-37,654
268,2022/7/15 18:30,70,191,-121,-1279
268,2022/7/15 18:40,57,159,-102,-2867
268,2022/7/15 18:50,44,192,-148,-2157
268,2022/7/15 19:00,45,139,-94,-1898
268,2022/7/15 19:10,42,107,-65,-1728
268,2022/7/15 19:20,39,113,-74,-1750
268,2022/7/15 19:30,40,108,-68,-1159
268,2022/7/15 19:40,36,104,-68,-942
268,2022/7/15 19:50,30,110,-80,-634
268,2022/7/15 20:00,32,102,-70,-404
268,2022/7/15 20:10,35,101,-66,153
268,2022/7/15 20:20,35,100,-65,34
268,2022/7/15 20:30,30,92,-62,111
268,2022/7/15 20:40,28,95,-67,37
268,2022/7/15 20:50,28,91,-63,109
268,2022/7/15 21:00,35,113,-78,485
268,2022/7/15 21:10,36,99,-63,601
268,2022/7/15 21:20,27,97,-70,216
268,2022/7/15 21:30,24,92,-68,38
268,2022/7/15 21:40,24,104,-80,-191
268,2022/7/15 21:50,20,91,-71,-173
268,2022/7/15 22:00,21,78,-57,634
268,2022/7/15 22:10,17,77,-60,-196
268,2022/7/15 22:20,12,75,-63,-1485
268,2022/7/15 22:30,10,94,-84,-1689
268,2022/7/15 22:40,4,78,-74,-1576
268,2022/7/15 22:50,1,73,-72,-1552
267,2022/7/15 5:00,0,1,-1,-21
267,2022/7/15 5:10,1,1,0,23
267,2022/7/15 5:20,16,1,15,184
267,2022/7/15 5:30,32,1,31,383
267,2022/7/15 5:40,31,2,29,489
267,2022/7/15 5:50,35,5,30,627
267,2022/7/15 6:00,47,13,34,538
267,2022/7/15 6:10,57,11,46,647
267,2022/7/15 6:20,76,48,28,993
267,2022/7/15 6:30,174,59,115,1188
267,2022/7/15 6:40,189,66,123,1787
267,2022/7/15 6:50,239,96,143,1924
267,2022/7/15 7:00,283,118,165,2536
267,2022/7/15 7:10,279,110,169,3498
267,2022/7/15 7:20,482,118,364,5301
267,2022/7/15 7:30,666,105,561,6618
267,2022/7/15 7:40,828,133,695,7417
267,2022/7/15 7:50,861,106,755,9464
267,2022/7/15 8:00,1049,109,940,8288
267,2022/7/15 8:10,741,119,622,4682
267,2022/7/15 8:20,740,117,623,1373
267,2022/7/15 8:30,679,123,556,-2931
267,2022/7/15 8:40,602,126,476,-13957
267,2022/7/15 8:50,316,106,210,-9774
267,2022/7/15 9:00,278,101,177,-8962
267,2022/7/15 9:10,219,109,110,-7168
267,2022/7/15 9:20,179,93,86,-5060
267,2022/7/15 9:30,103,96,7,-3125
267,2022/7/15 9:40,74,93,-19,-2935
267,2022/7/15 9:50,76,77,-1,-2801
267,2022/7/15 10:00,57,76,-19,-1794
267,2022/7/15 10:10,47,81,-34,-1082
267,2022/7/15 10:20,46,75,-29,-939
267,2022/7/15 10:30,42,74,-32,-1247
267,2022/7/15 10:40,38,76,-38,-1056
267,2022/7/15 10:50,39,76,-37,-849
267,2022/7/15 11:00,41,75,-34,-941
267,2022/7/15 11:10,43,73,-30,-826
267,2022/7/15 11:20,40,77,-37,-923
267,2022/7/15 11:30,37,77,-40,-796
267,2022/7/15 11:40,41,80,-39,-831
267,2022/7/15 11:50,42,78,-36,-702
267,2022/7/15 12:00,46,85,-39,-617
267,2022/7/15 12:10,54,88,-34,-520
267,2022/7/15 12:20,45,85,-40,-569
267,2022/7/15 12:30,47,76,-29,-564
267,2022/7/15 12:40,46,96,-50,-673
267,2022/7/15 12:50,43,93,-50,-717
267,2022/7/15 13:00,45,95,-50,-653
267,2022/7/15 13:10,47,96,-49,-527
267,2022/7/15 13:20,41,100,-59,-543
267,2022/7/15 13:30,43,90,-47,-536
267,2022/7/15 13:40,44,104,-60,-690
267,2022/7/15 13:50,41,99,-58,-485
267,2022/7/15 14:00,36,102,-66,-418
267,2022/7/15 14:10,40,87,-47,-380
267,2022/7/15 14:20,35,99,-64,-341
267,2022/7/15 14:30,35,105,-70,-411
267,2022/7/15 14:40,39,105,-66,-271
267,2022/7/15 14:50,38,108,-70,-189
267,2022/7/15 15:00,37,102,-65,-379
267,2022/7/15 15:10,49,113,-64,-35
267,2022/7/15 15:20,58,96,-38,-197
267,2022/7/15 15:30,62,104,-42,-251
267,2022/7/15 15:40,55,107,-52,-185
267,2022/7/15 15:50,43,125,-82,-223
267,2022/7/15 16:00,53,109,-56,297
267,2022/7/15 16:10,58,107,-49,581
267,2022/7/15 16:20,88,109,-21,238
267,2022/7/15 16:30,129,123,6,1339
267,2022/7/15 16:40,92,108,-16,1937
267,2022/7/15 16:50,142,133,9,1439
267,2022/7/15 17:00,205,143,62,4550
267,2022/7/15 17:10,230,158,72,5377
267,2022/7/15 17:20,176,178,-2,2384
267,2022/7/15 17:30,177,221,-44,3190
267,2022/7/15 17:40,170,298,-128,4751
267,2022/7/15 17:50,115,333,-218,1660
267,2022/7/15 18:00,101,336,-235,667
267,2022/7/15 18:10,87,326,-239,3309
267,2022/7/15 18:20,61,324,-263,391
267,2022/7/15 18:30,49,347,-298,-1577
267,2022/7/15 18:40,46,347,-301,-3168
267,2022/7/15 18:50,32,337,-305,-2462
267,2022/7/15 19:00,37,337,-300,-2198
267,2022/7/15 19:10,35,284,-249,-1977
267,2022/7/15 19:20,24,222,-198,-1948
267,2022/7/15 19:30,28,160,-132,-1291
267,2022/7/15 19:40,28,111,-83,-1025
267,2022/7/15 19:50,29,119,-90,-724
267,2022/7/15 20:00,27,111,-84,-488
267,2022/7/15 20:10,30,125,-95,58
267,2022/7/15 20:20,27,123,-96,-62
267,2022/7/15 20:30,33,123,-90,21
267,2022/7/15 20:40,29,116,-87,-50
267,2022/7/15 20:50,24,112,-88,21
267,2022/7/15 21:00,30,89,-59,426
267,2022/7/15 21:10,25,107,-82,519
267,2022/7/15 21:20,25,103,-78,138
267,2022/7/15 21:30,25,105,-80,-42
267,2022/7/15 21:40,24,101,-77,-268
267,2022/7/15 21:50,23,99,-76,-249
267,2022/7/15 22:00,26,112,-86,548
267,2022/7/15 22:10,21,108,-87,-283
267,2022/7/15 22:20,19,110,-91,-1576
267,2022/7/15 22:30,13,111,-98,-1787
267,2022/7/15 22:40,2,113,-111,-1687
267,2022/7/15 22:50,2,89,-87,-1639
286,2022/7/15 5:00,1,1,0,-21
286,2022/7/15 5:10,7,1,6,29
286,2022/7/15 5:20,22,1,21,205
286,2022/7/15 5:30,31,1,30,413
286,2022/7/15 5:40,31,1,30,519
286,2022/7/15 5:50,40,1,39,666
286,2022/7/15 6:00,46,1,45,583
286,2022/7/15 6:10,57,5,52,699
286,2022/7/15 6:20,84,32,52,1045
286,2022/7/15 6:30,184,38,146,1334
286,2022/7/15 6:40,244,50,194,1981
286,2022/7/15 6:50,278,70,208,2132
286,2022/7/15 7:00,359,78,281,2817
286,2022/7/15 7:10,470,104,366,3864
286,2022/7/15 7:20,665,105,560,5861
286,2022/7/15 7:30,740,102,638,7256
286,2022/7/15 7:40,864,113,751,8168
286,2022/7/15 7:50,1177,121,1056,10520
286,2022/7/15 8:00,1170,127,1043,9331
286,2022/7/15 8:10,1169,110,1059,5741
286,2022/7/15 8:20,827,94,733,2106
286,2022/7/15 8:30,724,122,602,-2329
286,2022/7/15 8:40,594,119,475,-13482
286,2022/7/15 8:50,331,109,222,-9552
286,2022/7/15 9:00,267,87,180,-8782
286,2022/7/15 9:10,216,83,133,-7035
286,2022/7/15 9:20,160,77,83,-4977
286,2022/7/15 9:30,116,77,39,-3086
286,2022/7/15 9:40,77,85,-8,-2943
286,2022/7/15 9:50,60,81,-21,-2822
286,2022/7/15 10:00,46,78,-32,-1826
286,2022/7/15 10:10,45,64,-19,-1101
286,2022/7/15 10:20,43,66,-23,-962
286,2022/7/15 10:30,38,75,-37,-1284
286,2022/7/15 10:40,36,64,-28,-1084
286,2022/7/15 10:50,35,82,-47,-896
286,2022/7/15 11:00,33,65,-32,-973
286,2022/7/15 11:10,37,83,-46,-872
286,2022/7/15 11:20,40,70,-30,-953
286,2022/7/15 11:30,35,81,-46,-842
286,2022/7/15 11:40,36,74,-38,-869
286,2022/7/15 11:50,40,82,-42,-744
286,2022/7/15 12:00,41,76,-35,-652
286,2022/7/15 12:10,44,81,-37,-557
286,2022/7/15 12:20,43,74,-31,-600
286,2022/7/15 12:30,44,87,-43,-607
286,2022/7/15 12:40,41,76,-35,-708
286,2022/7/15 12:50,41,97,-56,-773
286,2022/7/15 13:00,41,72,-31,-684
286,2022/7/15 13:10,44,91,-47,-574
286,2022/7/15 13:20,39,69,-30,-573
286,2022/7/15 13:30,38,90,-52,-588
286,2022/7/15 13:40,37,64,-27,-717
286,2022/7/15 13:50,37,94,-57,-542
286,2022/7/15 14:00,40,74,-34,-452
286,2022/7/15 14:10,33,93,-60,-440
286,2022/7/15 14:20,30,72,-42,-383
286,2022/7/15 14:30,32,105,-73,-484
286,2022/7/15 14:40,36,76,-40,-311
286,2022/7/15 14:50,37,105,-68,-257
286,2022/7/15 15:00,36,97,-61,-440
286,2022/7/15 15:10,44,102,-58,-93
286,2022/7/15 15:20,34,99,-65,-262
286,2022/7/15 15:30,40,121,-81,-332
286,2022/7/15 15:40,39,103,-64,-249
286,2022/7/15 15:50,37,125,-88,-311
286,2022/7/15 16:00,42,100,-58,239
286,2022/7/15 16:10,42,121,-79,502
286,2022/7/15 16:20,47,123,-76,162
286,2022/7/15 16:30,54,109,-55,1284
286,2022/7/15 16:40,48,125,-77,1860
286,2022/7/15 16:50,45,152,-107,1332
286,2022/7/15 17:00,77,111,-34,4516
286,2022/7/15 17:10,103,220,-117,5260
286,2022/7/15 17:20,65,189,-124,2260
286,2022/7/15 17:30,61,281,-220,2970
286,2022/7/15 17:40,69,295,-226,4525
286,2022/7/15 17:50,44,315,-271,1389
286,2022/7/15 18:00,44,317,-273,394
286,2022/7/15 18:10,53,321,-268,3041
286,2022/7/15 18:20,46,426,-380,11
286,2022/7/15 18:30,36,383,-347,-1924
286,2022/7/15 18:40,39,508,-469,-3637
286,2022/7/15 18:50,31,323,-292,-2754
286,2022/7/15 19:00,30,435,-405,-2603
286,2022/7/15 19:10,31,299,-268,-2245
286,2022/7/15 19:20,34,233,-199,-2147
286,2022/7/15 19:30,30,191,-161,-1452
286,2022/7/15 19:40,29,137,-108,-1133
286,2022/7/15 19:50,27,120,-93,-817
286,2022/7/15 20:00,28,110,-82,-570
286,2022/7/15 20:10,23,111,-88,-30
286,2022/7/15 20:20,25,121,-96,-158
286,2022/7/15 20:30,23,127,-104,-83
286,2022/7/15 20:40,26,126,-100,-150
286,2022/7/15 20:50,27,109,-82,-61
286,2022/7/15 21:00,25,122,-97,329
286,2022/7/15 21:10,29,126,-97,422
286,2022/7/15 21:20,22,114,-92,46
286,2022/7/15 21:30,21,123,-102,-144
286,2022/7/15 21:40,21,112,-91,-359
286,2022/7/15 21:50,17,103,-86,-335
286,2022/7/15 22:00,16,118,-102,446
286,2022/7/15 22:10,15,105,-90,-373
286,2022/7/15 22:20,8,123,-115,-1691
286,2022/7/15 22:30,7,110,-103,-1890
286,2022/7/15 22:40,2,103,-101,-1788
286,2022/7/15 22:50,2,99,-97,-1736
266,2022/7/15 5:00,0,1,-1,-22
266,2022/7/15 5:10,3,1,2,31
266,2022/7/15 5:20,12,1,11,216
266,2022/7/15 5:30,11,1,10,423
266,2022/7/15 5:40,14,1,13,532
266,2022/7/15 5:50,18,1,17,683
266,2022/7/15 6:00,22,1,21,604
266,2022/7/15 6:10,32,1,31,730
266,2022/7/15 6:20,42,5,37,1082
266,2022/7/15 6:30,43,22,21,1355
266,2022/7/15 6:40,54,19,35,2016
266,2022/7/15 6:50,77,23,54,2186
266,2022/7/15 7:00,75,39,36,2853
266,2022/7/15 7:10,152,40,112,3976
266,2022/7/15 7:20,199,50,149,6010
266,2022/7/15 7:30,265,66,199,7455
266,2022/7/15 7:40,278,54,224,8392
266,2022/7/15 7:50,283,83,200,10720
266,2022/7/15 8:00,277,86,191,9522
266,2022/7/15 8:10,270,108,162,5903
266,2022/7/15 8:20,206,96,110,2216
266,2022/7/15 8:30,182,114,68,-2261
266,2022/7/15 8:40,107,120,-13,-13495
266,2022/7/15 8:50,65,118,-53,-9605
266,2022/7/15 9:00,48,75,-27,-8809
266,2022/7/15 9:10,46,81,-35,-7070
266,2022/7/15 9:20,29,72,-43,-5020
266,2022/7/15 9:30,34,76,-42,-3128
266,2022/7/15 9:40,29,65,-36,-2979
266,2022/7/15 9:50,26,70,-44,-2866
266,2022/7/15 10:00,27,64,-37,-1863
266,2022/7/15 10:10,29,61,-32,-1133
266,2022/7/15 10:20,27,62,-35,-997
266,2022/7/15 10:30,24,47,-23,-1307
266,2022/7/15 10:40,27,71,-44,-1128
266,2022/7/15 10:50,26,55,-29,-925
266,2022/7/15 11:00,25,49,-24,-997
266,2022/7/15 11:10,28,50,-22,-894
266,2022/7/15 11:20,27,74,-47,-1000
266,2022/7/15 11:30,24,53,-29,-871
266,2022/7/15 11:40,25,48,-23,-892
266,2022/7/15 11:50,26,51,-25,-769
266,2022/7/15 12:00,27,65,-38,-690
266,2022/7/15 12:10,27,51,-24,-581
266,2022/7/15 12:20,27,48,-21,-621
266,2022/7/15 12:30,26,51,-25,-632
266,2022/7/15 12:40,27,72,-45,-753
266,2022/7/15 12:50,27,53,-26,-799
266,2022/7/15 13:00,28,51,-23,-707
266,2022/7/15 13:10,28,53,-25,-599
266,2022/7/15 13:20,25,69,-44,-617
266,2022/7/15 13:30,21,53,-32,-620
266,2022/7/15 13:40,25,49,-24,-741
266,2022/7/15 13:50,25,49,-24,-566
266,2022/7/15 14:00,28,69,-41,-493
266,2022/7/15 14:10,24,52,-28,-468
266,2022/7/15 14:20,27,54,-27,-410
266,2022/7/15 14:30,26,51,-25,-509
266,2022/7/15 14:40,24,83,-59,-370
266,2022/7/15 14:50,27,62,-35,-292
266,2022/7/15 15:00,28,53,-25,-465
266,2022/7/15 15:10,28,62,-34,-127
266,2022/7/15 15:20,27,76,-49,-311
266,2022/7/15 15:30,25,59,-34,-366
266,2022/7/15 15:40,30,62,-32,-281
266,2022/7/15 15:50,26,64,-38,-349
266,2022/7/15 16:00,27,95,-68,171
266,2022/7/15 16:10,29,68,-39,463
266,2022/7/15 16:20,30,66,-36,126
266,2022/7/15 16:30,30,69,-39,1245
266,2022/7/15 16:40,34,102,-68,1792
266,2022/7/15 16:50,31,75,-44,1288
266,2022/7/15 17:00,41,87,-46,4470
266,2022/7/15 17:10,41,97,-56,5204
266,2022/7/15 17:20,32,123,-91,2169
266,2022/7/15 17:30,49,106,-57,2913
266,2022/7/15 17:40,45,118,-73,4452
266,2022/7/15 17:50,41,105,-64,1325
266,2022/7/15 18:00,37,109,-72,322
266,2022/7/15 18:10,49,117,-68,2973
266,2022/7/15 18:20,41,171,-130,-119
266,2022/7/15 18:30,38,88,-50,-1974
266,2022/7/15 18:40,28,116,-88,-3725
266,2022/7/15 18:50,28,121,-93,-2847
266,2022/7/15 19:00,26,128,-102,-2705
266,2022/7/15 19:10,24,107,-83,-2328
266,2022/7/15 19:20,24,126,-102,-2249
266,2022/7/15 19:30,21,77,-56,-1508
266,2022/7/15 19:40,23,105,-82,-1215
266,2022/7/15 19:50,19,79,-60,-877
266,2022/7/15 20:00,17,77,-60,-630
266,2022/7/15 20:10,16,64,-48,-78
266,2022/7/15 20:20,18,77,-59,-217
266,2022/7/15 20:30,12,69,-57,-140
266,2022/7/15 20:40,17,63,-46,-196
266,2022/7/15 20:50,16,75,-59,-120
266,2022/7/15 21:00,15,67,-52,277
266,2022/7/15 21:10,21,74,-53,369
266,2022/7/15 21:20,14,77,-63,-17
266,2022/7/15 21:30,13,69,-56,-200
266,2022/7/15 21:40,16,68,-52,-411
266,2022/7/15 21:50,16,61,-45,-380
266,2022/7/15 22:00,12,65,-53,393
266,2022/7/15 22:10,10,60,-50,-423
266,2022/7/15 22:20,9,56,-47,-1738
266,2022/7/15 22:30,5,66,-61,-1951
266,2022/7/15 22:40,2,59,-57,-1845
266,2022/7/15 22:50,1,49,-48,-1784
285,2022/7/15 5:00,0,1,-1,-23
285,2022/7/15 5:10,3,1,2,33
285,2022/7/15 5:20,11,1,10,226
285,2022/7/15 5:30,16,1,15,438
285,2022/7/15 5:40,17,1,16,548
285,2022/7/15 5:50,18,1,17,700
285,2022/7/15 6:00,27,5,22,626
285,2022/7/15 6:10,36,1,35,765
285,2022/7/15 6:20,53,8,45,1127
285,2022/7/15 6:30,48,63,-15,1340
285,2022/7/15 6:40,62,63,-1,2015
285,2022/7/15 6:50,97,72,25,2211
285,2022/7/15 7:00,107,75,32,2885
285,2022/7/15 7:10,196,83,113,4089
285,2022/7/15 7:20,241,121,120,6130
285,2022/7/15 7:30,278,97,181,7636
285,2022/7/15 7:40,277,106,171,8563
285,2022/7/15 7:50,300,104,196,10916
285,2022/7/15 8:00,302,124,178,9700
285,2022/7/15 8:10,280,111,169,6072
285,2022/7/15 8:20,255,102,153,2369
285,2022/7/15 8:30,215,126,89,-2172
285,2022/7/15 8:40,157,110,47,-13448
285,2022/7/15 8:50,102,105,-3,-9608
285,2022/7/15 9:00,74,108,-34,-8843
285,2022/7/15 9:10,53,96,-43,-7113
285,2022/7/15 9:20,50,105,-55,-5075
285,2022/7/15 9:30,39,108,-69,-3197
285,2022/7/15 9:40,40,101,-61,-3040
285,2022/7/15 9:50,39,82,-43,-2909
285,2022/7/15 10:00,35,93,-58,-1921
285,2022/7/15 10:10,38,96,-58,-1191
285,2022/7/15 10:20,39,67,-28,-1025
285,2022/7/15 10:30,35,82,-47,-1354
285,2022/7/15 10:40,33,70,-37,-1165
285,2022/7/15 10:50,29,92,-63,-988
285,2022/7/15 11:00,30,66,-36,-1033
285,2022/7/15 11:10,33,65,-32,-926
285,2022/7/15 11:20,35,62,-27,-1027
285,2022/7/15 11:30,28,74,-46,-917
285,2022/7/15 11:40,34,71,-37,-929
285,2022/7/15 11:50,27,66,-39,-808
285,2022/7/15 12:00,35,63,-28,-718
285,2022/7/15 12:10,33,79,-46,-627
285,2022/7/15 12:20,36,67,-31,-652
285,2022/7/15 12:30,33,69,-36,-668
285,2022/7/15 12:40,29,68,-39,-792
285,2022/7/15 12:50,28,82,-54,-853
285,2022/7/15 13:00,37,74,-37,-744
285,2022/7/15 13:10,29,72,-43,-642
285,2022/7/15 13:20,31,71,-40,-657
285,2022/7/15 13:30,31,93,-62,-682
285,2022/7/15 13:40,32,64,-32,-773
285,2022/7/15 13:50,25,73,-48,-614
285,2022/7/15 14:00,31,72,-41,-534
285,2022/7/15 14:10,30,93,-63,-531
285,2022/7/15 14:20,33,80,-47,-457
285,2022/7/15 14:30,35,74,-39,-548
285,2022/7/15 14:40,31,77,-46,-416
285,2022/7/15 14:50,26,90,-64,-356
285,2022/7/15 15:00,33,74,-41,-506
285,2022/7/15 15:10,30,72,-42,-169
285,2022/7/15 15:20,34,75,-41,-352
285,2022/7/15 15:30,35,102,-67,-433
285,2022/7/15 15:40,35,75,-40,-321
285,2022/7/15 15:50,37,84,-47,-396
285,2022/7/15 16:00,33,76,-43,128
285,2022/7/15 16:10,39,108,-69,394
285,2022/7/15 16:20,40,76,-36,90
285,2022/7/15 16:30,39,84,-45,1200
285,2022/7/15 16:40,45,98,-53,1739
285,2022/7/15 16:50,44,118,-74,1214
285,2022/7/15 17:00,47,103,-56,4414
285,2022/7/15 17:10,67,105,-38,5166
285,2022/7/15 17:20,50,106,-56,2113
285,2022/7/15 17:30,62,152,-90,2823
285,2022/7/15 17:40,74,109,-35,4417
285,2022/7/15 17:50,70,168,-98,1227
285,2022/7/15 18:00,54,121,-67,255
285,2022/7/15 18:10,76,180,-104,2869
285,2022/7/15 18:20,40,111,-71,-190
285,2022/7/15 18:30,35,198,-163,-2137
285,2022/7/15 18:40,36,125,-89,-3814
285,2022/7/15 18:50,33,171,-138,-2985
285,2022/7/15 19:00,31,120,-89,-2794
285,2022/7/15 19:10,28,116,-88,-2416
285,2022/7/15 19:20,29,113,-84,-2333
285,2022/7/15 19:30,25,116,-91,-1599
285,2022/7/15 19:40,25,88,-63,-1278
285,2022/7/15 19:50,23,113,-90,-967
285,2022/7/15 20:00,24,80,-56,-686
285,2022/7/15 20:10,25,99,-74,-152
285,2022/7/15 20:20,27,77,-50,-267
285,2022/7/15 20:30,23,69,-46,-186
285,2022/7/15 20:40,21,71,-50,-246
285,2022/7/15 20:50,22,82,-60,-180
285,2022/7/15 21:00,22,74,-52,225
285,2022/7/15 21:10,21,83,-62,307
285,2022/7/15 21:20,22,85,-63,-80
285,2022/7/15 21:30,17,99,-82,-282
285,2022/7/15 21:40,15,84,-69,-480
285,2022/7/15 21:50,15,86,-71,-451
285,2022/7/15 22:00,15,71,-56,337
285,2022/7/15 22:10,13,71,-58,-481
285,2022/7/15 22:20,10,73,-63,-1801
285,2022/7/15 22:30,2,84,-82,-2033
285,2022/7/15 22:40,0,66,-66,-1911
285,2022/7/15 22:50,0,50,-50,-1834
275,2022/7/15 5:00,1,1,0,-23
275,2022/7/15 5:10,13,1,12,45
275,2022/7/15 5:20,28,1,27,253
275,2022/7/15 5:30,30,1,29,467
275,2022/7/15 5:40,30,1,29,577
275,2022/7/15 5:50,36,1,35,735
275,2022/7/15 6:00,33,1,32,658
275,2022/7/15 6:10,59,1,58,823
275,2022/7/15 6:20,79,1,78,1205
275,2022/7/15 6:30,88,49,39,1379
275,2022/7/15 6:40,206,70,136,2151
275,2022/7/15 6:50,190,67,123,2334
275,2022/7/15 7:00,277,70,207,3092
275,2022/7/15 7:10,303,69,234,4323
275,2022/7/15 7:20,378,77,301,6431
275,2022/7/15 7:30,599,79,520,8156
275,2022/7/15 7:40,602,118,484,9047
275,2022/7/15 7:50,666,76,590,11506
275,2022/7/15 8:00,657,72,585,10285
275,2022/7/15 8:10,631,99,532,6604
275,2022/7/15 8:20,369,75,294,2663
275,2022/7/15 8:30,302,76,226,-1946
275,2022/7/15 8:40,278,83,195,-13253
275,2022/7/15 8:50,185,62,123,-9485
275,2022/7/15 9:00,145,67,78,-8765
275,2022/7/15 9:10,83,64,19,-7094
275,2022/7/15 9:20,70,74,-4,-5079
275,2022/7/15 9:30,59,57,2,-3195
275,2022/7/15 9:40,48,70,-22,-3062
275,2022/7/15 9:50,41,73,-32,-2941
275,2022/7/15 10:00,37,62,-25,-1946
275,2022/7/15 10:10,37,69,-32,-1223
275,2022/7/15 10:20,26,57,-31,-1056
275,2022/7/15 10:30,28,69,-41,-1395
275,2022/7/15 10:40,30,56,-26,-1191
275,2022/7/15 10:50,36,62,-26,-1014
275,2022/7/15 11:00,33,78,-45,-1078
275,2022/7/15 11:10,28,65,-37,-963
275,2022/7/15 11:20,28,63,-35,-1062
275,2022/7/15 11:30,26,67,-41,-958
275,2022/7/15 11:40,27,85,-58,-987
275,2022/7/15 11:50,29,70,-41,-849
275,2022/7/15 12:00,35,60,-25,-743
275,2022/7/15 12:10,35,65,-30,-657
275,2022/7/15 12:20,36,82,-46,-698
275,2022/7/15 12:30,38,62,-24,-692
275,2022/7/15 12:40,39,62,-23,-815
275,2022/7/15 12:50,37,65,-28,-881
275,2022/7/15 13:00,34,89,-55,-799
275,2022/7/15 13:10,35,73,-38,-680
275,2022/7/15 13:20,28,74,-46,-703
275,2022/7/15 13:30,32,67,-35,-717
275,2022/7/15 13:40,29,90,-61,-834
275,2022/7/15 13:50,27,72,-45,-659
275,2022/7/15 14:00,29,70,-41,-575
275,2022/7/15 14:10,28,71,-43,-574
275,2022/7/15 14:20,24,101,-77,-534
275,2022/7/15 14:30,22,76,-54,-602
275,2022/7/15 14:40,33,66,-33,-449
275,2022/7/15 14:50,46,69,-23,-379
275,2022/7/15 15:00,46,101,-55,-561
275,2022/7/15 15:10,38,87,-49,-218
275,2022/7/15 15:20,34,79,-45,-397
275,2022/7/15 15:30,33,91,-58,-491
275,2022/7/15 15:40,34,118,-84,-405
275,2022/7/15 15:50,33,102,-69,-465
275,2022/7/15 16:00,26,93,-67,61
275,2022/7/15 16:10,28,93,-65,329
275,2022/7/15 16:20,35,110,-75,15
275,2022/7/15 16:30,37,102,-65,1135
275,2022/7/15 16:40,47,106,-59,1680
275,2022/7/15 16:50,42,104,-62,1152
275,2022/7/15 17:00,42,191,-149,4265
275,2022/7/15 17:10,46,121,-75,5091
275,2022/7/15 17:20,41,103,-62,2051
275,2022/7/15 17:30,37,233,-196,2627
275,2022/7/15 17:40,39,191,-152,4265
275,2022/7/15 17:50,30,253,-223,1004
275,2022/7/15 18:00,28,299,-271,-16
275,2022/7/15 18:10,37,320,-283,2586
275,2022/7/15 18:20,28,294,-266,-456
275,2022/7/15 18:30,26,316,-290,-2427
275,2022/7/15 18:40,29,331,-302,-4116
275,2022/7/15 18:50,27,321,-294,-3279
275,2022/7/15 19:00,22,294,-272,-3066
275,2022/7/15 19:10,23,301,-278,-2694
275,2022/7/15 19:20,22,182,-160,-2493
275,2022/7/15 19:30,19,145,-126,-1725
275,2022/7/15 19:40,18,109,-91,-1369
275,2022/7/15 19:50,18,124,-106,-1073
275,2022/7/15 20:00,16,106,-90,-776
275,2022/7/15 20:10,21,124,-103,-255
275,2022/7/15 20:20,22,108,-86,-353
275,2022/7/15 20:30,21,107,-86,-272
275,2022/7/15 20:40,17,104,-87,-333
275,2022/7/15 20:50,22,111,-89,-269
275,2022/7/15 21:00,24,111,-87,138
275,2022/7/15 21:10,22,100,-78,229
275,2022/7/15 21:20,17,107,-90,-170
275,2022/7/15 21:30,15,103,-88,-370
275,2022/7/15 21:40,13,107,-94,-574
275,2022/7/15 21:50,11,106,-95,-546
275,2022/7/15 22:00,11,124,-113,224
275,2022/7/15 22:10,10,95,-85,-566
275,2022/7/15 22:20,3,85,-82,-1883
275,2022/7/15 22:30,1,81,-80,-2113
275,2022/7/15 22:40,0,108,-108,-2019
275,2022/7/15 22:50,0,94,-94,-1928
281,2022/7/15 5:00,3,1,2,-21
281,2022/7/15 5:10,22,1,21,66
281,2022/7/15 5:20,33,1,32,285
281,2022/7/15 5:30,34,1,33,500
281,2022/7/15 5:40,36,1,35,612
281,2022/7/15 5:50,44,1,43,778
281,2022/7/15 6:00,69,1,68,726
281,2022/7/15 6:10,110,1,109,932
281,2022/7/15 6:20,199,1,198,1403
281,2022/7/15 6:30,249,45,204,1583
281,2022/7/15 6:40,339,45,294,2445
281,2022/7/15 6:50,369,72,297,2631
281,2022/7/15 7:00,630,81,549,3641
281,2022/7/15 7:10,735,85,650,4973
281,2022/7/15 7:20,1166,82,1084,7515
281,2022/7/15 7:30,1207,74,1133,9289
281,2022/7/15 7:40,1214,90,1124,10171
281,2022/7/15 7:50,1365,127,1238,12744
281,2022/7/15 8:00,1366,93,1273,11558
281,2022/7/15 8:10,1179,95,1084,7688
281,2022/7/15 8:20,743,106,637,3300
281,2022/7/15 8:30,598,108,490,-1456
281,2022/7/15 8:40,374,92,282,-12971
281,2022/7/15 8:50,318,74,244,-9241
281,2022/7/15 9:00,232,78,154,-8611
281,2022/7/15 9:10,175,65,110,-6984
281,2022/7/15 9:20,122,76,46,-5033
281,2022/7/15 9:30,73,62,11,-3184
281,2022/7/15 9:40,53,72,-19,-3081
281,2022/7/15 9:50,47,80,-33,-2974
281,2022/7/15 10:00,45,68,-23,-1969
281,2022/7/15 10:10,39,62,-23,-1246
281,2022/7/15 10:20,43,65,-22,-1078
281,2022/7/15 10:30,37,77,-40,-1435
281,2022/7/15 10:40,33,67,-34,-1225
281,2022/7/15 10:50,31,54,-23,-1037
281,2022/7/15 11:00,30,67,-37,-1115
281,2022/7/15 11:10,31,76,-45,-1008
281,2022/7/15 11:20,31,64,-33,-1095
281,2022/7/15 11:30,32,61,-29,-987
281,2022/7/15 11:40,37,61,-24,-1011
281,2022/7/15 11:50,36,81,-45,-894
281,2022/7/15 12:00,36,65,-29,-772
281,2022/7/15 12:10,42,61,-19,-676
281,2022/7/15 12:20,43,59,-16,-714
281,2022/7/15 12:30,40,88,-48,-740
281,2022/7/15 12:40,36,65,-29,-844
281,2022/7/15 12:50,34,63,-29,-910
281,2022/7/15 13:00,32,66,-34,-833
281,2022/7/15 13:10,32,91,-59,-739
281,2022/7/15 13:20,29,71,-42,-745
281,2022/7/15 13:30,28,74,-46,-763
281,2022/7/15 13:40,26,72,-46,-880
281,2022/7/15 13:50,26,91,-65,-724
281,2022/7/15 14:00,32,67,-35,-610
281,2022/7/15 14:10,29,71,-42,-616
281,2022/7/15 14:20,28,72,-44,-578
281,2022/7/15 14:30,24,105,-81,-683
281,2022/7/15 14:40,26,83,-57,-506
281,2022/7/15 14:50,28,72,-44,-423
281,2022/7/15 15:00,28,77,-49,-610
281,2022/7/15 15:10,33,105,-72,-290
281,2022/7/15 15:20,28,87,-59,-456
281,2022/7/15 15:30,33,78,-45,-536
281,2022/7/15 15:40,26,91,-65,-470
281,2022/7/15 15:50,29,116,-87,-552
281,2022/7/15 16:00,34,104,-70,-9
281,2022/7/15 16:10,35,93,-58,271
281,2022/7/15 16:20,35,111,-76,-61
281,2022/7/15 16:30,44,122,-78,1057
281,2022/7/15 16:40,37,120,-83,1597
281,2022/7/15 16:50,40,116,-76,1076
281,2022/7/15 17:00,40,125,-85,4180
281,2022/7/15 17:10,63,231,-168,4923
281,2022/7/15 17:20,45,144,-99,1952
281,2022/7/15 17:30,41,142,-101,2526
281,2022/7/15 17:40,42,378,-336,3929
281,2022/7/15 17:50,36,190,-154,850
281,2022/7/15 18:00,33,506,-473,-489
281,2022/7/15 18:10,37,196,-159,2427
281,2022/7/15 18:20,35,431,-396,-852
281,2022/7/15 18:30,29,233,-204,-2631
281,2022/7/15 18:40,24,421,-397,-4513
281,2022/7/15 18:50,27,222,-195,-3474
281,2022/7/15 19:00,25,506,-481,-3547
281,2022/7/15 19:10,22,181,-159,-2853
281,2022/7/15 19:20,20,328,-308,-2801
281,2022/7/15 19:30,21,111,-90,-1815
281,2022/7/15 19:40,22,226,-204,-1573
281,2022/7/15 19:50,21,104,-83,-1156
281,2022/7/15 20:00,25,151,-126,-902
281,2022/7/15 20:10,23,98,-75,-330
281,2022/7/15 20:20,19,110,-91,-444
281,2022/7/15 20:30,18,95,-77,-349
281,2022/7/15 20:40,20,110,-90,-423
281,2022/7/15 20:50,18,133,-115,-384
281,2022/7/15 21:00,18,97,-79,59
281,2022/7/15 21:10,14,104,-90,139
281,2022/7/15 21:20,13,112,-99,-269
281,2022/7/15 21:30,14,110,-96,-466
281,2022/7/15 21:40,12,108,-96,-670
281,2022/7/15 21:50,12,107,-95,-641
281,2022/7/15 22:00,13,110,-97,127
281,2022/7/15 22:10,13,112,-99,-665
281,2022/7/15 22:20,6,121,-115,-1998
281,2022/7/15 22:30,0,101,-101,-2214
281,2022/7/15 22:40,0,103,-103,-2122
281,2022/7/15 22:50,0,99,-99,-2027
310,2022/7/15 5:00,0,1,-1,-1
310,2022/7/15 5:10,3,1,2,2
310,2022/7/15 5:20,8,1,7,7
310,2022/7/15 5:30,7,1,6,6
310,2022/7/15 5:40,12,1,11,11
310,2022/7/15 5:50,21,1,20,20
310,2022/7/15 6:00,22,1,21,21
310,2022/7/15 6:10,34,1,33,33
310,2022/7/15 6:20,34,73,-39,-39
310,2022/7/15 6:30,62,63,-1,-1
310,2022/7/15 6:40,85,71,14,14
310,2022/7/15 6:50,101,73,28,28
310,2022/7/15 7:00,196,92,104,104
310,2022/7/15 7:10,246,124,122,122
310,2022/7/15 7:20,322,118,204,204
310,2022/7/15 7:30,570,108,462,462
310,2022/7/15 7:40,657,197,460,460
310,2022/7/15 7:50,824,334,490,490
310,2022/7/15 8:00,1044,430,614,614
310,2022/7/15 8:10,1038,478,560,560
310,2022/7/15 8:20,1045,576,469,469
310,2022/7/15 8:30,824,1136,-312,-312
310,2022/7/15 8:40,640,615,25,25
310,2022/7/15 8:50,437,432,5,5
310,2022/7/15 9:00,296,432,-136,-136
310,2022/7/15 9:10,266,341,-75,-75
310,2022/7/15 9:20,220,330,-110,-110
310,2022/7/15 9:30,180,297,-117,-117
310,2022/7/15 9:40,140,157,-17,-17
310,2022/7/15 9:50,94,137,-43,-43
310,2022/7/15 10:00,76,120,-44,-44
310,2022/7/15 10:10,76,103,-27,-27
310,2022/7/15 10:20,76,120,-44,-44
310,2022/7/15 10:30,69,109,-40,-40
310,2022/7/15 10:40,67,93,-26,-26
310,2022/7/15 10:50,60,105,-45,-45
310,2022/7/15 11:00,65,105,-40,-40
310,2022/7/15 11:10,62,101,-39,-39
310,2022/7/15 11:20,60,99,-39,-39
310,2022/7/15 11:30,75,70,5,5
310,2022/7/15 11:40,64,100,-36,-36
310,2022/7/15 11:50,57,96,-39,-39
310,2022/7/15 12:00,59,99,-40,-40
310,2022/7/15 12:10,59,103,-44,-44
310,2022/7/15 12:20,62,85,-23,-23
310,2022/7/15 12:30,63,108,-45,-45
310,2022/7/15 12:40,51,108,-57,-57
310,2022/7/15 12:50,62,112,-50,-50
310,2022/7/15 13:00,56,107,-51,-51
310,2022/7/15 13:10,58,109,-51,-51
310,2022/7/15 13:20,53,95,-42,-42
310,2022/7/15 13:30,59,114,-55,-55
310,2022/7/15 13:40,67,103,-36,-36
310,2022/7/15 13:50,67,122,-55,-55
310,2022/7/15 14:00,63,125,-62,-62
310,2022/7/15 14:10,68,96,-28,-28
310,2022/7/15 14:20,70,107,-37,-37
310,2022/7/15 14:30,76,125,-49,-49
310,2022/7/15 14:40,74,87,-13,-13
310,2022/7/15 14:50,71,127,-56,-56
310,2022/7/15 15:00,73,112,-39,-39
310,2022/7/15 15:10,81,90,-9,-9
310,2022/7/15 15:20,85,104,-19,-19
310,2022/7/15 15:30,120,123,-3,-3
310,2022/7/15 15:40,121,124,-3,-3
310,2022/7/15 15:50,118,117,1,1
310,2022/7/15 16:00,134,83,51,51
310,2022/7/15 16:10,151,112,39,39
310,2022/7/15 16:20,165,97,68,68
310,2022/7/15 16:30,236,122,114,114
310,2022/7/15 16:40,295,126,169,169
310,2022/7/15 16:50,328,122,206,206
310,2022/7/15 17:00,580,105,475,475
310,2022/7/15 17:10,699,120,579,579
310,2022/7/15 17:20,572,149,423,423
310,2022/7/15 17:30,658,212,446,446
310,2022/7/15 17:40,1205,144,1061,1061
310,2022/7/15 17:50,681,298,383,383
310,2022/7/15 18:00,650,336,314,314
310,2022/7/15 18:10,709,216,493,493
310,2022/7/15 18:20,459,326,133,133
310,2022/7/15 18:30,335,327,8,8
310,2022/7/15 18:40,271,300,-29,-29
310,2022/7/15 18:50,225,196,29,29
310,2022/7/15 19:00,163,198,-35,-35
310,2022/7/15 19:10,113,192,-79,-79
310,2022/7/15 19:20,78,132,-54,-54
310,2022/7/15 19:30,75,116,-41,-41
310,2022/7/15 19:40,63,118,-55,-55
310,2022/7/15 19:50,46,112,-66,-66
310,2022/7/15 20:00,43,113,-70,-70
310,2022/7/15 20:10,46,106,-60,-60
310,2022/7/15 20:20,62,106,-44,-44
310,2022/7/15 20:30,46,106,-60,-60
310,2022/7/15 20:40,47,92,-45,-45
310,2022/7/15 20:50,42,106,-64,-64
310,2022/7/15 21:00,38,104,-66,-66
310,2022/7/15 21:10,44,113,-69,-69
310,2022/7/15 21:20,36,95,-59,-59
310,2022/7/15 21:30,31,101,-70,-70
310,2022/7/15 21:40,35,100,-65,-65
310,2022/7/15 21:50,28,84,-56,-56
310,2022/7/15 22:00,27,94,-67,-67
310,2022/7/15 22:10,32,88,-56,-56
310,2022/7/15 22:20,26,67,-41,-41
310,2022/7/15 22:30,0,73,-73,-73
310,2022/7/15 22:40,0,79,-79,-79
310,2022/7/15 22:50,0,49,-49,-49
300,2022/7/15 5:00,0,1,-1,-2
300,2022/7/15 5:10,3,1,2,4
300,2022/7/15 5:20,7,1,6,13
300,2022/7/15 5:30,9,1,8,14
300,2022/7/15 5:40,11,1,10,21
300,2022/7/15 5:50,17,6,11,31
300,2022/7/15 6:00,18,2,16,37
300,2022/7/15 6:10,23,38,-15,18
300,2022/7/15 6:20,23,42,-19,-58
300,2022/7/15 6:30,31,55,-24,-25
300,2022/7/15 6:40,39,69,-30,-16
300,2022/7/15 6:50,42,83,-41,-13
300,2022/7/15 7:00,54,105,-51,53
300,2022/7/15 7:10,55,101,-46,76
300,2022/7/15 7:20,73,121,-48,156
300,2022/7/15 7:30,80,178,-98,364
300,2022/7/15 7:40,154,233,-79,381
300,2022/7/15 7:50,184,382,-198,292
300,2022/7/15 8:00,234,1638,-1404,-790
300,2022/7/15 8:10,231,2056,-1825,-1265
300,2022/7/15 8:20,243,2708,-2465,-1996
300,2022/7/15 8:30,223,4315,-4092,-4404
300,2022/7/15 8:40,216,6540,-6324,-6299
300,2022/7/15 8:50,180,4458,-4278,-4273
300,2022/7/15 9:00,122,2643,-2521,-2657
300,2022/7/15 9:10,82,1693,-1611,-1686
300,2022/7/15 9:20,74,597,-523,-633
300,2022/7/15 9:30,61,561,-500,-617
300,2022/7/15 9:40,56,427,-371,-388
300,2022/7/15 9:50,50,319,-269,-312
300,2022/7/15 10:00,48,223,-175,-219
300,2022/7/15 10:10,49,222,-173,-200
300,2022/7/15 10:20,50,183,-133,-177
300,2022/7/15 10:30,46,103,-57,-97
300,2022/7/15 10:40,53,144,-91,-117
300,2022/7/15 10:50,57,144,-87,-132
300,2022/7/15 11:00,52,111,-59,-99
300,2022/7/15 11:10,46,119,-73,-112
300,2022/7/15 11:20,58,126,-68,-107
300,2022/7/15 11:30,63,108,-45,-40
300,2022/7/15 11:40,67,110,-43,-79
300,2022/7/15 11:50,64,109,-45,-84
300,2022/7/15 12:00,72,119,-47,-87
300,2022/7/15 12:10,90,102,-12,-56
300,2022/7/15 12:20,82,108,-26,-49
300,2022/7/15 12:30,88,122,-34,-79
300,2022/7/15 12:40,97,121,-24,-81
300,2022/7/15 12:50,96,139,-43,-93
300,2022/7/15 13:00,133,120,13,-38
300,2022/7/15 13:10,148,123,25,-26
300,2022/7/15 13:20,142,113,29,-13
300,2022/7/15 13:30,140,125,15,-40
300,2022/7/15 13:40,151,152,-1,-37
300,2022/7/15 13:50,136,117,19,-36
300,2022/7/15 14:00,136,108,28,-34
300,2022/7/15 14:10,138,123,15,-13
300,2022/7/15 14:20,132,125,7,-30
300,2022/7/15 14:30,135,119,16,-33
300,2022/7/15 14:40,136,108,28,15
300,2022/7/15 14:50,140,122,18,-38
300,2022/7/15 15:00,177,109,68,29
300,2022/7/15 15:10,177,123,54,45
300,2022/7/15 15:20,183,114,69,50
300,2022/7/15 15:30,185,108,77,74
300,2022/7/15 15:40,180,109,71,68
300,2022/7/15 15:50,183,105,78,79
300,2022/7/15 16:00,208,108,100,151
300,2022/7/15 16:10,218,123,95,134
300,2022/7/15 16:20,214,125,89,157
300,2022/7/15 16:30,261,105,156,270
300,2022/7/15 16:40,307,116,191,360
300,2022/7/15 16:50,288,119,169,375
300,2022/7/15 17:00,641,147,494,969
300,2022/7/15 17:10,653,156,497,1076
300,2022/7/15 17:20,656,211,445,868
300,2022/7/15 17:30,1155,267,888,1334
300,2022/7/15 17:40,1587,296,1291,2352
300,2022/7/15 17:50,1200,321,879,1262
300,2022/7/15 18:00,1347,299,1048,1362
300,2022/7/15 18:10,1979,323,1656,2149
300,2022/7/15 18:20,1558,318,1240,1373
300,2022/7/15 18:30,1154,347,807,815
300,2022/7/15 18:40,827,320,507,478
300,2022/7/15 18:50,671,285,386,415
300,2022/7/15 19:00,577,195,382,347
300,2022/7/15 19:10,579,149,430,351
300,2022/7/15 19:20,371,103,268,214
300,2022/7/15 19:30,337,124,213,172
300,2022/7/15 19:40,318,105,213,158
300,2022/7/15 19:50,270,103,167,101
300,2022/7/15 20:00,306,112,194,124
300,2022/7/15 20:10,327,91,236,176
300,2022/7/15 20:20,314,92,222,178
300,2022/7/15 20:30,333,79,254,194
300,2022/7/15 20:40,348,93,255,210
300,2022/7/15 20:50,305,89,216,152
300,2022/7/15 21:00,321,78,243,177
300,2022/7/15 21:10,437,76,361,292
300,2022/7/15 21:20,317,77,240,181
300,2022/7/15 21:30,318,75,243,173
300,2022/7/15 21:40,268,77,191,126
300,2022/7/15 21:50,205,83,122,66
300,2022/7/15 22:00,267,71,196,129
300,2022/7/15 22:10,595,66,529,473
300,2022/7/15 22:20,58,72,-14,-55
300,2022/7/15 22:30,24,65,-41,-114
300,2022/7/15 22:40,14,62,-48,-127
300,2022/7/15 22:50,6,37,-31,-80
307,2022/7/15 5:00,0,1,-1,-3
307,2022/7/15 5:10,0,1,-1,3
307,2022/7/15 5:20,4,1,3,16
307,2022/7/15 5:30,12,1,11,25
307,2022/7/15 5:40,11,2,9,30
307,2022/7/15 5:50,21,1,20,51
307,2022/7/15 6:00,32,2,30,67
307,2022/7/15 6:10,36,37,-1,17
307,2022/7/15 6:20,47,33,14,-44
307,2022/7/15 6:30,65,64,1,-24
307,2022/7/15 6:40,84,67,17,1
307,2022/7/15 6:50,103,88,15,2
307,2022/7/15 7:00,165,98,67,120
307,2022/7/15 7:10,160,105,55,131
307,2022/7/15 7:20,200,116,84,240
307,2022/7/15 7:30,235,104,131,495
307,2022/7/15 7:40,281,117,164,545
307,2022/7/15 7:50,349,233,116,408
307,2022/7/15 8:00,325,332,-7,-797
307,2022/7/15 8:10,324,378,-54,-1319
307,2022/7/15 8:20,395,333,62,-1934
307,2022/7/15 8:30,335,379,-44,-4448
307,2022/7/15 8:40,282,379,-97,-6396
307,2022/7/15 8:50,234,318,-84,-4357
307,2022/7/15 9:00,216,218,-2,-2659
307,2022/7/15 9:10,179,180,-1,-1687
307,2022/7/15 9:20,117,119,-2,-635
307,2022/7/15 9:30,76,121,-45,-662
307,2022/7/15 9:40,66,122,-56,-444
307,2022/7/15 9:50,49,109,-60,-372
307,2022/7/15 10:00,47,105,-58,-277
307,2022/7/15 10:10,46,96,-50,-250
307,2022/7/15 10:20,43,104,-61,-238
307,2022/7/15 10:30,44,77,-33,-130
307,2022/7/15 10:40,44,93,-49,-166
307,2022/7/15 10:50,41,91,-50,-182
307,2022/7/15 11:00,40,98,-58,-157
307,2022/7/15 11:10,38,79,-41,-153
307,2022/7/15 11:20,41,85,-44,-151
307,2022/7/15 11:30,39,91,-52,-92
307,2022/7/15 11:40,41,76,-35,-114
307,2022/7/15 11:50,40,93,-53,-137
307,2022/7/15 12:00,43,90,-47,-134
307,2022/7/15 12:10,44,70,-26,-82
307,2022/7/15 12:20,46,93,-47,-96
307,2022/7/15 12:30,45,91,-46,-125
307,2022/7/15 12:40,43,109,-66,-147
307,2022/7/15 12:50,43,111,-68,-161
307,2022/7/15 13:00,46,100,-54,-92
307,2022/7/15 13:10,46,90,-44,-70
307,2022/7/15 13:20,43,96,-53,-66
307,2022/7/15 13:30,41,102,-61,-101
307,2022/7/15 13:40,44,111,-67,-104
307,2022/7/15 13:50,37,97,-60,-96
307,2022/7/15 14:00,38,92,-54,-88
307,2022/7/15 14:10,42,99,-57,-70
307,2022/7/15 14:20,42,98,-56,-86
307,2022/7/15 14:30,42,101,-59,-92
307,2022/7/15 14:40,44,111,-67,-52
307,2022/7/15 14:50,41,93,-52,-90
307,2022/7/15 15:00,43,76,-33,-4
307,2022/7/15 15:10,60,109,-49,-4
307,2022/7/15 15:20,47,105,-58,-8
307,2022/7/15 15:30,59,112,-53,21
307,2022/7/15 15:40,44,105,-61,7
307,2022/7/15 15:50,41,76,-35,44
307,2022/7/15 16:00,65,86,-21,130
307,2022/7/15 16:10,74,105,-31,103
307,2022/7/15 16:20,60,119,-59,98
307,2022/7/15 16:30,110,114,-4,266
307,2022/7/15 16:40,148,87,61,421
307,2022/7/15 16:50,132,119,13,388
307,2022/7/15 17:00,209,104,105,1074
307,2022/7/15 17:10,270,110,160,1236
307,2022/7/15 17:20,291,103,188,1056
307,2022/7/15 17:30,267,179,88,1422
307,2022/7/15 17:40,312,183,129,2481
307,2022/7/15 17:50,308,183,125,1387
307,2022/7/15 18:00,235,233,2,1364
307,2022/7/15 18:10,266,256,10,2159
307,2022/7/15 18:20,255,178,77,1450
307,2022/7/15 18:30,207,199,8,823
307,2022/7/15 18:40,173,226,-53,425
307,2022/7/15 18:50,133,192,-59,356
307,2022/7/15 19:00,77,117,-40,307
307,2022/7/15 19:10,65,123,-58,293
307,2022/7/15 19:20,50,111,-61,153
307,2022/7/15 19:30,44,129,-85,87
307,2022/7/15 19:40,45,110,-65,93
307,2022/7/15 19:50,39,109,-70,31
307,2022/7/15 20:00,38,107,-69,55
307,2022/7/15 20:10,36,107,-71,105
307,2022/7/15 20:20,31,102,-71,107
307,2022/7/15 20:30,35,112,-77,117
307,2022/7/15 20:40,26,108,-82,128
307,2022/7/15 20:50,26,111,-85,67
307,2022/7/15 21:00,29,102,-73,104
307,2022/7/15 21:10,29,111,-82,210
307,2022/7/15 21:20,33,105,-72,109
307,2022/7/15 21:30,27,110,-83,90
307,2022/7/15 21:40,26,109,-83,43
307,2022/7/15 21:50,26,112,-86,-20
307,2022/7/15 22:00,25,99,-74,55
307,2022/7/15 22:10,20,100,-80,393
307,2022/7/15 22:20,15,92,-77,-132
307,2022/7/15 22:30,13,121,-108,-222
307,2022/7/15 22:40,3,62,-59,-186
307,2022/7/15 22:50,1,40,-39,-119
298,2022/7/15 5:00,0,1,-1,-4
298,2022/7/15 5:10,0,1,-1,2
298,2022/7/15 5:20,3,1,2,18
298,2022/7/15 5:30,8,1,7,32
298,2022/7/15 5:40,9,2,7,37
298,2022/7/15 5:50,13,2,11,62
298,2022/7/15 6:00,27,11,16,83
298,2022/7/15 6:10,29,24,5,22
298,2022/7/15 6:20,32,29,3,-41
298,2022/7/15 6:30,42,45,-3,-27
298,2022/7/15 6:40,50,45,5,6
298,2022/7/15 6:50,57,69,-12,-10
298,2022/7/15 7:00,80,84,-4,116
298,2022/7/15 7:10,92,91,1,132
298,2022/7/15 7:20,94,105,-11,229
298,2022/7/15 7:30,157,109,48,543
298,2022/7/15 7:40,207,119,88,633
298,2022/7/15 7:50,264,109,155,563
298,2022/7/15 8:00,277,190,87,-710
298,2022/7/15 8:10,302,324,-22,-1341
298,2022/7/15 8:20,353,322,31,-1903
298,2022/7/15 8:30,281,382,-101,-4549
298,2022/7/15 8:40,269,436,-167,-6563
298,2022/7/15 8:50,215,431,-216,-4573
298,2022/7/15 9:00,184,535,-351,-3010
298,2022/7/15 9:10,167,505,-338,-2025
298,2022/7/15 9:20,78,317,-239,-874
298,2022/7/15 9:30,57,232,-175,-837
298,2022/7/15 9:40,57,231,-174,-618
298,2022/7/15 9:50,51,103,-52,-424
298,2022/7/15 10:00,45,119,-74,-351
298,2022/7/15 10:10,47,125,-78,-328
298,2022/7/15 10:20,46,105,-59,-297
298,2022/7/15 10:30,43,109,-66,-196
298,2022/7/15 10:40,43,106,-63,-229
298,2022/7/15 10:50,38,106,-68,-250
298,2022/7/15 11:00,38,96,-58,-215
298,2022/7/15 11:10,39,88,-49,-202
298,2022/7/15 11:20,39,89,-50,-201
298,2022/7/15 11:30,38,91,-53,-145
298,2022/7/15 11:40,38,92,-54,-168
298,2022/7/15 11:50,39,99,-60,-197
298,2022/7/15 12:00,43,89,-46,-180
298,2022/7/15 12:10,43,90,-47,-129
298,2022/7/15 12:20,40,98,-58,-154
298,2022/7/15 12:30,39,93,-54,-179
298,2022/7/15 12:40,42,106,-64,-211
298,2022/7/15 12:50,39,106,-67,-228
298,2022/7/15 13:00,42,99,-57,-149
298,2022/7/15 13:10,38,108,-70,-140
298,2022/7/15 13:20,44,113,-69,-135
298,2022/7/15 13:30,44,103,-59,-160
298,2022/7/15 13:40,45,104,-59,-163
298,2022/7/15 13:50,46,102,-56,-152
298,2022/7/15 14:00,49,104,-55,-143
298,2022/7/15 14:10,45,103,-58,-128
298,2022/7/15 14:20,44,99,-55,-141
298,2022/7/15 14:30,49,108,-59,-151
298,2022/7/15 14:40,44,96,-52,-104
298,2022/7/15 14:50,46,93,-47,-137
298,2022/7/15 15:00,52,92,-40,-44
298,2022/7/15 15:10,54,108,-54,-58
298,2022/7/15 15:20,52,111,-59,-67
298,2022/7/15 15:30,62,104,-42,-21
298,2022/7/15 15:40,62,105,-43,-36
298,2022/7/15 15:50,52,93,-41,3
298,2022/7/15 16:00,61,112,-51,79
298,2022/7/15 16:10,77,97,-20,83
298,2022/7/15 16:20,70,103,-33,65
298,2022/7/15 16:30,96,105,-9,257
298,2022/7/15 16:40,175,100,75,496
298,2022/7/15 16:50,134,107,27,415
298,2022/7/15 17:00,179,107,72,1146
298,2022/7/15 17:10,234,120,114,1350
298,2022/7/15 17:20,179,118,61,1117
298,2022/7/15 17:30,231,108,123,1545
298,2022/7/15 17:40,275,150,125,2606
298,2022/7/15 17:50,208,206,2,1389
298,2022/7/15 18:00,268,198,70,1434
298,2022/7/15 18:10,643,158,485,2644
298,2022/7/15 18:20,314,224,90,1540
298,2022/7/15 18:30,275,208,67,890
298,2022/7/15 18:40,350,184,166,591
298,2022/7/15 18:50,243,116,127,483
298,2022/7/15 19:00,214,111,103,410
298,2022/7/15 19:10,188,124,64,357
298,2022/7/15 19:20,148,107,41,194
298,2022/7/15 19:30,103,112,-9,78
298,2022/7/15 19:40,77,106,-29,64
298,2022/7/15 19:50,65,97,-32,-1
298,2022/7/15 20:00,59,83,-24,31
298,2022/7/15 20:10,64,94,-30,75
298,2022/7/15 20:20,46,93,-47,60
298,2022/7/15 20:30,47,84,-37,80
298,2022/7/15 20:40,47,81,-34,94
298,2022/7/15 20:50,42,95,-53,14
298,2022/7/15 21:00,47,80,-33,71
298,2022/7/15 21:10,42,88,-46,164
298,2022/7/15 21:20,38,89,-51,58
298,2022/7/15 21:30,36,88,-52,38
298,2022/7/15 21:40,28,84,-56,-13
298,2022/7/15 21:50,31,80,-49,-69
298,2022/7/15 22:00,28,72,-44,11
298,2022/7/15 22:10,27,77,-50,343
298,2022/7/15 22:20,25,79,-54,-186
298,2022/7/15 22:30,19,60,-41,-263
298,2022/7/15 22:40,10,67,-57,-243
298,2022/7/15 22:50,1,21,-20,-139
292,2022/7/15 5:00,0,1,-1,-5
292,2022/7/15 5:10,0,1,-1,1
292,2022/7/15 5:20,0,1,-1,17
292,2022/7/15 5:30,6,1,5,37
292,2022/7/15 5:40,10,5,5,42
292,2022/7/15 5:50,15,1,14,76
292,2022/7/15 6:00,21,23,-2,81
292,2022/7/15 6:10,23,54,-31,-9
292,2022/7/15 6:20,28,52,-24,-65
292,2022/7/15 6:30,32,85,-53,-80
292,2022/7/15 6:40,35,102,-67,-61
292,2022/7/15 6:50,43,144,-101,-111
292,2022/7/15 7:00,52,230,-178,-62
292,2022/7/15 7:10,58,325,-267,-135
292,2022/7/15 7:20,78,344,-266,-37
292,2022/7/15 7:30,102,534,-432,111
292,2022/7/15 7:40,176,432,-256,377
292,2022/7/15 7:50,215,431,-216,347
292,2022/7/15 8:00,234,572,-338,-1048
292,2022/7/15 8:10,259,1527,-1268,-2609
292,2022/7/15 8:20,286,1524,-1238,-3141
292,2022/7/15 8:30,278,2694,-2416,-6965
292,2022/7/15 8:40,226,3240,-3014,-9577
292,2022/7/15 8:50,222,2568,-2346,-6919
292,2022/7/15 9:00,222,1927,-1705,-4715
292,2022/7/15 9:10,216,1614,-1398,-3423
292,2022/7/15 9:20,202,619,-417,-1291
292,2022/7/15 9:30,183,599,-416,-1253
292,2022/7/15 9:40,167,460,-293,-911
292,2022/7/15 9:50,160,527,-367,-791
292,2022/7/15 10:00,138,434,-296,-647
292,2022/7/15 10:10,173,297,-124,-452
292,2022/7/15 10:20,178,330,-152,-449
292,2022/7/15 10:30,178,318,-140,-336
292,2022/7/15 10:40,174,216,-42,-271
292,2022/7/15 10:50,177,296,-119,-369
292,2022/7/15 11:00,174,232,-58,-273
292,2022/7/15 11:10,197,177,20,-182
292,2022/7/15 11:20,177,217,-40,-241
292,2022/7/15 11:30,184,179,5,-140
292,2022/7/15 11:40,212,254,-42,-210
292,2022/7/15 11:50,217,298,-81,-278
292,2022/7/15 12:00,222,231,-9,-189
292,2022/7/15 12:10,233,221,12,-117
292,2022/7/15 12:20,224,195,29,-125
292,2022/7/15 12:30,237,206,31,-148
292,2022/7/15 12:40,227,313,-86,-297
292,2022/7/15 12:50,241,318,-77,-305
292,2022/7/15 13:00,258,252,6,-143
292,2022/7/15 13:10,268,281,-13,-153
292,2022/7/15 13:20,271,195,76,-59
292,2022/7/15 13:30,273,283,-10,-170
292,2022/7/15 13:40,272,320,-48,-211
292,2022/7/15 13:50,270,217,53,-99
292,2022/7/15 14:00,271,226,45,-98
292,2022/7/15 14:10,288,214,74,-54
292,2022/7/15 14:20,290,178,112,-29
292,2022/7/15 14:30,349,197,152,1
292,2022/7/15 14:40,315,208,107,3
292,2022/7/15 14:50,313,150,163,26
292,2022/7/15 15:00,334,226,108,64
292,2022/7/15 15:10,328,181,147,89
292,2022/7/15 15:20,322,129,193,126
292,2022/7/15 15:30,314,226,88,67
292,2022/7/15 15:40,329,178,151,115
292,2022/7/15 15:50,310,234,76,79
292,2022/7/15 16:00,430,145,285,364
292,2022/7/15 16:10,583,181,402,485
292,2022/7/15 16:20,612,197,415,480
292,2022/7/15 16:30,643,213,430,687
292,2022/7/15 16:40,644,178,466,962
292,2022/7/15 16:50,696,207,489,904
292,2022/7/15 17:00,1030,265,765,1911
292,2022/7/15 17:10,1189,193,996,2346
292,2022/7/15 17:20,1011,307,704,1821
292,2022/7/15 17:30,1343,494,849,2394
292,2022/7/15 17:40,1973,426,1547,4153
292,2022/7/15 17:50,1204,514,690,2079
292,2022/7/15 18:00,1209,415,794,2228
292,2022/7/15 18:10,1538,431,1107,3751
292,2022/7/15 18:20,1153,489,664,2204
292,2022/7/15 18:30,715,415,300,1190
292,2022/7/15 18:40,704,412,292,883
292,2022/7/15 18:50,698,423,275,758
292,2022/7/15 19:00,698,313,385,795
292,2022/7/15 19:10,579,294,285,642
292,2022/7/15 19:20,570,209,361,555
292,2022/7/15 19:30,465,145,320,398
292,2022/7/15 19:40,369,123,246,310
292,2022/7/15 19:50,354,125,229,228
292,2022/7/15 20:00,563,120,443,474
292,2022/7/15 20:10,553,107,446,521
292,2022/7/15 20:20,470,111,359,419
292,2022/7/15 20:30,577,94,483,563
292,2022/7/15 20:40,561,112,449,543
292,2022/7/15 20:50,430,92,338,352
292,2022/7/15 21:00,554,107,447,518
292,2022/7/15 21:10,585,110,475,639
292,2022/7/15 21:20,368,89,279,337
292,2022/7/15 21:30,328,92,236,274
292,2022/7/15 21:40,310,95,215,202
292,2022/7/15 21:50,285,92,193,124
292,2022/7/15 22:00,346,83,263,274
292,2022/7/15 22:10,182,83,99,442
292,2022/7/15 22:20,64,75,-11,-197
292,2022/7/15 22:30,42,89,-47,-310
292,2022/7/15 22:40,24,55,-31,-274
292,2022/7/15 22:50,2,31,-29,-168
296,2022/7/15 5:00,0,1,-1,-6
296,2022/7/15 5:10,0,1,-1,0
296,2022/7/15 5:20,0,1,-1,16
296,2022/7/15 5:30,4,1,3,40
296,2022/7/15 5:40,7,1,6,48
296,2022/7/15 5:50,16,1,15,91
296,2022/7/15 6:00,24,6,18,99
296,2022/7/15 6:10,23,23,0,-9
296,2022/7/15 6:20,33,31,2,-63
296,2022/7/15 6:30,38,38,0,-80
296,2022/7/15 6:40,41,63,-22,-83
296,2022/7/15 6:50,59,70,-11,-122
296,2022/7/15 7:00,76,85,-9,-71
296,2022/7/15 7:10,88,89,-1,-136
296,2022/7/15 7:20,146,98,48,11
296,2022/7/15 7:30,187,124,63,174
296,2022/7/15 7:40,214,111,103,480
296,2022/7/15 7:50,248,192,56,403
296,2022/7/15 8:00,277,321,-44,-1092
296,2022/7/15 8:10,282,492,-210,-2819
296,2022/7/15 8:20,276,432,-156,-3297
296,2022/7/15 8:30,256,478,-222,-7187
296,2022/7/15 8:40,217,608,-391,-9968
296,2022/7/15 8:50,187,584,-397,-7316
296,2022/7/15 9:00,149,428,-279,-4994
296,2022/7/15 9:10,120,379,-259,-3682
296,2022/7/15 9:20,75,344,-269,-1560
296,2022/7/15 9:30,67,299,-232,-1485
296,2022/7/15 9:40,59,182,-123,-1034
296,2022/7/15 9:50,50,211,-161,-952
296,2022/7/15 10:00,43,121,-78,-725
296,2022/7/15 10:10,42,152,-110,-562
296,2022/7/15 10:20,45,118,-73,-522
296,2022/7/15 10:30,44,110,-66,-402
296,2022/7/15 10:40,42,124,-82,-353
296,2022/7/15 10:50,43,88,-45,-414
296,2022/7/15 11:00,43,96,-53,-326
296,2022/7/15 11:10,44,111,-67,-249
296,2022/7/15 11:20,42,112,-70,-311
296,2022/7/15 11:30,47,112,-65,-205
296,2022/7/15 11:40,49,111,-62,-272
296,2022/7/15 11:50,43,87,-44,-322
296,2022/7/15 12:00,45,90,-45,-234
296,2022/7/15 12:10,44,111,-67,-184
296,2022/7/15 12:20,44,112,-68,-193
296,2022/7/15 12:30,45,104,-59,-207
296,2022/7/15 12:40,45,104,-59,-356
296,2022/7/15 12:50,43,106,-63,-368
296,2022/7/15 13:00,45,105,-60,-203
296,2022/7/15 13:10,48,105,-57,-210
296,2022/7/15 13:20,43,122,-79,-138
296,2022/7/15 13:30,51,87,-36,-206
296,2022/7/15 13:40,49,105,-56,-267
296,2022/7/15 13:50,42,105,-63,-162
296,2022/7/15 14:00,55,108,-53,-151
296,2022/7/15 14:10,62,103,-41,-95
296,2022/7/15 14:20,47,108,-61,-90
296,2022/7/15 14:30,51,102,-51,-50
296,2022/7/15 14:40,49,101,-52,-49
296,2022/7/15 14:50,60,107,-47,-21
296,2022/7/15 15:00,62,112,-50,14
296,2022/7/15 15:10,69,98,-29,60
296,2022/7/15 15:20,71,112,-41,85
296,2022/7/15 15:30,85,106,-21,46
296,2022/7/15 15:40,79,101,-22,93
296,2022/7/15 15:50,69,102,-33,46
296,2022/7/15 16:00,79,103,-24,340
296,2022/7/15 16:10,110,112,-2,483
296,2022/7/15 16:20,129,104,25,505
296,2022/7/15 16:30,180,106,74,761
296,2022/7/15 16:40,198,122,76,1038
296,2022/7/15 16:50,197,120,77,981
296,2022/7/15 17:00,347,106,241,2152
296,2022/7/15 17:10,431,108,323,2669
296,2022/7/15 17:20,330,142,188,2009
296,2022/7/15 17:30,699,115,584,2978
296,2022/7/15 17:40,660,144,516,4669
296,2022/7/15 17:50,337,196,141,2220
296,2022/7/15 18:00,465,222,243,2471
296,2022/7/15 18:10,660,153,507,4258
296,2022/7/15 18:20,354,223,131,2335
296,2022/7/15 18:30,269,214,55,1245
296,2022/7/15 18:40,275,191,84,967
296,2022/7/15 18:50,225,171,54,812
296,2022/7/15 19:00,177,128,49,844
296,2022/7/15 19:10,179,110,69,711
296,2022/7/15 19:20,130,107,23,578
296,2022/7/15 19:30,94,105,-11,387
296,2022/7/15 19:40,83,113,-30,280
296,2022/7/15 19:50,65,107,-42,186
296,2022/7/15 20:00,69,74,-5,469
296,2022/7/15 20:10,77,94,-17,504
296,2022/7/15 20:20,57,98,-41,378
296,2022/7/15 20:30,54,77,-23,540
296,2022/7/15 20:40,61,78,-17,526
296,2022/7/15 20:50,60,66,-6,346
296,2022/7/15 21:00,45,92,-47,471
296,2022/7/15 21:10,74,62,12,651
296,2022/7/15 21:20,46,81,-35,302
296,2022/7/15 21:30,44,82,-38,236
296,2022/7/15 21:40,47,77,-30,172
296,2022/7/15 21:50,41,72,-31,93
296,2022/7/15 22:00,31,77,-46,228
296,2022/7/15 22:10,41,65,-24,418
296,2022/7/15 22:20,30,81,-51,-248
296,2022/7/15 22:30,26,67,-41,-351
296,2022/7/15 22:40,14,47,-33,-307
296,2022/7/15 22:50,0,25,-25,-193
309,2022/7/15 5:00,0,1,-1,-7
309,2022/7/15 5:10,0,1,-1,-1
309,2022/7/15 5:20,1,1,0,16
309,2022/7/15 5:30,3,1,2,42
309,2022/7/15 5:40,7,1,6,54
309,2022/7/15 5:50,17,16,1,92
309,2022/7/15 6:00,16,37,-21,78
309,2022/7/15 6:10,22,32,-10,-19
309,2022/7/15 6:20,27,65,-38,-101
309,2022/7/15 6:30,32,96,-64,-144
309,2022/7/15 6:40,35,104,-69,-152
309,2022/7/15 6:50,43,125,-82,-204
309,2022/7/15 7:00,52,190,-138,-209
309,2022/7/15 7:10,73,318,-245,-381
309,2022/7/15 7:20,78,253,-175,-164
309,2022/7/15 7:30,115,298,-183,-9
309,2022/7/15 7:40,154,324,-170,310
309,2022/7/15 7:50,195,436,-241,162
309,2022/7/15 8:00,236,401,-165,-1257
309,2022/7/15 8:10,226,1126,-900,-3719
309,2022/7/15 8:20,248,1597,-1349,-4646
309,2022/7/15 8:30,239,2009,-1770,-8957
309,2022/7/15 8:40,233,2604,-2371,-12339
309,2022/7/15 8:50,184,2706,-2522,-9838
309,2022/7/15 9:00,188,1865,-1677,-6671
309,2022/7/15 9:10,161,1676,-1515,-5197
309,2022/7/15 9:20,148,1199,-1051,-2611
309,2022/7/15 9:30,115,469,-354,-1839
309,2022/7/15 9:40,92,409,-317,-1351
309,2022/7/15 9:50,80,317,-237,-1189
309,2022/7/15 10:00,69,283,-214,-939
309,2022/7/15 10:10,76,213,-137,-699
309,2022/7/15 10:20,76,218,-142,-664
309,2022/7/15 10:30,66,192,-126,-528
309,2022/7/15 10:40,70,159,-89,-442
309,2022/7/15 10:50,66,122,-56,-470
309,2022/7/15 11:00,75,120,-45,-371
309,2022/7/15 11:10,76,143,-67,-316
309,2022/7/15 11:20,87,112,-25,-336
309,2022/7/15 11:30,126,110,16,-189
309,2022/7/15 11:40,74,120,-46,-318
309,2022/7/15 11:50,78,108,-30,-352
309,2022/7/15 12:00,93,108,-15,-249
309,2022/7/15 12:10,129,109,20,-164
309,2022/7/15 12:20,96,171,-75,-268
309,2022/7/15 12:30,86,171,-85,-292
309,2022/7/15 12:40,85,170,-85,-441
309,2022/7/15 12:50,73,192,-119,-487
309,2022/7/15 13:00,85,192,-107,-310
309,2022/7/15 13:10,109,192,-83,-293
309,2022/7/15 13:20,103,192,-89,-227
309,2022/7/15 13:30,136,139,-3,-209
309,2022/7/15 13:40,141,181,-40,-307
309,2022/7/15 13:50,128,152,-24,-186
309,2022/7/15 14:00,136,117,19,-132
309,2022/7/15 14:10,150,117,33,-62
309,2022/7/15 14:20,135,124,11,-79
309,2022/7/15 14:30,128,127,1,-49
309,2022/7/15 14:40,155,133,22,-27
309,2022/7/15 14:50,170,129,41,20
309,2022/7/15 15:00,163,111,52,66
309,2022/7/15 15:10,183,121,62,122
309,2022/7/15 15:20,175,108,67,152
309,2022/7/15 15:30,195,109,86,132
309,2022/7/15 15:40,207,105,102,195
309,2022/7/15 15:50,192,109,83,129
309,2022/7/15 16:00,228,115,113,453
309,2022/7/15 16:10,271,109,162,645
309,2022/7/15 16:20,268,109,159,664
309,2022/7/15 16:30,335,110,225,986
309,2022/7/15 16:40,336,109,227,1265
309,2022/7/15 16:50,305,115,190,1171
309,2022/7/15 17:00,376,108,268,2420
309,2022/7/15 17:10,642,183,459,3128
309,2022/7/15 17:20,574,177,397,2406
309,2022/7/15 17:30,654,254,400,3378
309,2022/7/15 17:40,1352,254,1098,5767
309,2022/7/15 17:50,830,298,532,2752
309,2022/7/15 18:00,800,320,480,2951
309,2022/7/15 18:10,1352,333,1019,5277
309,2022/7/15 18:20,1038,318,720,3055
309,2022/7/15 18:30,657,329,328,1573
309,2022/7/15 18:40,643,321,322,1289
309,2022/7/15 18:50,553,234,319,1131
309,2022/7/15 19:00,377,181,196,1040
309,2022/7/15 19:10,329,149,180,891
309,2022/7/15 19:20,269,121,148,726
309,2022/7/15 19:30,231,120,111,498
309,2022/7/15 19:40,228,112,116,396
309,2022/7/15 19:50,217,104,113,299
309,2022/7/15 20:00,262,103,159,628
309,2022/7/15 20:10,228,102,126,630
309,2022/7/15 20:20,211,95,116,494
309,2022/7/15 20:30,226,98,128,668
309,2022/7/15 20:40,238,90,148,674
309,2022/7/15 20:50,225,79,146,492
309,2022/7/15 21:00,267,77,190,661
309,2022/7/15 21:10,268,82,186,837
309,2022/7/15 21:20,210,87,123,425
309,2022/7/15 21:30,245,79,166,402
309,2022/7/15 21:40,210,77,133,305
309,2022/7/15 21:50,134,73,61,154
309,2022/7/15 22:00,599,75,524,752
309,2022/7/15 22:10,271,68,203,621
309,2022/7/15 22:20,71,70,1,-247
309,2022/7/15 22:30,40,63,-23,-374
309,2022/7/15 22:40,26,62,-36,-343
309,2022/7/15 22:50,12,42,-30,-223
311,2022/7/15 5:00,0,1,-1,-8
311,2022/7/15 5:10,0,1,-1,-2
311,2022/7/15 5:20,0,1,-1,15
311,2022/7/15 5:30,3,1,2,44
311,2022/7/15 5:40,6,1,5,59
311,2022/7/15 5:50,10,6,4,96
311,2022/7/15 6:00,12,6,6,84
311,2022/7/15 6:10,17,15,2,-17
311,2022/7/15 6:20,20,28,-8,-109
311,2022/7/15 6:30,26,62,-36,-180
311,2022/7/15 6:40,30,75,-45,-197
311,2022/7/15 6:50,37,71,-34,-238
311,2022/7/15 7:00,43,78,-35,-244
311,2022/7/15 7:10,58,109,-51,-432
311,2022/7/15 7:20,69,98,-29,-193
311,2022/7/15 7:30,85,109,-24,-33
311,2022/7/15 7:40,96,152,-56,254
311,2022/7/15 7:50,151,233,-82,80
311,2022/7/15 8:00,194,517,-323,-1580
311,2022/7/15 8:10,199,551,-352,-4071
311,2022/7/15 8:20,206,586,-380,-5026
311,2022/7/15 8:30,212,1886,-1674,-10631
311,2022/7/15 8:40,162,2787,-2625,-14964
311,2022/7/15 8:50,128,2847,-2719,-12557
311,2022/7/15 9:00,100,1531,-1431,-8102
311,2022/7/15 9:10,74,569,-495,-5692
311,2022/7/15 9:20,72,472,-400,-3011
311,2022/7/15 9:30,65,498,-433,-2272
311,2022/7/15 9:40,58,333,-275,-1626
311,2022/7/15 9:50,52,296,-244,-1433
311,2022/7/15 10:00,57,154,-97,-1036
311,2022/7/15 10:10,47,110,-63,-762
311,2022/7/15 10:20,47,126,-79,-743
311,2022/7/15 10:30,42,108,-66,-594
311,2022/7/15 10:40,45,114,-69,-511
311,2022/7/15 10:50,42,100,-58,-528
311,2022/7/15 11:00,45,121,-76,-447
311,2022/7/15 11:10,48,104,-56,-372
311,2022/7/15 11:20,44,108,-64,-400
311,2022/7/15 11:30,58,120,-62,-251
311,2022/7/15 11:40,65,125,-60,-378
311,2022/7/15 11:50,69,104,-35,-387
311,2022/7/15 12:00,67,126,-59,-308
311,2022/7/15 12:10,76,86,-10,-174
311,2022/7/15 12:20,80,114,-34,-302
311,2022/7/15 12:30,82,112,-30,-322
311,2022/7/15 12:40,86,110,-24,-465
311,2022/7/15 12:50,85,124,-39,-526
311,2022/7/15 13:00,114,120,-6,-316
311,2022/7/15 13:10,114,127,-13,-306
311,2022/7/15 13:20,133,121,12,-215
311,2022/7/15 13:30,113,112,1,-208
311,2022/7/15 13:40,128,122,6,-301
311,2022/7/15 13:50,90,126,-36,-222
311,2022/7/15 14:00,85,103,-18,-150
311,2022/7/15 14:10,110,124,-14,-76
311,2022/7/15 14:20,84,127,-43,-122
311,2022/7/15 14:30,86,114,-28,-77
311,2022/7/15 14:40,113,87,26,-1
311,2022/7/15 14:50,97,112,-15,5
311,2022/7/15 15:00,111,106,5,71
311,2022/7/15 15:10,133,107,26,148
311,2022/7/15 15:20,135,107,28,180
311,2022/7/15 15:30,138,86,52,184
311,2022/7/15 15:40,137,108,29,224
311,2022/7/15 15:50,150,103,47,176
311,2022/7/15 16:00,164,100,64,517
311,2022/7/15 16:10,174,103,71,716
311,2022/7/15 16:20,176,102,74,738
311,2022/7/15 16:30,208,97,111,1097
311,2022/7/15 16:40,214,117,97,1362
311,2022/7/15 16:50,256,106,150,1321
311,2022/7/15 17:00,325,124,201,2621
311,2022/7/15 17:10,571,123,448,3576
311,2022/7/15 17:20,425,132,293,2699
311,2022/7/15 17:30,699,110,589,3967
311,2022/7/15 17:40,1194,181,1013,6780
311,2022/7/15 17:50,794,191,603,3355
311,2022/7/15 18:00,790,181,609,3560
311,2022/7/15 18:10,1366,208,1158,6435
311,2022/7/15 18:20,1024,213,811,3866
311,2022/7/15 18:30,662,199,463,2036
311,2022/7/15 18:40,641,213,428,1717
311,2022/7/15 18:50,460,199,261,1392
311,2022/7/15 19:00,331,185,146,1186
311,2022/7/15 19:10,317,128,189,1080
311,2022/7/15 19:20,273,105,168,894
311,2022/7/15 19:30,240,104,136,634
311,2022/7/15 19:40,236,104,132,528
311,2022/7/15 19:50,214,110,104,403
311,2022/7/15 20:00,214,98,116,744
311,2022/7/15 20:10,204,91,113,743
311,2022/7/15 20:20,207,83,124,618
311,2022/7/15 20:30,223,77,146,814
311,2022/7/15 20:40,195,79,116,790
311,2022/7/15 20:50,197,77,120,612
311,2022/7/15 21:00,195,75,120,781
311,2022/7/15 21:10,194,73,121,958
311,2022/7/15 21:20,165,75,90,515
311,2022/7/15 21:30,164,71,93,495
311,2022/7/15 21:40,110,73,37,342
311,2022/7/15 21:50,105,70,35,189
311,2022/7/15 22:00,64,72,-8,744
311,2022/7/15 22:10,39,62,-23,598
311,2022/7/15 22:20,28,64,-36,-283
311,2022/7/15 22:30,22,60,-38,-412
311,2022/7/15 22:40,13,51,-38,-381
311,2022/7/15 22:50,7,40,-33,-256
294,2022/7/15 5:00,0,1,-1,-9
294,2022/7/15 5:10,0,1,-1,-3
294,2022/7/15 5:20,0,1,-1,14
294,2022/7/15 5:30,7,1,6,50
294,2022/7/15 5:40,16,1,15,74
294,2022/7/15 5:50,25,5,20,116
294,2022/7/15 6:00,30,25,5,89
294,2022/7/15 6:10,32,23,9,-8
294,2022/7/15 6:20,50,48,2,-107
294,2022/7/15 6:30,58,106,-48,-228
294,2022/7/15 6:40,75,84,-9,-206
294,2022/7/15 6:50,185,119,66,-172
294,2022/7/15 7:00,235,153,82,-162
294,2022/7/15 7:10,284,195,89,-343
294,2022/7/15 7:20,331,331,0,-193
294,2022/7/15 7:30,478,431,47,14
294,2022/7/15 7:40,632,418,214,468
294,2022/7/15 7:50,723,638,85,165
294,2022/7/15 8:00,694,1545,-851,-2431
294,2022/7/15 8:10,750,1701,-951,-5022
294,2022/7/15 8:20,678,2780,-2102,-7128
294,2022/7/15 8:30,723,4101,-3378,-14009
294,2022/7/15 8:40,600,4189,-3589,-18553
294,2022/7/15 8:50,387,2770,-2383,-14940
294,2022/7/15 9:00,340,1941,-1601,-9703
294,2022/7/15 9:10,277,1959,-1682,-7374
294,2022/7/15 9:20,250,569,-319,-3330
294,2022/7/15 9:30,202,514,-312,-2584
294,2022/7/15 9:40,167,420,-253,-1879
294,2022/7/15 9:50,120,331,-211,-1644
294,2022/7/15 10:00,109,208,-99,-1135
294,2022/7/15 10:10,79,151,-72,-834
294,2022/7/15 10:20,72,125,-53,-796
294,2022/7/15 10:30,69,133,-64,-658
294,2022/7/15 10:40,69,105,-36,-547
294,2022/7/15 10:50,71,104,-33,-561
294,2022/7/15 11:00,66,103,-37,-484
294,2022/7/15 11:10,74,123,-49,-421
294,2022/7/15 11:20,79,118,-39,-439
294,2022/7/15 11:30,73,117,-44,-295
294,2022/7/15 11:40,73,101,-28,-406
294,2022/7/15 11:50,81,105,-24,-411
294,2022/7/15 12:00,96,121,-25,-333
294,2022/7/15 12:10,96,109,-13,-187
294,2022/7/15 12:20,132,111,21,-281
294,2022/7/15 12:30,114,108,6,-316
294,2022/7/15 12:40,109,116,-7,-472
294,2022/7/15 12:50,92,117,-25,-551
294,2022/7/15 13:00,109,104,5,-311
294,2022/7/15 13:10,101,120,-19,-325
294,2022/7/15 13:20,93,133,-40,-255
294,2022/7/15 13:30,85,125,-40,-248
294,2022/7/15 13:40,89,120,-31,-332
294,2022/7/15 13:50,99,109,-10,-232
294,2022/7/15 14:00,99,110,-11,-161
294,2022/7/15 14:10,89,115,-26,-102
294,2022/7/15 14:20,133,110,23,-99
294,2022/7/15 14:30,88,104,-16,-93
294,2022/7/15 14:40,129,120,9,8
294,2022/7/15 14:50,128,108,20,25
294,2022/7/15 15:00,129,123,6,77
294,2022/7/15 15:10,149,120,29,177
294,2022/7/15 15:20,175,100,75,255
294,2022/7/15 15:30,167,110,57,241
294,2022/7/15 15:40,173,110,63,287
294,2022/7/15 15:50,165,108,57,233
294,2022/7/15 16:00,203,104,99,616
294,2022/7/15 16:10,223,121,102,818
294,2022/7/15 16:20,227,121,106,844
294,2022/7/15 16:30,269,128,141,1238
294,2022/7/15 16:40,319,144,175,1537
294,2022/7/15 16:50,463,152,311,1632
294,2022/7/15 17:00,654,149,505,3126
294,2022/7/15 17:10,1032,182,850,4426
294,2022/7/15 17:20,1150,195,955,3654
294,2022/7/15 17:30,825,282,543,4510
294,2022/7/15 17:40,1349,318,1031,7811
294,2022/7/15 17:50,1606,323,1283,4638
294,2022/7/15 18:00,1194,327,867,4427
294,2022/7/15 18:10,1190,347,843,7278
294,2022/7/15 18:20,1612,328,1284,5150
294,2022/7/15 18:30,1198,534,664,2700
294,2022/7/15 18:40,1035,434,601,2318
294,2022/7/15 18:50,712,301,411,1803
294,2022/7/15 19:00,641,348,293,1479
294,2022/7/15 19:10,610,257,353,1433
294,2022/7/15 19:20,432,215,217,1111
294,2022/7/15 19:30,349,150,199,833
294,2022/7/15 19:40,270,143,127,655
294,2022/7/15 19:50,247,117,130,533
294,2022/7/15 20:00,256,110,146,890
294,2022/7/15 20:10,241,124,117,860
294,2022/7/15 20:20,259,126,133,751
294,2022/7/15 20:30,208,107,101,915
294,2022/7/15 20:40,214,125,89,879
294,2022/7/15 20:50,211,125,86,698
294,2022/7/15 21:00,219,109,110,891
294,2022/7/15 21:10,274,120,154,1112
294,2022/7/15 21:20,219,110,109,624
294,2022/7/15 21:30,167,124,43,538
294,2022/7/15 21:40,116,125,-9,333
294,2022/7/15 21:50,74,120,-46,143
294,2022/7/15 22:00,66,110,-44,700
294,2022/7/15 22:10,59,110,-51,547
294,2022/7/15 22:20,42,107,-65,-348
294,2022/7/15 22:30,28,111,-83,-495
294,2022/7/15 22:40,16,93,-77,-458
294,2022/7/15 22:50,12,51,-39,-295
291,2022/7/15 5:00,0,1,-1,-10
291,2022/7/15 5:10,0,1,-1,-4
291,2022/7/15 5:20,0,1,-1,13
291,2022/7/15 5:30,5,1,4,54
291,2022/7/15 5:40,16,1,15,89
291,2022/7/15 5:50,18,21,-3,113
291,2022/7/15 6:00,23,30,-7,82
291,2022/7/15 6:10,32,44,-12,-20
291,2022/7/15 6:20,31,60,-29,-136
291,2022/7/15 6:30,41,72,-31,-259
291,2022/7/15 6:40,67,106,-39,-245
291,2022/7/15 6:50,97,105,-8,-180
291,2022/7/15 7:00,165,87,78,-84
291,2022/7/15 7:10,186,171,15,-328
291,2022/7/15 7:20,228,481,-253,-446
291,2022/7/15 7:30,269,561,-292,-278
291,2022/7/15 7:40,285,1601,-1316,-848
291,2022/7/15 7:50,344,4810,-4466,-4301
291,2022/7/15 8:00,351,4484,-4133,-6564
291,2022/7/15 8:10,339,8563,-8224,-13246
291,2022/7/15 8:20,351,11144,-10793,-17921
291,2022/7/15 8:30,315,10364,-10049,-24058
291,2022/7/15 8:40,257,11306,-11049,-29602
291,2022/7/15 8:50,213,9387,-9174,-24114
291,2022/7/15 9:00,193,9047,-8854,-18557
291,2022/7/15 9:10,166,7238,-7072,-14446
291,2022/7/15 9:20,138,5451,-5313,-8643
291,2022/7/15 9:30,107,2587,-2480,-5064
291,2022/7/15 9:40,94,2619,-2525,-4404
291,2022/7/15 9:50,77,1678,-1601,-3245
291,2022/7/15 10:00,72,428,-356,-1491
291,2022/7/15 10:10,72,375,-303,-1137
291,2022/7/15 10:20,73,196,-123,-919
291,2022/7/15 10:30,76,176,-100,-758
291,2022/7/15 10:40,103,146,-43,-590
291,2022/7/15 10:50,81,142,-61,-622
291,2022/7/15 11:00,91,120,-29,-513
291,2022/7/15 11:10,144,114,30,-391
291,2022/7/15 11:20,140,123,17,-422
291,2022/7/15 11:30,163,122,41,-254
291,2022/7/15 11:40,205,124,81,-325
291,2022/7/15 11:50,188,122,66,-345
291,2022/7/15 12:00,194,116,78,-255
291,2022/7/15 12:10,212,120,92,-95
291,2022/7/15 12:20,196,109,87,-194
291,2022/7/15 12:30,183,159,24,-292
291,2022/7/15 12:40,156,185,-29,-501
291,2022/7/15 12:50,162,159,3,-548
291,2022/7/15 13:00,137,152,-15,-326
291,2022/7/15 13:10,174,116,58,-267
291,2022/7/15 13:20,154,159,-5,-260
291,2022/7/15 13:30,133,181,-48,-296
291,2022/7/15 13:40,129,192,-63,-395
291,2022/7/15 13:50,138,139,-1,-233
291,2022/7/15 14:00,137,115,22,-139
291,2022/7/15 14:10,156,133,23,-79
291,2022/7/15 14:20,145,108,37,-62
291,2022/7/15 14:30,163,108,55,-38
291,2022/7/15 14:40,169,109,60,68
291,2022/7/15 14:50,175,102,73,98
291,2022/7/15 15:00,177,86,91,168
291,2022/7/15 15:10,213,114,99,276
291,2022/7/15 15:20,198,120,78,333
291,2022/7/15 15:30,202,102,100,341
291,2022/7/15 15:40,196,125,71,358
291,2022/7/15 15:50,198,106,92,325
291,2022/7/15 16:00,230,100,130,746
291,2022/7/15 16:10,268,118,150,968
291,2022/7/15 16:20,262,121,141,985
291,2022/7/15 16:30,548,106,442,1680
291,2022/7/15 16:40,610,116,494,2031
291,2022/7/15 16:50,664,120,544,2176
291,2022/7/15 17:00,1212,120,1092,4218
291,2022/7/15 17:10,3336,108,3228,7654
291,2022/7/15 17:20,2474,108,2366,6020
291,2022/7/15 17:30,3283,178,3105,7615
291,2022/7/15 17:40,3565,136,3429,11240
291,2022/7/15 17:50,3412,158,3254,7892
291,2022/7/15 18:00,3314,180,3134,7561
291,2022/7/15 18:10,3504,214,3290,10568
291,2022/7/15 18:20,3423,179,3244,8394
291,2022/7/15 18:30,3062,192,2870,5570
291,2022/7/15 18:40,2522,208,2314,4632
291,2022/7/15 18:50,1981,178,1803,3606
291,2022/7/15 19:00,1564,168,1396,2875
291,2022/7/15 19:10,1193,109,1084,2517
291,2022/7/15 19:20,1156,117,1039,2150
291,2022/7/15 19:30,718,124,594,1427
291,2022/7/15 19:40,650,106,544,1199
291,2022/7/15 19:50,573,101,472,1005
291,2022/7/15 20:00,555,113,442,1332
291,2022/7/15 20:10,673,107,566,1426
291,2022/7/15 20:20,583,101,482,1233
291,2022/7/15 20:30,431,107,324,1239
291,2022/7/15 20:40,362,107,255,1134
291,2022/7/15 20:50,269,95,174,872
291,2022/7/15 21:00,277,95,182,1073
291,2022/7/15 21:10,343,105,238,1350
291,2022/7/15 21:20,275,97,178,802
291,2022/7/15 21:30,214,89,125,663
291,2022/7/15 21:40,200,95,105,438
291,2022/7/15 21:50,102,95,7,150
291,2022/7/15 22:00,77,92,-15,685
291,2022/7/15 22:10,77,83,-6,541
291,2022/7/15 22:20,45,73,-28,-376
291,2022/7/15 22:30,29,72,-43,-538
291,2022/7/15 22:40,22,72,-50,-508
291,2022/7/15 22:50,15,55,-40,-335
295,2022/7/15 5:00,0,1,-1,-11
295,2022/7/15 5:10,0,1,-1,-5
295,2022/7/15 5:20,0,1,-1,12
295,2022/7/15 5:30,7,1,6,60
295,2022/7/15 5:40,19,1,18,107
295,2022/7/15 5:50,17,1,16,129
295,2022/7/15 6:00,26,13,13,95
295,2022/7/15 6:10,37,19,18,-2
295,2022/7/15 6:20,36,38,-2,-138
295,2022/7/15 6:30,58,51,7,-252
295,2022/7/15 6:40,82,62,20,-225
295,2022/7/15 6:50,179,72,107,-73
295,2022/7/15 7:00,197,76,121,37
295,2022/7/15 7:10,247,104,143,-185
295,2022/7/15 7:20,282,109,173,-273
295,2022/7/15 7:30,354,125,229,-49
295,2022/7/15 7:40,445,196,249,-599
295,2022/7/15 7:50,601,428,173,-4128
295,2022/7/15 8:00,633,519,114,-6450
295,2022/7/15 8:10,592,1480,-888,-14134
295,2022/7/15 8:20,392,1709,-1317,-19238
295,2022/7/15 8:30,336,1656,-1320,-25378
295,2022/7/15 8:40,280,2995,-2715,-32317
295,2022/7/15 8:50,284,2342,-2058,-26172
295,2022/7/15 9:00,232,1530,-1298,-19855
295,2022/7/15 9:10,200,1140,-940,-15386
295,2022/7/15 9:20,162,408,-246,-8889
295,2022/7/15 9:30,85,318,-233,-5297
295,2022/7/15 9:40,73,282,-209,-4613
295,2022/7/15 9:50,58,182,-124,-3369
295,2022/7/15 10:00,50,110,-60,-1551
295,2022/7/15 10:10,47,124,-77,-1214
295,2022/7/15 10:20,47,103,-56,-975
295,2022/7/15 10:30,47,111,-64,-822
295,2022/7/15 10:40,45,109,-64,-654
295,2022/7/15 10:50,40,75,-35,-657
295,2022/7/15 11:00,42,98,-56,-569
295,2022/7/15 11:10,41,99,-58,-449
295,2022/7/15 11:20,45,108,-63,-485
295,2022/7/15 11:30,44,104,-60,-314
295,2022/7/15 11:40,45,92,-47,-372
295,2022/7/15 11:50,46,75,-29,-374
295,2022/7/15 12:00,48,105,-57,-312
295,2022/7/15 12:10,45,108,-63,-158
295,2022/7/15 12:20,45,105,-60,-254
295,2022/7/15 12:30,51,105,-54,-346
295,2022/7/15 12:40,49,90,-41,-542
295,2022/7/15 12:50,47,110,-63,-611
295,2022/7/15 13:00,45,103,-58,-384
295,2022/7/15 13:10,50,109,-59,-326
295,2022/7/15 13:20,56,103,-47,-307
295,2022/7/15 13:30,48,111,-63,-359
295,2022/7/15 13:40,46,91,-45,-440
295,2022/7/15 13:50,45,107,-62,-295
295,2022/7/15 14:00,42,112,-70,-209
295,2022/7/15 14:10,43,103,-60,-139
295,2022/7/15 14:20,45,102,-57,-119
295,2022/7/15 14:30,45,97,-52,-90
295,2022/7/15 14:40,46,114,-68,0
295,2022/7/15 14:50,44,101,-57,41
295,2022/7/15 15:00,48,112,-64,104
295,2022/7/15 15:10,50,110,-60,216
295,2022/7/15 15:20,52,93,-41,292
295,2022/7/15 15:30,53,119,-66,275
295,2022/7/15 15:40,49,119,-70,288
295,2022/7/15 15:50,47,112,-65,260
295,2022/7/15 16:00,52,107,-55,691
295,2022/7/15 16:10,70,104,-34,934
295,2022/7/15 16:20,75,105,-30,955
295,2022/7/15 16:30,132,122,10,1690
295,2022/7/15 16:40,180,125,55,2086
295,2022/7/15 16:50,142,125,17,2193
295,2022/7/15 17:00,275,132,143,4361
295,2022/7/15 17:10,710,154,556,8210
295,2022/7/15 17:20,581,144,437,6457
295,2022/7/15 17:30,702,224,478,8093
295,2022/7/15 17:40,1976,217,1759,12999
295,2022/7/15 17:50,1204,298,906,8798
295,2022/7/15 18:00,1024,196,828,8389
295,2022/7/15 18:10,1587,335,1252,11820
295,2022/7/15 18:20,1202,335,867,9261
295,2022/7/15 18:30,798,257,541,6111
295,2022/7/15 18:40,610,335,275,4907
295,2022/7/15 18:50,312,336,-24,3582
295,2022/7/15 19:00,273,256,17,2892
295,2022/7/15 19:10,271,181,90,2607
295,2022/7/15 19:20,206,140,66,2216
295,2022/7/15 19:30,158,109,49,1476
295,2022/7/15 19:40,143,112,31,1230
295,2022/7/15 19:50,98,122,-24,981
295,2022/7/15 20:00,90,106,-16,1316
295,2022/7/15 20:10,129,91,38,1464
295,2022/7/15 20:20,79,104,-25,1208
295,2022/7/15 20:30,74,115,-41,1198
295,2022/7/15 20:40,133,107,26,1160
295,2022/7/15 20:50,77,110,-33,839
295,2022/7/15 21:00,67,106,-39,1034
295,2022/7/15 21:10,78,103,-25,1325
295,2022/7/15 21:20,64,107,-43,759
295,2022/7/15 21:30,41,112,-71,592
295,2022/7/15 21:40,42,104,-62,376
295,2022/7/15 21:50,35,103,-68,82
295,2022/7/15 22:00,25,103,-78,607
295,2022/7/15 22:10,26,98,-72,469
295,2022/7/15 22:20,23,90,-67,-443
295,2022/7/15 22:30,13,90,-77,-615
295,2022/7/15 22:40,11,77,-66,-574
295,2022/7/15 22:50,7,66,-59,-394
308,2022/7/15 5:00,0,1,-1,-12
308,2022/7/15 5:10,0,1,-1,-6
308,2022/7/15 5:20,1,1,0,12
308,2022/7/15 5:30,14,1,13,73
308,2022/7/15 5:40,19,1,18,125
308,2022/7/15 5:50,19,1,18,147
308,2022/7/15 6:00,28,8,20,115
308,2022/7/15 6:10,37,8,29,27
308,2022/7/15 6:20,41,38,3,-135
308,2022/7/15 6:30,57,49,8,-244
308,2022/7/15 6:40,65,48,17,-208
308,2022/7/15 6:50,96,72,24,-49
308,2022/7/15 7:00,157,77,80,117
308,2022/7/15 7:10,213,105,108,-77
308,2022/7/15 7:20,267,115,152,-121
308,2022/7/15 7:30,279,182,97,48
308,2022/7/15 7:40,327,170,157,-442
308,2022/7/15 7:50,342,128,214,-3914
308,2022/7/15 8:00,359,117,242,-6208
308,2022/7/15 8:10,285,110,175,-13959
308,2022/7/15 8:20,253,125,128,-19110
308,2022/7/15 8:30,238,123,115,-25263
308,2022/7/15 8:40,192,114,78,-32239
308,2022/7/15 8:50,176,98,78,-26094
308,2022/7/15 9:00,140,104,36,-19819
308,2022/7/15 9:10,100,103,-3,-15389
308,2022/7/15 9:20,74,99,-25,-8914
308,2022/7/15 9:30,52,91,-39,-5336
308,2022/7/15 9:40,46,76,-30,-4643
308,2022/7/15 9:50,41,76,-35,-3404
308,2022/7/15 10:00,38,93,-55,-1606
308,2022/7/15 10:10,33,74,-41,-1255
308,2022/7/15 10:20,27,74,-47,-1022
308,2022/7/15 10:30,27,74,-47,-869
308,2022/7/15 10:40,31,73,-42,-696
308,2022/7/15 10:50,30,75,-45,-702
308,2022/7/15 11:00,28,83,-55,-624
308,2022/7/15 11:10,31,75,-44,-493
308,2022/7/15 11:20,33,66,-33,-518
308,2022/7/15 11:30,31,60,-29,-343
308,2022/7/15 11:40,32,82,-50,-422
308,2022/7/15 11:50,24,77,-53,-427
308,2022/7/15 12:00,31,76,-45,-357
308,2022/7/15 12:10,39,71,-32,-190
308,2022/7/15 12:20,38,71,-33,-287
308,2022/7/15 12:30,33,76,-43,-389
308,2022/7/15 12:40,38,77,-39,-581
308,2022/7/15 12:50,38,77,-39,-650
308,2022/7/15 13:00,33,76,-43,-427
308,2022/7/15 13:10,29,69,-40,-366
308,2022/7/15 13:20,28,77,-49,-356
308,2022/7/15 13:30,31,80,-49,-408
308,2022/7/15 13:40,29,91,-62,-502
308,2022/7/15 13:50,30,77,-47,-342
308,2022/7/15 14:00,32,64,-32,-241
308,2022/7/15 14:10,29,83,-54,-193
308,2022/7/15 14:20,31,73,-42,-161
308,2022/7/15 14:30,34,84,-50,-140
308,2022/7/15 14:40,30,87,-57,-57
308,2022/7/15 14:50,39,82,-43,-2
308,2022/7/15 15:00,57,68,-11,93
308,2022/7/15 15:10,71,81,-10,206
308,2022/7/15 15:20,67,113,-46,246
308,2022/7/15 15:30,40,87,-47,228
308,2022/7/15 15:40,38,104,-66,222
308,2022/7/15 15:50,39,99,-60,200
308,2022/7/15 16:00,36,93,-57,634
308,2022/7/15 16:10,38,75,-37,897
308,2022/7/15 16:20,37,108,-71,884
308,2022/7/15 16:30,42,104,-62,1628
308,2022/7/15 16:40,43,108,-65,2021
308,2022/7/15 16:50,50,98,-48,2145
308,2022/7/15 17:00,49,99,-50,4311
308,2022/7/15 17:10,71,114,-43,8167
308,2022/7/15 17:20,71,109,-38,6419
308,2022/7/15 17:30,59,105,-46,8047
308,2022/7/15 17:40,96,108,-12,12987
308,2022/7/15 17:50,77,183,-106,8692
308,2022/7/15 18:00,77,184,-107,8282
308,2022/7/15 18:10,92,121,-29,11791
308,2022/7/15 18:20,67,184,-117,9144
308,2022/7/15 18:30,56,181,-125,5986
308,2022/7/15 18:40,43,150,-107,4800
308,2022/7/15 18:50,37,120,-83,3499
308,2022/7/15 19:00,37,138,-101,2791
308,2022/7/15 19:10,36,110,-74,2533
308,2022/7/15 19:20,25,124,-99,2117
308,2022/7/15 19:30,28,105,-77,1399
308,2022/7/15 19:40,27,110,-83,1147
308,2022/7/15 19:50,26,110,-84,897
308,2022/7/15 20:00,28,77,-49,1267
308,2022/7/15 20:10,25,95,-70,1394
308,2022/7/15 20:20,27,106,-79,1129
308,2022/7/15 20:30,24,94,-70,1128
308,2022/7/15 20:40,23,82,-59,1101
308,2022/7/15 20:50,24,93,-69,770
308,2022/7/15 21:00,26,78,-52,982
308,2022/7/15 21:10,23,80,-57,1268
308,2022/7/15 21:20,29,78,-49,710
308,2022/7/15 21:30,23,95,-72,520
308,2022/7/15 21:40,22,89,-67,309
308,2022/7/15 21:50,16,82,-66,16
308,2022/7/15 22:00,13,76,-63,544
308,2022/7/15 22:10,14,86,-72,397
308,2022/7/15 22:20,13,73,-60,-503
308,2022/7/15 22:30,6,71,-65,-680
308,2022/7/15 22:40,3,59,-56,-630
308,2022/7/15 22:50,2,64,-62,-456
299,2022/7/15 5:00,0,1,-1,-13
299,2022/7/15 5:10,3,1,2,-4
299,2022/7/15 5:20,17,1,16,28
299,2022/7/15 5:30,28,1,27,100
299,2022/7/15 5:40,33,1,32,157
299,2022/7/15 5:50,44,1,43,190
299,2022/7/15 6:00,87,1,86,201
299,2022/7/15 6:10,95,75,20,47
299,2022/7/15 6:20,186,71,115,-20
299,2022/7/15 6:30,244,84,160,-84
299,2022/7/15 6:40,345,105,240,32
299,2022/7/15 6:50,581,112,469,420
299,2022/7/15 7:00,664,146,518,635
299,2022/7/15 7:10,686,150,536,459
299,2022/7/15 7:20,1163,179,984,863
299,2022/7/15 7:30,1205,297,908,956
299,2022/7/15 7:40,1625,326,1299,857
299,2022/7/15 7:50,1971,530,1441,-2473
299,2022/7/15 8:00,1988,432,1556,-4652
299,2022/7/15 8:10,1626,533,1093,-12866
299,2022/7/15 8:20,1594,440,1154,-17956
299,2022/7/15 8:30,1383,431,952,-24311
299,2022/7/15 8:40,1198,521,677,-31562
299,2022/7/15 8:50,1164,433,731,-25363
299,2022/7/15 9:00,857,322,535,-19284
299,2022/7/15 9:10,724,283,441,-14948
299,2022/7/15 9:20,589,177,412,-8502
299,2022/7/15 9:30,365,177,188,-5148
299,2022/7/15 9:40,294,207,87,-4556
299,2022/7/15 9:50,278,169,109,-3295
299,2022/7/15 10:00,229,192,37,-1569
299,2022/7/15 10:10,212,146,66,-1189
299,2022/7/15 10:20,207,128,79,-943
299,2022/7/15 10:30,175,159,16,-853
299,2022/7/15 10:40,174,126,48,-648
299,2022/7/15 10:50,153,183,-30,-732
299,2022/7/15 11:00,131,139,-8,-632
299,2022/7/15 11:10,160,192,-32,-525
299,2022/7/15 11:20,147,185,-38,-556
299,2022/7/15 11:30,148,171,-23,-366
299,2022/7/15 11:40,169,117,52,-370
299,2022/7/15 11:50,176,172,4,-423
299,2022/7/15 12:00,206,152,54,-303
299,2022/7/15 12:10,217,192,25,-165
299,2022/7/15 12:20,226,181,45,-242
299,2022/7/15 12:30,228,146,82,-307
299,2022/7/15 12:40,218,128,90,-491
299,2022/7/15 12:50,214,146,68,-582
299,2022/7/15 13:00,222,192,30,-397
299,2022/7/15 13:10,213,192,21,-345
299,2022/7/15 13:20,208,146,62,-294
299,2022/7/15 13:30,195,121,74,-334
299,2022/7/15 13:40,205,192,13,-489
299,2022/7/15 13:50,206,171,35,-307
299,2022/7/15 14:00,185,180,5,-236
299,2022/7/15 14:10,190,198,-8,-201
299,2022/7/15 14:20,190,185,5,-156
299,2022/7/15 14:30,179,116,63,-77
299,2022/7/15 14:40,176,179,-3,-60
299,2022/7/15 14:50,162,214,-52,-54
299,2022/7/15 15:00,184,197,-13,80
299,2022/7/15 15:10,208,208,0,206
299,2022/7/15 15:20,196,146,50,296
299,2022/7/15 15:30,199,233,-34,194
299,2022/7/15 15:40,195,284,-89,133
299,2022/7/15 15:50,182,185,-3,197
299,2022/7/15 16:00,199,282,-83,551
299,2022/7/15 16:10,218,310,-92,805
299,2022/7/15 16:20,212,267,-55,829
299,2022/7/15 16:30,255,298,-43,1585
299,2022/7/15 16:40,261,332,-71,1950
299,2022/7/15 16:50,270,380,-110,2035
299,2022/7/15 17:00,269,375,-106,4205
299,2022/7/15 17:10,347,513,-166,8001
299,2022/7/15 17:20,335,410,-75,6344
299,2022/7/15 17:30,319,570,-251,7796
299,2022/7/15 17:40,378,562,-184,12803
299,2022/7/15 17:50,370,1557,-1187,7505
299,2022/7/15 18:00,378,1565,-1187,7095
299,2022/7/15 18:10,580,1113,-533,11258
299,2022/7/15 18:20,555,1874,-1319,7825
299,2022/7/15 18:30,457,1733,-1276,4710
299,2022/7/15 18:40,351,1862,-1511,3289
299,2022/7/15 18:50,332,1137,-805,2694
299,2022/7/15 19:00,275,609,-334,2457
299,2022/7/15 19:10,267,1171,-904,1629
299,2022/7/15 19:20,226,429,-203,1914
299,2022/7/15 19:30,196,492,-296,1103
299,2022/7/15 19:40,205,380,-175,972
299,2022/7/15 19:50,178,321,-143,754
299,2022/7/15 20:00,176,335,-159,1108
299,2022/7/15 20:10,204,206,-2,1392
299,2022/7/15 20:20,204,268,-64,1065
299,2022/7/15 20:30,171,285,-114,1014
299,2022/7/15 20:40,168,196,-28,1073
299,2022/7/15 20:50,182,190,-8,762
299,2022/7/15 21:00,179,233,-54,928
299,2022/7/15 21:10,163,234,-71,1197
299,2022/7/15 21:20,138,179,-41,669
299,2022/7/15 21:30,89,215,-126,394
299,2022/7/15 21:40,84,178,-94,215
299,2022/7/15 21:50,70,179,-109,-93
299,2022/7/15 22:00,60,149,-89,455
299,2022/7/15 22:10,56,145,-89,308
299,2022/7/15 22:20,30,187,-157,-660
299,2022/7/15 22:30,23,122,-99,-779
299,2022/7/15 22:40,23,122,-99,-729
299,2022/7/15 22:50,15,132,-117,-573
312,2022/7/15 5:00,0,1,-1,-14
312,2022/7/15 5:10,2,1,1,-3
312,2022/7/15 5:20,10,1,9,37
312,2022/7/15 5:30,13,1,12,112
312,2022/7/15 5:40,11,1,10,167
312,2022/7/15 5:50,20,1,19,209
312,2022/7/15 6:00,26,1,25,226
312,2022/7/15 6:10,26,17,9,56
312,2022/7/15 6:20,28,13,15,-5
312,2022/7/15 6:30,33,22,11,-73
312,2022/7/15 6:40,56,25,31,63
312,2022/7/15 6:50,81,40,41,461
312,2022/7/15 7:00,95,55,40,675
312,2022/7/15 7:10,109,73,36,495
312,2022/7/15 7:20,223,83,140,1003
312,2022/7/15 7:30,190,88,102,1058
312,2022/7/15 7:40,268,122,146,1003
312,2022/7/15 7:50,351,109,242,-2231
312,2022/7/15 8:00,326,171,155,-4497
312,2022/7/15 8:10,337,146,191,-12675
312,2022/7/15 8:20,281,125,156,-17800
312,2022/7/15 8:30,266,119,147,-24164
312,2022/7/15 8:40,216,110,106,-31456
312,2022/7/15 8:50,181,100,81,-25282
312,2022/7/15 9:00,98,98,0,-19284
312,2022/7/15 9:10,64,81,-17,-14965
312,2022/7/15 9:20,49,73,-24,-8526
312,2022/7/15 9:30,38,70,-32,-5180
312,2022/7/15 9:40,37,62,-25,-4581
312,2022/7/15 9:50,28,50,-22,-3317
312,2022/7/15 10:00,30,60,-30,-1599
312,2022/7/15 10:10,30,50,-20,-1209
312,2022/7/15 10:20,29,51,-22,-965
312,2022/7/15 10:30,25,39,-14,-867
312,2022/7/15 10:40,26,49,-23,-671
312,2022/7/15 10:50,27,45,-18,-750
312,2022/7/15 11:00,25,41,-16,-648
312,2022/7/15 11:10,24,38,-14,-539
312,2022/7/15 11:20,22,38,-16,-572
312,2022/7/15 11:30,17,45,-28,-394
312,2022/7/15 11:40,23,45,-22,-392
312,2022/7/15 11:50,23,46,-23,-446
312,2022/7/15 12:00,27,41,-14,-317
312,2022/7/15 12:10,26,39,-13,-178
312,2022/7/15 12:20,26,41,-15,-257
312,2022/7/15 12:30,29,51,-22,-329
312,2022/7/15 12:40,24,51,-27,-518
312,2022/7/15 12:50,28,51,-23,-605
312,2022/7/15 13:00,26,46,-20,-417
312,2022/7/15 13:10,22,45,-23,-368
312,2022/7/15 13:20,25,55,-30,-324
312,2022/7/15 13:30,24,58,-34,-368
312,2022/7/15 13:40,27,51,-24,-513
312,2022/7/15 13:50,26,51,-25,-332
312,2022/7/15 14:00,24,40,-16,-252
312,2022/7/15 14:10,24,54,-30,-231
312,2022/7/15 14:20,23,51,-28,-184
312,2022/7/15 14:30,24,54,-30,-107
312,2022/7/15 14:40,25,57,-32,-92
312,2022/7/15 14:50,23,48,-25,-79
312,2022/7/15 15:00,23,51,-28,52
312,2022/7/15 15:10,25,64,-39,167
312,2022/7/15 15:20,24,61,-37,259
312,2022/7/15 15:30,27,50,-23,171
312,2022/7/15 15:40,27,54,-27,106
312,2022/7/15 15:50,27,67,-40,157
312,2022/7/15 16:00,26,62,-36,515
312,2022/7/15 16:10,26,62,-36,769
312,2022/7/15 16:20,28,63,-35,794
312,2022/7/15 16:30,34,65,-31,1554
312,2022/7/15 16:40,38,65,-27,1923
312,2022/7/15 16:50,47,68,-21,2014
312,2022/7/15 17:00,47,71,-24,4181
312,2022/7/15 17:10,92,67,25,8026
312,2022/7/15 17:20,74,77,-3,6341
312,2022/7/15 17:30,73,96,-23,7773
312,2022/7/15 17:40,175,101,74,12877
312,2022/7/15 17:50,180,104,76,7581
312,2022/7/15 18:00,132,101,31,7126
312,2022/7/15 18:10,143,122,21,11279
312,2022/7/15 18:20,93,121,-28,7797
312,2022/7/15 18:30,70,119,-49,4661
312,2022/7/15 18:40,45,110,-65,3224
312,2022/7/15 18:50,36,109,-73,2621
312,2022/7/15 19:00,30,106,-76,2381
312,2022/7/15 19:10,24,123,-99,1530
312,2022/7/15 19:20,26,110,-84,1830
312,2022/7/15 19:30,25,112,-87,1016
312,2022/7/15 19:40,21,82,-61,911
312,2022/7/15 19:50,16,94,-78,676
312,2022/7/15 20:00,19,78,-59,1049
312,2022/7/15 20:10,22,73,-51,1341
312,2022/7/15 20:20,18,72,-54,1011
312,2022/7/15 20:30,19,71,-52,962
312,2022/7/15 20:40,18,74,-56,1017
312,2022/7/15 20:50,15,69,-54,708
312,2022/7/15 21:00,17,75,-58,870
312,2022/7/15 21:10,16,71,-55,1142
312,2022/7/15 21:20,17,77,-60,609
312,2022/7/15 21:30,15,71,-56,338
312,2022/7/15 21:40,14,62,-48,167
312,2022/7/15 21:50,12,74,-62,-155
312,2022/7/15 22:00,12,70,-58,397
312,2022/7/15 22:10,12,63,-51,257
312,2022/7/15 22:20,5,63,-58,-718
312,2022/7/15 22:30,3,63,-60,-839
312,2022/7/15 22:40,2,61,-59,-788
312,2022/7/15 22:50,1,52,-51,-624
297,2022/7/15 5:00,0,1,-1,-15
297,2022/7/15 5:10,0,1,-1,-4
297,2022/7/15 5:20,0,1,-1,36
297,2022/7/15 5:30,1,1,0,112
297,2022/7/15 5:40,8,1,7,174
297,2022/7/15 5:50,31,1,30,239
297,2022/7/15 6:00,88,2,86,312
297,2022/7/15 6:10,275,48,227,283
297,2022/7/15 6:20,248,38,210,205
297,2022/7/15 6:30,589,56,533,460
297,2022/7/15 6:40,645,67,578,641
297,2022/7/15 6:50,840,76,764,1225
297,2022/7/15 7:00,1191,98,1093,1768
297,2022/7/15 7:10,1599,119,1480,1975
297,2022/7/15 7:20,1986,178,1808,2811
297,2022/7/15 7:30,2534,233,2301,3359
297,2022/7/15 7:40,3463,300,3163,4166
297,2022/7/15 7:50,3407,328,3079,848
297,2022/7/15 8:00,3438,502,2936,-1561
297,2022/7/15 8:10,3442,378,3064,-9611
297,2022/7/15 8:20,3383,379,3004,-14796
297,2022/7/15 8:30,3087,536,2551,-21613
297,2022/7/15 8:40,1982,502,1480,-29976
297,2022/7/15 8:50,1626,321,1305,-23977
297,2022/7/15 9:00,1365,233,1132,-18152
297,2022/7/15 9:10,1019,169,850,-14115
297,2022/7/15 9:20,684,105,579,-7947
297,2022/7/15 9:30,580,128,452,-4728
297,2022/7/15 9:40,321,109,212,-4369
297,2022/7/15 9:50,327,109,218,-3099
297,2022/7/15 10:00,260,105,155,-1444
297,2022/7/15 10:10,225,113,112,-1097
297,2022/7/15 10:20,212,125,87,-878
297,2022/7/15 10:30,157,99,58,-809
297,2022/7/15 10:40,176,122,54,-617
297,2022/7/15 10:50,174,124,50,-700
297,2022/7/15 11:00,129,121,8,-640
297,2022/7/15 11:10,149,98,51,-488
297,2022/7/15 11:20,127,107,20,-552
297,2022/7/15 11:30,132,106,26,-368
297,2022/7/15 11:40,176,117,59,-333
297,2022/7/15 11:50,174,106,68,-378
297,2022/7/15 12:00,163,124,39,-278
297,2022/7/15 12:10,195,122,73,-105
297,2022/7/15 12:20,184,103,81,-176
297,2022/7/15 12:30,192,102,90,-239
297,2022/7/15 12:40,179,109,70,-448
297,2022/7/15 12:50,175,108,67,-538
297,2022/7/15 13:00,184,120,64,-353
297,2022/7/15 13:10,170,104,66,-302
297,2022/7/15 13:20,179,105,74,-250
297,2022/7/15 13:30,139,111,28,-340
297,2022/7/15 13:40,130,112,18,-495
297,2022/7/15 13:50,136,109,27,-305
297,2022/7/15 14:00,102,108,-6,-258
297,2022/7/15 14:10,72,124,-52,-283
297,2022/7/15 14:20,97,120,-23,-207
297,2022/7/15 14:30,82,121,-39,-146
297,2022/7/15 14:40,72,110,-38,-130
297,2022/7/15 14:50,91,117,-26,-105
297,2022/7/15 15:00,73,139,-66,-14
297,2022/7/15 15:10,93,123,-30,137
297,2022/7/15 15:20,89,185,-96,163
297,2022/7/15 15:30,78,226,-148,23
297,2022/7/15 15:40,76,181,-105,1
297,2022/7/15 15:50,79,181,-102,55
297,2022/7/15 16:00,78,216,-138,377
297,2022/7/15 16:10,144,179,-35,734
297,2022/7/15 16:20,150,177,-27,767
297,2022/7/15 16:30,168,268,-100,1454
297,2022/7/15 16:40,225,346,-121,1802
297,2022/7/15 16:50,202,298,-96,1918
297,2022/7/15 17:00,235,497,-262,3919
297,2022/7/15 17:10,292,505,-213,7813
297,2022/7/15 17:20,459,432,27,6368
297,2022/7/15 17:30,330,568,-238,7535
297,2022/7/15 17:40,328,616,-288,12589
297,2022/7/15 17:50,374,620,-246,7335
297,2022/7/15 18:00,545,1428,-883,6243
297,2022/7/15 18:10,432,1671,-1239,10040
297,2022/7/15 18:20,316,1714,-1398,6399
297,2022/7/15 18:30,241,1783,-1542,3119
297,2022/7/15 18:40,225,2447,-2222,1002
297,2022/7/15 18:50,174,2485,-2311,310
297,2022/7/15 19:00,114,2790,-2676,-295
297,2022/7/15 19:10,130,2029,-1899,-369
297,2022/7/15 19:20,77,1703,-1626,204
297,2022/7/15 19:30,64,1129,-1065,-49
297,2022/7/15 19:40,63,455,-392,519
297,2022/7/15 19:50,47,399,-352,324
297,2022/7/15 20:00,54,432,-378,671
297,2022/7/15 20:10,64,534,-470,871
297,2022/7/15 20:20,49,318,-269,742
297,2022/7/15 20:30,46,527,-481,481
297,2022/7/15 20:40,45,432,-387,630
297,2022/7/15 20:50,42,327,-285,423
297,2022/7/15 21:00,46,234,-188,682
297,2022/7/15 21:10,41,378,-337,805
297,2022/7/15 21:20,41,324,-283,326
297,2022/7/15 21:30,39,327,-288,50
297,2022/7/15 21:40,35,329,-294,-127
297,2022/7/15 21:50,29,300,-271,-426
297,2022/7/15 22:00,24,260,-236,161
297,2022/7/15 22:10,24,229,-205,52
297,2022/7/15 22:20,16,183,-167,-885
297,2022/7/15 22:30,8,150,-142,-981
297,2022/7/15 22:40,9,150,-141,-929
297,2022/7/15 22:50,5,127,-122,-746
302,2022/7/15 5:00,0,1,-1,-16
302,2022/7/15 5:10,0,1,-1,-5
302,2022/7/15 5:20,0,1,-1,35
302,2022/7/15 5:30,0,1,-1,111
302,2022/7/15 5:40,2,1,1,175
302,2022/7/15 5:50,55,1,54,293
302,2022/7/15 6:00,57,11,46,358
302,2022/7/15 6:10,77,5,72,355
302,2022/7/15 6:20,150,45,105,310
302,2022/7/15 6:30,236,51,185,645
302,2022/7/15 6:40,239,50,189,830
302,2022/7/15 6:50,281,47,234,1459
302,2022/7/15 7:00,447,81,366,2134
302,2022/7/15 7:10,622,85,537,2512
302,2022/7/15 7:20,757,107,650,3461
302,2022/7/15 7:30,1392,120,1272,4631
302,2022/7/15 7:40,1366,104,1262,5428
302,2022/7/15 7:50,1976,182,1794,2642
302,2022/7/15 8:00,1990,119,1871,310
302,2022/7/15 8:10,1621,110,1511,-8100
302,2022/7/15 8:20,1209,116,1093,-13703
302,2022/7/15 8:30,1035,113,922,-20691
302,2022/7/15 8:40,684,109,575,-29401
302,2022/7/15 8:50,663,122,541,-23436
302,2022/7/15 9:00,440,105,335,-17817
302,2022/7/15 9:10,273,106,167,-13948
302,2022/7/15 9:20,212,104,108,-7839
302,2022/7/15 9:30,143,90,53,-4675
302,2022/7/15 9:40,78,96,-18,-4387
302,2022/7/15 9:50,97,90,7,-3092
302,2022/7/15 10:00,73,73,0,-1444
302,2022/7/15 10:10,49,106,-57,-1154
302,2022/7/15 10:20,52,76,-24,-902
302,2022/7/15 10:30,46,87,-41,-850
302,2022/7/15 10:40,46,96,-50,-667
302,2022/7/15 10:50,44,93,-49,-749
302,2022/7/15 11:00,48,81,-33,-673
302,2022/7/15 11:10,40,62,-22,-510
302,2022/7/15 11:20,43,93,-50,-602
302,2022/7/15 11:30,43,92,-49,-417
302,2022/7/15 11:40,45,93,-48,-381
302,2022/7/15 11:50,56,93,-37,-415
302,2022/7/15 12:00,45,83,-38,-316
302,2022/7/15 12:10,53,89,-36,-141
302,2022/7/15 12:20,77,93,-16,-192
302,2022/7/15 12:30,48,90,-42,-281
302,2022/7/15 12:40,47,103,-56,-504
302,2022/7/15 12:50,46,91,-45,-583
302,2022/7/15 13:00,44,92,-48,-401
302,2022/7/15 13:10,44,98,-54,-356
302,2022/7/15 13:20,47,101,-54,-304
302,2022/7/15 13:30,42,100,-58,-398
302,2022/7/15 13:40,43,98,-55,-550
302,2022/7/15 13:50,37,90,-53,-358
302,2022/7/15 14:00,36,97,-61,-319
302,2022/7/15 14:10,43,104,-61,-344
302,2022/7/15 14:20,41,99,-58,-265
302,2022/7/15 14:30,31,107,-76,-222
302,2022/7/15 14:40,35,101,-66,-196
302,2022/7/15 14:50,33,90,-57,-162
302,2022/7/15 15:00,42,109,-67,-81
302,2022/7/15 15:10,41,107,-66,71
302,2022/7/15 15:20,40,125,-85,78
302,2022/7/15 15:30,41,104,-63,-40
302,2022/7/15 15:40,39,105,-66,-65
302,2022/7/15 15:50,37,121,-84,-29
302,2022/7/15 16:00,44,122,-78,299
302,2022/7/15 16:10,50,119,-69,665
302,2022/7/15 16:20,44,126,-82,685
302,2022/7/15 16:30,110,116,-6,1448
302,2022/7/15 16:40,74,111,-37,1765
302,2022/7/15 16:50,63,152,-89,1829
302,2022/7/15 17:00,180,181,-1,3918
302,2022/7/15 17:10,88,222,-134,7679
302,2022/7/15 17:20,79,150,-71,6297
302,2022/7/15 17:30,132,266,-134,7401
302,2022/7/15 17:40,137,320,-183,12406
302,2022/7/15 17:50,198,415,-217,7118
302,2022/7/15 18:00,82,519,-437,5806
302,2022/7/15 18:10,67,572,-505,9535
302,2022/7/15 18:20,68,574,-506,5893
302,2022/7/15 18:30,45,412,-367,2752
302,2022/7/15 18:40,39,625,-586,416
302,2022/7/15 18:50,38,576,-538,-228
302,2022/7/15 19:00,36,479,-443,-738
302,2022/7/15 19:10,27,405,-378,-747
302,2022/7/15 19:20,28,422,-394,-190
302,2022/7/15 19:30,28,502,-474,-523
302,2022/7/15 19:40,24,328,-304,215
302,2022/7/15 19:50,31,271,-240,84
302,2022/7/15 20:00,31,197,-166,505
302,2022/7/15 20:10,31,197,-166,705
302,2022/7/15 20:20,29,184,-155,587
302,2022/7/15 20:30,26,192,-166,315
302,2022/7/15 20:40,28,198,-170,460
302,2022/7/15 20:50,26,178,-152,271
302,2022/7/15 21:00,25,111,-86,596
302,2022/7/15 21:10,25,159,-134,671
302,2022/7/15 21:20,25,159,-134,192
302,2022/7/15 21:30,21,181,-160,-110
302,2022/7/15 21:40,20,104,-84,-211
302,2022/7/15 21:50,18,111,-93,-519
302,2022/7/15 22:00,20,110,-90,71
302,2022/7/15 22:10,6,112,-106,-54
302,2022/7/15 22:20,3,121,-118,-1003
302,2022/7/15 22:30,2,107,-105,-1086
302,2022/7/15 22:40,1,102,-101,-1030
302,2022/7/15 22:50,1,113,-112,-858
301,2022/7/15 5:00,0,1,-1,-17
301,2022/7/15 5:10,0,1,-1,-6
301,2022/7/15 5:20,0,1,-1,34
301,2022/7/15 5:30,0,1,-1,110
301,2022/7/15 5:40,30,1,29,204
301,2022/7/15 5:50,63,1,62,355
301,2022/7/15 6:00,60,5,55,413
301,2022/7/15 6:10,98,2,96,451
301,2022/7/15 6:20,97,38,59,369
301,2022/7/15 6:30,152,25,127,772
301,2022/7/15 6:40,225,38,187,1017
301,2022/7/15 6:50,326,59,267,1726
301,2022/7/15 7:00,480,68,412,2546
301,2022/7/15 7:10,834,69,765,3277
301,2022/7/15 7:20,1176,86,1090,4551
301,2022/7/15 7:30,1388,110,1278,5909
301,2022/7/15 7:40,1940,90,1850,7278
301,2022/7/15 7:50,1598,124,1474,4116
301,2022/7/15 8:00,1984,111,1873,2183
301,2022/7/15 8:10,1596,96,1500,-6600
301,2022/7/15 8:20,1152,105,1047,-12656
301,2022/7/15 8:30,843,123,720,-19971
301,2022/7/15 8:40,664,121,543,-28858
301,2022/7/15 8:50,341,104,237,-23199
301,2022/7/15 9:00,276,109,167,-17650
301,2022/7/15 9:10,216,105,111,-13837
301,2022/7/15 9:20,172,104,68,-7771
301,2022/7/15 9:30,96,93,3,-4672
301,2022/7/15 9:40,79,103,-24,-4411
301,2022/7/15 9:50,65,99,-34,-3126
301,2022/7/15 10:00,60,92,-32,-1476
301,2022/7/15 10:10,45,108,-63,-1217
301,2022/7/15 10:20,51,104,-53,-955
301,2022/7/15 10:30,52,87,-35,-885
301,2022/7/15 10:40,44,112,-68,-735
301,2022/7/15 10:50,55,93,-38,-787
301,2022/7/15 11:00,37,93,-56,-729
301,2022/7/15 11:10,31,87,-56,-566
301,2022/7/15 11:20,42,113,-71,-673
301,2022/7/15 11:30,42,93,-51,-468
301,2022/7/15 11:40,41,96,-55,-436
301,2022/7/15 11:50,52,87,-35,-450
301,2022/7/15 12:00,53,76,-23,-339
301,2022/7/15 12:10,56,92,-36,-177
301,2022/7/15 12:20,64,87,-23,-215
301,2022/7/15 12:30,50,99,-49,-330
301,2022/7/15 12:40,56,91,-35,-539
301,2022/7/15 12:50,53,90,-37,-620
301,2022/7/15 13:00,40,73,-33,-434
301,2022/7/15 13:10,54,97,-43,-399
301,2022/7/15 13:20,40,91,-51,-355
301,2022/7/15 13:30,45,108,-63,-461
301,2022/7/15 13:40,41,90,-49,-599
301,2022/7/15 13:50,44,90,-46,-404
301,2022/7/15 14:00,40,77,-37,-356
301,2022/7/15 14:10,38,92,-54,-398
301,2022/7/15 14:20,38,96,-58,-323
301,2022/7/15 14:30,37,101,-64,-286
301,2022/7/15 14:40,32,96,-64,-260
301,2022/7/15 14:50,45,73,-28,-190
301,2022/7/15 15:00,42,92,-50,-131
301,2022/7/15 15:10,40,105,-65,6
301,2022/7/15 15:20,40,106,-66,12
301,2022/7/15 15:30,47,102,-55,-95
301,2022/7/15 15:40,43,87,-44,-109
301,2022/7/15 15:50,44,86,-42,-71
301,2022/7/15 16:00,39,98,-59,240
301,2022/7/15 16:10,40,93,-53,612
301,2022/7/15 16:20,52,114,-62,623
301,2022/7/15 16:30,71,106,-35,1413
301,2022/7/15 16:40,73,125,-52,1713
301,2022/7/15 16:50,164,120,44,1873
301,2022/7/15 17:00,125,178,-53,3865
301,2022/7/15 17:10,121,118,3,7682
301,2022/7/15 17:20,173,150,23,6320
301,2022/7/15 17:30,134,221,-87,7314
301,2022/7/15 17:40,95,318,-223,12183
301,2022/7/15 17:50,76,318,-242,6876
301,2022/7/15 18:00,58,432,-374,5432
301,2022/7/15 18:10,60,422,-362,9173
301,2022/7/15 18:20,45,430,-385,5508
301,2022/7/15 18:30,39,418,-379,2373
301,2022/7/15 18:40,35,491,-456,-40
301,2022/7/15 18:50,24,490,-466,-694
301,2022/7/15 19:00,30,432,-402,-1140
301,2022/7/15 19:10,24,493,-469,-1216
301,2022/7/15 19:20,29,437,-408,-598
301,2022/7/15 19:30,28,379,-351,-874
301,2022/7/15 19:40,26,319,-293,-78
301,2022/7/15 19:50,27,336,-309,-225
301,2022/7/15 20:00,28,257,-229,276
301,2022/7/15 20:10,23,178,-155,550
301,2022/7/15 20:20,25,171,-146,441
301,2022/7/15 20:30,25,180,-155,160
301,2022/7/15 20:40,27,226,-199,261
301,2022/7/15 20:50,18,119,-101,170
301,2022/7/15 21:00,21,179,-158,438
301,2022/7/15 21:10,21,193,-172,499
301,2022/7/15 21:20,17,181,-164,28
301,2022/7/15 21:30,13,108,-95,-205
301,2022/7/15 21:40,12,153,-141,-352
301,2022/7/15 21:50,12,128,-116,-635
301,2022/7/15 22:00,8,121,-113,-42
301,2022/7/15 22:10,4,106,-102,-156
301,2022/7/15 22:20,2,120,-118,-1121
301,2022/7/15 22:30,2,102,-100,-1186
301,2022/7/15 22:40,2,87,-85,-1115
301,2022/7/15 22:50,2,110,-108,-966
293,2022/7/15 5:00,0,1,-1,-18
293,2022/7/15 5:10,0,1,-1,-7
293,2022/7/15 5:20,0,1,-1,33
293,2022/7/15 5:30,0,1,-1,109
293,2022/7/15 5:40,21,1,20,224
293,2022/7/15 5:50,25,2,23,378
293,2022/7/15 6:00,17,1,16,429
293,2022/7/15 6:10,29,11,18,469
293,2022/7/15 6:20,32,21,11,380
293,2022/7/15 6:30,36,55,-19,753
293,2022/7/15 6:40,51,47,4,1021
293,2022/7/15 6:50,57,37,20,1746
293,2022/7/15 7:00,56,60,-4,2542
293,2022/7/15 7:10,114,51,63,3340
293,2022/7/15 7:20,190,87,103,4654
293,2022/7/15 7:30,189,92,97,6006
293,2022/7/15 7:40,232,97,135,7413
293,2022/7/15 7:50,222,100,122,4238
293,2022/7/15 8:00,223,105,118,2301
293,2022/7/15 8:10,147,97,50,-6550
293,2022/7/15 8:20,96,111,-15,-12671
293,2022/7/15 8:30,70,111,-41,-20012
293,2022/7/15 8:40,79,100,-21,-28879
293,2022/7/15 8:50,33,105,-72,-23271
293,2022/7/15 9:00,43,83,-40,-17690
293,2022/7/15 9:10,35,65,-30,-13867
293,2022/7/15 9:20,24,97,-73,-7844
293,2022/7/15 9:30,31,101,-70,-4742
293,2022/7/15 9:40,23,62,-39,-4450
293,2022/7/15 9:50,25,92,-67,-3193
293,2022/7/15 10:00,24,77,-53,-1529
293,2022/7/15 10:10,21,68,-47,-1264
293,2022/7/15 10:20,25,76,-51,-1006
293,2022/7/15 10:30,27,81,-54,-939
293,2022/7/15 10:40,26,62,-36,-771
293,2022/7/15 10:50,22,63,-41,-828
293,2022/7/15 11:00,25,66,-41,-770
293,2022/7/15 11:10,24,62,-38,-604
293,2022/7/15 11:20,23,57,-34,-707
293,2022/7/15 11:30,21,57,-36,-504
293,2022/7/15 11:40,26,60,-34,-470
293,2022/7/15 11:50,23,63,-40,-490
293,2022/7/15 12:00,29,60,-31,-370
293,2022/7/15 12:10,22,60,-38,-215
293,2022/7/15 12:20,29,45,-16,-231
293,2022/7/15 12:30,23,45,-22,-352
293,2022/7/15 12:40,27,64,-37,-576
293,2022/7/15 12:50,29,59,-30,-650
293,2022/7/15 13:00,28,60,-32,-466
293,2022/7/15 13:10,24,62,-38,-437
293,2022/7/15 13:20,26,44,-18,-373
293,2022/7/15 13:30,25,57,-32,-493
293,2022/7/15 13:40,28,57,-29,-628
293,2022/7/15 13:50,23,56,-33,-437
293,2022/7/15 14:00,25,49,-24,-380
293,2022/7/15 14:10,24,48,-24,-422
293,2022/7/15 14:20,26,45,-19,-342
293,2022/7/15 14:30,25,62,-37,-323
293,2022/7/15 14:40,25,50,-25,-285
293,2022/7/15 14:50,24,61,-37,-227
293,2022/7/15 15:00,25,57,-32,-163
293,2022/7/15 15:10,24,40,-16,-10
293,2022/7/15 15:20,20,48,-28,-16
293,2022/7/15 15:30,25,61,-36,-131
293,2022/7/15 15:40,22,61,-39,-148
293,2022/7/15 15:50,29,48,-19,-90
293,2022/7/15 16:00,25,59,-34,206
293,2022/7/15 16:10,28,64,-36,576
293,2022/7/15 16:20,22,47,-25,598
293,2022/7/15 16:30,43,52,-9,1404
293,2022/7/15 16:40,36,63,-27,1686
293,2022/7/15 16:50,36,66,-30,1843
293,2022/7/15 17:00,39,80,-41,3824
293,2022/7/15 17:10,69,67,2,7684
293,2022/7/15 17:20,42,57,-15,6305
293,2022/7/15 17:30,58,92,-34,7280
293,2022/7/15 17:40,46,68,-22,12161
293,2022/7/15 17:50,44,76,-32,6844
293,2022/7/15 18:00,40,114,-74,5358
293,2022/7/15 18:10,27,95,-68,9105
293,2022/7/15 18:20,26,124,-98,5410
293,2022/7/15 18:30,24,104,-80,2293
293,2022/7/15 18:40,28,95,-67,-107
293,2022/7/15 18:50,21,114,-93,-787
293,2022/7/15 19:00,15,101,-86,-1226
293,2022/7/15 19:10,15,99,-84,-1300
293,2022/7/15 19:20,14,126,-112,-710
293,2022/7/15 19:30,12,85,-73,-947
293,2022/7/15 19:40,16,95,-79,-157
293,2022/7/15 19:50,16,94,-78,-303
293,2022/7/15 20:00,14,63,-49,227
293,2022/7/15 20:10,12,77,-65,485
293,2022/7/15 20:20,9,71,-62,379
293,2022/7/15 20:30,9,64,-55,105
293,2022/7/15 20:40,10,85,-75,186
293,2022/7/15 20:50,7,60,-53,117
293,2022/7/15 21:00,7,59,-52,386
293,2022/7/15 21:10,8,79,-71,428
293,2022/7/15 21:20,7,66,-59,-31
293,2022/7/15 21:30,4,56,-52,-257
293,2022/7/15 21:40,3,62,-59,-411
293,2022/7/15 21:50,4,71,-67,-702
293,2022/7/15 22:00,5,63,-58,-100
293,2022/7/15 22:10,0,54,-54,-210
293,2022/7/15 22:20,0,51,-51,-1172
293,2022/7/15 22:30,0,44,-44,-1230
293,2022/7/15 22:40,0,47,-47,-1162
293,2022/7/15 22:50,1,39,-38,-1004
303,2022/7/15 5:00,0,1,-1,-19
303,2022/7/15 5:10,0,1,-1,-8
303,2022/7/15 5:20,0,1,-1,32
303,2022/7/15 5:30,14,1,13,122
303,2022/7/15 5:40,28,1,27,251
303,2022/7/15 5:50,33,6,27,405
303,2022/7/15 6:00,42,5,37,466
303,2022/7/15 6:10,73,8,65,534
303,2022/7/15 6:20,109,16,93,473
303,2022/7/15 6:30,190,79,111,864
303,2022/7/15 6:40,281,68,213,1234
303,2022/7/15 6:50,370,72,298,2044
303,2022/7/15 7:00,655,87,568,3110
303,2022/7/15 7:10,740,118,622,3962
303,2022/7/15 7:20,1169,104,1065,5719
303,2022/7/15 7:30,1389,178,1211,7217
303,2022/7/15 7:40,1371,255,1116,8529
303,2022/7/15 7:50,1210,213,997,5235
303,2022/7/15 8:00,1167,198,969,3270
303,2022/7/15 8:10,1040,107,933,-5617
303,2022/7/15 8:20,732,224,508,-12163
303,2022/7/15 8:30,611,254,357,-19655
303,2022/7/15 8:40,369,180,189,-28690
303,2022/7/15 8:50,278,103,175,-23096
303,2022/7/15 9:00,236,150,86,-17604
303,2022/7/15 9:10,177,111,66,-13801
303,2022/7/15 9:20,162,142,20,-7824
303,2022/7/15 9:30,139,116,23,-4719
303,2022/7/15 9:40,130,101,29,-4421
303,2022/7/15 9:50,77,124,-47,-3240
303,2022/7/15 10:00,103,121,-18,-1547
303,2022/7/15 10:10,129,105,24,-1240
303,2022/7/15 10:20,108,101,7,-999
303,2022/7/15 10:30,77,104,-27,-966
303,2022/7/15 10:40,81,119,-38,-809
303,2022/7/15 10:50,65,102,-37,-865
303,2022/7/15 11:00,61,100,-39,-809
303,2022/7/15 11:10,62,115,-53,-657
303,2022/7/15 11:20,59,102,-43,-750
303,2022/7/15 11:30,95,119,-24,-528
303,2022/7/15 11:40,124,116,8,-462
303,2022/7/15 11:50,165,121,44,-446
303,2022/7/15 12:00,155,120,35,-335
303,2022/7/15 12:10,186,105,81,-134
303,2022/7/15 12:20,188,119,69,-162
303,2022/7/15 12:30,231,99,132,-220
303,2022/7/15 12:40,170,117,53,-523
303,2022/7/15 12:50,141,121,20,-630
303,2022/7/15 13:00,164,119,45,-421
303,2022/7/15 13:10,167,124,43,-394
303,2022/7/15 13:20,135,116,19,-354
303,2022/7/15 13:30,109,108,1,-492
303,2022/7/15 13:40,151,98,53,-575
303,2022/7/15 13:50,82,107,-25,-462
303,2022/7/15 14:00,127,105,22,-358
303,2022/7/15 14:10,116,123,-7,-429
303,2022/7/15 14:20,87,121,-34,-376
303,2022/7/15 14:30,99,125,-26,-349
303,2022/7/15 14:40,94,108,-14,-299
303,2022/7/15 14:50,118,114,4,-223
303,2022/7/15 15:00,163,121,42,-121
303,2022/7/15 15:10,184,122,62,52
303,2022/7/15 15:20,131,120,11,-5
303,2022/7/15 15:30,166,111,55,-76
303,2022/7/15 15:40,178,97,81,-67
303,2022/7/15 15:50,132,127,5,-85
303,2022/7/15 16:00,158,114,44,250
303,2022/7/15 16:10,187,108,79,655
303,2022/7/15 16:20,171,150,21,619
303,2022/7/15 16:30,194,111,83,1487
303,2022/7/15 16:40,259,106,153,1839
303,2022/7/15 16:50,268,139,129,1972
303,2022/7/15 17:00,213,181,32,3856
303,2022/7/15 17:10,194,252,-58,7626
303,2022/7/15 17:20,208,245,-37,6268
303,2022/7/15 17:30,181,217,-36,7244
303,2022/7/15 17:40,188,424,-236,11925
303,2022/7/15 17:50,202,324,-122,6722
303,2022/7/15 18:00,157,347,-190,5168
303,2022/7/15 18:10,124,427,-303,8802
303,2022/7/15 18:20,175,378,-203,5207
303,2022/7/15 18:30,70,499,-429,1864
303,2022/7/15 18:40,62,636,-574,-681
303,2022/7/15 18:50,71,434,-363,-1150
303,2022/7/15 19:00,49,414,-365,-1591
303,2022/7/15 19:10,61,457,-396,-1696
303,2022/7/15 19:20,64,392,-328,-1038
303,2022/7/15 19:30,64,411,-347,-1294
303,2022/7/15 19:40,42,413,-371,-528
303,2022/7/15 19:50,55,293,-238,-541
303,2022/7/15 20:00,44,506,-462,-235
303,2022/7/15 20:10,51,178,-127,358
303,2022/7/15 20:20,47,180,-133,246
303,2022/7/15 20:30,45,257,-212,-107
303,2022/7/15 20:40,39,116,-77,109
303,2022/7/15 20:50,38,221,-183,-66
303,2022/7/15 21:00,32,193,-161,225
303,2022/7/15 21:10,41,111,-70,358
303,2022/7/15 21:20,34,224,-190,-221
303,2022/7/15 21:30,27,120,-93,-350
303,2022/7/15 21:40,27,150,-123,-534
303,2022/7/15 21:50,27,128,-101,-803
303,2022/7/15 22:00,6,150,-144,-244
303,2022/7/15 22:10,3,120,-117,-327
303,2022/7/15 22:20,2,122,-120,-1292
303,2022/7/15 22:30,2,110,-108,-1338
303,2022/7/15 22:40,2,103,-101,-1263
303,2022/7/15 22:50,1,94,-93,-1097
306,2022/7/15 5:00,0,1,-1,-20
306,2022/7/15 5:10,0,1,-1,-9
306,2022/7/15 5:20,0,1,-1,31
306,2022/7/15 5:30,18,1,17,139
306,2022/7/15 5:40,30,1,29,280
306,2022/7/15 5:50,33,1,32,437
306,2022/7/15 6:00,37,1,36,502
306,2022/7/15 6:10,50,2,48,582
306,2022/7/15 6:20,80,2,78,551
306,2022/7/15 6:30,150,6,144,1008
306,2022/7/15 6:40,185,65,120,1354
306,2022/7/15 6:50,214,46,168,2212
306,2022/7/15 7:00,233,113,120,3230
306,2022/7/15 7:10,278,89,189,4151
306,2022/7/15 7:20,355,102,253,5972
306,2022/7/15 7:30,345,109,236,7453
306,2022/7/15 7:40,331,120,211,8740
306,2022/7/15 7:50,302,110,192,5427
306,2022/7/15 8:00,285,115,170,3440
306,2022/7/15 8:10,236,110,126,-5491
306,2022/7/15 8:20,189,111,78,-12085
306,2022/7/15 8:30,185,90,95,-19560
306,2022/7/15 8:40,82,105,-23,-28713
306,2022/7/15 8:50,73,110,-37,-23133
306,2022/7/15 9:00,54,64,-10,-17614
306,2022/7/15 9:10,49,93,-44,-13845
306,2022/7/15 9:20,45,104,-59,-7883
306,2022/7/15 9:30,47,75,-28,-4747
306,2022/7/15 9:40,38,82,-44,-4465
306,2022/7/15 9:50,38,76,-38,-3278
306,2022/7/15 10:00,39,80,-41,-1588
306,2022/7/15 10:10,38,65,-27,-1267
306,2022/7/15 10:20,38,74,-36,-1035
306,2022/7/15 10:30,38,65,-27,-993
306,2022/7/15 10:40,32,81,-49,-858
306,2022/7/15 10:50,29,76,-47,-912
306,2022/7/15 11:00,33,60,-27,-836
306,2022/7/15 11:10,33,82,-49,-706
306,2022/7/15 11:20,40,82,-42,-792
306,2022/7/15 11:30,37,86,-49,-577
306,2022/7/15 11:40,38,81,-43,-505
306,2022/7/15 11:50,34,76,-42,-488
306,2022/7/15 12:00,41,62,-21,-356
306,2022/7/15 12:10,36,75,-39,-173
306,2022/7/15 12:20,39,77,-38,-200
306,2022/7/15 12:30,34,73,-39,-259
306,2022/7/15 12:40,32,79,-47,-570
306,2022/7/15 12:50,30,76,-46,-676
306,2022/7/15 13:00,34,72,-38,-459
306,2022/7/15 13:10,32,87,-55,-449
306,2022/7/15 13:20,28,87,-59,-413
306,2022/7/15 13:30,29,81,-52,-544
306,2022/7/15 13:40,30,78,-48,-623
306,2022/7/15 13:50,29,59,-30,-492
306,2022/7/15 14:00,35,76,-41,-399
306,2022/7/15 14:10,30,76,-46,-475
306,2022/7/15 14:20,27,75,-48,-424
306,2022/7/15 14:30,25,78,-53,-402
306,2022/7/15 14:40,32,83,-51,-350
306,2022/7/15 14:50,32,64,-32,-255
306,2022/7/15 15:00,34,74,-40,-161
306,2022/7/15 15:10,33,81,-48,4
306,2022/7/15 15:20,33,78,-45,-50
306,2022/7/15 15:30,36,87,-51,-127
306,2022/7/15 15:40,34,69,-35,-102
306,2022/7/15 15:50,36,95,-59,-144
306,2022/7/15 16:00,41,101,-60,190
306,2022/7/15 16:10,38,61,-23,632
306,2022/7/15 16:20,63,92,-29,590
306,2022/7/15 16:30,67,63,4,1491
306,2022/7/15 16:40,70,83,-13,1826
306,2022/7/15 16:50,65,100,-35,1937
306,2022/7/15 17:00,52,98,-46,3810
306,2022/7/15 17:10,50,100,-50,7576
306,2022/7/15 17:20,74,106,-32,6236
306,2022/7/15 17:30,137,115,22,7266
306,2022/7/15 17:40,74,105,-31,11894
306,2022/7/15 17:50,67,116,-49,6673
306,2022/7/15 18:00,61,182,-121,5047
306,2022/7/15 18:10,47,103,-56,8746
306,2022/7/15 18:20,37,224,-187,5020
306,2022/7/15 18:30,37,110,-73,1791
306,2022/7/15 18:40,26,111,-85,-766
306,2022/7/15 18:50,28,209,-181,-1331
306,2022/7/15 19:00,28,114,-86,-1677
306,2022/7/15 19:10,23,123,-100,-1796
306,2022/7/15 19:20,25,180,-155,-1193
306,2022/7/15 19:30,26,100,-74,-1368
306,2022/7/15 19:40,24,124,-100,-628
306,2022/7/15 19:50,26,106,-80,-621
306,2022/7/15 20:00,26,93,-67,-302
306,2022/7/15 20:10,27,116,-89,269
306,2022/7/15 20:20,24,80,-56,190
306,2022/7/15 20:30,26,79,-53,-160
306,2022/7/15 20:40,23,105,-82,27
306,2022/7/15 20:50,16,71,-55,-121
306,2022/7/15 21:00,21,72,-51,174
306,2022/7/15 21:10,19,106,-87,271
306,2022/7/15 21:20,20,72,-52,-273
306,2022/7/15 21:30,17,77,-60,-410
306,2022/7/15 21:40,11,67,-56,-590
306,2022/7/15 21:50,8,95,-87,-890
306,2022/7/15 22:00,2,65,-63,-307
306,2022/7/15 22:10,1,82,-81,-408
306,2022/7/15 22:20,1,74,-73,-1365
306,2022/7/15 22:30,0,68,-68,-1406
306,2022/7/15 22:40,0,59,-59,-1322
306,2022/7/15 22:50,0,64,-64,-1161
305,2022/7/15 5:00,0,1,-1,-21
305,2022/7/15 5:10,0,1,-1,-10
305,2022/7/15 5:20,0,1,-1,30
305,2022/7/15 5:30,29,1,28,167
305,2022/7/15 5:40,32,1,31,311
305,2022/7/15 5:50,50,1,49,486
305,2022/7/15 6:00,45,1,44,546
305,2022/7/15 6:10,68,1,67,649
305,2022/7/15 6:20,114,1,113,664
305,2022/7/15 6:30,154,1,153,1161
305,2022/7/15 6:40,253,67,186,1540
305,2022/7/15 6:50,283,50,233,2445
305,2022/7/15 7:00,354,57,297,3527
305,2022/7/15 7:10,601,105,496,4647
305,2022/7/15 7:20,597,81,516,6488
305,2022/7/15 7:30,601,102,499,7952
305,2022/7/15 7:40,470,110,360,9100
305,2022/7/15 7:50,393,100,293,5720
305,2022/7/15 8:00,350,99,251,3691
305,2022/7/15 8:10,281,102,179,-5312
305,2022/7/15 8:20,232,113,119,-11966
305,2022/7/15 8:30,185,97,88,-19472
305,2022/7/15 8:40,146,108,38,-28675
305,2022/7/15 8:50,74,68,6,-23127
305,2022/7/15 9:00,53,110,-57,-17671
305,2022/7/15 9:10,41,76,-35,-13880
305,2022/7/15 9:20,45,68,-23,-7906
305,2022/7/15 9:30,39,91,-52,-4799
305,2022/7/15 9:40,33,87,-54,-4519
305,2022/7/15 9:50,37,67,-30,-3308
305,2022/7/15 10:00,31,75,-44,-1632
305,2022/7/15 10:10,32,68,-36,-1303
305,2022/7/15 10:20,28,65,-37,-1072
305,2022/7/15 10:30,31,79,-48,-1041
305,2022/7/15 10:40,35,74,-39,-897
305,2022/7/15 10:50,32,73,-41,-953
305,2022/7/15 11:00,27,74,-47,-883
305,2022/7/15 11:10,30,81,-51,-757
305,2022/7/15 11:20,38,62,-24,-816
305,2022/7/15 11:30,32,65,-33,-610
305,2022/7/15 11:40,37,85,-48,-553
305,2022/7/15 11:50,39,77,-38,-526
305,2022/7/15 12:00,38,85,-47,-403
305,2022/7/15 12:10,36,83,-47,-220
305,2022/7/15 12:20,39,62,-23,-223
305,2022/7/15 12:30,33,62,-29,-288
305,2022/7/15 12:40,33,73,-40,-610
305,2022/7/15 12:50,30,76,-46,-722
305,2022/7/15 13:00,32,93,-61,-520
305,2022/7/15 13:10,28,73,-45,-494
305,2022/7/15 13:20,30,60,-30,-443
305,2022/7/15 13:30,31,81,-50,-594
305,2022/7/15 13:40,29,75,-46,-669
305,2022/7/15 13:50,30,81,-51,-543
305,2022/7/15 14:00,28,77,-49,-448
305,2022/7/15 14:10,27,69,-42,-517
305,2022/7/15 14:20,31,68,-37,-461
305,2022/7/15 14:30,24,75,-51,-453
305,2022/7/15 14:40,31,76,-45,-395
305,2022/7/15 14:50,27,78,-51,-306
305,2022/7/15 15:00,31,74,-43,-204
305,2022/7/15 15:10,33,66,-33,-29
305,2022/7/15 15:20,30,76,-46,-96
305,2022/7/15 15:30,34,91,-57,-184
305,2022/7/15 15:40,35,90,-55,-157
305,2022/7/15 15:50,34,97,-63,-207
305,2022/7/15 16:00,37,68,-31,159
305,2022/7/15 16:10,37,105,-68,564
305,2022/7/15 16:20,42,99,-57,533
305,2022/7/15 16:30,45,83,-38,1453
305,2022/7/15 16:40,44,101,-57,1769
305,2022/7/15 16:50,43,87,-44,1893
305,2022/7/15 17:00,38,108,-70,3740
305,2022/7/15 17:10,49,168,-119,7457
305,2022/7/15 17:20,50,104,-54,6182
305,2022/7/15 17:30,42,102,-60,7206
305,2022/7/15 17:40,45,183,-138,11756
305,2022/7/15 17:50,46,108,-62,6611
305,2022/7/15 18:00,43,128,-85,4962
305,2022/7/15 18:10,44,234,-190,8556
305,2022/7/15 18:20,32,124,-92,4928
305,2022/7/15 18:30,26,220,-194,1597
305,2022/7/15 18:40,24,169,-145,-911
305,2022/7/15 18:50,24,110,-86,-1417
305,2022/7/15 19:00,24,227,-203,-1880
305,2022/7/15 19:10,24,109,-85,-1881
305,2022/7/15 19:20,25,119,-94,-1287
305,2022/7/15 19:30,22,191,-169,-1537
305,2022/7/15 19:40,17,104,-87,-715
305,2022/7/15 19:50,16,105,-89,-710
305,2022/7/15 20:00,22,122,-100,-402
305,2022/7/15 20:10,21,82,-61,208
305,2022/7/15 20:20,21,104,-83,107
305,2022/7/15 20:30,14,82,-68,-228
305,2022/7/15 20:40,23,73,-50,-23
305,2022/7/15 20:50,16,113,-97,-218
305,2022/7/15 21:00,20,77,-57,117
305,2022/7/15 21:10,17,63,-46,225
305,2022/7/15 21:20,16,106,-90,-363
305,2022/7/15 21:30,11,95,-84,-494
305,2022/7/15 21:40,9,72,-63,-653
305,2022/7/15 21:50,6,72,-66,-956
305,2022/7/15 22:00,0,98,-98,-405
305,2022/7/15 22:10,1,76,-75,-483
305,2022/7/15 22:20,0,75,-75,-1440
305,2022/7/15 22:30,0,69,-69,-1475
305,2022/7/15 22:40,0,62,-62,-1384
305,2022/7/15 22:50,0,69,-69,-1230
313,2022/7/15 5:00,0,1,-1,-22
313,2022/7/15 5:10,0,1,-1,-11
313,2022/7/15 5:20,8,1,7,37
313,2022/7/15 5:30,14,1,13,180
313,2022/7/15 5:40,20,1,19,330
313,2022/7/15 5:50,27,1,26,512
313,2022/7/15 6:00,29,1,28,574
313,2022/7/15 6:10,30,1,29,678
313,2022/7/15 6:20,40,1,39,703
313,2022/7/15 6:30,54,1,53,1214
313,2022/7/15 6:40,51,70,-19,1521
313,2022/7/15 6:50,78,60,18,2463
313,2022/7/15 7:00,102,38,64,3591
313,2022/7/15 7:10,145,44,101,4748
313,2022/7/15 7:20,214,70,144,6632
313,2022/7/15 7:30,223,53,170,8122
313,2022/7/15 7:40,190,70,120,9220
313,2022/7/15 7:50,147,60,87,5807
313,2022/7/15 8:00,83,60,23,3714
313,2022/7/15 8:10,74,61,13,-5299
313,2022/7/15 8:20,55,53,2,-11964
313,2022/7/15 8:30,53,85,-32,-19504
313,2022/7/15 8:40,44,67,-23,-28698
313,2022/7/15 8:50,30,63,-33,-23160
313,2022/7/15 9:00,27,52,-25,-17696
313,2022/7/15 9:10,27,72,-45,-13925
313,2022/7/15 9:20,30,69,-39,-7945
313,2022/7/15 9:30,28,71,-43,-4842
313,2022/7/15 9:40,26,72,-46,-4565
313,2022/7/15 9:50,27,60,-33,-3341
313,2022/7/15 10:00,25,71,-46,-1678
313,2022/7/15 10:10,25,67,-42,-1345
313,2022/7/15 10:20,24,53,-29,-1101
313,2022/7/15 10:30,24,51,-27,-1068
313,2022/7/15 10:40,28,67,-39,-936
313,2022/7/15 10:50,28,70,-42,-995
313,2022/7/15 11:00,26,49,-23,-906
313,2022/7/15 11:10,20,72,-52,-809
313,2022/7/15 11:20,25,68,-43,-859
313,2022/7/15 11:30,26,64,-38,-648
313,2022/7/15 11:40,25,68,-43,-596
313,2022/7/15 11:50,25,62,-37,-563
313,2022/7/15 12:00,22,55,-33,-436
313,2022/7/15 12:10,26,68,-42,-262
313,2022/7/15 12:20,22,69,-47,-270
313,2022/7/15 12:30,25,71,-46,-334
313,2022/7/15 12:40,24,71,-47,-657
313,2022/7/15 12:50,23,46,-23,-745
313,2022/7/15 13:00,25,62,-37,-557
313,2022/7/15 13:10,25,64,-39,-533
313,2022/7/15 13:20,24,70,-46,-489
313,2022/7/15 13:30,26,69,-43,-637
313,2022/7/15 13:40,26,63,-37,-706
313,2022/7/15 13:50,24,62,-38,-581
313,2022/7/15 14:00,25,69,-44,-492
313,2022/7/15 14:10,25,72,-47,-564
313,2022/7/15 14:20,26,66,-40,-501
313,2022/7/15 14:30,25,57,-32,-485
313,2022/7/15 14:40,24,46,-22,-417
313,2022/7/15 14:50,28,67,-39,-345
313,2022/7/15 15:00,26,67,-41,-245
313,2022/7/15 15:10,25,66,-41,-70
313,2022/7/15 15:20,23,68,-45,-141
313,2022/7/15 15:30,28,60,-32,-216
313,2022/7/15 15:40,32,59,-27,-184
313,2022/7/15 15:50,28,68,-40,-247
313,2022/7/15 16:00,25,84,-59,100
313,2022/7/15 16:10,25,50,-25,539
313,2022/7/15 16:20,26,81,-55,478
313,2022/7/15 16:30,26,83,-57,1396
313,2022/7/15 16:40,27,73,-46,1723
313,2022/7/15 16:50,36,70,-34,1859
313,2022/7/15 17:00,33,85,-52,3688
313,2022/7/15 17:10,32,85,-53,7404
313,2022/7/15 17:20,27,100,-73,6109
313,2022/7/15 17:30,29,64,-35,7171
313,2022/7/15 17:40,31,80,-49,11707
313,2022/7/15 17:50,25,105,-80,6531
313,2022/7/15 18:00,26,92,-66,4896
313,2022/7/15 18:10,28,99,-71,8485
313,2022/7/15 18:20,24,98,-74,4854
313,2022/7/15 18:30,23,99,-76,1521
313,2022/7/15 18:40,21,114,-93,-1004
313,2022/7/15 18:50,17,108,-91,-1508
313,2022/7/15 19:00,20,78,-58,-1938
313,2022/7/15 19:10,16,106,-90,-1971
313,2022/7/15 19:20,16,77,-61,-1348
313,2022/7/15 19:30,13,84,-71,-1608
313,2022/7/15 19:40,15,106,-91,-806
313,2022/7/15 19:50,14,68,-54,-764
313,2022/7/15 20:00,15,70,-55,-457
313,2022/7/15 20:10,15,84,-69,139
313,2022/7/15 20:20,17,56,-39,68
313,2022/7/15 20:30,18,72,-54,-282
313,2022/7/15 20:40,17,51,-34,-57
313,2022/7/15 20:50,18,51,-33,-251
313,2022/7/15 21:00,18,71,-53,64
313,2022/7/15 21:10,18,40,-22,203
313,2022/7/15 21:20,12,47,-35,-398
313,2022/7/15 21:30,14,61,-47,-541
313,2022/7/15 21:40,8,51,-43,-696
313,2022/7/15 21:50,2,40,-38,-994
313,2022/7/15 22:00,0,40,-40,-445
313,2022/7/15 22:10,0,51,-51,-534
313,2022/7/15 22:20,0,47,-47,-1487
313,2022/7/15 22:30,0,40,-40,-1515
313,2022/7/15 22:40,0,38,-38,-1422
313,2022/7/15 22:50,0,40,-40,-1270
304,2022/7/15 5:00,0,1,-1,-23
304,2022/7/15 5:10,0,1,-1,-12
304,2022/7/15 5:20,2,1,1,38
304,2022/7/15 5:30,4,1,3,183
304,2022/7/15 5:40,4,1,3,333
304,2022/7/15 5:50,7,1,6,518
304,2022/7/15 6:00,8,1,7,581
304,2022/7/15 6:10,9,1,8,686
304,2022/7/15 6:20,10,1,9,712
304,2022/7/15 6:30,12,1,11,1225
304,2022/7/15 6:40,18,30,-12,1509
304,2022/7/15 6:50,21,37,-16,2447
304,2022/7/15 7:00,29,71,-42,3549
304,2022/7/15 7:10,27,61,-34,4714
304,2022/7/15 7:20,34,57,-23,6609
304,2022/7/15 7:30,31,90,-59,8063
304,2022/7/15 7:40,34,53,-19,9201
304,2022/7/15 7:50,31,81,-50,5757
304,2022/7/15 8:00,23,96,-73,3641
304,2022/7/15 8:10,22,76,-54,-5353
304,2022/7/15 8:20,24,74,-50,-12014
304,2022/7/15 8:30,13,70,-57,-19561
304,2022/7/15 8:40,11,79,-68,-28766
304,2022/7/15 8:50,11,41,-30,-23190
304,2022/7/15 9:00,13,44,-31,-17727
304,2022/7/15 9:10,16,29,-13,-13938
304,2022/7/15 9:20,6,47,-41,-7986
304,2022/7/15 9:30,7,50,-43,-4885
304,2022/7/15 9:40,7,37,-30,-4595
304,2022/7/15 9:50,6,29,-23,-3364
304,2022/7/15 10:00,6,53,-47,-1725
304,2022/7/15 10:10,7,40,-33,-1378
304,2022/7/15 10:20,12,39,-27,-1128
304,2022/7/15 10:30,19,42,-23,-1091
304,2022/7/15 10:40,8,37,-29,-965
304,2022/7/15 10:50,16,52,-36,-1031
304,2022/7/15 11:00,10,52,-42,-948
304,2022/7/15 11:10,6,44,-38,-847
304,2022/7/15 11:20,9,36,-27,-886
304,2022/7/15 11:30,17,43,-26,-674
304,2022/7/15 11:40,17,36,-19,-615
304,2022/7/15 11:50,9,32,-23,-586
304,2022/7/15 12:00,9,31,-22,-458
304,2022/7/15 12:10,9,30,-21,-283
304,2022/7/15 12:20,8,24,-16,-286
304,2022/7/15 12:30,8,34,-26,-360
304,2022/7/15 12:40,22,37,-15,-672
304,2022/7/15 12:50,20,29,-9,-754
304,2022/7/15 13:00,8,34,-26,-583
304,2022/7/15 13:10,8,20,-12,-545
304,2022/7/15 13:20,21,36,-15,-504
304,2022/7/15 13:30,7,33,-26,-663
304,2022/7/15 13:40,9,35,-26,-732
304,2022/7/15 13:50,7,33,-26,-607
304,2022/7/15 14:00,24,23,1,-491
304,2022/7/15 14:10,21,21,0,-564
304,2022/7/15 14:20,7,32,-25,-526
304,2022/7/15 14:30,8,33,-25,-510
304,2022/7/15 14:40,22,31,-9,-426
304,2022/7/15 14:50,6,30,-24,-369
304,2022/7/15 15:00,9,23,-14,-259
304,2022/7/15 15:10,9,36,-27,-97
304,2022/7/15 15:20,9,36,-27,-168
304,2022/7/15 15:30,18,37,-19,-235
304,2022/7/15 15:40,17,38,-21,-205
304,2022/7/15 15:50,15,38,-23,-270
304,2022/7/15 16:00,9,33,-24,76
304,2022/7/15 16:10,9,38,-29,510
304,2022/7/15 16:20,16,30,-14,464
304,2022/7/15 16:30,26,29,-3,1393
304,2022/7/15 16:40,23,23,0,1723
304,2022/7/15 16:50,20,59,-39,1820
304,2022/7/15 17:00,20,50,-30,3658
304,2022/7/15 17:10,36,50,-14,7390
304,2022/7/15 17:20,26,43,-17,6092
304,2022/7/15 17:30,26,57,-31,7140
304,2022/7/15 17:40,39,35,4,11711
304,2022/7/15 17:50,26,38,-12,6519
304,2022/7/15 18:00,24,60,-36,4860
304,2022/7/15 18:10,15,44,-29,8456
304,2022/7/15 18:20,14,39,-25,4829
304,2022/7/15 18:30,25,65,-40,1481
304,2022/7/15 18:40,24,40,-16,-1020
304,2022/7/15 18:50,6,50,-44,-1552
304,2022/7/15 19:00,7,39,-32,-1970
304,2022/7/15 19:10,6,33,-27,-1998
304,2022/7/15 19:20,23,47,-24,-1372
304,2022/7/15 19:30,6,44,-38,-1646
304,2022/7/15 19:40,5,33,-28,-834
304,2022/7/15 19:50,4,37,-33,-797
304,2022/7/15 20:00,12,21,-9,-466
304,2022/7/15 20:10,16,25,-9,130
304,2022/7/15 20:20,3,34,-31,37
304,2022/7/15 20:30,2,21,-19,-301
304,2022/7/15 20:40,26,25,1,-56
304,2022/7/15 20:50,4,21,-17,-268
304,2022/7/15 21:00,3,21,-18,46
304,2022/7/15 21:10,2,27,-25,178
304,2022/7/15 21:20,25,18,7,-391
304,2022/7/15 21:30,16,15,1,-540
304,2022/7/15 21:40,6,21,-15,-711
304,2022/7/15 21:50,0,22,-22,-1016
304,2022/7/15 22:00,0,15,-15,-460
304,2022/7/15 22:10,0,21,-21,-555
304,2022/7/15 22:20,0,10,-10,-1497
304,2022/7/15 22:30,0,18,-18,-1533
304,2022/7/15 22:40,0,8,-8,-1430
304,2022/7/15 22:50,0,13,-13,-1283
