,stationid,startTime,inNums,outNums,flow,allflow
0,21,2022/4/15 5:00,1,1,0,0
1,21,2022/4/15 5:10,3,1,2,2
2,21,2022/4/15 5:20,8,1,7,7
3,21,2022/4/15 5:30,8,1,7,7
4,21,2022/4/15 5:40,8,1,7,7
5,21,2022/4/15 5:50,9,1,8,8
6,21,2022/4/15 6:00,23,1,22,22
7,21,2022/4/15 6:10,23,1,22,22
8,21,2022/4/15 6:20,26,11,15,15
9,21,2022/4/15 6:30,32,25,7,7
10,21,2022/4/15 6:40,64,29,35,35
11,21,2022/4/15 6:50,68,32,36,36
12,21,2022/4/15 7:00,88,46,42,42
13,21,2022/4/15 7:10,196,37,159,159
14,21,2022/4/15 7:20,267,38,229,229
15,21,2022/4/15 7:30,278,50,228,228
16,21,2022/4/15 7:40,382,51,331,331
17,21,2022/4/15 7:50,597,48,549,549
18,21,2022/4/15 8:00,442,53,389,389
19,21,2022/4/15 8:10,332,71,261,261
20,21,2022/4/15 8:20,280,67,213,213
21,21,2022/4/15 8:30,233,70,163,163
22,21,2022/4/15 8:40,169,70,99,99
23,21,2022/4/15 8:50,127,51,76,76
24,21,2022/4/15 9:00,48,45,3,3
25,21,2022/4/15 9:10,42,51,-9,-9
26,21,2022/4/15 9:20,41,45,-4,-4
27,21,2022/4/15 9:30,37,45,-8,-8
28,21,2022/4/15 9:40,32,40,-8,-8
29,21,2022/4/15 9:50,28,38,-10,-10
30,21,2022/4/15 10:00,25,40,-15,-15
31,21,2022/4/15 10:10,20,38,-18,-18
32,21,2022/4/15 10:20,23,37,-14,-14
33,21,2022/4/15 10:30,19,37,-18,-18
34,21,2022/4/15 10:40,20,37,-17,-17
35,21,2022/4/15 10:50,17,42,-25,-25
36,21,2022/4/15 11:00,16,39,-23,-23
37,21,2022/4/15 11:10,18,41,-23,-23
38,21,2022/4/15 11:20,20,39,-19,-19
39,21,2022/4/15 11:30,17,39,-22,-22
40,21,2022/4/15 11:40,20,37,-17,-17
41,21,2022/4/15 11:50,23,37,-14,-14
42,21,2022/4/15 12:00,27,37,-10,-10
43,21,2022/4/15 12:10,23,42,-19,-19
44,21,2022/4/15 12:20,21,39,-18,-18
45,21,2022/4/15 12:30,23,46,-23,-23
46,21,2022/4/15 12:40,23,45,-22,-22
47,21,2022/4/15 12:50,21,46,-25,-25
48,21,2022/4/15 13:00,17,47,-30,-30
49,21,2022/4/15 13:10,17,49,-32,-32
50,21,2022/4/15 13:20,20,50,-30,-30
51,21,2022/4/15 13:30,19,47,-28,-28
52,21,2022/4/15 13:40,17,41,-24,-24
53,21,2022/4/15 13:50,17,45,-28,-28
54,21,2022/4/15 14:00,19,50,-31,-31
55,21,2022/4/15 14:10,16,50,-34,-34
56,21,2022/4/15 14:20,18,50,-32,-32
57,21,2022/4/15 14:30,17,46,-29,-29
58,21,2022/4/15 14:40,16,50,-34,-34
59,21,2022/4/15 14:50,14,49,-35,-35
60,21,2022/4/15 15:00,19,49,-30,-30
61,21,2022/4/15 15:10,19,50,-31,-31
62,21,2022/4/15 15:20,23,61,-38,-38
63,21,2022/4/15 15:30,23,70,-47,-47
64,21,2022/4/15 15:40,20,66,-46,-46
65,21,2022/4/15 15:50,17,70,-53,-53
66,21,2022/4/15 16:00,24,72,-48,-48
67,21,2022/4/15 16:10,23,69,-46,-46
68,21,2022/4/15 16:20,26,70,-44,-44
69,21,2022/4/15 16:30,24,69,-45,-45
70,21,2022/4/15 16:40,22,65,-43,-43
71,21,2022/4/15 16:50,26,76,-50,-50
72,21,2022/4/15 17:00,33,77,-44,-44
73,21,2022/4/15 17:10,35,97,-62,-62
74,21,2022/4/15 17:20,30,102,-72,-72
75,21,2022/4/15 17:30,26,127,-101,-101
76,21,2022/4/15 17:40,30,122,-92,-92
77,21,2022/4/15 17:50,25,108,-83,-83
78,21,2022/4/15 18:00,27,119,-92,-92
79,21,2022/4/15 18:10,26,111,-85,-85
80,21,2022/4/15 18:20,24,109,-85,-85
81,21,2022/4/15 18:30,22,117,-95,-95
82,21,2022/4/15 18:40,23,111,-88,-88
83,21,2022/4/15 18:50,16,119,-103,-103
84,21,2022/4/15 19:00,15,110,-95,-95
85,21,2022/4/15 19:10,13,123,-110,-110
86,21,2022/4/15 19:20,12,110,-98,-98
87,21,2022/4/15 19:30,10,108,-98,-98
88,21,2022/4/15 19:40,9,99,-90,-90
89,21,2022/4/15 19:50,9,83,-74,-74
90,21,2022/4/15 20:00,11,81,-70,-70
91,21,2022/4/15 20:10,10,87,-77,-77
92,21,2022/4/15 20:20,7,77,-70,-70
93,21,2022/4/15 20:30,10,66,-56,-56
94,21,2022/4/15 20:40,8,79,-71,-71
95,21,2022/4/15 20:50,9,61,-52,-52
96,21,2022/4/15 21:00,8,88,-80,-80
97,21,2022/4/15 21:10,7,66,-59,-59
98,21,2022/4/15 21:20,8,78,-70,-70
99,21,2022/4/15 21:30,7,67,-60,-60
100,21,2022/4/15 21:40,6,52,-46,-46
101,21,2022/4/15 21:50,4,72,-68,-68
102,21,2022/4/15 22:00,1,46,-45,-45
103,21,2022/4/15 22:10,0,70,-70,-70
104,21,2022/4/15 22:20,0,34,-34,-34
105,21,2022/4/15 22:30,0,49,-49,-49
106,21,2022/4/15 22:40,0,39,-39,-39
107,21,2022/4/15 22:50,0,25,-25,-25
108,24,2022/4/15 5:00,0,1,-1,-1
109,24,2022/4/15 5:10,0,1,-1,1
110,24,2022/4/15 5:20,0,1,-1,6
111,24,2022/4/15 5:30,0,1,-1,6
112,24,2022/4/15 5:40,2,1,1,8
113,24,2022/4/15 5:50,2,1,1,9
114,24,2022/4/15 6:00,3,1,2,24
115,24,2022/4/15 6:10,7,1,6,28
116,24,2022/4/15 6:20,6,11,-5,10
117,24,2022/4/15 6:30,6,6,0,7
118,24,2022/4/15 6:40,14,8,6,41
119,24,2022/4/15 6:50,22,6,16,52
120,24,2022/4/15 7:00,25,11,14,56
121,24,2022/4/15 7:10,36,16,20,179
122,24,2022/4/15 7:20,36,23,13,242
123,24,2022/4/15 7:30,56,22,34,262
124,24,2022/4/15 7:40,46,31,15,346
125,24,2022/4/15 7:50,53,38,15,564
126,24,2022/4/15 8:00,56,21,35,424
127,24,2022/4/15 8:10,47,29,18,279
128,24,2022/4/15 8:20,36,14,22,235
129,24,2022/4/15 8:30,31,48,-17,146
130,24,2022/4/15 8:40,24,61,-37,62
131,24,2022/4/15 8:50,21,47,-26,50
132,24,2022/4/15 9:00,14,32,-18,-15
133,24,2022/4/15 9:10,12,30,-18,-27
134,24,2022/4/15 9:20,13,29,-16,-20
135,24,2022/4/15 9:30,10,21,-11,-19
136,24,2022/4/15 9:40,8,21,-13,-21
137,24,2022/4/15 9:50,3,19,-16,-26
138,24,2022/4/15 10:00,7,19,-12,-27
139,24,2022/4/15 10:10,4,19,-15,-33
140,24,2022/4/15 10:20,4,19,-15,-29
141,24,2022/4/15 10:30,4,18,-14,-32
142,24,2022/4/15 10:40,7,16,-9,-26
143,24,2022/4/15 10:50,7,12,-5,-30
144,24,2022/4/15 11:00,4,19,-15,-38
145,24,2022/4/15 11:10,6,19,-13,-36
146,24,2022/4/15 11:20,5,12,-7,-26
147,24,2022/4/15 11:30,6,12,-6,-28
148,24,2022/4/15 11:40,6,12,-6,-23
149,24,2022/4/15 11:50,6,8,-2,-16
150,24,2022/4/15 12:00,7,19,-12,-22
151,24,2022/4/15 12:10,5,8,-3,-22
152,24,2022/4/15 12:20,6,15,-9,-27
153,24,2022/4/15 12:30,5,14,-9,-32
154,24,2022/4/15 12:40,6,21,-15,-37
155,24,2022/4/15 12:50,5,19,-14,-39
156,24,2022/4/15 13:00,5,14,-9,-39
157,24,2022/4/15 13:10,4,18,-14,-46
158,24,2022/4/15 13:20,6,16,-10,-40
159,24,2022/4/15 13:30,6,19,-13,-41
160,24,2022/4/15 13:40,4,16,-12,-36
161,24,2022/4/15 13:50,5,15,-10,-38
162,24,2022/4/15 14:00,5,16,-11,-42
163,24,2022/4/15 14:10,5,16,-11,-45
164,24,2022/4/15 14:20,5,15,-10,-42
165,24,2022/4/15 14:30,4,14,-10,-39
166,24,2022/4/15 14:40,5,18,-13,-47
167,24,2022/4/15 14:50,6,14,-8,-43
168,24,2022/4/15 15:00,8,19,-11,-41
169,24,2022/4/15 15:10,8,18,-10,-41
170,24,2022/4/15 15:20,7,16,-9,-47
171,24,2022/4/15 15:30,8,21,-13,-60
172,24,2022/4/15 15:40,9,21,-12,-58
173,24,2022/4/15 15:50,8,19,-11,-64
174,24,2022/4/15 16:00,9,19,-10,-58
175,24,2022/4/15 16:10,8,23,-15,-61
176,24,2022/4/15 16:20,10,23,-13,-57
177,24,2022/4/15 16:30,8,23,-15,-60
178,24,2022/4/15 16:40,11,23,-12,-55
179,24,2022/4/15 16:50,10,38,-28,-78
180,24,2022/4/15 17:00,12,30,-18,-62
181,24,2022/4/15 17:10,17,35,-18,-80
182,24,2022/4/15 17:20,13,38,-25,-97
183,24,2022/4/15 17:30,14,46,-32,-133
184,24,2022/4/15 17:40,14,40,-26,-118
185,24,2022/4/15 17:50,12,45,-33,-116
186,24,2022/4/15 18:00,10,51,-41,-133
187,24,2022/4/15 18:10,8,53,-45,-130
188,24,2022/4/15 18:20,6,49,-43,-128
189,24,2022/4/15 18:30,6,55,-49,-144
190,24,2022/4/15 18:40,6,46,-40,-128
191,24,2022/4/15 18:50,4,40,-36,-139
192,24,2022/4/15 19:00,4,40,-36,-131
193,24,2022/4/15 19:10,3,36,-33,-143
194,24,2022/4/15 19:20,1,26,-25,-123
195,24,2022/4/15 19:30,4,25,-21,-119
196,24,2022/4/15 19:40,4,23,-19,-109
197,24,2022/4/15 19:50,2,18,-16,-90
198,24,2022/4/15 20:00,3,25,-22,-92
199,24,2022/4/15 20:10,2,21,-19,-96
200,24,2022/4/15 20:20,2,10,-8,-78
201,24,2022/4/15 20:30,2,25,-23,-79
202,24,2022/4/15 20:40,2,10,-8,-79
203,24,2022/4/15 20:50,2,25,-23,-75
204,24,2022/4/15 21:00,1,18,-17,-97
205,24,2022/4/15 21:10,1,21,-20,-79
206,24,2022/4/15 21:20,2,16,-14,-84
207,24,2022/4/15 21:30,1,22,-21,-81
208,24,2022/4/15 21:40,1,21,-20,-66
209,24,2022/4/15 21:50,1,13,-12,-80
210,24,2022/4/15 22:00,0,19,-19,-64
211,24,2022/4/15 22:10,0,10,-10,-80
212,24,2022/4/15 22:20,0,18,-18,-52
213,24,2022/4/15 22:30,0,8,-8,-57
214,24,2022/4/15 22:40,0,15,-15,-54
215,24,2022/4/15 22:50,0,10,-10,-35
216,11,2022/4/15 5:00,0,1,-1,-2
217,11,2022/4/15 5:10,2,1,1,2
218,11,2022/4/15 5:20,5,1,4,10
219,11,2022/4/15 5:30,6,1,5,11
220,11,2022/4/15 5:40,6,1,5,13
221,11,2022/4/15 5:50,11,1,10,19
222,11,2022/4/15 6:00,9,1,8,32
223,11,2022/4/15 6:10,16,1,15,43
224,11,2022/4/15 6:20,18,16,2,12
225,11,2022/4/15 6:30,21,16,5,12
226,11,2022/4/15 6:40,33,14,19,60
227,11,2022/4/15 6:50,36,14,22,74
228,11,2022/4/15 7:00,46,13,33,89
229,11,2022/4/15 7:10,60,23,37,216
230,11,2022/4/15 7:20,88,38,50,292
231,11,2022/4/15 7:30,189,46,143,405
232,11,2022/4/15 7:40,192,57,135,481
233,11,2022/4/15 7:50,185,65,120,684
234,11,2022/4/15 8:00,173,82,91,515
235,11,2022/4/15 8:10,169,84,85,364
236,11,2022/4/15 8:20,108,67,41,276
237,11,2022/4/15 8:30,76,109,-33,113
238,11,2022/4/15 8:40,58,110,-52,10
239,11,2022/4/15 8:50,56,102,-46,4
240,11,2022/4/15 9:00,27,107,-80,-95
241,11,2022/4/15 9:10,27,122,-95,-122
242,11,2022/4/15 9:20,26,104,-78,-98
243,11,2022/4/15 9:30,22,93,-71,-90
244,11,2022/4/15 9:40,20,75,-55,-76
245,11,2022/4/15 9:50,19,72,-53,-79
246,11,2022/4/15 10:00,19,66,-47,-74
247,11,2022/4/15 10:10,17,47,-30,-63
248,11,2022/4/15 10:20,11,38,-27,-56
249,11,2022/4/15 10:30,16,45,-29,-61
250,11,2022/4/15 10:40,14,38,-24,-50
251,11,2022/4/15 10:50,15,38,-23,-53
252,11,2022/4/15 11:00,16,35,-19,-57
253,11,2022/4/15 11:10,11,32,-21,-57
254,11,2022/4/15 11:20,15,38,-23,-49
255,11,2022/4/15 11:30,16,31,-15,-43
256,11,2022/4/15 11:40,15,28,-13,-36
257,11,2022/4/15 11:50,15,32,-17,-33
258,11,2022/4/15 12:00,16,32,-16,-38
259,11,2022/4/15 12:10,16,33,-17,-39
260,11,2022/4/15 12:20,16,37,-21,-48
261,11,2022/4/15 12:30,16,38,-22,-54
262,11,2022/4/15 12:40,15,38,-23,-60
263,11,2022/4/15 12:50,15,38,-23,-62
264,11,2022/4/15 13:00,14,39,-25,-64
265,11,2022/4/15 13:10,17,44,-27,-73
266,11,2022/4/15 13:20,15,36,-21,-61
267,11,2022/4/15 13:30,14,38,-24,-65
268,11,2022/4/15 13:40,14,39,-25,-61
269,11,2022/4/15 13:50,15,40,-25,-63
270,11,2022/4/15 14:00,13,38,-25,-67
271,11,2022/4/15 14:10,14,38,-24,-69
272,11,2022/4/15 14:20,12,38,-26,-68
273,11,2022/4/15 14:30,13,38,-25,-64
274,11,2022/4/15 14:40,17,41,-24,-71
275,11,2022/4/15 14:50,15,40,-25,-68
276,11,2022/4/15 15:00,15,47,-32,-73
277,11,2022/4/15 15:10,12,38,-26,-67
278,11,2022/4/15 15:20,15,34,-19,-66
279,11,2022/4/15 15:30,17,46,-29,-89
280,11,2022/4/15 15:40,18,42,-24,-82
281,11,2022/4/15 15:50,15,45,-30,-94
282,11,2022/4/15 16:00,13,41,-28,-86
283,11,2022/4/15 16:10,18,44,-26,-87
284,11,2022/4/15 16:20,14,50,-36,-93
285,11,2022/4/15 16:30,22,49,-27,-87
286,11,2022/4/15 16:40,26,55,-29,-84
287,11,2022/4/15 16:50,26,51,-25,-103
288,11,2022/4/15 17:00,29,50,-21,-83
289,11,2022/4/15 17:10,24,64,-40,-120
290,11,2022/4/15 17:20,26,72,-46,-143
291,11,2022/4/15 17:30,36,76,-40,-173
292,11,2022/4/15 17:40,47,77,-30,-148
293,11,2022/4/15 17:50,46,90,-44,-160
294,11,2022/4/15 18:00,44,110,-66,-199
295,11,2022/4/15 18:10,63,110,-47,-177
296,11,2022/4/15 18:20,45,114,-69,-197
297,11,2022/4/15 18:30,34,103,-69,-213
298,11,2022/4/15 18:40,28,95,-67,-195
299,11,2022/4/15 18:50,24,101,-77,-216
300,11,2022/4/15 19:00,26,95,-69,-200
301,11,2022/4/15 19:10,25,76,-51,-194
302,11,2022/4/15 19:20,20,75,-55,-178
303,11,2022/4/15 19:30,18,71,-53,-172
304,11,2022/4/15 19:40,16,56,-40,-149
305,11,2022/4/15 19:50,14,51,-37,-127
306,11,2022/4/15 20:00,16,54,-38,-130
307,11,2022/4/15 20:10,17,48,-31,-127
308,11,2022/4/15 20:20,16,34,-18,-96
309,11,2022/4/15 20:30,13,53,-40,-119
310,11,2022/4/15 20:40,11,37,-26,-105
311,11,2022/4/15 20:50,13,51,-38,-113
312,11,2022/4/15 21:00,12,40,-28,-125
313,11,2022/4/15 21:10,9,50,-41,-120
314,11,2022/4/15 21:20,6,52,-46,-130
315,11,2022/4/15 21:30,7,34,-27,-108
316,11,2022/4/15 21:40,10,48,-38,-104
317,11,2022/4/15 21:50,3,30,-27,-107
318,11,2022/4/15 22:00,1,49,-48,-112
319,11,2022/4/15 22:10,0,24,-24,-104
320,11,2022/4/15 22:20,0,41,-41,-93
321,11,2022/4/15 22:30,0,43,-43,-100
322,11,2022/4/15 22:40,0,34,-34,-88
323,11,2022/4/15 22:50,0,23,-23,-58
324,6,2022/4/15 5:00,0,1,-1,-3
325,6,2022/4/15 5:10,7,1,6,8
326,6,2022/4/15 5:20,13,1,12,22
327,6,2022/4/15 5:30,14,1,13,24
328,6,2022/4/15 5:40,16,1,15,28
329,6,2022/4/15 5:50,23,1,22,41
330,6,2022/4/15 6:00,25,1,24,56
331,6,2022/4/15 6:10,32,11,21,64
332,6,2022/4/15 6:20,37,23,14,26
333,6,2022/4/15 6:30,46,32,14,26
334,6,2022/4/15 6:40,65,40,25,85
335,6,2022/4/15 6:50,94,54,40,114
336,6,2022/4/15 7:00,151,63,88,177
337,6,2022/4/15 7:10,200,69,131,347
338,6,2022/4/15 7:20,253,76,177,469
339,6,2022/4/15 7:30,317,93,224,629
340,6,2022/4/15 7:40,324,108,216,697
341,6,2022/4/15 7:50,474,127,347,1031
342,6,2022/4/15 8:00,632,105,527,1042
343,6,2022/4/15 8:10,583,177,406,770
344,6,2022/4/15 8:20,474,151,323,599
345,6,2022/4/15 8:30,349,233,116,229
346,6,2022/4/15 8:40,282,513,-231,-221
347,6,2022/4/15 8:50,239,321,-82,-78
348,6,2022/4/15 9:00,199,296,-97,-192
349,6,2022/4/15 9:10,145,326,-181,-303
350,6,2022/4/15 9:20,79,298,-219,-317
351,6,2022/4/15 9:30,65,221,-156,-246
352,6,2022/4/15 9:40,62,197,-135,-211
353,6,2022/4/15 9:50,43,154,-111,-190
354,6,2022/4/15 10:00,48,133,-85,-159
355,6,2022/4/15 10:10,44,122,-78,-141
356,6,2022/4/15 10:20,44,98,-54,-110
357,6,2022/4/15 10:30,41,109,-68,-129
358,6,2022/4/15 10:40,41,112,-71,-121
359,6,2022/4/15 10:50,41,112,-71,-124
360,6,2022/4/15 11:00,43,105,-62,-119
361,6,2022/4/15 11:10,37,106,-69,-126
362,6,2022/4/15 11:20,44,102,-58,-107
363,6,2022/4/15 11:30,44,105,-61,-104
364,6,2022/4/15 11:40,50,114,-64,-100
365,6,2022/4/15 11:50,57,108,-51,-84
366,6,2022/4/15 12:00,66,102,-36,-74
367,6,2022/4/15 12:10,74,106,-32,-71
368,6,2022/4/15 12:20,66,105,-39,-87
369,6,2022/4/15 12:30,75,108,-33,-87
370,6,2022/4/15 12:40,71,111,-40,-100
371,6,2022/4/15 12:50,77,107,-30,-92
372,6,2022/4/15 13:00,70,109,-39,-103
373,6,2022/4/15 13:10,72,107,-35,-108
374,6,2022/4/15 13:20,72,106,-34,-95
375,6,2022/4/15 13:30,63,105,-42,-107
376,6,2022/4/15 13:40,56,107,-51,-112
377,6,2022/4/15 13:50,70,107,-37,-100
378,6,2022/4/15 14:00,53,109,-56,-123
379,6,2022/4/15 14:10,60,105,-45,-114
380,6,2022/4/15 14:20,60,103,-43,-111
381,6,2022/4/15 14:30,73,103,-30,-94
382,6,2022/4/15 14:40,57,106,-49,-120
383,6,2022/4/15 14:50,53,101,-48,-116
384,6,2022/4/15 15:00,58,106,-48,-121
385,6,2022/4/15 15:10,72,117,-45,-112
386,6,2022/4/15 15:20,66,122,-56,-122
387,6,2022/4/15 15:30,74,124,-50,-139
388,6,2022/4/15 15:40,65,124,-59,-141
389,6,2022/4/15 15:50,70,105,-35,-129
390,6,2022/4/15 16:00,74,111,-37,-123
391,6,2022/4/15 16:10,73,124,-51,-138
392,6,2022/4/15 16:20,73,109,-36,-129
393,6,2022/4/15 16:30,85,111,-26,-113
394,6,2022/4/15 16:40,162,119,43,-41
395,6,2022/4/15 16:50,130,126,4,-99
396,6,2022/4/15 17:00,175,148,27,-56
397,6,2022/4/15 17:10,217,189,28,-92
398,6,2022/4/15 17:20,199,223,-24,-167
399,6,2022/4/15 17:30,236,253,-17,-190
400,6,2022/4/15 17:40,309,330,-21,-169
401,6,2022/4/15 17:50,265,372,-107,-267
402,6,2022/4/15 18:00,265,507,-242,-441
403,6,2022/4/15 18:10,576,495,81,-96
404,6,2022/4/15 18:20,310,503,-193,-390
405,6,2022/4/15 18:30,271,508,-237,-450
406,6,2022/4/15 18:40,235,505,-270,-465
407,6,2022/4/15 18:50,205,506,-301,-517
408,6,2022/4/15 19:00,179,382,-203,-403
409,6,2022/4/15 19:10,172,327,-155,-349
410,6,2022/4/15 19:20,150,216,-66,-244
411,6,2022/4/15 19:30,101,191,-90,-262
412,6,2022/4/15 19:40,93,137,-44,-193
413,6,2022/4/15 19:50,85,123,-38,-165
414,6,2022/4/15 20:00,80,115,-35,-165
415,6,2022/4/15 20:10,76,127,-51,-178
416,6,2022/4/15 20:20,92,104,-12,-108
417,6,2022/4/15 20:30,91,98,-7,-126
418,6,2022/4/15 20:40,104,116,-12,-117
419,6,2022/4/15 20:50,130,92,38,-75
420,6,2022/4/15 21:00,150,126,24,-101
421,6,2022/4/15 21:10,132,100,32,-88
422,6,2022/4/15 21:20,76,117,-41,-171
423,6,2022/4/15 21:30,86,105,-19,-127
424,6,2022/4/15 21:40,105,92,13,-91
425,6,2022/4/15 21:50,67,104,-37,-144
426,6,2022/4/15 22:00,30,77,-47,-159
427,6,2022/4/15 22:10,3,106,-103,-207
428,6,2022/4/15 22:20,2,85,-83,-176
429,6,2022/4/15 22:30,0,110,-110,-210
430,6,2022/4/15 22:40,1,75,-74,-162
431,6,2022/4/15 22:50,0,64,-64,-122
432,20,2022/4/15 5:00,0,1,-1,-4
433,20,2022/4/15 5:10,3,1,2,10
434,20,2022/4/15 5:20,6,1,5,27
435,20,2022/4/15 5:30,10,1,9,33
436,20,2022/4/15 5:40,10,1,9,37
437,20,2022/4/15 5:50,13,2,11,52
438,20,2022/4/15 6:00,20,1,19,75
439,20,2022/4/15 6:10,27,21,6,70
440,20,2022/4/15 6:20,28,32,-4,22
441,20,2022/4/15 6:30,35,37,-2,24
442,20,2022/4/15 6:40,40,47,-7,78
443,20,2022/4/15 6:50,59,51,8,122
444,20,2022/4/15 7:00,64,58,6,183
445,20,2022/4/15 7:10,75,72,3,350
446,20,2022/4/15 7:20,157,75,82,551
447,20,2022/4/15 7:30,217,96,121,750
448,20,2022/4/15 7:40,282,124,158,855
449,20,2022/4/15 7:50,280,108,172,1203
450,20,2022/4/15 8:00,345,189,156,1198
451,20,2022/4/15 8:10,359,178,181,951
452,20,2022/4/15 8:20,318,501,-183,416
453,20,2022/4/15 8:30,245,298,-53,176
454,20,2022/4/15 8:40,227,496,-269,-490
455,20,2022/4/15 8:50,163,381,-218,-296
456,20,2022/4/15 9:00,90,299,-209,-401
457,20,2022/4/15 9:10,74,325,-251,-554
458,20,2022/4/15 9:20,70,181,-111,-428
459,20,2022/4/15 9:30,52,122,-70,-316
460,20,2022/4/15 9:40,43,150,-107,-318
461,20,2022/4/15 9:50,42,114,-72,-262
462,20,2022/4/15 10:00,37,124,-87,-246
463,20,2022/4/15 10:10,43,100,-57,-198
464,20,2022/4/15 10:20,35,106,-71,-181
465,20,2022/4/15 10:30,33,110,-77,-206
466,20,2022/4/15 10:40,37,102,-65,-186
467,20,2022/4/15 10:50,38,101,-63,-187
468,20,2022/4/15 11:00,39,107,-68,-187
469,20,2022/4/15 11:10,38,101,-63,-189
470,20,2022/4/15 11:20,37,110,-73,-180
471,20,2022/4/15 11:30,36,102,-66,-170
472,20,2022/4/15 11:40,43,103,-60,-160
473,20,2022/4/15 11:50,41,99,-58,-142
474,20,2022/4/15 12:00,41,110,-69,-143
475,20,2022/4/15 12:10,43,108,-65,-136
476,20,2022/4/15 12:20,52,104,-52,-139
477,20,2022/4/15 12:30,43,108,-65,-152
478,20,2022/4/15 12:40,46,106,-60,-160
479,20,2022/4/15 12:50,54,102,-48,-140
480,20,2022/4/15 13:00,54,104,-50,-153
481,20,2022/4/15 13:10,60,111,-51,-159
482,20,2022/4/15 13:20,53,122,-69,-164
483,20,2022/4/15 13:30,41,105,-64,-171
484,20,2022/4/15 13:40,57,120,-63,-175
485,20,2022/4/15 13:50,47,110,-63,-163
486,20,2022/4/15 14:00,47,103,-56,-179
487,20,2022/4/15 14:10,55,106,-51,-165
488,20,2022/4/15 14:20,46,109,-63,-174
489,20,2022/4/15 14:30,49,86,-37,-131
490,20,2022/4/15 14:40,55,99,-44,-164
491,20,2022/4/15 14:50,62,108,-46,-162
492,20,2022/4/15 15:00,58,103,-45,-166
493,20,2022/4/15 15:10,56,104,-48,-160
494,20,2022/4/15 15:20,58,100,-42,-164
495,20,2022/4/15 15:30,55,117,-62,-201
496,20,2022/4/15 15:40,53,116,-63,-204
497,20,2022/4/15 15:50,65,105,-40,-169
498,20,2022/4/15 16:00,64,123,-59,-182
499,20,2022/4/15 16:10,77,100,-23,-161
500,20,2022/4/15 16:20,75,119,-44,-173
501,20,2022/4/15 16:30,75,115,-40,-153
502,20,2022/4/15 16:40,76,110,-34,-75
503,20,2022/4/15 16:50,70,150,-80,-179
504,20,2022/4/15 17:00,139,108,31,-25
505,20,2022/4/15 17:10,202,149,53,-39
506,20,2022/4/15 17:20,216,178,38,-129
507,20,2022/4/15 17:30,214,196,18,-172
508,20,2022/4/15 17:40,334,232,102,-67
509,20,2022/4/15 17:50,268,323,-55,-322
510,20,2022/4/15 18:00,204,329,-125,-566
511,20,2022/4/15 18:10,269,327,-58,-154
512,20,2022/4/15 18:20,316,326,-10,-400
513,20,2022/4/15 18:30,257,328,-71,-521
514,20,2022/4/15 18:40,244,321,-77,-542
515,20,2022/4/15 18:50,243,285,-42,-559
516,20,2022/4/15 19:00,177,209,-32,-435
517,20,2022/4/15 19:10,143,145,-2,-351
518,20,2022/4/15 19:20,129,107,22,-222
519,20,2022/4/15 19:30,73,111,-38,-300
520,20,2022/4/15 19:40,74,120,-46,-239
521,20,2022/4/15 19:50,65,109,-44,-209
522,20,2022/4/15 20:00,63,104,-41,-206
523,20,2022/4/15 20:10,75,87,-12,-190
524,20,2022/4/15 20:20,76,98,-22,-130
525,20,2022/4/15 20:30,72,106,-34,-160
526,20,2022/4/15 20:40,68,89,-21,-138
527,20,2022/4/15 20:50,64,113,-49,-124
528,20,2022/4/15 21:00,83,72,11,-90
529,20,2022/4/15 21:10,89,112,-23,-111
530,20,2022/4/15 21:20,70,72,-2,-173
531,20,2022/4/15 21:30,74,89,-15,-142
532,20,2022/4/15 21:40,66,72,-6,-97
533,20,2022/4/15 21:50,63,103,-40,-184
534,20,2022/4/15 22:00,42,78,-36,-195
535,20,2022/4/15 22:10,6,73,-67,-274
536,20,2022/4/15 22:20,1,94,-93,-269
537,20,2022/4/15 22:30,0,62,-62,-272
538,20,2022/4/15 22:40,0,62,-62,-224
539,20,2022/4/15 22:50,1,38,-37,-159
540,1,2022/4/15 5:00,0,1,-1,-5
541,1,2022/4/15 5:10,2,1,1,11
542,1,2022/4/15 5:20,9,1,8,35
543,1,2022/4/15 5:30,15,1,14,47
544,1,2022/4/15 5:40,20,1,19,56
545,1,2022/4/15 5:50,17,1,16,68
546,1,2022/4/15 6:00,25,1,24,99
547,1,2022/4/15 6:10,31,13,18,88
548,1,2022/4/15 6:20,45,17,28,50
549,1,2022/4/15 6:30,57,21,36,60
550,1,2022/4/15 6:40,69,32,37,115
551,1,2022/4/15 6:50,105,50,55,177
552,1,2022/4/15 7:00,181,67,114,297
553,1,2022/4/15 7:10,215,73,142,492
554,1,2022/4/15 7:20,252,75,177,728
555,1,2022/4/15 7:30,323,97,226,976
556,1,2022/4/15 7:40,590,106,484,1339
557,1,2022/4/15 7:50,639,110,529,1732
558,1,2022/4/15 8:00,723,123,600,1798
559,1,2022/4/15 8:10,687,226,461,1412
560,1,2022/4/15 8:20,653,171,482,898
561,1,2022/4/15 8:30,573,234,339,515
562,1,2022/4/15 8:40,358,222,136,-354
563,1,2022/4/15 8:50,278,180,98,-198
564,1,2022/4/15 9:00,232,152,80,-321
565,1,2022/4/15 9:10,174,121,53,-501
566,1,2022/4/15 9:20,106,123,-17,-445
567,1,2022/4/15 9:30,68,107,-39,-355
568,1,2022/4/15 9:40,55,108,-53,-371
569,1,2022/4/15 9:50,50,97,-47,-309
570,1,2022/4/15 10:00,44,76,-32,-278
571,1,2022/4/15 10:10,42,81,-39,-237
572,1,2022/4/15 10:20,36,77,-41,-222
573,1,2022/4/15 10:30,31,72,-41,-247
574,1,2022/4/15 10:40,32,75,-43,-229
575,1,2022/4/15 10:50,35,72,-37,-224
576,1,2022/4/15 11:00,33,65,-32,-219
577,1,2022/4/15 11:10,26,66,-40,-229
578,1,2022/4/15 11:20,36,61,-25,-205
579,1,2022/4/15 11:30,33,82,-49,-219
580,1,2022/4/15 11:40,36,70,-34,-194
581,1,2022/4/15 11:50,35,76,-41,-183
582,1,2022/4/15 12:00,39,75,-36,-179
583,1,2022/4/15 12:10,41,77,-36,-172
584,1,2022/4/15 12:20,45,70,-25,-164
585,1,2022/4/15 12:30,43,84,-41,-193
586,1,2022/4/15 12:40,43,81,-38,-198
587,1,2022/4/15 12:50,44,75,-31,-171
588,1,2022/4/15 13:00,38,92,-54,-207
589,1,2022/4/15 13:10,38,76,-38,-197
590,1,2022/4/15 13:20,34,91,-57,-221
591,1,2022/4/15 13:30,37,76,-39,-210
592,1,2022/4/15 13:40,34,77,-43,-218
593,1,2022/4/15 13:50,36,76,-40,-203
594,1,2022/4/15 14:00,30,74,-44,-223
595,1,2022/4/15 14:10,35,77,-42,-207
596,1,2022/4/15 14:20,31,84,-53,-227
597,1,2022/4/15 14:30,30,76,-46,-177
598,1,2022/4/15 14:40,28,76,-48,-212
599,1,2022/4/15 14:50,27,81,-54,-216
600,1,2022/4/15 15:00,34,91,-57,-223
601,1,2022/4/15 15:10,39,76,-37,-197
602,1,2022/4/15 15:20,40,92,-52,-216
603,1,2022/4/15 15:30,42,87,-45,-246
604,1,2022/4/15 15:40,39,96,-57,-261
605,1,2022/4/15 15:50,36,97,-61,-230
606,1,2022/4/15 16:00,45,97,-52,-234
607,1,2022/4/15 16:10,53,109,-56,-217
608,1,2022/4/15 16:20,56,103,-47,-220
609,1,2022/4/15 16:30,52,102,-50,-203
610,1,2022/4/15 16:40,73,110,-37,-112
611,1,2022/4/15 16:50,68,111,-43,-222
612,1,2022/4/15 17:00,125,103,22,-3
613,1,2022/4/15 17:10,208,110,98,59
614,1,2022/4/15 17:20,174,151,23,-106
615,1,2022/4/15 17:30,163,191,-28,-200
616,1,2022/4/15 17:40,221,233,-12,-79
617,1,2022/4/15 17:50,183,217,-34,-356
618,1,2022/4/15 18:00,149,300,-151,-717
619,1,2022/4/15 18:10,203,327,-124,-278
620,1,2022/4/15 18:20,163,334,-171,-571
621,1,2022/4/15 18:30,74,319,-245,-766
622,1,2022/4/15 18:40,56,301,-245,-787
623,1,2022/4/15 18:50,46,256,-210,-769
624,1,2022/4/15 19:00,43,197,-154,-589
625,1,2022/4/15 19:10,40,147,-107,-458
626,1,2022/4/15 19:20,40,144,-104,-326
627,1,2022/4/15 19:30,37,110,-73,-373
628,1,2022/4/15 19:40,35,125,-90,-329
629,1,2022/4/15 19:50,28,125,-97,-306
630,1,2022/4/15 20:00,33,105,-72,-278
631,1,2022/4/15 20:10,38,108,-70,-260
632,1,2022/4/15 20:20,41,81,-40,-170
633,1,2022/4/15 20:30,40,122,-82,-242
634,1,2022/4/15 20:40,44,83,-39,-177
635,1,2022/4/15 20:50,32,107,-75,-199
636,1,2022/4/15 21:00,28,78,-50,-140
637,1,2022/4/15 21:10,27,127,-100,-211
638,1,2022/4/15 21:20,25,108,-83,-256
639,1,2022/4/15 21:30,29,99,-70,-212
640,1,2022/4/15 21:40,25,102,-77,-174
641,1,2022/4/15 21:50,23,78,-55,-239
642,1,2022/4/15 22:00,15,106,-91,-286
643,1,2022/4/15 22:10,2,73,-71,-345
644,1,2022/4/15 22:20,0,108,-108,-377
645,1,2022/4/15 22:30,0,79,-79,-351
646,1,2022/4/15 22:40,1,75,-74,-298
647,1,2022/4/15 22:50,0,34,-34,-193
648,19,2022/4/15 5:00,0,1,-1,-6
649,19,2022/4/15 5:10,2,1,1,12
650,19,2022/4/15 5:20,5,1,4,39
651,19,2022/4/15 5:30,16,1,15,62
652,19,2022/4/15 5:40,18,1,17,73
653,19,2022/4/15 5:50,16,1,15,83
654,19,2022/4/15 6:00,25,1,24,123
655,19,2022/4/15 6:10,27,19,8,96
656,19,2022/4/15 6:20,32,14,18,68
657,19,2022/4/15 6:30,36,23,13,73
658,19,2022/4/15 6:40,57,34,23,138
659,19,2022/4/15 6:50,70,25,45,222
660,19,2022/4/15 7:00,76,54,22,319
661,19,2022/4/15 7:10,109,72,37,529
662,19,2022/4/15 7:20,187,78,109,837
663,19,2022/4/15 7:30,255,105,150,1126
664,19,2022/4/15 7:40,361,184,177,1516
665,19,2022/4/15 7:50,376,133,243,1975
666,19,2022/4/15 8:00,572,298,274,2072
667,19,2022/4/15 8:10,591,212,379,1791
668,19,2022/4/15 8:20,436,232,204,1102
669,19,2022/4/15 8:30,392,268,124,639
670,19,2022/4/15 8:40,277,326,-49,-403
671,19,2022/4/15 8:50,254,323,-69,-267
672,19,2022/4/15 9:00,197,268,-71,-392
673,19,2022/4/15 9:10,162,208,-46,-547
674,19,2022/4/15 9:20,93,184,-91,-536
675,19,2022/4/15 9:30,67,119,-52,-407
676,19,2022/4/15 9:40,64,114,-50,-421
677,19,2022/4/15 9:50,52,114,-62,-371
678,19,2022/4/15 10:00,44,105,-61,-339
679,19,2022/4/15 10:10,45,99,-54,-291
680,19,2022/4/15 10:20,43,94,-51,-273
681,19,2022/4/15 10:30,36,97,-61,-308
682,19,2022/4/15 10:40,40,89,-49,-278
683,19,2022/4/15 10:50,30,75,-45,-269
684,19,2022/4/15 11:00,37,87,-50,-269
685,19,2022/4/15 11:10,43,76,-33,-262
686,19,2022/4/15 11:20,40,75,-35,-240
687,19,2022/4/15 11:30,52,78,-26,-245
688,19,2022/4/15 11:40,66,87,-21,-215
689,19,2022/4/15 11:50,85,87,-2,-185
690,19,2022/4/15 12:00,72,76,-4,-183
691,19,2022/4/15 12:10,62,92,-30,-202
692,19,2022/4/15 12:20,62,92,-30,-194
693,19,2022/4/15 12:30,67,95,-28,-221
694,19,2022/4/15 12:40,63,98,-35,-233
695,19,2022/4/15 12:50,57,106,-49,-220
696,19,2022/4/15 13:00,60,105,-45,-252
697,19,2022/4/15 13:10,60,105,-45,-242
698,19,2022/4/15 13:20,60,102,-42,-263
699,19,2022/4/15 13:30,54,110,-56,-266
700,19,2022/4/15 13:40,43,110,-67,-285
701,19,2022/4/15 13:50,41,99,-58,-261
702,19,2022/4/15 14:00,44,94,-50,-273
703,19,2022/4/15 14:10,50,96,-46,-253
704,19,2022/4/15 14:20,44,93,-49,-276
705,19,2022/4/15 14:30,44,106,-62,-239
706,19,2022/4/15 14:40,40,97,-57,-269
707,19,2022/4/15 14:50,41,101,-60,-276
708,19,2022/4/15 15:00,45,104,-59,-282
709,19,2022/4/15 15:10,95,97,-2,-199
710,19,2022/4/15 15:20,64,103,-39,-255
711,19,2022/4/15 15:30,53,101,-48,-294
712,19,2022/4/15 15:40,49,111,-62,-323
713,19,2022/4/15 15:50,61,101,-40,-270
714,19,2022/4/15 16:00,61,103,-42,-276
715,19,2022/4/15 16:10,62,110,-48,-265
716,19,2022/4/15 16:20,69,109,-40,-260
717,19,2022/4/15 16:30,93,104,-11,-214
718,19,2022/4/15 16:40,138,102,36,-76
719,19,2022/4/15 16:50,174,109,65,-157
720,19,2022/4/15 17:00,267,123,144,141
721,19,2022/4/15 17:10,310,124,186,245
722,19,2022/4/15 17:20,283,118,165,59
723,19,2022/4/15 17:30,298,110,188,-12
724,19,2022/4/15 17:40,367,183,184,105
725,19,2022/4/15 17:50,334,177,157,-199
726,19,2022/4/15 18:00,266,208,58,-659
727,19,2022/4/15 18:10,265,223,42,-236
728,19,2022/4/15 18:20,256,236,20,-551
729,19,2022/4/15 18:30,183,224,-41,-807
730,19,2022/4/15 18:40,150,220,-70,-857
731,19,2022/4/15 18:50,96,178,-82,-851
732,19,2022/4/15 19:00,68,226,-158,-747
733,19,2022/4/15 19:10,70,139,-69,-527
734,19,2022/4/15 19:20,53,120,-67,-393
735,19,2022/4/15 19:30,44,109,-65,-438
736,19,2022/4/15 19:40,41,127,-86,-415
737,19,2022/4/15 19:50,41,113,-72,-378
738,19,2022/4/15 20:00,45,120,-75,-353
739,19,2022/4/15 20:10,45,110,-65,-325
740,19,2022/4/15 20:20,43,99,-56,-226
741,19,2022/4/15 20:30,44,106,-62,-304
742,19,2022/4/15 20:40,47,105,-58,-235
743,19,2022/4/15 20:50,45,106,-61,-260
744,19,2022/4/15 21:00,44,122,-78,-218
745,19,2022/4/15 21:10,37,93,-56,-267
746,19,2022/4/15 21:20,37,114,-77,-333
747,19,2022/4/15 21:30,35,105,-70,-282
748,19,2022/4/15 21:40,30,112,-82,-256
749,19,2022/4/15 21:50,33,121,-88,-327
750,19,2022/4/15 22:00,25,96,-71,-357
751,19,2022/4/15 22:10,12,105,-93,-438
752,19,2022/4/15 22:20,3,71,-68,-445
753,19,2022/4/15 22:30,2,96,-94,-445
754,19,2022/4/15 22:40,2,71,-69,-367
755,19,2022/4/15 22:50,0,39,-39,-232
756,25,2022/4/15 5:00,0,1,-1,-7
757,25,2022/4/15 5:10,1,1,0,12
758,25,2022/4/15 5:20,6,1,5,44
759,25,2022/4/15 5:30,11,1,10,72
760,25,2022/4/15 5:40,20,1,19,92
761,25,2022/4/15 5:50,20,5,15,98
762,25,2022/4/15 6:00,26,1,25,148
763,25,2022/4/15 6:10,34,16,18,114
764,25,2022/4/15 6:20,40,19,21,89
765,25,2022/4/15 6:30,55,23,32,105
766,25,2022/4/15 6:40,60,25,35,173
767,25,2022/4/15 6:50,79,23,56,278
768,25,2022/4/15 7:00,186,46,140,459
769,25,2022/4/15 7:10,192,64,128,657
770,25,2022/4/15 7:20,227,62,165,1002
771,25,2022/4/15 7:30,254,68,186,1312
772,25,2022/4/15 7:40,350,75,275,1791
773,25,2022/4/15 7:50,368,74,294,2269
774,25,2022/4/15 8:00,478,110,368,2440
775,25,2022/4/15 8:10,571,123,448,2239
776,25,2022/4/15 8:20,573,139,434,1536
777,25,2022/4/15 8:30,368,152,216,855
778,25,2022/4/15 8:40,278,222,56,-347
779,25,2022/4/15 8:50,247,110,137,-130
780,25,2022/4/15 9:00,212,110,102,-290
781,25,2022/4/15 9:10,181,105,76,-471
782,25,2022/4/15 9:20,122,108,14,-522
783,25,2022/4/15 9:30,75,98,-23,-430
784,25,2022/4/15 9:40,60,84,-24,-445
785,25,2022/4/15 9:50,48,76,-28,-399
786,25,2022/4/15 10:00,43,73,-30,-369
787,25,2022/4/15 10:10,38,70,-32,-323
788,25,2022/4/15 10:20,37,70,-33,-306
789,25,2022/4/15 10:30,29,71,-42,-350
790,25,2022/4/15 10:40,32,72,-40,-318
791,25,2022/4/15 10:50,31,62,-31,-300
792,25,2022/4/15 11:00,31,62,-31,-300
793,25,2022/4/15 11:10,32,67,-35,-297
794,25,2022/4/15 11:20,29,64,-35,-275
795,25,2022/4/15 11:30,32,66,-34,-279
796,25,2022/4/15 11:40,27,61,-34,-249
797,25,2022/4/15 11:50,33,70,-37,-222
798,25,2022/4/15 12:00,31,67,-36,-219
799,25,2022/4/15 12:10,31,66,-35,-237
800,25,2022/4/15 12:20,32,66,-34,-228
801,25,2022/4/15 12:30,31,70,-39,-260
802,25,2022/4/15 12:40,29,73,-44,-277
803,25,2022/4/15 12:50,31,71,-40,-260
804,25,2022/4/15 13:00,34,62,-28,-280
805,25,2022/4/15 13:10,33,71,-38,-280
806,25,2022/4/15 13:20,31,69,-38,-301
807,25,2022/4/15 13:30,33,70,-37,-303
808,25,2022/4/15 13:40,28,69,-41,-326
809,25,2022/4/15 13:50,29,87,-58,-319
810,25,2022/4/15 14:00,33,64,-31,-304
811,25,2022/4/15 14:10,31,77,-46,-299
812,25,2022/4/15 14:20,25,77,-52,-328
813,25,2022/4/15 14:30,34,66,-32,-271
814,25,2022/4/15 14:40,29,76,-47,-316
815,25,2022/4/15 14:50,31,85,-54,-330
816,25,2022/4/15 15:00,33,74,-41,-323
817,25,2022/4/15 15:10,30,83,-53,-252
818,25,2022/4/15 15:20,35,76,-41,-296
819,25,2022/4/15 15:30,35,97,-62,-356
820,25,2022/4/15 15:40,29,90,-61,-384
821,25,2022/4/15 15:50,36,93,-57,-327
822,25,2022/4/15 16:00,38,91,-53,-329
823,25,2022/4/15 16:10,34,101,-67,-332
824,25,2022/4/15 16:20,36,108,-72,-332
825,25,2022/4/15 16:30,37,106,-69,-283
826,25,2022/4/15 16:40,43,112,-69,-145
827,25,2022/4/15 16:50,43,106,-63,-220
828,25,2022/4/15 17:00,91,116,-25,116
829,25,2022/4/15 17:10,133,123,10,255
830,25,2022/4/15 17:20,61,118,-57,2
831,25,2022/4/15 17:30,80,151,-71,-83
832,25,2022/4/15 17:40,185,183,2,107
833,25,2022/4/15 17:50,83,178,-95,-294
834,25,2022/4/15 18:00,72,226,-154,-813
835,25,2022/4/15 18:10,130,226,-96,-332
836,25,2022/4/15 18:20,74,223,-149,-700
837,25,2022/4/15 18:30,46,226,-180,-987
838,25,2022/4/15 18:40,44,198,-154,-1011
839,25,2022/4/15 18:50,43,184,-141,-992
840,25,2022/4/15 19:00,37,152,-115,-862
841,25,2022/4/15 19:10,38,110,-72,-599
842,25,2022/4/15 19:20,33,109,-76,-469
843,25,2022/4/15 19:30,29,118,-89,-527
844,25,2022/4/15 19:40,27,104,-77,-492
845,25,2022/4/15 19:50,27,106,-79,-457
846,25,2022/4/15 20:00,28,108,-80,-433
847,25,2022/4/15 20:10,28,110,-82,-407
848,25,2022/4/15 20:20,28,79,-51,-277
849,25,2022/4/15 20:30,23,107,-84,-388
850,25,2022/4/15 20:40,29,78,-49,-284
851,25,2022/4/15 20:50,25,106,-81,-341
852,25,2022/4/15 21:00,24,94,-70,-288
853,25,2022/4/15 21:10,23,106,-83,-350
854,25,2022/4/15 21:20,22,99,-77,-410
855,25,2022/4/15 21:30,16,100,-84,-366
856,25,2022/4/15 21:40,13,105,-92,-348
857,25,2022/4/15 21:50,14,87,-73,-400
858,25,2022/4/15 22:00,16,107,-91,-448
859,25,2022/4/15 22:10,6,73,-67,-505
860,25,2022/4/15 22:20,4,99,-95,-540
861,25,2022/4/15 22:30,1,73,-72,-517
862,25,2022/4/15 22:40,0,59,-59,-426
863,25,2022/4/15 22:50,0,3,-3,-235
864,2,2022/4/15 5:00,0,1,-1,-8
865,2,2022/4/15 5:10,1,1,0,12
866,2,2022/4/15 5:20,3,1,2,46
867,2,2022/4/15 5:30,8,1,7,79
868,2,2022/4/15 5:40,18,1,17,109
869,2,2022/4/15 5:50,21,6,15,113
870,2,2022/4/15 6:00,23,21,2,150
871,2,2022/4/15 6:10,30,21,9,123
872,2,2022/4/15 6:20,33,23,10,99
873,2,2022/4/15 6:30,41,38,3,108
874,2,2022/4/15 6:40,44,33,11,184
875,2,2022/4/15 6:50,63,52,11,289
876,2,2022/4/15 7:00,76,67,9,468
877,2,2022/4/15 7:10,91,68,23,680
878,2,2022/4/15 7:20,101,75,26,1028
879,2,2022/4/15 7:30,162,105,57,1369
880,2,2022/4/15 7:40,226,122,104,1895
881,2,2022/4/15 7:50,274,185,89,2358
882,2,2022/4/15 8:00,300,281,19,2459
883,2,2022/4/15 8:10,318,507,-189,2050
884,2,2022/4/15 8:20,337,535,-198,1338
885,2,2022/4/15 8:30,303,434,-131,724
886,2,2022/4/15 8:40,269,1126,-857,-1204
887,2,2022/4/15 8:50,224,429,-205,-335
888,2,2022/4/15 9:00,182,317,-135,-425
889,2,2022/4/15 9:10,145,217,-72,-543
890,2,2022/4/15 9:20,83,181,-98,-620
891,2,2022/4/15 9:30,65,133,-68,-498
892,2,2022/4/15 9:40,51,121,-70,-515
893,2,2022/4/15 9:50,48,109,-61,-460
894,2,2022/4/15 10:00,45,105,-60,-429
895,2,2022/4/15 10:10,44,98,-54,-377
896,2,2022/4/15 10:20,42,90,-48,-354
897,2,2022/4/15 10:30,37,90,-53,-403
898,2,2022/4/15 10:40,36,93,-57,-375
899,2,2022/4/15 10:50,36,76,-40,-340
900,2,2022/4/15 11:00,37,70,-33,-333
901,2,2022/4/15 11:10,36,85,-49,-346
902,2,2022/4/15 11:20,37,81,-44,-319
903,2,2022/4/15 11:30,38,74,-36,-315
904,2,2022/4/15 11:40,34,76,-42,-291
905,2,2022/4/15 11:50,34,70,-36,-258
906,2,2022/4/15 12:00,38,76,-38,-257
907,2,2022/4/15 12:10,45,69,-24,-261
908,2,2022/4/15 12:20,44,76,-32,-260
909,2,2022/4/15 12:30,41,73,-32,-292
910,2,2022/4/15 12:40,46,76,-30,-307
911,2,2022/4/15 12:50,41,90,-49,-309
912,2,2022/4/15 13:00,41,73,-32,-312
913,2,2022/4/15 13:10,38,104,-66,-346
914,2,2022/4/15 13:20,41,76,-35,-336
915,2,2022/4/15 13:30,38,93,-55,-358
916,2,2022/4/15 13:40,44,82,-38,-364
917,2,2022/4/15 13:50,41,87,-46,-365
918,2,2022/4/15 14:00,41,93,-52,-356
919,2,2022/4/15 14:10,44,82,-38,-337
920,2,2022/4/15 14:20,36,94,-58,-386
921,2,2022/4/15 14:30,35,81,-46,-317
922,2,2022/4/15 14:40,40,79,-39,-355
923,2,2022/4/15 14:50,37,79,-42,-372
924,2,2022/4/15 15:00,43,77,-34,-357
925,2,2022/4/15 15:10,41,93,-52,-304
926,2,2022/4/15 15:20,42,83,-41,-337
927,2,2022/4/15 15:30,45,105,-60,-416
928,2,2022/4/15 15:40,43,87,-44,-428
929,2,2022/4/15 15:50,46,104,-58,-385
930,2,2022/4/15 16:00,50,92,-42,-371
931,2,2022/4/15 16:10,53,97,-44,-376
932,2,2022/4/15 16:20,47,100,-53,-385
933,2,2022/4/15 16:30,68,99,-31,-314
934,2,2022/4/15 16:40,94,112,-18,-163
935,2,2022/4/15 16:50,85,105,-20,-240
936,2,2022/4/15 17:00,277,108,169,285
937,2,2022/4/15 17:10,310,125,185,440
938,2,2022/4/15 17:20,275,110,165,167
939,2,2022/4/15 17:30,327,108,219,136
940,2,2022/4/15 17:40,710,142,568,675
941,2,2022/4/15 17:50,462,181,281,-13
942,2,2022/4/15 18:00,326,184,142,-671
943,2,2022/4/15 18:10,577,192,385,53
944,2,2022/4/15 18:20,272,159,113,-587
945,2,2022/4/15 18:30,205,185,20,-967
946,2,2022/4/15 18:40,176,152,24,-987
947,2,2022/4/15 18:50,89,117,-28,-1020
948,2,2022/4/15 19:00,76,110,-34,-896
949,2,2022/4/15 19:10,65,124,-59,-658
950,2,2022/4/15 19:20,52,103,-51,-520
951,2,2022/4/15 19:30,45,111,-66,-593
952,2,2022/4/15 19:40,39,105,-66,-558
953,2,2022/4/15 19:50,40,95,-55,-512
954,2,2022/4/15 20:00,39,82,-43,-476
955,2,2022/4/15 20:10,40,95,-55,-462
956,2,2022/4/15 20:20,36,93,-57,-334
957,2,2022/4/15 20:30,32,79,-47,-435
958,2,2022/4/15 20:40,37,92,-55,-339
959,2,2022/4/15 20:50,36,78,-42,-383
960,2,2022/4/15 21:00,30,77,-47,-335
961,2,2022/4/15 21:10,29,82,-53,-403
962,2,2022/4/15 21:20,30,97,-67,-477
963,2,2022/4/15 21:30,29,76,-47,-413
964,2,2022/4/15 21:40,26,80,-54,-402
965,2,2022/4/15 21:50,28,79,-51,-451
966,2,2022/4/15 22:00,23,86,-63,-511
967,2,2022/4/15 22:10,28,79,-51,-556
968,2,2022/4/15 22:20,15,78,-63,-603
969,2,2022/4/15 22:30,11,77,-66,-583
970,2,2022/4/15 22:40,5,52,-47,-473
971,2,2022/4/15 22:50,0,3,-3,-238
972,16,2022/4/15 5:00,0,1,-1,-9
973,16,2022/4/15 5:10,0,1,-1,11
974,16,2022/4/15 5:20,2,1,1,47
975,16,2022/4/15 5:30,6,1,5,84
976,16,2022/4/15 5:40,13,1,12,121
977,16,2022/4/15 5:50,13,5,8,121
978,16,2022/4/15 6:00,17,8,9,159
979,16,2022/4/15 6:10,22,23,-1,122
980,16,2022/4/15 6:20,22,30,-8,91
981,16,2022/4/15 6:30,30,37,-7,101
982,16,2022/4/15 6:40,32,63,-31,153
983,16,2022/4/15 6:50,31,93,-62,227
984,16,2022/4/15 7:00,42,123,-81,387
985,16,2022/4/15 7:10,52,109,-57,623
986,16,2022/4/15 7:20,56,126,-70,958
987,16,2022/4/15 7:30,67,124,-57,1312
988,16,2022/4/15 7:40,94,139,-45,1850
989,16,2022/4/15 7:50,145,197,-52,2306
990,16,2022/4/15 8:00,180,506,-326,2133
991,16,2022/4/15 8:10,189,565,-376,1674
992,16,2022/4/15 8:20,224,1597,-1373,-35
993,16,2022/4/15 8:30,221,1522,-1301,-577
994,16,2022/4/15 8:40,176,1981,-1805,-3009
995,16,2022/4/15 8:50,150,1521,-1371,-1706
996,16,2022/4/15 9:00,84,429,-345,-770
997,16,2022/4/15 9:10,74,508,-434,-977
998,16,2022/4/15 9:20,68,317,-249,-869
999,16,2022/4/15 9:30,58,190,-132,-630
1000,16,2022/4/15 9:40,53,169,-116,-631
1001,16,2022/4/15 9:50,49,142,-93,-553
1002,16,2022/4/15 10:00,45,129,-84,-513
1003,16,2022/4/15 10:10,43,102,-59,-436
1004,16,2022/4/15 10:20,49,114,-65,-419
1005,16,2022/4/15 10:30,47,104,-57,-460
1006,16,2022/4/15 10:40,45,113,-68,-443
1007,16,2022/4/15 10:50,42,112,-70,-410
1008,16,2022/4/15 11:00,44,111,-67,-400
1009,16,2022/4/15 11:10,48,106,-58,-404
1010,16,2022/4/15 11:20,45,101,-56,-375
1011,16,2022/4/15 11:30,49,111,-62,-377
1012,16,2022/4/15 11:40,49,104,-55,-346
1013,16,2022/4/15 11:50,47,110,-63,-321
1014,16,2022/4/15 12:00,56,100,-44,-301
1015,16,2022/4/15 12:10,59,105,-46,-307
1016,16,2022/4/15 12:20,45,108,-63,-323
1017,16,2022/4/15 12:30,58,108,-50,-342
1018,16,2022/4/15 12:40,50,109,-59,-366
1019,16,2022/4/15 12:50,58,108,-50,-359
1020,16,2022/4/15 13:00,54,105,-51,-363
1021,16,2022/4/15 13:10,67,107,-40,-386
1022,16,2022/4/15 13:20,62,105,-43,-379
1023,16,2022/4/15 13:30,60,109,-49,-407
1024,16,2022/4/15 13:40,58,108,-50,-414
1025,16,2022/4/15 13:50,60,105,-45,-410
1026,16,2022/4/15 14:00,56,112,-56,-412
1027,16,2022/4/15 14:10,55,111,-56,-393
1028,16,2022/4/15 14:20,58,106,-48,-434
1029,16,2022/4/15 14:30,56,106,-50,-367
1030,16,2022/4/15 14:40,52,112,-60,-415
1031,16,2022/4/15 14:50,57,112,-55,-427
1032,16,2022/4/15 15:00,56,105,-49,-406
1033,16,2022/4/15 15:10,71,109,-38,-342
1034,16,2022/4/15 15:20,77,104,-27,-364
1035,16,2022/4/15 15:30,67,104,-37,-453
1036,16,2022/4/15 15:40,83,108,-25,-453
1037,16,2022/4/15 15:50,68,103,-35,-420
1038,16,2022/4/15 16:00,85,109,-24,-395
1039,16,2022/4/15 16:10,79,105,-26,-402
1040,16,2022/4/15 16:20,92,106,-14,-399
1041,16,2022/4/15 16:30,167,105,62,-252
1042,16,2022/4/15 16:40,178,105,73,-90
1043,16,2022/4/15 16:50,206,106,100,-140
1044,16,2022/4/15 17:00,342,109,233,518
1045,16,2022/4/15 17:10,461,97,364,804
1046,16,2022/4/15 17:20,312,120,192,359
1047,16,2022/4/15 17:30,657,109,548,684
1048,16,2022/4/15 17:40,1045,132,913,1588
1049,16,2022/4/15 17:50,710,181,529,516
1050,16,2022/4/15 18:00,835,152,683,12
1051,16,2022/4/15 18:10,1149,153,996,1049
1052,16,2022/4/15 18:20,679,153,526,-61
1053,16,2022/4/15 18:30,576,150,426,-541
1054,16,2022/4/15 18:40,311,144,167,-820
1055,16,2022/4/15 18:50,274,116,158,-862
1056,16,2022/4/15 19:00,216,111,105,-791
1057,16,2022/4/15 19:10,222,112,110,-548
1058,16,2022/4/15 19:20,178,115,63,-457
1059,16,2022/4/15 19:30,175,97,78,-515
1060,16,2022/4/15 19:40,139,95,44,-514
1061,16,2022/4/15 19:50,130,83,47,-465
1062,16,2022/4/15 20:00,102,99,3,-473
1063,16,2022/4/15 20:10,84,71,13,-449
1064,16,2022/4/15 20:20,70,79,-9,-343
1065,16,2022/4/15 20:30,67,63,4,-431
1066,16,2022/4/15 20:40,67,87,-20,-359
1067,16,2022/4/15 20:50,76,67,9,-374
1068,16,2022/4/15 21:00,64,85,-21,-356
1069,16,2022/4/15 21:10,59,69,-10,-413
1070,16,2022/4/15 21:20,43,75,-32,-509
1071,16,2022/4/15 21:30,39,79,-40,-453
1072,16,2022/4/15 21:40,38,67,-29,-431
1073,16,2022/4/15 21:50,30,77,-47,-498
1074,16,2022/4/15 22:00,39,61,-22,-533
1075,16,2022/4/15 22:10,26,76,-50,-606
1076,16,2022/4/15 22:20,12,74,-62,-665
1077,16,2022/4/15 22:30,5,67,-62,-645
1078,16,2022/4/15 22:40,0,24,-24,-497
1079,16,2022/4/15 22:50,0,3,-3,-241
1080,18,2022/4/15 5:00,0,1,-1,-10
1081,18,2022/4/15 5:10,0,1,-1,10
1082,18,2022/4/15 5:20,1,1,0,47
1083,18,2022/4/15 5:30,5,1,4,88
1084,18,2022/4/15 5:40,10,8,2,123
1085,18,2022/4/15 5:50,15,23,-8,113
1086,18,2022/4/15 6:00,16,57,-41,118
1087,18,2022/4/15 6:10,19,59,-40,82
1088,18,2022/4/15 6:20,27,68,-41,50
1089,18,2022/4/15 6:30,24,93,-69,32
1090,18,2022/4/15 6:40,33,106,-73,80
1091,18,2022/4/15 6:50,32,105,-73,154
1092,18,2022/4/15 7:00,37,123,-86,301
1093,18,2022/4/15 7:10,31,123,-92,531
1094,18,2022/4/15 7:20,44,128,-84,874
1095,18,2022/4/15 7:30,52,152,-100,1212
1096,18,2022/4/15 7:40,57,152,-95,1755
1097,18,2022/4/15 7:50,61,269,-208,2098
1098,18,2022/4/15 8:00,70,325,-255,1878
1099,18,2022/4/15 8:10,75,421,-346,1328
1100,18,2022/4/15 8:20,69,491,-422,-457
1101,18,2022/4/15 8:30,68,589,-521,-1098
1102,18,2022/4/15 8:40,54,574,-520,-3529
1103,18,2022/4/15 8:50,53,505,-452,-2158
1104,18,2022/4/15 9:00,49,333,-284,-1054
1105,18,2022/4/15 9:10,45,298,-253,-1230
1106,18,2022/4/15 9:20,43,196,-153,-1022
1107,18,2022/4/15 9:30,42,225,-183,-813
1108,18,2022/4/15 9:40,46,232,-186,-817
1109,18,2022/4/15 9:50,47,221,-174,-727
1110,18,2022/4/15 10:00,41,179,-138,-651
1111,18,2022/4/15 10:10,44,192,-148,-584
1112,18,2022/4/15 10:20,40,192,-152,-571
1113,18,2022/4/15 10:30,44,180,-136,-596
1114,18,2022/4/15 10:40,48,146,-98,-541
1115,18,2022/4/15 10:50,51,146,-95,-505
1116,18,2022/4/15 11:00,62,169,-107,-507
1117,18,2022/4/15 11:10,60,153,-93,-497
1118,18,2022/4/15 11:20,66,138,-72,-447
1119,18,2022/4/15 11:30,70,181,-111,-488
1120,18,2022/4/15 11:40,73,151,-78,-424
1121,18,2022/4/15 11:50,75,142,-67,-388
1122,18,2022/4/15 12:00,82,137,-55,-356
1123,18,2022/4/15 12:10,108,151,-43,-350
1124,18,2022/4/15 12:20,124,110,14,-309
1125,18,2022/4/15 12:30,124,170,-46,-388
1126,18,2022/4/15 12:40,132,138,-6,-372
1127,18,2022/4/15 12:50,156,153,3,-356
1128,18,2022/4/15 13:00,175,152,23,-340
1129,18,2022/4/15 13:10,174,146,28,-358
1130,18,2022/4/15 13:20,173,182,-9,-388
1131,18,2022/4/15 13:30,198,170,28,-379
1132,18,2022/4/15 13:40,204,192,12,-402
1133,18,2022/4/15 13:50,191,154,37,-373
1134,18,2022/4/15 14:00,203,170,33,-379
1135,18,2022/4/15 14:10,206,139,67,-326
1136,18,2022/4/15 14:20,207,119,88,-346
1137,18,2022/4/15 14:30,201,138,63,-304
1138,18,2022/4/15 14:40,217,105,112,-303
1139,18,2022/4/15 14:50,242,105,137,-290
1140,18,2022/4/15 15:00,243,109,134,-272
1141,18,2022/4/15 15:10,268,110,158,-184
1142,18,2022/4/15 15:20,272,122,150,-214
1143,18,2022/4/15 15:30,267,119,148,-305
1144,18,2022/4/15 15:40,270,116,154,-299
1145,18,2022/4/15 15:50,261,88,173,-247
1146,18,2022/4/15 16:00,265,102,163,-232
1147,18,2022/4/15 16:10,287,108,179,-223
1148,18,2022/4/15 16:20,293,102,191,-208
1149,18,2022/4/15 16:30,331,105,226,-26
1150,18,2022/4/15 16:40,350,96,254,164
1151,18,2022/4/15 16:50,368,96,272,132
1152,18,2022/4/15 17:00,695,99,596,1114
1153,18,2022/4/15 17:10,654,90,564,1368
1154,18,2022/4/15 17:20,598,99,499,858
1155,18,2022/4/15 17:30,618,98,520,1204
1156,18,2022/4/15 17:40,706,93,613,2201
1157,18,2022/4/15 17:50,698,104,594,1110
1158,18,2022/4/15 18:00,575,108,467,479
1159,18,2022/4/15 18:10,639,92,547,1596
1160,18,2022/4/15 18:20,368,99,269,208
1161,18,2022/4/15 18:30,273,112,161,-380
1162,18,2022/4/15 18:40,218,92,126,-694
1163,18,2022/4/15 18:50,174,93,81,-781
1164,18,2022/4/15 19:00,127,68,59,-732
1165,18,2022/4/15 19:10,73,69,4,-544
1166,18,2022/4/15 19:20,42,67,-25,-482
1167,18,2022/4/15 19:30,36,67,-31,-546
1168,18,2022/4/15 19:40,30,59,-29,-543
1169,18,2022/4/15 19:50,29,51,-22,-487
1170,18,2022/4/15 20:00,31,47,-16,-489
1171,18,2022/4/15 20:10,31,56,-25,-474
1172,18,2022/4/15 20:20,26,49,-23,-366
1173,18,2022/4/15 20:30,24,67,-43,-474
1174,18,2022/4/15 20:40,25,47,-22,-381
1175,18,2022/4/15 20:50,23,63,-40,-414
1176,18,2022/4/15 21:00,29,47,-18,-374
1177,18,2022/4/15 21:10,27,53,-26,-439
1178,18,2022/4/15 21:20,23,49,-26,-535
1179,18,2022/4/15 21:30,20,60,-40,-493
1180,18,2022/4/15 21:40,22,54,-32,-463
1181,18,2022/4/15 21:50,15,51,-36,-534
1182,18,2022/4/15 22:00,20,56,-36,-569
1183,18,2022/4/15 22:10,11,40,-29,-635
1184,18,2022/4/15 22:20,6,71,-65,-730
1185,18,2022/4/15 22:30,2,55,-53,-698
1186,18,2022/4/15 22:40,0,25,-25,-522
1187,18,2022/4/15 22:50,0,3,-3,-244
1188,10,2022/4/15 5:00,0,1,-1,-11
1189,10,2022/4/15 5:10,2,1,1,11
1190,10,2022/4/15 5:20,7,1,6,53
1191,10,2022/4/15 5:30,10,11,-1,87
1192,10,2022/4/15 5:40,15,6,9,132
1193,10,2022/4/15 5:50,23,13,10,123
1194,10,2022/4/15 6:00,22,46,-24,94
1195,10,2022/4/15 6:10,26,58,-32,50
1196,10,2022/4/15 6:20,29,60,-31,19
1197,10,2022/4/15 6:30,34,73,-39,-7
1198,10,2022/4/15 6:40,38,77,-39,41
1199,10,2022/4/15 6:50,34,106,-72,82
1200,10,2022/4/15 7:00,42,113,-71,230
1201,10,2022/4/15 7:10,46,117,-71,460
1202,10,2022/4/15 7:20,52,190,-138,736
1203,10,2022/4/15 7:30,58,325,-267,945
1204,10,2022/4/15 7:40,68,443,-375,1380
1205,10,2022/4/15 7:50,83,440,-357,1741
1206,10,2022/4/15 8:00,113,1189,-1076,802
1207,10,2022/4/15 8:10,154,2156,-2002,-674
1208,10,2022/4/15 8:20,155,3168,-3013,-3470
1209,10,2022/4/15 8:30,128,3266,-3138,-4236
1210,10,2022/4/15 8:40,83,2848,-2765,-6294
1211,10,2022/4/15 8:50,78,3164,-3086,-5244
1212,10,2022/4/15 9:00,69,1627,-1558,-2612
1213,10,2022/4/15 9:10,66,1565,-1499,-2729
1214,10,2022/4/15 9:20,70,1120,-1050,-2072
1215,10,2022/4/15 9:30,71,478,-407,-1220
1216,10,2022/4/15 9:40,65,427,-362,-1179
1217,10,2022/4/15 9:50,67,438,-371,-1098
1218,10,2022/4/15 10:00,66,323,-257,-908
1219,10,2022/4/15 10:10,72,326,-254,-838
1220,10,2022/4/15 10:20,73,232,-159,-730
1221,10,2022/4/15 10:30,69,207,-138,-734
1222,10,2022/4/15 10:40,82,179,-97,-638
1223,10,2022/4/15 10:50,74,178,-104,-609
1224,10,2022/4/15 11:00,91,171,-80,-587
1225,10,2022/4/15 11:10,100,117,-17,-514
1226,10,2022/4/15 11:20,100,152,-52,-499
1227,10,2022/4/15 11:30,127,128,-1,-489
1228,10,2022/4/15 11:40,114,139,-25,-449
1229,10,2022/4/15 11:50,132,152,-20,-408
1230,10,2022/4/15 12:00,128,120,8,-348
1231,10,2022/4/15 12:10,113,105,8,-342
1232,10,2022/4/15 12:20,141,150,-9,-318
1233,10,2022/4/15 12:30,131,112,19,-369
1234,10,2022/4/15 12:40,135,160,-25,-397
1235,10,2022/4/15 12:50,131,154,-23,-379
1236,10,2022/4/15 13:00,154,192,-38,-378
1237,10,2022/4/15 13:10,169,185,-16,-374
1238,10,2022/4/15 13:20,175,192,-17,-405
1239,10,2022/4/15 13:30,175,185,-10,-389
1240,10,2022/4/15 13:40,200,179,21,-381
1241,10,2022/4/15 13:50,196,171,25,-348
1242,10,2022/4/15 14:00,213,183,30,-349
1243,10,2022/4/15 14:10,214,144,70,-256
1244,10,2022/4/15 14:20,195,170,25,-321
1245,10,2022/4/15 14:30,210,139,71,-233
1246,10,2022/4/15 14:40,207,154,53,-250
1247,10,2022/4/15 14:50,216,139,77,-213
1248,10,2022/4/15 15:00,236,117,119,-153
1249,10,2022/4/15 15:10,270,111,159,-25
1250,10,2022/4/15 15:20,270,117,153,-61
1251,10,2022/4/15 15:30,263,117,146,-159
1252,10,2022/4/15 15:40,271,117,154,-145
1253,10,2022/4/15 15:50,272,119,153,-94
1254,10,2022/4/15 16:00,319,115,204,-28
1255,10,2022/4/15 16:10,344,109,235,12
1256,10,2022/4/15 16:20,342,119,223,15
1257,10,2022/4/15 16:30,552,129,423,397
1258,10,2022/4/15 16:40,576,129,447,611
1259,10,2022/4/15 16:50,552,128,424,556
1260,10,2022/4/15 17:00,1160,123,1037,2151
1261,10,2022/4/15 17:10,1357,106,1251,2619
1262,10,2022/4/15 17:20,1025,157,868,1726
1263,10,2022/4/15 17:30,1357,179,1178,2382
1264,10,2022/4/15 17:40,1587,178,1409,3610
1265,10,2022/4/15 17:50,1030,213,817,1927
1266,10,2022/4/15 18:00,1209,223,986,1465
1267,10,2022/4/15 18:10,1357,235,1122,2718
1268,10,2022/4/15 18:20,1037,234,803,1011
1269,10,2022/4/15 18:30,705,200,505,125
1270,10,2022/4/15 18:40,654,236,418,-276
1271,10,2022/4/15 18:50,568,179,389,-392
1272,10,2022/4/15 19:00,552,180,372,-360
1273,10,2022/4/15 19:10,422,114,308,-236
1274,10,2022/4/15 19:20,327,109,218,-264
1275,10,2022/4/15 19:30,306,114,192,-354
1276,10,2022/4/15 19:40,289,100,189,-354
1277,10,2022/4/15 19:50,295,99,196,-291
1278,10,2022/4/15 20:00,575,108,467,-22
1279,10,2022/4/15 20:10,576,111,465,-9
1280,10,2022/4/15 20:20,332,107,225,-141
1281,10,2022/4/15 20:30,264,105,159,-315
1282,10,2022/4/15 20:40,271,92,179,-202
1283,10,2022/4/15 20:50,270,94,176,-238
1284,10,2022/4/15 21:00,265,88,177,-197
1285,10,2022/4/15 21:10,268,81,187,-252
1286,10,2022/4/15 21:20,214,99,115,-420
1287,10,2022/4/15 21:30,261,69,192,-301
1288,10,2022/4/15 21:40,213,78,135,-328
1289,10,2022/4/15 21:50,191,64,127,-407
1290,10,2022/4/15 22:00,216,78,138,-431
1291,10,2022/4/15 22:10,168,78,90,-545
1292,10,2022/4/15 22:20,46,85,-39,-769
1293,10,2022/4/15 22:30,35,70,-35,-733
1294,10,2022/4/15 22:40,24,64,-40,-562
1295,10,2022/4/15 22:50,16,50,-34,-278
1296,26,2022/4/15 5:00,0,1,-1,-12
1297,26,2022/4/15 5:10,0,1,-1,10
1298,26,2022/4/15 5:20,1,1,0,53
1299,26,2022/4/15 5:30,3,1,2,89
1300,26,2022/4/15 5:40,12,1,11,143
1301,26,2022/4/15 5:50,20,6,14,137
1302,26,2022/4/15 6:00,19,23,-4,90
1303,26,2022/4/15 6:10,21,41,-20,30
1304,26,2022/4/15 6:20,30,51,-21,-2
1305,26,2022/4/15 6:30,32,62,-30,-37
1306,26,2022/4/15 6:40,31,77,-46,-5
1307,26,2022/4/15 6:50,34,76,-42,40
1308,26,2022/4/15 7:00,38,93,-55,175
1309,26,2022/4/15 7:10,44,111,-67,393
1310,26,2022/4/15 7:20,57,119,-62,674
1311,26,2022/4/15 7:30,60,139,-79,866
1312,26,2022/4/15 7:40,76,180,-104,1276
1313,26,2022/4/15 7:50,148,335,-187,1554
1314,26,2022/4/15 8:00,144,497,-353,449
1315,26,2022/4/15 8:10,153,565,-412,-1086
1316,26,2022/4/15 8:20,173,1095,-922,-4392
1317,26,2022/4/15 8:30,150,1094,-944,-5180
1318,26,2022/4/15 8:40,121,2051,-1930,-8224
1319,26,2022/4/15 8:50,81,1104,-1023,-6267
1320,26,2022/4/15 9:00,77,433,-356,-2968
1321,26,2022/4/15 9:10,69,417,-348,-3077
1322,26,2022/4/15 9:20,66,378,-312,-2384
1323,26,2022/4/15 9:30,59,379,-320,-1540
1324,26,2022/4/15 9:40,62,334,-272,-1451
1325,26,2022/4/15 9:50,63,332,-269,-1367
1326,26,2022/4/15 10:00,62,269,-207,-1115
1327,26,2022/4/15 10:10,64,219,-155,-993
1328,26,2022/4/15 10:20,63,214,-151,-881
1329,26,2022/4/15 10:30,70,209,-139,-873
1330,26,2022/4/15 10:40,65,198,-133,-771
1331,26,2022/4/15 10:50,75,192,-117,-726
1332,26,2022/4/15 11:00,75,153,-78,-665
1333,26,2022/4/15 11:10,92,186,-94,-608
1334,26,2022/4/15 11:20,87,151,-64,-563
1335,26,2022/4/15 11:30,91,170,-79,-568
1336,26,2022/4/15 11:40,131,109,22,-427
1337,26,2022/4/15 11:50,133,120,13,-395
1338,26,2022/4/15 12:00,139,110,29,-319
1339,26,2022/4/15 12:10,176,120,56,-286
1340,26,2022/4/15 12:20,172,105,67,-251
1341,26,2022/4/15 12:30,156,111,45,-324
1342,26,2022/4/15 12:40,186,170,16,-381
1343,26,2022/4/15 12:50,179,152,27,-352
1344,26,2022/4/15 13:00,177,138,39,-339
1345,26,2022/4/15 13:10,204,159,45,-329
1346,26,2022/4/15 13:20,213,152,61,-344
1347,26,2022/4/15 13:30,207,156,51,-338
1348,26,2022/4/15 13:40,201,181,20,-361
1349,26,2022/4/15 13:50,202,146,56,-292
1350,26,2022/4/15 14:00,225,169,56,-293
1351,26,2022/4/15 14:10,218,171,47,-209
1352,26,2022/4/15 14:20,218,127,91,-230
1353,26,2022/4/15 14:30,210,111,99,-134
1354,26,2022/4/15 14:40,237,119,118,-132
1355,26,2022/4/15 14:50,216,128,88,-125
1356,26,2022/4/15 15:00,273,112,161,8
1357,26,2022/4/15 15:10,272,117,155,130
1358,26,2022/4/15 15:20,266,108,158,97
1359,26,2022/4/15 15:30,310,125,185,26
1360,26,2022/4/15 15:40,268,109,159,14
1361,26,2022/4/15 15:50,254,110,144,50
1362,26,2022/4/15 16:00,272,104,168,140
1363,26,2022/4/15 16:10,262,120,142,154
1364,26,2022/4/15 16:20,268,123,145,160
1365,26,2022/4/15 16:30,338,119,219,616
1366,26,2022/4/15 16:40,334,123,211,822
1367,26,2022/4/15 16:50,328,126,202,758
1368,26,2022/4/15 17:00,636,121,515,2666
1369,26,2022/4/15 17:10,657,114,543,3162
1370,26,2022/4/15 17:20,674,103,571,2297
1371,26,2022/4/15 17:30,710,120,590,2972
1372,26,2022/4/15 17:40,1362,111,1251,4861
1373,26,2022/4/15 17:50,730,110,620,2547
1374,26,2022/4/15 18:00,697,121,576,2041
1375,26,2022/4/15 18:10,1043,120,923,3641
1376,26,2022/4/15 18:20,697,107,590,1601
1377,26,2022/4/15 18:30,360,110,250,375
1378,26,2022/4/15 18:40,315,110,205,-71
1379,26,2022/4/15 18:50,247,126,121,-271
1380,26,2022/4/15 19:00,205,124,81,-279
1381,26,2022/4/15 19:10,198,110,88,-148
1382,26,2022/4/15 19:20,138,97,41,-223
1383,26,2022/4/15 19:30,138,88,50,-304
1384,26,2022/4/15 19:40,113,77,36,-318
1385,26,2022/4/15 19:50,80,79,1,-290
1386,26,2022/4/15 20:00,102,79,23,1
1387,26,2022/4/15 20:10,76,67,9,0
1388,26,2022/4/15 20:20,67,87,-20,-161
1389,26,2022/4/15 20:30,64,72,-8,-323
1390,26,2022/4/15 20:40,71,72,-1,-203
1391,26,2022/4/15 20:50,88,68,20,-218
1392,26,2022/4/15 21:00,174,74,100,-97
1393,26,2022/4/15 21:10,85,78,7,-245
1394,26,2022/4/15 21:20,47,73,-26,-446
1395,26,2022/4/15 21:30,40,71,-31,-332
1396,26,2022/4/15 21:40,35,72,-37,-365
1397,26,2022/4/15 21:50,28,65,-37,-444
1398,26,2022/4/15 22:00,32,74,-42,-473
1399,26,2022/4/15 22:10,28,74,-46,-591
1400,26,2022/4/15 22:20,21,84,-63,-832
1401,26,2022/4/15 22:30,1,46,-45,-778
1402,26,2022/4/15 22:40,0,3,-3,-565
1403,26,2022/4/15 22:50,0,3,-3,-281
1404,22,2022/4/15 5:00,0,1,-1,-13
1405,22,2022/4/15 5:10,0,1,-1,9
1406,22,2022/4/15 5:20,0,1,-1,52
1407,22,2022/4/15 5:30,2,1,1,90
1408,22,2022/4/15 5:40,8,1,7,150
1409,22,2022/4/15 5:50,13,6,7,144
1410,22,2022/4/15 6:00,15,16,-1,89
1411,22,2022/4/15 6:10,16,21,-5,25
1412,22,2022/4/15 6:20,22,23,-1,-3
1413,22,2022/4/15 6:30,29,35,-6,-43
1414,22,2022/4/15 6:40,32,54,-22,-27
1415,22,2022/4/15 6:50,36,55,-19,21
1416,22,2022/4/15 7:00,40,68,-28,147
1417,22,2022/4/15 7:10,42,75,-33,360
1418,22,2022/4/15 7:20,44,92,-48,626
1419,22,2022/4/15 7:30,55,114,-59,807
1420,22,2022/4/15 7:40,58,120,-62,1214
1421,22,2022/4/15 7:50,85,117,-32,1522
1422,22,2022/4/15 8:00,85,159,-74,375
1423,22,2022/4/15 8:10,127,324,-197,-1283
1424,22,2022/4/15 8:20,146,297,-151,-4543
1425,22,2022/4/15 8:30,149,298,-149,-5329
1426,22,2022/4/15 8:40,85,432,-347,-8571
1427,22,2022/4/15 8:50,73,341,-268,-6535
1428,22,2022/4/15 9:00,49,384,-335,-3303
1429,22,2022/4/15 9:10,51,323,-272,-3349
1430,22,2022/4/15 9:20,48,255,-207,-2591
1431,22,2022/4/15 9:30,43,213,-170,-1710
1432,22,2022/4/15 9:40,40,196,-156,-1607
1433,22,2022/4/15 9:50,32,145,-113,-1480
1434,22,2022/4/15 10:00,37,108,-71,-1186
1435,22,2022/4/15 10:10,31,107,-76,-1069
1436,22,2022/4/15 10:20,36,118,-82,-963
1437,22,2022/4/15 10:30,39,112,-73,-946
1438,22,2022/4/15 10:40,36,112,-76,-847
1439,22,2022/4/15 10:50,33,104,-71,-797
1440,22,2022/4/15 11:00,33,92,-59,-724
1441,22,2022/4/15 11:10,33,93,-60,-668
1442,22,2022/4/15 11:20,37,91,-54,-617
1443,22,2022/4/15 11:30,39,114,-75,-643
1444,22,2022/4/15 11:40,37,101,-64,-491
1445,22,2022/4/15 11:50,38,97,-59,-454
1446,22,2022/4/15 12:00,39,96,-57,-376
1447,22,2022/4/15 12:10,35,106,-71,-357
1448,22,2022/4/15 12:20,36,98,-62,-313
1449,22,2022/4/15 12:30,42,105,-63,-387
1450,22,2022/4/15 12:40,37,106,-69,-450
1451,22,2022/4/15 12:50,41,108,-67,-419
1452,22,2022/4/15 13:00,37,109,-72,-411
1453,22,2022/4/15 13:10,40,119,-79,-408
1454,22,2022/4/15 13:20,41,107,-66,-410
1455,22,2022/4/15 13:30,44,88,-44,-382
1456,22,2022/4/15 13:40,43,107,-64,-425
1457,22,2022/4/15 13:50,43,100,-57,-349
1458,22,2022/4/15 14:00,42,106,-64,-357
1459,22,2022/4/15 14:10,42,112,-70,-279
1460,22,2022/4/15 14:20,44,105,-61,-291
1461,22,2022/4/15 14:30,52,103,-51,-185
1462,22,2022/4/15 14:40,46,103,-57,-189
1463,22,2022/4/15 14:50,46,107,-61,-186
1464,22,2022/4/15 15:00,51,109,-58,-50
1465,22,2022/4/15 15:10,63,109,-46,84
1466,22,2022/4/15 15:20,59,106,-47,50
1467,22,2022/4/15 15:30,53,105,-52,-26
1468,22,2022/4/15 15:40,61,105,-44,-30
1469,22,2022/4/15 15:50,69,108,-39,11
1470,22,2022/4/15 16:00,73,101,-28,112
1471,22,2022/4/15 16:10,76,112,-36,118
1472,22,2022/4/15 16:20,77,108,-31,129
1473,22,2022/4/15 16:30,74,102,-28,588
1474,22,2022/4/15 16:40,80,105,-25,797
1475,22,2022/4/15 16:50,85,108,-23,735
1476,22,2022/4/15 17:00,232,102,130,2796
1477,22,2022/4/15 17:10,216,103,113,3275
1478,22,2022/4/15 17:20,186,102,84,2381
1479,22,2022/4/15 17:30,272,103,169,3141
1480,22,2022/4/15 17:40,347,123,224,5085
1481,22,2022/4/15 17:50,247,116,131,2678
1482,22,2022/4/15 18:00,293,111,182,2223
1483,22,2022/4/15 18:10,552,116,436,4077
1484,22,2022/4/15 18:20,325,138,187,1788
1485,22,2022/4/15 18:30,272,152,120,495
1486,22,2022/4/15 18:40,241,119,122,51
1487,22,2022/4/15 18:50,213,112,101,-170
1488,22,2022/4/15 19:00,163,122,41,-238
1489,22,2022/4/15 19:10,141,123,18,-130
1490,22,2022/4/15 19:20,92,102,-10,-233
1491,22,2022/4/15 19:30,78,100,-22,-326
1492,22,2022/4/15 19:40,73,95,-22,-340
1493,22,2022/4/15 19:50,65,95,-30,-320
1494,22,2022/4/15 20:00,71,75,-4,-3
1495,22,2022/4/15 20:10,63,82,-19,-19
1496,22,2022/4/15 20:20,53,70,-17,-178
1497,22,2022/4/15 20:30,55,78,-23,-346
1498,22,2022/4/15 20:40,71,82,-11,-214
1499,22,2022/4/15 20:50,66,79,-13,-231
1500,22,2022/4/15 21:00,66,75,-9,-106
1501,22,2022/4/15 21:10,76,62,14,-231
1502,22,2022/4/15 21:20,56,77,-21,-467
1503,22,2022/4/15 21:30,62,63,-1,-333
1504,22,2022/4/15 21:40,73,78,-5,-370
1505,22,2022/4/15 21:50,65,67,-2,-446
1506,22,2022/4/15 22:00,92,63,29,-444
1507,22,2022/4/15 22:10,53,70,-17,-608
1508,22,2022/4/15 22:20,25,58,-33,-865
1509,22,2022/4/15 22:30,4,45,-41,-819
1510,22,2022/4/15 22:40,0,3,-3,-568
1511,22,2022/4/15 22:50,0,3,-3,-284
1512,12,2022/4/15 5:00,0,1,-1,-14
1513,12,2022/4/15 5:10,0,1,-1,8
1514,12,2022/4/15 5:20,1,1,0,52
1515,12,2022/4/15 5:30,2,1,1,91
1516,12,2022/4/15 5:40,11,1,10,160
1517,12,2022/4/15 5:50,19,39,-20,124
1518,12,2022/4/15 6:00,25,25,0,89
1519,12,2022/4/15 6:10,32,50,-18,7
1520,12,2022/4/15 6:20,33,53,-20,-23
1521,12,2022/4/15 6:30,39,93,-54,-97
1522,12,2022/4/15 6:40,50,102,-52,-79
1523,12,2022/4/15 6:50,57,110,-53,-32
1524,12,2022/4/15 7:00,75,110,-35,112
1525,12,2022/4/15 7:10,88,117,-29,331
1526,12,2022/4/15 7:20,181,180,1,627
1527,12,2022/4/15 7:30,215,233,-18,789
1528,12,2022/4/15 7:40,280,326,-46,1168
1529,12,2022/4/15 7:50,344,320,24,1546
1530,12,2022/4/15 8:00,597,447,150,525
1531,12,2022/4/15 8:10,628,425,203,-1080
1532,12,2022/4/15 8:20,719,486,233,-4310
1533,12,2022/4/15 8:30,628,1570,-942,-6271
1534,12,2022/4/15 8:40,442,1578,-1136,-9707
1535,12,2022/4/15 8:50,330,1623,-1293,-7828
1536,12,2022/4/15 9:00,274,603,-329,-3632
1537,12,2022/4/15 9:10,277,603,-326,-3675
1538,12,2022/4/15 9:20,233,570,-337,-2928
1539,12,2022/4/15 9:30,219,438,-219,-1929
1540,12,2022/4/15 9:40,188,381,-193,-1800
1541,12,2022/4/15 9:50,175,281,-106,-1586
1542,12,2022/4/15 10:00,145,208,-63,-1249
1543,12,2022/4/15 10:10,149,192,-43,-1112
1544,12,2022/4/15 10:20,134,185,-51,-1014
1545,12,2022/4/15 10:30,141,193,-52,-998
1546,12,2022/4/15 10:40,146,155,-9,-856
1547,12,2022/4/15 10:50,134,152,-18,-815
1548,12,2022/4/15 11:00,128,128,0,-724
1549,12,2022/4/15 11:10,139,133,6,-662
1550,12,2022/4/15 11:20,130,112,18,-599
1551,12,2022/4/15 11:30,149,128,21,-622
1552,12,2022/4/15 11:40,128,112,16,-475
1553,12,2022/4/15 11:50,135,128,7,-447
1554,12,2022/4/15 12:00,141,109,32,-344
1555,12,2022/4/15 12:10,150,128,22,-335
1556,12,2022/4/15 12:20,167,117,50,-263
1557,12,2022/4/15 12:30,179,152,27,-360
1558,12,2022/4/15 12:40,174,152,22,-428
1559,12,2022/4/15 12:50,178,152,26,-393
1560,12,2022/4/15 13:00,176,181,-5,-416
1561,12,2022/4/15 13:10,184,170,14,-394
1562,12,2022/4/15 13:20,196,150,46,-364
1563,12,2022/4/15 13:30,181,181,0,-382
1564,12,2022/4/15 13:40,173,154,19,-406
1565,12,2022/4/15 13:50,195,151,44,-305
1566,12,2022/4/15 14:00,169,151,18,-339
1567,12,2022/4/15 14:10,188,139,49,-230
1568,12,2022/4/15 14:20,181,128,53,-238
1569,12,2022/4/15 14:30,170,154,16,-169
1570,12,2022/4/15 14:40,166,146,20,-169
1571,12,2022/4/15 14:50,173,151,22,-164
1572,12,2022/4/15 15:00,183,181,2,-48
1573,12,2022/4/15 15:10,202,152,50,134
1574,12,2022/4/15 15:20,203,150,53,103
1575,12,2022/4/15 15:30,227,154,73,47
1576,12,2022/4/15 15:40,214,169,45,15
1577,12,2022/4/15 15:50,230,169,61,72
1578,12,2022/4/15 16:00,234,181,53,165
1579,12,2022/4/15 16:10,244,184,60,178
1580,12,2022/4/15 16:20,226,192,34,163
1581,12,2022/4/15 16:30,258,192,66,654
1582,12,2022/4/15 16:40,264,179,85,882
1583,12,2022/4/15 16:50,270,198,72,807
1584,12,2022/4/15 17:00,354,204,150,2946
1585,12,2022/4/15 17:10,577,280,297,3572
1586,12,2022/4/15 17:20,553,376,177,2558
1587,12,2022/4/15 17:30,610,372,238,3379
1588,12,2022/4/15 17:40,711,318,393,5478
1589,12,2022/4/15 17:50,697,435,262,2940
1590,12,2022/4/15 18:00,705,423,282,2505
1591,12,2022/4/15 18:10,1217,419,798,4875
1592,12,2022/4/15 18:20,839,435,404,2192
1593,12,2022/4/15 18:30,678,419,259,754
1594,12,2022/4/15 18:40,657,530,127,178
1595,12,2022/4/15 18:50,571,329,242,72
1596,12,2022/4/15 19:00,351,258,93,-145
1597,12,2022/4/15 19:10,332,199,133,3
1598,12,2022/4/15 19:20,267,193,74,-159
1599,12,2022/4/15 19:30,238,126,112,-214
1600,12,2022/4/15 19:40,234,111,123,-217
1601,12,2022/4/15 19:50,210,125,85,-235
1602,12,2022/4/15 20:00,234,118,116,113
1603,12,2022/4/15 20:10,244,107,137,118
1604,12,2022/4/15 20:20,206,124,82,-96
1605,12,2022/4/15 20:30,223,107,116,-230
1606,12,2022/4/15 20:40,210,123,87,-127
1607,12,2022/4/15 20:50,210,103,107,-124
1608,12,2022/4/15 21:00,226,99,127,21
1609,12,2022/4/15 21:10,262,116,146,-85
1610,12,2022/4/15 21:20,210,78,132,-335
1611,12,2022/4/15 21:30,242,115,127,-206
1612,12,2022/4/15 21:40,201,100,101,-269
1613,12,2022/4/15 21:50,171,103,68,-378
1614,12,2022/4/15 22:00,263,99,164,-280
1615,12,2022/4/15 22:10,225,83,142,-466
1616,12,2022/4/15 22:20,55,78,-23,-888
1617,12,2022/4/15 22:30,20,65,-45,-864
1618,12,2022/4/15 22:40,0,3,-3,-571
1619,12,2022/4/15 22:50,0,3,-3,-287
1620,14,2022/4/15 5:00,0,1,-1,-15
1621,14,2022/4/15 5:10,0,1,-1,7
1622,14,2022/4/15 5:20,0,1,-1,51
1623,14,2022/4/15 5:30,1,1,0,91
1624,14,2022/4/15 5:40,2,1,1,161
1625,14,2022/4/15 5:50,6,5,1,125
1626,14,2022/4/15 6:00,8,11,-3,86
1627,14,2022/4/15 6:10,14,23,-9,-2
1628,14,2022/4/15 6:20,14,29,-15,-38
1629,14,2022/4/15 6:30,21,38,-17,-114
1630,14,2022/4/15 6:40,19,40,-21,-100
1631,14,2022/4/15 6:50,24,66,-42,-74
1632,14,2022/4/15 7:00,30,66,-36,76
1633,14,2022/4/15 7:10,31,90,-59,272
1634,14,2022/4/15 7:20,33,104,-71,556
1635,14,2022/4/15 7:30,40,107,-67,722
1636,14,2022/4/15 7:40,46,104,-58,1110
1637,14,2022/4/15 7:50,56,122,-66,1480
1638,14,2022/4/15 8:00,64,117,-53,472
1639,14,2022/4/15 8:10,67,226,-159,-1239
1640,14,2022/4/15 8:20,69,233,-164,-4474
1641,14,2022/4/15 8:30,56,180,-124,-6395
1642,14,2022/4/15 8:40,56,320,-264,-9971
1643,14,2022/4/15 8:50,43,186,-143,-7971
1644,14,2022/4/15 9:00,41,139,-98,-3730
1645,14,2022/4/15 9:10,39,119,-80,-3755
1646,14,2022/4/15 9:20,31,116,-85,-3013
1647,14,2022/4/15 9:30,31,102,-71,-2000
1648,14,2022/4/15 9:40,32,101,-69,-1869
1649,14,2022/4/15 9:50,29,104,-75,-1661
1650,14,2022/4/15 10:00,29,100,-71,-1320
1651,14,2022/4/15 10:10,28,93,-65,-1177
1652,14,2022/4/15 10:20,28,97,-69,-1083
1653,14,2022/4/15 10:30,28,93,-65,-1063
1654,14,2022/4/15 10:40,26,75,-49,-905
1655,14,2022/4/15 10:50,27,77,-50,-865
1656,14,2022/4/15 11:00,26,81,-55,-779
1657,14,2022/4/15 11:10,32,73,-41,-703
1658,14,2022/4/15 11:20,31,62,-31,-630
1659,14,2022/4/15 11:30,37,74,-37,-659
1660,14,2022/4/15 11:40,27,64,-37,-512
1661,14,2022/4/15 11:50,33,62,-29,-476
1662,14,2022/4/15 12:00,27,68,-41,-385
1663,14,2022/4/15 12:10,27,80,-53,-388
1664,14,2022/4/15 12:20,32,77,-45,-308
1665,14,2022/4/15 12:30,33,83,-50,-410
1666,14,2022/4/15 12:40,30,97,-67,-495
1667,14,2022/4/15 12:50,26,91,-65,-458
1668,14,2022/4/15 13:00,31,86,-55,-471
1669,14,2022/4/15 13:10,30,90,-60,-454
1670,14,2022/4/15 13:20,32,93,-61,-425
1671,14,2022/4/15 13:30,31,90,-59,-441
1672,14,2022/4/15 13:40,31,92,-61,-467
1673,14,2022/4/15 13:50,36,77,-41,-346
1674,14,2022/4/15 14:00,31,84,-53,-392
1675,14,2022/4/15 14:10,31,69,-38,-268
1676,14,2022/4/15 14:20,31,83,-52,-290
1677,14,2022/4/15 14:30,39,80,-41,-210
1678,14,2022/4/15 14:40,35,68,-33,-202
1679,14,2022/4/15 14:50,36,81,-45,-209
1680,14,2022/4/15 15:00,34,82,-48,-96
1681,14,2022/4/15 15:10,40,68,-28,106
1682,14,2022/4/15 15:20,41,74,-33,70
1683,14,2022/4/15 15:30,42,84,-42,5
1684,14,2022/4/15 15:40,40,76,-36,-21
1685,14,2022/4/15 15:50,47,84,-37,35
1686,14,2022/4/15 16:00,65,69,-4,161
1687,14,2022/4/15 16:10,53,79,-26,152
1688,14,2022/4/15 16:20,52,70,-18,145
1689,14,2022/4/15 16:30,104,60,44,698
1690,14,2022/4/15 16:40,97,68,29,911
1691,14,2022/4/15 16:50,162,83,79,886
1692,14,2022/4/15 17:00,271,73,198,3144
1693,14,2022/4/15 17:10,225,74,151,3723
1694,14,2022/4/15 17:20,194,94,100,2658
1695,14,2022/4/15 17:30,175,103,72,3451
1696,14,2022/4/15 17:40,170,108,62,5540
1697,14,2022/4/15 17:50,98,105,-7,2933
1698,14,2022/4/15 18:00,130,103,27,2532
1699,14,2022/4/15 18:10,179,109,70,4945
1700,14,2022/4/15 18:20,132,110,22,2214
1701,14,2022/4/15 18:30,77,106,-29,725
1702,14,2022/4/15 18:40,64,101,-37,141
1703,14,2022/4/15 18:50,50,106,-56,16
1704,14,2022/4/15 19:00,45,93,-48,-193
1705,14,2022/4/15 19:10,46,82,-36,-33
1706,14,2022/4/15 19:20,36,79,-43,-202
1707,14,2022/4/15 19:30,31,62,-31,-245
1708,14,2022/4/15 19:40,31,70,-39,-256
1709,14,2022/4/15 19:50,34,67,-33,-268
1710,14,2022/4/15 20:00,32,51,-19,94
1711,14,2022/4/15 20:10,28,63,-35,83
1712,14,2022/4/15 20:20,43,52,-9,-105
1713,14,2022/4/15 20:30,30,60,-30,-260
1714,14,2022/4/15 20:40,22,46,-24,-151
1715,14,2022/4/15 20:50,23,47,-24,-148
1716,14,2022/4/15 21:00,25,58,-33,-12
1717,14,2022/4/15 21:10,27,41,-14,-99
1718,14,2022/4/15 21:20,28,67,-39,-374
1719,14,2022/4/15 21:30,24,46,-22,-228
1720,14,2022/4/15 21:40,23,46,-23,-292
1721,14,2022/4/15 21:50,29,51,-22,-400
1722,14,2022/4/15 22:00,21,38,-17,-297
1723,14,2022/4/15 22:10,23,48,-25,-491
1724,14,2022/4/15 22:20,11,34,-23,-911
1725,14,2022/4/15 22:30,1,31,-30,-894
1726,14,2022/4/15 22:40,0,10,-10,-581
1727,14,2022/4/15 22:50,0,3,-3,-290
1728,7,2022/4/15 5:00,0,1,-1,-16
1729,7,2022/4/15 5:10,0,1,-1,6
1730,7,2022/4/15 5:20,0,1,-1,50
1731,7,2022/4/15 5:30,3,1,2,93
1732,7,2022/4/15 5:40,8,5,3,164
1733,7,2022/4/15 5:50,18,1,17,142
1734,7,2022/4/15 6:00,22,29,-7,79
1735,7,2022/4/15 6:10,30,30,0,-2
1736,7,2022/4/15 6:20,34,54,-20,-58
1737,7,2022/4/15 6:30,44,71,-27,-141
1738,7,2022/4/15 6:40,57,106,-49,-149
1739,7,2022/4/15 6:50,75,123,-48,-122
1740,7,2022/4/15 7:00,89,224,-135,-59
1741,7,2022/4/15 7:10,150,318,-168,104
1742,7,2022/4/15 7:20,163,190,-27,529
1743,7,2022/4/15 7:30,227,232,-5,717
1744,7,2022/4/15 7:40,269,254,15,1125
1745,7,2022/4/15 7:50,301,255,46,1526
1746,7,2022/4/15 8:00,359,384,-25,447
1747,7,2022/4/15 8:10,366,429,-63,-1302
1748,7,2022/4/15 8:20,392,432,-40,-4514
1749,7,2022/4/15 8:30,338,575,-237,-6632
1750,7,2022/4/15 8:40,318,1133,-815,-10786
1751,7,2022/4/15 8:50,274,1138,-864,-8835
1752,7,2022/4/15 9:00,233,429,-196,-3926
1753,7,2022/4/15 9:10,221,531,-310,-4065
1754,7,2022/4/15 9:20,179,502,-323,-3336
1755,7,2022/4/15 9:30,149,332,-183,-2183
1756,7,2022/4/15 9:40,120,254,-134,-2003
1757,7,2022/4/15 9:50,76,190,-114,-1775
1758,7,2022/4/15 10:00,64,192,-128,-1448
1759,7,2022/4/15 10:10,65,108,-43,-1220
1760,7,2022/4/15 10:20,61,124,-63,-1146
1761,7,2022/4/15 10:30,56,122,-66,-1129
1762,7,2022/4/15 10:40,49,102,-53,-958
1763,7,2022/4/15 10:50,55,107,-52,-917
1764,7,2022/4/15 11:00,49,106,-57,-836
1765,7,2022/4/15 11:10,52,103,-51,-754
1766,7,2022/4/15 11:20,57,106,-49,-679
1767,7,2022/4/15 11:30,57,112,-55,-714
1768,7,2022/4/15 11:40,76,110,-34,-546
1769,7,2022/4/15 11:50,80,109,-29,-505
1770,7,2022/4/15 12:00,75,105,-30,-415
1771,7,2022/4/15 12:10,75,105,-30,-418
1772,7,2022/4/15 12:20,71,106,-35,-343
1773,7,2022/4/15 12:30,76,108,-32,-442
1774,7,2022/4/15 12:40,71,97,-26,-521
1775,7,2022/4/15 12:50,65,105,-40,-498
1776,7,2022/4/15 13:00,65,127,-62,-533
1777,7,2022/4/15 13:10,68,102,-34,-488
1778,7,2022/4/15 13:20,66,125,-59,-484
1779,7,2022/4/15 13:30,63,116,-53,-494
1780,7,2022/4/15 13:40,70,127,-57,-524
1781,7,2022/4/15 13:50,62,121,-59,-405
1782,7,2022/4/15 14:00,71,107,-36,-428
1783,7,2022/4/15 14:10,62,103,-41,-309
1784,7,2022/4/15 14:20,71,122,-51,-341
1785,7,2022/4/15 14:30,70,100,-30,-240
1786,7,2022/4/15 14:40,82,105,-23,-225
1787,7,2022/4/15 14:50,77,111,-34,-243
1788,7,2022/4/15 15:00,83,103,-20,-116
1789,7,2022/4/15 15:10,85,103,-18,88
1790,7,2022/4/15 15:20,82,108,-26,44
1791,7,2022/4/15 15:30,119,100,19,24
1792,7,2022/4/15 15:40,109,119,-10,-31
1793,7,2022/4/15 15:50,137,125,12,47
1794,7,2022/4/15 16:00,158,107,51,212
1795,7,2022/4/15 16:10,189,118,71,223
1796,7,2022/4/15 16:20,202,106,96,241
1797,7,2022/4/15 16:30,264,120,144,842
1798,7,2022/4/15 16:40,273,105,168,1079
1799,7,2022/4/15 16:50,265,110,155,1041
1800,7,2022/4/15 17:00,576,111,465,3609
1801,7,2022/4/15 17:10,672,108,564,4287
1802,7,2022/4/15 17:20,637,158,479,3137
1803,7,2022/4/15 17:30,653,196,457,3908
1804,7,2022/4/15 17:40,846,197,649,6189
1805,7,2022/4/15 17:50,698,207,491,3424
1806,7,2022/4/15 18:00,697,301,396,2928
1807,7,2022/4/15 18:10,717,270,447,5392
1808,7,2022/4/15 18:20,639,298,341,2555
1809,7,2022/4/15 18:30,429,284,145,870
1810,7,2022/4/15 18:40,343,218,125,266
1811,7,2022/4/15 18:50,268,179,89,105
1812,7,2022/4/15 19:00,237,186,51,-142
1813,7,2022/4/15 19:10,230,132,98,65
1814,7,2022/4/15 19:20,198,116,82,-120
1815,7,2022/4/15 19:30,143,117,26,-219
1816,7,2022/4/15 19:40,101,122,-21,-277
1817,7,2022/4/15 19:50,79,126,-47,-315
1818,7,2022/4/15 20:00,83,111,-28,66
1819,7,2022/4/15 20:10,77,112,-35,48
1820,7,2022/4/15 20:20,70,107,-37,-142
1821,7,2022/4/15 20:30,64,108,-44,-304
1822,7,2022/4/15 20:40,67,114,-47,-198
1823,7,2022/4/15 20:50,57,111,-54,-202
1824,7,2022/4/15 21:00,60,107,-47,-59
1825,7,2022/4/15 21:10,73,104,-31,-130
1826,7,2022/4/15 21:20,66,104,-38,-412
1827,7,2022/4/15 21:30,59,115,-56,-284
1828,7,2022/4/15 21:40,73,107,-34,-326
1829,7,2022/4/15 21:50,47,98,-51,-451
1830,7,2022/4/15 22:00,45,110,-65,-362
1831,7,2022/4/15 22:10,44,80,-36,-527
1832,7,2022/4/15 22:20,22,104,-82,-993
1833,7,2022/4/15 22:30,12,86,-74,-968
1834,7,2022/4/15 22:40,4,41,-37,-618
1835,7,2022/4/15 22:50,2,21,-19,-309
1836,5,2022/4/15 5:00,0,1,-1,-17
1837,5,2022/4/15 5:10,0,1,-1,5
1838,5,2022/4/15 5:20,2,1,1,51
1839,5,2022/4/15 5:30,5,1,4,97
1840,5,2022/4/15 5:40,7,2,5,169
1841,5,2022/4/15 5:50,12,1,11,153
1842,5,2022/4/15 6:00,20,13,7,86
1843,5,2022/4/15 6:10,19,22,-3,-5
1844,5,2022/4/15 6:20,28,40,-12,-70
1845,5,2022/4/15 6:30,32,63,-31,-172
1846,5,2022/4/15 6:40,36,73,-37,-186
1847,5,2022/4/15 6:50,45,76,-31,-153
1848,5,2022/4/15 7:00,54,123,-69,-128
1849,5,2022/4/15 7:10,57,123,-66,38
1850,5,2022/4/15 7:20,59,106,-47,482
1851,5,2022/4/15 7:30,83,112,-29,688
1852,5,2022/4/15 7:40,147,171,-24,1101
1853,5,2022/4/15 7:50,162,181,-19,1507
1854,5,2022/4/15 8:00,194,281,-87,360
1855,5,2022/4/15 8:10,232,322,-90,-1392
1856,5,2022/4/15 8:20,232,325,-93,-4607
1857,5,2022/4/15 8:30,221,387,-166,-6798
1858,5,2022/4/15 8:40,184,438,-254,-11040
1859,5,2022/4/15 8:50,148,504,-356,-9191
1860,5,2022/4/15 9:00,94,335,-241,-4167
1861,5,2022/4/15 9:10,76,283,-207,-4272
1862,5,2022/4/15 9:20,66,233,-167,-3503
1863,5,2022/4/15 9:30,55,192,-137,-2320
1864,5,2022/4/15 9:40,45,139,-94,-2097
1865,5,2022/4/15 9:50,49,133,-84,-1859
1866,5,2022/4/15 10:00,43,117,-74,-1522
1867,5,2022/4/15 10:10,46,105,-59,-1279
1868,5,2022/4/15 10:20,39,103,-64,-1210
1869,5,2022/4/15 10:30,47,110,-63,-1192
1870,5,2022/4/15 10:40,38,93,-55,-1013
1871,5,2022/4/15 10:50,38,99,-61,-978
1872,5,2022/4/15 11:00,36,93,-57,-893
1873,5,2022/4/15 11:10,43,79,-36,-790
1874,5,2022/4/15 11:20,41,77,-36,-715
1875,5,2022/4/15 11:30,42,75,-33,-747
1876,5,2022/4/15 11:40,42,76,-34,-580
1877,5,2022/4/15 11:50,37,76,-39,-544
1878,5,2022/4/15 12:00,46,92,-46,-461
1879,5,2022/4/15 12:10,42,88,-46,-464
1880,5,2022/4/15 12:20,43,82,-39,-382
1881,5,2022/4/15 12:30,44,92,-48,-490
1882,5,2022/4/15 12:40,41,93,-52,-573
1883,5,2022/4/15 12:50,41,109,-68,-566
1884,5,2022/4/15 13:00,41,93,-52,-585
1885,5,2022/4/15 13:10,44,108,-64,-552
1886,5,2022/4/15 13:20,37,99,-62,-546
1887,5,2022/4/15 13:30,40,93,-53,-547
1888,5,2022/4/15 13:40,44,111,-67,-591
1889,5,2022/4/15 13:50,45,91,-46,-451
1890,5,2022/4/15 14:00,45,91,-46,-474
1891,5,2022/4/15 14:10,45,90,-45,-354
1892,5,2022/4/15 14:20,48,90,-42,-383
1893,5,2022/4/15 14:30,49,92,-43,-283
1894,5,2022/4/15 14:40,46,92,-46,-271
1895,5,2022/4/15 14:50,50,80,-30,-273
1896,5,2022/4/15 15:00,55,90,-35,-151
1897,5,2022/4/15 15:10,69,92,-23,65
1898,5,2022/4/15 15:20,48,91,-43,1
1899,5,2022/4/15 15:30,56,87,-31,-7
1900,5,2022/4/15 15:40,47,93,-46,-77
1901,5,2022/4/15 15:50,48,77,-29,18
1902,5,2022/4/15 16:00,61,104,-43,169
1903,5,2022/4/15 16:10,76,92,-16,207
1904,5,2022/4/15 16:20,64,93,-29,212
1905,5,2022/4/15 16:30,71,93,-22,820
1906,5,2022/4/15 16:40,93,93,0,1079
1907,5,2022/4/15 16:50,131,110,21,1062
1908,5,2022/4/15 17:00,202,111,91,3700
1909,5,2022/4/15 17:10,244,105,139,4426
1910,5,2022/4/15 17:20,199,124,75,3212
1911,5,2022/4/15 17:30,265,102,163,4071
1912,5,2022/4/15 17:40,421,105,316,6505
1913,5,2022/4/15 17:50,268,110,158,3582
1914,5,2022/4/15 18:00,271,133,138,3066
1915,5,2022/4/15 18:10,580,133,447,5839
1916,5,2022/4/15 18:20,290,119,171,2726
1917,5,2022/4/15 18:30,223,107,116,986
1918,5,2022/4/15 18:40,207,110,97,363
1919,5,2022/4/15 18:50,137,126,11,116
1920,5,2022/4/15 19:00,83,126,-43,-185
1921,5,2022/4/15 19:10,85,110,-25,40
1922,5,2022/4/15 19:20,66,115,-49,-169
1923,5,2022/4/15 19:30,43,100,-57,-276
1924,5,2022/4/15 19:40,39,83,-44,-321
1925,5,2022/4/15 19:50,37,86,-49,-364
1926,5,2022/4/15 20:00,47,85,-38,28
1927,5,2022/4/15 20:10,47,74,-27,21
1928,5,2022/4/15 20:20,39,75,-36,-178
1929,5,2022/4/15 20:30,39,80,-41,-345
1930,5,2022/4/15 20:40,37,88,-51,-249
1931,5,2022/4/15 20:50,29,71,-42,-244
1932,5,2022/4/15 21:00,40,63,-23,-82
1933,5,2022/4/15 21:10,37,75,-38,-168
1934,5,2022/4/15 21:20,33,62,-29,-441
1935,5,2022/4/15 21:30,32,75,-43,-327
1936,5,2022/4/15 21:40,27,63,-36,-362
1937,5,2022/4/15 21:50,24,70,-46,-497
1938,5,2022/4/15 22:00,26,74,-48,-410
1939,5,2022/4/15 22:10,25,52,-27,-554
1940,5,2022/4/15 22:20,13,65,-52,-1045
1941,5,2022/4/15 22:30,6,48,-42,-1010
1942,5,2022/4/15 22:40,2,33,-31,-649
1943,5,2022/4/15 22:50,0,3,-3,-312
1944,17,2022/4/15 5:00,0,1,-1,-18
1945,17,2022/4/15 5:10,0,1,-1,4
1946,17,2022/4/15 5:20,1,1,0,51
1947,17,2022/4/15 5:30,6,1,5,102
1948,17,2022/4/15 5:40,6,2,4,173
1949,17,2022/4/15 5:50,15,1,14,167
1950,17,2022/4/15 6:00,20,5,15,101
1951,17,2022/4/15 6:10,29,19,10,5
1952,17,2022/4/15 6:20,33,29,4,-66
1953,17,2022/4/15 6:30,43,30,13,-159
1954,17,2022/4/15 6:40,48,42,6,-180
1955,17,2022/4/15 6:50,60,68,-8,-161
1956,17,2022/4/15 7:00,94,83,11,-117
1957,17,2022/4/15 7:10,108,72,36,74
1958,17,2022/4/15 7:20,108,96,12,494
1959,17,2022/4/15 7:30,224,127,97,785
1960,17,2022/4/15 7:40,246,109,137,1238
1961,17,2022/4/15 7:50,275,139,136,1643
1962,17,2022/4/15 8:00,302,206,96,456
1963,17,2022/4/15 8:10,280,296,-16,-1408
1964,17,2022/4/15 8:20,279,344,-65,-4672
1965,17,2022/4/15 8:30,266,380,-114,-6912
1966,17,2022/4/15 8:40,217,495,-278,-11318
1967,17,2022/4/15 8:50,168,246,-78,-9269
1968,17,2022/4/15 9:00,115,192,-77,-4244
1969,17,2022/4/15 9:10,74,128,-54,-4326
1970,17,2022/4/15 9:20,61,121,-60,-3563
1971,17,2022/4/15 9:30,52,102,-50,-2370
1972,17,2022/4/15 9:40,46,115,-69,-2166
1973,17,2022/4/15 9:50,39,93,-54,-1913
1974,17,2022/4/15 10:00,38,77,-39,-1561
1975,17,2022/4/15 10:10,40,73,-33,-1312
1976,17,2022/4/15 10:20,38,73,-35,-1245
1977,17,2022/4/15 10:30,35,62,-27,-1219
1978,17,2022/4/15 10:40,31,71,-40,-1053
1979,17,2022/4/15 10:50,29,66,-37,-1015
1980,17,2022/4/15 11:00,37,62,-25,-918
1981,17,2022/4/15 11:10,35,65,-30,-820
1982,17,2022/4/15 11:20,29,68,-39,-754
1983,17,2022/4/15 11:30,32,61,-29,-776
1984,17,2022/4/15 11:40,28,65,-37,-617
1985,17,2022/4/15 11:50,27,71,-44,-588
1986,17,2022/4/15 12:00,29,66,-37,-498
1987,17,2022/4/15 12:10,31,74,-43,-507
1988,17,2022/4/15 12:20,34,75,-41,-423
1989,17,2022/4/15 12:30,28,73,-45,-535
1990,17,2022/4/15 12:40,33,69,-36,-609
1991,17,2022/4/15 12:50,34,82,-48,-614
1992,17,2022/4/15 13:00,29,71,-42,-627
1993,17,2022/4/15 13:10,31,83,-52,-604
1994,17,2022/4/15 13:20,32,78,-46,-592
1995,17,2022/4/15 13:30,29,84,-55,-602
1996,17,2022/4/15 13:40,28,85,-57,-648
1997,17,2022/4/15 13:50,32,76,-44,-495
1998,17,2022/4/15 14:00,32,77,-45,-519
1999,17,2022/4/15 14:10,26,67,-41,-395
2000,17,2022/4/15 14:20,36,71,-35,-418
2001,17,2022/4/15 14:30,27,77,-50,-333
2002,17,2022/4/15 14:40,34,87,-53,-324
2003,17,2022/4/15 14:50,36,78,-42,-315
2004,17,2022/4/15 15:00,35,72,-37,-188
2005,17,2022/4/15 15:10,44,77,-33,32
2006,17,2022/4/15 15:20,41,77,-36,-35
2007,17,2022/4/15 15:30,35,73,-38,-45
2008,17,2022/4/15 15:40,41,80,-39,-116
2009,17,2022/4/15 15:50,30,93,-63,-45
2010,17,2022/4/15 16:00,50,78,-28,141
2011,17,2022/4/15 16:10,66,90,-24,183
2012,17,2022/4/15 16:20,44,93,-49,163
2013,17,2022/4/15 16:30,69,98,-29,791
2014,17,2022/4/15 16:40,70,104,-34,1045
2015,17,2022/4/15 16:50,75,108,-33,1029
2016,17,2022/4/15 17:00,197,104,93,3793
2017,17,2022/4/15 17:10,262,112,150,4576
2018,17,2022/4/15 17:20,238,126,112,3324
2019,17,2022/4/15 17:30,222,123,99,4170
2020,17,2022/4/15 17:40,326,124,202,6707
2021,17,2022/4/15 17:50,278,108,170,3752
2022,17,2022/4/15 18:00,217,109,108,3174
2023,17,2022/4/15 18:10,340,117,223,6062
2024,17,2022/4/15 18:20,256,144,112,2838
2025,17,2022/4/15 18:30,171,111,60,1046
2026,17,2022/4/15 18:40,93,109,-16,347
2027,17,2022/4/15 18:50,64,112,-48,68
2028,17,2022/4/15 19:00,47,121,-74,-259
2029,17,2022/4/15 19:10,46,122,-76,-36
2030,17,2022/4/15 19:20,35,104,-69,-238
2031,17,2022/4/15 19:30,38,101,-63,-339
2032,17,2022/4/15 19:40,35,81,-46,-367
2033,17,2022/4/15 19:50,28,92,-64,-428
2034,17,2022/4/15 20:00,29,78,-49,-21
2035,17,2022/4/15 20:10,31,76,-45,-24
2036,17,2022/4/15 20:20,29,64,-35,-213
2037,17,2022/4/15 20:30,29,94,-65,-410
2038,17,2022/4/15 20:40,26,72,-46,-295
2039,17,2022/4/15 20:50,28,79,-51,-295
2040,17,2022/4/15 21:00,26,81,-55,-137
2041,17,2022/4/15 21:10,26,62,-36,-204
2042,17,2022/4/15 21:20,25,91,-66,-507
2043,17,2022/4/15 21:30,21,74,-53,-380
2044,17,2022/4/15 21:40,24,92,-68,-430
2045,17,2022/4/15 21:50,20,83,-63,-560
2046,17,2022/4/15 22:00,18,62,-44,-454
2047,17,2022/4/15 22:10,12,77,-65,-619
2048,17,2022/4/15 22:20,2,55,-53,-1098
2049,17,2022/4/15 22:30,2,64,-62,-1072
2050,17,2022/4/15 22:40,1,40,-39,-688
2051,17,2022/4/15 22:50,0,3,-3,-315
2052,23,2022/4/15 5:00,0,1,-1,-19
2053,23,2022/4/15 5:10,0,1,-1,3
2054,23,2022/4/15 5:20,0,1,-1,50
2055,23,2022/4/15 5:30,3,1,2,104
2056,23,2022/4/15 5:40,2,1,1,174
2057,23,2022/4/15 5:50,5,1,4,171
2058,23,2022/4/15 6:00,5,8,-3,98
2059,23,2022/4/15 6:10,12,21,-9,-4
2060,23,2022/4/15 6:20,11,19,-8,-74
2061,23,2022/4/15 6:30,19,38,-19,-178
2062,23,2022/4/15 6:40,22,66,-44,-224
2063,23,2022/4/15 6:50,22,65,-43,-204
2064,23,2022/4/15 7:00,26,53,-27,-144
2065,23,2022/4/15 7:10,31,75,-44,30
2066,23,2022/4/15 7:20,35,104,-69,425
2067,23,2022/4/15 7:30,43,125,-82,703
2068,23,2022/4/15 7:40,59,226,-167,1071
2069,23,2022/4/15 7:50,57,330,-273,1370
2070,23,2022/4/15 8:00,70,642,-572,-116
2071,23,2022/4/15 8:10,85,1583,-1498,-2906
2072,23,2022/4/15 8:20,67,2019,-1952,-6624
2073,23,2022/4/15 8:30,64,3158,-3094,-10006
2074,23,2022/4/15 8:40,68,2825,-2757,-14075
2075,23,2022/4/15 8:50,53,2967,-2914,-12183
2076,23,2022/4/15 9:00,39,493,-454,-4698
2077,23,2022/4/15 9:10,36,582,-546,-4872
2078,23,2022/4/15 9:20,39,532,-493,-4056
2079,23,2022/4/15 9:30,33,267,-234,-2604
2080,23,2022/4/15 9:40,29,178,-149,-2315
2081,23,2022/4/15 9:50,29,115,-86,-1999
2082,23,2022/4/15 10:00,33,120,-87,-1648
2083,23,2022/4/15 10:10,29,114,-85,-1397
2084,23,2022/4/15 10:20,34,106,-72,-1317
2085,23,2022/4/15 10:30,35,105,-70,-1289
2086,23,2022/4/15 10:40,28,114,-86,-1139
2087,23,2022/4/15 10:50,37,96,-59,-1074
2088,23,2022/4/15 11:00,37,93,-56,-974
2089,23,2022/4/15 11:10,39,90,-51,-871
2090,23,2022/4/15 11:20,39,93,-54,-808
2091,23,2022/4/15 11:30,37,98,-61,-837
2092,23,2022/4/15 11:40,43,98,-55,-672
2093,23,2022/4/15 11:50,43,90,-47,-635
2094,23,2022/4/15 12:00,38,81,-43,-541
2095,23,2022/4/15 12:10,45,81,-36,-543
2096,23,2022/4/15 12:20,42,92,-50,-473
2097,23,2022/4/15 12:30,40,92,-52,-587
2098,23,2022/4/15 12:40,37,101,-64,-673
2099,23,2022/4/15 12:50,41,90,-49,-663
2100,23,2022/4/15 13:00,40,93,-53,-680
2101,23,2022/4/15 13:10,45,99,-54,-658
2102,23,2022/4/15 13:20,42,104,-62,-654
2103,23,2022/4/15 13:30,39,101,-62,-664
2104,23,2022/4/15 13:40,42,97,-55,-703
2105,23,2022/4/15 13:50,46,110,-64,-559
2106,23,2022/4/15 14:00,44,93,-49,-568
2107,23,2022/4/15 14:10,44,93,-49,-444
2108,23,2022/4/15 14:20,43,93,-50,-468
2109,23,2022/4/15 14:30,44,90,-46,-379
2110,23,2022/4/15 14:40,44,96,-52,-376
2111,23,2022/4/15 14:50,44,90,-46,-361
2112,23,2022/4/15 15:00,45,87,-42,-230
2113,23,2022/4/15 15:10,44,87,-43,-11
2114,23,2022/4/15 15:20,46,80,-34,-69
2115,23,2022/4/15 15:30,51,90,-39,-84
2116,23,2022/4/15 15:40,52,93,-41,-157
2117,23,2022/4/15 15:50,64,93,-29,-74
2118,23,2022/4/15 16:00,66,92,-26,115
2119,23,2022/4/15 16:10,80,82,-2,181
2120,23,2022/4/15 16:20,67,90,-23,140
2121,23,2022/4/15 16:30,137,90,47,838
2122,23,2022/4/15 16:40,174,99,75,1120
2123,23,2022/4/15 16:50,156,88,68,1097
2124,23,2022/4/15 17:00,277,90,187,3980
2125,23,2022/4/15 17:10,576,96,480,5056
2126,23,2022/4/15 17:20,369,105,264,3588
2127,23,2022/4/15 17:30,675,105,570,4740
2128,23,2022/4/15 17:40,1977,103,1874,8581
2129,23,2022/4/15 17:50,1368,112,1256,5008
2130,23,2022/4/15 18:00,1167,109,1058,4232
2131,23,2022/4/15 18:10,1983,113,1870,7932
2132,23,2022/4/15 18:20,1208,107,1101,3939
2133,23,2022/4/15 18:30,636,110,526,1572
2134,23,2022/4/15 18:40,336,110,226,573
2135,23,2022/4/15 18:50,279,108,171,239
2136,23,2022/4/15 19:00,226,95,131,-128
2137,23,2022/4/15 19:10,187,99,88,52
2138,23,2022/4/15 19:20,129,77,52,-186
2139,23,2022/4/15 19:30,77,69,8,-331
2140,23,2022/4/15 19:40,73,62,11,-356
2141,23,2022/4/15 19:50,49,68,-19,-447
2142,23,2022/4/15 20:00,55,61,-6,-27
2143,23,2022/4/15 20:10,62,58,4,-20
2144,23,2022/4/15 20:20,45,51,-6,-219
2145,23,2022/4/15 20:30,47,52,-5,-415
2146,23,2022/4/15 20:40,43,50,-7,-302
2147,23,2022/4/15 20:50,41,54,-13,-308
2148,23,2022/4/15 21:00,50,48,2,-135
2149,23,2022/4/15 21:10,66,39,27,-177
2150,23,2022/4/15 21:20,64,53,11,-496
2151,23,2022/4/15 21:30,137,34,103,-277
2152,23,2022/4/15 21:40,149,52,97,-333
2153,23,2022/4/15 21:50,41,40,1,-559
2154,23,2022/4/15 22:00,29,39,-10,-464
2155,23,2022/4/15 22:10,21,40,-19,-638
2156,23,2022/4/15 22:20,6,36,-30,-1128
2157,23,2022/4/15 22:30,2,40,-38,-1110
2158,23,2022/4/15 22:40,1,25,-24,-712
2159,23,2022/4/15 22:50,0,3,-3,-318
2160,15,2022/4/15 5:00,0,1,-1,-20
2161,15,2022/4/15 5:10,0,1,-1,2
2162,15,2022/4/15 5:20,3,1,2,52
2163,15,2022/4/15 5:30,5,1,4,108
2164,15,2022/4/15 5:40,7,1,6,180
2165,15,2022/4/15 5:50,9,1,8,179
2166,15,2022/4/15 6:00,16,2,14,112
2167,15,2022/4/15 6:10,21,22,-1,-5
2168,15,2022/4/15 6:20,33,33,0,-74
2169,15,2022/4/15 6:30,34,49,-15,-193
2170,15,2022/4/15 6:40,44,58,-14,-238
2171,15,2022/4/15 6:50,54,50,4,-200
2172,15,2022/4/15 7:00,57,77,-20,-164
2173,15,2022/4/15 7:10,73,95,-22,8
2174,15,2022/4/15 7:20,85,105,-20,405
2175,15,2022/4/15 7:30,149,104,45,748
2176,15,2022/4/15 7:40,186,108,78,1149
2177,15,2022/4/15 7:50,232,120,112,1482
2178,15,2022/4/15 8:00,256,178,78,-38
2179,15,2022/4/15 8:10,283,212,71,-2835
2180,15,2022/4/15 8:20,254,221,33,-6591
2181,15,2022/4/15 8:30,234,283,-49,-10055
2182,15,2022/4/15 8:40,184,326,-142,-14217
2183,15,2022/4/15 8:50,112,197,-85,-12268
2184,15,2022/4/15 9:00,88,110,-22,-4720
2185,15,2022/4/15 9:10,60,121,-61,-4933
2186,15,2022/4/15 9:20,52,117,-65,-4121
2187,15,2022/4/15 9:30,44,120,-76,-2680
2188,15,2022/4/15 9:40,39,104,-65,-2380
2189,15,2022/4/15 9:50,38,105,-67,-2066
2190,15,2022/4/15 10:00,35,98,-63,-1711
2191,15,2022/4/15 10:10,38,65,-27,-1424
2192,15,2022/4/15 10:20,32,77,-45,-1362
2193,15,2022/4/15 10:30,35,74,-39,-1328
2194,15,2022/4/15 10:40,33,84,-51,-1190
2195,15,2022/4/15 10:50,32,76,-44,-1118
2196,15,2022/4/15 11:00,32,77,-45,-1019
2197,15,2022/4/15 11:10,31,62,-31,-902
2198,15,2022/4/15 11:20,31,69,-38,-846
2199,15,2022/4/15 11:30,35,85,-50,-887
2200,15,2022/4/15 11:40,33,73,-40,-712
2201,15,2022/4/15 11:50,33,79,-46,-681
2202,15,2022/4/15 12:00,34,71,-37,-578
2203,15,2022/4/15 12:10,38,76,-38,-581
2204,15,2022/4/15 12:20,38,74,-36,-509
2205,15,2022/4/15 12:30,36,74,-38,-625
2206,15,2022/4/15 12:40,38,93,-55,-728
2207,15,2022/4/15 12:50,37,92,-55,-718
2208,15,2022/4/15 13:00,35,76,-41,-721
2209,15,2022/4/15 13:10,36,77,-41,-699
2210,15,2022/4/15 13:20,33,77,-44,-698
2211,15,2022/4/15 13:30,33,82,-49,-713
2212,15,2022/4/15 13:40,37,91,-54,-757
2213,15,2022/4/15 13:50,35,87,-52,-611
2214,15,2022/4/15 14:00,34,78,-44,-612
2215,15,2022/4/15 14:10,40,81,-41,-485
2216,15,2022/4/15 14:20,37,83,-46,-514
2217,15,2022/4/15 14:30,29,78,-49,-428
2218,15,2022/4/15 14:40,31,76,-45,-421
2219,15,2022/4/15 14:50,31,91,-60,-421
2220,15,2022/4/15 15:00,40,79,-39,-269
2221,15,2022/4/15 15:10,35,93,-58,-69
2222,15,2022/4/15 15:20,42,83,-41,-110
2223,15,2022/4/15 15:30,47,90,-43,-127
2224,15,2022/4/15 15:40,45,90,-45,-202
2225,15,2022/4/15 15:50,46,90,-44,-118
2226,15,2022/4/15 16:00,47,87,-40,75
2227,15,2022/4/15 16:10,47,93,-46,135
2228,15,2022/4/15 16:20,54,105,-51,89
2229,15,2022/4/15 16:30,64,101,-37,801
2230,15,2022/4/15 16:40,77,103,-26,1094
2231,15,2022/4/15 16:50,70,103,-33,1064
2232,15,2022/4/15 17:00,137,112,25,4005
2233,15,2022/4/15 17:10,207,98,109,5165
2234,15,2022/4/15 17:20,150,111,39,3627
2235,15,2022/4/15 17:30,164,104,60,4800
2236,15,2022/4/15 17:40,228,178,50,8631
2237,15,2022/4/15 17:50,224,132,92,5100
2238,15,2022/4/15 18:00,230,116,114,4346
2239,15,2022/4/15 18:10,272,142,130,8062
2240,15,2022/4/15 18:20,215,111,104,4043
2241,15,2022/4/15 18:30,138,152,-14,1558
2242,15,2022/4/15 18:40,96,151,-55,518
2243,15,2022/4/15 18:50,70,109,-39,200
2244,15,2022/4/15 19:00,60,124,-64,-192
2245,15,2022/4/15 19:10,44,125,-81,-29
2246,15,2022/4/15 19:20,45,103,-58,-244
2247,15,2022/4/15 19:30,41,102,-61,-392
2248,15,2022/4/15 19:40,34,95,-61,-417
2249,15,2022/4/15 19:50,35,77,-42,-489
2250,15,2022/4/15 20:00,37,94,-57,-84
2251,15,2022/4/15 20:10,40,85,-45,-65
2252,15,2022/4/15 20:20,40,77,-37,-256
2253,15,2022/4/15 20:30,28,71,-43,-458
2254,15,2022/4/15 20:40,36,86,-50,-352
2255,15,2022/4/15 20:50,36,75,-39,-347
2256,15,2022/4/15 21:00,34,59,-25,-160
2257,15,2022/4/15 21:10,37,78,-41,-218
2258,15,2022/4/15 21:20,30,63,-33,-529
2259,15,2022/4/15 21:30,26,89,-63,-340
2260,15,2022/4/15 21:40,28,77,-49,-382
2261,15,2022/4/15 21:50,27,62,-35,-594
2262,15,2022/4/15 22:00,25,73,-48,-512
2263,15,2022/4/15 22:10,13,55,-42,-680
2264,15,2022/4/15 22:20,2,87,-85,-1213
2265,15,2022/4/15 22:30,2,53,-51,-1161
2266,15,2022/4/15 22:40,1,50,-49,-761
2267,15,2022/4/15 22:50,0,18,-18,-336
2268,9,2022/4/15 5:00,0,1,-1,-21
2269,9,2022/4/15 5:10,0,1,-1,1
2270,9,2022/4/15 5:20,2,1,1,53
2271,9,2022/4/15 5:30,5,1,4,112
2272,9,2022/4/15 5:40,8,1,7,187
2273,9,2022/4/15 5:50,12,1,11,190
2274,9,2022/4/15 6:00,20,2,18,130
2275,9,2022/4/15 6:10,26,11,15,10
2276,9,2022/4/15 6:20,32,16,16,-58
2277,9,2022/4/15 6:30,37,32,5,-188
2278,9,2022/4/15 6:40,49,41,8,-230
2279,9,2022/4/15 6:50,53,70,-17,-217
2280,9,2022/4/15 7:00,57,77,-20,-184
2281,9,2022/4/15 7:10,62,72,-10,-2
2282,9,2022/4/15 7:20,80,95,-15,390
2283,9,2022/4/15 7:30,150,100,50,798
2284,9,2022/4/15 7:40,152,105,47,1196
2285,9,2022/4/15 7:50,216,122,94,1576
2286,9,2022/4/15 8:00,224,109,115,77
2287,9,2022/4/15 8:10,222,112,110,-2725
2288,9,2022/4/15 8:20,209,117,92,-6499
2289,9,2022/4/15 8:30,194,185,9,-10046
2290,9,2022/4/15 8:40,149,191,-42,-14259
2291,9,2022/4/15 8:50,100,191,-91,-12359
2292,9,2022/4/15 9:00,65,111,-46,-4766
2293,9,2022/4/15 9:10,54,123,-69,-5002
2294,9,2022/4/15 9:20,48,113,-65,-4186
2295,9,2022/4/15 9:30,38,112,-74,-2754
2296,9,2022/4/15 9:40,30,90,-60,-2440
2297,9,2022/4/15 9:50,34,76,-42,-2108
2298,9,2022/4/15 10:00,34,71,-37,-1748
2299,9,2022/4/15 10:10,29,63,-34,-1458
2300,9,2022/4/15 10:20,25,61,-36,-1398
2301,9,2022/4/15 10:30,28,61,-33,-1361
2302,9,2022/4/15 10:40,29,60,-31,-1221
2303,9,2022/4/15 10:50,28,65,-37,-1155
2304,9,2022/4/15 11:00,27,65,-38,-1057
2305,9,2022/4/15 11:10,27,55,-28,-930
2306,9,2022/4/15 11:20,28,59,-31,-877
2307,9,2022/4/15 11:30,28,61,-33,-920
2308,9,2022/4/15 11:40,29,55,-26,-738
2309,9,2022/4/15 11:50,28,60,-32,-713
2310,9,2022/4/15 12:00,29,63,-34,-612
2311,9,2022/4/15 12:10,28,66,-38,-619
2312,9,2022/4/15 12:20,29,60,-31,-540
2313,9,2022/4/15 12:30,28,57,-29,-654
2314,9,2022/4/15 12:40,27,62,-35,-763
2315,9,2022/4/15 12:50,25,61,-36,-754
2316,9,2022/4/15 13:00,25,69,-44,-765
2317,9,2022/4/15 13:10,28,62,-34,-733
2318,9,2022/4/15 13:20,30,67,-37,-735
2319,9,2022/4/15 13:30,29,67,-38,-751
2320,9,2022/4/15 13:40,28,70,-42,-799
2321,9,2022/4/15 13:50,26,69,-43,-654
2322,9,2022/4/15 14:00,30,61,-31,-643
2323,9,2022/4/15 14:10,30,70,-40,-525
2324,9,2022/4/15 14:20,28,72,-44,-558
2325,9,2022/4/15 14:30,23,72,-49,-477
2326,9,2022/4/15 14:40,21,72,-51,-472
2327,9,2022/4/15 14:50,25,67,-42,-463
2328,9,2022/4/15 15:00,26,71,-45,-314
2329,9,2022/4/15 15:10,32,65,-33,-102
2330,9,2022/4/15 15:20,29,71,-42,-152
2331,9,2022/4/15 15:30,32,81,-49,-176
2332,9,2022/4/15 15:40,32,83,-51,-253
2333,9,2022/4/15 15:50,25,69,-44,-162
2334,9,2022/4/15 16:00,31,73,-42,33
2335,9,2022/4/15 16:10,36,84,-48,87
2336,9,2022/4/15 16:20,44,76,-32,57
2337,9,2022/4/15 16:30,45,76,-31,770
2338,9,2022/4/15 16:40,43,76,-33,1061
2339,9,2022/4/15 16:50,47,82,-35,1029
2340,9,2022/4/15 17:00,85,93,-8,3997
2341,9,2022/4/15 17:10,207,99,108,5273
2342,9,2022/4/15 17:20,136,109,27,3654
2343,9,2022/4/15 17:30,149,116,33,4833
2344,9,2022/4/15 17:40,144,121,23,8654
2345,9,2022/4/15 17:50,154,124,30,5130
2346,9,2022/4/15 18:00,88,126,-38,4308
2347,9,2022/4/15 18:10,198,112,86,8148
2348,9,2022/4/15 18:20,133,125,8,4051
2349,9,2022/4/15 18:30,66,106,-40,1518
2350,9,2022/4/15 18:40,48,111,-63,455
2351,9,2022/4/15 18:50,48,126,-78,122
2352,9,2022/4/15 19:00,36,110,-74,-266
2353,9,2022/4/15 19:10,35,114,-79,-108
2354,9,2022/4/15 19:20,29,106,-77,-321
2355,9,2022/4/15 19:30,26,92,-66,-458
2356,9,2022/4/15 19:40,28,78,-50,-467
2357,9,2022/4/15 19:50,25,77,-52,-541
2358,9,2022/4/15 20:00,26,74,-48,-132
2359,9,2022/4/15 20:10,26,68,-42,-107
2360,9,2022/4/15 20:20,27,73,-46,-302
2361,9,2022/4/15 20:30,24,72,-48,-506
2362,9,2022/4/15 20:40,24,67,-43,-395
2363,9,2022/4/15 20:50,27,69,-42,-389
2364,9,2022/4/15 21:00,27,73,-46,-206
2365,9,2022/4/15 21:10,25,59,-34,-252
2366,9,2022/4/15 21:20,22,81,-59,-588
2367,9,2022/4/15 21:30,19,65,-46,-386
2368,9,2022/4/15 21:40,17,73,-56,-438
2369,9,2022/4/15 21:50,20,75,-55,-649
2370,9,2022/4/15 22:00,13,56,-43,-555
2371,9,2022/4/15 22:10,7,73,-66,-746
2372,9,2022/4/15 22:20,4,44,-40,-1253
2373,9,2022/4/15 22:30,1,71,-70,-1231
2374,9,2022/4/15 22:40,2,49,-47,-808
2375,9,2022/4/15 22:50,0,18,-18,-354
2376,13,2022/4/15 5:00,0,1,-1,-22
2377,13,2022/4/15 5:10,0,1,-1,0
2378,13,2022/4/15 5:20,0,1,-1,52
2379,13,2022/4/15 5:30,1,1,0,112
2380,13,2022/4/15 5:40,5,1,4,191
2381,13,2022/4/15 5:50,14,1,13,203
2382,13,2022/4/15 6:00,16,2,14,144
2383,13,2022/4/15 6:10,25,11,14,24
2384,13,2022/4/15 6:20,31,30,1,-57
2385,13,2022/4/15 6:30,35,32,3,-185
2386,13,2022/4/15 6:40,53,29,24,-206
2387,13,2022/4/15 6:50,60,6,54,-163
2388,13,2022/4/15 7:00,75,41,34,-150
2389,13,2022/4/15 7:10,76,65,11,9
2390,13,2022/4/15 7:20,102,70,32,422
2391,13,2022/4/15 7:30,176,79,97,895
2392,13,2022/4/15 7:40,205,73,132,1328
2393,13,2022/4/15 7:50,235,88,147,1723
2394,13,2022/4/15 8:00,276,103,173,250
2395,13,2022/4/15 8:10,278,103,175,-2550
2396,13,2022/4/15 8:20,234,105,129,-6370
2397,13,2022/4/15 8:30,223,124,99,-9947
2398,13,2022/4/15 8:40,180,102,78,-14181
2399,13,2022/4/15 8:50,104,102,2,-12357
2400,13,2022/4/15 9:00,78,79,-1,-4767
2401,13,2022/4/15 9:10,50,97,-47,-5049
2402,13,2022/4/15 9:20,46,67,-21,-4207
2403,13,2022/4/15 9:30,40,85,-45,-2799
2404,13,2022/4/15 9:40,33,75,-42,-2482
2405,13,2022/4/15 9:50,26,76,-50,-2158
2406,13,2022/4/15 10:00,35,72,-37,-1785
2407,13,2022/4/15 10:10,30,83,-53,-1511
2408,13,2022/4/15 10:20,28,74,-46,-1444
2409,13,2022/4/15 10:30,23,76,-53,-1414
2410,13,2022/4/15 10:40,29,68,-39,-1260
2411,13,2022/4/15 10:50,27,82,-55,-1210
2412,13,2022/4/15 11:00,28,68,-40,-1097
2413,13,2022/4/15 11:10,30,73,-43,-973
2414,13,2022/4/15 11:20,28,71,-43,-920
2415,13,2022/4/15 11:30,27,67,-40,-960
2416,13,2022/4/15 11:40,29,67,-38,-776
2417,13,2022/4/15 11:50,28,67,-39,-752
2418,13,2022/4/15 12:00,28,68,-40,-652
2419,13,2022/4/15 12:10,28,65,-37,-656
2420,13,2022/4/15 12:20,31,69,-38,-578
2421,13,2022/4/15 12:30,26,72,-46,-700
2422,13,2022/4/15 12:40,32,69,-37,-800
2423,13,2022/4/15 12:50,28,66,-38,-792
2424,13,2022/4/15 13:00,26,74,-48,-813
2425,13,2022/4/15 13:10,31,68,-37,-770
2426,13,2022/4/15 13:20,29,62,-33,-768
2427,13,2022/4/15 13:30,25,71,-46,-797
2428,13,2022/4/15 13:40,29,72,-43,-842
2429,13,2022/4/15 13:50,26,74,-48,-702
2430,13,2022/4/15 14:00,30,70,-40,-683
2431,13,2022/4/15 14:10,28,73,-45,-570
2432,13,2022/4/15 14:20,27,72,-45,-603
2433,13,2022/4/15 14:30,27,63,-36,-513
2434,13,2022/4/15 14:40,27,64,-37,-509
2435,13,2022/4/15 14:50,30,71,-41,-504
2436,13,2022/4/15 15:00,29,69,-40,-354
2437,13,2022/4/15 15:10,31,68,-37,-139
2438,13,2022/4/15 15:20,26,74,-48,-200
2439,13,2022/4/15 15:30,33,69,-36,-212
2440,13,2022/4/15 15:40,31,78,-47,-300
2441,13,2022/4/15 15:50,27,77,-50,-212
2442,13,2022/4/15 16:00,30,73,-43,-10
2443,13,2022/4/15 16:10,28,85,-57,30
2444,13,2022/4/15 16:20,33,73,-40,17
2445,13,2022/4/15 16:30,35,87,-52,718
2446,13,2022/4/15 16:40,37,76,-39,1022
2447,13,2022/4/15 16:50,40,90,-50,979
2448,13,2022/4/15 17:00,45,90,-45,3952
2449,13,2022/4/15 17:10,43,111,-68,5205
2450,13,2022/4/15 17:20,41,89,-48,3606
2451,13,2022/4/15 17:30,47,123,-76,4757
2452,13,2022/4/15 17:40,42,106,-64,8590
2453,13,2022/4/15 17:50,35,126,-91,5039
2454,13,2022/4/15 18:00,35,125,-90,4218
2455,13,2022/4/15 18:10,39,104,-65,8083
2456,13,2022/4/15 18:20,37,104,-67,3984
2457,13,2022/4/15 18:30,28,128,-100,1418
2458,13,2022/4/15 18:40,30,117,-87,368
2459,13,2022/4/15 18:50,28,110,-82,40
2460,13,2022/4/15 19:00,28,121,-93,-359
2461,13,2022/4/15 19:10,27,111,-84,-192
2462,13,2022/4/15 19:20,18,110,-92,-413
2463,13,2022/4/15 19:30,20,105,-85,-543
2464,13,2022/4/15 19:40,20,95,-75,-542
2465,13,2022/4/15 19:50,17,93,-76,-617
2466,13,2022/4/15 20:00,14,76,-62,-194
2467,13,2022/4/15 20:10,14,83,-69,-176
2468,13,2022/4/15 20:20,16,74,-58,-360
2469,13,2022/4/15 20:30,16,76,-60,-566
2470,13,2022/4/15 20:40,14,77,-63,-458
2471,13,2022/4/15 20:50,14,69,-55,-444
2472,13,2022/4/15 21:00,12,77,-65,-271
2473,13,2022/4/15 21:10,15,79,-64,-316
2474,13,2022/4/15 21:20,14,76,-62,-650
2475,13,2022/4/15 21:30,13,21,-8,-394
2476,13,2022/4/15 21:40,10,75,-65,-503
2477,13,2022/4/15 21:50,11,78,-67,-716
2478,13,2022/4/15 22:00,6,78,-72,-627
2479,13,2022/4/15 22:10,2,66,-64,-810
2480,13,2022/4/15 22:20,1,41,-40,-1293
2481,13,2022/4/15 22:30,2,65,-63,-1294
2482,13,2022/4/15 22:40,1,59,-58,-866
2483,13,2022/4/15 22:50,0,32,-32,-386
2484,4,2022/4/15 5:00,0,1,-1,-23
2485,4,2022/4/15 5:10,0,1,-1,-1
2486,4,2022/4/15 5:20,0,1,-1,51
2487,4,2022/4/15 5:30,5,1,4,116
2488,4,2022/4/15 5:40,9,1,8,199
2489,4,2022/4/15 5:50,10,21,-11,192
2490,4,2022/4/15 6:00,7,5,2,146
2491,4,2022/4/15 6:10,9,34,-25,-1
2492,4,2022/4/15 6:20,17,49,-32,-89
2493,4,2022/4/15 6:30,15,33,-18,-203
2494,4,2022/4/15 6:40,17,42,-25,-231
2495,4,2022/4/15 6:50,16,62,-46,-209
2496,4,2022/4/15 7:00,20,75,-55,-205
2497,4,2022/4/15 7:10,23,87,-64,-55
2498,4,2022/4/15 7:20,25,93,-68,354
2499,4,2022/4/15 7:30,28,109,-81,814
2500,4,2022/4/15 7:40,31,108,-77,1251
2501,4,2022/4/15 7:50,39,213,-174,1549
2502,4,2022/4/15 8:00,47,319,-272,-22
2503,4,2022/4/15 8:10,58,346,-288,-2838
2504,4,2022/4/15 8:20,44,208,-164,-6534
2505,4,2022/4/15 8:30,34,178,-144,-10091
2506,4,2022/4/15 8:40,30,152,-122,-14303
2507,4,2022/4/15 8:50,28,123,-95,-12452
2508,4,2022/4/15 9:00,27,76,-49,-4816
2509,4,2022/4/15 9:10,26,82,-56,-5105
2510,4,2022/4/15 9:20,23,71,-48,-4255
2511,4,2022/4/15 9:30,21,74,-53,-2852
2512,4,2022/4/15 9:40,23,64,-41,-2523
2513,4,2022/4/15 9:50,22,65,-43,-2201
2514,4,2022/4/15 10:00,24,64,-40,-1825
2515,4,2022/4/15 10:10,25,58,-33,-1544
2516,4,2022/4/15 10:20,24,65,-41,-1485
2517,4,2022/4/15 10:30,20,54,-34,-1448
2518,4,2022/4/15 10:40,21,62,-41,-1301
2519,4,2022/4/15 10:50,25,55,-30,-1240
2520,4,2022/4/15 11:00,26,59,-33,-1130
2521,4,2022/4/15 11:10,26,59,-33,-1006
2522,4,2022/4/15 11:20,26,60,-34,-954
2523,4,2022/4/15 11:30,32,59,-27,-987
2524,4,2022/4/15 11:40,25,65,-40,-816
2525,4,2022/4/15 11:50,24,51,-27,-779
2526,4,2022/4/15 12:00,28,54,-26,-678
2527,4,2022/4/15 12:10,29,55,-26,-682
2528,4,2022/4/15 12:20,25,61,-36,-614
2529,4,2022/4/15 12:30,27,62,-35,-735
2530,4,2022/4/15 12:40,28,67,-39,-839
2531,4,2022/4/15 12:50,25,60,-35,-827
2532,4,2022/4/15 13:00,29,58,-29,-842
2533,4,2022/4/15 13:10,26,61,-35,-805
2534,4,2022/4/15 13:20,26,53,-27,-795
2535,4,2022/4/15 13:30,28,55,-27,-824
2536,4,2022/4/15 13:40,26,52,-26,-868
2537,4,2022/4/15 13:50,25,48,-23,-725
2538,4,2022/4/15 14:00,28,50,-22,-705
2539,4,2022/4/15 14:10,27,42,-15,-585
2540,4,2022/4/15 14:20,29,45,-16,-619
2541,4,2022/4/15 14:30,27,44,-17,-530
2542,4,2022/4/15 14:40,29,44,-15,-524
2543,4,2022/4/15 14:50,28,46,-18,-522
2544,4,2022/4/15 15:00,24,45,-21,-375
2545,4,2022/4/15 15:10,28,42,-14,-153
2546,4,2022/4/15 15:20,29,41,-12,-212
2547,4,2022/4/15 15:30,26,49,-23,-235
2548,4,2022/4/15 15:40,30,45,-15,-315
2549,4,2022/4/15 15:50,33,45,-12,-224
2550,4,2022/4/15 16:00,36,46,-10,-20
2551,4,2022/4/15 16:10,48,46,2,32
2552,4,2022/4/15 16:20,41,59,-18,-1
2553,4,2022/4/15 16:30,97,46,51,769
2554,4,2022/4/15 16:40,93,50,43,1065
2555,4,2022/4/15 16:50,157,47,110,1089
2556,4,2022/4/15 17:00,322,48,274,4226
2557,4,2022/4/15 17:10,348,53,295,5500
2558,4,2022/4/15 17:20,180,51,129,3735
2559,4,2022/4/15 17:30,137,54,83,4840
2560,4,2022/4/15 17:40,177,55,122,8712
2561,4,2022/4/15 17:50,76,52,24,5063
2562,4,2022/4/15 18:00,65,55,10,4228
2563,4,2022/4/15 18:10,56,55,1,8084
2564,4,2022/4/15 18:20,41,54,-13,3971
2565,4,2022/4/15 18:30,43,58,-15,1403
2566,4,2022/4/15 18:40,32,50,-18,350
2567,4,2022/4/15 18:50,29,52,-23,17
2568,4,2022/4/15 19:00,24,56,-32,-391
2569,4,2022/4/15 19:10,29,54,-25,-217
2570,4,2022/4/15 19:20,32,48,-16,-429
2571,4,2022/4/15 19:30,25,27,-2,-545
2572,4,2022/4/15 19:40,22,42,-20,-562
2573,4,2022/4/15 19:50,24,44,-20,-637
2574,4,2022/4/15 20:00,28,38,-10,-204
2575,4,2022/4/15 20:10,30,25,5,-171
2576,4,2022/4/15 20:20,23,40,-17,-377
2577,4,2022/4/15 20:30,25,34,-9,-575
2578,4,2022/4/15 20:40,17,39,-22,-480
2579,4,2022/4/15 20:50,22,30,-8,-452
2580,4,2022/4/15 21:00,22,25,-3,-274
2581,4,2022/4/15 21:10,20,33,-13,-329
2582,4,2022/4/15 21:20,17,15,2,-648
2583,4,2022/4/15 21:30,11,31,-20,-414
2584,4,2022/4/15 21:40,12,30,-18,-521
2585,4,2022/4/15 21:50,11,29,-18,-734
2586,4,2022/4/15 22:00,7,27,-20,-647
2587,4,2022/4/15 22:10,8,7,1,-809
2588,4,2022/4/15 22:20,3,25,-22,-1315
2589,4,2022/4/15 22:30,0,24,-24,-1318
2590,4,2022/4/15 22:40,1,23,-22,-888
2591,4,2022/4/15 22:50,1,13,-12,-398
2592,8,2022/4/15 5:00,0,1,-1,-22
2593,8,2022/4/15 5:10,2,1,1,2
2594,8,2022/4/15 5:20,10,1,9,62
2595,8,2022/4/15 5:30,15,1,14,126
2596,8,2022/4/15 5:40,17,1,16,203
2597,8,2022/4/15 5:50,19,1,18,208
2598,8,2022/4/15 6:00,26,1,25,155
2599,8,2022/4/15 6:10,33,1,32,42
2600,8,2022/4/15 6:20,36,19,17,-41
2601,8,2022/4/15 6:30,55,29,26,-162
2602,8,2022/4/15 6:40,67,46,21,-209
2603,8,2022/4/15 6:50,69,53,16,-201
2604,8,2022/4/15 7:00,109,57,52,-132
2605,8,2022/4/15 7:10,155,68,87,85
2606,8,2022/4/15 7:20,231,45,186,576
2607,8,2022/4/15 7:30,280,51,229,1027
2608,8,2022/4/15 7:40,358,86,272,1468
2609,8,2022/4/15 7:50,468,105,363,1939
2610,8,2022/4/15 8:00,467,110,357,434
2611,8,2022/4/15 8:10,474,191,283,-2442
2612,8,2022/4/15 8:20,375,222,153,-6346
2613,8,2022/4/15 8:30,345,159,186,-9860
2614,8,2022/4/15 8:40,253,381,-128,-14387
2615,8,2022/4/15 8:50,196,91,105,-12254
2616,8,2022/4/15 9:00,177,218,-41,-4807
2617,8,2022/4/15 9:10,98,32,66,-4936
2618,8,2022/4/15 9:20,74,115,-41,-4227
2619,8,2022/4/15 9:30,53,103,-50,-2804
2620,8,2022/4/15 9:40,51,112,-61,-2501
2621,8,2022/4/15 9:50,45,114,-69,-2177
2622,8,2022/4/15 10:00,43,93,-50,-1798
2623,8,2022/4/15 10:10,41,80,-39,-1497
2624,8,2022/4/15 10:20,37,76,-39,-1437
2625,8,2022/4/15 10:30,38,78,-40,-1401
2626,8,2022/4/15 10:40,30,76,-46,-1267
2627,8,2022/4/15 10:50,32,68,-36,-1191
2628,8,2022/4/15 11:00,31,85,-54,-1111
2629,8,2022/4/15 11:10,31,83,-52,-982
2630,8,2022/4/15 11:20,28,74,-46,-923
2631,8,2022/4/15 11:30,31,74,-43,-963
2632,8,2022/4/15 11:40,30,77,-47,-785
2633,8,2022/4/15 11:50,35,77,-42,-755
2634,8,2022/4/15 12:00,35,80,-45,-657
2635,8,2022/4/15 12:10,39,75,-36,-655
2636,8,2022/4/15 12:20,38,77,-39,-579
2637,8,2022/4/15 12:30,38,81,-43,-697
2638,8,2022/4/15 12:40,37,79,-42,-805
2639,8,2022/4/15 12:50,43,75,-32,-786
2640,8,2022/4/15 13:00,39,79,-40,-805
2641,8,2022/4/15 13:10,38,76,-38,-771
2642,8,2022/4/15 13:20,35,76,-41,-776
2643,8,2022/4/15 13:30,40,77,-37,-788
2644,8,2022/4/15 13:40,37,82,-45,-844
2645,8,2022/4/15 13:50,34,76,-42,-696
2646,8,2022/4/15 14:00,37,81,-44,-687
2647,8,2022/4/15 14:10,33,77,-44,-569
2648,8,2022/4/15 14:20,35,75,-40,-598
2649,8,2022/4/15 14:30,37,83,-46,-523
2650,8,2022/4/15 14:40,32,92,-60,-532
2651,8,2022/4/15 14:50,29,93,-64,-527
2652,8,2022/4/15 15:00,39,91,-52,-366
2653,8,2022/4/15 15:10,32,93,-61,-163
2654,8,2022/4/15 15:20,36,93,-57,-209
2655,8,2022/4/15 15:30,33,98,-65,-241
2656,8,2022/4/15 15:40,32,111,-79,-332
2657,8,2022/4/15 15:50,36,105,-69,-231
2658,8,2022/4/15 16:00,38,111,-73,-40
2659,8,2022/4/15 16:10,38,105,-67,20
2660,8,2022/4/15 16:20,38,111,-73,-16
2661,8,2022/4/15 16:30,44,119,-75,695
2662,8,2022/4/15 16:40,45,107,-62,999
2663,8,2022/4/15 16:50,48,117,-69,960
2664,8,2022/4/15 17:00,73,121,-48,3949
2665,8,2022/4/15 17:10,176,109,67,5340
2666,8,2022/4/15 17:20,74,119,-45,3609
2667,8,2022/4/15 17:30,132,153,-21,4812
2668,8,2022/4/15 17:40,239,190,49,8703
2669,8,2022/4/15 17:50,186,433,-247,4883
2670,8,2022/4/15 18:00,169,282,-113,4195
2671,8,2022/4/15 18:10,249,267,-18,8130
2672,8,2022/4/15 18:20,176,313,-137,3914
2673,8,2022/4/15 18:30,103,328,-225,1293
2674,8,2022/4/15 18:40,71,283,-212,243
2675,8,2022/4/15 18:50,60,293,-233,-111
2676,8,2022/4/15 19:00,48,180,-132,-398
2677,8,2022/4/15 19:10,41,192,-151,-259
2678,8,2022/4/15 19:20,35,119,-84,-405
2679,8,2022/4/15 19:30,35,109,-74,-532
2680,8,2022/4/15 19:40,39,124,-85,-552
2681,8,2022/4/15 19:50,31,106,-75,-616
2682,8,2022/4/15 20:00,43,105,-62,-194
2683,8,2022/4/15 20:10,44,113,-69,-176
2684,8,2022/4/15 20:20,30,98,-68,-370
2685,8,2022/4/15 20:30,31,102,-71,-577
2686,8,2022/4/15 20:40,37,102,-65,-460
2687,8,2022/4/15 20:50,25,99,-74,-463
2688,8,2022/4/15 21:00,31,10,21,-185
2689,8,2022/4/15 21:10,30,102,-72,-324
2690,8,2022/4/15 21:20,35,105,-70,-658
2691,8,2022/4/15 21:30,28,114,-86,-472
2692,8,2022/4/15 21:40,29,61,-32,-470
2693,8,2022/4/15 21:50,23,75,-52,-701
2694,8,2022/4/15 22:00,9,99,-90,-645
2695,8,2022/4/15 22:10,2,98,-96,-842
2696,8,2022/4/15 22:20,2,97,-95,-1348
2697,8,2022/4/15 22:30,1,7,-6,-1237
2698,8,2022/4/15 22:40,1,78,-77,-885
2699,8,2022/4/15 22:50,1,64,-63,-417
2700,27,2022/4/15 5:00,0,1,-1,-23
2701,27,2022/4/15 5:10,1,1,0,2
2702,27,2022/4/15 5:20,7,1,6,68
2703,27,2022/4/15 5:30,1,1,0,126
2704,27,2022/4/15 5:40,1,1,0,203
2705,27,2022/4/15 5:50,9,1,8,216
2706,27,2022/4/15 6:00,8,1,7,162
2707,27,2022/4/15 6:10,8,1,7,49
2708,27,2022/4/15 6:20,17,1,16,-25
2709,27,2022/4/15 6:30,22,16,6,-156
2710,27,2022/4/15 6:40,22,16,6,-203
2711,27,2022/4/15 6:50,27,23,4,-197
2712,27,2022/4/15 7:00,31,37,-6,-138
2713,27,2022/4/15 7:10,32,8,24,109
2714,27,2022/4/15 7:20,36,29,7,583
2715,27,2022/4/15 7:30,38,23,15,1042
2716,27,2022/4/15 7:40,54,29,25,1493
2717,27,2022/4/15 7:50,52,40,12,1951
2718,27,2022/4/15 8:00,50,47,3,437
2719,27,2022/4/15 8:10,50,51,-1,-2443
2720,27,2022/4/15 8:20,44,51,-7,-6353
2721,27,2022/4/15 8:30,36,51,-15,-9875
2722,27,2022/4/15 8:40,33,62,-29,-14416
2723,27,2022/4/15 8:50,30,59,-29,-12283
2724,27,2022/4/15 9:00,25,47,-22,-4829
2725,27,2022/4/15 9:10,23,33,-10,-4946
2726,27,2022/4/15 9:20,18,38,-20,-4247
2727,27,2022/4/15 9:30,17,25,-8,-2812
2728,27,2022/4/15 9:40,15,25,-10,-2511
2729,27,2022/4/15 9:50,14,24,-10,-2187
2730,27,2022/4/15 10:00,12,23,-11,-1809
2731,27,2022/4/15 10:10,12,21,-9,-1506
2732,27,2022/4/15 10:20,11,23,-12,-1449
2733,27,2022/4/15 10:30,11,21,-10,-1411
2734,27,2022/4/15 10:40,9,23,-14,-1281
2735,27,2022/4/15 10:50,8,19,-11,-1202
2736,27,2022/4/15 11:00,9,19,-10,-1121
2737,27,2022/4/15 11:10,10,21,-11,-993
2738,27,2022/4/15 11:20,10,25,-15,-938
2739,27,2022/4/15 11:30,9,23,-14,-977
2740,27,2022/4/15 11:40,11,23,-12,-797
2741,27,2022/4/15 11:50,11,21,-10,-765
2742,27,2022/4/15 12:00,11,19,-8,-665
2743,27,2022/4/15 12:10,11,21,-10,-665
2744,27,2022/4/15 12:20,11,23,-12,-591
2745,27,2022/4/15 12:30,11,23,-12,-709
2746,27,2022/4/15 12:40,12,23,-11,-816
2747,27,2022/4/15 12:50,9,22,-13,-799
2748,27,2022/4/15 13:00,10,23,-13,-818
2749,27,2022/4/15 13:10,11,25,-14,-785
2750,27,2022/4/15 13:20,11,23,-12,-788
2751,27,2022/4/15 13:30,9,23,-14,-802
2752,27,2022/4/15 13:40,8,23,-15,-859
2753,27,2022/4/15 13:50,11,23,-12,-708
2754,27,2022/4/15 14:00,10,23,-13,-700
2755,27,2022/4/15 14:10,12,23,-11,-580
2756,27,2022/4/15 14:20,11,23,-12,-610
2757,27,2022/4/15 14:30,11,23,-12,-535
2758,27,2022/4/15 14:40,8,23,-15,-547
2759,27,2022/4/15 14:50,10,23,-13,-540
2760,27,2022/4/15 15:00,11,23,-12,-378
2761,27,2022/4/15 15:10,10,31,-21,-184
2762,27,2022/4/15 15:20,11,28,-17,-226
2763,27,2022/4/15 15:30,10,25,-15,-256
2764,27,2022/4/15 15:40,10,32,-22,-354
2765,27,2022/4/15 15:50,9,38,-29,-260
2766,27,2022/4/15 16:00,14,31,-17,-57
2767,27,2022/4/15 16:10,12,32,-20,0
2768,27,2022/4/15 16:20,14,34,-20,-36
2769,27,2022/4/15 16:30,18,38,-20,675
2770,27,2022/4/15 16:40,15,37,-22,977
2771,27,2022/4/15 16:50,17,41,-24,936
2772,27,2022/4/15 17:00,26,46,-20,3929
2773,27,2022/4/15 17:10,29,49,-20,5320
2774,27,2022/4/15 17:20,22,50,-28,3581
2775,27,2022/4/15 17:30,16,70,-54,4758
2776,27,2022/4/15 17:40,17,62,-45,8658
2777,27,2022/4/15 17:50,15,66,-51,4832
2778,27,2022/4/15 18:00,21,72,-51,4144
2779,27,2022/4/15 18:10,21,77,-56,8074
2780,27,2022/4/15 18:20,19,78,-59,3855
2781,27,2022/4/15 18:30,16,83,-67,1226
2782,27,2022/4/15 18:40,14,77,-63,180
2783,27,2022/4/15 18:50,15,79,-64,-175
2784,27,2022/4/15 19:00,12,76,-64,-462
2785,27,2022/4/15 19:10,12,75,-63,-322
2786,27,2022/4/15 19:20,11,65,-54,-459
2787,27,2022/4/15 19:30,10,55,-45,-577
2788,27,2022/4/15 19:40,9,51,-42,-594
2789,27,2022/4/15 19:50,9,43,-34,-650
2790,27,2022/4/15 20:00,10,48,-38,-232
2791,27,2022/4/15 20:10,10,41,-31,-207
2792,27,2022/4/15 20:20,7,37,-30,-400
2793,27,2022/4/15 20:30,10,34,-24,-601
2794,27,2022/4/15 20:40,10,27,-17,-477
2795,27,2022/4/15 20:50,6,40,-34,-497
2796,27,2022/4/15 21:00,6,38,-32,-217
2797,27,2022/4/15 21:10,6,34,-28,-352
2798,27,2022/4/15 21:20,7,41,-34,-692
2799,27,2022/4/15 21:30,6,37,-31,-503
2800,27,2022/4/15 21:40,6,4,2,-468
2801,27,2022/4/15 21:50,6,40,-34,-735
2802,27,2022/4/15 22:00,0,40,-40,-685
2803,27,2022/4/15 22:10,1,34,-33,-875
2804,27,2022/4/15 22:20,0,25,-25,-1373
2805,27,2022/4/15 22:30,0,8,-8,-1245
2806,27,2022/4/15 22:40,0,24,-24,-909
2807,27,2022/4/15 22:50,0,13,-13,-430
2808,3,2022/4/15 5:00,0,1,-1,-24
2809,3,2022/4/15 5:10,4,1,3,5
2810,3,2022/4/15 5:20,13,1,12,80
2811,3,2022/4/15 5:30,9,1,8,134
2812,3,2022/4/15 5:40,16,1,15,218
2813,3,2022/4/15 5:50,23,1,22,238
2814,3,2022/4/15 6:00,27,1,26,188
2815,3,2022/4/15 6:10,31,1,30,79
2816,3,2022/4/15 6:20,47,19,28,3
2817,3,2022/4/15 6:30,57,16,41,-115
2818,3,2022/4/15 6:40,68,23,45,-158
2819,3,2022/4/15 6:50,88,23,65,-132
2820,3,2022/4/15 7:00,144,11,133,-5
2821,3,2022/4/15 7:10,222,25,197,306
2822,3,2022/4/15 7:20,274,40,234,817
2823,3,2022/4/15 7:30,325,50,275,1317
2824,3,2022/4/15 7:40,593,38,555,2048
2825,3,2022/4/15 7:50,684,49,635,2586
2826,3,2022/4/15 8:00,699,54,645,1082
2827,3,2022/4/15 8:10,707,61,646,-1797
2828,3,2022/4/15 8:20,629,62,567,-5786
2829,3,2022/4/15 8:30,367,72,295,-9580
2830,3,2022/4/15 8:40,282,71,211,-14205
2831,3,2022/4/15 8:50,234,62,172,-12111
2832,3,2022/4/15 9:00,169,64,105,-4724
2833,3,2022/4/15 9:10,116,46,70,-4876
2834,3,2022/4/15 9:20,65,52,13,-4234
2835,3,2022/4/15 9:30,49,42,7,-2805
2836,3,2022/4/15 9:40,41,51,-10,-2521
2837,3,2022/4/15 9:50,40,47,-7,-2194
2838,3,2022/4/15 10:00,33,49,-16,-1825
2839,3,2022/4/15 10:10,34,42,-8,-1514
2840,3,2022/4/15 10:20,30,48,-18,-1467
2841,3,2022/4/15 10:30,25,50,-25,-1436
2842,3,2022/4/15 10:40,28,47,-19,-1300
2843,3,2022/4/15 10:50,26,48,-22,-1224
2844,3,2022/4/15 11:00,26,50,-24,-1145
2845,3,2022/4/15 11:10,25,50,-25,-1018
2846,3,2022/4/15 11:20,26,51,-25,-963
2847,3,2022/4/15 11:30,25,49,-24,-1001
2848,3,2022/4/15 11:40,25,51,-26,-823
2849,3,2022/4/15 11:50,26,50,-24,-789
2850,3,2022/4/15 12:00,28,52,-24,-689
2851,3,2022/4/15 12:10,27,50,-23,-688
2852,3,2022/4/15 12:20,27,51,-24,-615
2853,3,2022/4/15 12:30,27,52,-25,-734
2854,3,2022/4/15 12:40,29,52,-23,-839
2855,3,2022/4/15 12:50,25,54,-29,-828
2856,3,2022/4/15 13:00,27,55,-28,-846
2857,3,2022/4/15 13:10,28,58,-30,-815
2858,3,2022/4/15 13:20,28,53,-25,-813
2859,3,2022/4/15 13:30,28,54,-26,-828
2860,3,2022/4/15 13:40,28,63,-35,-894
2861,3,2022/4/15 13:50,23,63,-40,-748
2862,3,2022/4/15 14:00,25,67,-42,-742
2863,3,2022/4/15 14:10,22,66,-44,-624
2864,3,2022/4/15 14:20,24,65,-41,-651
2865,3,2022/4/15 14:30,22,59,-37,-572
2866,3,2022/4/15 14:40,20,61,-41,-588
2867,3,2022/4/15 14:50,23,70,-47,-587
2868,3,2022/4/15 15:00,21,65,-44,-422
2869,3,2022/4/15 15:10,20,67,-47,-231
2870,3,2022/4/15 15:20,21,73,-52,-278
2871,3,2022/4/15 15:30,22,81,-59,-315
2872,3,2022/4/15 15:40,19,73,-54,-408
2873,3,2022/4/15 15:50,21,76,-55,-315
2874,3,2022/4/15 16:00,21,76,-55,-112
2875,3,2022/4/15 16:10,20,74,-54,-54
2876,3,2022/4/15 16:20,22,79,-57,-93
2877,3,2022/4/15 16:30,26,93,-67,608
2878,3,2022/4/15 16:40,29,97,-68,909
2879,3,2022/4/15 16:50,26,103,-77,859
2880,3,2022/4/15 17:00,24,104,-80,3849
2881,3,2022/4/15 17:10,29,111,-82,5238
2882,3,2022/4/15 17:20,31,101,-70,3511
2883,3,2022/4/15 17:30,29,115,-86,4672
2884,3,2022/4/15 17:40,29,109,-80,8578
2885,3,2022/4/15 17:50,29,181,-152,4680
2886,3,2022/4/15 18:00,26,128,-102,4042
2887,3,2022/4/15 18:10,30,179,-149,7925
2888,3,2022/4/15 18:20,27,226,-199,3656
2889,3,2022/4/15 18:30,29,234,-205,1021
2890,3,2022/4/15 18:40,23,220,-197,-17
2891,3,2022/4/15 18:50,22,223,-201,-376
2892,3,2022/4/15 19:00,19,145,-126,-588
2893,3,2022/4/15 19:10,17,139,-122,-444
2894,3,2022/4/15 19:20,18,111,-93,-552
2895,3,2022/4/15 19:30,16,119,-103,-680
2896,3,2022/4/15 19:40,15,100,-85,-679
2897,3,2022/4/15 19:50,16,112,-96,-746
2898,3,2022/4/15 20:00,15,101,-86,-318
2899,3,2022/4/15 20:10,15,95,-80,-287
2900,3,2022/4/15 20:20,17,97,-80,-480
2901,3,2022/4/15 20:30,14,78,-64,-665
2902,3,2022/4/15 20:40,14,92,-78,-555
2903,3,2022/4/15 20:50,12,85,-73,-570
2904,3,2022/4/15 21:00,13,94,-81,-298
2905,3,2022/4/15 21:10,16,95,-79,-431
2906,3,2022/4/15 21:20,12,60,-48,-740
2907,3,2022/4/15 21:30,11,86,-75,-578
2908,3,2022/4/15 21:40,10,102,-92,-560
2909,3,2022/4/15 21:50,5,114,-109,-844
2910,3,2022/4/15 22:00,1,94,-93,-778
2911,3,2022/4/15 22:10,0,77,-77,-952
2912,3,2022/4/15 22:20,0,25,-25,-1398
2913,3,2022/4/15 22:30,0,86,-86,-1331
2914,3,2022/4/15 22:40,1,77,-76,-985
2915,3,2022/4/15 22:50,0,54,-54,-484
2916,43,2022/4/15 5:00,0,1,-1,-1
2917,43,2022/4/15 5:10,1,1,0,0
2918,43,2022/4/15 5:20,10,1,9,9
2919,43,2022/4/15 5:30,7,1,6,6
2920,43,2022/4/15 5:40,14,1,13,13
2921,43,2022/4/15 5:50,16,1,15,15
2922,43,2022/4/15 6:00,20,1,19,19
2923,43,2022/4/15 6:10,29,1,28,28
2924,43,2022/4/15 6:20,34,1,33,33
2925,43,2022/4/15 6:30,30,21,9,9
2926,43,2022/4/15 6:40,33,21,12,12
2927,43,2022/4/15 6:50,53,64,-11,-11
2928,43,2022/4/15 7:00,58,68,-10,-10
2929,43,2022/4/15 7:10,91,60,31,31
2930,43,2022/4/15 7:20,151,100,51,51
2931,43,2022/4/15 7:30,148,91,57,57
2932,43,2022/4/15 7:40,161,93,68,68
2933,43,2022/4/15 7:50,184,118,66,66
2934,43,2022/4/15 8:00,173,109,64,64
2935,43,2022/4/15 8:10,92,110,-18,-18
2936,43,2022/4/15 8:20,79,144,-65,-65
2937,43,2022/4/15 8:30,53,121,-68,-68
2938,43,2022/4/15 8:40,44,112,-68,-68
2939,43,2022/4/15 8:50,39,87,-48,-48
2940,43,2022/4/15 9:00,34,126,-92,-92
2941,43,2022/4/15 9:10,28,93,-65,-65
2942,43,2022/4/15 9:20,27,81,-54,-54
2943,43,2022/4/15 9:30,22,77,-55,-55
2944,43,2022/4/15 9:40,22,87,-65,-65
2945,43,2022/4/15 9:50,23,67,-44,-44
2946,43,2022/4/15 10:00,25,52,-27,-27
2947,43,2022/4/15 10:10,25,51,-26,-26
2948,43,2022/4/15 10:20,25,50,-25,-25
2949,43,2022/4/15 10:30,24,41,-17,-17
2950,43,2022/4/15 10:40,23,44,-21,-21
2951,43,2022/4/15 10:50,25,49,-24,-24
2952,43,2022/4/15 11:00,23,51,-28,-28
2953,43,2022/4/15 11:10,25,50,-25,-25
2954,43,2022/4/15 11:20,21,50,-29,-29
2955,43,2022/4/15 11:30,36,25,11,11
2956,43,2022/4/15 11:40,23,49,-26,-26
2957,43,2022/4/15 11:50,21,52,-31,-31
2958,43,2022/4/15 12:00,23,52,-29,-29
2959,43,2022/4/15 12:10,23,50,-27,-27
2960,43,2022/4/15 12:20,23,66,-43,-43
2961,43,2022/4/15 12:30,19,37,-18,-18
2962,43,2022/4/15 12:40,25,59,-34,-34
2963,43,2022/4/15 12:50,25,62,-37,-37
2964,43,2022/4/15 13:00,22,65,-43,-43
2965,43,2022/4/15 13:10,26,66,-40,-40
2966,43,2022/4/15 13:20,25,47,-22,-22
2967,43,2022/4/15 13:30,22,25,-3,-3
2968,43,2022/4/15 13:40,24,49,-25,-25
2969,43,2022/4/15 13:50,22,55,-33,-33
2970,43,2022/4/15 14:00,24,55,-31,-31
2971,43,2022/4/15 14:10,24,50,-26,-26
2972,43,2022/4/15 14:20,22,51,-29,-29
2973,43,2022/4/15 14:30,22,23,-1,-1
2974,43,2022/4/15 14:40,34,54,-20,-20
2975,43,2022/4/15 14:50,19,54,-35,-35
2976,43,2022/4/15 15:00,19,54,-35,-35
2977,43,2022/4/15 15:10,23,65,-42,-42
2978,43,2022/4/15 15:20,21,53,-32,-32
2979,43,2022/4/15 15:30,22,32,-10,-10
2980,43,2022/4/15 15:40,22,64,-42,-42
2981,43,2022/4/15 15:50,25,60,-35,-35
2982,43,2022/4/15 16:00,21,70,-49,-49
2983,43,2022/4/15 16:10,29,63,-34,-34
2984,43,2022/4/15 16:20,29,71,-42,-42
2985,43,2022/4/15 16:30,32,45,-13,-13
2986,43,2022/4/15 16:40,33,73,-40,-40
2987,43,2022/4/15 16:50,39,71,-32,-32
2988,43,2022/4/15 17:00,42,67,-25,-25
2989,43,2022/4/15 17:10,204,75,129,129
2990,43,2022/4/15 17:20,137,74,63,63
2991,43,2022/4/15 17:30,73,69,4,4
2992,43,2022/4/15 17:40,69,86,-17,-17
2993,43,2022/4/15 17:50,63,76,-13,-13
2994,43,2022/4/15 18:00,59,104,-45,-45
2995,43,2022/4/15 18:10,48,92,-44,-44
2996,43,2022/4/15 18:20,63,115,-52,-52
2997,43,2022/4/15 18:30,38,101,-63,-63
2998,43,2022/4/15 18:40,34,111,-77,-77
2999,43,2022/4/15 18:50,26,97,-71,-71
3000,43,2022/4/15 19:00,25,92,-67,-67
3001,43,2022/4/15 19:10,37,106,-69,-69
3002,43,2022/4/15 19:20,17,105,-88,-88
3003,43,2022/4/15 19:30,17,79,-62,-62
3004,43,2022/4/15 19:40,16,76,-60,-60
3005,43,2022/4/15 19:50,14,71,-57,-57
3006,43,2022/4/15 20:00,19,82,-63,-63
3007,43,2022/4/15 20:10,22,52,-30,-30
3008,43,2022/4/15 20:20,14,56,-42,-42
3009,43,2022/4/15 20:30,14,69,-55,-55
3010,43,2022/4/15 20:40,18,70,-52,-52
3011,43,2022/4/15 20:50,11,54,-43,-43
3012,43,2022/4/15 21:00,11,56,-45,-45
3013,43,2022/4/15 21:10,11,55,-44,-44
3014,43,2022/4/15 21:20,14,59,-45,-45
3015,43,2022/4/15 21:30,9,53,-44,-44
3016,43,2022/4/15 21:40,7,60,-53,-53
3017,43,2022/4/15 21:50,5,62,-57,-57
3018,43,2022/4/15 22:00,6,48,-42,-42
3019,43,2022/4/15 22:10,3,57,-54,-54
3020,43,2022/4/15 22:20,1,50,-49,-49
3021,43,2022/4/15 22:30,2,50,-48,-48
3022,43,2022/4/15 22:40,0,43,-43,-43
3023,43,2022/4/15 22:50,0,47,-47,-47
3024,56,2022/4/15 5:00,0,1,-1,-2
3025,56,2022/4/15 5:10,4,1,3,3
3026,56,2022/4/15 5:20,15,1,14,23
3027,56,2022/4/15 5:30,12,1,11,17
3028,56,2022/4/15 5:40,15,1,14,27
3029,56,2022/4/15 5:50,20,1,19,34
3030,56,2022/4/15 6:00,30,1,29,48
3031,56,2022/4/15 6:10,35,2,33,61
3032,56,2022/4/15 6:20,44,2,42,75
3033,56,2022/4/15 6:30,70,5,65,74
3034,56,2022/4/15 6:40,108,13,95,107
3035,56,2022/4/15 6:50,147,62,85,74
3036,56,2022/4/15 7:00,227,59,168,158
3037,56,2022/4/15 7:10,245,52,193,224
3038,56,2022/4/15 7:20,343,51,292,343
3039,56,2022/4/15 7:30,325,78,247,304
3040,56,2022/4/15 7:40,572,77,495,563
3041,56,2022/4/15 7:50,632,90,542,608
3042,56,2022/4/15 8:00,662,127,535,599
3043,56,2022/4/15 8:10,392,93,299,281
3044,56,2022/4/15 8:20,330,99,231,166
3045,56,2022/4/15 8:30,284,75,209,141
3046,56,2022/4/15 8:40,226,121,105,37
3047,56,2022/4/15 8:50,168,83,85,37
3048,56,2022/4/15 9:00,96,72,24,-68
3049,56,2022/4/15 9:10,68,77,-9,-74
3050,56,2022/4/15 9:20,44,99,-55,-109
3051,56,2022/4/15 9:30,43,72,-29,-84
3052,56,2022/4/15 9:40,38,62,-24,-89
3053,56,2022/4/15 9:50,37,74,-37,-81
3054,56,2022/4/15 10:00,29,69,-40,-67
3055,56,2022/4/15 10:10,29,52,-23,-49
3056,56,2022/4/15 10:20,26,65,-39,-64
3057,56,2022/4/15 10:30,28,68,-40,-57
3058,56,2022/4/15 10:40,28,67,-39,-60
3059,56,2022/4/15 10:50,27,66,-39,-63
3060,56,2022/4/15 11:00,25,23,2,-26
3061,56,2022/4/15 11:10,24,62,-38,-63
3062,56,2022/4/15 11:20,29,69,-40,-69
3063,56,2022/4/15 11:30,28,71,-43,-32
3064,56,2022/4/15 11:40,30,74,-44,-70
3065,56,2022/4/15 11:50,28,50,-22,-53
3066,56,2022/4/15 12:00,31,45,-14,-43
3067,56,2022/4/15 12:10,30,61,-31,-58
3068,56,2022/4/15 12:20,32,64,-32,-75
3069,56,2022/4/15 12:30,33,74,-41,-59
3070,56,2022/4/15 12:40,28,74,-46,-80
3071,56,2022/4/15 12:50,27,52,-25,-62
3072,56,2022/4/15 13:00,28,55,-27,-70
3073,56,2022/4/15 13:10,25,72,-47,-87
3074,56,2022/4/15 13:20,28,81,-53,-75
3075,56,2022/4/15 13:30,27,68,-41,-44
3076,56,2022/4/15 13:40,28,72,-44,-69
3077,56,2022/4/15 13:50,24,50,-26,-59
3078,56,2022/4/15 14:00,28,63,-35,-66
3079,56,2022/4/15 14:10,27,71,-44,-70
3080,56,2022/4/15 14:20,27,69,-42,-71
3081,56,2022/4/15 14:30,25,77,-52,-53
3082,56,2022/4/15 14:40,28,83,-55,-75
3083,56,2022/4/15 14:50,27,48,-21,-56
3084,56,2022/4/15 15:00,26,66,-40,-75
3085,56,2022/4/15 15:10,29,67,-38,-80
3086,56,2022/4/15 15:20,26,81,-55,-87
3087,56,2022/4/15 15:30,29,83,-54,-64
3088,56,2022/4/15 15:40,26,83,-57,-99
3089,56,2022/4/15 15:50,27,60,-33,-68
3090,56,2022/4/15 16:00,28,64,-36,-85
3091,56,2022/4/15 16:10,28,82,-54,-88
3092,56,2022/4/15 16:20,26,109,-83,-125
3093,56,2022/4/15 16:30,33,103,-70,-83
3094,56,2022/4/15 16:40,31,95,-64,-104
3095,56,2022/4/15 16:50,31,90,-59,-91
3096,56,2022/4/15 17:00,29,107,-78,-103
3097,56,2022/4/15 17:10,53,108,-55,74
3098,56,2022/4/15 17:20,42,126,-84,-21
3099,56,2022/4/15 17:30,45,106,-61,-57
3100,56,2022/4/15 17:40,47,177,-130,-147
3101,56,2022/4/15 17:50,47,118,-71,-84
3102,56,2022/4/15 18:00,45,119,-74,-119
3103,56,2022/4/15 18:10,38,147,-109,-153
3104,56,2022/4/15 18:20,32,326,-294,-346
3105,56,2022/4/15 18:30,33,180,-147,-210
3106,56,2022/4/15 18:40,28,180,-152,-229
3107,56,2022/4/15 18:50,26,198,-172,-243
3108,56,2022/4/15 19:00,28,328,-300,-367
3109,56,2022/4/15 19:10,27,145,-118,-187
3110,56,2022/4/15 19:20,21,180,-159,-247
3111,56,2022/4/15 19:30,20,97,-77,-139
3112,56,2022/4/15 19:40,21,180,-159,-219
3113,56,2022/4/15 19:50,19,107,-88,-145
3114,56,2022/4/15 20:00,19,106,-87,-150
3115,56,2022/4/15 20:10,19,118,-99,-129
3116,56,2022/4/15 20:20,17,108,-91,-133
3117,56,2022/4/15 20:30,20,90,-70,-125
3118,56,2022/4/15 20:40,16,95,-79,-131
3119,56,2022/4/15 20:50,19,105,-86,-129
3120,56,2022/4/15 21:00,14,104,-90,-135
3121,56,2022/4/15 21:10,18,94,-76,-120
3122,56,2022/4/15 21:20,16,110,-94,-139
3123,56,2022/4/15 21:30,16,75,-59,-103
3124,56,2022/4/15 21:40,12,92,-80,-133
3125,56,2022/4/15 21:50,10,100,-90,-147
3126,56,2022/4/15 22:00,9,72,-63,-105
3127,56,2022/4/15 22:10,8,109,-101,-155
3128,56,2022/4/15 22:20,5,78,-73,-122
3129,56,2022/4/15 22:30,1,90,-89,-137
3130,56,2022/4/15 22:40,0,79,-79,-122
3131,56,2022/4/15 22:50,0,49,-49,-96
3132,46,2022/4/15 5:00,0,1,-1,-2
3133,46,2022/4/15 5:10,1,1,0,3
3134,46,2022/4/15 5:20,10,1,9,23
3135,46,2022/4/15 5:30,14,1,13,24
3136,46,2022/4/15 5:40,15,1,14,28
3137,46,2022/4/15 5:50,18,1,17,36
3138,46,2022/4/15 6:00,25,1,24,53
3139,46,2022/4/15 6:10,31,1,30,63
3140,46,2022/4/15 6:20,32,1,31,
3141,46,2022/4/15 6:30,48,1,47,
3142,46,2022/4/15 6:40,58,23,35,
3143,46,2022/4/15 6:50,78,47,31,
3144,46,2022/4/15 7:00,70,47,23,
3145,46,2022/4/15 7:10,152,65,87,
3146,46,2022/4/15 7:20,245,69,176,
3147,46,2022/4/15 7:30,283,50,233,
3148,46,2022/4/15 7:40,328,60,268,
3149,46,2022/4/15 7:50,328,69,259,
3150,46,2022/4/15 8:00,326,72,254,
3151,46,2022/4/15 8:10,301,72,229,
3152,46,2022/4/15 8:20,254,106,148,
3153,46,2022/4/15 8:30,184,100,84,
3154,46,2022/4/15 8:40,163,87,76,
3155,46,2022/4/15 8:50,104,73,31,
3156,46,2022/4/15 9:00,68,84,-16,
3157,46,2022/4/15 9:10,49,55,-6,
3158,46,2022/4/15 9:20,43,48,-5,
3159,46,2022/4/15 9:30,32,40,-8,
3160,46,2022/4/15 9:40,32,63,-31,
3161,46,2022/4/15 9:50,27,38,-11,
3162,46,2022/4/15 10:00,28,61,-33,
3163,46,2022/4/15 10:10,27,45,-18,
3164,46,2022/4/15 10:20,25,8,17,
3165,46,2022/4/15 10:30,20,51,-31,
3166,46,2022/4/15 10:40,23,50,-27,
3167,46,2022/4/15 10:50,23,41,-18,
3168,46,2022/4/15 11:00,18,45,-27,
3169,46,2022/4/15 11:10,23,38,-15,
3170,46,2022/4/15 11:20,17,23,-6,
3171,46,2022/4/15 11:30,20,44,-24,
3172,46,2022/4/15 11:40,20,48,-28,
3173,46,2022/4/15 11:50,22,49,-27,
3174,46,2022/4/15 12:00,22,45,-23,
3175,46,2022/4/15 12:10,23,22,1,
3176,46,2022/4/15 12:20,27,40,-13,
3177,46,2022/4/15 12:30,19,62,-43,
3178,46,2022/4/15 12:40,23,56,-33,
3179,46,2022/4/15 12:50,24,51,-27,
3180,46,2022/4/15 13:00,23,49,-26,
3181,46,2022/4/15 13:10,22,23,-1,
3182,46,2022/4/15 13:20,19,46,-27,
3183,46,2022/4/15 13:30,20,52,-32,
3184,46,2022/4/15 13:40,21,48,-27,
3185,46,2022/4/15 13:50,19,50,-31,
3186,46,2022/4/15 14:00,17,60,-43,
3187,46,2022/4/15 14:10,20,32,-12,
3188,46,2022/4/15 14:20,17,47,-30,
3189,46,2022/4/15 14:30,16,64,-48,
3190,46,2022/4/15 14:40,20,65,-45,
3191,46,2022/4/15 14:50,20,61,-41,
3192,46,2022/4/15 15:00,17,66,-49,
3193,46,2022/4/15 15:10,17,35,-18,
3194,46,2022/4/15 15:20,20,57,-37,
3195,46,2022/4/15 15:30,15,68,-53,
3196,46,2022/4/15 15:40,21,72,-51,
3197,46,2022/4/15 15:50,22,77,-55,
3198,46,2022/4/15 16:00,21,77,-56,
3199,46,2022/4/15 16:10,30,43,-13,
3200,46,2022/4/15 16:20,28,68,-40,
3201,46,2022/4/15 16:30,27,75,-48,
3202,46,2022/4/15 16:40,28,106,-78,
3203,46,2022/4/15 16:50,34,78,-44,
3204,46,2022/4/15 17:00,31,77,-46,
3205,46,2022/4/15 17:10,44,76,-32,
3206,46,2022/4/15 17:20,35,115,-80,
3207,46,2022/4/15 17:30,30,103,-73,
3208,46,2022/4/15 17:40,30,105,-75,
3209,46,2022/4/15 17:50,35,105,-70,
3210,46,2022/4/15 18:00,29,151,-122,
3211,46,2022/4/15 18:10,28,128,-100,
3212,46,2022/4/15 18:20,29,110,-81,
3213,46,2022/4/15 18:30,28,112,-84,
3214,46,2022/4/15 18:40,20,235,-215,
3215,46,2022/4/15 18:50,20,111,-91,
3216,46,2022/4/15 19:00,19,105,-86,
3217,46,2022/4/15 19:10,15,114,-99,
3218,46,2022/4/15 19:20,15,139,-124,
3219,46,2022/4/15 19:30,14,104,-90,
3220,46,2022/4/15 19:40,16,106,-90,
3221,46,2022/4/15 19:50,12,76,-64,
3222,46,2022/4/15 20:00,14,114,-100,
3223,46,2022/4/15 20:10,13,71,-58,
3224,46,2022/4/15 20:20,12,78,-66,
3225,46,2022/4/15 20:30,11,54,-43,
3226,46,2022/4/15 20:40,13,98,-85,
3227,46,2022/4/15 20:50,14,66,-52,
3228,46,2022/4/15 21:00,10,92,-82,
3229,46,2022/4/15 21:10,15,47,-32,
3230,46,2022/4/15 21:20,11,95,-84,
3231,46,2022/4/15 21:30,8,71,-63,
3232,46,2022/4/15 21:40,7,73,-66,
3233,46,2022/4/15 21:50,5,86,-81,
3234,46,2022/4/15 22:00,4,43,-39,
3235,46,2022/4/15 22:10,2,96,-94,
3236,46,2022/4/15 22:20,2,83,-81,
3237,46,2022/4/15 22:30,2,64,-62,
3238,46,2022/4/15 22:40,0,63,-63,
3239,46,2022/4/15 22:50,0,54,-54,
3240,49,2022/4/15 5:00,0,1,-1,
3241,49,2022/4/15 5:10,0,1,-1,
3242,49,2022/4/15 5:20,7,1,6,
3243,49,2022/4/15 5:30,20,1,19,
3244,49,2022/4/15 5:40,19,1,18,
3245,49,2022/4/15 5:50,21,1,20,
3246,49,2022/4/15 6:00,26,1,25,
3247,49,2022/4/15 6:10,34,1,33,
3248,49,2022/4/15 6:20,40,2,38,
3249,49,2022/4/15 6:30,58,5,53,
3250,49,2022/4/15 6:40,100,34,66,
3251,49,2022/4/15 6:50,180,38,142,
3252,49,2022/4/15 7:00,169,23,146,
3253,49,2022/4/15 7:10,254,65,189,
3254,49,2022/4/15 7:20,361,47,314,
3255,49,2022/4/15 7:30,325,69,256,
3256,49,2022/4/15 7:40,591,61,530,
3257,49,2022/4/15 7:50,663,65,598,
3258,49,2022/4/15 8:00,629,69,560,
3259,49,2022/4/15 8:10,592,93,499,
3260,49,2022/4/15 8:20,376,74,302,
3261,49,2022/4/15 8:30,301,74,227,
3262,49,2022/4/15 8:40,280,62,218,
3263,49,2022/4/15 8:50,218,77,141,
3264,49,2022/4/15 9:00,148,61,87,
3265,49,2022/4/15 9:10,94,45,49,
3266,49,2022/4/15 9:20,68,50,18,
3267,49,2022/4/15 9:30,53,65,-12,
3268,49,2022/4/15 9:40,40,45,-5,
3269,49,2022/4/15 9:50,33,51,-18,
3270,49,2022/4/15 10:00,31,41,-10,
3271,49,2022/4/15 10:10,29,46,-17,
3272,49,2022/4/15 10:20,27,49,-22,
3273,49,2022/4/15 10:30,27,8,19,
3274,49,2022/4/15 10:40,29,48,-19,
3275,49,2022/4/15 10:50,28,50,-22,
3276,49,2022/4/15 11:00,26,50,-24,
3277,49,2022/4/15 11:10,29,50,-21,
3278,49,2022/4/15 11:20,22,51,-29,
3279,49,2022/4/15 11:30,23,8,15,
3280,49,2022/4/15 11:40,27,61,-34,
3281,49,2022/4/15 11:50,28,60,-32,
3282,49,2022/4/15 12:00,27,51,-24,
3283,49,2022/4/15 12:10,30,62,-32,
3284,49,2022/4/15 12:20,27,51,-24,
3285,49,2022/4/15 12:30,30,8,22,
3286,49,2022/4/15 12:40,26,67,-41,
3287,49,2022/4/15 12:50,28,63,-35,
3288,49,2022/4/15 13:00,28,64,-36,
3289,49,2022/4/15 13:10,25,60,-35,
3290,49,2022/4/15 13:20,25,58,-33,
3291,49,2022/4/15 13:30,29,17,12,
3292,49,2022/4/15 13:40,22,60,-38,
3293,49,2022/4/15 13:50,26,68,-42,
3294,49,2022/4/15 14:00,21,65,-44,
3295,49,2022/4/15 14:10,22,72,-50,
3296,49,2022/4/15 14:20,20,63,-43,
3297,49,2022/4/15 14:30,22,15,7,
3298,49,2022/4/15 14:40,21,70,-49,
3299,49,2022/4/15 14:50,22,70,-48,
3300,49,2022/4/15 15:00,20,76,-56,
3301,49,2022/4/15 15:10,27,74,-47,
3302,49,2022/4/15 15:20,24,70,-46,
3303,49,2022/4/15 15:30,20,22,-2,
3304,49,2022/4/15 15:40,24,78,-54,
3305,49,2022/4/15 15:50,24,90,-66,
3306,49,2022/4/15 16:00,22,97,-75,
3307,49,2022/4/15 16:10,28,99,-71,
3308,49,2022/4/15 16:20,28,88,-60,
3309,49,2022/4/15 16:30,28,101,-73,
3310,49,2022/4/15 16:40,29,76,-47,
3311,49,2022/4/15 16:50,26,91,-65,
3312,49,2022/4/15 17:00,30,101,-71,
3313,49,2022/4/15 17:10,31,118,-87,
3314,49,2022/4/15 17:20,31,93,-62,
3315,49,2022/4/15 17:30,34,116,-82,
3316,49,2022/4/15 17:40,29,116,-87,
3317,49,2022/4/15 17:50,26,255,-229,
3318,49,2022/4/15 18:00,28,150,-122,
3319,49,2022/4/15 18:10,32,154,-122,
3320,49,2022/4/15 18:20,33,197,-164,
3321,49,2022/4/15 18:30,27,537,-510,
3322,49,2022/4/15 18:40,23,197,-174,
3323,49,2022/4/15 18:50,25,191,-166,
3324,49,2022/4/15 19:00,21,198,-177,
3325,49,2022/4/15 19:10,18,286,-268,
3326,49,2022/4/15 19:20,15,109,-94,
3327,49,2022/4/15 19:30,15,123,-108,
3328,49,2022/4/15 19:40,17,121,-104,
3329,49,2022/4/15 19:50,17,126,-109,
3330,49,2022/4/15 20:00,14,97,-83,
3331,49,2022/4/15 20:10,14,95,-81,
3332,49,2022/4/15 20:20,14,110,-96,
3333,49,2022/4/15 20:30,15,107,-92,
3334,49,2022/4/15 20:40,15,78,-63,
3335,49,2022/4/15 20:50,14,92,-78,
3336,49,2022/4/15 21:00,13,110,-97,
3337,49,2022/4/15 21:10,14,106,-92,
3338,49,2022/4/15 21:20,8,89,-81,
3339,49,2022/4/15 21:30,10,97,-87,
3340,49,2022/4/15 21:40,9,100,-91,
3341,49,2022/4/15 21:50,7,95,-88,
3342,49,2022/4/15 22:00,7,104,-97,
3343,49,2022/4/15 22:10,10,95,-85,
3344,49,2022/4/15 22:20,3,85,-82,
3345,49,2022/4/15 22:30,2,78,-76,
3346,49,2022/4/15 22:40,1,92,-91,
3347,49,2022/4/15 22:50,0,63,-63,
3348,48,2022/4/15 5:00,0,1,-1,
3349,48,2022/4/15 5:10,0,1,-1,
3350,48,2022/4/15 5:20,5,1,4,
3351,48,2022/4/15 5:30,25,1,24,
3352,48,2022/4/15 5:40,25,1,24,
3353,48,2022/4/15 5:50,30,1,29,
3354,48,2022/4/15 6:00,32,2,30,
3355,48,2022/4/15 6:10,47,2,45,
3356,48,2022/4/15 6:20,60,5,55,
3357,48,2022/4/15 6:30,79,5,74,
3358,48,2022/4/15 6:40,149,61,88,
3359,48,2022/4/15 6:50,176,38,138,
3360,48,2022/4/15 7:00,223,52,171,
3361,48,2022/4/15 7:10,321,54,267,
3362,48,2022/4/15 7:20,369,67,302,
3363,48,2022/4/15 7:30,654,62,592,
3364,48,2022/4/15 7:40,737,88,649,
3365,48,2022/4/15 7:50,1186,76,1110,
3366,48,2022/4/15 8:00,1177,76,1101,
3367,48,2022/4/15 8:10,1175,79,1096,
3368,48,2022/4/15 8:20,736,76,660,
3369,48,2022/4/15 8:30,638,81,557,
3370,48,2022/4/15 8:40,442,79,363,
3371,48,2022/4/15 8:50,318,67,251,
3372,48,2022/4/15 9:00,274,83,191,
3373,48,2022/4/15 9:10,191,73,118,
3374,48,2022/4/15 9:20,149,64,85,
3375,48,2022/4/15 9:30,78,64,14,
3376,48,2022/4/15 9:40,67,68,-1,
3377,48,2022/4/15 9:50,47,69,-22,
3378,48,2022/4/15 10:00,44,73,-29,
3379,48,2022/4/15 10:10,42,58,-16,
3380,48,2022/4/15 10:20,40,68,-28,
3381,48,2022/4/15 10:30,30,72,-42,
3382,48,2022/4/15 10:40,37,64,-27,
3383,48,2022/4/15 10:50,32,74,-42,
3384,48,2022/4/15 11:00,29,69,-40,
3385,48,2022/4/15 11:10,32,61,-29,
3386,48,2022/4/15 11:20,31,64,-33,
3387,48,2022/4/15 11:30,32,83,-51,
3388,48,2022/4/15 11:40,29,61,-32,
3389,48,2022/4/15 11:50,33,77,-44,
3390,48,2022/4/15 12:00,34,71,-37,
3391,48,2022/4/15 12:10,34,69,-35,
3392,48,2022/4/15 12:20,37,70,-33,
3393,48,2022/4/15 12:30,38,77,-39,
3394,48,2022/4/15 12:40,38,70,-32,
3395,48,2022/4/15 12:50,34,76,-42,
3396,48,2022/4/15 13:00,36,68,-32,
3397,48,2022/4/15 13:10,28,64,-36,
3398,48,2022/4/15 13:20,30,81,-51,
3399,48,2022/4/15 13:30,34,76,-42,
3400,48,2022/4/15 13:40,36,66,-30,
3401,48,2022/4/15 13:50,29,76,-47,
3402,48,2022/4/15 14:00,29,73,-44,
3403,48,2022/4/15 14:10,29,70,-41,
3404,48,2022/4/15 14:20,29,77,-48,
3405,48,2022/4/15 14:30,26,93,-67,
3406,48,2022/4/15 14:40,29,71,-42,
3407,48,2022/4/15 14:50,27,93,-66,
3408,48,2022/4/15 15:00,27,80,-53,
3409,48,2022/4/15 15:10,27,75,-48,
3410,48,2022/4/15 15:20,27,99,-72,
3411,48,2022/4/15 15:30,28,108,-80,
3412,48,2022/4/15 15:40,27,73,-46,
3413,48,2022/4/15 15:50,27,101,-74,
3414,48,2022/4/15 16:00,28,103,-75,
3415,48,2022/4/15 16:10,30,91,-61,
3416,48,2022/4/15 16:20,31,101,-70,
3417,48,2022/4/15 16:30,31,106,-75,
3418,48,2022/4/15 16:40,37,125,-88,
3419,48,2022/4/15 16:50,35,114,-79,
3420,48,2022/4/15 17:00,37,110,-73,
3421,48,2022/4/15 17:10,39,109,-70,
3422,48,2022/4/15 17:20,45,152,-107,
3423,48,2022/4/15 17:30,44,177,-133,
3424,48,2022/4/15 17:40,45,195,-150,
3425,48,2022/4/15 17:50,44,212,-168,
3426,48,2022/4/15 18:00,35,380,-345,
3427,48,2022/4/15 18:10,43,325,-282,
3428,48,2022/4/15 18:20,33,433,-400,
3429,48,2022/4/15 18:30,29,329,-300,
3430,48,2022/4/15 18:40,28,421,-393,
3431,48,2022/4/15 18:50,30,537,-507,
3432,48,2022/4/15 19:00,28,536,-508,
3433,48,2022/4/15 19:10,29,235,-206,
3434,48,2022/4/15 19:20,28,285,-257,
3435,48,2022/4/15 19:30,24,191,-167,
3436,48,2022/4/15 19:40,26,150,-124,
3437,48,2022/4/15 19:50,29,107,-78,
3438,48,2022/4/15 20:00,22,124,-102,
3439,48,2022/4/15 20:10,28,116,-88,
3440,48,2022/4/15 20:20,24,114,-90,
3441,48,2022/4/15 20:30,29,106,-77,
3442,48,2022/4/15 20:40,24,124,-100,
3443,48,2022/4/15 20:50,25,111,-86,
3444,48,2022/4/15 21:00,25,124,-99,
3445,48,2022/4/15 21:10,28,110,-82,
3446,48,2022/4/15 21:20,26,115,-89,
3447,48,2022/4/15 21:30,24,101,-77,
3448,48,2022/4/15 21:40,22,100,-78,
3449,48,2022/4/15 21:50,21,110,-89,
3450,48,2022/4/15 22:00,21,113,-92,
3451,48,2022/4/15 22:10,17,109,-92,
3452,48,2022/4/15 22:20,10,93,-83,
3453,48,2022/4/15 22:30,6,113,-107,
3454,48,2022/4/15 22:40,2,124,-122,
3455,48,2022/4/15 22:50,1,74,-73,
3456,41,2022/4/15 5:00,0,1,-1,
3457,41,2022/4/15 5:10,0,1,-1,
3458,41,2022/4/15 5:20,0,1,-1,
3459,41,2022/4/15 5:30,1,1,0,
3460,41,2022/4/15 5:40,8,1,7,
3461,41,2022/4/15 5:50,7,2,5,
3462,41,2022/4/15 6:00,9,5,4,
3463,41,2022/4/15 6:10,13,5,8,
3464,41,2022/4/15 6:20,17,8,9,
3465,41,2022/4/15 6:30,26,22,4,
3466,41,2022/4/15 6:40,27,21,6,
3467,41,2022/4/15 6:50,33,30,3,
3468,41,2022/4/15 7:00,36,33,3,
3469,41,2022/4/15 7:10,34,35,-1,
3470,41,2022/4/15 7:20,54,46,8,
3471,41,2022/4/15 7:30,57,49,8,
3472,41,2022/4/15 7:40,98,67,31,
3473,41,2022/4/15 7:50,72,69,3,
3474,41,2022/4/15 8:00,149,93,56,
3475,41,2022/4/15 8:10,72,87,-15,
3476,41,2022/4/15 8:20,103,79,24,
3477,41,2022/4/15 8:30,54,62,-8,
3478,41,2022/4/15 8:40,57,68,-11,
3479,41,2022/4/15 8:50,35,55,-20,
3480,41,2022/4/15 9:00,36,45,-9,
3481,41,2022/4/15 9:10,26,37,-11,
3482,41,2022/4/15 9:20,26,42,-16,
3483,41,2022/4/15 9:30,20,32,-12,
3484,41,2022/4/15 9:40,14,25,-11,
3485,41,2022/4/15 9:50,16,23,-7,
3486,41,2022/4/15 10:00,14,30,-16,
3487,41,2022/4/15 10:10,12,29,-17,
3488,41,2022/4/15 10:20,13,21,-8,
3489,41,2022/4/15 10:30,12,23,-11,
3490,41,2022/4/15 10:40,11,19,-8,
3491,41,2022/4/15 10:50,11,21,-10,
3492,41,2022/4/15 11:00,10,21,-11,
3493,41,2022/4/15 11:10,11,19,-8,
3494,41,2022/4/15 11:20,12,21,-9,
3495,41,2022/4/15 11:30,10,21,-11,
3496,41,2022/4/15 11:40,11,19,-8,
3497,41,2022/4/15 11:50,8,21,-13,
3498,41,2022/4/15 12:00,12,31,-19,
3499,41,2022/4/15 12:10,13,21,-8,
3500,41,2022/4/15 12:20,12,23,-11,
3501,41,2022/4/15 12:30,12,28,-16,
3502,41,2022/4/15 12:40,15,21,-6,
3503,41,2022/4/15 12:50,13,25,-12,
3504,41,2022/4/15 13:00,11,25,-14,
3505,41,2022/4/15 13:10,12,23,-11,
3506,41,2022/4/15 13:20,12,31,-19,
3507,41,2022/4/15 13:30,10,29,-19,
3508,41,2022/4/15 13:40,9,21,-12,
3509,41,2022/4/15 13:50,9,23,-14,
3510,41,2022/4/15 14:00,9,32,-23,
3511,41,2022/4/15 14:10,11,25,-14,
3512,41,2022/4/15 14:20,13,31,-18,
3513,41,2022/4/15 14:30,12,32,-20,
3514,41,2022/4/15 14:40,9,23,-14,
3515,41,2022/4/15 14:50,9,25,-16,
3516,41,2022/4/15 15:00,10,35,-25,
3517,41,2022/4/15 15:10,12,25,-13,
3518,41,2022/4/15 15:20,10,32,-22,
3519,41,2022/4/15 15:30,13,40,-27,
3520,41,2022/4/15 15:40,12,32,-20,
3521,41,2022/4/15 15:50,14,38,-24,
3522,41,2022/4/15 16:00,14,46,-32,
3523,41,2022/4/15 16:10,17,37,-20,
3524,41,2022/4/15 16:20,17,44,-27,
3525,41,2022/4/15 16:30,24,45,-21,
3526,41,2022/4/15 16:40,25,52,-27,
3527,41,2022/4/15 16:50,23,46,-23,
3528,41,2022/4/15 17:00,29,61,-32,
3529,41,2022/4/15 17:10,26,57,-31,
3530,41,2022/4/15 17:20,29,75,-46,
3531,41,2022/4/15 17:30,25,70,-45,
3532,41,2022/4/15 17:40,29,93,-64,
3533,41,2022/4/15 17:50,28,76,-48,
3534,41,2022/4/15 18:00,24,97,-73,
3535,41,2022/4/15 18:10,26,77,-51,
3536,41,2022/4/15 18:20,25,106,-81,
3537,41,2022/4/15 18:30,17,77,-60,
3538,41,2022/4/15 18:40,16,107,-91,
3539,41,2022/4/15 18:50,14,85,-71,
3540,41,2022/4/15 19:00,14,76,-62,
3541,41,2022/4/15 19:10,12,71,-59,
3542,41,2022/4/15 19:20,10,61,-51,
3543,41,2022/4/15 19:30,7,57,-50,
3544,41,2022/4/15 19:40,8,54,-46,
3545,41,2022/4/15 19:50,7,46,-39,
3546,41,2022/4/15 20:00,5,55,-50,
3547,41,2022/4/15 20:10,5,33,-28,
3548,41,2022/4/15 20:20,6,47,-41,
3549,41,2022/4/15 20:30,6,39,-33,
3550,41,2022/4/15 20:40,8,52,-44,
3551,41,2022/4/15 20:50,6,36,-30,
3552,41,2022/4/15 21:00,7,47,-40,
3553,41,2022/4/15 21:10,6,37,-31,
3554,41,2022/4/15 21:20,4,34,-30,
3555,41,2022/4/15 21:30,8,47,-39,
3556,41,2022/4/15 21:40,6,40,-34,
3557,41,2022/4/15 21:50,2,36,-34,
3558,41,2022/4/15 22:00,2,40,-38,
3559,41,2022/4/15 22:10,1,32,-31,
3560,41,2022/4/15 22:20,2,35,-33,
3561,41,2022/4/15 22:30,1,41,-40,
3562,41,2022/4/15 22:40,0,32,-32,
3563,41,2022/4/15 22:50,0,8,-8,
3564,57,2022/4/15 5:00,0,1,-1,
3565,57,2022/4/15 5:10,0,1,-1,
3566,57,2022/4/15 5:20,0,1,-1,
3567,57,2022/4/15 5:30,0,1,-1,
3568,57,2022/4/15 5:40,2,1,1,
3569,57,2022/4/15 5:50,3,1,2,
3570,57,2022/4/15 6:00,3,1,2,
3571,57,2022/4/15 6:10,6,1,5,
3572,57,2022/4/15 6:20,10,1,9,
3573,57,2022/4/15 6:30,11,19,-8,
3574,57,2022/4/15 6:40,15,16,-1,
3575,57,2022/4/15 6:50,16,21,-5,
3576,57,2022/4/15 7:00,20,31,-11,
3577,57,2022/4/15 7:10,23,33,-10,
3578,57,2022/4/15 7:20,21,64,-43,
3579,57,2022/4/15 7:30,26,64,-38,
3580,57,2022/4/15 7:40,31,62,-31,
3581,57,2022/4/15 7:50,33,103,-70,
3582,57,2022/4/15 8:00,29,126,-97,
3583,57,2022/4/15 8:10,32,107,-75,
3584,57,2022/4/15 8:20,30,97,-67,
3585,57,2022/4/15 8:30,29,92,-63,
3586,57,2022/4/15 8:40,27,105,-78,
3587,57,2022/4/15 8:50,22,96,-74,
3588,57,2022/4/15 9:00,17,64,-47,
3589,57,2022/4/15 9:10,14,94,-80,
3590,57,2022/4/15 9:20,13,77,-64,
3591,57,2022/4/15 9:30,12,69,-57,
3592,57,2022/4/15 9:40,12,70,-58,
3593,57,2022/4/15 9:50,10,74,-64,
3594,57,2022/4/15 10:00,9,50,-41,
3595,57,2022/4/15 10:10,12,58,-46,
3596,57,2022/4/15 10:20,10,37,-27,
3597,57,2022/4/15 10:30,9,23,-14,
3598,57,2022/4/15 10:40,10,33,-23,
3599,57,2022/4/15 10:50,11,23,-12,
3600,57,2022/4/15 11:00,14,23,-9,
3601,57,2022/4/15 11:10,10,23,-13,
3602,57,2022/4/15 11:20,9,21,-12,
3603,57,2022/4/15 11:30,10,16,-6,
3604,57,2022/4/15 11:40,13,23,-10,
3605,57,2022/4/15 11:50,19,19,0,
3606,57,2022/4/15 12:00,20,23,-3,
3607,57,2022/4/15 12:10,20,24,-4,
3608,57,2022/4/15 12:20,16,22,-6,
3609,57,2022/4/15 12:30,13,23,-10,
3610,57,2022/4/15 12:40,16,36,-20,
3611,57,2022/4/15 12:50,12,30,-18,
3612,57,2022/4/15 13:00,12,32,-20,
3613,57,2022/4/15 13:10,12,37,-25,
3614,57,2022/4/15 13:20,12,32,-20,
3615,57,2022/4/15 13:30,13,34,-21,
3616,57,2022/4/15 13:40,14,37,-23,
3617,57,2022/4/15 13:50,14,29,-15,
3618,57,2022/4/15 14:00,12,33,-21,
3619,57,2022/4/15 14:10,14,38,-24,
3620,57,2022/4/15 14:20,15,31,-16,
3621,57,2022/4/15 14:30,20,23,-3,
3622,57,2022/4/15 14:40,34,37,-3,
3623,57,2022/4/15 14:50,29,21,8,
3624,57,2022/4/15 15:00,18,28,-10,
3625,57,2022/4/15 15:10,19,31,-12,
3626,57,2022/4/15 15:20,16,23,-7,
3627,57,2022/4/15 15:30,22,23,-1,
3628,57,2022/4/15 15:40,26,33,-7,
3629,57,2022/4/15 15:50,24,32,-8,
3630,57,2022/4/15 16:00,19,31,-12,
3631,57,2022/4/15 16:10,21,36,-15,
3632,57,2022/4/15 16:20,25,31,-6,
3633,57,2022/4/15 16:30,25,38,-13,
3634,57,2022/4/15 16:40,25,38,-13,
3635,57,2022/4/15 16:50,25,44,-19,
3636,57,2022/4/15 17:00,35,38,-3,
3637,57,2022/4/15 17:10,43,52,-9,
3638,57,2022/4/15 17:20,30,37,-7,
3639,57,2022/4/15 17:30,32,57,-25,
3640,57,2022/4/15 17:40,40,49,-9,
3641,57,2022/4/15 17:50,27,58,-31,
3642,57,2022/4/15 18:00,35,53,-18,
3643,57,2022/4/15 18:10,30,61,-31,
3644,57,2022/4/15 18:20,25,51,-26,
3645,57,2022/4/15 18:30,27,59,-32,
3646,57,2022/4/15 18:40,28,50,-22,
3647,57,2022/4/15 18:50,21,52,-31,
3648,57,2022/4/15 19:00,20,41,-21,
3649,57,2022/4/15 19:10,18,43,-25,
3650,57,2022/4/15 19:20,14,33,-19,
3651,57,2022/4/15 19:30,12,39,-27,
3652,57,2022/4/15 19:40,12,25,-13,
3653,57,2022/4/15 19:50,12,25,-13,
3654,57,2022/4/15 20:00,10,23,-13,
3655,57,2022/4/15 20:10,11,27,-16,
3656,57,2022/4/15 20:20,9,23,-14,
3657,57,2022/4/15 20:30,10,32,-22,
3658,57,2022/4/15 20:40,14,25,-11,
3659,57,2022/4/15 20:50,10,25,-15,
3660,57,2022/4/15 21:00,7,23,-16,
3661,57,2022/4/15 21:10,6,25,-19,
3662,57,2022/4/15 21:20,8,25,-17,
3663,57,2022/4/15 21:30,5,25,-20,
3664,57,2022/4/15 21:40,7,25,-18,
3665,57,2022/4/15 21:50,6,27,-21,
3666,57,2022/4/15 22:00,5,23,-18,
3667,57,2022/4/15 22:10,4,18,-14,
3668,57,2022/4/15 22:20,2,21,-19,
3669,57,2022/4/15 22:30,1,21,-20,
3670,57,2022/4/15 22:40,1,15,-14,
3671,57,2022/4/15 22:50,0,3,-3,
3672,40,2022/4/15 5:00,0,1,-1,
3673,40,2022/4/15 5:10,0,1,-1,
3674,40,2022/4/15 5:20,0,1,-1,
3675,40,2022/4/15 5:30,2,1,1,
3676,40,2022/4/15 5:40,5,1,4,
3677,40,2022/4/15 5:50,8,7,1,
3678,40,2022/4/15 6:00,11,6,5,
3679,40,2022/4/15 6:10,16,6,10,
3680,40,2022/4/15 6:20,25,18,7,
3681,40,2022/4/15 6:30,29,56,-27,
3682,40,2022/4/15 6:40,30,54,-24,
3683,40,2022/4/15 6:50,35,49,-14,
3684,40,2022/4/15 7:00,42,89,-47,
3685,40,2022/4/15 7:10,51,88,-37,
3686,40,2022/4/15 7:20,58,118,-60,
3687,40,2022/4/15 7:30,86,108,-22,
3688,40,2022/4/15 7:40,126,111,15,
3689,40,2022/4/15 7:50,168,123,45,
3690,40,2022/4/15 8:00,149,134,15,
3691,40,2022/4/15 8:10,122,121,1,
3692,40,2022/4/15 8:20,146,104,42,
3693,40,2022/4/15 8:30,77,109,-32,
3694,40,2022/4/15 8:40,59,143,-84,
3695,40,2022/4/15 8:50,49,107,-58,
3696,40,2022/4/15 9:00,36,99,-63,
3697,40,2022/4/15 9:10,39,84,-45,
3698,40,2022/4/15 9:20,33,99,-66,
3699,40,2022/4/15 9:30,27,73,-46,
3700,40,2022/4/15 9:40,25,79,-54,
3701,40,2022/4/15 9:50,24,74,-50,
3702,40,2022/4/15 10:00,25,84,-59,
3703,40,2022/4/15 10:10,23,59,-36,
3704,40,2022/4/15 10:20,23,59,-36,
3705,40,2022/4/15 10:30,24,71,-47,
3706,40,2022/4/15 10:40,24,60,-36,
3707,40,2022/4/15 10:50,23,63,-40,
3708,40,2022/4/15 11:00,24,51,-27,
3709,40,2022/4/15 11:10,26,51,-25,
3710,40,2022/4/15 11:20,23,57,-34,
3711,40,2022/4/15 11:30,20,60,-40,
3712,40,2022/4/15 11:40,21,52,-31,
3713,40,2022/4/15 11:50,25,60,-35,
3714,40,2022/4/15 12:00,27,61,-34,
3715,40,2022/4/15 12:10,20,50,-30,
3716,40,2022/4/15 12:20,23,64,-41,
3717,40,2022/4/15 12:30,26,61,-35,
3718,40,2022/4/15 12:40,22,62,-40,
3719,40,2022/4/15 12:50,22,62,-40,
3720,40,2022/4/15 13:00,22,56,-34,
3721,40,2022/4/15 13:10,21,56,-35,
3722,40,2022/4/15 13:20,24,53,-29,
3723,40,2022/4/15 13:30,25,63,-38,
3724,40,2022/4/15 13:40,24,50,-26,
3725,40,2022/4/15 13:50,26,57,-31,
3726,40,2022/4/15 14:00,25,51,-26,
3727,40,2022/4/15 14:10,24,50,-26,
3728,40,2022/4/15 14:20,22,54,-32,
3729,40,2022/4/15 14:30,25,61,-36,
3730,40,2022/4/15 14:40,61,50,11,
3731,40,2022/4/15 14:50,37,60,-23,
3732,40,2022/4/15 15:00,32,62,-30,
3733,40,2022/4/15 15:10,29,64,-35,
3734,40,2022/4/15 15:20,27,68,-41,
3735,40,2022/4/15 15:30,27,59,-32,
3736,40,2022/4/15 15:40,43,57,-14,
3737,40,2022/4/15 15:50,30,66,-36,
3738,40,2022/4/15 16:00,28,59,-31,
3739,40,2022/4/15 16:10,34,72,-38,
3740,40,2022/4/15 16:20,39,61,-22,
3741,40,2022/4/15 16:30,38,62,-24,
3742,40,2022/4/15 16:40,36,84,-48,
3743,40,2022/4/15 16:50,30,71,-41,
3744,40,2022/4/15 17:00,44,93,-49,
3745,40,2022/4/15 17:10,45,69,-24,
3746,40,2022/4/15 17:20,39,111,-72,
3747,40,2022/4/15 17:30,27,97,-70,
3748,40,2022/4/15 17:40,35,126,-91,
3749,40,2022/4/15 17:50,30,97,-67,
3750,40,2022/4/15 18:00,37,102,-65,
3751,40,2022/4/15 18:10,60,114,-54,
3752,40,2022/4/15 18:20,46,107,-61,
3753,40,2022/4/15 18:30,37,107,-70,
3754,40,2022/4/15 18:40,29,108,-79,
3755,40,2022/4/15 18:50,24,106,-82,
3756,40,2022/4/15 19:00,28,112,-84,
3757,40,2022/4/15 19:10,27,75,-48,
3758,40,2022/4/15 19:20,22,95,-73,
3759,40,2022/4/15 19:30,22,75,-53,
3760,40,2022/4/15 19:40,18,76,-58,
3761,40,2022/4/15 19:50,17,60,-43,
3762,40,2022/4/15 20:00,17,73,-56,
3763,40,2022/4/15 20:10,20,59,-39,
3764,40,2022/4/15 20:20,17,67,-50,
3765,40,2022/4/15 20:30,14,60,-46,
3766,40,2022/4/15 20:40,16,67,-51,
3767,40,2022/4/15 20:50,13,63,-50,
3768,40,2022/4/15 21:00,12,75,-63,
3769,40,2022/4/15 21:10,15,52,-37,
3770,40,2022/4/15 21:20,12,69,-57,
3771,40,2022/4/15 21:30,11,68,-57,
3772,40,2022/4/15 21:40,9,62,-53,
3773,40,2022/4/15 21:50,10,71,-61,
3774,40,2022/4/15 22:00,7,47,-40,
3775,40,2022/4/15 22:10,12,64,-52,
3776,40,2022/4/15 22:20,6,66,-60,
3777,40,2022/4/15 22:30,2,42,-40,
3778,40,2022/4/15 22:40,2,49,-47,
3779,40,2022/4/15 22:50,0,8,-8,
3780,53,2022/4/15 5:00,0,1,-1,
3781,53,2022/4/15 5:10,0,1,-1,
3782,53,2022/4/15 5:20,0,1,-1,
3783,53,2022/4/15 5:30,2,1,1,
3784,53,2022/4/15 5:40,2,1,1,
3785,53,2022/4/15 5:50,13,6,7,
3786,53,2022/4/15 6:00,11,2,9,
3787,53,2022/4/15 6:10,16,11,5,
3788,53,2022/4/15 6:20,25,19,6,
3789,53,2022/4/15 6:30,31,61,-30,
3790,53,2022/4/15 6:40,37,71,-34,
3791,53,2022/4/15 6:50,41,91,-50,
3792,53,2022/4/15 7:00,43,87,-44,
3793,53,2022/4/15 7:10,57,108,-51,
3794,53,2022/4/15 7:20,55,105,-50,
3795,53,2022/4/15 7:30,63,107,-44,
3796,53,2022/4/15 7:40,123,107,16,
3797,53,2022/4/15 7:50,164,125,39,
3798,53,2022/4/15 8:00,167,131,36,
3799,53,2022/4/15 8:10,181,334,-153,
3800,53,2022/4/15 8:20,186,296,-110,
3801,53,2022/4/15 8:30,149,344,-195,
3802,53,2022/4/15 8:40,93,377,-284,
3803,53,2022/4/15 8:50,79,332,-253,
3804,53,2022/4/15 9:00,62,222,-160,
3805,53,2022/4/15 9:10,53,233,-180,
3806,53,2022/4/15 9:20,52,108,-56,
3807,53,2022/4/15 9:30,41,110,-69,
3808,53,2022/4/15 9:40,38,107,-69,
3809,53,2022/4/15 9:50,29,96,-67,
3810,53,2022/4/15 10:00,29,76,-47,
3811,53,2022/4/15 10:10,28,76,-48,
3812,53,2022/4/15 10:20,27,67,-40,
3813,53,2022/4/15 10:30,25,76,-51,
3814,53,2022/4/15 10:40,29,69,-40,
3815,53,2022/4/15 10:50,28,61,-33,
3816,53,2022/4/15 11:00,28,73,-45,
3817,53,2022/4/15 11:10,28,49,-21,
3818,53,2022/4/15 11:20,27,59,-32,
3819,53,2022/4/15 11:30,25,66,-41,
3820,53,2022/4/15 11:40,27,67,-40,
3821,53,2022/4/15 11:50,26,60,-34,
3822,53,2022/4/15 12:00,27,66,-39,
3823,53,2022/4/15 12:10,28,69,-41,
3824,53,2022/4/15 12:20,23,60,-37,
3825,53,2022/4/15 12:30,26,65,-39,
3826,53,2022/4/15 12:40,25,78,-53,
3827,53,2022/4/15 12:50,23,60,-37,
3828,53,2022/4/15 13:00,23,72,-49,
3829,53,2022/4/15 13:10,23,70,-47,
3830,53,2022/4/15 13:20,28,61,-33,
3831,53,2022/4/15 13:30,27,75,-48,
3832,53,2022/4/15 13:40,24,68,-44,
3833,53,2022/4/15 13:50,29,62,-33,
3834,53,2022/4/15 14:00,25,72,-47,
3835,53,2022/4/15 14:10,26,67,-41,
3836,53,2022/4/15 14:20,31,52,-21,
3837,53,2022/4/15 14:30,23,67,-44,
3838,53,2022/4/15 14:40,22,64,-42,
3839,53,2022/4/15 14:50,26,60,-34,
3840,53,2022/4/15 15:00,27,64,-37,
3841,53,2022/4/15 15:10,29,73,-44,
3842,53,2022/4/15 15:20,31,59,-28,
3843,53,2022/4/15 15:30,26,72,-46,
3844,53,2022/4/15 15:40,26,78,-52,
3845,53,2022/4/15 15:50,36,59,-23,
3846,53,2022/4/15 16:00,35,63,-28,
3847,53,2022/4/15 16:10,35,70,-35,
3848,53,2022/4/15 16:20,38,77,-39,
3849,53,2022/4/15 16:30,44,85,-41,
3850,53,2022/4/15 16:40,44,82,-38,
3851,53,2022/4/15 16:50,43,87,-44,
3852,53,2022/4/15 17:00,85,90,-5,
3853,53,2022/4/15 17:10,169,99,70,
3854,53,2022/4/15 17:20,140,108,32,
3855,53,2022/4/15 17:30,175,106,69,
3856,53,2022/4/15 17:40,233,103,130,
3857,53,2022/4/15 17:50,217,127,90,
3858,53,2022/4/15 18:00,223,125,98,
3859,53,2022/4/15 18:10,304,121,183,
3860,53,2022/4/15 18:20,267,125,142,
3861,53,2022/4/15 18:30,191,110,81,
3862,53,2022/4/15 18:40,164,121,43,
3863,53,2022/4/15 18:50,82,88,-6,
3864,53,2022/4/15 19:00,69,106,-37,
3865,53,2022/4/15 19:10,50,102,-52,
3866,53,2022/4/15 19:20,45,91,-46,
3867,53,2022/4/15 19:30,41,89,-48,
3868,53,2022/4/15 19:40,40,79,-39,
3869,53,2022/4/15 19:50,33,73,-40,
3870,53,2022/4/15 20:00,35,72,-37,
3871,53,2022/4/15 20:10,31,64,-33,
3872,53,2022/4/15 20:20,30,60,-30,
3873,53,2022/4/15 20:30,30,63,-33,
3874,53,2022/4/15 20:40,33,67,-34,
3875,53,2022/4/15 20:50,29,71,-42,
3876,53,2022/4/15 21:00,35,56,-21,
3877,53,2022/4/15 21:10,27,63,-36,
3878,53,2022/4/15 21:20,26,62,-36,
3879,53,2022/4/15 21:30,25,65,-40,
3880,53,2022/4/15 21:40,28,58,-30,
3881,53,2022/4/15 21:50,29,70,-41,
3882,53,2022/4/15 22:00,24,59,-35,
3883,53,2022/4/15 22:10,24,48,-24,
3884,53,2022/4/15 22:20,17,51,-34,
3885,53,2022/4/15 22:30,10,49,-39,
3886,53,2022/4/15 22:40,4,18,-14,
3887,53,2022/4/15 22:50,1,10,-9,
3888,38,2022/4/15 5:00,0,1,-1,
3889,38,2022/4/15 5:10,0,1,-1,
3890,38,2022/4/15 5:20,3,1,2,
3891,38,2022/4/15 5:30,6,1,5,
3892,38,2022/4/15 5:40,18,1,17,
3893,38,2022/4/15 5:50,20,1,19,
3894,38,2022/4/15 6:00,20,19,1,
3895,38,2022/4/15 6:10,30,21,9,
3896,38,2022/4/15 6:20,31,57,-26,
3897,38,2022/4/15 6:30,42,65,-23,
3898,38,2022/4/15 6:40,54,74,-20,
3899,38,2022/4/15 6:50,65,114,-49,
3900,38,2022/4/15 7:00,75,120,-45,
3901,38,2022/4/15 7:10,124,226,-102,
3902,38,2022/4/15 7:20,104,180,-76,
3903,38,2022/4/15 7:30,157,144,13,
3904,38,2022/4/15 7:40,197,192,5,
3905,38,2022/4/15 7:50,239,299,-60,
3906,38,2022/4/15 8:00,279,509,-230,
3907,38,2022/4/15 8:10,279,575,-296,
3908,38,2022/4/15 8:20,251,586,-335,
3909,38,2022/4/15 8:30,247,1505,-1258,
3910,38,2022/4/15 8:40,207,1873,-1666,
3911,38,2022/4/15 8:50,192,1120,-928,
3912,38,2022/4/15 9:00,139,584,-445,
3913,38,2022/4/15 9:10,84,426,-342,
3914,38,2022/4/15 9:20,77,343,-266,
3915,38,2022/4/15 9:30,64,196,-132,
3916,38,2022/4/15 9:40,62,212,-150,
3917,38,2022/4/15 9:50,48,167,-119,
3918,38,2022/4/15 10:00,43,117,-74,
3919,38,2022/4/15 10:10,43,126,-83,
3920,38,2022/4/15 10:20,43,112,-69,
3921,38,2022/4/15 10:30,42,111,-69,
3922,38,2022/4/15 10:40,39,110,-71,
3923,38,2022/4/15 10:50,37,93,-56,
3924,38,2022/4/15 11:00,37,78,-41,
3925,38,2022/4/15 11:10,43,93,-50,
3926,38,2022/4/15 11:20,37,90,-53,
3927,38,2022/4/15 11:30,41,81,-40,
3928,38,2022/4/15 11:40,44,93,-49,
3929,38,2022/4/15 11:50,41,81,-40,
3930,38,2022/4/15 12:00,41,90,-49,
3931,38,2022/4/15 12:10,44,100,-56,
3932,38,2022/4/15 12:20,42,93,-51,
3933,38,2022/4/15 12:30,44,105,-61,
3934,38,2022/4/15 12:40,44,112,-68,
3935,38,2022/4/15 12:50,43,106,-63,
3936,38,2022/4/15 13:00,38,110,-72,
3937,38,2022/4/15 13:10,46,112,-66,
3938,38,2022/4/15 13:20,41,101,-60,
3939,38,2022/4/15 13:30,35,101,-66,
3940,38,2022/4/15 13:40,36,105,-69,
3941,38,2022/4/15 13:50,39,99,-60,
3942,38,2022/4/15 14:00,41,102,-61,
3943,38,2022/4/15 14:10,42,96,-54,
3944,38,2022/4/15 14:20,41,91,-50,
3945,38,2022/4/15 14:30,43,90,-47,
3946,38,2022/4/15 14:40,43,97,-54,
3947,38,2022/4/15 14:50,47,97,-50,
3948,38,2022/4/15 15:00,55,98,-43,
3949,38,2022/4/15 15:10,63,105,-42,
3950,38,2022/4/15 15:20,65,80,-15,
3951,38,2022/4/15 15:30,65,103,-38,
3952,38,2022/4/15 15:40,54,104,-50,
3953,38,2022/4/15 15:50,79,92,-13,
3954,38,2022/4/15 16:00,133,102,31,
3955,38,2022/4/15 16:10,139,108,31,
3956,38,2022/4/15 16:20,134,96,38,
3957,38,2022/4/15 16:30,150,103,47,
3958,38,2022/4/15 16:40,217,87,130,
3959,38,2022/4/15 16:50,214,110,104,
3960,38,2022/4/15 17:00,270,121,149,
3961,38,2022/4/15 17:10,429,122,307,
3962,38,2022/4/15 17:20,352,120,232,
3963,38,2022/4/15 17:30,307,108,199,
3964,38,2022/4/15 17:40,578,181,397,
3965,38,2022/4/15 17:50,567,127,440,
3966,38,2022/4/15 18:00,461,226,235,
3967,38,2022/4/15 18:10,830,155,675,
3968,38,2022/4/15 18:20,673,226,447,
3969,38,2022/4/15 18:30,462,146,316,
3970,38,2022/4/15 18:40,344,178,166,
3971,38,2022/4/15 18:50,250,117,133,
3972,38,2022/4/15 19:00,179,117,62,
3973,38,2022/4/15 19:10,169,126,43,
3974,38,2022/4/15 19:20,134,121,13,
3975,38,2022/4/15 19:30,67,105,-38,
3976,38,2022/4/15 19:40,70,113,-43,
3977,38,2022/4/15 19:50,53,80,-27,
3978,38,2022/4/15 20:00,52,95,-43,
3979,38,2022/4/15 20:10,62,92,-30,
3980,38,2022/4/15 20:20,48,79,-31,
3981,38,2022/4/15 20:30,49,89,-40,
3982,38,2022/4/15 20:40,47,76,-29,
3983,38,2022/4/15 20:50,43,92,-49,
3984,38,2022/4/15 21:00,43,85,-42,
3985,38,2022/4/15 21:10,63,95,-32,
3986,38,2022/4/15 21:20,43,79,-36,
3987,38,2022/4/15 21:30,44,77,-33,
3988,38,2022/4/15 21:40,37,95,-58,
3989,38,2022/4/15 21:50,29,82,-53,
3990,38,2022/4/15 22:00,31,86,-55,
3991,38,2022/4/15 22:10,29,94,-65,
3992,38,2022/4/15 22:20,29,77,-48,
3993,38,2022/4/15 22:30,22,85,-63,
3994,38,2022/4/15 22:40,13,62,-49,
3995,38,2022/4/15 22:50,9,52,-43,
3996,42,2022/4/15 5:00,0,1,-1,
3997,42,2022/4/15 5:10,0,1,-1,
3998,42,2022/4/15 5:20,0,1,-1,
3999,42,2022/4/15 5:30,0,1,-1,
4000,42,2022/4/15 5:40,3,1,2,
4001,42,2022/4/15 5:50,7,1,6,
4002,42,2022/4/15 6:00,20,2,18,
4003,42,2022/4/15 6:10,30,21,9,
4004,42,2022/4/15 6:20,32,38,-6,
4005,42,2022/4/15 6:30,38,23,15,
4006,42,2022/4/15 6:40,59,49,10,
4007,42,2022/4/15 6:50,78,72,6,
4008,42,2022/4/15 7:00,84,71,13,
4009,42,2022/4/15 7:10,177,74,103,
4010,42,2022/4/15 7:20,174,73,101,
4011,42,2022/4/15 7:30,234,109,125,
4012,42,2022/4/15 7:40,277,107,170,
4013,42,2022/4/15 7:50,275,109,166,
4014,42,2022/4/15 8:00,279,169,110,
4015,42,2022/4/15 8:10,318,178,140,
4016,42,2022/4/15 8:20,279,178,101,
4017,42,2022/4/15 8:30,282,332,-50,
4018,42,2022/4/15 8:40,238,434,-196,
4019,42,2022/4/15 8:50,195,436,-241,
4020,42,2022/4/15 9:00,143,213,-70,
4021,42,2022/4/15 9:10,135,320,-185,
4022,42,2022/4/15 9:20,79,208,-129,
4023,42,2022/4/15 9:30,66,110,-44,
4024,42,2022/4/15 9:40,48,109,-61,
4025,42,2022/4/15 9:50,40,103,-63,
4026,42,2022/4/15 10:00,38,109,-71,
4027,42,2022/4/15 10:10,39,80,-41,
4028,42,2022/4/15 10:20,31,99,-68,
4029,42,2022/4/15 10:30,32,88,-56,
4030,42,2022/4/15 10:40,27,69,-42,
4031,42,2022/4/15 10:50,29,75,-46,
4032,42,2022/4/15 11:00,33,83,-50,
4033,42,2022/4/15 11:10,32,65,-33,
4034,42,2022/4/15 11:20,30,75,-45,
4035,42,2022/4/15 11:30,30,62,-32,
4036,42,2022/4/15 11:40,28,78,-50,
4037,42,2022/4/15 11:50,29,64,-35,
4038,42,2022/4/15 12:00,32,64,-32,
4039,42,2022/4/15 12:10,31,74,-43,
4040,42,2022/4/15 12:20,28,82,-54,
4041,42,2022/4/15 12:30,35,81,-46,
4042,42,2022/4/15 12:40,30,70,-40,
4043,42,2022/4/15 12:50,32,87,-55,
4044,42,2022/4/15 13:00,32,77,-45,
4045,42,2022/4/15 13:10,31,70,-39,
4046,42,2022/4/15 13:20,30,80,-50,
4047,42,2022/4/15 13:30,32,70,-38,
4048,42,2022/4/15 13:40,34,72,-38,
4049,42,2022/4/15 13:50,31,74,-43,
4050,42,2022/4/15 14:00,32,69,-37,
4051,42,2022/4/15 14:10,26,75,-49,
4052,42,2022/4/15 14:20,33,84,-51,
4053,42,2022/4/15 14:30,32,77,-45,
4054,42,2022/4/15 14:40,33,66,-33,
4055,42,2022/4/15 14:50,28,76,-48,
4056,42,2022/4/15 15:00,30,82,-52,
4057,42,2022/4/15 15:10,30,75,-45,
4058,42,2022/4/15 15:20,29,91,-62,
4059,42,2022/4/15 15:30,34,91,-57,
4060,42,2022/4/15 15:40,31,81,-50,
4061,42,2022/4/15 15:50,30,101,-71,
4062,42,2022/4/15 16:00,44,93,-49,
4063,42,2022/4/15 16:10,40,90,-50,
4064,42,2022/4/15 16:20,45,114,-69,
4065,42,2022/4/15 16:30,47,93,-46,
4066,42,2022/4/15 16:40,48,106,-58,
4067,42,2022/4/15 16:50,48,116,-68,
4068,42,2022/4/15 17:00,112,109,3,
4069,42,2022/4/15 17:10,173,123,50,
4070,42,2022/4/15 17:20,88,124,-36,
4071,42,2022/4/15 17:30,97,169,-72,
4072,42,2022/4/15 17:40,239,116,123,
4073,42,2022/4/15 17:50,226,178,48,
4074,42,2022/4/15 18:00,198,151,47,
4075,42,2022/4/15 18:10,335,198,137,
4076,42,2022/4/15 18:20,307,144,163,
4077,42,2022/4/15 18:30,213,178,35,
4078,42,2022/4/15 18:40,204,126,78,
4079,42,2022/4/15 18:50,137,155,-18,
4080,42,2022/4/15 19:00,96,113,-17,
4081,42,2022/4/15 19:10,75,113,-38,
4082,42,2022/4/15 19:20,50,110,-60,
4083,42,2022/4/15 19:30,46,90,-44,
4084,42,2022/4/15 19:40,43,79,-36,
4085,42,2022/4/15 19:50,37,104,-67,
4086,42,2022/4/15 20:00,31,94,-63,
4087,42,2022/4/15 20:10,35,79,-44,
4088,42,2022/4/15 20:20,36,99,-63,
4089,42,2022/4/15 20:30,27,89,-62,
4090,42,2022/4/15 20:40,29,85,-56,
4091,42,2022/4/15 20:50,28,85,-57,
4092,42,2022/4/15 21:00,27,100,-73,
4093,42,2022/4/15 21:10,35,70,-35,
4094,42,2022/4/15 21:20,22,106,-84,
4095,42,2022/4/15 21:30,27,68,-41,
4096,42,2022/4/15 21:40,24,70,-46,
4097,42,2022/4/15 21:50,23,100,-77,
4098,42,2022/4/15 22:00,20,72,-52,
4099,42,2022/4/15 22:10,23,70,-47,
4100,42,2022/4/15 22:20,16,94,-78,
4101,42,2022/4/15 22:30,8,61,-53,
4102,42,2022/4/15 22:40,4,41,-37,
4103,42,2022/4/15 22:50,2,65,-63,
4104,30,2022/4/15 5:00,0,1,-1,
4105,30,2022/4/15 5:10,0,1,-1,
4106,30,2022/4/15 5:20,0,1,-1,
4107,30,2022/4/15 5:30,3,1,2,
4108,30,2022/4/15 5:40,6,1,5,
4109,30,2022/4/15 5:50,18,1,17,
4110,30,2022/4/15 6:00,20,1,19,
4111,30,2022/4/15 6:10,31,33,-2,
4112,30,2022/4/15 6:20,33,45,-12,
4113,30,2022/4/15 6:30,40,55,-15,
4114,30,2022/4/15 6:40,59,71,-12,
4115,30,2022/4/15 6:50,67,79,-12,
4116,30,2022/4/15 7:00,92,88,4,
4117,30,2022/4/15 7:10,156,114,42,
4118,30,2022/4/15 7:20,216,101,115,
4119,30,2022/4/15 7:30,235,123,112,
4120,30,2022/4/15 7:40,303,128,175,
4121,30,2022/4/15 7:50,326,180,146,
4122,30,2022/4/15 8:00,443,317,126,
4123,30,2022/4/15 8:10,476,414,62,
4124,30,2022/4/15 8:20,443,485,-42,
4125,30,2022/4/15 8:30,345,567,-222,
4126,30,2022/4/15 8:40,330,1532,-1202,
4127,30,2022/4/15 8:50,254,592,-338,
4128,30,2022/4/15 9:00,225,505,-280,
4129,30,2022/4/15 9:10,193,322,-129,
4130,30,2022/4/15 9:20,173,231,-58,
4131,30,2022/4/15 9:30,145,217,-72,
4132,30,2022/4/15 9:40,91,191,-100,
4133,30,2022/4/15 9:50,76,151,-75,
4134,30,2022/4/15 10:00,73,121,-48,
4135,30,2022/4/15 10:10,67,108,-41,
4136,30,2022/4/15 10:20,57,123,-66,
4137,30,2022/4/15 10:30,55,113,-58,
4138,30,2022/4/15 10:40,48,105,-57,
4139,30,2022/4/15 10:50,47,105,-58,
4140,30,2022/4/15 11:00,50,105,-55,
4141,30,2022/4/15 11:10,45,97,-52,
4142,30,2022/4/15 11:20,43,103,-60,
4143,30,2022/4/15 11:30,49,105,-56,
4144,30,2022/4/15 11:40,54,100,-46,
4145,30,2022/4/15 11:50,48,106,-58,
4146,30,2022/4/15 12:00,60,105,-45,
4147,30,2022/4/15 12:10,60,87,-27,
4148,30,2022/4/15 12:20,67,103,-36,
4149,30,2022/4/15 12:30,60,127,-67,
4150,30,2022/4/15 12:40,67,123,-56,
4151,30,2022/4/15 12:50,62,97,-35,
4152,30,2022/4/15 13:00,68,126,-58,
4153,30,2022/4/15 13:10,74,119,-45,
4154,30,2022/4/15 13:20,71,103,-32,
4155,30,2022/4/15 13:30,77,108,-31,
4156,30,2022/4/15 13:40,71,122,-51,
4157,30,2022/4/15 13:50,61,106,-45,
4158,30,2022/4/15 14:00,67,104,-37,
4159,30,2022/4/15 14:10,67,109,-42,
4160,30,2022/4/15 14:20,68,112,-44,
4161,30,2022/4/15 14:30,70,96,-26,
4162,30,2022/4/15 14:40,66,104,-38,
4163,30,2022/4/15 14:50,66,105,-39,
4164,30,2022/4/15 15:00,70,122,-52,
4165,30,2022/4/15 15:10,65,123,-58,
4166,30,2022/4/15 15:20,64,110,-46,
4167,30,2022/4/15 15:30,117,121,-4,
4168,30,2022/4/15 15:40,85,121,-36,
4169,30,2022/4/15 15:50,168,96,72,
4170,30,2022/4/15 16:00,146,111,35,
4171,30,2022/4/15 16:10,111,100,11,
4172,30,2022/4/15 16:20,130,97,33,
4173,30,2022/4/15 16:30,180,121,59,
4174,30,2022/4/15 16:40,170,113,57,
4175,30,2022/4/15 16:50,179,118,61,
4176,30,2022/4/15 17:00,269,143,126,
4177,30,2022/4/15 17:10,336,138,198,
4178,30,2022/4/15 17:20,269,152,117,
4179,30,2022/4/15 17:30,568,178,390,
4180,30,2022/4/15 17:40,649,225,424,
4181,30,2022/4/15 17:50,422,218,204,
4182,30,2022/4/15 18:00,620,268,352,
4183,30,2022/4/15 18:10,818,313,505,
4184,30,2022/4/15 18:20,569,217,352,
4185,30,2022/4/15 18:30,351,300,51,
4186,30,2022/4/15 18:40,310,269,41,
4187,30,2022/4/15 18:50,265,232,33,
4188,30,2022/4/15 19:00,234,153,81,
4189,30,2022/4/15 19:10,216,139,77,
4190,30,2022/4/15 19:20,179,112,67,
4191,30,2022/4/15 19:30,137,125,12,
4192,30,2022/4/15 19:40,137,108,29,
4193,30,2022/4/15 19:50,115,103,12,
4194,30,2022/4/15 20:00,96,104,-8,
4195,30,2022/4/15 20:10,113,113,0,
4196,30,2022/4/15 20:20,85,92,-7,
4197,30,2022/4/15 20:30,125,97,28,
4198,30,2022/4/15 20:40,79,106,-27,
4199,30,2022/4/15 20:50,74,92,-18,
4200,30,2022/4/15 21:00,144,78,66,
4201,30,2022/4/15 21:10,138,92,46,
4202,30,2022/4/15 21:20,89,80,9,
4203,30,2022/4/15 21:30,64,111,-47,
4204,30,2022/4/15 21:40,58,77,-19,
4205,30,2022/4/15 21:50,41,67,-26,
4206,30,2022/4/15 22:00,41,92,-51,
4207,30,2022/4/15 22:10,34,78,-44,
4208,30,2022/4/15 22:20,25,84,-59,
4209,30,2022/4/15 22:30,22,80,-58,
4210,30,2022/4/15 22:40,16,59,-43,
4211,30,2022/4/15 22:50,10,51,-41,
4212,32,2022/4/15 5:00,0,1,-1,
4213,32,2022/4/15 5:10,0,1,-1,
4214,32,2022/4/15 5:20,0,1,-1,
4215,32,2022/4/15 5:30,0,1,-1,
4216,32,2022/4/15 5:40,6,1,5,
4217,32,2022/4/15 5:50,20,1,19,
4218,32,2022/4/15 6:00,39,6,33,
4219,32,2022/4/15 6:10,43,51,-8,
4220,32,2022/4/15 6:20,55,45,10,
4221,32,2022/4/15 6:30,68,47,21,
4222,32,2022/4/15 6:40,121,70,51,
4223,32,2022/4/15 6:50,189,78,111,
4224,32,2022/4/15 7:00,222,94,128,
4225,32,2022/4/15 7:10,244,107,137,
4226,32,2022/4/15 7:20,281,106,175,
4227,32,2022/4/15 7:30,360,119,241,
4228,32,2022/4/15 7:40,475,170,305,
4229,32,2022/4/15 7:50,598,178,420,
4230,32,2022/4/15 8:00,442,117,325,
4231,32,2022/4/15 8:10,366,268,98,
4232,32,2022/4/15 8:20,341,192,149,
4233,32,2022/4/15 8:30,344,180,164,
4234,32,2022/4/15 8:40,278,180,98,
4235,32,2022/4/15 8:50,277,285,-8,
4236,32,2022/4/15 9:00,247,151,96,
4237,32,2022/4/15 9:10,201,139,62,
4238,32,2022/4/15 9:20,179,110,69,
4239,32,2022/4/15 9:30,107,109,-2,
4240,32,2022/4/15 9:40,72,112,-40,
4241,32,2022/4/15 9:50,73,97,-24,
4242,32,2022/4/15 10:00,49,101,-52,
4243,32,2022/4/15 10:10,44,114,-70,
4244,32,2022/4/15 10:20,46,80,-34,
4245,32,2022/4/15 10:30,41,79,-38,
4246,32,2022/4/15 10:40,43,80,-37,
4247,32,2022/4/15 10:50,37,81,-44,
4248,32,2022/4/15 11:00,41,87,-46,
4249,32,2022/4/15 11:10,41,79,-38,
4250,32,2022/4/15 11:20,41,83,-42,
4251,32,2022/4/15 11:30,38,94,-56,
4252,32,2022/4/15 11:40,39,69,-30,
4253,32,2022/4/15 11:50,43,90,-47,
4254,32,2022/4/15 12:00,41,101,-60,
4255,32,2022/4/15 12:10,44,81,-37,
4256,32,2022/4/15 12:20,43,93,-50,
4257,32,2022/4/15 12:30,46,106,-60,
4258,32,2022/4/15 12:40,44,78,-34,
4259,32,2022/4/15 12:50,41,103,-62,
4260,32,2022/4/15 13:00,45,111,-66,
4261,32,2022/4/15 13:10,44,76,-32,
4262,32,2022/4/15 13:20,38,100,-62,
4263,32,2022/4/15 13:30,40,98,-58,
4264,32,2022/4/15 13:40,40,73,-33,
4265,32,2022/4/15 13:50,37,96,-59,
4266,32,2022/4/15 14:00,44,108,-64,
4267,32,2022/4/15 14:10,36,68,-32,
4268,32,2022/4/15 14:20,37,94,-57,
4269,32,2022/4/15 14:30,37,105,-68,
4270,32,2022/4/15 14:40,37,76,-39,
4271,32,2022/4/15 14:50,39,105,-66,
4272,32,2022/4/15 15:00,41,111,-70,
4273,32,2022/4/15 15:10,49,84,-35,
4274,32,2022/4/15 15:20,44,112,-68,
4275,32,2022/4/15 15:30,53,104,-51,
4276,32,2022/4/15 15:40,41,81,-40,
4277,32,2022/4/15 15:50,44,108,-64,
4278,32,2022/4/15 16:00,60,123,-63,
4279,32,2022/4/15 16:10,61,96,-35,
4280,32,2022/4/15 16:20,55,106,-51,
4281,32,2022/4/15 16:30,68,126,-58,
4282,32,2022/4/15 16:40,79,103,-24,
4283,32,2022/4/15 16:50,86,125,-39,
4284,32,2022/4/15 17:00,207,103,104,
4285,32,2022/4/15 17:10,270,138,132,
4286,32,2022/4/15 17:20,214,143,71,
4287,32,2022/4/15 17:30,174,233,-59,
4288,32,2022/4/15 17:40,225,225,0,
4289,32,2022/4/15 17:50,206,298,-92,
4290,32,2022/4/15 18:00,177,285,-108,
4291,32,2022/4/15 18:10,222,328,-106,
4292,32,2022/4/15 18:20,169,284,-115,
4293,32,2022/4/15 18:30,110,301,-191,
4294,32,2022/4/15 18:40,80,285,-205,
4295,32,2022/4/15 18:50,59,235,-176,
4296,32,2022/4/15 19:00,48,192,-144,
4297,32,2022/4/15 19:10,46,154,-108,
4298,32,2022/4/15 19:20,43,128,-85,
4299,32,2022/4/15 19:30,36,110,-74,
4300,32,2022/4/15 19:40,36,109,-73,
4301,32,2022/4/15 19:50,32,106,-74,
4302,32,2022/4/15 20:00,32,128,-96,
4303,32,2022/4/15 20:10,35,107,-72,
4304,32,2022/4/15 20:20,33,100,-67,
4305,32,2022/4/15 20:30,29,100,-71,
4306,32,2022/4/15 20:40,29,77,-48,
4307,32,2022/4/15 20:50,32,129,-97,
4308,32,2022/4/15 21:00,66,83,-17,
4309,32,2022/4/15 21:10,32,125,-93,
4310,32,2022/4/15 21:20,30,78,-48,
4311,32,2022/4/15 21:30,27,107,-80,
4312,32,2022/4/15 21:40,32,103,-71,
4313,32,2022/4/15 21:50,27,94,-67,
4314,32,2022/4/15 22:00,25,95,-70,
4315,32,2022/4/15 22:10,17,110,-93,
4316,32,2022/4/15 22:20,12,77,-65,
4317,32,2022/4/15 22:30,7,108,-101,
4318,32,2022/4/15 22:40,6,64,-58,
4319,32,2022/4/15 22:50,3,66,-63,
4320,59,2022/4/15 5:00,0,1,-1,
4321,59,2022/4/15 5:10,0,1,-1,
4322,59,2022/4/15 5:20,0,1,-1,
4323,59,2022/4/15 5:30,0,1,-1,
4324,59,2022/4/15 5:40,2,1,1,
4325,59,2022/4/15 5:50,14,1,13,
4326,59,2022/4/15 6:00,29,2,27,
4327,59,2022/4/15 6:10,31,29,2,
4328,59,2022/4/15 6:20,35,32,3,
4329,59,2022/4/15 6:30,33,32,1,
4330,59,2022/4/15 6:40,54,38,16,
4331,59,2022/4/15 6:50,70,37,33,
4332,59,2022/4/15 7:00,88,50,38,
4333,59,2022/4/15 7:10,157,52,105,
4334,59,2022/4/15 7:20,186,65,121,
4335,59,2022/4/15 7:30,227,72,155,
4336,59,2022/4/15 7:40,276,80,196,
4337,59,2022/4/15 7:50,277,92,185,
4338,59,2022/4/15 8:00,318,104,214,
4339,59,2022/4/15 8:10,278,106,172,
4340,59,2022/4/15 8:20,233,104,129,
4341,59,2022/4/15 8:30,215,108,107,
4342,59,2022/4/15 8:40,199,124,75,
4343,59,2022/4/15 8:50,123,90,33,
4344,59,2022/4/15 9:00,76,95,-19,
4345,59,2022/4/15 9:10,63,77,-14,
4346,59,2022/4/15 9:20,50,62,-12,
4347,59,2022/4/15 9:30,43,70,-27,
4348,59,2022/4/15 9:40,39,71,-32,
4349,59,2022/4/15 9:50,35,79,-44,
4350,59,2022/4/15 10:00,32,69,-37,
4351,59,2022/4/15 10:10,26,60,-34,
4352,59,2022/4/15 10:20,26,71,-45,
4353,59,2022/4/15 10:30,22,72,-50,
4354,59,2022/4/15 10:40,23,53,-30,
4355,59,2022/4/15 10:50,29,70,-41,
4356,59,2022/4/15 11:00,29,68,-39,
4357,59,2022/4/15 11:10,28,52,-24,
4358,59,2022/4/15 11:20,25,60,-35,
4359,59,2022/4/15 11:30,30,64,-34,
4360,59,2022/4/15 11:40,31,60,-29,
4361,59,2022/4/15 11:50,27,65,-38,
4362,59,2022/4/15 12:00,34,52,-18,
4363,59,2022/4/15 12:10,31,66,-35,
4364,59,2022/4/15 12:20,33,63,-30,
4365,59,2022/4/15 12:30,37,57,-20,
4366,59,2022/4/15 12:40,30,72,-42,
4367,59,2022/4/15 12:50,27,61,-34,
4368,59,2022/4/15 13:00,30,65,-35,
4369,59,2022/4/15 13:10,28,72,-44,
4370,59,2022/4/15 13:20,26,74,-48,
4371,59,2022/4/15 13:30,29,60,-31,
4372,59,2022/4/15 13:40,28,71,-43,
4373,59,2022/4/15 13:50,28,66,-38,
4374,59,2022/4/15 14:00,29,70,-41,
4375,59,2022/4/15 14:10,30,82,-52,
4376,59,2022/4/15 14:20,26,64,-38,
4377,59,2022/4/15 14:30,28,65,-37,
4378,59,2022/4/15 14:40,25,85,-60,
4379,59,2022/4/15 14:50,29,69,-40,
4380,59,2022/4/15 15:00,29,62,-33,
4381,59,2022/4/15 15:10,28,77,-49,
4382,59,2022/4/15 15:20,28,67,-39,
4383,59,2022/4/15 15:30,28,60,-32,
4384,59,2022/4/15 15:40,30,74,-44,
4385,59,2022/4/15 15:50,32,76,-44,
4386,59,2022/4/15 16:00,32,68,-36,
4387,59,2022/4/15 16:10,29,77,-48,
4388,59,2022/4/15 16:20,26,87,-61,
4389,59,2022/4/15 16:30,33,69,-36,
4390,59,2022/4/15 16:40,41,91,-50,
4391,59,2022/4/15 16:50,33,92,-59,
4392,59,2022/4/15 17:00,39,93,-54,
4393,59,2022/4/15 17:10,41,108,-67,
4394,59,2022/4/15 17:20,39,105,-66,
4395,59,2022/4/15 17:30,38,125,-87,
4396,59,2022/4/15 17:40,54,103,-49,
4397,59,2022/4/15 17:50,43,105,-62,
4398,59,2022/4/15 18:00,70,110,-40,
4399,59,2022/4/15 18:10,45,109,-64,
4400,59,2022/4/15 18:20,46,105,-59,
4401,59,2022/4/15 18:30,32,107,-75,
4402,59,2022/4/15 18:40,26,109,-83,
4403,59,2022/4/15 18:50,29,104,-75,
4404,59,2022/4/15 19:00,26,125,-99,
4405,59,2022/4/15 19:10,22,110,-88,
4406,59,2022/4/15 19:20,23,100,-77,
4407,59,2022/4/15 19:30,19,101,-82,
4408,59,2022/4/15 19:40,21,86,-65,
4409,59,2022/4/15 19:50,19,80,-61,
4410,59,2022/4/15 20:00,19,62,-43,
4411,59,2022/4/15 20:10,23,71,-48,
4412,59,2022/4/15 20:20,23,78,-55,
4413,59,2022/4/15 20:30,19,64,-45,
4414,59,2022/4/15 20:40,21,84,-63,
4415,59,2022/4/15 20:50,22,66,-44,
4416,59,2022/4/15 21:00,18,84,-66,
4417,59,2022/4/15 21:10,18,68,-50,
4418,59,2022/4/15 21:20,16,78,-62,
4419,59,2022/4/15 21:30,17,62,-45,
4420,59,2022/4/15 21:40,15,75,-60,
4421,59,2022/4/15 21:50,12,69,-57,
4422,59,2022/4/15 22:00,13,66,-53,
4423,59,2022/4/15 22:10,12,73,-61,
4424,59,2022/4/15 22:20,7,66,-59,
4425,59,2022/4/15 22:30,3,62,-59,
4426,59,2022/4/15 22:40,2,62,-60,
4427,59,2022/4/15 22:50,1,39,-38,
4428,52,2022/4/15 5:00,0,1,-1,
4429,52,2022/4/15 5:10,0,1,-1,
4430,52,2022/4/15 5:20,0,1,-1,
4431,52,2022/4/15 5:30,0,1,-1,
4432,52,2022/4/15 5:40,6,1,5,
4433,52,2022/4/15 5:50,20,1,19,
4434,52,2022/4/15 6:00,42,6,36,
4435,52,2022/4/15 6:10,54,29,25,
4436,52,2022/4/15 6:20,70,30,40,
4437,52,2022/4/15 6:30,109,37,72,
4438,52,2022/4/15 6:40,212,46,166,
4439,52,2022/4/15 6:50,247,71,176,
4440,52,2022/4/15 7:00,359,82,277,
4441,52,2022/4/15 7:10,596,75,521,
4442,52,2022/4/15 7:20,721,76,645,
4443,52,2022/4/15 7:30,737,75,662,
4444,52,2022/4/15 7:40,1051,105,946,
4445,52,2022/4/15 7:50,1233,90,1143,
4446,52,2022/4/15 8:00,1055,113,942,
4447,52,2022/4/15 8:10,836,121,715,
4448,52,2022/4/15 8:20,722,104,618,
4449,52,2022/4/15 8:30,665,123,542,
4450,52,2022/4/15 8:40,597,109,488,
4451,52,2022/4/15 8:50,374,108,266,
4452,52,2022/4/15 9:00,324,91,233,
4453,52,2022/4/15 9:10,269,100,169,
4454,52,2022/4/15 9:20,230,79,151,
4455,52,2022/4/15 9:30,149,84,65,
4456,52,2022/4/15 9:40,91,82,9,
4457,52,2022/4/15 9:50,62,75,-13,
4458,52,2022/4/15 10:00,57,70,-13,
4459,52,2022/4/15 10:10,49,73,-24,
4460,52,2022/4/15 10:20,41,69,-28,
4461,52,2022/4/15 10:30,37,78,-41,
4462,52,2022/4/15 10:40,35,72,-37,
4463,52,2022/4/15 10:50,36,73,-37,
4464,52,2022/4/15 11:00,35,75,-40,
4465,52,2022/4/15 11:10,39,82,-43,
4466,52,2022/4/15 11:20,33,70,-37,
4467,52,2022/4/15 11:30,31,68,-37,
4468,52,2022/4/15 11:40,38,76,-38,
4469,52,2022/4/15 11:50,35,74,-39,
4470,52,2022/4/15 12:00,37,81,-44,
4471,52,2022/4/15 12:10,42,80,-38,
4472,52,2022/4/15 12:20,41,66,-25,
4473,52,2022/4/15 12:30,37,75,-38,
4474,52,2022/4/15 12:40,37,82,-45,
4475,52,2022/4/15 12:50,37,72,-35,
4476,52,2022/4/15 13:00,39,87,-48,
4477,52,2022/4/15 13:10,35,92,-57,
4478,52,2022/4/15 13:20,38,72,-34,
4479,52,2022/4/15 13:30,31,81,-50,
4480,52,2022/4/15 13:40,33,90,-57,
4481,52,2022/4/15 13:50,30,71,-41,
4482,52,2022/4/15 14:00,33,81,-48,
4483,52,2022/4/15 14:10,32,90,-58,
4484,52,2022/4/15 14:20,29,71,-42,
4485,52,2022/4/15 14:30,33,93,-60,
4486,52,2022/4/15 14:40,33,98,-65,
4487,52,2022/4/15 14:50,25,77,-52,
4488,52,2022/4/15 15:00,27,101,-74,
4489,52,2022/4/15 15:10,33,103,-70,
4490,52,2022/4/15 15:20,32,76,-44,
4491,52,2022/4/15 15:30,35,110,-75,
4492,52,2022/4/15 15:40,29,114,-85,
4493,52,2022/4/15 15:50,30,93,-63,
4494,52,2022/4/15 16:00,35,122,-87,
4495,52,2022/4/15 16:10,32,125,-93,
4496,52,2022/4/15 16:20,29,94,-65,
4497,52,2022/4/15 16:30,40,110,-70,
4498,52,2022/4/15 16:40,43,123,-80,
4499,52,2022/4/15 16:50,35,120,-85,
4500,52,2022/4/15 17:00,60,144,-84,
4501,52,2022/4/15 17:10,93,143,-50,
4502,52,2022/4/15 17:20,52,296,-244,
4503,52,2022/4/15 17:30,56,205,-149,
4504,52,2022/4/15 17:40,65,431,-366,
4505,52,2022/4/15 17:50,47,332,-285,
4506,52,2022/4/15 18:00,45,501,-456,
4507,52,2022/4/15 18:10,57,345,-288,
4508,52,2022/4/15 18:20,51,430,-379,
4509,52,2022/4/15 18:30,45,323,-278,
4510,52,2022/4/15 18:40,39,429,-390,
4511,52,2022/4/15 18:50,29,334,-305,
4512,52,2022/4/15 19:00,33,435,-402,
4513,52,2022/4/15 19:10,35,223,-188,
4514,52,2022/4/15 19:20,26,234,-208,
4515,52,2022/4/15 19:30,28,116,-88,
4516,52,2022/4/15 19:40,29,158,-129,
4517,52,2022/4/15 19:50,25,113,-88,
4518,52,2022/4/15 20:00,28,109,-81,
4519,52,2022/4/15 20:10,26,107,-81,
4520,52,2022/4/15 20:20,26,92,-66,
4521,52,2022/4/15 20:30,24,110,-86,
4522,52,2022/4/15 20:40,22,111,-89,
4523,52,2022/4/15 20:50,20,100,-80,
4524,52,2022/4/15 21:00,21,123,-102,
4525,52,2022/4/15 21:10,24,114,-90,
4526,52,2022/4/15 21:20,18,97,-79,
4527,52,2022/4/15 21:30,18,133,-115,
4528,52,2022/4/15 21:40,18,108,-90,
4529,52,2022/4/15 21:50,18,127,-109,
4530,52,2022/4/15 22:00,13,106,-93,
4531,52,2022/4/15 22:10,14,93,-79,
4532,52,2022/4/15 22:20,7,118,-111,
4533,52,2022/4/15 22:30,4,105,-101,
4534,52,2022/4/15 22:40,3,89,-86,
4535,52,2022/4/15 22:50,1,57,-56,
4536,39,2022/4/15 5:00,0,1,-1,
4537,39,2022/4/15 5:10,0,1,-1,
4538,39,2022/4/15 5:20,0,1,-1,
4539,39,2022/4/15 5:30,0,1,-1,
4540,39,2022/4/15 5:40,5,1,4,
4541,39,2022/4/15 5:50,31,1,30,
4542,39,2022/4/15 6:00,47,17,30,
4543,39,2022/4/15 6:10,44,41,3,
4544,39,2022/4/15 6:20,72,51,21,
4545,39,2022/4/15 6:30,149,55,94,
4546,39,2022/4/15 6:40,212,64,148,
4547,39,2022/4/15 6:50,245,74,171,
4548,39,2022/4/15 7:00,278,66,212,
4549,39,2022/4/15 7:10,338,95,243,
4550,39,2022/4/15 7:20,469,110,359,
4551,39,2022/4/15 7:30,699,114,585,
4552,39,2022/4/15 7:40,829,109,720,
4553,39,2022/4/15 7:50,1062,121,941,
4554,39,2022/4/15 8:00,1061,112,949,
4555,39,2022/4/15 8:10,870,298,572,
4556,39,2022/4/15 8:20,682,159,523,
4557,39,2022/4/15 8:30,722,183,539,
4558,39,2022/4/15 8:40,595,192,403,
4559,39,2022/4/15 8:50,324,159,165,
4560,39,2022/4/15 9:00,312,123,189,
4561,39,2022/4/15 9:10,281,106,175,
4562,39,2022/4/15 9:20,207,108,99,
4563,39,2022/4/15 9:30,149,104,45,
4564,39,2022/4/15 9:40,86,103,-17,
4565,39,2022/4/15 9:50,70,101,-31,
4566,39,2022/4/15 10:00,64,97,-33,
4567,39,2022/4/15 10:10,52,69,-17,
4568,39,2022/4/15 10:20,47,87,-40,
4569,39,2022/4/15 10:30,45,77,-32,
4570,39,2022/4/15 10:40,46,94,-48,
4571,39,2022/4/15 10:50,42,92,-50,
4572,39,2022/4/15 11:00,46,88,-42,
4573,39,2022/4/15 11:10,41,65,-24,
4574,39,2022/4/15 11:20,43,76,-33,
4575,39,2022/4/15 11:30,40,91,-51,
4576,39,2022/4/15 11:40,44,75,-31,
4577,39,2022/4/15 11:50,38,104,-66,
4578,39,2022/4/15 12:00,48,97,-49,
4579,39,2022/4/15 12:10,45,75,-30,
4580,39,2022/4/15 12:20,46,97,-51,
4581,39,2022/4/15 12:30,44,92,-48,
4582,39,2022/4/15 12:40,43,92,-49,
4583,39,2022/4/15 12:50,44,93,-49,
4584,39,2022/4/15 13:00,45,108,-63,
4585,39,2022/4/15 13:10,48,76,-28,
4586,39,2022/4/15 13:20,41,92,-51,
4587,39,2022/4/15 13:30,45,96,-51,
4588,39,2022/4/15 13:40,40,77,-37,
4589,39,2022/4/15 13:50,40,93,-53,
4590,39,2022/4/15 14:00,41,94,-53,
4591,39,2022/4/15 14:10,45,80,-35,
4592,39,2022/4/15 14:20,41,99,-58,
4593,39,2022/4/15 14:30,36,101,-65,
4594,39,2022/4/15 14:40,37,105,-68,
4595,39,2022/4/15 14:50,39,83,-44,
4596,39,2022/4/15 15:00,43,96,-53,
4597,39,2022/4/15 15:10,39,93,-54,
4598,39,2022/4/15 15:20,41,112,-71,
4599,39,2022/4/15 15:30,44,106,-62,
4600,39,2022/4/15 15:40,44,97,-53,
4601,39,2022/4/15 15:50,44,107,-63,
4602,39,2022/4/15 16:00,43,102,-59,
4603,39,2022/4/15 16:10,50,105,-55,
4604,39,2022/4/15 16:20,56,121,-65,
4605,39,2022/4/15 16:30,71,125,-54,
4606,39,2022/4/15 16:40,71,107,-36,
4607,39,2022/4/15 16:50,77,111,-34,
4608,39,2022/4/15 17:00,210,114,96,
4609,39,2022/4/15 17:10,222,178,44,
4610,39,2022/4/15 17:20,164,118,46,
4611,39,2022/4/15 17:30,191,218,-27,
4612,39,2022/4/15 17:40,258,206,52,
4613,39,2022/4/15 17:50,224,344,-120,
4614,39,2022/4/15 18:00,199,254,-55,
4615,39,2022/4/15 18:10,187,432,-245,
4616,39,2022/4/15 18:20,132,298,-166,
4617,39,2022/4/15 18:30,87,535,-448,
4618,39,2022/4/15 18:40,76,300,-224,
4619,39,2022/4/15 18:50,61,510,-449,
4620,39,2022/4/15 19:00,44,219,-175,
4621,39,2022/4/15 19:10,44,341,-297,
4622,39,2022/4/15 19:20,39,158,-119,
4623,39,2022/4/15 19:30,36,225,-189,
4624,39,2022/4/15 19:40,28,111,-83,
4625,39,2022/4/15 19:50,31,120,-89,
4626,39,2022/4/15 20:00,31,116,-85,
4627,39,2022/4/15 20:10,35,104,-69,
4628,39,2022/4/15 20:20,32,111,-79,
4629,39,2022/4/15 20:30,29,107,-78,
4630,39,2022/4/15 20:40,30,104,-74,
4631,39,2022/4/15 20:50,24,133,-109,
4632,39,2022/4/15 21:00,25,107,-82,
4633,39,2022/4/15 21:10,27,116,-89,
4634,39,2022/4/15 21:20,29,106,-77,
4635,39,2022/4/15 21:30,27,112,-85,
4636,39,2022/4/15 21:40,25,109,-84,
4637,39,2022/4/15 21:50,20,111,-91,
4638,39,2022/4/15 22:00,20,111,-91,
4639,39,2022/4/15 22:10,14,106,-92,
4640,39,2022/4/15 22:20,9,95,-86,
4641,39,2022/4/15 22:30,7,105,-98,
4642,39,2022/4/15 22:40,5,95,-90,
4643,39,2022/4/15 22:50,5,63,-58,
4644,47,2022/4/15 5:00,0,1,-1,
4645,47,2022/4/15 5:10,0,1,-1,
4646,47,2022/4/15 5:20,0,1,-1,
4647,47,2022/4/15 5:30,0,1,-1,
4648,47,2022/4/15 5:40,4,1,3,
4649,47,2022/4/15 5:50,17,1,16,
4650,47,2022/4/15 6:00,30,13,17,
4651,47,2022/4/15 6:10,34,21,13,
4652,47,2022/4/15 6:20,29,34,-5,
4653,47,2022/4/15 6:30,39,33,6,
4654,47,2022/4/15 6:40,57,65,-8,
4655,47,2022/4/15 6:50,59,78,-19,
4656,47,2022/4/15 7:00,84,115,-31,
4657,47,2022/4/15 7:10,162,104,58,
4658,47,2022/4/15 7:20,246,185,61,
4659,47,2022/4/15 7:30,268,208,60,
4660,47,2022/4/15 7:40,302,153,149,
4661,47,2022/4/15 7:50,347,234,113,
4662,47,2022/4/15 8:00,318,298,20,
4663,47,2022/4/15 8:10,281,332,-51,
4664,47,2022/4/15 8:20,252,378,-126,
4665,47,2022/4/15 8:30,204,380,-176,
4666,47,2022/4/15 8:40,193,437,-244,
4667,47,2022/4/15 8:50,152,332,-180,
4668,47,2022/4/15 9:00,92,208,-116,
4669,47,2022/4/15 9:10,69,147,-78,
4670,47,2022/4/15 9:20,49,110,-61,
4671,47,2022/4/15 9:30,47,108,-61,
4672,47,2022/4/15 9:40,45,123,-78,
4673,47,2022/4/15 9:50,41,93,-52,
4674,47,2022/4/15 10:00,36,76,-40,
4675,47,2022/4/15 10:10,36,93,-57,
4676,47,2022/4/15 10:20,26,92,-66,
4677,47,2022/4/15 10:30,36,79,-43,
4678,47,2022/4/15 10:40,28,85,-57,
4679,47,2022/4/15 10:50,27,81,-54,
4680,47,2022/4/15 11:00,30,60,-30,
4681,47,2022/4/15 11:10,31,83,-52,
4682,47,2022/4/15 11:20,32,79,-47,
4683,47,2022/4/15 11:30,31,57,-26,
4684,47,2022/4/15 11:40,37,92,-55,
4685,47,2022/4/15 11:50,41,83,-42,
4686,47,2022/4/15 12:00,36,78,-42,
4687,47,2022/4/15 12:10,35,75,-40,
4688,47,2022/4/15 12:20,45,72,-27,
4689,47,2022/4/15 12:30,34,81,-47,
4690,47,2022/4/15 12:40,39,93,-54,
4691,47,2022/4/15 12:50,36,76,-40,
4692,47,2022/4/15 13:00,35,86,-51,
4693,47,2022/4/15 13:10,39,93,-54,
4694,47,2022/4/15 13:20,38,73,-35,
4695,47,2022/4/15 13:30,32,76,-44,
4696,47,2022/4/15 13:40,33,80,-47,
4697,47,2022/4/15 13:50,39,80,-41,
4698,47,2022/4/15 14:00,36,76,-40,
4699,47,2022/4/15 14:10,34,94,-60,
4700,47,2022/4/15 14:20,32,81,-49,
4701,47,2022/4/15 14:30,71,76,-5,
4702,47,2022/4/15 14:40,143,90,53,
4703,47,2022/4/15 14:50,57,73,-16,
4704,47,2022/4/15 15:00,57,77,-20,
4705,47,2022/4/15 15:10,41,92,-51,
4706,47,2022/4/15 15:20,46,80,-34,
4707,47,2022/4/15 15:30,43,84,-41,
4708,47,2022/4/15 15:40,45,101,-56,
4709,47,2022/4/15 15:50,44,75,-31,
4710,47,2022/4/15 16:00,47,96,-49,
4711,47,2022/4/15 16:10,54,99,-45,
4712,47,2022/4/15 16:20,70,83,-13,
4713,47,2022/4/15 16:30,136,92,44,
4714,47,2022/4/15 16:40,113,112,1,
4715,47,2022/4/15 16:50,92,87,5,
4716,47,2022/4/15 17:00,268,105,163,
4717,47,2022/4/15 17:10,270,109,161,
4718,47,2022/4/15 17:20,195,124,71,
4719,47,2022/4/15 17:30,273,106,167,
4720,47,2022/4/15 17:40,553,116,437,
4721,47,2022/4/15 17:50,272,124,148,
4722,47,2022/4/15 18:00,235,116,119,
4723,47,2022/4/15 18:10,336,110,226,
4724,47,2022/4/15 18:20,218,179,39,
4725,47,2022/4/15 18:30,135,109,26,
4726,47,2022/4/15 18:40,82,170,-88,
4727,47,2022/4/15 18:50,58,109,-51,
4728,47,2022/4/15 19:00,44,117,-73,
4729,47,2022/4/15 19:10,37,107,-70,
4730,47,2022/4/15 19:20,32,126,-94,
4731,47,2022/4/15 19:30,28,95,-67,
4732,47,2022/4/15 19:40,25,110,-85,
4733,47,2022/4/15 19:50,29,80,-51,
4734,47,2022/4/15 20:00,28,73,-45,
4735,47,2022/4/15 20:10,27,83,-56,
4736,47,2022/4/15 20:20,29,75,-46,
4737,47,2022/4/15 20:30,26,70,-44,
4738,47,2022/4/15 20:40,26,79,-53,
4739,47,2022/4/15 20:50,21,70,-49,
4740,47,2022/4/15 21:00,26,85,-59,
4741,47,2022/4/15 21:10,22,70,-48,
4742,47,2022/4/15 21:20,23,95,-72,
4743,47,2022/4/15 21:30,16,65,-49,
4744,47,2022/4/15 21:40,19,83,-64,
4745,47,2022/4/15 21:50,15,70,-55,
4746,47,2022/4/15 22:00,13,57,-44,
4747,47,2022/4/15 22:10,9,71,-62,
4748,47,2022/4/15 22:20,5,53,-48,
4749,47,2022/4/15 22:30,6,50,-44,
4750,47,2022/4/15 22:40,2,74,-72,
4751,47,2022/4/15 22:50,2,27,-25,
4752,55,2022/4/15 5:00,0,1,-1,
4753,55,2022/4/15 5:10,0,1,-1,
4754,55,2022/4/15 5:20,0,1,-1,
4755,55,2022/4/15 5:30,0,1,-1,
4756,55,2022/4/15 5:40,3,1,2,
4757,55,2022/4/15 5:50,10,1,9,
4758,55,2022/4/15 6:00,9,5,4,
4759,55,2022/4/15 6:10,11,16,-5,
4760,55,2022/4/15 6:20,16,14,2,
4761,55,2022/4/15 6:30,18,23,-5,
4762,55,2022/4/15 6:40,17,23,-6,
4763,55,2022/4/15 6:50,20,23,-3,
4764,55,2022/4/15 7:00,21,32,-11,
4765,55,2022/4/15 7:10,22,38,-16,
4766,55,2022/4/15 7:20,31,51,-20,
4767,55,2022/4/15 7:30,37,69,-32,
4768,55,2022/4/15 7:40,40,75,-35,
4769,55,2022/4/15 7:50,34,87,-53,
4770,55,2022/4/15 8:00,43,78,-35,
4771,55,2022/4/15 8:10,40,99,-59,
4772,55,2022/4/15 8:20,38,75,-37,
4773,55,2022/4/15 8:30,35,76,-41,
4774,55,2022/4/15 8:40,30,79,-49,
4775,55,2022/4/15 8:50,24,70,-46,
4776,55,2022/4/15 9:00,20,49,-29,
4777,55,2022/4/15 9:10,21,55,-34,
4778,55,2022/4/15 9:20,19,46,-27,
4779,55,2022/4/15 9:30,16,47,-31,
4780,55,2022/4/15 9:40,16,40,-24,
4781,55,2022/4/15 9:50,14,40,-26,
4782,55,2022/4/15 10:00,16,38,-22,
4783,55,2022/4/15 10:10,15,33,-18,
4784,55,2022/4/15 10:20,16,30,-14,
4785,55,2022/4/15 10:30,15,40,-25,
4786,55,2022/4/15 10:40,13,31,-18,
4787,55,2022/4/15 10:50,13,23,-10,
4788,55,2022/4/15 11:00,14,38,-24,
4789,55,2022/4/15 11:10,13,32,-19,
4790,55,2022/4/15 11:20,13,23,-10,
4791,55,2022/4/15 11:30,12,34,-22,
4792,55,2022/4/15 11:40,15,31,-16,
4793,55,2022/4/15 11:50,14,25,-11,
4794,55,2022/4/15 12:00,13,25,-12,
4795,55,2022/4/15 12:10,14,23,-9,
4796,55,2022/4/15 12:20,13,32,-19,
4797,55,2022/4/15 12:30,13,38,-25,
4798,55,2022/4/15 12:40,13,23,-10,
4799,55,2022/4/15 12:50,15,38,-23,
4800,55,2022/4/15 13:00,13,40,-27,
4801,55,2022/4/15 13:10,15,23,-8,
4802,55,2022/4/15 13:20,12,38,-26,
4803,55,2022/4/15 13:30,13,38,-25,
4804,55,2022/4/15 13:40,15,23,-8,
4805,55,2022/4/15 13:50,15,38,-23,
4806,55,2022/4/15 14:00,14,37,-23,
4807,55,2022/4/15 14:10,14,23,-9,
4808,55,2022/4/15 14:20,14,38,-24,
4809,55,2022/4/15 14:30,15,38,-23,
4810,55,2022/4/15 14:40,14,23,-9,
4811,55,2022/4/15 14:50,14,32,-18,
4812,55,2022/4/15 15:00,20,33,-13,
4813,55,2022/4/15 15:10,17,19,-2,
4814,55,2022/4/15 15:20,19,38,-19,
4815,55,2022/4/15 15:30,16,37,-21,
4816,55,2022/4/15 15:40,15,19,-4,
4817,55,2022/4/15 15:50,16,35,-19,
4818,55,2022/4/15 16:00,19,37,-18,
4819,55,2022/4/15 16:10,18,21,-3,
4820,55,2022/4/15 16:20,18,35,-17,
4821,55,2022/4/15 16:30,25,37,-12,
4822,55,2022/4/15 16:40,25,23,2,
4823,55,2022/4/15 16:50,20,38,-18,
4824,55,2022/4/15 17:00,44,39,5,
4825,55,2022/4/15 17:10,33,37,-4,
4826,55,2022/4/15 17:20,26,38,-12,
4827,55,2022/4/15 17:30,19,45,-26,
4828,55,2022/4/15 17:40,28,38,-10,
4829,55,2022/4/15 17:50,29,51,-22,
4830,55,2022/4/15 18:00,28,46,-18,
4831,55,2022/4/15 18:10,24,62,-38,
4832,55,2022/4/15 18:20,18,52,-34,
4833,55,2022/4/15 18:30,20,60,-40,
4834,55,2022/4/15 18:40,15,48,-33,
4835,55,2022/4/15 18:50,16,67,-51,
4836,55,2022/4/15 19:00,17,52,-35,
4837,55,2022/4/15 19:10,13,63,-50,
4838,55,2022/4/15 19:20,11,40,-29,
4839,55,2022/4/15 19:30,12,49,-37,
4840,55,2022/4/15 19:40,9,34,-25,
4841,55,2022/4/15 19:50,8,25,-17,
4842,55,2022/4/15 20:00,11,40,-29,
4843,55,2022/4/15 20:10,7,40,-33,
4844,55,2022/4/15 20:20,6,27,-21,
4845,55,2022/4/15 20:30,7,38,-31,
4846,55,2022/4/15 20:40,9,37,-28,
4847,55,2022/4/15 20:50,6,27,-21,
4848,55,2022/4/15 21:00,8,34,-26,
4849,55,2022/4/15 21:10,6,33,-27,
4850,55,2022/4/15 21:20,4,35,-31,
4851,55,2022/4/15 21:30,4,43,-39,
4852,55,2022/4/15 21:40,2,32,-30,
4853,55,2022/4/15 21:50,4,44,-40,
4854,55,2022/4/15 22:00,5,25,-20,
4855,55,2022/4/15 22:10,2,25,-23,
4856,55,2022/4/15 22:20,0,40,-40,
4857,55,2022/4/15 22:30,0,33,-33,
4858,55,2022/4/15 22:40,0,23,-23,
4859,55,2022/4/15 22:50,0,34,-34,
4860,54,2022/4/15 5:00,0,1,-1,
4861,54,2022/4/15 5:10,0,1,-1,
4862,54,2022/4/15 5:20,0,1,-1,
4863,54,2022/4/15 5:30,1,1,0,
4864,54,2022/4/15 5:40,20,1,19,
4865,54,2022/4/15 5:50,60,5,55,
4866,54,2022/4/15 6:00,106,19,87,
4867,54,2022/4/15 6:10,148,8,140,
4868,54,2022/4/15 6:20,205,43,162,
4869,54,2022/4/15 6:30,258,34,224,
4870,54,2022/4/15 6:40,276,52,224,
4871,54,2022/4/15 6:50,348,65,283,
4872,54,2022/4/15 7:00,571,96,475,
4873,54,2022/4/15 7:10,588,109,479,
4874,54,2022/4/15 7:20,687,109,578,
4875,54,2022/4/15 7:30,862,111,751,
4876,54,2022/4/15 7:40,1221,105,1116,
4877,54,2022/4/15 7:50,1370,100,1270,
4878,54,2022/4/15 8:00,1232,122,1110,
4879,54,2022/4/15 8:10,1175,104,1071,
4880,54,2022/4/15 8:20,830,110,720,
4881,54,2022/4/15 8:30,731,106,625,
4882,54,2022/4/15 8:40,627,125,502,
4883,54,2022/4/15 8:50,365,109,256,
4884,54,2022/4/15 9:00,311,93,218,
4885,54,2022/4/15 9:10,247,78,169,
4886,54,2022/4/15 9:20,191,90,101,
4887,54,2022/4/15 9:30,144,83,61,
4888,54,2022/4/15 9:40,71,76,-5,
4889,54,2022/4/15 9:50,62,84,-22,
4890,54,2022/4/15 10:00,55,69,-14,
4891,54,2022/4/15 10:10,47,70,-23,
4892,54,2022/4/15 10:20,43,76,-33,
4893,54,2022/4/15 10:30,44,64,-20,
4894,54,2022/4/15 10:40,39,92,-53,
4895,54,2022/4/15 10:50,39,75,-36,
4896,54,2022/4/15 11:00,37,60,-23,
4897,54,2022/4/15 11:10,38,91,-53,
4898,54,2022/4/15 11:20,38,81,-43,
4899,54,2022/4/15 11:30,37,68,-31,
4900,54,2022/4/15 11:40,45,79,-34,
4901,54,2022/4/15 11:50,44,75,-31,
4902,54,2022/4/15 12:00,51,80,-29,
4903,54,2022/4/15 12:10,46,92,-46,
4904,54,2022/4/15 12:20,48,74,-26,
4905,54,2022/4/15 12:30,45,82,-37,
4906,54,2022/4/15 12:40,45,87,-42,
4907,54,2022/4/15 12:50,45,75,-30,
4908,54,2022/4/15 13:00,45,76,-31,
4909,54,2022/4/15 13:10,45,80,-35,
4910,54,2022/4/15 13:20,35,73,-38,
4911,54,2022/4/15 13:30,36,78,-42,
4912,54,2022/4/15 13:40,37,97,-60,
4913,54,2022/4/15 13:50,36,76,-40,
4914,54,2022/4/15 14:00,34,76,-42,
4915,54,2022/4/15 14:10,37,91,-54,
4916,54,2022/4/15 14:20,36,87,-51,
4917,54,2022/4/15 14:30,33,77,-44,
4918,54,2022/4/15 14:40,31,103,-72,
4919,54,2022/4/15 14:50,29,101,-72,
4920,54,2022/4/15 15:00,31,83,-52,
4921,54,2022/4/15 15:10,34,101,-67,
4922,54,2022/4/15 15:20,30,105,-75,
4923,54,2022/4/15 15:30,33,108,-75,
4924,54,2022/4/15 15:40,31,126,-95,
4925,54,2022/4/15 15:50,28,120,-92,
4926,54,2022/4/15 16:00,38,103,-65,
4927,54,2022/4/15 16:10,37,109,-72,
4928,54,2022/4/15 16:20,36,108,-72,
4929,54,2022/4/15 16:30,47,122,-75,
4930,54,2022/4/15 16:40,50,128,-78,
4931,54,2022/4/15 16:50,42,117,-75,
4932,54,2022/4/15 17:00,56,115,-59,
4933,54,2022/4/15 17:10,73,222,-149,
4934,54,2022/4/15 17:20,65,214,-149,
4935,54,2022/4/15 17:30,55,282,-227,
4936,54,2022/4/15 17:40,68,317,-249,
4937,54,2022/4/15 17:50,62,431,-369,
4938,54,2022/4/15 18:00,74,320,-246,
4939,54,2022/4/15 18:10,63,431,-368,
4940,54,2022/4/15 18:20,43,503,-460,
4941,54,2022/4/15 18:30,35,417,-382,
4942,54,2022/4/15 18:40,30,537,-507,
4943,54,2022/4/15 18:50,32,433,-401,
4944,54,2022/4/15 19:00,31,434,-403,
4945,54,2022/4/15 19:10,27,533,-506,
4946,54,2022/4/15 19:20,29,283,-254,
4947,54,2022/4/15 19:30,27,255,-228,
4948,54,2022/4/15 19:40,27,176,-149,
4949,54,2022/4/15 19:50,24,190,-166,
4950,54,2022/4/15 20:00,24,104,-80,
4951,54,2022/4/15 20:10,28,115,-87,
4952,54,2022/4/15 20:20,27,128,-101,
4953,54,2022/4/15 20:30,23,105,-82,
4954,54,2022/4/15 20:40,26,128,-102,
4955,54,2022/4/15 20:50,24,119,-95,
4956,54,2022/4/15 21:00,23,110,-87,
4957,54,2022/4/15 21:10,22,119,-97,
4958,54,2022/4/15 21:20,23,109,-86,
4959,54,2022/4/15 21:30,20,102,-82,
4960,54,2022/4/15 21:40,20,153,-133,
4961,54,2022/4/15 21:50,16,109,-93,
4962,54,2022/4/15 22:00,13,117,-104,
4963,54,2022/4/15 22:10,6,107,-101,
4964,54,2022/4/15 22:20,4,100,-96,
4965,54,2022/4/15 22:30,3,111,-108,
4966,54,2022/4/15 22:40,2,124,-122,
4967,54,2022/4/15 22:50,1,109,-108,
4968,45,2022/4/15 5:00,1,1,0,
4969,45,2022/4/15 5:10,0,1,-1,
4970,45,2022/4/15 5:20,0,1,-1,
4971,45,2022/4/15 5:30,10,1,9,
4972,45,2022/4/15 5:40,34,1,33,
4973,45,2022/4/15 5:50,60,8,52,
4974,45,2022/4/15 6:00,67,19,48,
4975,45,2022/4/15 6:10,145,23,122,
4976,45,2022/4/15 6:20,188,68,120,
4977,45,2022/4/15 6:30,237,80,157,
4978,45,2022/4/15 6:40,347,71,276,
4979,45,2022/4/15 6:50,386,86,300,
4980,45,2022/4/15 7:00,652,105,547,
4981,45,2022/4/15 7:10,854,127,727,
4982,45,2022/4/15 7:20,1162,133,1029,
4983,45,2022/4/15 7:30,1215,159,1056,
4984,45,2022/4/15 7:40,1604,269,1335,
4985,45,2022/4/15 7:50,1395,227,1168,
4986,45,2022/4/15 8:00,1585,298,1287,
4987,45,2022/4/15 8:10,1222,231,991,
4988,45,2022/4/15 8:20,1061,326,735,
4989,45,2022/4/15 8:30,847,332,515,
4990,45,2022/4/15 8:40,683,326,357,
4991,45,2022/4/15 8:50,574,144,430,
4992,45,2022/4/15 9:00,342,159,183,
4993,45,2022/4/15 9:10,311,185,126,
4994,45,2022/4/15 9:20,229,119,110,
4995,45,2022/4/15 9:30,178,121,57,
4996,45,2022/4/15 9:40,175,104,71,
4997,45,2022/4/15 9:50,108,144,-36,
4998,45,2022/4/15 10:00,82,110,-28,
4999,45,2022/4/15 10:10,84,108,-24,
5000,45,2022/4/15 10:20,72,118,-46,
5001,45,2022/4/15 10:30,71,120,-49,
5002,45,2022/4/15 10:40,69,126,-57,
5003,45,2022/4/15 10:50,56,86,-30,
5004,45,2022/4/15 11:00,64,106,-42,
5005,45,2022/4/15 11:10,67,108,-41,
5006,45,2022/4/15 11:20,57,123,-66,
5007,45,2022/4/15 11:30,68,120,-52,
5008,45,2022/4/15 11:40,72,103,-31,
5009,45,2022/4/15 11:50,76,100,-24,
5010,45,2022/4/15 12:00,74,106,-32,
5011,45,2022/4/15 12:10,133,114,19,
5012,45,2022/4/15 12:20,82,104,-22,
5013,45,2022/4/15 12:30,130,99,31,
5014,45,2022/4/15 12:40,95,107,-12,
5015,45,2022/4/15 12:50,101,111,-10,
5016,45,2022/4/15 13:00,73,107,-34,
5017,45,2022/4/15 13:10,113,117,-4,
5018,45,2022/4/15 13:20,89,110,-21,
5019,45,2022/4/15 13:30,97,105,-8,
5020,45,2022/4/15 13:40,80,116,-36,
5021,45,2022/4/15 13:50,72,106,-34,
5022,45,2022/4/15 14:00,73,105,-32,
5023,45,2022/4/15 14:10,76,127,-51,
5024,45,2022/4/15 14:20,75,124,-49,
5025,45,2022/4/15 14:30,76,104,-28,
5026,45,2022/4/15 14:40,67,116,-49,
5027,45,2022/4/15 14:50,72,109,-37,
5028,45,2022/4/15 15:00,73,122,-49,
5029,45,2022/4/15 15:10,92,123,-31,
5030,45,2022/4/15 15:20,82,127,-45,
5031,45,2022/4/15 15:30,126,115,11,
5032,45,2022/4/15 15:40,100,119,-19,
5033,45,2022/4/15 15:50,96,119,-23,
5034,45,2022/4/15 16:00,91,106,-15,
5035,45,2022/4/15 16:10,137,139,-2,
5036,45,2022/4/15 16:20,96,198,-102,
5037,45,2022/4/15 16:30,168,105,63,
5038,45,2022/4/15 16:40,209,213,-4,
5039,45,2022/4/15 16:50,181,234,-53,
5040,45,2022/4/15 17:00,212,179,33,
5041,45,2022/4/15 17:10,270,230,40,
5042,45,2022/4/15 17:20,265,343,-78,
5043,45,2022/4/15 17:30,268,325,-57,
5044,45,2022/4/15 17:40,312,321,-9,
5045,45,2022/4/15 17:50,343,426,-83,
5046,45,2022/4/15 18:00,265,534,-269,
5047,45,2022/4/15 18:10,246,490,-244,
5048,45,2022/4/15 18:20,225,419,-194,
5049,45,2022/4/15 18:30,136,578,-442,
5050,45,2022/4/15 18:40,130,430,-300,
5051,45,2022/4/15 18:50,61,580,-519,
5052,45,2022/4/15 19:00,74,438,-364,
5053,45,2022/4/15 19:10,60,431,-371,
5054,45,2022/4/15 19:20,60,377,-317,
5055,45,2022/4/15 19:30,40,535,-495,
5056,45,2022/4/15 19:40,48,196,-148,
5057,45,2022/4/15 19:50,44,256,-212,
5058,45,2022/4/15 20:00,46,191,-145,
5059,45,2022/4/15 20:10,47,115,-68,
5060,45,2022/4/15 20:20,56,180,-124,
5061,45,2022/4/15 20:30,46,137,-91,
5062,45,2022/4/15 20:40,44,121,-77,
5063,45,2022/4/15 20:50,44,181,-137,
5064,45,2022/4/15 21:00,41,104,-63,
5065,45,2022/4/15 21:10,36,143,-107,
5066,45,2022/4/15 21:20,35,121,-86,
5067,45,2022/4/15 21:30,35,192,-157,
5068,45,2022/4/15 21:40,31,114,-83,
5069,45,2022/4/15 21:50,25,108,-83,
5070,45,2022/4/15 22:00,25,116,-91,
5071,45,2022/4/15 22:10,11,105,-94,
5072,45,2022/4/15 22:20,10,108,-98,
5073,45,2022/4/15 22:30,6,94,-88,
5074,45,2022/4/15 22:40,4,92,-88,
5075,45,2022/4/15 22:50,4,101,-97,
5076,44,2022/4/15 5:00,0,1,-1,
5077,44,2022/4/15 5:10,0,1,-1,
5078,44,2022/4/15 5:20,0,1,-1,
5079,44,2022/4/15 5:30,14,1,13,
5080,44,2022/4/15 5:40,25,1,24,
5081,44,2022/4/15 5:50,24,5,19,
5082,44,2022/4/15 6:00,30,5,25,
5083,44,2022/4/15 6:10,26,6,20,
5084,44,2022/4/15 6:20,45,8,37,
5085,44,2022/4/15 6:30,55,69,-14,
5086,44,2022/4/15 6:40,57,60,-3,
5087,44,2022/4/15 6:50,74,76,-2,
5088,44,2022/4/15 7:00,188,73,115,
5089,44,2022/4/15 7:10,123,98,25,
5090,44,2022/4/15 7:20,244,99,145,
5091,44,2022/4/15 7:30,244,92,152,
5092,44,2022/4/15 7:40,280,92,188,
5093,44,2022/4/15 7:50,279,107,172,
5094,44,2022/4/15 8:00,234,104,130,
5095,44,2022/4/15 8:10,215,105,110,
5096,44,2022/4/15 8:20,167,95,72,
5097,44,2022/4/15 8:30,182,105,77,
5098,44,2022/4/15 8:40,89,77,12,
5099,44,2022/4/15 8:50,53,81,-28,
5100,44,2022/4/15 9:00,48,79,-31,
5101,44,2022/4/15 9:10,45,76,-31,
5102,44,2022/4/15 9:20,32,69,-37,
5103,44,2022/4/15 9:30,24,70,-46,
5104,44,2022/4/15 9:40,27,74,-47,
5105,44,2022/4/15 9:50,27,69,-42,
5106,44,2022/4/15 10:00,27,66,-39,
5107,44,2022/4/15 10:10,27,67,-40,
5108,44,2022/4/15 10:20,25,62,-37,
5109,44,2022/4/15 10:30,27,66,-39,
5110,44,2022/4/15 10:40,29,46,-17,
5111,44,2022/4/15 10:50,26,74,-48,
5112,44,2022/4/15 11:00,25,68,-43,
5113,44,2022/4/15 11:10,28,48,-20,
5114,44,2022/4/15 11:20,27,67,-40,
5115,44,2022/4/15 11:30,26,65,-39,
5116,44,2022/4/15 11:40,28,50,-22,
5117,44,2022/4/15 11:50,26,66,-40,
5118,44,2022/4/15 12:00,25,68,-43,
5119,44,2022/4/15 12:10,27,52,-25,
5120,44,2022/4/15 12:20,28,71,-43,
5121,44,2022/4/15 12:30,28,67,-39,
5122,44,2022/4/15 12:40,27,61,-34,
5123,44,2022/4/15 12:50,22,79,-57,
5124,44,2022/4/15 13:00,29,65,-36,
5125,44,2022/4/15 13:10,24,65,-41,
5126,44,2022/4/15 13:20,26,65,-39,
5127,44,2022/4/15 13:30,26,63,-37,
5128,44,2022/4/15 13:40,26,54,-28,
5129,44,2022/4/15 13:50,23,68,-45,
5130,44,2022/4/15 14:00,28,68,-40,
5131,44,2022/4/15 14:10,28,56,-28,
5132,44,2022/4/15 14:20,28,64,-36,
5133,44,2022/4/15 14:30,25,65,-40,
5134,44,2022/4/15 14:40,26,51,-25,
5135,44,2022/4/15 14:50,27,67,-40,
5136,44,2022/4/15 15:00,24,74,-50,
5137,44,2022/4/15 15:10,29,61,-32,
5138,44,2022/4/15 15:20,31,82,-51,
5139,44,2022/4/15 15:30,26,78,-52,
5140,44,2022/4/15 15:40,29,69,-40,
5141,44,2022/4/15 15:50,26,76,-50,
5142,44,2022/4/15 16:00,35,84,-49,
5143,44,2022/4/15 16:10,24,70,-46,
5144,44,2022/4/15 16:20,27,93,-66,
5145,44,2022/4/15 16:30,31,77,-46,
5146,44,2022/4/15 16:40,39,76,-37,
5147,44,2022/4/15 16:50,53,103,-50,
5148,44,2022/4/15 17:00,30,99,-69,
5149,44,2022/4/15 17:10,47,93,-46,
5150,44,2022/4/15 17:20,28,105,-77,
5151,44,2022/4/15 17:30,39,107,-68,
5152,44,2022/4/15 17:40,42,102,-60,
5153,44,2022/4/15 17:50,42,110,-68,
5154,44,2022/4/15 18:00,37,128,-91,
5155,44,2022/4/15 18:10,34,119,-85,
5156,44,2022/4/15 18:20,29,110,-81,
5157,44,2022/4/15 18:30,28,111,-83,
5158,44,2022/4/15 18:40,24,110,-86,
5159,44,2022/4/15 18:50,25,139,-114,
5160,44,2022/4/15 19:00,24,109,-85,
5161,44,2022/4/15 19:10,24,116,-92,
5162,44,2022/4/15 19:20,18,123,-105,
5163,44,2022/4/15 19:30,17,120,-103,
5164,44,2022/4/15 19:40,15,107,-92,
5165,44,2022/4/15 19:50,24,106,-82,
5166,44,2022/4/15 20:00,13,78,-65,
5167,44,2022/4/15 20:10,14,95,-81,
5168,44,2022/4/15 20:20,16,79,-63,
5169,44,2022/4/15 20:30,13,92,-79,
5170,44,2022/4/15 20:40,16,70,-54,
5171,44,2022/4/15 20:50,9,77,-68,
5172,44,2022/4/15 21:00,16,79,-63,
5173,44,2022/4/15 21:10,10,71,-61,
5174,44,2022/4/15 21:20,7,95,-88,
5175,44,2022/4/15 21:30,9,73,-64,
5176,44,2022/4/15 21:40,8,72,-64,
5177,44,2022/4/15 21:50,5,83,-78,
5178,44,2022/4/15 22:00,1,63,-62,
5179,44,2022/4/15 22:10,1,77,-76,
5180,44,2022/4/15 22:20,1,61,-60,
5181,44,2022/4/15 22:30,1,50,-49,
5182,44,2022/4/15 22:40,0,70,-70,
5183,44,2022/4/15 22:50,0,41,-41,
5184,37,2022/4/15 5:00,0,1,-1,
5185,37,2022/4/15 5:10,0,1,-1,
5186,37,2022/4/15 5:20,5,1,4,
5187,37,2022/4/15 5:30,14,1,13,
5188,37,2022/4/15 5:40,23,1,22,
5189,37,2022/4/15 5:50,25,6,19,
5190,37,2022/4/15 6:00,32,6,26,
5191,37,2022/4/15 6:10,46,14,32,
5192,37,2022/4/15 6:20,58,16,42,
5193,37,2022/4/15 6:30,63,43,20,
5194,37,2022/4/15 6:40,68,61,7,
5195,37,2022/4/15 6:50,124,67,57,
5196,37,2022/4/15 7:00,245,91,154,
5197,37,2022/4/15 7:10,281,102,179,
5198,37,2022/4/15 7:20,349,102,247,
5199,37,2022/4/15 7:30,339,109,230,
5200,37,2022/4/15 7:40,474,109,365,
5201,37,2022/4/15 7:50,572,192,380,
5202,37,2022/4/15 8:00,322,110,212,
5203,37,2022/4/15 8:10,323,192,131,
5204,37,2022/4/15 8:20,277,120,157,
5205,37,2022/4/15 8:30,250,119,131,
5206,37,2022/4/15 8:40,157,115,42,
5207,37,2022/4/15 8:50,156,109,47,
5208,37,2022/4/15 9:00,72,93,-21,
5209,37,2022/4/15 9:10,47,93,-46,
5210,37,2022/4/15 9:20,51,97,-46,
5211,37,2022/4/15 9:30,38,79,-41,
5212,37,2022/4/15 9:40,42,74,-32,
5213,37,2022/4/15 9:50,27,75,-48,
5214,37,2022/4/15 10:00,38,62,-24,
5215,37,2022/4/15 10:10,31,69,-38,
5216,37,2022/4/15 10:20,27,86,-59,
5217,37,2022/4/15 10:30,34,59,-25,
5218,37,2022/4/15 10:40,35,73,-38,
5219,37,2022/4/15 10:50,30,73,-43,
5220,37,2022/4/15 11:00,35,61,-26,
5221,37,2022/4/15 11:10,30,70,-40,
5222,37,2022/4/15 11:20,30,67,-37,
5223,37,2022/4/15 11:30,30,61,-31,
5224,37,2022/4/15 11:40,33,72,-39,
5225,37,2022/4/15 11:50,36,61,-25,
5226,37,2022/4/15 12:00,31,59,-28,
5227,37,2022/4/15 12:10,29,68,-39,
5228,37,2022/4/15 12:20,35,61,-26,
5229,37,2022/4/15 12:30,34,74,-40,
5230,37,2022/4/15 12:40,32,82,-50,
5231,37,2022/4/15 12:50,33,68,-35,
5232,37,2022/4/15 13:00,33,69,-36,
5233,37,2022/4/15 13:10,31,79,-48,
5234,37,2022/4/15 13:20,31,70,-39,
5235,37,2022/4/15 13:30,28,74,-46,
5236,37,2022/4/15 13:40,28,77,-49,
5237,37,2022/4/15 13:50,31,69,-38,
5238,37,2022/4/15 14:00,26,75,-49,
5239,37,2022/4/15 14:10,33,83,-50,
5240,37,2022/4/15 14:20,36,63,-27,
5241,37,2022/4/15 14:30,31,83,-52,
5242,37,2022/4/15 14:40,27,68,-41,
5243,37,2022/4/15 14:50,28,61,-33,
5244,37,2022/4/15 15:00,29,76,-47,
5245,37,2022/4/15 15:10,23,73,-50,
5246,37,2022/4/15 15:20,25,72,-47,
5247,37,2022/4/15 15:30,29,75,-46,
5248,37,2022/4/15 15:40,27,76,-49,
5249,37,2022/4/15 15:50,30,63,-33,
5250,37,2022/4/15 16:00,24,79,-55,
5251,37,2022/4/15 16:10,41,91,-50,
5252,37,2022/4/15 16:20,34,82,-48,
5253,37,2022/4/15 16:30,42,98,-56,
5254,37,2022/4/15 16:40,75,98,-23,
5255,37,2022/4/15 16:50,67,93,-26,
5256,37,2022/4/15 17:00,75,109,-34,
5257,37,2022/4/15 17:10,174,106,68,
5258,37,2022/4/15 17:20,217,106,111,
5259,37,2022/4/15 17:30,134,110,24,
5260,37,2022/4/15 17:40,69,118,-49,
5261,37,2022/4/15 17:50,136,115,21,
5262,37,2022/4/15 18:00,65,107,-42,
5263,37,2022/4/15 18:10,42,158,-116,
5264,37,2022/4/15 18:20,42,128,-86,
5265,37,2022/4/15 18:30,38,226,-188,
5266,37,2022/4/15 18:40,28,181,-153,
5267,37,2022/4/15 18:50,32,234,-202,
5268,37,2022/4/15 19:00,25,143,-118,
5269,37,2022/4/15 19:10,27,198,-171,
5270,37,2022/4/15 19:20,25,134,-109,
5271,37,2022/4/15 19:30,24,152,-128,
5272,37,2022/4/15 19:40,25,103,-78,
5273,37,2022/4/15 19:50,23,110,-87,
5274,37,2022/4/15 20:00,27,114,-87,
5275,37,2022/4/15 20:10,20,109,-89,
5276,37,2022/4/15 20:20,17,106,-89,
5277,37,2022/4/15 20:30,19,77,-58,
5278,37,2022/4/15 20:40,17,114,-97,
5279,37,2022/4/15 20:50,16,105,-89,
5280,37,2022/4/15 21:00,17,94,-77,
5281,37,2022/4/15 21:10,17,107,-90,
5282,37,2022/4/15 21:20,14,84,-70,
5283,37,2022/4/15 21:30,12,110,-98,
5284,37,2022/4/15 21:40,9,79,-70,
5285,37,2022/4/15 21:50,9,75,-66,
5286,37,2022/4/15 22:00,3,99,-96,
5287,37,2022/4/15 22:10,2,73,-71,
5288,37,2022/4/15 22:20,2,70,-68,
5289,37,2022/4/15 22:30,2,83,-81,
5290,37,2022/4/15 22:40,2,63,-61,
5291,37,2022/4/15 22:50,1,65,-64,
5292,29,2022/4/15 5:00,0,1,-1,
5293,29,2022/4/15 5:10,0,1,-1,
5294,29,2022/4/15 5:20,6,1,5,
5295,29,2022/4/15 5:30,18,1,17,
5296,29,2022/4/15 5:40,14,1,13,
5297,29,2022/4/15 5:50,17,1,16,
5298,29,2022/4/15 6:00,26,1,25,
5299,29,2022/4/15 6:10,28,1,27,
5300,29,2022/4/15 6:20,40,5,35,
5301,29,2022/4/15 6:30,46,23,23,
5302,29,2022/4/15 6:40,70,23,47,
5303,29,2022/4/15 6:50,84,41,43,
5304,29,2022/4/15 7:00,169,55,114,
5305,29,2022/4/15 7:10,232,38,194,
5306,29,2022/4/15 7:20,283,105,178,
5307,29,2022/4/15 7:30,279,64,215,
5308,29,2022/4/15 7:40,279,80,199,
5309,29,2022/4/15 7:50,267,70,197,
5310,29,2022/4/15 8:00,237,107,130,
5311,29,2022/4/15 8:10,189,93,96,
5312,29,2022/4/15 8:20,156,75,81,
5313,29,2022/4/15 8:30,150,75,75,
5314,29,2022/4/15 8:40,61,100,-39,
5315,29,2022/4/15 8:50,56,68,-12,
5316,29,2022/4/15 9:00,41,57,-16,
5317,29,2022/4/15 9:10,28,66,-38,
5318,29,2022/4/15 9:20,30,71,-41,
5319,29,2022/4/15 9:30,29,65,-36,
5320,29,2022/4/15 9:40,29,66,-37,
5321,29,2022/4/15 9:50,28,47,-19,
5322,29,2022/4/15 10:00,27,63,-36,
5323,29,2022/4/15 10:10,23,61,-38,
5324,29,2022/4/15 10:20,26,51,-25,
5325,29,2022/4/15 10:30,25,32,-7,
5326,29,2022/4/15 10:40,25,55,-30,
5327,29,2022/4/15 10:50,27,64,-37,
5328,29,2022/4/15 11:00,24,49,-25,
5329,29,2022/4/15 11:10,25,11,14,
5330,29,2022/4/15 11:20,27,50,-23,
5331,29,2022/4/15 11:30,28,49,-21,
5332,29,2022/4/15 11:40,28,51,-23,
5333,29,2022/4/15 11:50,29,55,-26,
5334,29,2022/4/15 12:00,26,54,-28,
5335,29,2022/4/15 12:10,23,7,16,
5336,29,2022/4/15 12:20,25,67,-42,
5337,29,2022/4/15 12:30,24,58,-34,
5338,29,2022/4/15 12:40,28,62,-34,
5339,29,2022/4/15 12:50,23,60,-37,
5340,29,2022/4/15 13:00,23,20,3,
5341,29,2022/4/15 13:10,25,52,-27,
5342,29,2022/4/15 13:20,22,63,-41,
5343,29,2022/4/15 13:30,23,70,-47,
5344,29,2022/4/15 13:40,20,66,-46,
5345,29,2022/4/15 13:50,25,62,-37,
5346,29,2022/4/15 14:00,22,30,-8,
5347,29,2022/4/15 14:10,26,48,-22,
5348,29,2022/4/15 14:20,25,61,-36,
5349,29,2022/4/15 14:30,26,61,-35,
5350,29,2022/4/15 14:40,23,62,-39,
5351,29,2022/4/15 14:50,26,65,-39,
5352,29,2022/4/15 15:00,24,27,-3,
5353,29,2022/4/15 15:10,24,49,-25,
5354,29,2022/4/15 15:20,27,67,-40,
5355,29,2022/4/15 15:30,25,66,-41,
5356,29,2022/4/15 15:40,24,67,-43,
5357,29,2022/4/15 15:50,28,70,-42,
5358,29,2022/4/15 16:00,22,36,-14,
5359,29,2022/4/15 16:10,24,48,-24,
5360,29,2022/4/15 16:20,27,60,-33,
5361,29,2022/4/15 16:30,28,67,-39,
5362,29,2022/4/15 16:40,27,77,-50,
5363,29,2022/4/15 16:50,31,77,-46,
5364,29,2022/4/15 17:00,26,43,-17,
5365,29,2022/4/15 17:10,37,76,-39,
5366,29,2022/4/15 17:20,32,105,-73,
5367,29,2022/4/15 17:30,29,111,-82,
5368,29,2022/4/15 17:40,34,122,-88,
5369,29,2022/4/15 17:50,28,100,-72,
5370,29,2022/4/15 18:00,28,110,-82,
5371,29,2022/4/15 18:10,28,106,-78,
5372,29,2022/4/15 18:20,26,122,-96,
5373,29,2022/4/15 18:30,27,128,-101,
5374,29,2022/4/15 18:40,20,125,-105,
5375,29,2022/4/15 18:50,20,98,-78,
5376,29,2022/4/15 19:00,17,121,-104,
5377,29,2022/4/15 19:10,16,110,-94,
5378,29,2022/4/15 19:20,13,107,-94,
5379,29,2022/4/15 19:30,14,112,-98,
5380,29,2022/4/15 19:40,17,106,-89,
5381,29,2022/4/15 19:50,15,101,-86,
5382,29,2022/4/15 20:00,14,79,-65,
5383,29,2022/4/15 20:10,14,85,-71,
5384,29,2022/4/15 20:20,12,84,-72,
5385,29,2022/4/15 20:30,12,94,-82,
5386,29,2022/4/15 20:40,12,35,-23,
5387,29,2022/4/15 20:50,10,79,-69,
5388,29,2022/4/15 21:00,11,77,-66,
5389,29,2022/4/15 21:10,11,86,-75,
5390,29,2022/4/15 21:20,8,75,-67,
5391,29,2022/4/15 21:30,7,10,-3,
5392,29,2022/4/15 21:40,8,76,-68,
5393,29,2022/4/15 21:50,2,78,-76,
5394,29,2022/4/15 22:00,0,14,-14,
5395,29,2022/4/15 22:10,0,69,-69,
5396,29,2022/4/15 22:20,0,77,-77,
5397,29,2022/4/15 22:30,0,23,-23,
5398,29,2022/4/15 22:40,0,56,-56,
5399,29,2022/4/15 22:50,0,62,-62,
5400,36,2022/4/15 5:00,0,1,-1,
5401,36,2022/4/15 5:10,1,1,0,
5402,36,2022/4/15 5:20,11,1,10,
5403,36,2022/4/15 5:30,25,1,24,
5404,36,2022/4/15 5:40,28,1,27,
5405,36,2022/4/15 5:50,30,1,29,
5406,36,2022/4/15 6:00,36,1,35,
5407,36,2022/4/15 6:10,49,1,48,
5408,36,2022/4/15 6:20,58,1,57,
5409,36,2022/4/15 6:30,73,1,72,
5410,36,2022/4/15 6:40,67,73,-6,
5411,36,2022/4/15 6:50,87,21,66,
5412,36,2022/4/15 7:00,206,63,143,
5413,36,2022/4/15 7:10,217,110,107,
5414,36,2022/4/15 7:20,282,102,180,
5415,36,2022/4/15 7:30,254,104,150,
5416,36,2022/4/15 7:40,316,109,207,
5417,36,2022/4/15 7:50,227,119,108,
5418,36,2022/4/15 8:00,229,112,117,
5419,36,2022/4/15 8:10,198,111,87,
5420,36,2022/4/15 8:20,186,171,15,
5421,36,2022/4/15 8:30,85,120,-35,
5422,36,2022/4/15 8:40,71,104,-33,
5423,36,2022/4/15 8:50,55,90,-35,
5424,36,2022/4/15 9:00,44,123,-79,
5425,36,2022/4/15 9:10,34,104,-70,
5426,36,2022/4/15 9:20,28,82,-54,
5427,36,2022/4/15 9:30,26,90,-64,
5428,36,2022/4/15 9:40,27,108,-81,
5429,36,2022/4/15 9:50,31,84,-53,
5430,36,2022/4/15 10:00,27,72,-45,
5431,36,2022/4/15 10:10,25,57,-32,
5432,36,2022/4/15 10:20,28,67,-39,
5433,36,2022/4/15 10:30,25,84,-59,
5434,36,2022/4/15 10:40,26,73,-47,
5435,36,2022/4/15 10:50,23,12,11,
5436,36,2022/4/15 11:00,28,83,-55,
5437,36,2022/4/15 11:10,25,62,-37,
5438,36,2022/4/15 11:20,25,74,-49,
5439,36,2022/4/15 11:30,25,65,-40,
5440,36,2022/4/15 11:40,28,69,-41,
5441,36,2022/4/15 11:50,25,16,9,
5442,36,2022/4/15 12:00,27,70,-43,
5443,36,2022/4/15 12:10,34,71,-37,
5444,36,2022/4/15 12:20,28,77,-49,
5445,36,2022/4/15 12:30,24,64,-40,
5446,36,2022/4/15 12:40,29,21,8,
5447,36,2022/4/15 12:50,38,61,-23,
5448,36,2022/4/15 13:00,33,85,-52,
5449,36,2022/4/15 13:10,30,69,-39,
5450,36,2022/4/15 13:20,25,85,-60,
5451,36,2022/4/15 13:30,26,71,-45,
5452,36,2022/4/15 13:40,22,23,-1,
5453,36,2022/4/15 13:50,25,66,-41,
5454,36,2022/4/15 14:00,25,83,-58,
5455,36,2022/4/15 14:10,24,63,-39,
5456,36,2022/4/15 14:20,23,63,-40,
5457,36,2022/4/15 14:30,24,65,-41,
5458,36,2022/4/15 14:40,30,19,11,
5459,36,2022/4/15 14:50,21,71,-50,
5460,36,2022/4/15 15:00,26,72,-46,
5461,36,2022/4/15 15:10,29,76,-47,
5462,36,2022/4/15 15:20,31,83,-52,
5463,36,2022/4/15 15:30,28,77,-49,
5464,36,2022/4/15 15:40,30,19,11,
5465,36,2022/4/15 15:50,28,82,-54,
5466,36,2022/4/15 16:00,29,76,-47,
5467,36,2022/4/15 16:10,26,94,-68,
5468,36,2022/4/15 16:20,37,98,-61,
5469,36,2022/4/15 16:30,30,80,-50,
5470,36,2022/4/15 16:40,41,28,13,
5471,36,2022/4/15 16:50,46,89,-43,
5472,36,2022/4/15 17:00,42,102,-60,
5473,36,2022/4/15 17:10,44,106,-62,
5474,36,2022/4/15 17:20,48,109,-61,
5475,36,2022/4/15 17:30,73,122,-49,
5476,36,2022/4/15 17:40,47,125,-78,
5477,36,2022/4/15 17:50,41,105,-64,
5478,36,2022/4/15 18:00,45,169,-124,
5479,36,2022/4/15 18:10,35,107,-72,
5480,36,2022/4/15 18:20,45,107,-62,
5481,36,2022/4/15 18:30,41,123,-82,
5482,36,2022/4/15 18:40,42,200,-158,
5483,36,2022/4/15 18:50,36,180,-144,
5484,36,2022/4/15 19:00,25,119,-94,
5485,36,2022/4/15 19:10,25,124,-99,
5486,36,2022/4/15 19:20,24,233,-209,
5487,36,2022/4/15 19:30,21,103,-82,
5488,36,2022/4/15 19:40,18,90,-72,
5489,36,2022/4/15 19:50,18,105,-87,
5490,36,2022/4/15 20:00,18,104,-86,
5491,36,2022/4/15 20:10,22,104,-82,
5492,36,2022/4/15 20:20,16,78,-62,
5493,36,2022/4/15 20:30,18,97,-79,
5494,36,2022/4/15 20:40,21,95,-74,
5495,36,2022/4/15 20:50,14,107,-93,
5496,36,2022/4/15 21:00,17,100,-83,
5497,36,2022/4/15 21:10,14,100,-86,
5498,36,2022/4/15 21:20,17,3,14,
5499,36,2022/4/15 21:30,13,102,-89,
5500,36,2022/4/15 21:40,10,103,-93,
5501,36,2022/4/15 21:50,1,62,-61,
5502,36,2022/4/15 22:00,0,72,-72,
5503,36,2022/4/15 22:10,0,98,-98,
5504,36,2022/4/15 22:20,0,99,-99,
5505,36,2022/4/15 22:30,0,10,-10,
5506,36,2022/4/15 22:40,0,80,-80,
5507,36,2022/4/15 22:50,0,67,-67,
5508,35,2022/4/15 5:00,0,1,-1,
5509,35,2022/4/15 5:10,2,1,1,
5510,35,2022/4/15 5:20,31,1,30,
5511,35,2022/4/15 5:30,29,1,28,
5512,35,2022/4/15 5:40,37,1,36,
5513,35,2022/4/15 5:50,49,1,48,
5514,35,2022/4/15 6:00,56,2,54,
5515,35,2022/4/15 6:10,74,1,73,
5516,35,2022/4/15 6:20,91,2,89,
5517,35,2022/4/15 6:30,212,1,211,
5518,35,2022/4/15 6:40,270,104,166,
5519,35,2022/4/15 6:50,347,99,248,
5520,35,2022/4/15 7:00,597,134,463,
5521,35,2022/4/15 7:10,590,222,368,
5522,35,2022/4/15 7:20,720,150,570,
5523,35,2022/4/15 7:30,720,158,562,
5524,35,2022/4/15 7:40,661,110,551,
5525,35,2022/4/15 7:50,593,540,53,
5526,35,2022/4/15 8:00,592,319,273,
5527,35,2022/4/15 8:10,442,121,321,
5528,35,2022/4/15 8:20,347,178,169,
5529,35,2022/4/15 8:30,269,234,35,
5530,35,2022/4/15 8:40,228,299,-71,
5531,35,2022/4/15 8:50,186,110,76,
5532,35,2022/4/15 9:00,86,112,-26,
5533,35,2022/4/15 9:10,142,159,-17,
5534,35,2022/4/15 9:20,92,111,-19,
5535,35,2022/4/15 9:30,70,100,-30,
5536,35,2022/4/15 9:40,66,112,-46,
5537,35,2022/4/15 9:50,70,108,-38,
5538,35,2022/4/15 10:00,66,124,-58,
5539,35,2022/4/15 10:10,55,102,-47,
5540,35,2022/4/15 10:20,69,103,-34,
5541,35,2022/4/15 10:30,58,122,-64,
5542,35,2022/4/15 10:40,54,31,23,
5543,35,2022/4/15 10:50,56,98,-42,
5544,35,2022/4/15 11:00,64,110,-46,
5545,35,2022/4/15 11:10,63,99,-36,
5546,35,2022/4/15 11:20,63,112,-49,
5547,35,2022/4/15 11:30,83,81,2,
5548,35,2022/4/15 11:40,109,59,50,
5549,35,2022/4/15 11:50,128,104,24,
5550,35,2022/4/15 12:00,111,109,2,
5551,35,2022/4/15 12:10,156,109,47,
5552,35,2022/4/15 12:20,149,109,40,
5553,35,2022/4/15 12:30,129,42,87,
5554,35,2022/4/15 12:40,99,111,-12,
5555,35,2022/4/15 12:50,99,102,-3,
5556,35,2022/4/15 13:00,81,120,-39,
5557,35,2022/4/15 13:10,60,122,-62,
5558,35,2022/4/15 13:20,72,105,-33,
5559,35,2022/4/15 13:30,55,46,9,
5560,35,2022/4/15 13:40,64,95,-31,
5561,35,2022/4/15 13:50,57,103,-46,
5562,35,2022/4/15 14:00,63,105,-42,
5563,35,2022/4/15 14:10,65,105,-40,
5564,35,2022/4/15 14:20,81,110,-29,
5565,35,2022/4/15 14:30,60,35,25,
5566,35,2022/4/15 14:40,82,102,-20,
5567,35,2022/4/15 14:50,94,112,-18,
5568,35,2022/4/15 15:00,96,108,-12,
5569,35,2022/4/15 15:10,83,96,-13,
5570,35,2022/4/15 15:20,98,103,-5,
5571,35,2022/4/15 15:30,69,39,30,
5572,35,2022/4/15 15:40,109,123,-14,
5573,35,2022/4/15 15:50,145,119,26,
5574,35,2022/4/15 16:00,180,119,61,
5575,35,2022/4/15 16:10,207,121,86,
5576,35,2022/4/15 16:20,170,107,63,
5577,35,2022/4/15 16:30,180,57,123,
5578,35,2022/4/15 16:40,222,121,101,
5579,35,2022/4/15 16:50,222,111,111,
5580,35,2022/4/15 17:00,195,119,76,
5581,35,2022/4/15 17:10,270,140,130,
5582,35,2022/4/15 17:20,287,109,178,
5583,35,2022/4/15 17:30,265,54,211,
5584,35,2022/4/15 17:40,223,317,-94,
5585,35,2022/4/15 17:50,274,115,159,
5586,35,2022/4/15 18:00,133,111,22,
5587,35,2022/4/15 18:10,156,179,-23,
5588,35,2022/4/15 18:20,167,271,-104,
5589,35,2022/4/15 18:30,55,128,-73,
5590,35,2022/4/15 18:40,49,153,-104,
5591,35,2022/4/15 18:50,40,224,-184,
5592,35,2022/4/15 19:00,41,315,-274,
5593,35,2022/4/15 19:10,33,109,-76,
5594,35,2022/4/15 19:20,36,111,-75,
5595,35,2022/4/15 19:30,23,179,-156,
5596,35,2022/4/15 19:40,37,216,-179,
5597,35,2022/4/15 19:50,29,99,-70,
5598,35,2022/4/15 20:00,29,103,-74,
5599,35,2022/4/15 20:10,33,115,-82,
5600,35,2022/4/15 20:20,28,66,-38,
5601,35,2022/4/15 20:30,28,116,-88,
5602,35,2022/4/15 20:40,28,116,-88,
5603,35,2022/4/15 20:50,30,108,-78,
5604,35,2022/4/15 21:00,26,105,-79,
5605,35,2022/4/15 21:10,32,22,10,
5606,35,2022/4/15 21:20,27,112,-85,
5607,35,2022/4/15 21:30,21,106,-85,
5608,35,2022/4/15 21:40,13,100,-87,
5609,35,2022/4/15 21:50,0,3,-3,
5610,35,2022/4/15 22:00,0,102,-102,
5611,35,2022/4/15 22:10,0,107,-107,
5612,35,2022/4/15 22:20,0,3,-3,
5613,35,2022/4/15 22:30,0,104,-104,
5614,35,2022/4/15 22:40,0,92,-92,
5615,35,2022/4/15 22:50,0,3,-3,
5616,51,2022/4/15 5:00,0,1,-1,
5617,51,2022/4/15 5:10,0,1,-1,
5618,51,2022/4/15 5:20,0,1,-1,
5619,51,2022/4/15 5:30,7,1,6,
5620,51,2022/4/15 5:40,16,1,15,
5621,51,2022/4/15 5:50,9,1,8,
5622,51,2022/4/15 6:00,11,1,10,
5623,51,2022/4/15 6:10,16,1,15,
5624,51,2022/4/15 6:20,12,1,11,
5625,51,2022/4/15 6:30,19,12,7,
5626,51,2022/4/15 6:40,17,67,-50,
5627,51,2022/4/15 6:50,25,60,-35,
5628,51,2022/4/15 7:00,28,62,-34,
5629,51,2022/4/15 7:10,25,91,-66,
5630,51,2022/4/15 7:20,33,99,-66,
5631,51,2022/4/15 7:30,34,99,-65,
5632,51,2022/4/15 7:40,28,97,-69,
5633,51,2022/4/15 7:50,30,106,-76,
5634,51,2022/4/15 8:00,24,117,-93,
5635,51,2022/4/15 8:10,30,95,-65,
5636,51,2022/4/15 8:20,27,106,-79,
5637,51,2022/4/15 8:30,23,128,-105,
5638,51,2022/4/15 8:40,26,101,-75,
5639,51,2022/4/15 8:50,26,92,-66,
5640,51,2022/4/15 9:00,24,103,-79,
5641,51,2022/4/15 9:10,24,99,-75,
5642,51,2022/4/15 9:20,20,109,-89,
5643,51,2022/4/15 9:30,21,114,-93,
5644,51,2022/4/15 9:40,18,91,-73,
5645,51,2022/4/15 9:50,30,128,-98,
5646,51,2022/4/15 10:00,24,106,-82,
5647,51,2022/4/15 10:10,33,91,-58,
5648,51,2022/4/15 10:20,36,87,-51,
5649,51,2022/4/15 10:30,27,47,-20,
5650,51,2022/4/15 10:40,42,84,-42,
5651,51,2022/4/15 10:50,30,93,-63,
5652,51,2022/4/15 11:00,65,73,-8,
5653,51,2022/4/15 11:10,42,65,-23,
5654,51,2022/4/15 11:20,50,69,-19,
5655,51,2022/4/15 11:30,47,34,13,
5656,51,2022/4/15 11:40,39,67,-28,
5657,51,2022/4/15 11:50,33,57,-24,
5658,51,2022/4/15 12:00,30,60,-30,
5659,51,2022/4/15 12:10,33,60,-27,
5660,51,2022/4/15 12:20,35,18,17,
5661,51,2022/4/15 12:30,30,56,-26,
5662,51,2022/4/15 12:40,22,58,-36,
5663,51,2022/4/15 12:50,23,55,-32,
5664,51,2022/4/15 13:00,21,55,-34,
5665,51,2022/4/15 13:10,25,63,-38,
5666,51,2022/4/15 13:20,26,22,4,
5667,51,2022/4/15 13:30,21,61,-40,
5668,51,2022/4/15 13:40,22,61,-39,
5669,51,2022/4/15 13:50,23,51,-28,
5670,51,2022/4/15 14:00,15,55,-40,
5671,51,2022/4/15 14:10,23,51,-28,
5672,51,2022/4/15 14:20,20,19,1,
5673,51,2022/4/15 14:30,25,48,-23,
5674,51,2022/4/15 14:40,15,43,-28,
5675,51,2022/4/15 14:50,22,39,-17,
5676,51,2022/4/15 15:00,18,42,-24,
5677,51,2022/4/15 15:10,21,47,-26,
5678,51,2022/4/15 15:20,22,18,4,
5679,51,2022/4/15 15:30,19,41,-22,
5680,51,2022/4/15 15:40,23,50,-27,
5681,51,2022/4/15 15:50,15,38,-23,
5682,51,2022/4/15 16:00,20,38,-18,
5683,51,2022/4/15 16:10,21,42,-21,
5684,51,2022/4/15 16:20,25,22,3,
5685,51,2022/4/15 16:30,23,38,-15,
5686,51,2022/4/15 16:40,22,41,-19,
5687,51,2022/4/15 16:50,30,49,-19,
5688,51,2022/4/15 17:00,35,51,-16,
5689,51,2022/4/15 17:10,36,61,-25,
5690,51,2022/4/15 17:20,31,29,2,
5691,51,2022/4/15 17:30,20,70,-50,
5692,51,2022/4/15 17:40,17,59,-42,
5693,51,2022/4/15 17:50,19,45,-26,
5694,51,2022/4/15 18:00,22,39,-17,
5695,51,2022/4/15 18:10,21,62,-41,
5696,51,2022/4/15 18:20,19,60,-41,
5697,51,2022/4/15 18:30,13,52,-39,
5698,51,2022/4/15 18:40,17,51,-34,
5699,51,2022/4/15 18:50,11,68,-57,
5700,51,2022/4/15 19:00,21,48,-27,
5701,51,2022/4/15 19:10,11,43,-32,
5702,51,2022/4/15 19:20,14,49,-35,
5703,51,2022/4/15 19:30,8,54,-46,
5704,51,2022/4/15 19:40,10,41,-31,
5705,51,2022/4/15 19:50,6,27,-21,
5706,51,2022/4/15 20:00,22,25,-3,
5707,51,2022/4/15 20:10,8,25,-17,
5708,51,2022/4/15 20:20,11,25,-14,
5709,51,2022/4/15 20:30,5,32,-27,
5710,51,2022/4/15 20:40,12,31,-19,
5711,51,2022/4/15 20:50,6,27,-21,
5712,51,2022/4/15 21:00,16,10,6,
5713,51,2022/4/15 21:10,15,23,-8,
5714,51,2022/4/15 21:20,1,37,-36,
5715,51,2022/4/15 21:30,1,31,-30,
5716,51,2022/4/15 21:40,1,3,-2,
5717,51,2022/4/15 21:50,0,31,-31,
5718,51,2022/4/15 22:00,0,33,-33,
5719,51,2022/4/15 22:10,0,21,-21,
5720,51,2022/4/15 22:20,0,13,-13,
5721,51,2022/4/15 22:30,0,25,-25,
5722,51,2022/4/15 22:40,0,10,-10,
5723,51,2022/4/15 22:50,0,8,-8,
5724,31,2022/4/15 5:00,0,1,-1,
5725,31,2022/4/15 5:10,0,1,-1,
5726,31,2022/4/15 5:20,2,1,1,
5727,31,2022/4/15 5:30,5,1,4,
5728,31,2022/4/15 5:40,3,1,2,
5729,31,2022/4/15 5:50,4,1,3,
5730,31,2022/4/15 6:00,13,1,12,
5731,31,2022/4/15 6:10,16,1,15,
5732,31,2022/4/15 6:20,19,1,18,
5733,31,2022/4/15 6:30,17,1,16,
5734,31,2022/4/15 6:40,23,23,0,
5735,31,2022/4/15 6:50,23,21,2,
5736,31,2022/4/15 7:00,29,33,-4,
5737,31,2022/4/15 7:10,31,19,12,
5738,31,2022/4/15 7:20,36,65,-29,
5739,31,2022/4/15 7:30,31,64,-33,
5740,31,2022/4/15 7:40,31,71,-40,
5741,31,2022/4/15 7:50,31,50,-19,
5742,31,2022/4/15 8:00,30,63,-33,
5743,31,2022/4/15 8:10,22,51,-29,
5744,31,2022/4/15 8:20,23,67,-44,
5745,31,2022/4/15 8:30,19,59,-40,
5746,31,2022/4/15 8:40,17,53,-36,
5747,31,2022/4/15 8:50,15,80,-65,
5748,31,2022/4/15 9:00,10,47,-37,
5749,31,2022/4/15 9:10,11,30,-19,
5750,31,2022/4/15 9:20,11,35,-24,
5751,31,2022/4/15 9:30,9,34,-25,
5752,31,2022/4/15 9:40,9,37,-28,
5753,31,2022/4/15 9:50,10,32,-22,
5754,31,2022/4/15 10:00,8,30,-22,
5755,31,2022/4/15 10:10,9,37,-28,
5756,31,2022/4/15 10:20,8,21,-13,
5757,31,2022/4/15 10:30,8,32,-24,
5758,31,2022/4/15 10:40,6,37,-31,
5759,31,2022/4/15 10:50,8,29,-21,
5760,31,2022/4/15 11:00,7,8,-1,
5761,31,2022/4/15 11:10,10,33,-23,
5762,31,2022/4/15 11:20,11,30,-19,
5763,31,2022/4/15 11:30,10,29,-19,
5764,31,2022/4/15 11:40,11,23,-12,
5765,31,2022/4/15 11:50,11,23,-12,
5766,31,2022/4/15 12:00,12,16,-4,
5767,31,2022/4/15 12:10,10,15,-5,
5768,31,2022/4/15 12:20,10,32,-22,
5769,31,2022/4/15 12:30,13,23,-10,
5770,31,2022/4/15 12:40,10,25,-15,
5771,31,2022/4/15 12:50,8,22,-14,
5772,31,2022/4/15 13:00,13,8,5,
5773,31,2022/4/15 13:10,11,25,-14,
5774,31,2022/4/15 13:20,10,31,-21,
5775,31,2022/4/15 13:30,10,25,-15,
5776,31,2022/4/15 13:40,11,29,-18,
5777,31,2022/4/15 13:50,11,23,-12,
5778,31,2022/4/15 14:00,8,12,-4,
5779,31,2022/4/15 14:10,9,35,-26,
5780,31,2022/4/15 14:20,10,32,-22,
5781,31,2022/4/15 14:30,11,31,-20,
5782,31,2022/4/15 14:40,11,23,-12,
5783,31,2022/4/15 14:50,9,21,-12,
5784,31,2022/4/15 15:00,11,21,-10,
5785,31,2022/4/15 15:10,11,32,-21,
5786,31,2022/4/15 15:20,12,35,-23,
5787,31,2022/4/15 15:30,12,29,-17,
5788,31,2022/4/15 15:40,13,32,-19,
5789,31,2022/4/15 15:50,12,30,-18,
5790,31,2022/4/15 16:00,20,12,8,
5791,31,2022/4/15 16:10,9,31,-22,
5792,31,2022/4/15 16:20,26,23,3,
5793,31,2022/4/15 16:30,20,47,-27,
5794,31,2022/4/15 16:40,19,38,-19,
5795,31,2022/4/15 16:50,26,32,-6,
5796,31,2022/4/15 17:00,22,14,8,
5797,31,2022/4/15 17:10,23,41,-18,
5798,31,2022/4/15 17:20,22,40,-18,
5799,31,2022/4/15 17:30,33,38,-5,
5800,31,2022/4/15 17:40,19,39,-20,
5801,31,2022/4/15 17:50,29,45,-16,
5802,31,2022/4/15 18:00,21,45,-24,
5803,31,2022/4/15 18:10,15,48,-33,
5804,31,2022/4/15 18:20,17,47,-30,
5805,31,2022/4/15 18:30,17,68,-51,
5806,31,2022/4/15 18:40,12,72,-60,
5807,31,2022/4/15 18:50,14,51,-37,
5808,31,2022/4/15 19:00,12,46,-34,
5809,31,2022/4/15 19:10,9,60,-51,
5810,31,2022/4/15 19:20,8,61,-53,
5811,31,2022/4/15 19:30,5,47,-42,
5812,31,2022/4/15 19:40,8,40,-32,
5813,31,2022/4/15 19:50,6,47,-41,
5814,31,2022/4/15 20:00,8,44,-36,
5815,31,2022/4/15 20:10,3,37,-34,
5816,31,2022/4/15 20:20,2,34,-32,
5817,31,2022/4/15 20:30,4,40,-36,
5818,31,2022/4/15 20:40,5,10,-5,
5819,31,2022/4/15 20:50,3,40,-37,
5820,31,2022/4/15 21:00,2,34,-32,
5821,31,2022/4/15 21:10,2,36,-34,
5822,31,2022/4/15 21:20,2,36,-34,
5823,31,2022/4/15 21:30,3,7,-4,
5824,31,2022/4/15 21:40,0,35,-35,
5825,31,2022/4/15 21:50,0,34,-34,
5826,31,2022/4/15 22:00,0,10,-10,
5827,31,2022/4/15 22:10,0,25,-25,
5828,31,2022/4/15 22:20,0,31,-31,
5829,31,2022/4/15 22:30,0,21,-21,
5830,31,2022/4/15 22:40,0,13,-13,
5831,31,2022/4/15 22:50,0,21,-21,
5832,50,2022/4/15 5:00,0,1,-1,
5833,50,2022/4/15 5:10,0,1,-1,
5834,50,2022/4/15 5:20,3,1,2,
5835,50,2022/4/15 5:30,15,1,14,
5836,50,2022/4/15 5:40,11,1,10,
5837,50,2022/4/15 5:50,12,1,11,
5838,50,2022/4/15 6:00,14,1,13,
5839,50,2022/4/15 6:10,17,1,16,
5840,50,2022/4/15 6:20,30,1,29,
5841,50,2022/4/15 6:30,30,1,29,
5842,50,2022/4/15 6:40,32,8,24,
5843,50,2022/4/15 6:50,41,38,3,
5844,50,2022/4/15 7:00,45,33,12,
5845,50,2022/4/15 7:10,60,59,1,
5846,50,2022/4/15 7:20,70,77,-7,
5847,50,2022/4/15 7:30,56,72,-16,
5848,50,2022/4/15 7:40,80,83,-3,
5849,50,2022/4/15 7:50,77,123,-46,
5850,50,2022/4/15 8:00,40,103,-63,
5851,50,2022/4/15 8:10,79,104,-25,
5852,50,2022/4/15 8:20,34,105,-71,
5853,50,2022/4/15 8:30,29,116,-87,
5854,50,2022/4/15 8:40,23,93,-70,
5855,50,2022/4/15 8:50,18,87,-69,
5856,50,2022/4/15 9:00,21,69,-48,
5857,50,2022/4/15 9:10,25,100,-75,
5858,50,2022/4/15 9:20,13,54,-41,
5859,50,2022/4/15 9:30,15,45,-30,
5860,50,2022/4/15 9:40,13,49,-36,
5861,50,2022/4/15 9:50,12,44,-32,
5862,50,2022/4/15 10:00,15,49,-34,
5863,50,2022/4/15 10:10,22,38,-16,
5864,50,2022/4/15 10:20,12,39,-27,
5865,50,2022/4/15 10:30,10,37,-27,
5866,50,2022/4/15 10:40,13,38,-25,
5867,50,2022/4/15 10:50,12,12,0,
5868,50,2022/4/15 11:00,11,38,-27,
5869,50,2022/4/15 11:10,18,47,-29,
5870,50,2022/4/15 11:20,19,38,-19,
5871,50,2022/4/15 11:30,17,43,-26,
5872,50,2022/4/15 11:40,16,25,-9,
5873,50,2022/4/15 11:50,14,23,-9,
5874,50,2022/4/15 12:00,25,41,-16,
5875,50,2022/4/15 12:10,25,46,-21,
5876,50,2022/4/15 12:20,17,46,-29,
5877,50,2022/4/15 12:30,17,38,-21,
5878,50,2022/4/15 12:40,16,8,8,
5879,50,2022/4/15 12:50,13,49,-36,
5880,50,2022/4/15 13:00,17,45,-28,
5881,50,2022/4/15 13:10,21,46,-25,
5882,50,2022/4/15 13:20,14,38,-24,
5883,50,2022/4/15 13:30,12,37,-25,
5884,50,2022/4/15 13:40,15,19,-4,
5885,50,2022/4/15 13:50,13,41,-28,
5886,50,2022/4/15 14:00,12,38,-26,
5887,50,2022/4/15 14:10,16,38,-22,
5888,50,2022/4/15 14:20,16,37,-21,
5889,50,2022/4/15 14:30,17,41,-24,
5890,50,2022/4/15 14:40,16,14,2,
5891,50,2022/4/15 14:50,13,40,-27,
5892,50,2022/4/15 15:00,15,45,-30,
5893,50,2022/4/15 15:10,20,40,-20,
5894,50,2022/4/15 15:20,17,46,-29,
5895,50,2022/4/15 15:30,15,46,-31,
5896,50,2022/4/15 15:40,19,12,7,
5897,50,2022/4/15 15:50,19,50,-31,
5898,50,2022/4/15 16:00,28,52,-24,
5899,50,2022/4/15 16:10,41,63,-22,
5900,50,2022/4/15 16:20,25,50,-25,
5901,50,2022/4/15 16:30,37,51,-14,
5902,50,2022/4/15 16:40,45,23,22,
5903,50,2022/4/15 16:50,38,54,-16,
5904,50,2022/4/15 17:00,48,66,-18,
5905,50,2022/4/15 17:10,72,61,11,
5906,50,2022/4/15 17:20,36,69,-33,
5907,50,2022/4/15 17:30,37,66,-29,
5908,50,2022/4/15 17:40,40,71,-31,
5909,50,2022/4/15 17:50,31,60,-29,
5910,50,2022/4/15 18:00,33,63,-30,
5911,50,2022/4/15 18:10,41,78,-37,
5912,50,2022/4/15 18:20,22,69,-47,
5913,50,2022/4/15 18:30,25,70,-45,
5914,50,2022/4/15 18:40,20,74,-54,
5915,50,2022/4/15 18:50,17,97,-80,
5916,50,2022/4/15 19:00,18,91,-73,
5917,50,2022/4/15 19:10,28,72,-44,
5918,50,2022/4/15 19:20,16,75,-59,
5919,50,2022/4/15 19:30,13,94,-81,
5920,50,2022/4/15 19:40,11,77,-66,
5921,50,2022/4/15 19:50,10,74,-64,
5922,50,2022/4/15 20:00,13,71,-58,
5923,50,2022/4/15 20:10,18,67,-49,
5924,50,2022/4/15 20:20,9,33,-24,
5925,50,2022/4/15 20:30,8,59,-51,
5926,50,2022/4/15 20:40,12,68,-56,
5927,50,2022/4/15 20:50,8,64,-56,
5928,50,2022/4/15 21:00,6,63,-57,
5929,50,2022/4/15 21:10,11,66,-55,
5930,50,2022/4/15 21:20,6,15,-9,
5931,50,2022/4/15 21:30,2,52,-50,
5932,50,2022/4/15 21:40,1,65,-64,
5933,50,2022/4/15 21:50,1,44,-43,
5934,50,2022/4/15 22:00,0,31,-31,
5935,50,2022/4/15 22:10,0,55,-55,
5936,50,2022/4/15 22:20,0,47,-47,
5937,50,2022/4/15 22:30,0,3,-3,
5938,50,2022/4/15 22:40,0,46,-46,
5939,50,2022/4/15 22:50,0,38,-38,
5940,28,2022/4/15 5:00,0,1,-1,
5941,28,2022/4/15 5:10,6,1,5,
5942,28,2022/4/15 5:20,23,1,22,
5943,28,2022/4/15 5:30,24,1,23,
5944,28,2022/4/15 5:40,26,2,24,
5945,28,2022/4/15 5:50,31,1,30,
5946,28,2022/4/15 6:00,29,5,24,
5947,28,2022/4/15 6:10,54,6,48,
5948,28,2022/4/15 6:20,59,5,54,
5949,28,2022/4/15 6:30,92,8,84,
5950,28,2022/4/15 6:40,94,19,75,
5951,28,2022/4/15 6:50,149,77,72,
5952,28,2022/4/15 7:00,195,76,119,
5953,28,2022/4/15 7:10,184,99,85,
5954,28,2022/4/15 7:20,227,108,119,
5955,28,2022/4/15 7:30,264,104,160,
5956,28,2022/4/15 7:40,215,111,104,
5957,28,2022/4/15 7:50,188,108,80,
5958,28,2022/4/15 8:00,194,98,96,
5959,28,2022/4/15 8:10,144,139,5,
5960,28,2022/4/15 8:20,99,123,-24,
5961,28,2022/4/15 8:30,68,110,-42,
5962,28,2022/4/15 8:40,60,133,-73,
5963,28,2022/4/15 8:50,56,122,-66,
5964,28,2022/4/15 9:00,45,99,-54,
5965,28,2022/4/15 9:10,38,105,-67,
5966,28,2022/4/15 9:20,38,87,-49,
5967,28,2022/4/15 9:30,36,108,-72,
5968,28,2022/4/15 9:40,28,87,-59,
5969,28,2022/4/15 9:50,29,76,-47,
5970,28,2022/4/15 10:00,32,109,-77,
5971,28,2022/4/15 10:10,29,81,-52,
5972,28,2022/4/15 10:20,29,76,-47,
5973,28,2022/4/15 10:30,30,76,-46,
5974,28,2022/4/15 10:40,30,23,7,
5975,28,2022/4/15 10:50,31,101,-70,
5976,28,2022/4/15 11:00,31,93,-62,
5977,28,2022/4/15 11:10,27,96,-69,
5978,28,2022/4/15 11:20,29,76,-47,
5979,28,2022/4/15 11:30,31,36,-5,
5980,28,2022/4/15 11:40,37,97,-60,
5981,28,2022/4/15 11:50,32,92,-60,
5982,28,2022/4/15 12:00,36,96,-60,
5983,28,2022/4/15 12:10,36,93,-57,
5984,28,2022/4/15 12:20,35,70,-35,
5985,28,2022/4/15 12:30,33,68,-35,
5986,28,2022/4/15 12:40,37,93,-56,
5987,28,2022/4/15 12:50,35,91,-56,
5988,28,2022/4/15 13:00,39,94,-55,
5989,28,2022/4/15 13:10,36,97,-61,
5990,28,2022/4/15 13:20,31,61,-30,
5991,28,2022/4/15 13:30,32,64,-32,
5992,28,2022/4/15 13:40,33,97,-64,
5993,28,2022/4/15 13:50,40,97,-57,
5994,28,2022/4/15 14:00,32,90,-58,
5995,28,2022/4/15 14:10,33,97,-64,
5996,28,2022/4/15 14:20,32,58,-26,
5997,28,2022/4/15 14:30,33,57,-24,
5998,28,2022/4/15 14:40,30,93,-63,
5999,28,2022/4/15 14:50,32,95,-63,
6000,28,2022/4/15 15:00,37,100,-63,
6001,28,2022/4/15 15:10,37,95,-58,
6002,28,2022/4/15 15:20,35,97,-62,
6003,28,2022/4/15 15:30,33,22,11,
6004,28,2022/4/15 15:40,33,102,-69,
6005,28,2022/4/15 15:50,37,102,-65,
6006,28,2022/4/15 16:00,37,102,-65,
6007,28,2022/4/15 16:10,41,101,-60,
6008,28,2022/4/15 16:20,48,85,-37,
6009,28,2022/4/15 16:30,53,59,-6,
6010,28,2022/4/15 16:40,52,118,-66,
6011,28,2022/4/15 16:50,89,102,-13,
6012,28,2022/4/15 17:00,70,122,-52,
6013,28,2022/4/15 17:10,73,124,-51,
6014,28,2022/4/15 17:20,66,103,-37,
6015,28,2022/4/15 17:30,73,78,-5,
6016,28,2022/4/15 17:40,73,132,-59,
6017,28,2022/4/15 17:50,61,179,-118,
6018,28,2022/4/15 18:00,70,124,-54,
6019,28,2022/4/15 18:10,57,123,-66,
6020,28,2022/4/15 18:20,47,110,-63,
6021,28,2022/4/15 18:30,42,214,-172,
6022,28,2022/4/15 18:40,40,110,-70,
6023,28,2022/4/15 18:50,37,110,-73,
6024,28,2022/4/15 19:00,37,110,-73,
6025,28,2022/4/15 19:10,41,180,-139,
6026,28,2022/4/15 19:20,34,126,-92,
6027,28,2022/4/15 19:30,34,99,-65,
6028,28,2022/4/15 19:40,37,117,-80,
6029,28,2022/4/15 19:50,33,103,-70,
6030,28,2022/4/15 20:00,30,95,-65,
6031,28,2022/4/15 20:10,37,88,-51,
6032,28,2022/4/15 20:20,25,84,-59,
6033,28,2022/4/15 20:30,29,92,-63,
6034,28,2022/4/15 20:40,27,82,-55,
6035,28,2022/4/15 20:50,25,88,-63,
6036,28,2022/4/15 21:00,26,75,-49,
6037,28,2022/4/15 21:10,26,23,3,
6038,28,2022/4/15 21:20,25,75,-50,
6039,28,2022/4/15 21:30,26,76,-50,
6040,28,2022/4/15 21:40,7,85,-78,
6041,28,2022/4/15 21:50,7,8,-1,
6042,28,2022/4/15 22:00,7,82,-75,
6043,28,2022/4/15 22:10,4,85,-81,
6044,28,2022/4/15 22:20,1,15,-14,
6045,28,2022/4/15 22:30,2,70,-68,
6046,28,2022/4/15 22:40,2,74,-72,
6047,28,2022/4/15 22:50,1,10,-9,
6048,58,2022/4/15 5:00,0,1,-1,
6049,58,2022/4/15 5:10,0,1,-1,
6050,58,2022/4/15 5:20,0,1,-1,
6051,58,2022/4/15 5:30,18,1,17,
6052,58,2022/4/15 5:40,21,1,20,
6053,58,2022/4/15 5:50,19,1,18,
6054,58,2022/4/15 6:00,22,1,21,
6055,58,2022/4/15 6:10,30,1,29,
6056,58,2022/4/15 6:20,36,1,35,
6057,58,2022/4/15 6:30,57,1,56,
6058,58,2022/4/15 6:40,78,1,77,
6059,58,2022/4/15 6:50,111,38,73,
6060,58,2022/4/15 7:00,183,38,145,
6061,58,2022/4/15 7:10,180,45,135,
6062,58,2022/4/15 7:20,207,11,196,
6063,58,2022/4/15 7:30,219,59,160,
6064,58,2022/4/15 7:40,200,46,154,
6065,58,2022/4/15 7:50,200,65,135,
6066,58,2022/4/15 8:00,162,64,98,
6067,58,2022/4/15 8:10,107,93,14,
6068,58,2022/4/15 8:20,85,121,-36,
6069,58,2022/4/15 8:30,51,95,-44,
6070,58,2022/4/15 8:40,54,75,-21,
6071,58,2022/4/15 8:50,34,66,-32,
6072,58,2022/4/15 9:00,37,79,-42,
6073,58,2022/4/15 9:10,32,57,-25,
6074,58,2022/4/15 9:20,30,46,-16,
6075,58,2022/4/15 9:30,27,60,-33,
6076,58,2022/4/15 9:40,29,50,-21,
6077,58,2022/4/15 9:50,27,40,-13,
6078,58,2022/4/15 10:00,25,40,-15,
6079,58,2022/4/15 10:10,25,46,-21,
6080,58,2022/4/15 10:20,26,61,-35,
6081,58,2022/4/15 10:30,22,22,0,
6082,58,2022/4/15 10:40,22,38,-16,
6083,58,2022/4/15 10:50,21,62,-41,
6084,58,2022/4/15 11:00,21,51,-30,
6085,58,2022/4/15 11:10,18,12,6,
6086,58,2022/4/15 11:20,23,51,-28,
6087,58,2022/4/15 11:30,22,42,-20,
6088,58,2022/4/15 11:40,21,45,-24,
6089,58,2022/4/15 11:50,21,49,-28,
6090,58,2022/4/15 12:00,22,50,-28,
6091,58,2022/4/15 12:10,26,54,-28,
6092,58,2022/4/15 12:20,28,12,16,
6093,58,2022/4/15 12:30,24,54,-30,
6094,58,2022/4/15 12:40,21,52,-31,
6095,58,2022/4/15 12:50,25,61,-36,
6096,58,2022/4/15 13:00,22,54,-32,
6097,58,2022/4/15 13:10,28,44,-16,
6098,58,2022/4/15 13:20,20,25,-5,
6099,58,2022/4/15 13:30,21,58,-37,
6100,58,2022/4/15 13:40,20,52,-32,
6101,58,2022/4/15 13:50,18,57,-39,
6102,58,2022/4/15 14:00,22,50,-28,
6103,58,2022/4/15 14:10,15,37,-22,
6104,58,2022/4/15 14:20,17,37,-20,
6105,58,2022/4/15 14:30,21,48,-27,
6106,58,2022/4/15 14:40,21,54,-33,
6107,58,2022/4/15 14:50,19,52,-33,
6108,58,2022/4/15 15:00,21,61,-40,
6109,58,2022/4/15 15:10,21,37,-16,
6110,58,2022/4/15 15:20,24,70,-46,
6111,58,2022/4/15 15:30,22,25,-3,
6112,58,2022/4/15 15:40,18,66,-48,
6113,58,2022/4/15 15:50,23,64,-41,
6114,58,2022/4/15 16:00,21,66,-45,
6115,58,2022/4/15 16:10,20,50,-30,
6116,58,2022/4/15 16:20,21,36,-15,
6117,58,2022/4/15 16:30,25,60,-35,
6118,58,2022/4/15 16:40,24,85,-61,
6119,58,2022/4/15 16:50,27,74,-47,
6120,58,2022/4/15 17:00,26,69,-43,
6121,58,2022/4/15 17:10,25,70,-45,
6122,58,2022/4/15 17:20,25,49,-24,
6123,58,2022/4/15 17:30,29,88,-59,
6124,58,2022/4/15 17:40,36,90,-54,
6125,58,2022/4/15 17:50,33,93,-60,
6126,58,2022/4/15 18:00,31,104,-73,
6127,58,2022/4/15 18:10,31,93,-62,
6128,58,2022/4/15 18:20,29,95,-66,
6129,58,2022/4/15 18:30,25,115,-90,
6130,58,2022/4/15 18:40,28,128,-100,
6131,58,2022/4/15 18:50,26,114,-88,
6132,58,2022/4/15 19:00,23,107,-84,
6133,58,2022/4/15 19:10,21,112,-91,
6134,58,2022/4/15 19:20,19,109,-90,
6135,58,2022/4/15 19:30,14,108,-94,
6136,58,2022/4/15 19:40,13,113,-100,
6137,58,2022/4/15 19:50,16,100,-84,
6138,58,2022/4/15 20:00,15,129,-114,
6139,58,2022/4/15 20:10,15,77,-62,
6140,58,2022/4/15 20:20,12,74,-62,
6141,58,2022/4/15 20:30,13,83,-70,
6142,58,2022/4/15 20:40,9,76,-67,
6143,58,2022/4/15 20:50,9,77,-68,
6144,58,2022/4/15 21:00,10,18,-8,
6145,58,2022/4/15 21:10,13,74,-61,
6146,58,2022/4/15 21:20,12,71,-59,
6147,58,2022/4/15 21:30,8,79,-71,
6148,58,2022/4/15 21:40,1,31,-30,
6149,58,2022/4/15 21:50,2,69,-67,
6150,58,2022/4/15 22:00,1,74,-73,
6151,58,2022/4/15 22:10,2,74,-72,
6152,58,2022/4/15 22:20,2,4,-2,
6153,58,2022/4/15 22:30,1,68,-67,
6154,58,2022/4/15 22:40,0,61,-61,
6155,58,2022/4/15 22:50,1,3,-2,
6156,33,2022/4/15 5:00,0,1,-1,
6157,33,2022/4/15 5:10,0,1,-1,
6158,33,2022/4/15 5:20,3,1,2,
6159,33,2022/4/15 5:30,13,1,12,
6160,33,2022/4/15 5:40,8,1,7,
6161,33,2022/4/15 5:50,8,1,7,
6162,33,2022/4/15 6:00,10,1,9,
6163,33,2022/4/15 6:10,15,1,14,
6164,33,2022/4/15 6:20,24,1,23,
6165,33,2022/4/15 6:30,28,1,27,
6166,33,2022/4/15 6:40,39,1,38,
6167,33,2022/4/15 6:50,49,1,48,
6168,33,2022/4/15 7:00,55,45,10,
6169,33,2022/4/15 7:10,64,12,52,
6170,33,2022/4/15 7:20,59,29,30,
6171,33,2022/4/15 7:30,76,50,26,
6172,33,2022/4/15 7:40,48,38,10,
6173,33,2022/4/15 7:50,55,37,18,
6174,33,2022/4/15 8:00,42,59,-17,
6175,33,2022/4/15 8:10,50,45,5,
6176,33,2022/4/15 8:20,36,44,-8,
6177,33,2022/4/15 8:30,29,51,-22,
6178,33,2022/4/15 8:40,30,65,-35,
6179,33,2022/4/15 8:50,26,46,-20,
6180,33,2022/4/15 9:00,21,48,-27,
6181,33,2022/4/15 9:10,21,38,-17,
6182,33,2022/4/15 9:20,21,59,-38,
6183,33,2022/4/15 9:30,13,37,-24,
6184,33,2022/4/15 9:40,15,38,-23,
6185,33,2022/4/15 9:50,18,48,-30,
6186,33,2022/4/15 10:00,13,40,-27,
6187,33,2022/4/15 10:10,13,28,-15,
6188,33,2022/4/15 10:20,14,38,-24,
6189,33,2022/4/15 10:30,13,38,-25,
6190,33,2022/4/15 10:40,12,37,-25,
6191,33,2022/4/15 10:50,17,40,-23,
6192,33,2022/4/15 11:00,11,8,3,
6193,33,2022/4/15 11:10,16,40,-24,
6194,33,2022/4/15 11:20,11,39,-28,
6195,33,2022/4/15 11:30,10,29,-19,
6196,33,2022/4/15 11:40,19,37,-18,
6197,33,2022/4/15 11:50,12,33,-21,
6198,33,2022/4/15 12:00,14,8,6,
6199,33,2022/4/15 12:10,13,33,-20,
6200,33,2022/4/15 12:20,9,38,-29,
6201,33,2022/4/15 12:30,16,38,-22,
6202,33,2022/4/15 12:40,12,25,-13,
6203,33,2022/4/15 12:50,8,8,0,
6204,33,2022/4/15 13:00,13,25,-12,
6205,33,2022/4/15 13:10,11,33,-22,
6206,33,2022/4/15 13:20,12,38,-26,
6207,33,2022/4/15 13:30,13,32,-19,
6208,33,2022/4/15 13:40,12,38,-26,
6209,33,2022/4/15 13:50,10,8,2,
6210,33,2022/4/15 14:00,12,35,-23,
6211,33,2022/4/15 14:10,10,35,-25,
6212,33,2022/4/15 14:20,8,33,-25,
6213,33,2022/4/15 14:30,17,38,-21,
6214,33,2022/4/15 14:40,9,38,-29,
6215,33,2022/4/15 14:50,10,7,3,
6216,33,2022/4/15 15:00,15,33,-18,
6217,33,2022/4/15 15:10,15,40,-25,
6218,33,2022/4/15 15:20,13,38,-25,
6219,33,2022/4/15 15:30,14,44,-30,
6220,33,2022/4/15 15:40,13,38,-25,
6221,33,2022/4/15 15:50,19,8,11,
6222,33,2022/4/15 16:00,15,37,-22,
6223,33,2022/4/15 16:10,15,45,-30,
6224,33,2022/4/15 16:20,14,44,-30,
6225,33,2022/4/15 16:30,16,47,-31,
6226,33,2022/4/15 16:40,16,46,-30,
6227,33,2022/4/15 16:50,14,19,-5,
6228,33,2022/4/15 17:00,18,46,-28,
6229,33,2022/4/15 17:10,20,54,-34,
6230,33,2022/4/15 17:20,19,61,-42,
6231,33,2022/4/15 17:30,17,63,-46,
6232,33,2022/4/15 17:40,22,66,-44,
6233,33,2022/4/15 17:50,21,71,-50,
6234,33,2022/4/15 18:00,20,62,-42,
6235,33,2022/4/15 18:10,19,63,-44,
6236,33,2022/4/15 18:20,19,98,-79,
6237,33,2022/4/15 18:30,14,71,-57,
6238,33,2022/4/15 18:40,15,69,-54,
6239,33,2022/4/15 18:50,10,64,-54,
6240,33,2022/4/15 19:00,9,101,-92,
6241,33,2022/4/15 19:10,15,74,-59,
6242,33,2022/4/15 19:20,8,79,-71,
6243,33,2022/4/15 19:30,8,71,-63,
6244,33,2022/4/15 19:40,8,103,-95,
6245,33,2022/4/15 19:50,5,73,-68,
6246,33,2022/4/15 20:00,6,67,-61,
6247,33,2022/4/15 20:10,6,56,-50,
6248,33,2022/4/15 20:20,4,73,-69,
6249,33,2022/4/15 20:30,2,47,-45,
6250,33,2022/4/15 20:40,5,8,-3,
6251,33,2022/4/15 20:50,4,52,-48,
6252,33,2022/4/15 21:00,4,49,-45,
6253,33,2022/4/15 21:10,4,43,-39,
6254,33,2022/4/15 21:20,1,40,-39,
6255,33,2022/4/15 21:30,0,11,-11,
6256,33,2022/4/15 21:40,0,45,-45,
6257,33,2022/4/15 21:50,0,43,-43,
6258,33,2022/4/15 22:00,0,49,-49,
6259,33,2022/4/15 22:10,0,4,-4,
6260,33,2022/4/15 22:20,0,43,-43,
6261,33,2022/4/15 22:30,0,33,-33,
6262,33,2022/4/15 22:40,0,3,-3,
6263,33,2022/4/15 22:50,0,33,-33,
6264,34,2022/4/15 5:00,0,1,-1,
6265,34,2022/4/15 5:10,0,1,-1,
6266,34,2022/4/15 5:20,11,1,10,
6267,34,2022/4/15 5:30,17,1,16,
6268,34,2022/4/15 5:40,16,1,15,
6269,34,2022/4/15 5:50,20,1,19,
6270,34,2022/4/15 6:00,22,1,21,
6271,34,2022/4/15 6:10,28,1,27,
6272,34,2022/4/15 6:20,38,1,37,
6273,34,2022/4/15 6:30,57,1,56,
6274,34,2022/4/15 6:40,73,5,68,
6275,34,2022/4/15 6:50,155,5,150,
6276,34,2022/4/15 7:00,143,57,86,
6277,34,2022/4/15 7:10,283,62,221,
6278,34,2022/4/15 7:20,246,64,182,
6279,34,2022/4/15 7:30,151,69,82,
6280,34,2022/4/15 7:40,186,62,124,
6281,34,2022/4/15 7:50,124,70,54,
6282,34,2022/4/15 8:00,148,70,78,
6283,34,2022/4/15 8:10,71,81,-10,
6284,34,2022/4/15 8:20,65,96,-31,
6285,34,2022/4/15 8:30,51,69,-18,
6286,34,2022/4/15 8:40,53,65,-12,
6287,34,2022/4/15 8:50,33,95,-62,
6288,34,2022/4/15 9:00,26,71,-45,
6289,34,2022/4/15 9:10,31,61,-30,
6290,34,2022/4/15 9:20,28,75,-47,
6291,34,2022/4/15 9:30,24,87,-63,
6292,34,2022/4/15 9:40,22,67,-45,
6293,34,2022/4/15 9:50,22,75,-53,
6294,34,2022/4/15 10:00,28,60,-32,
6295,34,2022/4/15 10:10,23,98,-75,
6296,34,2022/4/15 10:20,27,67,-40,
6297,34,2022/4/15 10:30,22,66,-44,
6298,34,2022/4/15 10:40,29,62,-33,
6299,34,2022/4/15 10:50,25,7,18,
6300,34,2022/4/15 11:00,25,82,-57,
6301,34,2022/4/15 11:10,17,72,-55,
6302,34,2022/4/15 11:20,24,76,-52,
6303,34,2022/4/15 11:30,17,59,-42,
6304,34,2022/4/15 11:40,22,35,-13,
6305,34,2022/4/15 11:50,22,42,-20,
6306,34,2022/4/15 12:00,27,67,-40,
6307,34,2022/4/15 12:10,25,66,-41,
6308,34,2022/4/15 12:20,27,67,-40,
6309,34,2022/4/15 12:30,20,67,-47,
6310,34,2022/4/15 12:40,28,7,21,
6311,34,2022/4/15 12:50,21,61,-40,
6312,34,2022/4/15 13:00,24,65,-41,
6313,34,2022/4/15 13:10,26,65,-39,
6314,34,2022/4/15 13:20,29,65,-36,
6315,34,2022/4/15 13:30,24,60,-36,
6316,34,2022/4/15 13:40,28,9,19,
6317,34,2022/4/15 13:50,29,59,-30,
6318,34,2022/4/15 14:00,24,60,-36,
6319,34,2022/4/15 14:10,28,67,-39,
6320,34,2022/4/15 14:20,23,62,-39,
6321,34,2022/4/15 14:30,29,62,-33,
6322,34,2022/4/15 14:40,26,7,19,
6323,34,2022/4/15 14:50,26,61,-35,
6324,34,2022/4/15 15:00,25,68,-43,
6325,34,2022/4/15 15:10,25,66,-41,
6326,34,2022/4/15 15:20,23,61,-38,
6327,34,2022/4/15 15:30,28,69,-41,
6328,34,2022/4/15 15:40,34,2,32,
6329,34,2022/4/15 15:50,28,69,-41,
6330,34,2022/4/15 16:00,24,72,-48,
6331,34,2022/4/15 16:10,26,65,-39,
6332,34,2022/4/15 16:20,26,71,-45,
6333,34,2022/4/15 16:30,32,72,-40,
6334,34,2022/4/15 16:40,25,5,20,
6335,34,2022/4/15 16:50,27,83,-56,
6336,34,2022/4/15 17:00,24,69,-45,
6337,34,2022/4/15 17:10,25,90,-65,
6338,34,2022/4/15 17:20,28,77,-49,
6339,34,2022/4/15 17:30,24,78,-54,
6340,34,2022/4/15 17:40,26,23,3,
6341,34,2022/4/15 17:50,25,122,-97,
6342,34,2022/4/15 18:00,27,93,-66,
6343,34,2022/4/15 18:10,26,85,-59,
6344,34,2022/4/15 18:20,23,97,-74,
6345,34,2022/4/15 18:30,25,111,-86,
6346,34,2022/4/15 18:40,25,107,-82,
6347,34,2022/4/15 18:50,22,107,-85,
6348,34,2022/4/15 19:00,19,114,-95,
6349,34,2022/4/15 19:10,18,116,-98,
6350,34,2022/4/15 19:20,14,89,-75,
6351,34,2022/4/15 19:30,15,106,-91,
6352,34,2022/4/15 19:40,19,112,-93,
6353,34,2022/4/15 19:50,13,111,-98,
6354,34,2022/4/15 20:00,14,92,-78,
6355,34,2022/4/15 20:10,11,78,-67,
6356,34,2022/4/15 20:20,11,83,-72,
6357,34,2022/4/15 20:30,10,73,-63,
6358,34,2022/4/15 20:40,7,69,-62,
6359,34,2022/4/15 20:50,8,77,-69,
6360,34,2022/4/15 21:00,9,77,-68,
6361,34,2022/4/15 21:10,11,66,-55,
6362,34,2022/4/15 21:20,9,59,-50,
6363,34,2022/4/15 21:30,0,28,-28,
6364,34,2022/4/15 21:40,0,67,-67,
6365,34,2022/4/15 21:50,0,72,-72,
6366,34,2022/4/15 22:00,0,3,-3,
6367,34,2022/4/15 22:10,0,68,-68,
6368,34,2022/4/15 22:20,0,69,-69,
6369,34,2022/4/15 22:30,0,59,-59,
6370,34,2022/4/15 22:40,0,4,-4,
6371,34,2022/4/15 22:50,0,55,-55,
6372,65,2022/4/15 5:00,0,1,-1,-1
6373,65,2022/4/15 5:10,0,1,-1,-1
6374,65,2022/4/15 5:20,0,1,-1,-1
6375,65,2022/4/15 5:30,1,1,0,0
6376,65,2022/4/15 5:40,19,1,18,18
6377,65,2022/4/15 5:50,31,1,30,30
6378,65,2022/4/15 6:00,24,1,23,23
6379,65,2022/4/15 6:10,27,1,26,26
6380,65,2022/4/15 6:20,38,1,37,37
6381,65,2022/4/15 6:30,47,53,-6,-6
6382,65,2022/4/15 6:40,58,38,20,20
6383,65,2022/4/15 6:50,56,46,10,10
6384,65,2022/4/15 7:00,83,78,5,5
6385,65,2022/4/15 7:10,150,102,48,48
6386,65,2022/4/15 7:20,187,96,91,91
6387,65,2022/4/15 7:30,223,109,114,114
6388,65,2022/4/15 7:40,274,269,5,5
6389,65,2022/4/15 7:50,282,297,-15,-15
6390,65,2022/4/15 8:00,183,221,-38,-38
6391,65,2022/4/15 8:10,146,324,-178,-178
6392,65,2022/4/15 8:20,79,425,-346,-346
6393,65,2022/4/15 8:30,60,486,-426,-426
6394,65,2022/4/15 8:40,54,231,-177,-177
6395,65,2022/4/15 8:50,51,120,-69,-69
6396,65,2022/4/15 9:00,36,112,-76,-76
6397,65,2022/4/15 9:10,28,99,-71,-71
6398,65,2022/4/15 9:20,32,90,-58,-58
6399,65,2022/4/15 9:30,23,96,-73,-73
6400,65,2022/4/15 9:40,27,71,-44,-44
6401,65,2022/4/15 9:50,22,77,-55,-55
6402,65,2022/4/15 10:00,22,72,-50,-50
6403,65,2022/4/15 10:10,27,57,-30,-30
6404,65,2022/4/15 10:20,25,67,-42,-42
6405,65,2022/4/15 10:30,21,65,-44,-44
6406,65,2022/4/15 10:40,21,62,-41,-41
6407,65,2022/4/15 10:50,24,69,-45,-45
6408,65,2022/4/15 11:00,27,67,-40,-40
6409,65,2022/4/15 11:10,28,59,-31,-31
6410,65,2022/4/15 11:20,20,65,-45,-45
6411,65,2022/4/15 11:30,26,65,-39,-39
6412,65,2022/4/15 11:40,28,62,-34,-34
6413,65,2022/4/15 11:50,27,73,-46,-46
6414,65,2022/4/15 12:00,26,71,-45,-45
6415,65,2022/4/15 12:10,33,65,-32,-32
6416,65,2022/4/15 12:20,30,74,-44,-44
6417,65,2022/4/15 12:30,39,66,-27,-27
6418,65,2022/4/15 12:40,30,69,-39,-39
6419,65,2022/4/15 12:50,30,68,-38,-38
6420,65,2022/4/15 13:00,22,68,-46,-46
6421,65,2022/4/15 13:10,26,75,-49,-49
6422,65,2022/4/15 13:20,24,71,-47,-47
6423,65,2022/4/15 13:30,24,62,-38,-38
6424,65,2022/4/15 13:40,23,67,-44,-44
6425,65,2022/4/15 13:50,24,71,-47,-47
6426,65,2022/4/15 14:00,21,73,-52,-52
6427,65,2022/4/15 14:10,20,68,-48,-48
6428,65,2022/4/15 14:20,24,67,-43,-43
6429,65,2022/4/15 14:30,21,71,-50,-50
6430,65,2022/4/15 14:40,24,68,-44,-44
6431,65,2022/4/15 14:50,23,67,-44,-44
6432,65,2022/4/15 15:00,26,62,-36,-36
6433,65,2022/4/15 15:10,23,73,-50,-50
6434,65,2022/4/15 15:20,21,66,-45,-45
6435,65,2022/4/15 15:30,24,65,-41,-41
6436,65,2022/4/15 15:40,30,69,-39,-39
6437,65,2022/4/15 15:50,31,69,-38,-38
6438,65,2022/4/15 16:00,35,86,-51,-51
6439,65,2022/4/15 16:10,45,75,-30,-30
6440,65,2022/4/15 16:20,62,83,-21,-21
6441,65,2022/4/15 16:30,41,92,-51,-51
6442,65,2022/4/15 16:40,57,76,-19,-19
6443,65,2022/4/15 16:50,73,82,-9,-9
6444,65,2022/4/15 17:00,73,87,-14,-14
6445,65,2022/4/15 17:10,128,90,38,38
6446,65,2022/4/15 17:20,137,92,45,45
6447,65,2022/4/15 17:30,96,101,-5,-5
6448,65,2022/4/15 17:40,257,106,151,151
6449,65,2022/4/15 17:50,302,109,193,193
6450,65,2022/4/15 18:00,236,107,129,129
6451,65,2022/4/15 18:10,163,118,45,45
6452,65,2022/4/15 18:20,90,109,-19,-19
6453,65,2022/4/15 18:30,70,123,-53,-53
6454,65,2022/4/15 18:40,43,111,-68,-68
6455,65,2022/4/15 18:50,39,110,-71,-71
6456,65,2022/4/15 19:00,31,113,-82,-82
6457,65,2022/4/15 19:10,34,109,-75,-75
6458,65,2022/4/15 19:20,35,105,-70,-70
6459,65,2022/4/15 19:30,29,117,-88,-88
6460,65,2022/4/15 19:40,28,114,-86,-86
6461,65,2022/4/15 19:50,28,106,-78,-78
6462,65,2022/4/15 20:00,29,104,-75,-75
6463,65,2022/4/15 20:10,28,86,-58,-58
6464,65,2022/4/15 20:20,27,99,-72,-72
6465,65,2022/4/15 20:30,27,92,-65,-65
6466,65,2022/4/15 20:40,27,79,-52,-52
6467,65,2022/4/15 20:50,27,74,-47,-47
6468,65,2022/4/15 21:00,28,100,-72,-72
6469,65,2022/4/15 21:10,27,85,-58,-58
6470,65,2022/4/15 21:20,23,73,-50,-50
6471,65,2022/4/15 21:30,25,92,-67,-67
6472,65,2022/4/15 21:40,21,77,-56,-56
6473,65,2022/4/15 21:50,12,77,-65,-65
6474,65,2022/4/15 22:00,0,85,-85,-85
6475,65,2022/4/15 22:10,0,78,-78,-78
6476,65,2022/4/15 22:20,0,71,-71,-71
6477,65,2022/4/15 22:30,0,66,-66,-66
6478,65,2022/4/15 22:40,0,65,-65,-65
6479,65,2022/4/15 22:50,0,47,-47,-47
6480,70,2022/4/15 5:00,0,1,-1,
6481,70,2022/4/15 5:10,0,1,-1,
6482,70,2022/4/15 5:20,0,1,-1,
6483,70,2022/4/15 5:30,0,1,-1,
6484,70,2022/4/15 5:40,4,1,3,
6485,70,2022/4/15 5:50,13,1,12,
6486,70,2022/4/15 6:00,12,1,11,
6487,70,2022/4/15 6:10,17,1,16,
6488,70,2022/4/15 6:20,32,1,31,
6489,70,2022/4/15 6:30,31,33,-2,
6490,70,2022/4/15 6:40,29,31,-2,
6491,70,2022/4/15 6:50,32,7,25,
6492,70,2022/4/15 7:00,52,22,30,
6493,70,2022/4/15 7:10,57,48,9,
6494,70,2022/4/15 7:20,55,75,-20,
6495,70,2022/4/15 7:30,64,64,0,
6496,70,2022/4/15 7:40,69,93,-24,
6497,70,2022/4/15 7:50,76,98,-22,
6498,70,2022/4/15 8:00,72,213,-141,
6499,70,2022/4/15 8:10,57,128,-71,
6500,70,2022/4/15 8:20,45,75,-30,
6501,70,2022/4/15 8:30,48,87,-39,
6502,70,2022/4/15 8:40,28,111,-83,
6503,70,2022/4/15 8:50,25,71,-46,
6504,70,2022/4/15 9:00,25,59,-34,
6505,70,2022/4/15 9:10,15,63,-48,
6506,70,2022/4/15 9:20,15,65,-50,
6507,70,2022/4/15 9:30,22,47,-25,
6508,70,2022/4/15 9:40,12,38,-26,
6509,70,2022/4/15 9:50,16,38,-22,
6510,70,2022/4/15 10:00,14,32,-18,
6511,70,2022/4/15 10:10,14,25,-11,
6512,70,2022/4/15 10:20,15,31,-16,
6513,70,2022/4/15 10:30,12,38,-26,
6514,70,2022/4/15 10:40,14,21,-7,
6515,70,2022/4/15 10:50,13,19,-6,
6516,70,2022/4/15 11:00,15,21,-6,
6517,70,2022/4/15 11:10,16,19,-3,
6518,70,2022/4/15 11:20,15,23,-8,
6519,70,2022/4/15 11:30,16,25,-9,
6520,70,2022/4/15 11:40,16,21,-5,
6521,70,2022/4/15 11:50,15,23,-8,
6522,70,2022/4/15 12:00,19,23,-4,
6523,70,2022/4/15 12:10,13,23,-10,
6524,70,2022/4/15 12:20,16,25,-9,
6525,70,2022/4/15 12:30,19,31,-12,
6526,70,2022/4/15 12:40,22,31,-9,
6527,70,2022/4/15 12:50,12,30,-18,
6528,70,2022/4/15 13:00,18,23,-5,
6529,70,2022/4/15 13:10,16,23,-7,
6530,70,2022/4/15 13:20,16,23,-7,
6531,70,2022/4/15 13:30,12,23,-11,
6532,70,2022/4/15 13:40,16,29,-13,
6533,70,2022/4/15 13:50,15,21,-6,
6534,70,2022/4/15 14:00,13,23,-10,
6535,70,2022/4/15 14:10,16,23,-7,
6536,70,2022/4/15 14:20,17,23,-6,
6537,70,2022/4/15 14:30,16,19,-3,
6538,70,2022/4/15 14:40,21,21,0,
6539,70,2022/4/15 14:50,17,22,-5,
6540,70,2022/4/15 15:00,16,23,-7,
6541,70,2022/4/15 15:10,21,23,-2,
6542,70,2022/4/15 15:20,19,21,-2,
6543,70,2022/4/15 15:30,24,23,1,
6544,70,2022/4/15 15:40,20,23,-3,
6545,70,2022/4/15 15:50,22,25,-3,
6546,70,2022/4/15 16:00,22,23,-1,
6547,70,2022/4/15 16:10,24,23,1,
6548,70,2022/4/15 16:20,25,23,2,
6549,70,2022/4/15 16:30,34,23,11,
6550,70,2022/4/15 16:40,35,30,5,
6551,70,2022/4/15 16:50,36,33,3,
6552,70,2022/4/15 17:00,52,33,19,
6553,70,2022/4/15 17:10,203,38,165,
6554,70,2022/4/15 17:20,70,35,35,
6555,70,2022/4/15 17:30,45,52,-7,
6556,70,2022/4/15 17:40,47,32,15,
6557,70,2022/4/15 17:50,43,48,-5,
6558,70,2022/4/15 18:00,26,52,-26,
6559,70,2022/4/15 18:10,28,51,-23,
6560,70,2022/4/15 18:20,28,63,-35,
6561,70,2022/4/15 18:30,22,64,-42,
6562,70,2022/4/15 18:40,16,61,-45,
6563,70,2022/4/15 18:50,20,67,-47,
6564,70,2022/4/15 19:00,15,47,-32,
6565,70,2022/4/15 19:10,12,45,-33,
6566,70,2022/4/15 19:20,14,51,-37,
6567,70,2022/4/15 19:30,12,47,-35,
6568,70,2022/4/15 19:40,13,29,-16,
6569,70,2022/4/15 19:50,12,47,-35,
6570,70,2022/4/15 20:00,12,38,-26,
6571,70,2022/4/15 20:10,10,30,-20,
6572,70,2022/4/15 20:20,8,25,-17,
6573,70,2022/4/15 20:30,7,34,-27,
6574,70,2022/4/15 20:40,7,23,-16,
6575,70,2022/4/15 20:50,9,34,-25,
6576,70,2022/4/15 21:00,5,21,-16,
6577,70,2022/4/15 21:10,6,25,-19,
6578,70,2022/4/15 21:20,4,21,-17,
6579,70,2022/4/15 21:30,2,27,-25,
6580,70,2022/4/15 21:40,4,23,-19,
6581,70,2022/4/15 21:50,2,22,-20,
6582,70,2022/4/15 22:00,1,23,-22,
6583,70,2022/4/15 22:10,0,25,-25,
6584,70,2022/4/15 22:20,0,25,-25,
6585,70,2022/4/15 22:30,0,23,-23,
6586,70,2022/4/15 22:40,0,25,-25,
6587,70,2022/4/15 22:50,0,13,-13,
6588,66,2022/4/15 5:00,0,1,-1,
6589,66,2022/4/15 5:10,0,1,-1,
6590,66,2022/4/15 5:20,0,1,-1,
6591,66,2022/4/15 5:30,0,1,-1,
6592,66,2022/4/15 5:40,6,1,5,
6593,66,2022/4/15 5:50,20,1,19,
6594,66,2022/4/15 6:00,32,1,31,
6595,66,2022/4/15 6:10,32,1,31,
6596,66,2022/4/15 6:20,32,33,-1,
6597,66,2022/4/15 6:30,58,19,39,
6598,66,2022/4/15 6:40,60,29,31,
6599,66,2022/4/15 6:50,67,48,19,
6600,66,2022/4/15 7:00,99,6,93,
6601,66,2022/4/15 7:10,187,91,96,
6602,66,2022/4/15 7:20,207,76,131,
6603,66,2022/4/15 7:30,274,89,185,
6604,66,2022/4/15 7:40,302,89,213,
6605,66,2022/4/15 7:50,343,181,162,
6606,66,2022/4/15 8:00,327,99,228,
6607,66,2022/4/15 8:10,276,105,171,
6608,66,2022/4/15 8:20,234,91,143,
6609,66,2022/4/15 8:30,183,113,70,
6610,66,2022/4/15 8:40,81,60,21,
6611,66,2022/4/15 8:50,59,51,8,
6612,66,2022/4/15 9:00,44,46,-2,
6613,66,2022/4/15 9:10,38,72,-34,
6614,66,2022/4/15 9:20,32,49,-17,
6615,66,2022/4/15 9:30,31,63,-32,
6616,66,2022/4/15 9:40,28,47,-19,
6617,66,2022/4/15 9:50,25,42,-17,
6618,66,2022/4/15 10:00,22,47,-25,
6619,66,2022/4/15 10:10,26,44,-18,
6620,66,2022/4/15 10:20,19,41,-22,
6621,66,2022/4/15 10:30,19,31,-12,
6622,66,2022/4/15 10:40,20,40,-20,
6623,66,2022/4/15 10:50,20,38,-18,
6624,66,2022/4/15 11:00,17,32,-15,
6625,66,2022/4/15 11:10,17,39,-22,
6626,66,2022/4/15 11:20,19,45,-26,
6627,66,2022/4/15 11:30,19,38,-19,
6628,66,2022/4/15 11:40,18,41,-23,
6629,66,2022/4/15 11:50,22,42,-20,
6630,66,2022/4/15 12:00,23,40,-17,
6631,66,2022/4/15 12:10,21,47,-26,
6632,66,2022/4/15 12:20,26,38,-12,
6633,66,2022/4/15 12:30,21,47,-26,
6634,66,2022/4/15 12:40,22,45,-23,
6635,66,2022/4/15 12:50,20,50,-30,
6636,66,2022/4/15 13:00,19,45,-26,
6637,66,2022/4/15 13:10,18,42,-24,
6638,66,2022/4/15 13:20,19,46,-27,
6639,66,2022/4/15 13:30,16,46,-30,
6640,66,2022/4/15 13:40,20,50,-30,
6641,66,2022/4/15 13:50,21,47,-26,
6642,66,2022/4/15 14:00,18,49,-31,
6643,66,2022/4/15 14:10,17,50,-33,
6644,66,2022/4/15 14:20,16,47,-31,
6645,66,2022/4/15 14:30,18,51,-33,
6646,66,2022/4/15 14:40,16,57,-41,
6647,66,2022/4/15 14:50,14,51,-37,
6648,66,2022/4/15 15:00,19,57,-38,
6649,66,2022/4/15 15:10,14,58,-44,
6650,66,2022/4/15 15:20,19,61,-42,
6651,66,2022/4/15 15:30,20,62,-42,
6652,66,2022/4/15 15:40,22,66,-44,
6653,66,2022/4/15 15:50,24,59,-35,
6654,66,2022/4/15 16:00,24,67,-43,
6655,66,2022/4/15 16:10,25,68,-43,
6656,66,2022/4/15 16:20,28,65,-37,
6657,66,2022/4/15 16:30,30,65,-35,
6658,66,2022/4/15 16:40,32,70,-38,
6659,66,2022/4/15 16:50,30,75,-45,
6660,66,2022/4/15 17:00,63,98,-35,
6661,66,2022/4/15 17:10,70,90,-20,
6662,66,2022/4/15 17:20,73,99,-26,
6663,66,2022/4/15 17:30,43,89,-46,
6664,66,2022/4/15 17:40,39,111,-72,
6665,66,2022/4/15 17:50,29,118,-89,
6666,66,2022/4/15 18:00,28,123,-95,
6667,66,2022/4/15 18:10,28,112,-84,
6668,66,2022/4/15 18:20,28,109,-81,
6669,66,2022/4/15 18:30,27,111,-84,
6670,66,2022/4/15 18:40,19,109,-90,
6671,66,2022/4/15 18:50,19,104,-85,
6672,66,2022/4/15 19:00,21,107,-86,
6673,66,2022/4/15 19:10,18,109,-91,
6674,66,2022/4/15 19:20,17,122,-105,
6675,66,2022/4/15 19:30,14,107,-93,
6676,66,2022/4/15 19:40,15,102,-87,
6677,66,2022/4/15 19:50,15,94,-79,
6678,66,2022/4/15 20:00,12,78,-66,
6679,66,2022/4/15 20:10,13,79,-66,
6680,66,2022/4/15 20:20,12,64,-52,
6681,66,2022/4/15 20:30,11,79,-68,
6682,66,2022/4/15 20:40,12,84,-72,
6683,66,2022/4/15 20:50,11,62,-51,
6684,66,2022/4/15 21:00,10,56,-46,
6685,66,2022/4/15 21:10,9,72,-63,
6686,66,2022/4/15 21:20,10,72,-62,
6687,66,2022/4/15 21:30,6,73,-67,
6688,66,2022/4/15 21:40,6,71,-65,
6689,66,2022/4/15 21:50,6,72,-66,
6690,66,2022/4/15 22:00,1,59,-58,
6691,66,2022/4/15 22:10,0,64,-64,
6692,66,2022/4/15 22:20,0,63,-63,
6693,66,2022/4/15 22:30,0,68,-68,
6694,66,2022/4/15 22:40,0,63,-63,
6695,66,2022/4/15 22:50,0,3,-3,
6696,72,2022/4/15 5:00,0,1,-1,
6697,72,2022/4/15 5:10,0,1,-1,
6698,72,2022/4/15 5:20,0,1,-1,
6699,72,2022/4/15 5:30,0,1,-1,
6700,72,2022/4/15 5:40,3,1,2,
6701,72,2022/4/15 5:50,11,1,10,
6702,72,2022/4/15 6:00,31,1,30,
6703,72,2022/4/15 6:10,30,1,29,
6704,72,2022/4/15 6:20,37,19,18,
6705,72,2022/4/15 6:30,44,19,25,
6706,72,2022/4/15 6:40,60,38,22,
6707,72,2022/4/15 6:50,76,47,29,
6708,72,2022/4/15 7:00,85,41,44,
6709,72,2022/4/15 7:10,155,39,116,
6710,72,2022/4/15 7:20,236,51,185,
6711,72,2022/4/15 7:30,281,48,233,
6712,72,2022/4/15 7:40,278,70,208,
6713,72,2022/4/15 7:50,331,63,268,
6714,72,2022/4/15 8:00,346,53,293,
6715,72,2022/4/15 8:10,303,54,249,
6716,72,2022/4/15 8:20,244,76,168,
6717,72,2022/4/15 8:30,195,62,133,
6718,72,2022/4/15 8:40,86,47,39,
6719,72,2022/4/15 8:50,72,47,25,
6720,72,2022/4/15 9:00,48,56,-8,
6721,72,2022/4/15 9:10,37,41,-4,
6722,72,2022/4/15 9:20,30,50,-20,
6723,72,2022/4/15 9:30,28,38,-10,
6724,72,2022/4/15 9:40,24,41,-17,
6725,72,2022/4/15 9:50,27,38,-11,
6726,72,2022/4/15 10:00,25,23,2,
6727,72,2022/4/15 10:10,22,47,-25,
6728,72,2022/4/15 10:20,21,31,-10,
6729,72,2022/4/15 10:30,18,38,-20,
6730,72,2022/4/15 10:40,18,38,-20,
6731,72,2022/4/15 10:50,18,36,-18,
6732,72,2022/4/15 11:00,16,33,-17,
6733,72,2022/4/15 11:10,18,38,-20,
6734,72,2022/4/15 11:20,18,38,-20,
6735,72,2022/4/15 11:30,17,39,-22,
6736,72,2022/4/15 11:40,17,38,-21,
6737,72,2022/4/15 11:50,20,46,-26,
6738,72,2022/4/15 12:00,22,42,-20,
6739,72,2022/4/15 12:10,22,38,-16,
6740,72,2022/4/15 12:20,21,38,-17,
6741,72,2022/4/15 12:30,19,46,-27,
6742,72,2022/4/15 12:40,23,38,-15,
6743,72,2022/4/15 12:50,17,38,-21,
6744,72,2022/4/15 13:00,17,41,-24,
6745,72,2022/4/15 13:10,19,47,-28,
6746,72,2022/4/15 13:20,13,47,-34,
6747,72,2022/4/15 13:30,15,42,-27,
6748,72,2022/4/15 13:40,18,50,-32,
6749,72,2022/4/15 13:50,17,41,-24,
6750,72,2022/4/15 14:00,17,44,-27,
6751,72,2022/4/15 14:10,15,49,-34,
6752,72,2022/4/15 14:20,13,48,-35,
6753,72,2022/4/15 14:30,14,50,-36,
6754,72,2022/4/15 14:40,15,45,-30,
6755,72,2022/4/15 14:50,16,57,-41,
6756,72,2022/4/15 15:00,10,57,-47,
6757,72,2022/4/15 15:10,15,57,-42,
6758,72,2022/4/15 15:20,16,57,-41,
6759,72,2022/4/15 15:30,16,62,-46,
6760,72,2022/4/15 15:40,17,62,-45,
6761,72,2022/4/15 15:50,14,62,-48,
6762,72,2022/4/15 16:00,17,66,-49,
6763,72,2022/4/15 16:10,20,71,-51,
6764,72,2022/4/15 16:20,22,72,-50,
6765,72,2022/4/15 16:30,25,68,-43,
6766,72,2022/4/15 16:40,27,71,-44,
6767,72,2022/4/15 16:50,35,82,-47,
6768,72,2022/4/15 17:00,37,76,-39,
6769,72,2022/4/15 17:10,43,90,-47,
6770,72,2022/4/15 17:20,33,104,-71,
6771,72,2022/4/15 17:30,28,118,-90,
6772,72,2022/4/15 17:40,26,117,-91,
6773,72,2022/4/15 17:50,33,116,-83,
6774,72,2022/4/15 18:00,39,110,-71,
6775,72,2022/4/15 18:10,25,132,-107,
6776,72,2022/4/15 18:20,26,133,-107,
6777,72,2022/4/15 18:30,21,121,-100,
6778,72,2022/4/15 18:40,19,124,-105,
6779,72,2022/4/15 18:50,17,107,-90,
6780,72,2022/4/15 19:00,14,107,-93,
6781,72,2022/4/15 19:10,18,106,-88,
6782,72,2022/4/15 19:20,15,120,-105,
6783,72,2022/4/15 19:30,14,117,-103,
6784,72,2022/4/15 19:40,15,102,-87,
6785,72,2022/4/15 19:50,15,94,-79,
6786,72,2022/4/15 20:00,20,79,-59,
6787,72,2022/4/15 20:10,15,78,-63,
6788,72,2022/4/15 20:20,13,80,-67,
6789,72,2022/4/15 20:30,17,75,-58,
6790,72,2022/4/15 20:40,15,70,-55,
6791,72,2022/4/15 20:50,13,64,-51,
6792,72,2022/4/15 21:00,14,71,-57,
6793,72,2022/4/15 21:10,16,73,-57,
6794,72,2022/4/15 21:20,14,75,-61,
6795,72,2022/4/15 21:30,12,73,-61,
6796,72,2022/4/15 21:40,12,74,-62,
6797,72,2022/4/15 21:50,9,75,-66,
6798,72,2022/4/15 22:00,6,71,-65,
6799,72,2022/4/15 22:10,0,64,-64,
6800,72,2022/4/15 22:20,0,65,-65,
6801,72,2022/4/15 22:30,0,56,-56,
6802,72,2022/4/15 22:40,0,40,-40,
6803,72,2022/4/15 22:50,0,3,-3,
6804,67,2022/4/15 5:00,0,1,-1,
6805,67,2022/4/15 5:10,0,1,-1,
6806,67,2022/4/15 5:20,0,1,-1,
6807,67,2022/4/15 5:30,0,1,-1,
6808,67,2022/4/15 5:40,2,1,1,
6809,67,2022/4/15 5:50,6,1,5,
6810,67,2022/4/15 6:00,20,1,19,
6811,67,2022/4/15 6:10,20,5,15,
6812,67,2022/4/15 6:20,27,23,4,
6813,67,2022/4/15 6:30,33,23,10,
6814,67,2022/4/15 6:40,40,37,3,
6815,67,2022/4/15 6:50,47,49,-2,
6816,67,2022/4/15 7:00,76,34,42,
6817,67,2022/4/15 7:10,130,57,73,
6818,67,2022/4/15 7:20,193,63,130,
6819,67,2022/4/15 7:30,235,77,158,
6820,67,2022/4/15 7:40,278,99,179,
6821,67,2022/4/15 7:50,349,82,267,
6822,67,2022/4/15 8:00,330,69,261,
6823,67,2022/4/15 8:10,281,76,205,
6824,67,2022/4/15 8:20,240,69,171,
6825,67,2022/4/15 8:30,184,83,101,
6826,67,2022/4/15 8:40,87,57,30,
6827,67,2022/4/15 8:50,71,53,18,
6828,67,2022/4/15 9:00,42,52,-10,
6829,67,2022/4/15 9:10,29,51,-22,
6830,67,2022/4/15 9:20,30,35,-5,
6831,67,2022/4/15 9:30,28,41,-13,
6832,67,2022/4/15 9:40,22,32,-10,
6833,67,2022/4/15 9:50,22,32,-10,
6834,67,2022/4/15 10:00,19,29,-10,
6835,67,2022/4/15 10:10,18,23,-5,
6836,67,2022/4/15 10:20,15,31,-16,
6837,67,2022/4/15 10:30,14,30,-16,
6838,67,2022/4/15 10:40,16,33,-17,
6839,67,2022/4/15 10:50,15,32,-17,
6840,67,2022/4/15 11:00,14,32,-18,
6841,67,2022/4/15 11:10,13,37,-24,
6842,67,2022/4/15 11:20,12,38,-26,
6843,67,2022/4/15 11:30,13,37,-24,
6844,67,2022/4/15 11:40,14,38,-24,
6845,67,2022/4/15 11:50,15,37,-22,
6846,67,2022/4/15 12:00,15,40,-25,
6847,67,2022/4/15 12:10,17,38,-21,
6848,67,2022/4/15 12:20,18,38,-20,
6849,67,2022/4/15 12:30,19,40,-21,
6850,67,2022/4/15 12:40,14,42,-28,
6851,67,2022/4/15 12:50,15,40,-25,
6852,67,2022/4/15 13:00,14,33,-19,
6853,67,2022/4/15 13:10,13,38,-25,
6854,67,2022/4/15 13:20,12,38,-26,
6855,67,2022/4/15 13:30,13,38,-25,
6856,67,2022/4/15 13:40,13,43,-30,
6857,67,2022/4/15 13:50,13,37,-24,
6858,67,2022/4/15 14:00,10,48,-38,
6859,67,2022/4/15 14:10,9,47,-38,
6860,67,2022/4/15 14:20,12,45,-33,
6861,67,2022/4/15 14:30,11,45,-34,
6862,67,2022/4/15 14:40,11,41,-30,
6863,67,2022/4/15 14:50,11,50,-39,
6864,67,2022/4/15 15:00,11,52,-41,
6865,67,2022/4/15 15:10,13,55,-42,
6866,67,2022/4/15 15:20,11,51,-40,
6867,67,2022/4/15 15:30,13,54,-41,
6868,67,2022/4/15 15:40,11,63,-52,
6869,67,2022/4/15 15:50,13,57,-44,
6870,67,2022/4/15 16:00,12,66,-54,
6871,67,2022/4/15 16:10,15,66,-51,
6872,67,2022/4/15 16:20,16,69,-53,
6873,67,2022/4/15 16:30,17,70,-53,
6874,67,2022/4/15 16:40,21,69,-48,
6875,67,2022/4/15 16:50,21,70,-49,
6876,67,2022/4/15 17:00,24,92,-68,
6877,67,2022/4/15 17:10,26,98,-72,
6878,67,2022/4/15 17:20,26,96,-70,
6879,67,2022/4/15 17:30,24,117,-93,
6880,67,2022/4/15 17:40,28,116,-88,
6881,67,2022/4/15 17:50,32,109,-77,
6882,67,2022/4/15 18:00,41,133,-92,
6883,67,2022/4/15 18:10,26,143,-117,
6884,67,2022/4/15 18:20,22,117,-95,
6885,67,2022/4/15 18:30,19,111,-92,
6886,67,2022/4/15 18:40,17,117,-100,
6887,67,2022/4/15 18:50,12,111,-99,
6888,67,2022/4/15 19:00,12,112,-100,
6889,67,2022/4/15 19:10,12,123,-111,
6890,67,2022/4/15 19:20,12,91,-79,
6891,67,2022/4/15 19:30,13,105,-92,
6892,67,2022/4/15 19:40,12,95,-83,
6893,67,2022/4/15 19:50,12,79,-67,
6894,67,2022/4/15 20:00,10,78,-68,
6895,67,2022/4/15 20:10,12,76,-64,
6896,67,2022/4/15 20:20,11,72,-61,
6897,67,2022/4/15 20:30,10,71,-61,
6898,67,2022/4/15 20:40,10,57,-47,
6899,67,2022/4/15 20:50,10,77,-67,
6900,67,2022/4/15 21:00,11,73,-62,
6901,67,2022/4/15 21:10,9,67,-58,
6902,67,2022/4/15 21:20,10,73,-63,
6903,67,2022/4/15 21:30,8,62,-54,
6904,67,2022/4/15 21:40,6,62,-56,
6905,67,2022/4/15 21:50,3,74,-71,
6906,67,2022/4/15 22:00,4,59,-55,
6907,67,2022/4/15 22:10,2,62,-60,
6908,67,2022/4/15 22:20,2,67,-65,
6909,67,2022/4/15 22:30,1,50,-49,
6910,67,2022/4/15 22:40,0,49,-49,
6911,67,2022/4/15 22:50,0,3,-3,
6912,61,2022/4/15 5:00,0,1,-1,
6913,61,2022/4/15 5:10,0,1,-1,
6914,61,2022/4/15 5:20,0,1,-1,
6915,61,2022/4/15 5:30,0,1,-1,
6916,61,2022/4/15 5:40,1,1,0,
6917,61,2022/4/15 5:50,5,1,4,
6918,61,2022/4/15 6:00,26,1,25,
6919,61,2022/4/15 6:10,37,5,32,
6920,61,2022/4/15 6:20,41,21,20,
6921,61,2022/4/15 6:30,54,21,33,
6922,61,2022/4/15 6:40,60,23,37,
6923,61,2022/4/15 6:50,81,45,36,
6924,61,2022/4/15 7:00,151,47,104,
6925,61,2022/4/15 7:10,185,49,136,
6926,61,2022/4/15 7:20,236,51,185,
6927,61,2022/4/15 7:30,277,55,222,
6928,61,2022/4/15 7:40,303,51,252,
6929,61,2022/4/15 7:50,339,46,293,
6930,61,2022/4/15 8:00,359,41,318,
6931,61,2022/4/15 8:10,327,46,281,
6932,61,2022/4/15 8:20,283,44,239,
6933,61,2022/4/15 8:30,230,37,193,
6934,61,2022/4/15 8:40,127,37,90,
6935,61,2022/4/15 8:50,87,24,63,
6936,61,2022/4/15 9:00,53,29,24,
6937,61,2022/4/15 9:10,48,29,19,
6938,61,2022/4/15 9:20,34,37,-3,
6939,61,2022/4/15 9:30,29,29,0,
6940,61,2022/4/15 9:40,27,32,-5,
6941,61,2022/4/15 9:50,28,32,-4,
6942,61,2022/4/15 10:00,23,23,0,
6943,61,2022/4/15 10:10,19,19,0,
6944,61,2022/4/15 10:20,20,42,-22,
6945,61,2022/4/15 10:30,18,32,-14,
6946,61,2022/4/15 10:40,18,23,-5,
6947,61,2022/4/15 10:50,15,29,-14,
6948,61,2022/4/15 11:00,19,32,-13,
6949,61,2022/4/15 11:10,15,33,-18,
6950,61,2022/4/15 11:20,14,32,-18,
6951,61,2022/4/15 11:30,15,38,-23,
6952,61,2022/4/15 11:40,17,32,-15,
6953,61,2022/4/15 11:50,18,38,-20,
6954,61,2022/4/15 12:00,19,35,-16,
6955,61,2022/4/15 12:10,21,34,-13,
6956,61,2022/4/15 12:20,21,38,-17,
6957,61,2022/4/15 12:30,17,38,-21,
6958,61,2022/4/15 12:40,17,38,-21,
6959,61,2022/4/15 12:50,18,38,-20,
6960,61,2022/4/15 13:00,18,34,-16,
6961,61,2022/4/15 13:10,15,32,-17,
6962,61,2022/4/15 13:20,16,38,-22,
6963,61,2022/4/15 13:30,17,38,-21,
6964,61,2022/4/15 13:40,12,36,-24,
6965,61,2022/4/15 13:50,14,46,-32,
6966,61,2022/4/15 14:00,13,38,-25,
6967,61,2022/4/15 14:10,16,46,-30,
6968,61,2022/4/15 14:20,13,47,-34,
6969,61,2022/4/15 14:30,14,43,-29,
6970,61,2022/4/15 14:40,12,45,-33,
6971,61,2022/4/15 14:50,14,51,-37,
6972,61,2022/4/15 15:00,13,42,-29,
6973,61,2022/4/15 15:10,14,56,-42,
6974,61,2022/4/15 15:20,15,49,-34,
6975,61,2022/4/15 15:30,14,61,-47,
6976,61,2022/4/15 15:40,14,61,-47,
6977,61,2022/4/15 15:50,14,57,-43,
6978,61,2022/4/15 16:00,16,71,-55,
6979,61,2022/4/15 16:10,14,70,-56,
6980,61,2022/4/15 16:20,17,75,-58,
6981,61,2022/4/15 16:30,20,67,-47,
6982,61,2022/4/15 16:40,27,77,-50,
6983,61,2022/4/15 16:50,27,93,-66,
6984,61,2022/4/15 17:00,29,90,-61,
6985,61,2022/4/15 17:10,29,106,-77,
6986,61,2022/4/15 17:20,22,102,-80,
6987,61,2022/4/15 17:30,20,96,-76,
6988,61,2022/4/15 17:40,14,110,-96,
6989,61,2022/4/15 17:50,18,111,-93,
6990,61,2022/4/15 18:00,15,104,-89,
6991,61,2022/4/15 18:10,16,117,-101,
6992,61,2022/4/15 18:20,14,117,-103,
6993,61,2022/4/15 18:30,13,116,-103,
6994,61,2022/4/15 18:40,13,121,-108,
6995,61,2022/4/15 18:50,14,124,-110,
6996,61,2022/4/15 19:00,12,106,-94,
6997,61,2022/4/15 19:10,11,103,-92,
6998,61,2022/4/15 19:20,11,107,-96,
6999,61,2022/4/15 19:30,8,111,-103,
7000,61,2022/4/15 19:40,8,91,-83,
7001,61,2022/4/15 19:50,9,77,-68,
7002,61,2022/4/15 20:00,9,76,-67,
7003,61,2022/4/15 20:10,8,78,-70,
7004,61,2022/4/15 20:20,9,77,-68,
7005,61,2022/4/15 20:30,11,70,-59,
7006,61,2022/4/15 20:40,6,85,-79,
7007,61,2022/4/15 20:50,11,55,-44,
7008,61,2022/4/15 21:00,8,68,-60,
7009,61,2022/4/15 21:10,8,66,-58,
7010,61,2022/4/15 21:20,5,72,-67,
7011,61,2022/4/15 21:30,4,66,-62,
7012,61,2022/4/15 21:40,4,61,-57,
7013,61,2022/4/15 21:50,4,71,-67,
7014,61,2022/4/15 22:00,2,71,-69,
7015,61,2022/4/15 22:10,1,68,-67,
7016,61,2022/4/15 22:20,0,49,-49,
7017,61,2022/4/15 22:30,0,53,-53,
7018,61,2022/4/15 22:40,0,36,-36,
7019,61,2022/4/15 22:50,0,3,-3,
7020,62,2022/4/15 5:00,0,1,-1,
7021,62,2022/4/15 5:10,0,1,-1,
7022,62,2022/4/15 5:20,0,1,-1,
7023,62,2022/4/15 5:30,0,1,-1,
7024,62,2022/4/15 5:40,0,1,-1,
7025,62,2022/4/15 5:50,1,1,0,
7026,62,2022/4/15 6:00,2,1,1,
7027,62,2022/4/15 6:10,6,22,-16,
7028,62,2022/4/15 6:20,6,38,-32,
7029,62,2022/4/15 6:30,8,42,-34,
7030,62,2022/4/15 6:40,8,75,-67,
7031,62,2022/4/15 6:50,10,66,-56,
7032,62,2022/4/15 7:00,16,111,-95,
7033,62,2022/4/15 7:10,18,64,-46,
7034,62,2022/4/15 7:20,10,46,-36,
7035,62,2022/4/15 7:30,12,34,-22,
7036,62,2022/4/15 7:40,14,63,-49,
7037,62,2022/4/15 7:50,18,61,-43,
7038,62,2022/4/15 8:00,19,69,-50,
7039,62,2022/4/15 8:10,15,62,-47,
7040,62,2022/4/15 8:20,14,67,-53,
7041,62,2022/4/15 8:30,12,33,-21,
7042,62,2022/4/15 8:40,11,42,-31,
7043,62,2022/4/15 8:50,6,23,-17,
7044,62,2022/4/15 9:00,4,23,-19,
7045,62,2022/4/15 9:10,4,23,-19,
7046,62,2022/4/15 9:20,4,25,-21,
7047,62,2022/4/15 9:30,7,19,-12,
7048,62,2022/4/15 9:40,2,21,-19,
7049,62,2022/4/15 9:50,4,23,-19,
7050,62,2022/4/15 10:00,6,23,-17,
7051,62,2022/4/15 10:10,2,23,-21,
7052,62,2022/4/15 10:20,5,19,-14,
7053,62,2022/4/15 10:30,4,22,-18,
7054,62,2022/4/15 10:40,4,19,-15,
7055,62,2022/4/15 10:50,2,19,-17,
7056,62,2022/4/15 11:00,7,17,-10,
7057,62,2022/4/15 11:10,7,16,-9,
7058,62,2022/4/15 11:20,5,16,-11,
7059,62,2022/4/15 11:30,6,14,-8,
7060,62,2022/4/15 11:40,5,15,-10,
7061,62,2022/4/15 11:50,7,18,-11,
7062,62,2022/4/15 12:00,4,15,-11,
7063,62,2022/4/15 12:10,8,18,-10,
7064,62,2022/4/15 12:20,5,19,-14,
7065,62,2022/4/15 12:30,4,14,-10,
7066,62,2022/4/15 12:40,4,14,-10,
7067,62,2022/4/15 12:50,7,16,-9,
7068,62,2022/4/15 13:00,6,19,-13,
7069,62,2022/4/15 13:10,2,18,-16,
7070,62,2022/4/15 13:20,7,21,-14,
7071,62,2022/4/15 13:30,7,12,-5,
7072,62,2022/4/15 13:40,6,15,-9,
7073,62,2022/4/15 13:50,3,19,-16,
7074,62,2022/4/15 14:00,5,16,-11,
7075,62,2022/4/15 14:10,7,14,-7,
7076,62,2022/4/15 14:20,6,16,-10,
7077,62,2022/4/15 14:30,7,8,-1,
7078,62,2022/4/15 14:40,4,8,-4,
7079,62,2022/4/15 14:50,8,12,-4,
7080,62,2022/4/15 15:00,9,12,-3,
7081,62,2022/4/15 15:10,8,12,-4,
7082,62,2022/4/15 15:20,9,12,-3,
7083,62,2022/4/15 15:30,8,8,0,
7084,62,2022/4/15 15:40,10,12,-2,
7085,62,2022/4/15 15:50,8,16,-8,
7086,62,2022/4/15 16:00,11,11,0,
7087,62,2022/4/15 16:10,14,12,2,
7088,62,2022/4/15 16:20,13,14,-1,
7089,62,2022/4/15 16:30,26,8,18,
7090,62,2022/4/15 16:40,51,23,28,
7091,62,2022/4/15 16:50,32,23,9,
7092,62,2022/4/15 17:00,30,21,9,
7093,62,2022/4/15 17:10,26,19,7,
7094,62,2022/4/15 17:20,20,23,-3,
7095,62,2022/4/15 17:30,15,23,-8,
7096,62,2022/4/15 17:40,15,23,-8,
7097,62,2022/4/15 17:50,11,23,-12,
7098,62,2022/4/15 18:00,13,32,-19,
7099,62,2022/4/15 18:10,13,26,-13,
7100,62,2022/4/15 18:20,12,27,-15,
7101,62,2022/4/15 18:30,12,23,-11,
7102,62,2022/4/15 18:40,14,25,-11,
7103,62,2022/4/15 18:50,11,25,-14,
7104,62,2022/4/15 19:00,10,25,-15,
7105,62,2022/4/15 19:10,6,25,-19,
7106,62,2022/4/15 19:20,4,21,-17,
7107,62,2022/4/15 19:30,6,22,-16,
7108,62,2022/4/15 19:40,5,13,-8,
7109,62,2022/4/15 19:50,3,15,-12,
7110,62,2022/4/15 20:00,2,15,-13,
7111,62,2022/4/15 20:10,2,15,-13,
7112,62,2022/4/15 20:20,2,8,-6,
7113,62,2022/4/15 20:30,3,13,-10,
7114,62,2022/4/15 20:40,2,13,-11,
7115,62,2022/4/15 20:50,2,10,-8,
7116,62,2022/4/15 21:00,2,13,-11,
7117,62,2022/4/15 21:10,2,10,-8,
7118,62,2022/4/15 21:20,2,13,-11,
7119,62,2022/4/15 21:30,2,15,-13,
7120,62,2022/4/15 21:40,1,10,-9,
7121,62,2022/4/15 21:50,1,8,-7,
7122,62,2022/4/15 22:00,2,10,-8,
7123,62,2022/4/15 22:10,1,7,-6,
7124,62,2022/4/15 22:20,0,8,-8,
7125,62,2022/4/15 22:30,0,10,-10,
7126,62,2022/4/15 22:40,0,3,-3,
7127,62,2022/4/15 22:50,0,3,-3,
7128,60,2022/4/15 5:00,0,1,-1,
7129,60,2022/4/15 5:10,0,1,-1,
7130,60,2022/4/15 5:20,0,1,-1,
7131,60,2022/4/15 5:30,0,1,-1,
7132,60,2022/4/15 5:40,3,1,2,
7133,60,2022/4/15 5:50,8,1,7,
7134,60,2022/4/15 6:00,20,1,19,
7135,60,2022/4/15 6:10,37,13,24,
7136,60,2022/4/15 6:20,35,21,14,
7137,60,2022/4/15 6:30,45,23,22,
7138,60,2022/4/15 6:40,53,21,32,
7139,60,2022/4/15 6:50,73,33,40,
7140,60,2022/4/15 7:00,99,38,61,
7141,60,2022/4/15 7:10,154,49,105,
7142,60,2022/4/15 7:20,196,62,134,
7143,60,2022/4/15 7:30,245,72,173,
7144,60,2022/4/15 7:40,282,81,201,
7145,60,2022/4/15 7:50,360,90,270,
7146,60,2022/4/15 8:00,343,90,253,
7147,60,2022/4/15 8:10,279,103,176,
7148,60,2022/4/15 8:20,253,75,178,
7149,60,2022/4/15 8:30,192,64,128,
7150,60,2022/4/15 8:40,154,67,87,
7151,60,2022/4/15 8:50,79,61,18,
7152,60,2022/4/15 9:00,52,54,-2,
7153,60,2022/4/15 9:10,48,60,-12,
7154,60,2022/4/15 9:20,40,45,-5,
7155,60,2022/4/15 9:30,29,57,-28,
7156,60,2022/4/15 9:40,28,50,-22,
7157,60,2022/4/15 9:50,27,38,-11,
7158,60,2022/4/15 10:00,28,45,-17,
7159,60,2022/4/15 10:10,26,38,-12,
7160,60,2022/4/15 10:20,20,42,-22,
7161,60,2022/4/15 10:30,22,46,-24,
7162,60,2022/4/15 10:40,19,46,-27,
7163,60,2022/4/15 10:50,19,38,-19,
7164,60,2022/4/15 11:00,22,38,-16,
7165,60,2022/4/15 11:10,17,46,-29,
7166,60,2022/4/15 11:20,22,45,-23,
7167,60,2022/4/15 11:30,21,41,-20,
7168,60,2022/4/15 11:40,22,46,-24,
7169,60,2022/4/15 11:50,23,45,-22,
7170,60,2022/4/15 12:00,24,41,-17,
7171,60,2022/4/15 12:10,24,45,-21,
7172,60,2022/4/15 12:20,26,44,-18,
7173,60,2022/4/15 12:30,22,40,-18,
7174,60,2022/4/15 12:40,23,48,-25,
7175,60,2022/4/15 12:50,22,45,-23,
7176,60,2022/4/15 13:00,23,51,-28,
7177,60,2022/4/15 13:10,23,45,-22,
7178,60,2022/4/15 13:20,20,48,-28,
7179,60,2022/4/15 13:30,17,50,-33,
7180,60,2022/4/15 13:40,21,50,-29,
7181,60,2022/4/15 13:50,18,49,-31,
7182,60,2022/4/15 14:00,20,45,-25,
7183,60,2022/4/15 14:10,16,58,-42,
7184,60,2022/4/15 14:20,18,49,-31,
7185,60,2022/4/15 14:30,20,58,-38,
7186,60,2022/4/15 14:40,20,54,-34,
7187,60,2022/4/15 14:50,21,49,-28,
7188,60,2022/4/15 15:00,19,54,-35,
7189,60,2022/4/15 15:10,21,56,-35,
7190,60,2022/4/15 15:20,23,61,-38,
7191,60,2022/4/15 15:30,24,61,-37,
7192,60,2022/4/15 15:40,19,59,-40,
7193,60,2022/4/15 15:50,22,67,-45,
7194,60,2022/4/15 16:00,27,69,-42,
7195,60,2022/4/15 16:10,28,72,-44,
7196,60,2022/4/15 16:20,25,72,-47,
7197,60,2022/4/15 16:30,27,70,-43,
7198,60,2022/4/15 16:40,28,73,-45,
7199,60,2022/4/15 16:50,25,83,-58,
7200,60,2022/4/15 17:00,41,76,-35,
7201,60,2022/4/15 17:10,43,105,-62,
7202,60,2022/4/15 17:20,31,102,-71,
7203,60,2022/4/15 17:30,27,122,-95,
7204,60,2022/4/15 17:40,25,121,-96,
7205,60,2022/4/15 17:50,28,123,-95,
7206,60,2022/4/15 18:00,28,111,-83,
7207,60,2022/4/15 18:10,25,181,-156,
7208,60,2022/4/15 18:20,24,143,-119,
7209,60,2022/4/15 18:30,21,181,-160,
7210,60,2022/4/15 18:40,23,124,-101,
7211,60,2022/4/15 18:50,17,109,-92,
7212,60,2022/4/15 19:00,17,109,-92,
7213,60,2022/4/15 19:10,20,124,-104,
7214,60,2022/4/15 19:20,17,104,-87,
7215,60,2022/4/15 19:30,17,98,-81,
7216,60,2022/4/15 19:40,13,93,-80,
7217,60,2022/4/15 19:50,13,77,-64,
7218,60,2022/4/15 20:00,13,83,-70,
7219,60,2022/4/15 20:10,14,87,-73,
7220,60,2022/4/15 20:20,13,64,-51,
7221,60,2022/4/15 20:30,15,77,-62,
7222,60,2022/4/15 20:40,14,73,-59,
7223,60,2022/4/15 20:50,14,71,-57,
7224,60,2022/4/15 21:00,13,71,-58,
7225,60,2022/4/15 21:10,12,84,-72,
7226,60,2022/4/15 21:20,11,71,-60,
7227,60,2022/4/15 21:30,8,70,-62,
7228,60,2022/4/15 21:40,8,78,-70,
7229,60,2022/4/15 21:50,9,83,-74,
7230,60,2022/4/15 22:00,6,70,-64,
7231,60,2022/4/15 22:10,5,67,-62,
7232,60,2022/4/15 22:20,1,74,-73,
7233,60,2022/4/15 22:30,2,49,-47,
7234,60,2022/4/15 22:40,0,3,-3,
7235,60,2022/4/15 22:50,0,3,-3,
7236,68,2022/4/15 5:00,0,1,-1,
7237,68,2022/4/15 5:10,0,1,-1,
7238,68,2022/4/15 5:20,0,1,-1,
7239,68,2022/4/15 5:30,0,1,-1,
7240,68,2022/4/15 5:40,0,1,-1,
7241,68,2022/4/15 5:50,6,1,5,
7242,68,2022/4/15 6:00,22,1,21,
7243,68,2022/4/15 6:10,35,16,19,
7244,68,2022/4/15 6:20,42,32,10,
7245,68,2022/4/15 6:30,54,37,17,
7246,68,2022/4/15 6:40,61,45,16,
7247,68,2022/4/15 6:50,87,52,35,
7248,68,2022/4/15 7:00,156,72,84,
7249,68,2022/4/15 7:10,234,73,161,
7250,68,2022/4/15 7:20,238,105,133,
7251,68,2022/4/15 7:30,319,90,229,
7252,68,2022/4/15 7:40,573,123,450,
7253,68,2022/4/15 7:50,590,108,482,
7254,68,2022/4/15 8:00,599,192,407,
7255,68,2022/4/15 8:10,597,121,476,
7256,68,2022/4/15 8:20,337,192,145,
7257,68,2022/4/15 8:30,277,152,125,
7258,68,2022/4/15 8:40,227,336,-109,
7259,68,2022/4/15 8:50,184,150,34,
7260,68,2022/4/15 9:00,120,226,-106,
7261,68,2022/4/15 9:10,61,159,-98,
7262,68,2022/4/15 9:20,51,179,-128,
7263,68,2022/4/15 9:30,40,125,-85,
7264,68,2022/4/15 9:40,38,105,-67,
7265,68,2022/4/15 9:50,31,112,-81,
7266,68,2022/4/15 10:00,31,76,-45,
7267,68,2022/4/15 10:10,33,77,-44,
7268,68,2022/4/15 10:20,32,76,-44,
7269,68,2022/4/15 10:30,26,77,-51,
7270,68,2022/4/15 10:40,28,69,-41,
7271,68,2022/4/15 10:50,28,74,-46,
7272,68,2022/4/15 11:00,30,71,-41,
7273,68,2022/4/15 11:10,26,66,-40,
7274,68,2022/4/15 11:20,30,66,-36,
7275,68,2022/4/15 11:30,28,69,-41,
7276,68,2022/4/15 11:40,30,66,-36,
7277,68,2022/4/15 11:50,32,72,-40,
7278,68,2022/4/15 12:00,30,62,-32,
7279,68,2022/4/15 12:10,36,64,-28,
7280,68,2022/4/15 12:20,33,62,-29,
7281,68,2022/4/15 12:30,33,74,-41,
7282,68,2022/4/15 12:40,35,74,-39,
7283,68,2022/4/15 12:50,28,71,-43,
7284,68,2022/4/15 13:00,29,82,-53,
7285,68,2022/4/15 13:10,29,82,-53,
7286,68,2022/4/15 13:20,26,85,-59,
7287,68,2022/4/15 13:30,35,65,-30,
7288,68,2022/4/15 13:40,29,74,-45,
7289,68,2022/4/15 13:50,28,81,-53,
7290,68,2022/4/15 14:00,25,72,-47,
7291,68,2022/4/15 14:10,26,62,-36,
7292,68,2022/4/15 14:20,29,69,-40,
7293,68,2022/4/15 14:30,30,66,-36,
7294,68,2022/4/15 14:40,32,74,-42,
7295,68,2022/4/15 14:50,31,76,-45,
7296,68,2022/4/15 15:00,29,81,-52,
7297,68,2022/4/15 15:10,31,69,-38,
7298,68,2022/4/15 15:20,35,82,-47,
7299,68,2022/4/15 15:30,28,83,-55,
7300,68,2022/4/15 15:40,32,84,-52,
7301,68,2022/4/15 15:50,33,78,-45,
7302,68,2022/4/15 16:00,40,76,-36,
7303,68,2022/4/15 16:10,35,90,-55,
7304,68,2022/4/15 16:20,36,90,-54,
7305,68,2022/4/15 16:30,43,92,-49,
7306,68,2022/4/15 16:40,45,97,-52,
7307,68,2022/4/15 16:50,43,104,-61,
7308,68,2022/4/15 17:00,198,125,73,
7309,68,2022/4/15 17:10,144,122,22,
7310,68,2022/4/15 17:20,70,110,-40,
7311,68,2022/4/15 17:30,103,191,-88,
7312,68,2022/4/15 17:40,204,191,13,
7313,68,2022/4/15 17:50,149,178,-29,
7314,68,2022/4/15 18:00,143,215,-72,
7315,68,2022/4/15 18:10,217,257,-40,
7316,68,2022/4/15 18:20,137,219,-82,
7317,68,2022/4/15 18:30,110,223,-113,
7318,68,2022/4/15 18:40,88,214,-126,
7319,68,2022/4/15 18:50,60,191,-131,
7320,68,2022/4/15 19:00,45,153,-108,
7321,68,2022/4/15 19:10,44,104,-60,
7322,68,2022/4/15 19:20,38,126,-88,
7323,68,2022/4/15 19:30,33,90,-57,
7324,68,2022/4/15 19:40,29,114,-85,
7325,68,2022/4/15 19:50,28,108,-80,
7326,68,2022/4/15 20:00,24,95,-71,
7327,68,2022/4/15 20:10,33,95,-62,
7328,68,2022/4/15 20:20,29,85,-56,
7329,68,2022/4/15 20:30,29,71,-42,
7330,68,2022/4/15 20:40,29,112,-83,
7331,68,2022/4/15 20:50,28,85,-57,
7332,68,2022/4/15 21:00,28,79,-51,
7333,68,2022/4/15 21:10,25,92,-67,
7334,68,2022/4/15 21:20,28,77,-49,
7335,68,2022/4/15 21:30,25,79,-54,
7336,68,2022/4/15 21:40,23,95,-72,
7337,68,2022/4/15 21:50,19,89,-70,
7338,68,2022/4/15 22:00,18,79,-61,
7339,68,2022/4/15 22:10,14,85,-71,
7340,68,2022/4/15 22:20,3,82,-79,
7341,68,2022/4/15 22:30,0,54,-54,
7342,68,2022/4/15 22:40,0,3,-3,
7343,68,2022/4/15 22:50,0,3,-3,
7344,69,2022/4/15 5:00,0,1,-1,
7345,69,2022/4/15 5:10,0,1,-1,
7346,69,2022/4/15 5:20,0,1,-1,
7347,69,2022/4/15 5:30,1,1,0,
7348,69,2022/4/15 5:40,2,1,1,
7349,69,2022/4/15 5:50,5,1,4,
7350,69,2022/4/15 6:00,16,1,15,
7351,69,2022/4/15 6:10,31,19,12,
7352,69,2022/4/15 6:20,33,41,-8,
7353,69,2022/4/15 6:30,39,38,1,
7354,69,2022/4/15 6:40,54,63,-9,
7355,69,2022/4/15 6:50,57,63,-6,
7356,69,2022/4/15 7:00,82,73,9,
7357,69,2022/4/15 7:10,114,84,30,
7358,69,2022/4/15 7:20,231,106,125,
7359,69,2022/4/15 7:30,264,102,162,
7360,69,2022/4/15 7:40,330,102,228,
7361,69,2022/4/15 7:50,442,109,333,
7362,69,2022/4/15 8:00,323,144,179,
7363,69,2022/4/15 8:10,324,231,93,
7364,69,2022/4/15 8:20,357,225,132,
7365,69,2022/4/15 8:30,252,225,27,
7366,69,2022/4/15 8:40,222,325,-103,
7367,69,2022/4/15 8:50,167,321,-154,
7368,69,2022/4/15 9:00,78,191,-113,
7369,69,2022/4/15 9:10,70,116,-46,
7370,69,2022/4/15 9:20,54,133,-79,
7371,69,2022/4/15 9:30,44,108,-64,
7372,69,2022/4/15 9:40,39,106,-67,
7373,69,2022/4/15 9:50,35,78,-43,
7374,69,2022/4/15 10:00,31,91,-60,
7375,69,2022/4/15 10:10,31,97,-66,
7376,69,2022/4/15 10:20,29,77,-48,
7377,69,2022/4/15 10:30,33,87,-54,
7378,69,2022/4/15 10:40,27,72,-45,
7379,69,2022/4/15 10:50,30,83,-53,
7380,69,2022/4/15 11:00,32,74,-42,
7381,69,2022/4/15 11:10,29,64,-35,
7382,69,2022/4/15 11:20,29,74,-45,
7383,69,2022/4/15 11:30,31,72,-41,
7384,69,2022/4/15 11:40,31,69,-38,
7385,69,2022/4/15 11:50,31,66,-35,
7386,69,2022/4/15 12:00,34,62,-28,
7387,69,2022/4/15 12:10,31,61,-30,
7388,69,2022/4/15 12:20,35,69,-34,
7389,69,2022/4/15 12:30,31,83,-52,
7390,69,2022/4/15 12:40,30,73,-43,
7391,69,2022/4/15 12:50,30,73,-43,
7392,69,2022/4/15 13:00,32,69,-37,
7393,69,2022/4/15 13:10,32,77,-45,
7394,69,2022/4/15 13:20,33,78,-45,
7395,69,2022/4/15 13:30,32,84,-52,
7396,69,2022/4/15 13:40,28,76,-48,
7397,69,2022/4/15 13:50,32,84,-52,
7398,69,2022/4/15 14:00,33,77,-44,
7399,69,2022/4/15 14:10,31,74,-43,
7400,69,2022/4/15 14:20,31,69,-38,
7401,69,2022/4/15 14:30,34,84,-50,
7402,69,2022/4/15 14:40,33,82,-49,
7403,69,2022/4/15 14:50,33,69,-36,
7404,69,2022/4/15 15:00,33,81,-48,
7405,69,2022/4/15 15:10,35,76,-41,
7406,69,2022/4/15 15:20,37,76,-39,
7407,69,2022/4/15 15:30,33,83,-50,
7408,69,2022/4/15 15:40,33,76,-43,
7409,69,2022/4/15 15:50,35,88,-53,
7410,69,2022/4/15 16:00,39,90,-51,
7411,69,2022/4/15 16:10,45,77,-32,
7412,69,2022/4/15 16:20,46,99,-53,
7413,69,2022/4/15 16:30,49,90,-41,
7414,69,2022/4/15 16:40,45,103,-58,
7415,69,2022/4/15 16:50,48,109,-61,
7416,69,2022/4/15 17:00,243,106,137,
7417,69,2022/4/15 17:10,222,108,114,
7418,69,2022/4/15 17:20,130,115,15,
7419,69,2022/4/15 17:30,207,170,37,
7420,69,2022/4/15 17:40,245,153,92,
7421,69,2022/4/15 17:50,142,190,-48,
7422,69,2022/4/15 18:00,149,234,-85,
7423,69,2022/4/15 18:10,234,224,10,
7424,69,2022/4/15 18:20,157,234,-77,
7425,69,2022/4/15 18:30,77,178,-101,
7426,69,2022/4/15 18:40,67,180,-113,
7427,69,2022/4/15 18:50,48,184,-136,
7428,69,2022/4/15 19:00,39,154,-115,
7429,69,2022/4/15 19:10,41,124,-83,
7430,69,2022/4/15 19:20,29,99,-70,
7431,69,2022/4/15 19:30,31,110,-79,
7432,69,2022/4/15 19:40,31,110,-79,
7433,69,2022/4/15 19:50,29,98,-69,
7434,69,2022/4/15 20:00,36,95,-59,
7435,69,2022/4/15 20:10,38,89,-51,
7436,69,2022/4/15 20:20,35,77,-42,
7437,69,2022/4/15 20:30,29,110,-81,
7438,69,2022/4/15 20:40,26,68,-42,
7439,69,2022/4/15 20:50,24,79,-55,
7440,69,2022/4/15 21:00,29,78,-49,
7441,69,2022/4/15 21:10,25,83,-58,
7442,69,2022/4/15 21:20,25,83,-58,
7443,69,2022/4/15 21:30,25,77,-52,
7444,69,2022/4/15 21:40,25,86,-61,
7445,69,2022/4/15 21:50,24,79,-55,
7446,69,2022/4/15 22:00,20,87,-67,
7447,69,2022/4/15 22:10,15,67,-52,
7448,69,2022/4/15 22:20,8,70,-62,
7449,69,2022/4/15 22:30,1,59,-58,
7450,69,2022/4/15 22:40,0,3,-3,
7451,69,2022/4/15 22:50,0,3,-3,
7452,64,2022/4/15 5:00,0,1,-1,
7453,64,2022/4/15 5:10,0,1,-1,
7454,64,2022/4/15 5:20,0,1,-1,
7455,64,2022/4/15 5:30,0,1,-1,
7456,64,2022/4/15 5:40,3,1,2,
7457,64,2022/4/15 5:50,8,1,7,
7458,64,2022/4/15 6:00,14,16,-2,
7459,64,2022/4/15 6:10,29,11,18,
7460,64,2022/4/15 6:20,40,30,10,
7461,64,2022/4/15 6:30,56,32,24,
7462,64,2022/4/15 6:40,57,40,17,
7463,64,2022/4/15 6:50,74,50,24,
7464,64,2022/4/15 7:00,152,66,86,
7465,64,2022/4/15 7:10,192,68,124,
7466,64,2022/4/15 7:20,225,84,141,
7467,64,2022/4/15 7:30,282,100,182,
7468,64,2022/4/15 7:40,367,106,261,
7469,64,2022/4/15 7:50,597,108,489,
7470,64,2022/4/15 8:00,590,122,468,
7471,64,2022/4/15 8:10,474,109,365,
7472,64,2022/4/15 8:20,357,119,238,
7473,64,2022/4/15 8:30,278,124,154,
7474,64,2022/4/15 8:40,246,100,146,
7475,64,2022/4/15 8:50,191,119,72,
7476,64,2022/4/15 9:00,145,109,36,
7477,64,2022/4/15 9:10,101,99,2,
7478,64,2022/4/15 9:20,70,87,-17,
7479,64,2022/4/15 9:30,50,71,-21,
7480,64,2022/4/15 9:40,44,69,-25,
7481,64,2022/4/15 9:50,36,78,-42,
7482,64,2022/4/15 10:00,34,71,-37,
7483,64,2022/4/15 10:10,34,62,-28,
7484,64,2022/4/15 10:20,30,63,-33,
7485,64,2022/4/15 10:30,27,61,-34,
7486,64,2022/4/15 10:40,28,67,-39,
7487,64,2022/4/15 10:50,31,61,-30,
7488,64,2022/4/15 11:00,31,53,-22,
7489,64,2022/4/15 11:10,27,61,-34,
7490,64,2022/4/15 11:20,31,55,-24,
7491,64,2022/4/15 11:30,27,57,-30,
7492,64,2022/4/15 11:40,28,60,-32,
7493,64,2022/4/15 11:50,30,65,-35,
7494,64,2022/4/15 12:00,30,60,-30,
7495,64,2022/4/15 12:10,33,61,-28,
7496,64,2022/4/15 12:20,30,63,-33,
7497,64,2022/4/15 12:30,35,69,-34,
7498,64,2022/4/15 12:40,35,64,-29,
7499,64,2022/4/15 12:50,32,70,-38,
7500,64,2022/4/15 13:00,30,67,-37,
7501,64,2022/4/15 13:10,34,72,-38,
7502,64,2022/4/15 13:20,24,68,-44,
7503,64,2022/4/15 13:30,23,70,-47,
7504,64,2022/4/15 13:40,26,72,-46,
7505,64,2022/4/15 13:50,32,71,-39,
7506,64,2022/4/15 14:00,24,69,-45,
7507,64,2022/4/15 14:10,24,72,-48,
7508,64,2022/4/15 14:20,27,65,-38,
7509,64,2022/4/15 14:30,26,69,-43,
7510,64,2022/4/15 14:40,28,71,-43,
7511,64,2022/4/15 14:50,24,73,-49,
7512,64,2022/4/15 15:00,27,72,-45,
7513,64,2022/4/15 15:10,29,73,-44,
7514,64,2022/4/15 15:20,30,73,-43,
7515,64,2022/4/15 15:30,29,76,-47,
7516,64,2022/4/15 15:40,24,76,-52,
7517,64,2022/4/15 15:50,29,79,-50,
7518,64,2022/4/15 16:00,28,79,-51,
7519,64,2022/4/15 16:10,33,76,-43,
7520,64,2022/4/15 16:20,31,90,-59,
7521,64,2022/4/15 16:30,43,84,-41,
7522,64,2022/4/15 16:40,46,103,-57,
7523,64,2022/4/15 16:50,44,106,-62,
7524,64,2022/4/15 17:00,129,102,27,
7525,64,2022/4/15 17:10,139,109,30,
7526,64,2022/4/15 17:20,62,118,-56,
7527,64,2022/4/15 17:30,74,168,-94,
7528,64,2022/4/15 17:40,77,153,-76,
7529,64,2022/4/15 17:50,49,179,-130,
7530,64,2022/4/15 18:00,53,213,-160,
7531,64,2022/4/15 18:10,42,226,-184,
7532,64,2022/4/15 18:20,36,234,-198,
7533,64,2022/4/15 18:30,37,227,-190,
7534,64,2022/4/15 18:40,32,199,-167,
7535,64,2022/4/15 18:50,31,178,-147,
7536,64,2022/4/15 19:00,28,128,-100,
7537,64,2022/4/15 19:10,25,105,-80,
7538,64,2022/4/15 19:20,28,103,-75,
7539,64,2022/4/15 19:30,27,107,-80,
7540,64,2022/4/15 19:40,21,110,-89,
7541,64,2022/4/15 19:50,21,106,-85,
7542,64,2022/4/15 20:00,21,93,-72,
7543,64,2022/4/15 20:10,21,93,-72,
7544,64,2022/4/15 20:20,18,80,-62,
7545,64,2022/4/15 20:30,18,77,-59,
7546,64,2022/4/15 20:40,20,71,-51,
7547,64,2022/4/15 20:50,19,78,-59,
7548,64,2022/4/15 21:00,20,85,-65,
7549,64,2022/4/15 21:10,16,99,-83,
7550,64,2022/4/15 21:20,19,95,-76,
7551,64,2022/4/15 21:30,14,84,-70,
7552,64,2022/4/15 21:40,14,95,-81,
7553,64,2022/4/15 21:50,9,83,-74,
7554,64,2022/4/15 22:00,12,89,-77,
7555,64,2022/4/15 22:10,10,83,-73,
7556,64,2022/4/15 22:20,4,105,-101,
7557,64,2022/4/15 22:30,0,16,-16,
7558,64,2022/4/15 22:40,0,3,-3,
7559,64,2022/4/15 22:50,0,3,-3,
7560,71,2022/4/15 5:00,0,1,-1,
7561,71,2022/4/15 5:10,0,1,-1,
7562,71,2022/4/15 5:20,0,1,-1,
7563,71,2022/4/15 5:30,0,1,-1,
7564,71,2022/4/15 5:40,1,1,0,
7565,71,2022/4/15 5:50,8,1,7,
7566,71,2022/4/15 6:00,8,1,7,
7567,71,2022/4/15 6:10,10,2,8,
7568,71,2022/4/15 6:20,17,37,-20,
7569,71,2022/4/15 6:30,15,23,-8,
7570,71,2022/4/15 6:40,22,41,-19,
7571,71,2022/4/15 6:50,22,47,-25,
7572,71,2022/4/15 7:00,25,59,-34,
7573,71,2022/4/15 7:10,27,62,-35,
7574,71,2022/4/15 7:20,30,74,-44,
7575,71,2022/4/15 7:30,36,93,-57,
7576,71,2022/4/15 7:40,42,102,-60,
7577,71,2022/4/15 7:50,53,109,-56,
7578,71,2022/4/15 8:00,62,137,-75,
7579,71,2022/4/15 8:10,53,380,-327,
7580,71,2022/4/15 8:20,42,231,-189,
7581,71,2022/4/15 8:30,33,382,-349,
7582,71,2022/4/15 8:40,35,534,-499,
7583,71,2022/4/15 8:50,30,332,-302,
7584,71,2022/4/15 9:00,29,181,-152,
7585,71,2022/4/15 9:10,27,170,-143,
7586,71,2022/4/15 9:20,26,105,-79,
7587,71,2022/4/15 9:30,22,82,-60,
7588,71,2022/4/15 9:40,18,76,-58,
7589,71,2022/4/15 9:50,17,67,-50,
7590,71,2022/4/15 10:00,17,68,-51,
7591,71,2022/4/15 10:10,16,63,-47,
7592,71,2022/4/15 10:20,15,60,-45,
7593,71,2022/4/15 10:30,16,52,-36,
7594,71,2022/4/15 10:40,16,49,-33,
7595,71,2022/4/15 10:50,19,51,-32,
7596,71,2022/4/15 11:00,16,40,-24,
7597,71,2022/4/15 11:10,23,47,-24,
7598,71,2022/4/15 11:20,22,45,-23,
7599,71,2022/4/15 11:30,21,46,-25,
7600,71,2022/4/15 11:40,22,42,-20,
7601,71,2022/4/15 11:50,21,46,-25,
7602,71,2022/4/15 12:00,26,47,-21,
7603,71,2022/4/15 12:10,22,40,-18,
7604,71,2022/4/15 12:20,21,47,-26,
7605,71,2022/4/15 12:30,20,46,-26,
7606,71,2022/4/15 12:40,25,49,-24,
7607,71,2022/4/15 12:50,20,51,-31,
7608,71,2022/4/15 13:00,18,49,-31,
7609,71,2022/4/15 13:10,22,53,-31,
7610,71,2022/4/15 13:20,18,50,-32,
7611,71,2022/4/15 13:30,20,48,-28,
7612,71,2022/4/15 13:40,22,49,-27,
7613,71,2022/4/15 13:50,22,49,-27,
7614,71,2022/4/15 14:00,21,47,-26,
7615,71,2022/4/15 14:10,19,50,-31,
7616,71,2022/4/15 14:20,22,48,-26,
7617,71,2022/4/15 14:30,21,45,-24,
7618,71,2022/4/15 14:40,21,48,-27,
7619,71,2022/4/15 14:50,24,46,-22,
7620,71,2022/4/15 15:00,23,45,-22,
7621,71,2022/4/15 15:10,26,46,-20,
7622,71,2022/4/15 15:20,25,41,-16,
7623,71,2022/4/15 15:30,21,47,-26,
7624,71,2022/4/15 15:40,25,47,-22,
7625,71,2022/4/15 15:50,27,51,-24,
7626,71,2022/4/15 16:00,28,40,-12,
7627,71,2022/4/15 16:10,27,37,-10,
7628,71,2022/4/15 16:20,28,55,-27,
7629,71,2022/4/15 16:30,44,55,-11,
7630,71,2022/4/15 16:40,40,42,-2,
7631,71,2022/4/15 16:50,47,52,-5,
7632,71,2022/4/15 17:00,94,62,32,
7633,71,2022/4/15 17:10,197,60,137,
7634,71,2022/4/15 17:20,79,64,15,
7635,71,2022/4/15 17:30,266,70,196,
7636,71,2022/4/15 17:40,461,72,389,
7637,71,2022/4/15 17:50,227,69,158,
7638,71,2022/4/15 18:00,216,85,131,
7639,71,2022/4/15 18:10,268,77,191,
7640,71,2022/4/15 18:20,137,77,60,
7641,71,2022/4/15 18:30,65,72,-7,
7642,71,2022/4/15 18:40,44,64,-20,
7643,71,2022/4/15 18:50,38,76,-38,
7644,71,2022/4/15 19:00,35,64,-29,
7645,71,2022/4/15 19:10,32,74,-42,
7646,71,2022/4/15 19:20,28,65,-37,
7647,71,2022/4/15 19:30,26,63,-37,
7648,71,2022/4/15 19:40,26,54,-28,
7649,71,2022/4/15 19:50,19,52,-33,
7650,71,2022/4/15 20:00,19,50,-31,
7651,71,2022/4/15 20:10,21,47,-26,
7652,71,2022/4/15 20:20,20,34,-14,
7653,71,2022/4/15 20:30,17,48,-31,
7654,71,2022/4/15 20:40,18,40,-22,
7655,71,2022/4/15 20:50,15,42,-27,
7656,71,2022/4/15 21:00,15,50,-35,
7657,71,2022/4/15 21:10,19,39,-20,
7658,71,2022/4/15 21:20,15,50,-35,
7659,71,2022/4/15 21:30,12,50,-38,
7660,71,2022/4/15 21:40,12,44,-32,
7661,71,2022/4/15 21:50,12,48,-36,
7662,71,2022/4/15 22:00,10,49,-39,
7663,71,2022/4/15 22:10,10,47,-37,
7664,71,2022/4/15 22:20,3,25,-22,
7665,71,2022/4/15 22:30,0,4,-4,
7666,71,2022/4/15 22:40,0,3,-3,
7667,71,2022/4/15 22:50,0,3,-3,
7668,63,2022/4/15 5:00,0,1,-1,
7669,63,2022/4/15 5:10,0,1,-1,
7670,63,2022/4/15 5:20,0,1,-1,
7671,63,2022/4/15 5:30,1,1,0,
7672,63,2022/4/15 5:40,1,1,0,
7673,63,2022/4/15 5:50,10,1,9,
7674,63,2022/4/15 6:00,6,1,5,
7675,63,2022/4/15 6:10,12,21,-9,
7676,63,2022/4/15 6:20,15,6,9,
7677,63,2022/4/15 6:30,17,32,-15,
7678,63,2022/4/15 6:40,26,25,1,
7679,63,2022/4/15 6:50,29,37,-8,
7680,63,2022/4/15 7:00,30,50,-20,
7681,63,2022/4/15 7:10,34,69,-35,
7682,63,2022/4/15 7:20,36,78,-42,
7683,63,2022/4/15 7:30,41,90,-49,
7684,63,2022/4/15 7:40,48,108,-60,
7685,63,2022/4/15 7:50,53,169,-116,
7686,63,2022/4/15 8:00,55,432,-377,
7687,63,2022/4/15 8:10,59,433,-374,
7688,63,2022/4/15 8:20,52,436,-384,
7689,63,2022/4/15 8:30,44,533,-489,
7690,63,2022/4/15 8:40,36,495,-459,
7691,63,2022/4/15 8:50,32,332,-300,
7692,63,2022/4/15 9:00,32,234,-202,
7693,63,2022/4/15 9:10,29,146,-117,
7694,63,2022/4/15 9:20,28,111,-83,
7695,63,2022/4/15 9:30,26,105,-79,
7696,63,2022/4/15 9:40,24,105,-81,
7697,63,2022/4/15 9:50,20,84,-64,
7698,63,2022/4/15 10:00,21,92,-71,
7699,63,2022/4/15 10:10,22,70,-48,
7700,63,2022/4/15 10:20,22,67,-45,
7701,63,2022/4/15 10:30,21,62,-41,
7702,63,2022/4/15 10:40,22,61,-39,
7703,63,2022/4/15 10:50,19,54,-35,
7704,63,2022/4/15 11:00,22,47,-25,
7705,63,2022/4/15 11:10,23,50,-27,
7706,63,2022/4/15 11:20,25,44,-19,
7707,63,2022/4/15 11:30,26,58,-32,
7708,63,2022/4/15 11:40,28,51,-23,
7709,63,2022/4/15 11:50,24,50,-26,
7710,63,2022/4/15 12:00,30,46,-16,
7711,63,2022/4/15 12:10,27,47,-20,
7712,63,2022/4/15 12:20,22,51,-29,
7713,63,2022/4/15 12:30,24,55,-31,
7714,63,2022/4/15 12:40,26,67,-41,
7715,63,2022/4/15 12:50,22,62,-40,
7716,63,2022/4/15 13:00,26,64,-38,
7717,63,2022/4/15 13:10,23,70,-47,
7718,63,2022/4/15 13:20,26,61,-35,
7719,63,2022/4/15 13:30,27,65,-38,
7720,63,2022/4/15 13:40,24,62,-38,
7721,63,2022/4/15 13:50,22,54,-32,
7722,63,2022/4/15 14:00,22,52,-30,
7723,63,2022/4/15 14:10,26,54,-28,
7724,63,2022/4/15 14:20,26,54,-28,
7725,63,2022/4/15 14:30,27,56,-29,
7726,63,2022/4/15 14:40,25,53,-28,
7727,63,2022/4/15 14:50,28,56,-28,
7728,63,2022/4/15 15:00,29,56,-27,
7729,63,2022/4/15 15:10,27,57,-30,
7730,63,2022/4/15 15:20,25,52,-27,
7731,63,2022/4/15 15:30,29,61,-32,
7732,63,2022/4/15 15:40,26,54,-28,
7733,63,2022/4/15 15:50,29,62,-33,
7734,63,2022/4/15 16:00,30,62,-32,
7735,63,2022/4/15 16:10,32,61,-29,
7736,63,2022/4/15 16:20,32,66,-34,
7737,63,2022/4/15 16:30,44,57,-13,
7738,63,2022/4/15 16:40,41,74,-33,
7739,63,2022/4/15 16:50,50,55,-5,
7740,63,2022/4/15 17:00,274,70,204,
7741,63,2022/4/15 17:10,368,67,301,
7742,63,2022/4/15 17:20,227,65,162,
7743,63,2022/4/15 17:30,260,75,185,
7744,63,2022/4/15 17:40,577,84,493,
7745,63,2022/4/15 17:50,287,79,208,
7746,63,2022/4/15 18:00,227,93,134,
7747,63,2022/4/15 18:10,291,92,199,
7748,63,2022/4/15 18:20,213,99,114,
7749,63,2022/4/15 18:30,132,81,51,
7750,63,2022/4/15 18:40,131,78,53,
7751,63,2022/4/15 18:50,63,80,-17,
7752,63,2022/4/15 19:00,44,77,-33,
7753,63,2022/4/15 19:10,42,64,-22,
7754,63,2022/4/15 19:20,31,68,-37,
7755,63,2022/4/15 19:30,28,55,-27,
7756,63,2022/4/15 19:40,24,55,-31,
7757,63,2022/4/15 19:50,28,57,-29,
7758,63,2022/4/15 20:00,29,52,-23,
7759,63,2022/4/15 20:10,28,48,-20,
7760,63,2022/4/15 20:20,27,47,-20,
7761,63,2022/4/15 20:30,27,48,-21,
7762,63,2022/4/15 20:40,26,50,-24,
7763,63,2022/4/15 20:50,22,41,-19,
7764,63,2022/4/15 21:00,21,52,-31,
7765,63,2022/4/15 21:10,24,47,-23,
7766,63,2022/4/15 21:20,22,51,-29,
7767,63,2022/4/15 21:30,24,52,-28,
7768,63,2022/4/15 21:40,21,44,-23,
7769,63,2022/4/15 21:50,11,48,-37,
7770,63,2022/4/15 22:00,12,40,-28,
7771,63,2022/4/15 22:10,13,38,-25,
7772,63,2022/4/15 22:20,3,34,-31,
7773,63,2022/4/15 22:30,1,15,-14,
7774,63,2022/4/15 22:40,0,3,-3,
7775,63,2022/4/15 22:50,0,3,-3,
7776,77,2022/4/15 5:00,0,1,-1,-1
7777,77,2022/4/15 5:10,0,1,-1,-1
7778,77,2022/4/15 5:20,0,1,-1,-1
7779,77,2022/4/15 5:30,3,1,2,2
7780,77,2022/4/15 5:40,30,1,29,29
7781,77,2022/4/15 5:50,67,1,66,66
7782,77,2022/4/15 6:00,60,1,59,59
7783,77,2022/4/15 6:10,97,1,96,96
7784,77,2022/4/15 6:20,215,1,214,214
7785,77,2022/4/15 6:30,235,54,181,181
7786,77,2022/4/15 6:40,277,37,240,240
7787,77,2022/4/15 6:50,328,37,291,291
7788,77,2022/4/15 7:00,599,49,550,550
7789,77,2022/4/15 7:10,730,56,674,674
7790,77,2022/4/15 7:20,824,83,741,741
7791,77,2022/4/15 7:30,1214,75,1139,1139
7792,77,2022/4/15 7:40,1600,92,1508,1508
7793,77,2022/4/15 7:50,1987,87,1900,1900
7794,77,2022/4/15 8:00,1988,109,1879,1879
7795,77,2022/4/15 8:10,1638,121,1517,1517
7796,77,2022/4/15 8:20,1384,110,1274,1274
7797,77,2022/4/15 8:30,1167,108,1059,1059
7798,77,2022/4/15 8:40,726,111,615,615
7799,77,2022/4/15 8:50,639,106,533,533
7800,77,2022/4/15 9:00,432,106,326,326
7801,77,2022/4/15 9:10,275,121,154,154
7802,77,2022/4/15 9:20,275,93,182,182
7803,77,2022/4/15 9:30,219,93,126,126
7804,77,2022/4/15 9:40,177,74,103,103
7805,77,2022/4/15 9:50,140,94,46,46
7806,77,2022/4/15 10:00,85,104,-19,-19
7807,77,2022/4/15 10:10,76,85,-9,-9
7808,77,2022/4/15 10:20,62,84,-22,-22
7809,77,2022/4/15 10:30,58,87,-29,-29
7810,77,2022/4/15 10:40,57,102,-45,-45
7811,77,2022/4/15 10:50,48,80,-32,-32
7812,77,2022/4/15 11:00,47,77,-30,-30
7813,77,2022/4/15 11:10,47,106,-59,-59
7814,77,2022/4/15 11:20,45,108,-63,-63
7815,77,2022/4/15 11:30,44,87,-43,-43
7816,77,2022/4/15 11:40,59,69,-10,-10
7817,77,2022/4/15 11:50,66,107,-41,-41
7818,77,2022/4/15 12:00,62,102,-40,-40
7819,77,2022/4/15 12:10,62,77,-15,-15
7820,77,2022/4/15 12:20,68,75,-7,-7
7821,77,2022/4/15 12:30,67,103,-36,-36
7822,77,2022/4/15 12:40,64,103,-39,-39
7823,77,2022/4/15 12:50,56,79,-23,-23
7824,77,2022/4/15 13:00,54,75,-21,-21
7825,77,2022/4/15 13:10,55,108,-53,-53
7826,77,2022/4/15 13:20,45,110,-65,-65
7827,77,2022/4/15 13:30,43,90,-47,-47
7828,77,2022/4/15 13:40,43,82,-39,-39
7829,77,2022/4/15 13:50,48,93,-45,-45
7830,77,2022/4/15 14:00,42,124,-82,-82
7831,77,2022/4/15 14:10,41,87,-46,-46
7832,77,2022/4/15 14:20,41,93,-52,-52
7833,77,2022/4/15 14:30,40,108,-68,-68
7834,77,2022/4/15 14:40,43,115,-72,-72
7835,77,2022/4/15 14:50,40,105,-65,-65
7836,77,2022/4/15 15:00,40,93,-53,-53
7837,77,2022/4/15 15:10,41,102,-61,-61
7838,77,2022/4/15 15:20,38,109,-71,-71
7839,77,2022/4/15 15:30,46,106,-60,-60
7840,77,2022/4/15 15:40,46,105,-59,-59
7841,77,2022/4/15 15:50,41,121,-80,-80
7842,77,2022/4/15 16:00,44,184,-140,-140
7843,77,2022/4/15 16:10,44,120,-76,-76
7844,77,2022/4/15 16:20,43,124,-81,-81
7845,77,2022/4/15 16:30,44,115,-71,-71
7846,77,2022/4/15 16:40,50,198,-148,-148
7847,77,2022/4/15 16:50,44,120,-76,-76
7848,77,2022/4/15 17:00,49,118,-69,-69
7849,77,2022/4/15 17:10,70,317,-247,-247
7850,77,2022/4/15 17:20,53,175,-122,-122
7851,77,2022/4/15 17:30,54,231,-177,-177
7852,77,2022/4/15 17:40,128,531,-403,-403
7853,77,2022/4/15 17:50,75,317,-242,-242
7854,77,2022/4/15 18:00,66,477,-411,-411
7855,77,2022/4/15 18:10,70,573,-503,-503
7856,77,2022/4/15 18:20,67,503,-436,-436
7857,77,2022/4/15 18:30,46,601,-555,-555
7858,77,2022/4/15 18:40,42,1109,-1067,-1067
7859,77,2022/4/15 18:50,36,402,-366,-366
7860,77,2022/4/15 19:00,43,626,-583,-583
7861,77,2022/4/15 19:10,29,584,-555,-555
7862,77,2022/4/15 19:20,28,326,-298,-298
7863,77,2022/4/15 19:30,33,504,-471,-471
7864,77,2022/4/15 19:40,31,435,-404,-404
7865,77,2022/4/15 19:50,26,169,-143,-143
7866,77,2022/4/15 20:00,30,272,-242,-242
7867,77,2022/4/15 20:10,33,219,-186,-186
7868,77,2022/4/15 20:20,30,112,-82,-82
7869,77,2022/4/15 20:30,28,237,-209,-209
7870,77,2022/4/15 20:40,36,109,-73,-73
7871,77,2022/4/15 20:50,24,144,-120,-120
7872,77,2022/4/15 21:00,32,198,-166,-166
7873,77,2022/4/15 21:10,25,109,-84,-84
7874,77,2022/4/15 21:20,24,128,-104,-104
7875,77,2022/4/15 21:30,27,111,-84,-84
7876,77,2022/4/15 21:40,28,273,-245,-245
7877,77,2022/4/15 21:50,26,153,-127,-127
7878,77,2022/4/15 22:00,20,110,-90,-90
7879,77,2022/4/15 22:10,1,115,-114,-114
7880,77,2022/4/15 22:20,1,209,-208,-208
7881,77,2022/4/15 22:30,0,122,-122,-122
7882,77,2022/4/15 22:40,0,100,-100,-100
7883,77,2022/4/15 22:50,0,95,-95,-95
7884,76,2022/4/15 5:00,0,1,-1,
7885,76,2022/4/15 5:10,0,1,-1,
7886,76,2022/4/15 5:20,0,1,-1,
7887,76,2022/4/15 5:30,0,1,-1,
7888,76,2022/4/15 5:40,4,1,3,
7889,76,2022/4/15 5:50,17,1,16,
7890,76,2022/4/15 6:00,19,1,18,
7891,76,2022/4/15 6:10,23,1,22,
7892,76,2022/4/15 6:20,25,1,24,
7893,76,2022/4/15 6:30,32,19,13,
7894,76,2022/4/15 6:40,31,8,23,
7895,76,2022/4/15 6:50,32,31,1,
7896,76,2022/4/15 7:00,27,23,4,
7897,76,2022/4/15 7:10,43,21,22,
7898,76,2022/4/15 7:20,49,40,9,
7899,76,2022/4/15 7:30,47,37,10,
7900,76,2022/4/15 7:40,80,41,39,
7901,76,2022/4/15 7:50,80,67,13,
7902,76,2022/4/15 8:00,56,102,-46,
7903,76,2022/4/15 8:10,52,89,-37,
7904,76,2022/4/15 8:20,59,112,-53,
7905,76,2022/4/15 8:30,53,108,-55,
7906,76,2022/4/15 8:40,39,114,-75,
7907,76,2022/4/15 8:50,32,125,-93,
7908,76,2022/4/15 9:00,27,98,-71,
7909,76,2022/4/15 9:10,24,60,-36,
7910,76,2022/4/15 9:20,24,77,-53,
7911,76,2022/4/15 9:30,23,58,-35,
7912,76,2022/4/15 9:40,20,72,-52,
7913,76,2022/4/15 9:50,20,51,-31,
7914,76,2022/4/15 10:00,19,38,-19,
7915,76,2022/4/15 10:10,18,40,-22,
7916,76,2022/4/15 10:20,19,60,-41,
7917,76,2022/4/15 10:30,14,41,-27,
7918,76,2022/4/15 10:40,16,33,-17,
7919,76,2022/4/15 10:50,16,31,-15,
7920,76,2022/4/15 11:00,17,45,-28,
7921,76,2022/4/15 11:10,17,33,-16,
7922,76,2022/4/15 11:20,16,31,-15,
7923,76,2022/4/15 11:30,15,32,-17,
7924,76,2022/4/15 11:40,17,44,-27,
7925,76,2022/4/15 11:50,17,34,-17,
7926,76,2022/4/15 12:00,18,29,-11,
7927,76,2022/4/15 12:10,18,31,-13,
7928,76,2022/4/15 12:20,20,49,-29,
7929,76,2022/4/15 12:30,20,34,-14,
7930,76,2022/4/15 12:40,17,40,-23,
7931,76,2022/4/15 12:50,17,31,-14,
7932,76,2022/4/15 13:00,19,52,-33,
7933,76,2022/4/15 13:10,15,39,-24,
7934,76,2022/4/15 13:20,16,38,-22,
7935,76,2022/4/15 13:30,19,38,-19,
7936,76,2022/4/15 13:40,19,61,-42,
7937,76,2022/4/15 13:50,19,47,-28,
7938,76,2022/4/15 14:00,20,40,-20,
7939,76,2022/4/15 14:10,17,38,-21,
7940,76,2022/4/15 14:20,20,61,-41,
7941,76,2022/4/15 14:30,16,46,-30,
7942,76,2022/4/15 14:40,16,38,-22,
7943,76,2022/4/15 14:50,19,38,-19,
7944,76,2022/4/15 15:00,16,62,-46,
7945,76,2022/4/15 15:10,17,38,-21,
7946,76,2022/4/15 15:20,18,37,-19,
7947,76,2022/4/15 15:30,18,38,-20,
7948,76,2022/4/15 15:40,20,67,-47,
7949,76,2022/4/15 15:50,18,48,-30,
7950,76,2022/4/15 16:00,19,38,-19,
7951,76,2022/4/15 16:10,20,41,-21,
7952,76,2022/4/15 16:20,17,63,-46,
7953,76,2022/4/15 16:30,22,49,-27,
7954,76,2022/4/15 16:40,25,45,-20,
7955,76,2022/4/15 16:50,23,47,-24,
7956,76,2022/4/15 17:00,28,73,-45,
7957,76,2022/4/15 17:10,28,48,-20,
7958,76,2022/4/15 17:20,33,63,-30,
7959,76,2022/4/15 17:30,35,70,-35,
7960,76,2022/4/15 17:40,68,61,7,
7961,76,2022/4/15 17:50,35,75,-40,
7962,76,2022/4/15 18:00,37,79,-42,
7963,76,2022/4/15 18:10,62,71,-9,
7964,76,2022/4/15 18:20,47,89,-42,
7965,76,2022/4/15 18:30,35,97,-62,
7966,76,2022/4/15 18:40,29,75,-46,
7967,76,2022/4/15 18:50,29,92,-63,
7968,76,2022/4/15 19:00,26,88,-62,
7969,76,2022/4/15 19:10,24,65,-41,
7970,76,2022/4/15 19:20,20,72,-52,
7971,76,2022/4/15 19:30,15,75,-60,
7972,76,2022/4/15 19:40,16,53,-37,
7973,76,2022/4/15 19:50,16,70,-54,
7974,76,2022/4/15 20:00,13,60,-47,
7975,76,2022/4/15 20:10,15,38,-23,
7976,76,2022/4/15 20:20,12,52,-40,
7977,76,2022/4/15 20:30,12,39,-27,
7978,76,2022/4/15 20:40,11,43,-32,
7979,76,2022/4/15 20:50,10,53,-43,
7980,76,2022/4/15 21:00,12,30,-18,
7981,76,2022/4/15 21:10,15,32,-17,
7982,76,2022/4/15 21:20,13,32,-19,
7983,76,2022/4/15 21:30,10,51,-41,
7984,76,2022/4/15 21:40,11,34,-23,
7985,76,2022/4/15 21:50,8,27,-19,
7986,76,2022/4/15 22:00,9,37,-28,
7987,76,2022/4/15 22:10,1,46,-45,
7988,76,2022/4/15 22:20,0,34,-34,
7989,76,2022/4/15 22:30,0,27,-27,
7990,76,2022/4/15 22:40,0,26,-26,
7991,76,2022/4/15 22:50,0,21,-21,
7992,74,2022/4/15 5:00,0,1,-1,
7993,74,2022/4/15 5:10,0,1,-1,
7994,74,2022/4/15 5:20,0,1,-1,
7995,74,2022/4/15 5:30,0,1,-1,
7996,74,2022/4/15 5:40,3,1,2,
7997,74,2022/4/15 5:50,17,1,16,
7998,74,2022/4/15 6:00,31,2,29,
7999,74,2022/4/15 6:10,31,1,30,
8000,74,2022/4/15 6:20,43,2,41,
8001,74,2022/4/15 6:30,57,22,35,
8002,74,2022/4/15 6:40,72,30,42,
8003,74,2022/4/15 6:50,85,23,62,
8004,74,2022/4/15 7:00,148,32,116,
8005,74,2022/4/15 7:10,217,48,169,
8006,74,2022/4/15 7:20,280,44,236,
8007,74,2022/4/15 7:30,351,51,300,
8008,74,2022/4/15 7:40,474,69,405,
8009,74,2022/4/15 7:50,598,66,532,
8010,74,2022/4/15 8:00,631,72,559,
8011,74,2022/4/15 8:10,590,93,497,
8012,74,2022/4/15 8:20,474,86,388,
8013,74,2022/4/15 8:30,331,98,233,
8014,74,2022/4/15 8:40,278,110,168,
8015,74,2022/4/15 8:50,200,124,76,
8016,74,2022/4/15 9:00,145,97,48,
8017,74,2022/4/15 9:10,95,77,18,
8018,74,2022/4/15 9:20,64,56,8,
8019,74,2022/4/15 9:30,46,71,-25,
8020,74,2022/4/15 9:40,43,54,-11,
8021,74,2022/4/15 9:50,40,52,-12,
8022,74,2022/4/15 10:00,31,61,-30,
8023,74,2022/4/15 10:10,30,58,-28,
8024,74,2022/4/15 10:20,28,47,-19,
8025,74,2022/4/15 10:30,29,50,-21,
8026,74,2022/4/15 10:40,28,48,-20,
8027,74,2022/4/15 10:50,28,64,-36,
8028,74,2022/4/15 11:00,24,45,-21,
8029,74,2022/4/15 11:10,28,48,-20,
8030,74,2022/4/15 11:20,25,64,-39,
8031,74,2022/4/15 11:30,22,62,-40,
8032,74,2022/4/15 11:40,28,54,-26,
8033,74,2022/4/15 11:50,28,54,-26,
8034,74,2022/4/15 12:00,30,60,-30,
8035,74,2022/4/15 12:10,28,64,-36,
8036,74,2022/4/15 12:20,29,48,-19,
8037,74,2022/4/15 12:30,30,51,-21,
8038,74,2022/4/15 12:40,29,64,-35,
8039,74,2022/4/15 12:50,27,72,-45,
8040,74,2022/4/15 13:00,29,66,-37,
8041,74,2022/4/15 13:10,28,49,-21,
8042,74,2022/4/15 13:20,28,65,-37,
8043,74,2022/4/15 13:30,29,84,-55,
8044,74,2022/4/15 13:40,28,54,-26,
8045,74,2022/4/15 13:50,26,58,-32,
8046,74,2022/4/15 14:00,28,59,-31,
8047,74,2022/4/15 14:10,27,83,-56,
8048,74,2022/4/15 14:20,29,60,-31,
8049,74,2022/4/15 14:30,22,66,-44,
8050,74,2022/4/15 14:40,27,67,-40,
8051,74,2022/4/15 14:50,28,77,-49,
8052,74,2022/4/15 15:00,22,64,-42,
8053,74,2022/4/15 15:10,26,66,-40,
8054,74,2022/4/15 15:20,27,75,-48,
8055,74,2022/4/15 15:30,25,93,-68,
8056,74,2022/4/15 15:40,26,69,-43,
8057,74,2022/4/15 15:50,25,83,-58,
8058,74,2022/4/15 16:00,29,90,-61,
8059,74,2022/4/15 16:10,27,110,-83,
8060,74,2022/4/15 16:20,28,77,-49,
8061,74,2022/4/15 16:30,27,77,-50,
8062,74,2022/4/15 16:40,29,110,-81,
8063,74,2022/4/15 16:50,30,108,-78,
8064,74,2022/4/15 17:00,28,108,-80,
8065,74,2022/4/15 17:10,39,122,-83,
8066,74,2022/4/15 17:20,29,106,-77,
8067,74,2022/4/15 17:30,35,120,-85,
8068,74,2022/4/15 17:40,40,183,-143,
8069,74,2022/4/15 17:50,29,110,-81,
8070,74,2022/4/15 18:00,48,223,-175,
8071,74,2022/4/15 18:10,77,322,-245,
8072,74,2022/4/15 18:20,45,110,-65,
8073,74,2022/4/15 18:30,35,337,-302,
8074,74,2022/4/15 18:40,39,322,-283,
8075,74,2022/4/15 18:50,29,119,-90,
8076,74,2022/4/15 19:00,28,285,-257,
8077,74,2022/4/15 19:10,26,178,-152,
8078,74,2022/4/15 19:20,25,113,-88,
8079,74,2022/4/15 19:30,24,103,-79,
8080,74,2022/4/15 19:40,23,112,-89,
8081,74,2022/4/15 19:50,21,97,-76,
8082,74,2022/4/15 20:00,22,103,-81,
8083,74,2022/4/15 20:10,19,109,-90,
8084,74,2022/4/15 20:20,18,81,-63,
8085,74,2022/4/15 20:30,17,104,-87,
8086,74,2022/4/15 20:40,19,89,-70,
8087,74,2022/4/15 20:50,17,83,-66,
8088,74,2022/4/15 21:00,19,78,-59,
8089,74,2022/4/15 21:10,16,107,-91,
8090,74,2022/4/15 21:20,13,75,-62,
8091,74,2022/4/15 21:30,13,85,-72,
8092,74,2022/4/15 21:40,13,92,-79,
8093,74,2022/4/15 21:50,11,109,-98,
8094,74,2022/4/15 22:00,12,94,-82,
8095,74,2022/4/15 22:10,6,78,-72,
8096,74,2022/4/15 22:20,1,71,-70,
8097,74,2022/4/15 22:30,1,92,-91,
8098,74,2022/4/15 22:40,1,59,-58,
8099,74,2022/4/15 22:50,0,3,-3,
8100,78,2022/4/15 5:00,0,1,-1,
8101,78,2022/4/15 5:10,0,1,-1,
8102,78,2022/4/15 5:20,0,1,-1,
8103,78,2022/4/15 5:30,0,1,-1,
8104,78,2022/4/15 5:40,1,1,0,
8105,78,2022/4/15 5:50,13,1,12,
8106,78,2022/4/15 6:00,30,1,29,
8107,78,2022/4/15 6:10,31,1,30,
8108,78,2022/4/15 6:20,46,23,23,
8109,78,2022/4/15 6:30,57,33,24,
8110,78,2022/4/15 6:40,87,41,46,
8111,78,2022/4/15 6:50,154,39,115,
8112,78,2022/4/15 7:00,225,45,180,
8113,78,2022/4/15 7:10,279,46,233,
8114,78,2022/4/15 7:20,350,60,290,
8115,78,2022/4/15 7:30,441,77,364,
8116,78,2022/4/15 7:40,593,68,525,
8117,78,2022/4/15 7:50,599,126,473,
8118,78,2022/4/15 8:00,688,109,579,
8119,78,2022/4/15 8:10,663,115,548,
8120,78,2022/4/15 8:20,590,180,410,
8121,78,2022/4/15 8:30,375,106,269,
8122,78,2022/4/15 8:40,281,194,87,
8123,78,2022/4/15 8:50,247,181,66,
8124,78,2022/4/15 9:00,200,133,67,
8125,78,2022/4/15 9:10,149,102,47,
8126,78,2022/4/15 9:20,81,89,-8,
8127,78,2022/4/15 9:30,58,79,-21,
8128,78,2022/4/15 9:40,51,83,-32,
8129,78,2022/4/15 9:50,43,75,-32,
8130,78,2022/4/15 10:00,36,80,-44,
8131,78,2022/4/15 10:10,37,54,-17,
8132,78,2022/4/15 10:20,31,63,-32,
8133,78,2022/4/15 10:30,35,71,-36,
8134,78,2022/4/15 10:40,27,64,-37,
8135,78,2022/4/15 10:50,29,51,-22,
8136,78,2022/4/15 11:00,29,45,-16,
8137,78,2022/4/15 11:10,28,60,-32,
8138,78,2022/4/15 11:20,26,59,-33,
8139,78,2022/4/15 11:30,26,46,-20,
8140,78,2022/4/15 11:40,27,55,-28,
8141,78,2022/4/15 11:50,33,63,-30,
8142,78,2022/4/15 12:00,25,61,-36,
8143,78,2022/4/15 12:10,34,57,-23,
8144,78,2022/4/15 12:20,33,65,-32,
8145,78,2022/4/15 12:30,28,85,-57,
8146,78,2022/4/15 12:40,31,64,-33,
8147,78,2022/4/15 12:50,31,53,-22,
8148,78,2022/4/15 13:00,29,63,-34,
8149,78,2022/4/15 13:10,32,69,-37,
8150,78,2022/4/15 13:20,27,69,-42,
8151,78,2022/4/15 13:30,28,65,-37,
8152,78,2022/4/15 13:40,29,64,-35,
8153,78,2022/4/15 13:50,28,73,-45,
8154,78,2022/4/15 14:00,26,73,-47,
8155,78,2022/4/15 14:10,28,62,-34,
8156,78,2022/4/15 14:20,25,66,-41,
8157,78,2022/4/15 14:30,26,76,-50,
8158,78,2022/4/15 14:40,23,75,-52,
8159,78,2022/4/15 14:50,26,60,-34,
8160,78,2022/4/15 15:00,29,69,-40,
8161,78,2022/4/15 15:10,30,80,-50,
8162,78,2022/4/15 15:20,27,75,-48,
8163,78,2022/4/15 15:30,31,73,-42,
8164,78,2022/4/15 15:40,27,83,-56,
8165,78,2022/4/15 15:50,28,105,-77,
8166,78,2022/4/15 16:00,32,92,-60,
8167,78,2022/4/15 16:10,26,74,-48,
8168,78,2022/4/15 16:20,27,80,-53,
8169,78,2022/4/15 16:30,36,121,-85,
8170,78,2022/4/15 16:40,37,112,-75,
8171,78,2022/4/15 16:50,33,105,-72,
8172,78,2022/4/15 17:00,54,109,-55,
8173,78,2022/4/15 17:10,81,100,-19,
8174,78,2022/4/15 17:20,57,181,-124,
8175,78,2022/4/15 17:30,73,144,-71,
8176,78,2022/4/15 17:40,216,157,59,
8177,78,2022/4/15 17:50,139,333,-194,
8178,78,2022/4/15 18:00,70,225,-155,
8179,78,2022/4/15 18:10,197,299,-102,
8180,78,2022/4/15 18:20,92,328,-236,
8181,78,2022/4/15 18:30,56,227,-171,
8182,78,2022/4/15 18:40,48,300,-252,
8183,78,2022/4/15 18:50,43,329,-286,
8184,78,2022/4/15 19:00,38,158,-120,
8185,78,2022/4/15 19:10,38,154,-116,
8186,78,2022/4/15 19:20,31,146,-115,
8187,78,2022/4/15 19:30,28,122,-94,
8188,78,2022/4/15 19:40,33,124,-91,
8189,78,2022/4/15 19:50,27,115,-88,
8190,78,2022/4/15 20:00,27,109,-82,
8191,78,2022/4/15 20:10,28,92,-64,
8192,78,2022/4/15 20:20,26,122,-96,
8193,78,2022/4/15 20:30,25,89,-64,
8194,78,2022/4/15 20:40,22,91,-69,
8195,78,2022/4/15 20:50,20,91,-71,
8196,78,2022/4/15 21:00,21,123,-102,
8197,78,2022/4/15 21:10,22,92,-70,
8198,78,2022/4/15 21:20,17,77,-60,
8199,78,2022/4/15 21:30,17,95,-78,
8200,78,2022/4/15 21:40,16,127,-111,
8201,78,2022/4/15 21:50,16,75,-59,
8202,78,2022/4/15 22:00,13,78,-65,
8203,78,2022/4/15 22:10,10,84,-74,
8204,78,2022/4/15 22:20,2,103,-101,
8205,78,2022/4/15 22:30,2,71,-69,
8206,78,2022/4/15 22:40,0,54,-54,
8207,78,2022/4/15 22:50,0,3,-3,
8208,80,2022/4/15 5:00,0,1,-1,
8209,80,2022/4/15 5:10,0,1,-1,
8210,80,2022/4/15 5:20,0,1,-1,
8211,80,2022/4/15 5:30,0,1,-1,
8212,80,2022/4/15 5:40,0,1,-1,
8213,80,2022/4/15 5:50,4,1,3,
8214,80,2022/4/15 6:00,11,1,10,
8215,80,2022/4/15 6:10,10,6,4,
8216,80,2022/4/15 6:20,16,35,-19,
8217,80,2022/4/15 6:30,20,23,-3,
8218,80,2022/4/15 6:40,29,50,-21,
8219,80,2022/4/15 6:50,32,84,-52,
8220,80,2022/4/15 7:00,32,66,-34,
8221,80,2022/4/15 7:10,33,99,-66,
8222,80,2022/4/15 7:20,54,97,-43,
8223,80,2022/4/15 7:30,60,124,-64,
8224,80,2022/4/15 7:40,88,184,-96,
8225,80,2022/4/15 7:50,112,131,-19,
8226,80,2022/4/15 8:00,157,322,-165,
8227,80,2022/4/15 8:10,150,428,-278,
8228,80,2022/4/15 8:20,163,494,-331,
8229,80,2022/4/15 8:30,143,1459,-1316,
8230,80,2022/4/15 8:40,87,1904,-1817,
8231,80,2022/4/15 8:50,57,411,-354,
8232,80,2022/4/15 9:00,48,434,-386,
8233,80,2022/4/15 9:10,37,501,-464,
8234,80,2022/4/15 9:20,39,316,-277,
8235,80,2022/4/15 9:30,29,196,-167,
8236,80,2022/4/15 9:40,30,376,-346,
8237,80,2022/4/15 9:50,33,177,-144,
8238,80,2022/4/15 10:00,28,110,-82,
8239,80,2022/4/15 10:10,28,106,-78,
8240,80,2022/4/15 10:20,33,110,-77,
8241,80,2022/4/15 10:30,31,97,-66,
8242,80,2022/4/15 10:40,33,93,-60,
8243,80,2022/4/15 10:50,30,77,-47,
8244,80,2022/4/15 11:00,31,108,-77,
8245,80,2022/4/15 11:10,29,75,-46,
8246,80,2022/4/15 11:20,33,61,-28,
8247,80,2022/4/15 11:30,33,64,-31,
8248,80,2022/4/15 11:40,33,101,-68,
8249,80,2022/4/15 11:50,30,83,-53,
8250,80,2022/4/15 12:00,32,78,-46,
8251,80,2022/4/15 12:10,35,72,-37,
8252,80,2022/4/15 12:20,42,105,-63,
8253,80,2022/4/15 12:30,36,82,-46,
8254,80,2022/4/15 12:40,36,76,-40,
8255,80,2022/4/15 12:50,37,73,-36,
8256,80,2022/4/15 13:00,36,110,-74,
8257,80,2022/4/15 13:10,39,75,-36,
8258,80,2022/4/15 13:20,36,74,-38,
8259,80,2022/4/15 13:30,35,77,-42,
8260,80,2022/4/15 13:40,38,104,-66,
8261,80,2022/4/15 13:50,37,76,-39,
8262,80,2022/4/15 14:00,39,74,-35,
8263,80,2022/4/15 14:10,35,69,-34,
8264,80,2022/4/15 14:20,43,106,-63,
8265,80,2022/4/15 14:30,38,84,-46,
8266,80,2022/4/15 14:40,44,84,-40,
8267,80,2022/4/15 14:50,40,62,-22,
8268,80,2022/4/15 15:00,39,101,-62,
8269,80,2022/4/15 15:10,43,85,-42,
8270,80,2022/4/15 15:20,43,81,-38,
8271,80,2022/4/15 15:30,38,74,-36,
8272,80,2022/4/15 15:40,45,109,-64,
8273,80,2022/4/15 15:50,43,85,-42,
8274,80,2022/4/15 16:00,48,83,-35,
8275,80,2022/4/15 16:10,49,67,-18,
8276,80,2022/4/15 16:20,54,104,-50,
8277,80,2022/4/15 16:30,62,81,-19,
8278,80,2022/4/15 16:40,98,84,14,
8279,80,2022/4/15 16:50,72,74,-2,
8280,80,2022/4/15 17:00,177,103,74,
8281,80,2022/4/15 17:10,271,109,162,
8282,80,2022/4/15 17:20,319,83,236,
8283,80,2022/4/15 17:30,317,112,205,
8284,80,2022/4/15 17:40,660,110,550,
8285,80,2022/4/15 17:50,432,108,324,
8286,80,2022/4/15 18:00,369,111,258,
8287,80,2022/4/15 18:10,723,143,580,
8288,80,2022/4/15 18:20,657,123,534,
8289,80,2022/4/15 18:30,326,152,174,
8290,80,2022/4/15 18:40,361,111,250,
8291,80,2022/4/15 18:50,275,107,168,
8292,80,2022/4/15 19:00,214,111,103,
8293,80,2022/4/15 19:10,225,123,102,
8294,80,2022/4/15 19:20,177,76,101,
8295,80,2022/4/15 19:30,129,106,23,
8296,80,2022/4/15 19:40,110,91,19,
8297,80,2022/4/15 19:50,77,56,21,
8298,80,2022/4/15 20:00,77,81,-4,
8299,80,2022/4/15 20:10,85,73,12,
8300,80,2022/4/15 20:20,70,59,11,
8301,80,2022/4/15 20:30,63,57,6,
8302,80,2022/4/15 20:40,63,67,-4,
8303,80,2022/4/15 20:50,55,71,-16,
8304,80,2022/4/15 21:00,56,52,4,
8305,80,2022/4/15 21:10,74,53,21,
8306,80,2022/4/15 21:20,75,64,11,
8307,80,2022/4/15 21:30,59,73,-14,
8308,80,2022/4/15 21:40,63,51,12,
8309,80,2022/4/15 21:50,48,51,-3,
8310,80,2022/4/15 22:00,42,58,-16,
8311,80,2022/4/15 22:10,40,66,-26,
8312,80,2022/4/15 22:20,12,42,-30,
8313,80,2022/4/15 22:30,2,36,-34,
8314,80,2022/4/15 22:40,0,31,-31,
8315,80,2022/4/15 22:50,0,3,-3,
8316,73,2022/4/15 5:00,0,1,-1,
8317,73,2022/4/15 5:10,0,1,-1,
8318,73,2022/4/15 5:20,0,1,-1,
8319,73,2022/4/15 5:30,0,1,-1,
8320,73,2022/4/15 5:40,0,1,-1,
8321,73,2022/4/15 5:50,3,1,2,
8322,73,2022/4/15 6:00,20,1,19,
8323,73,2022/4/15 6:10,22,8,14,
8324,73,2022/4/15 6:20,27,30,-3,
8325,73,2022/4/15 6:30,34,31,3,
8326,73,2022/4/15 6:40,47,45,2,
8327,73,2022/4/15 6:50,57,50,7,
8328,73,2022/4/15 7:00,66,46,20,
8329,73,2022/4/15 7:10,88,81,7,
8330,73,2022/4/15 7:20,105,89,16,
8331,73,2022/4/15 7:30,187,93,94,
8332,73,2022/4/15 7:40,217,107,110,
8333,73,2022/4/15 7:50,236,117,119,
8334,73,2022/4/15 8:00,256,190,66,
8335,73,2022/4/15 8:10,268,509,-241,
8336,73,2022/4/15 8:20,243,500,-257,
8337,73,2022/4/15 8:30,233,326,-93,
8338,73,2022/4/15 8:40,199,493,-294,
8339,73,2022/4/15 8:50,155,421,-266,
8340,73,2022/4/15 9:00,76,226,-150,
8341,73,2022/4/15 9:10,59,300,-241,
8342,73,2022/4/15 9:20,49,120,-71,
8343,73,2022/4/15 9:30,40,183,-143,
8344,73,2022/4/15 9:40,37,103,-66,
8345,73,2022/4/15 9:50,31,88,-57,
8346,73,2022/4/15 10:00,27,76,-49,
8347,73,2022/4/15 10:10,30,105,-75,
8348,73,2022/4/15 10:20,27,69,-42,
8349,73,2022/4/15 10:30,29,67,-38,
8350,73,2022/4/15 10:40,27,67,-40,
8351,73,2022/4/15 10:50,27,76,-49,
8352,73,2022/4/15 11:00,31,62,-31,
8353,73,2022/4/15 11:10,28,67,-39,
8354,73,2022/4/15 11:20,26,61,-35,
8355,73,2022/4/15 11:30,29,62,-33,
8356,73,2022/4/15 11:40,27,64,-37,
8357,73,2022/4/15 11:50,32,55,-23,
8358,73,2022/4/15 12:00,32,62,-30,
8359,73,2022/4/15 12:10,32,79,-47,
8360,73,2022/4/15 12:20,28,62,-34,
8361,73,2022/4/15 12:30,35,64,-29,
8362,73,2022/4/15 12:40,31,63,-32,
8363,73,2022/4/15 12:50,33,90,-57,
8364,73,2022/4/15 13:00,30,63,-33,
8365,73,2022/4/15 13:10,30,62,-32,
8366,73,2022/4/15 13:20,28,66,-38,
8367,73,2022/4/15 13:30,28,97,-69,
8368,73,2022/4/15 13:40,30,69,-39,
8369,73,2022/4/15 13:50,26,70,-44,
8370,73,2022/4/15 14:00,29,61,-32,
8371,73,2022/4/15 14:10,33,93,-60,
8372,73,2022/4/15 14:20,33,70,-37,
8373,73,2022/4/15 14:30,25,60,-35,
8374,73,2022/4/15 14:40,31,64,-33,
8375,73,2022/4/15 14:50,27,80,-53,
8376,73,2022/4/15 15:00,34,70,-36,
8377,73,2022/4/15 15:10,26,69,-43,
8378,73,2022/4/15 15:20,31,69,-38,
8379,73,2022/4/15 15:30,33,87,-54,
8380,73,2022/4/15 15:40,29,67,-38,
8381,73,2022/4/15 15:50,25,67,-42,
8382,73,2022/4/15 16:00,32,65,-33,
8383,73,2022/4/15 16:10,38,93,-55,
8384,73,2022/4/15 16:20,40,81,-41,
8385,73,2022/4/15 16:30,47,78,-31,
8386,73,2022/4/15 16:40,46,74,-28,
8387,73,2022/4/15 16:50,48,106,-58,
8388,73,2022/4/15 17:00,110,77,33,
8389,73,2022/4/15 17:10,227,103,124,
8390,73,2022/4/15 17:20,137,117,20,
8391,73,2022/4/15 17:30,228,112,116,
8392,73,2022/4/15 17:40,351,132,219,
8393,73,2022/4/15 17:50,305,151,154,
8394,73,2022/4/15 18:00,271,120,151,
8395,73,2022/4/15 18:10,352,191,161,
8396,73,2022/4/15 18:20,319,192,127,
8397,73,2022/4/15 18:30,205,114,91,
8398,73,2022/4/15 18:40,175,139,36,
8399,73,2022/4/15 18:50,132,143,-11,
8400,73,2022/4/15 19:00,77,108,-31,
8401,73,2022/4/15 19:10,58,115,-57,
8402,73,2022/4/15 19:20,52,127,-75,
8403,73,2022/4/15 19:30,46,104,-58,
8404,73,2022/4/15 19:40,40,110,-70,
8405,73,2022/4/15 19:50,35,97,-62,
8406,73,2022/4/15 20:00,32,70,-38,
8407,73,2022/4/15 20:10,34,93,-59,
8408,73,2022/4/15 20:20,35,66,-31,
8409,73,2022/4/15 20:30,31,71,-40,
8410,73,2022/4/15 20:40,28,109,-81,
8411,73,2022/4/15 20:50,29,74,-45,
8412,73,2022/4/15 21:00,26,72,-46,
8413,73,2022/4/15 21:10,31,68,-37,
8414,73,2022/4/15 21:20,33,95,-62,
8415,73,2022/4/15 21:30,29,76,-47,
8416,73,2022/4/15 21:40,28,70,-42,
8417,73,2022/4/15 21:50,26,83,-57,
8418,73,2022/4/15 22:00,20,89,-69,
8419,73,2022/4/15 22:10,17,65,-48,
8420,73,2022/4/15 22:20,9,55,-46,
8421,73,2022/4/15 22:30,3,62,-59,
8422,73,2022/4/15 22:40,0,46,-46,
8423,73,2022/4/15 22:50,0,3,-3,
8424,75,2022/4/15 5:00,0,1,-1,
8425,75,2022/4/15 5:10,0,1,-1,
8426,75,2022/4/15 5:20,0,1,-1,
8427,75,2022/4/15 5:30,0,1,-1,
8428,75,2022/4/15 5:40,0,1,-1,
8429,75,2022/4/15 5:50,3,1,2,
8430,75,2022/4/15 6:00,13,1,12,
8431,75,2022/4/15 6:10,18,19,-1,
8432,75,2022/4/15 6:20,23,25,-2,
8433,75,2022/4/15 6:30,32,37,-5,
8434,75,2022/4/15 6:40,32,50,-18,
8435,75,2022/4/15 6:50,41,52,-11,
8436,75,2022/4/15 7:00,36,51,-15,
8437,75,2022/4/15 7:10,57,73,-16,
8438,75,2022/4/15 7:20,56,88,-32,
8439,75,2022/4/15 7:30,68,99,-31,
8440,75,2022/4/15 7:40,87,124,-37,
8441,75,2022/4/15 7:50,155,88,67,
8442,75,2022/4/15 8:00,168,133,35,
8443,75,2022/4/15 8:10,198,197,1,
8444,75,2022/4/15 8:20,183,155,28,
8445,75,2022/4/15 8:30,181,214,-33,
8446,75,2022/4/15 8:40,148,268,-120,
8447,75,2022/4/15 8:50,122,155,-33,
8448,75,2022/4/15 9:00,69,139,-70,
8449,75,2022/4/15 9:10,64,125,-61,
8450,75,2022/4/15 9:20,49,110,-61,
8451,75,2022/4/15 9:30,46,105,-59,
8452,75,2022/4/15 9:40,38,125,-87,
8453,75,2022/4/15 9:50,38,123,-85,
8454,75,2022/4/15 10:00,29,103,-74,
8455,75,2022/4/15 10:10,32,110,-78,
8456,75,2022/4/15 10:20,31,108,-77,
8457,75,2022/4/15 10:30,27,114,-87,
8458,75,2022/4/15 10:40,29,103,-74,
8459,75,2022/4/15 10:50,29,99,-70,
8460,75,2022/4/15 11:00,34,110,-76,
8461,75,2022/4/15 11:10,28,105,-77,
8462,75,2022/4/15 11:20,29,99,-70,
8463,75,2022/4/15 11:30,31,101,-70,
8464,75,2022/4/15 11:40,39,108,-69,
8465,75,2022/4/15 11:50,45,110,-65,
8466,75,2022/4/15 12:00,45,112,-67,
8467,75,2022/4/15 12:10,52,99,-47,
8468,75,2022/4/15 12:20,44,105,-61,
8469,75,2022/4/15 12:30,47,108,-61,
8470,75,2022/4/15 12:40,40,104,-64,
8471,75,2022/4/15 12:50,49,103,-54,
8472,75,2022/4/15 13:00,56,113,-57,
8473,75,2022/4/15 13:10,59,105,-46,
8474,75,2022/4/15 13:20,47,104,-57,
8475,75,2022/4/15 13:30,55,104,-49,
8476,75,2022/4/15 13:40,51,107,-56,
8477,75,2022/4/15 13:50,47,105,-58,
8478,75,2022/4/15 14:00,56,110,-54,
8479,75,2022/4/15 14:10,55,106,-51,
8480,75,2022/4/15 14:20,59,102,-43,
8481,75,2022/4/15 14:30,59,110,-51,
8482,75,2022/4/15 14:40,57,112,-55,
8483,75,2022/4/15 14:50,64,97,-33,
8484,75,2022/4/15 15:00,55,104,-49,
8485,75,2022/4/15 15:10,67,108,-41,
8486,75,2022/4/15 15:20,72,112,-40,
8487,75,2022/4/15 15:30,64,104,-40,
8488,75,2022/4/15 15:40,76,110,-34,
8489,75,2022/4/15 15:50,76,103,-27,
8490,75,2022/4/15 16:00,73,108,-35,
8491,75,2022/4/15 16:10,71,101,-30,
8492,75,2022/4/15 16:20,70,99,-29,
8493,75,2022/4/15 16:30,168,95,73,
8494,75,2022/4/15 16:40,128,121,7,
8495,75,2022/4/15 16:50,175,116,59,
8496,75,2022/4/15 17:00,234,110,124,
8497,75,2022/4/15 17:10,272,143,129,
8498,75,2022/4/15 17:20,205,149,56,
8499,75,2022/4/15 17:30,213,221,-8,
8500,75,2022/4/15 17:40,235,232,3,
8501,75,2022/4/15 17:50,255,268,-13,
8502,75,2022/4/15 18:00,202,336,-134,
8503,75,2022/4/15 18:10,268,320,-52,
8504,75,2022/4/15 18:20,205,321,-116,
8505,75,2022/4/15 18:30,211,387,-176,
8506,75,2022/4/15 18:40,165,336,-171,
8507,75,2022/4/15 18:50,142,285,-143,
8508,75,2022/4/15 19:00,127,197,-70,
8509,75,2022/4/15 19:10,110,158,-48,
8510,75,2022/4/15 19:20,96,128,-32,
8511,75,2022/4/15 19:30,83,111,-28,
8512,75,2022/4/15 19:40,101,115,-14,
8513,75,2022/4/15 19:50,133,116,17,
8514,75,2022/4/15 20:00,170,106,64,
8515,75,2022/4/15 20:10,167,107,60,
8516,75,2022/4/15 20:20,196,112,84,
8517,75,2022/4/15 20:30,273,99,174,
8518,75,2022/4/15 20:40,268,89,179,
8519,75,2022/4/15 20:50,208,94,114,
8520,75,2022/4/15 21:00,204,93,111,
8521,75,2022/4/15 21:10,149,94,55,
8522,75,2022/4/15 21:20,157,76,81,
8523,75,2022/4/15 21:30,159,78,81,
8524,75,2022/4/15 21:40,114,78,36,
8525,75,2022/4/15 21:50,124,75,49,
8526,75,2022/4/15 22:00,271,76,195,
8527,75,2022/4/15 22:10,90,62,28,
8528,75,2022/4/15 22:20,24,69,-45,
8529,75,2022/4/15 22:30,10,67,-57,
8530,75,2022/4/15 22:40,1,21,-20,
8531,75,2022/4/15 22:50,0,3,-3,
8532,79,2022/4/15 5:00,0,1,-1,
8533,79,2022/4/15 5:10,0,1,-1,
8534,79,2022/4/15 5:20,0,1,-1,
8535,79,2022/4/15 5:30,0,1,-1,
8536,79,2022/4/15 5:40,0,1,-1,
8537,79,2022/4/15 5:50,3,1,2,
8538,79,2022/4/15 6:00,7,1,6,
8539,79,2022/4/15 6:10,13,2,11,
8540,79,2022/4/15 6:20,15,23,-8,
8541,79,2022/4/15 6:30,20,23,-3,
8542,79,2022/4/15 6:40,21,33,-12,
8543,79,2022/4/15 6:50,29,46,-17,
8544,79,2022/4/15 7:00,31,60,-29,
8545,79,2022/4/15 7:10,39,64,-25,
8546,79,2022/4/15 7:20,36,80,-44,
8547,79,2022/4/15 7:30,38,81,-43,
8548,79,2022/4/15 7:40,57,97,-40,
8549,79,2022/4/15 7:50,58,98,-40,
8550,79,2022/4/15 8:00,58,121,-63,
8551,79,2022/4/15 8:10,69,178,-109,
8552,79,2022/4/15 8:20,67,217,-150,
8553,79,2022/4/15 8:30,63,206,-143,
8554,79,2022/4/15 8:40,52,321,-269,
8555,79,2022/4/15 8:50,40,382,-342,
8556,79,2022/4/15 9:00,38,185,-147,
8557,79,2022/4/15 9:10,35,119,-84,
8558,79,2022/4/15 9:20,30,121,-91,
8559,79,2022/4/15 9:30,30,183,-153,
8560,79,2022/4/15 9:40,28,120,-92,
8561,79,2022/4/15 9:50,25,98,-73,
8562,79,2022/4/15 10:00,27,97,-70,
8563,79,2022/4/15 10:10,29,106,-77,
8564,79,2022/4/15 10:20,28,76,-48,
8565,79,2022/4/15 10:30,29,61,-32,
8566,79,2022/4/15 10:40,23,72,-49,
8567,79,2022/4/15 10:50,29,83,-54,
8568,79,2022/4/15 11:00,26,61,-35,
8569,79,2022/4/15 11:10,28,50,-22,
8570,79,2022/4/15 11:20,26,62,-36,
8571,79,2022/4/15 11:30,27,84,-57,
8572,79,2022/4/15 11:40,29,54,-25,
8573,79,2022/4/15 11:50,28,50,-22,
8574,79,2022/4/15 12:00,27,64,-37,
8575,79,2022/4/15 12:10,29,82,-53,
8576,79,2022/4/15 12:20,25,57,-32,
8577,79,2022/4/15 12:30,25,62,-37,
8578,79,2022/4/15 12:40,28,62,-34,
8579,79,2022/4/15 12:50,29,75,-46,
8580,79,2022/4/15 13:00,26,63,-37,
8581,79,2022/4/15 13:10,28,59,-31,
8582,79,2022/4/15 13:20,28,71,-43,
8583,79,2022/4/15 13:30,29,79,-50,
8584,79,2022/4/15 13:40,27,70,-43,
8585,79,2022/4/15 13:50,28,61,-33,
8586,79,2022/4/15 14:00,29,62,-33,
8587,79,2022/4/15 14:10,26,81,-55,
8588,79,2022/4/15 14:20,25,60,-35,
8589,79,2022/4/15 14:30,28,63,-35,
8590,79,2022/4/15 14:40,25,64,-39,
8591,79,2022/4/15 14:50,27,76,-49,
8592,79,2022/4/15 15:00,30,62,-32,
8593,79,2022/4/15 15:10,26,60,-34,
8594,79,2022/4/15 15:20,28,63,-35,
8595,79,2022/4/15 15:30,32,77,-45,
8596,79,2022/4/15 15:40,35,70,-35,
8597,79,2022/4/15 15:50,29,70,-41,
8598,79,2022/4/15 16:00,34,66,-32,
8599,79,2022/4/15 16:10,37,80,-43,
8600,79,2022/4/15 16:20,37,65,-28,
8601,79,2022/4/15 16:30,43,72,-29,
8602,79,2022/4/15 16:40,46,73,-27,
8603,79,2022/4/15 16:50,46,93,-47,
8604,79,2022/4/15 17:00,148,69,79,
8605,79,2022/4/15 17:10,167,77,90,
8606,79,2022/4/15 17:20,98,99,-1,
8607,79,2022/4/15 17:30,206,99,107,
8608,79,2022/4/15 17:40,233,112,121,
8609,79,2022/4/15 17:50,139,120,19,
8610,79,2022/4/15 18:00,225,107,118,
8611,79,2022/4/15 18:10,308,101,207,
8612,79,2022/4/15 18:20,216,110,106,
8613,79,2022/4/15 18:30,154,95,59,
8614,79,2022/4/15 18:40,129,107,22,
8615,79,2022/4/15 18:50,65,107,-42,
8616,79,2022/4/15 19:00,59,78,-19,
8617,79,2022/4/15 19:10,54,77,-23,
8618,79,2022/4/15 19:20,44,95,-51,
8619,79,2022/4/15 19:30,37,67,-30,
8620,79,2022/4/15 19:40,35,70,-35,
8621,79,2022/4/15 19:50,28,66,-38,
8622,79,2022/4/15 20:00,31,50,-19,
8623,79,2022/4/15 20:10,34,70,-36,
8624,79,2022/4/15 20:20,27,50,-23,
8625,79,2022/4/15 20:30,29,48,-19,
8626,79,2022/4/15 20:40,29,62,-33,
8627,79,2022/4/15 20:50,29,67,-38,
8628,79,2022/4/15 21:00,27,47,-20,
8629,79,2022/4/15 21:10,28,40,-12,
8630,79,2022/4/15 21:20,28,60,-32,
8631,79,2022/4/15 21:30,26,61,-35,
8632,79,2022/4/15 21:40,26,50,-24,
8633,79,2022/4/15 21:50,25,51,-26,
8634,79,2022/4/15 22:00,26,56,-30,
8635,79,2022/4/15 22:10,24,53,-29,
8636,79,2022/4/15 22:20,13,40,-27,
8637,79,2022/4/15 22:30,2,32,-30,
8638,79,2022/4/15 22:40,0,3,-3,
8639,79,2022/4/15 22:50,0,3,-3,
8640,88,2022/4/15 5:00,0,1,-1,-1
8641,88,2022/4/15 5:10,0,1,-1,-1
8642,88,2022/4/15 5:20,0,1,-1,-1
8643,88,2022/4/15 5:30,2,1,1,1
8644,88,2022/4/15 5:40,4,1,3,3
8645,88,2022/4/15 5:50,7,1,6,6
8646,88,2022/4/15 6:00,4,1,3,3
8647,88,2022/4/15 6:10,14,1,13,13
8648,88,2022/4/15 6:20,13,5,8,8
8649,88,2022/4/15 6:30,12,5,7,7
8650,88,2022/4/15 6:40,12,23,-11,-11
8651,88,2022/4/15 6:50,17,38,-21,-21
8652,88,2022/4/15 7:00,14,54,-40,-40
8653,88,2022/4/15 7:10,16,61,-45,-45
8654,88,2022/4/15 7:20,15,57,-42,-42
8655,88,2022/4/15 7:30,17,46,-29,-29
8656,88,2022/4/15 7:40,18,47,-29,-29
8657,88,2022/4/15 7:50,19,50,-31,-31
8658,88,2022/4/15 8:00,16,50,-34,-34
8659,88,2022/4/15 8:10,16,68,-52,-52
8660,88,2022/4/15 8:20,19,54,-35,-35
8661,88,2022/4/15 8:30,18,51,-33,-33
8662,88,2022/4/15 8:40,16,41,-25,-25
8663,88,2022/4/15 8:50,14,33,-19,-19
8664,88,2022/4/15 9:00,11,23,-12,-12
8665,88,2022/4/15 9:10,13,23,-10,-10
8666,88,2022/4/15 9:20,15,31,-16,-16
8667,88,2022/4/15 9:30,11,32,-21,-21
8668,88,2022/4/15 9:40,13,24,-11,-11
8669,88,2022/4/15 9:50,11,23,-12,-12
8670,88,2022/4/15 10:00,10,16,-6,-6
8671,88,2022/4/15 10:10,7,19,-12,-12
8672,88,2022/4/15 10:20,9,23,-14,-14
8673,88,2022/4/15 10:30,10,16,-6,-6
8674,88,2022/4/15 10:40,10,12,-2,-2
8675,88,2022/4/15 10:50,8,21,-13,-13
8676,88,2022/4/15 11:00,10,19,-9,-9
8677,88,2022/4/15 11:10,8,18,-10,-10
8678,88,2022/4/15 11:20,11,23,-12,-12
8679,88,2022/4/15 11:30,10,19,-9,-9
8680,88,2022/4/15 11:40,8,21,-13,-13
8681,88,2022/4/15 11:50,12,25,-13,-13
8682,88,2022/4/15 12:00,12,21,-9,-9
8683,88,2022/4/15 12:10,10,19,-9,-9
8684,88,2022/4/15 12:20,13,25,-12,-12
8685,88,2022/4/15 12:30,10,19,-9,-9
8686,88,2022/4/15 12:40,10,19,-9,-9
8687,88,2022/4/15 12:50,10,23,-13,-13
8688,88,2022/4/15 13:00,12,23,-11,-11
8689,88,2022/4/15 13:10,8,22,-14,-14
8690,88,2022/4/15 13:20,10,22,-12,-12
8691,88,2022/4/15 13:30,11,19,-8,-8
8692,88,2022/4/15 13:40,11,19,-8,-8
8693,88,2022/4/15 13:50,8,21,-13,-13
8694,88,2022/4/15 14:00,11,19,-8,-8
8695,88,2022/4/15 14:10,10,23,-13,-13
8696,88,2022/4/15 14:20,10,23,-13,-13
8697,88,2022/4/15 14:30,11,21,-10,-10
8698,88,2022/4/15 14:40,10,14,-4,-4
8699,88,2022/4/15 14:50,12,21,-9,-9
8700,88,2022/4/15 15:00,13,29,-16,-16
8701,88,2022/4/15 15:10,13,23,-10,-10
8702,88,2022/4/15 15:20,12,19,-7,-7
8703,88,2022/4/15 15:30,15,21,-6,-6
8704,88,2022/4/15 15:40,16,22,-6,-6
8705,88,2022/4/15 15:50,12,23,-11,-11
8706,88,2022/4/15 16:00,14,23,-9,-9
8707,88,2022/4/15 16:10,16,22,-6,-6
8708,88,2022/4/15 16:20,18,23,-5,-5
8709,88,2022/4/15 16:30,13,23,-10,-10
8710,88,2022/4/15 16:40,19,21,-2,-2
8711,88,2022/4/15 16:50,19,23,-4,-4
8712,88,2022/4/15 17:00,17,39,-22,-22
8713,88,2022/4/15 17:10,19,23,-4,-4
8714,88,2022/4/15 17:20,22,25,-3,-3
8715,88,2022/4/15 17:30,20,38,-18,-18
8716,88,2022/4/15 17:40,24,30,-6,-6
8717,88,2022/4/15 17:50,27,38,-11,-11
8718,88,2022/4/15 18:00,22,25,-3,-3
8719,88,2022/4/15 18:10,20,32,-12,-12
8720,88,2022/4/15 18:20,22,23,-1,-1
8721,88,2022/4/15 18:30,25,21,4,4
8722,88,2022/4/15 18:40,21,23,-2,-2
8723,88,2022/4/15 18:50,17,23,-6,-6
8724,88,2022/4/15 19:00,16,23,-7,-7
8725,88,2022/4/15 19:10,12,13,-1,-1
8726,88,2022/4/15 19:20,11,21,-10,-10
8727,88,2022/4/15 19:30,14,18,-4,-4
8728,88,2022/4/15 19:40,12,13,-1,-1
8729,88,2022/4/15 19:50,10,18,-8,-8
8730,88,2022/4/15 20:00,9,10,-1,-1
8731,88,2022/4/15 20:10,8,13,-5,-5
8732,88,2022/4/15 20:20,8,15,-7,-7
8733,88,2022/4/15 20:30,9,10,-1,-1
8734,88,2022/4/15 20:40,7,8,-1,-1
8735,88,2022/4/15 20:50,7,10,-3,-3
8736,88,2022/4/15 21:00,7,8,-1,-1
8737,88,2022/4/15 21:10,8,7,1,1
8738,88,2022/4/15 21:20,12,4,8,8
8739,88,2022/4/15 21:30,6,8,-2,-2
8740,88,2022/4/15 21:40,8,7,1,1
8741,88,2022/4/15 21:50,6,13,-7,-7
8742,88,2022/4/15 22:00,1,8,-7,-7
8743,88,2022/4/15 22:10,0,3,-3,-3
8744,88,2022/4/15 22:20,0,8,-8,-8
8745,88,2022/4/15 22:30,0,3,-3,-3
8746,88,2022/4/15 22:40,0,3,-3,-3
8747,88,2022/4/15 22:50,0,4,-4,-4
8748,84,2022/4/15 5:00,0,1,-1,
8749,84,2022/4/15 5:10,0,1,-1,
8750,84,2022/4/15 5:20,0,1,-1,
8751,84,2022/4/15 5:30,0,1,-1,
8752,84,2022/4/15 5:40,1,1,0,
8753,84,2022/4/15 5:50,0,2,-2,
8754,84,2022/4/15 6:00,1,1,0,
8755,84,2022/4/15 6:10,3,1,2,
8756,84,2022/4/15 6:20,1,1,0,
8757,84,2022/4/15 6:30,4,1,3,
8758,84,2022/4/15 6:40,5,12,-7,
8759,84,2022/4/15 6:50,1,8,-7,
8760,84,2022/4/15 7:00,4,21,-17,
8761,84,2022/4/15 7:10,3,16,-13,
8762,84,2022/4/15 7:20,6,19,-13,
8763,84,2022/4/15 7:30,8,21,-13,
8764,84,2022/4/15 7:40,14,19,-5,
8765,84,2022/4/15 7:50,8,23,-15,
8766,84,2022/4/15 8:00,7,25,-18,
8767,84,2022/4/15 8:10,6,31,-25,
8768,84,2022/4/15 8:20,8,39,-31,
8769,84,2022/4/15 8:30,6,38,-32,
8770,84,2022/4/15 8:40,3,23,-20,
8771,84,2022/4/15 8:50,3,31,-28,
8772,84,2022/4/15 9:00,2,17,-15,
8773,84,2022/4/15 9:10,1,21,-20,
8774,84,2022/4/15 9:20,1,13,-12,
8775,84,2022/4/15 9:30,1,14,-13,
8776,84,2022/4/15 9:40,1,8,-7,
8777,84,2022/4/15 9:50,2,8,-6,
8778,84,2022/4/15 10:00,1,5,-4,
8779,84,2022/4/15 10:10,1,7,-6,
8780,84,2022/4/15 10:20,1,5,-4,
8781,84,2022/4/15 10:30,1,2,-1,
8782,84,2022/4/15 10:40,2,2,0,
8783,84,2022/4/15 10:50,1,1,0,
8784,84,2022/4/15 11:00,1,5,-4,
8785,84,2022/4/15 11:10,1,5,-4,
8786,84,2022/4/15 11:20,2,5,-3,
8787,84,2022/4/15 11:30,1,5,-4,
8788,84,2022/4/15 11:40,2,2,0,
8789,84,2022/4/15 11:50,2,1,1,
8790,84,2022/4/15 12:00,3,5,-2,
8791,84,2022/4/15 12:10,2,1,1,
8792,84,2022/4/15 12:20,2,5,-3,
8793,84,2022/4/15 12:30,1,5,-4,
8794,84,2022/4/15 12:40,2,8,-6,
8795,84,2022/4/15 12:50,2,5,-3,
8796,84,2022/4/15 13:00,1,5,-4,
8797,84,2022/4/15 13:10,1,5,-4,
8798,84,2022/4/15 13:20,2,2,0,
8799,84,2022/4/15 13:30,1,7,-6,
8800,84,2022/4/15 13:40,1,1,0,
8801,84,2022/4/15 13:50,3,5,-2,
8802,84,2022/4/15 14:00,2,5,-3,
8803,84,2022/4/15 14:10,2,2,0,
8804,84,2022/4/15 14:20,2,7,-5,
8805,84,2022/4/15 14:30,2,5,-3,
8806,84,2022/4/15 14:40,2,5,-3,
8807,84,2022/4/15 14:50,2,5,-3,
8808,84,2022/4/15 15:00,2,7,-5,
8809,84,2022/4/15 15:10,2,5,-3,
8810,84,2022/4/15 15:20,1,2,-1,
8811,84,2022/4/15 15:30,2,5,-3,
8812,84,2022/4/15 15:40,3,7,-4,
8813,84,2022/4/15 15:50,3,5,-2,
8814,84,2022/4/15 16:00,3,5,-2,
8815,84,2022/4/15 16:10,4,2,2,
8816,84,2022/4/15 16:20,7,5,2,
8817,84,2022/4/15 16:30,6,5,1,
8818,84,2022/4/15 16:40,12,5,7,
8819,84,2022/4/15 16:50,11,7,4,
8820,84,2022/4/15 17:00,11,5,6,
8821,84,2022/4/15 17:10,11,11,0,
8822,84,2022/4/15 17:20,11,21,-10,
8823,84,2022/4/15 17:30,11,15,-4,
8824,84,2022/4/15 17:40,10,12,-2,
8825,84,2022/4/15 17:50,10,8,2,
8826,84,2022/4/15 18:00,8,10,-2,
8827,84,2022/4/15 18:10,11,13,-2,
8828,84,2022/4/15 18:20,11,10,1,
8829,84,2022/4/15 18:30,9,15,-6,
8830,84,2022/4/15 18:40,7,8,-1,
8831,84,2022/4/15 18:50,4,13,-9,
8832,84,2022/4/15 19:00,3,15,-12,
8833,84,2022/4/15 19:10,4,13,-9,
8834,84,2022/4/15 19:20,2,15,-13,
8835,84,2022/4/15 19:30,2,8,-6,
8836,84,2022/4/15 19:40,2,15,-13,
8837,84,2022/4/15 19:50,1,8,-7,
8838,84,2022/4/15 20:00,1,3,-2,
8839,84,2022/4/15 20:10,2,7,-5,
8840,84,2022/4/15 20:20,2,8,-6,
8841,84,2022/4/15 20:30,1,7,-6,
8842,84,2022/4/15 20:40,2,8,-6,
8843,84,2022/4/15 20:50,2,4,-2,
8844,84,2022/4/15 21:00,1,7,-6,
8845,84,2022/4/15 21:10,1,10,-9,
8846,84,2022/4/15 21:20,2,7,-5,
8847,84,2022/4/15 21:30,1,3,-2,
8848,84,2022/4/15 21:40,1,8,-7,
8849,84,2022/4/15 21:50,1,8,-7,
8850,84,2022/4/15 22:00,0,8,-8,
8851,84,2022/4/15 22:10,0,3,-3,
8852,84,2022/4/15 22:20,0,3,-3,
8853,84,2022/4/15 22:30,0,3,-3,
8854,84,2022/4/15 22:40,0,3,-3,
8855,84,2022/4/15 22:50,0,3,-3,
8856,92,2022/4/15 5:00,0,1,-1,
8857,92,2022/4/15 5:10,0,1,-1,
8858,92,2022/4/15 5:20,0,1,-1,
8859,92,2022/4/15 5:30,0,1,-1,
8860,92,2022/4/15 5:40,2,1,1,
8861,92,2022/4/15 5:50,13,1,12,
8862,92,2022/4/15 6:00,19,1,18,
8863,92,2022/4/15 6:10,35,2,33,
8864,92,2022/4/15 6:20,60,2,58,
8865,92,2022/4/15 6:30,60,23,37,
8866,92,2022/4/15 6:40,61,32,29,
8867,92,2022/4/15 6:50,150,42,108,
8868,92,2022/4/15 7:00,107,63,44,
8869,92,2022/4/15 7:10,142,68,74,
8870,92,2022/4/15 7:20,225,72,153,
8871,92,2022/4/15 7:30,244,98,146,
8872,92,2022/4/15 7:40,286,106,180,
8873,92,2022/4/15 7:50,283,106,177,
8874,92,2022/4/15 8:00,263,104,159,
8875,92,2022/4/15 8:10,250,96,154,
8876,92,2022/4/15 8:20,182,104,78,
8877,92,2022/4/15 8:30,156,96,60,
8878,92,2022/4/15 8:40,142,107,35,
8879,92,2022/4/15 8:50,73,86,-13,
8880,92,2022/4/15 9:00,68,81,-13,
8881,92,2022/4/15 9:10,49,68,-19,
8882,92,2022/4/15 9:20,38,77,-39,
8883,92,2022/4/15 9:30,28,81,-53,
8884,92,2022/4/15 9:40,37,66,-29,
8885,92,2022/4/15 9:50,23,62,-39,
8886,92,2022/4/15 10:00,26,47,-21,
8887,92,2022/4/15 10:10,29,69,-40,
8888,92,2022/4/15 10:20,28,63,-35,
8889,92,2022/4/15 10:30,28,62,-34,
8890,92,2022/4/15 10:40,27,38,-11,
8891,92,2022/4/15 10:50,32,63,-31,
8892,92,2022/4/15 11:00,24,59,-35,
8893,92,2022/4/15 11:10,20,65,-45,
8894,92,2022/4/15 11:20,25,63,-38,
8895,92,2022/4/15 11:30,20,49,-29,
8896,92,2022/4/15 11:40,28,66,-38,
8897,92,2022/4/15 11:50,32,47,-15,
8898,92,2022/4/15 12:00,21,65,-44,
8899,92,2022/4/15 12:10,25,68,-43,
8900,92,2022/4/15 12:20,31,70,-39,
8901,92,2022/4/15 12:30,21,62,-41,
8902,92,2022/4/15 12:40,24,57,-33,
8903,92,2022/4/15 12:50,25,72,-47,
8904,92,2022/4/15 13:00,25,64,-39,
8905,92,2022/4/15 13:10,26,71,-45,
8906,92,2022/4/15 13:20,25,68,-43,
8907,92,2022/4/15 13:30,22,62,-40,
8908,92,2022/4/15 13:40,23,83,-60,
8909,92,2022/4/15 13:50,24,54,-30,
8910,92,2022/4/15 14:00,26,60,-34,
8911,92,2022/4/15 14:10,24,66,-42,
8912,92,2022/4/15 14:20,25,69,-44,
8913,92,2022/4/15 14:30,28,72,-44,
8914,92,2022/4/15 14:40,22,59,-37,
8915,92,2022/4/15 14:50,21,71,-50,
8916,92,2022/4/15 15:00,22,84,-62,
8917,92,2022/4/15 15:10,23,82,-59,
8918,92,2022/4/15 15:20,22,73,-51,
8919,92,2022/4/15 15:30,23,62,-39,
8920,92,2022/4/15 15:40,26,104,-78,
8921,92,2022/4/15 15:50,22,76,-54,
8922,92,2022/4/15 16:00,27,76,-49,
8923,92,2022/4/15 16:10,27,103,-76,
8924,92,2022/4/15 16:20,31,97,-66,
8925,92,2022/4/15 16:30,40,71,-31,
8926,92,2022/4/15 16:40,62,122,-60,
8927,92,2022/4/15 16:50,35,85,-50,
8928,92,2022/4/15 17:00,45,126,-81,
8929,92,2022/4/15 17:10,70,97,-27,
8930,92,2022/4/15 17:20,56,118,-62,
8931,92,2022/4/15 17:30,38,118,-80,
8932,92,2022/4/15 17:40,39,106,-67,
8933,92,2022/4/15 17:50,43,151,-108,
8934,92,2022/4/15 18:00,27,109,-82,
8935,92,2022/4/15 18:10,26,197,-171,
8936,92,2022/4/15 18:20,25,128,-103,
8937,92,2022/4/15 18:30,27,120,-93,
8938,92,2022/4/15 18:40,26,184,-158,
8939,92,2022/4/15 18:50,21,128,-107,
8940,92,2022/4/15 19:00,16,198,-182,
8941,92,2022/4/15 19:10,19,123,-104,
8942,92,2022/4/15 19:20,16,178,-162,
8943,92,2022/4/15 19:30,15,115,-100,
8944,92,2022/4/15 19:40,14,124,-110,
8945,92,2022/4/15 19:50,14,113,-99,
8946,92,2022/4/15 20:00,14,98,-84,
8947,92,2022/4/15 20:10,12,77,-65,
8948,92,2022/4/15 20:20,12,107,-95,
8949,92,2022/4/15 20:30,12,73,-61,
8950,92,2022/4/15 20:40,10,80,-70,
8951,92,2022/4/15 20:50,13,77,-64,
8952,92,2022/4/15 21:00,8,76,-68,
8953,92,2022/4/15 21:10,10,92,-82,
8954,92,2022/4/15 21:20,7,92,-85,
8955,92,2022/4/15 21:30,8,93,-85,
8956,92,2022/4/15 21:40,5,18,-13,
8957,92,2022/4/15 21:50,2,84,-82,
8958,92,2022/4/15 22:00,2,101,-99,
8959,92,2022/4/15 22:10,1,95,-94,
8960,92,2022/4/15 22:20,0,8,-8,
8961,92,2022/4/15 22:30,0,3,-3,
8962,92,2022/4/15 22:40,0,4,-4,
8963,92,2022/4/15 22:50,0,3,-3,
8964,83,2022/4/15 5:00,0,1,-1,
8965,83,2022/4/15 5:10,0,1,-1,
8966,83,2022/4/15 5:20,0,1,-1,
8967,83,2022/4/15 5:30,0,1,-1,
8968,83,2022/4/15 5:40,0,1,-1,
8969,83,2022/4/15 5:50,12,1,11,
8970,83,2022/4/15 6:00,36,1,35,
8971,83,2022/4/15 6:10,77,2,75,
8972,83,2022/4/15 6:20,70,11,59,
8973,83,2022/4/15 6:30,91,6,85,
8974,83,2022/4/15 6:40,155,25,130,
8975,83,2022/4/15 6:50,190,21,169,
8976,83,2022/4/15 7:00,218,25,193,
8977,83,2022/4/15 7:10,229,32,197,
8978,83,2022/4/15 7:20,284,41,243,
8979,83,2022/4/15 7:30,277,32,245,
8980,83,2022/4/15 7:40,279,39,240,
8981,83,2022/4/15 7:50,284,38,246,
8982,83,2022/4/15 8:00,280,40,240,
8983,83,2022/4/15 8:10,252,42,210,
8984,83,2022/4/15 8:20,193,38,155,
8985,83,2022/4/15 8:30,185,41,144,
8986,83,2022/4/15 8:40,149,40,109,
8987,83,2022/4/15 8:50,86,49,37,
8988,83,2022/4/15 9:00,61,37,24,
8989,83,2022/4/15 9:10,53,47,6,
8990,83,2022/4/15 9:20,44,38,6,
8991,83,2022/4/15 9:30,36,45,-9,
8992,83,2022/4/15 9:40,25,50,-25,
8993,83,2022/4/15 9:50,29,57,-28,
8994,83,2022/4/15 10:00,30,40,-10,
8995,83,2022/4/15 10:10,27,44,-17,
8996,83,2022/4/15 10:20,26,47,-21,
8997,83,2022/4/15 10:30,28,65,-37,
8998,83,2022/4/15 10:40,27,42,-15,
8999,83,2022/4/15 10:50,21,47,-26,
9000,83,2022/4/15 11:00,28,38,-10,
9001,83,2022/4/15 11:10,19,49,-30,
9002,83,2022/4/15 11:20,25,49,-24,
9003,83,2022/4/15 11:30,21,32,-11,
9004,83,2022/4/15 11:40,33,41,-8,
9005,83,2022/4/15 11:50,25,51,-26,
9006,83,2022/4/15 12:00,28,47,-19,
9007,83,2022/4/15 12:10,23,45,-22,
9008,83,2022/4/15 12:20,33,37,-4,
9009,83,2022/4/15 12:30,22,60,-38,
9010,83,2022/4/15 12:40,27,43,-16,
9011,83,2022/4/15 12:50,22,50,-28,
9012,83,2022/4/15 13:00,24,47,-23,
9013,83,2022/4/15 13:10,21,53,-32,
9014,83,2022/4/15 13:20,28,66,-38,
9015,83,2022/4/15 13:30,19,46,-27,
9016,83,2022/4/15 13:40,24,52,-28,
9017,83,2022/4/15 13:50,20,61,-41,
9018,83,2022/4/15 14:00,23,52,-29,
9019,83,2022/4/15 14:10,17,60,-43,
9020,83,2022/4/15 14:20,23,46,-23,
9021,83,2022/4/15 14:30,17,71,-54,
9022,83,2022/4/15 14:40,16,59,-43,
9023,83,2022/4/15 14:50,19,56,-37,
9024,83,2022/4/15 15:00,19,63,-44,
9025,83,2022/4/15 15:10,16,64,-48,
9026,83,2022/4/15 15:20,17,83,-66,
9027,83,2022/4/15 15:30,20,53,-33,
9028,83,2022/4/15 15:40,15,69,-54,
9029,83,2022/4/15 15:50,15,72,-57,
9030,83,2022/4/15 16:00,18,90,-72,
9031,83,2022/4/15 16:10,17,75,-58,
9032,83,2022/4/15 16:20,18,71,-53,
9033,83,2022/4/15 16:30,20,102,-82,
9034,83,2022/4/15 16:40,18,76,-58,
9035,83,2022/4/15 16:50,22,87,-65,
9036,83,2022/4/15 17:00,17,83,-66,
9037,83,2022/4/15 17:10,20,122,-102,
9038,83,2022/4/15 17:20,13,89,-76,
9039,83,2022/4/15 17:30,17,108,-91,
9040,83,2022/4/15 17:40,18,103,-85,
9041,83,2022/4/15 17:50,19,108,-89,
9042,83,2022/4/15 18:00,15,144,-129,
9043,83,2022/4/15 18:10,15,110,-95,
9044,83,2022/4/15 18:20,15,139,-124,
9045,83,2022/4/15 18:30,14,180,-166,
9046,83,2022/4/15 18:40,15,127,-112,
9047,83,2022/4/15 18:50,16,235,-219,
9048,83,2022/4/15 19:00,14,110,-96,
9049,83,2022/4/15 19:10,12,222,-210,
9050,83,2022/4/15 19:20,11,192,-181,
9051,83,2022/4/15 19:30,13,180,-167,
9052,83,2022/4/15 19:40,11,104,-93,
9053,83,2022/4/15 19:50,11,95,-84,
9054,83,2022/4/15 20:00,11,119,-108,
9055,83,2022/4/15 20:10,13,92,-79,
9056,83,2022/4/15 20:20,7,95,-88,
9057,83,2022/4/15 20:30,11,101,-90,
9058,83,2022/4/15 20:40,8,126,-118,
9059,83,2022/4/15 20:50,8,85,-77,
9060,83,2022/4/15 21:00,7,95,-88,
9061,83,2022/4/15 21:10,7,104,-97,
9062,83,2022/4/15 21:20,6,69,-63,
9063,83,2022/4/15 21:30,4,62,-58,
9064,83,2022/4/15 21:40,5,104,-99,
9065,83,2022/4/15 21:50,1,101,-100,
9066,83,2022/4/15 22:00,1,91,-90,
9067,83,2022/4/15 22:10,1,69,-68,
9068,83,2022/4/15 22:20,1,102,-101,
9069,83,2022/4/15 22:30,0,7,-7,
9070,83,2022/4/15 22:40,0,3,-3,
9071,83,2022/4/15 22:50,0,3,-3,
9072,82,2022/4/15 5:00,0,1,-1,
9073,82,2022/4/15 5:10,0,1,-1,
9074,82,2022/4/15 5:20,0,1,-1,
9075,82,2022/4/15 5:30,0,1,-1,
9076,82,2022/4/15 5:40,0,1,-1,
9077,82,2022/4/15 5:50,2,1,1,
9078,82,2022/4/15 6:00,27,1,26,
9079,82,2022/4/15 6:10,21,1,20,
9080,82,2022/4/15 6:20,30,1,29,
9081,82,2022/4/15 6:30,21,2,19,
9082,82,2022/4/15 6:40,33,5,28,
9083,82,2022/4/15 6:50,28,6,22,
9084,82,2022/4/15 7:00,40,8,32,
9085,82,2022/4/15 7:10,32,21,11,
9086,82,2022/4/15 7:20,77,23,54,
9087,82,2022/4/15 7:30,58,25,33,
9088,82,2022/4/15 7:40,82,23,59,
9089,82,2022/4/15 7:50,62,23,39,
9090,82,2022/4/15 8:00,52,21,31,
9091,82,2022/4/15 8:10,36,21,15,
9092,82,2022/4/15 8:20,36,21,15,
9093,82,2022/4/15 8:30,35,21,14,
9094,82,2022/4/15 8:40,18,21,-3,
9095,82,2022/4/15 8:50,29,19,10,
9096,82,2022/4/15 9:00,12,14,-2,
9097,82,2022/4/15 9:10,13,19,-6,
9098,82,2022/4/15 9:20,16,21,-5,
9099,82,2022/4/15 9:30,5,18,-13,
9100,82,2022/4/15 9:40,14,21,-7,
9101,82,2022/4/15 9:50,10,19,-9,
9102,82,2022/4/15 10:00,4,23,-19,
9103,82,2022/4/15 10:10,12,21,-9,
9104,82,2022/4/15 10:20,5,19,-14,
9105,82,2022/4/15 10:30,8,21,-13,
9106,82,2022/4/15 10:40,9,19,-10,
9107,82,2022/4/15 10:50,4,23,-19,
9108,82,2022/4/15 11:00,8,21,-13,
9109,82,2022/4/15 11:10,4,16,-12,
9110,82,2022/4/15 11:20,11,15,-4,
9111,82,2022/4/15 11:30,4,23,-19,
9112,82,2022/4/15 11:40,11,16,-5,
9113,82,2022/4/15 11:50,2,21,-19,
9114,82,2022/4/15 12:00,13,16,-3,
9115,82,2022/4/15 12:10,6,25,-19,
9116,82,2022/4/15 12:20,10,16,-6,
9117,82,2022/4/15 12:30,10,18,-8,
9118,82,2022/4/15 12:40,5,21,-16,
9119,82,2022/4/15 12:50,8,29,-21,
9120,82,2022/4/15 13:00,3,23,-20,
9121,82,2022/4/15 13:10,9,14,-5,
9122,82,2022/4/15 13:20,7,21,-14,
9123,82,2022/4/15 13:30,4,23,-19,
9124,82,2022/4/15 13:40,8,23,-15,
9125,82,2022/4/15 13:50,2,21,-19,
9126,82,2022/4/15 14:00,7,19,-12,
9127,82,2022/4/15 14:10,6,33,-27,
9128,82,2022/4/15 14:20,4,19,-15,
9129,82,2022/4/15 14:30,7,23,-16,
9130,82,2022/4/15 14:40,2,23,-21,
9131,82,2022/4/15 14:50,6,29,-23,
9132,82,2022/4/15 15:00,6,21,-15,
9133,82,2022/4/15 15:10,4,17,-13,
9134,82,2022/4/15 15:20,6,28,-22,
9135,82,2022/4/15 15:30,2,38,-36,
9136,82,2022/4/15 15:40,9,37,-28,
9137,82,2022/4/15 15:50,8,36,-28,
9138,82,2022/4/15 16:00,3,31,-28,
9139,82,2022/4/15 16:10,9,53,-44,
9140,82,2022/4/15 16:20,4,29,-25,
9141,82,2022/4/15 16:30,10,50,-40,
9142,82,2022/4/15 16:40,12,44,-32,
9143,82,2022/4/15 16:50,7,38,-31,
9144,82,2022/4/15 17:00,11,59,-48,
9145,82,2022/4/15 17:10,6,38,-32,
9146,82,2022/4/15 17:20,6,67,-61,
9147,82,2022/4/15 17:30,10,51,-41,
9148,82,2022/4/15 17:40,4,56,-52,
9149,82,2022/4/15 17:50,12,82,-70,
9150,82,2022/4/15 18:00,9,61,-52,
9151,82,2022/4/15 18:10,5,94,-89,
9152,82,2022/4/15 18:20,3,65,-62,
9153,82,2022/4/15 18:30,6,99,-93,
9154,82,2022/4/15 18:40,5,62,-57,
9155,82,2022/4/15 18:50,2,70,-68,
9156,82,2022/4/15 19:00,5,92,-87,
9157,82,2022/4/15 19:10,4,72,-68,
9158,82,2022/4/15 19:20,2,92,-90,
9159,82,2022/4/15 19:30,2,56,-54,
9160,82,2022/4/15 19:40,2,70,-68,
9161,82,2022/4/15 19:50,1,47,-46,
9162,82,2022/4/15 20:00,2,46,-44,
9163,82,2022/4/15 20:10,1,67,-66,
9164,82,2022/4/15 20:20,2,39,-37,
9165,82,2022/4/15 20:30,1,36,-35,
9166,82,2022/4/15 20:40,2,25,-23,
9167,82,2022/4/15 20:50,1,50,-49,
9168,82,2022/4/15 21:00,2,40,-38,
9169,82,2022/4/15 21:10,2,41,-39,
9170,82,2022/4/15 21:20,1,8,-7,
9171,82,2022/4/15 21:30,2,43,-41,
9172,82,2022/4/15 21:40,0,40,-40,
9173,82,2022/4/15 21:50,0,33,-33,
9174,82,2022/4/15 22:00,0,7,-7,
9175,82,2022/4/15 22:10,0,40,-40,
9176,82,2022/4/15 22:20,0,38,-38,
9177,82,2022/4/15 22:30,0,3,-3,
9178,82,2022/4/15 22:40,0,3,-3,
9179,82,2022/4/15 22:50,0,3,-3,
9180,91,2022/4/15 5:00,0,1,-1,
9181,91,2022/4/15 5:10,0,1,-1,
9182,91,2022/4/15 5:20,0,1,-1,
9183,91,2022/4/15 5:30,0,1,-1,
9184,91,2022/4/15 5:40,0,1,-1,
9185,91,2022/4/15 5:50,28,1,27,
9186,91,2022/4/15 6:00,121,1,120,
9187,91,2022/4/15 6:10,42,16,26,
9188,91,2022/4/15 6:20,73,16,57,
9189,91,2022/4/15 6:30,94,22,72,
9190,91,2022/4/15 6:40,168,19,149,
9191,91,2022/4/15 6:50,134,43,91,
9192,91,2022/4/15 7:00,147,52,95,
9193,91,2022/4/15 7:10,209,83,126,
9194,91,2022/4/15 7:20,227,81,146,
9195,91,2022/4/15 7:30,239,67,172,
9196,91,2022/4/15 7:40,318,76,242,
9197,91,2022/4/15 7:50,173,72,101,
9198,91,2022/4/15 8:00,161,77,84,
9199,91,2022/4/15 8:10,158,83,75,
9200,91,2022/4/15 8:20,85,62,23,
9201,91,2022/4/15 8:30,71,74,-3,
9202,91,2022/4/15 8:40,72,61,11,
9203,91,2022/4/15 8:50,55,64,-9,
9204,91,2022/4/15 9:00,35,49,-14,
9205,91,2022/4/15 9:10,27,60,-33,
9206,91,2022/4/15 9:20,37,64,-27,
9207,91,2022/4/15 9:30,26,68,-42,
9208,91,2022/4/15 9:40,28,80,-52,
9209,91,2022/4/15 9:50,31,65,-34,
9210,91,2022/4/15 10:00,24,66,-42,
9211,91,2022/4/15 10:10,24,55,-31,
9212,91,2022/4/15 10:20,24,63,-39,
9213,91,2022/4/15 10:30,29,73,-44,
9214,91,2022/4/15 10:40,21,54,-33,
9215,91,2022/4/15 10:50,21,46,-25,
9216,91,2022/4/15 11:00,26,64,-38,
9217,91,2022/4/15 11:10,26,69,-43,
9218,91,2022/4/15 11:20,26,54,-28,
9219,91,2022/4/15 11:30,25,57,-32,
9220,91,2022/4/15 11:40,25,44,-19,
9221,91,2022/4/15 11:50,22,65,-43,
9222,91,2022/4/15 12:00,28,38,-10,
9223,91,2022/4/15 12:10,24,58,-34,
9224,91,2022/4/15 12:20,25,53,-28,
9225,91,2022/4/15 12:30,22,71,-49,
9226,91,2022/4/15 12:40,22,53,-31,
9227,91,2022/4/15 12:50,29,45,-16,
9228,91,2022/4/15 13:00,22,65,-43,
9229,91,2022/4/15 13:10,24,80,-56,
9230,91,2022/4/15 13:20,26,63,-37,
9231,91,2022/4/15 13:30,24,59,-35,
9232,91,2022/4/15 13:40,24,51,-27,
9233,91,2022/4/15 13:50,26,81,-55,
9234,91,2022/4/15 14:00,28,49,-21,
9235,91,2022/4/15 14:10,26,62,-36,
9236,91,2022/4/15 14:20,25,63,-38,
9237,91,2022/4/15 14:30,25,68,-43,
9238,91,2022/4/15 14:40,25,57,-32,
9239,91,2022/4/15 14:50,26,54,-28,
9240,91,2022/4/15 15:00,25,57,-32,
9241,91,2022/4/15 15:10,23,73,-50,
9242,91,2022/4/15 15:20,27,60,-33,
9243,91,2022/4/15 15:30,25,68,-43,
9244,91,2022/4/15 15:40,29,56,-27,
9245,91,2022/4/15 15:50,24,92,-68,
9246,91,2022/4/15 16:00,26,76,-50,
9247,91,2022/4/15 16:10,23,71,-48,
9248,91,2022/4/15 16:20,28,90,-62,
9249,91,2022/4/15 16:30,27,93,-66,
9250,91,2022/4/15 16:40,23,67,-44,
9251,91,2022/4/15 16:50,25,100,-75,
9252,91,2022/4/15 17:00,31,75,-44,
9253,91,2022/4/15 17:10,37,105,-68,
9254,91,2022/4/15 17:20,29,87,-58,
9255,91,2022/4/15 17:30,29,111,-82,
9256,91,2022/4/15 17:40,27,110,-83,
9257,91,2022/4/15 17:50,27,108,-81,
9258,91,2022/4/15 18:00,27,128,-101,
9259,91,2022/4/15 18:10,20,114,-94,
9260,91,2022/4/15 18:20,15,192,-177,
9261,91,2022/4/15 18:30,23,129,-106,
9262,91,2022/4/15 18:40,18,113,-95,
9263,91,2022/4/15 18:50,15,184,-169,
9264,91,2022/4/15 19:00,15,104,-89,
9265,91,2022/4/15 19:10,12,179,-167,
9266,91,2022/4/15 19:20,11,104,-93,
9267,91,2022/4/15 19:30,7,109,-102,
9268,91,2022/4/15 19:40,10,92,-82,
9269,91,2022/4/15 19:50,9,108,-99,
9270,91,2022/4/15 20:00,7,86,-79,
9271,91,2022/4/15 20:10,7,85,-78,
9272,91,2022/4/15 20:20,6,70,-64,
9273,91,2022/4/15 20:30,6,107,-101,
9274,91,2022/4/15 20:40,4,67,-63,
9275,91,2022/4/15 20:50,2,73,-71,
9276,91,2022/4/15 21:00,5,67,-62,
9277,91,2022/4/15 21:10,2,61,-59,
9278,91,2022/4/15 21:20,3,83,-80,
9279,91,2022/4/15 21:30,2,71,-69,
9280,91,2022/4/15 21:40,2,64,-62,
9281,91,2022/4/15 21:50,1,8,-7,
9282,91,2022/4/15 22:00,1,73,-72,
9283,91,2022/4/15 22:10,0,70,-70,
9284,91,2022/4/15 22:20,0,13,-13,
9285,91,2022/4/15 22:30,0,62,-62,
9286,91,2022/4/15 22:40,0,3,-3,
9287,91,2022/4/15 22:50,0,3,-3,
9288,85,2022/4/15 5:00,0,1,-1,
9289,85,2022/4/15 5:10,0,1,-1,
9290,85,2022/4/15 5:20,0,1,-1,
9291,85,2022/4/15 5:30,0,1,-1,
9292,85,2022/4/15 5:40,6,1,5,
9293,85,2022/4/15 5:50,72,1,71,
9294,85,2022/4/15 6:00,113,1,112,
9295,85,2022/4/15 6:10,169,1,168,
9296,85,2022/4/15 6:20,233,49,184,
9297,85,2022/4/15 6:30,249,38,211,
9298,85,2022/4/15 6:40,348,46,302,
9299,85,2022/4/15 6:50,339,41,298,
9300,85,2022/4/15 7:00,390,69,321,
9301,85,2022/4/15 7:10,345,75,270,
9302,85,2022/4/15 7:20,340,86,254,
9303,85,2022/4/15 7:30,347,105,242,
9304,85,2022/4/15 7:40,280,92,188,
9305,85,2022/4/15 7:50,274,96,178,
9306,85,2022/4/15 8:00,222,85,137,
9307,85,2022/4/15 8:10,220,105,115,
9308,85,2022/4/15 8:20,185,101,84,
9309,85,2022/4/15 8:30,147,105,42,
9310,85,2022/4/15 8:40,111,103,8,
9311,85,2022/4/15 8:50,90,88,2,
9312,85,2022/4/15 9:00,57,85,-28,
9313,85,2022/4/15 9:10,65,74,-9,
9314,85,2022/4/15 9:20,47,92,-45,
9315,85,2022/4/15 9:30,50,87,-37,
9316,85,2022/4/15 9:40,43,100,-57,
9317,85,2022/4/15 9:50,41,103,-62,
9318,85,2022/4/15 10:00,39,102,-63,
9319,85,2022/4/15 10:10,40,98,-58,
9320,85,2022/4/15 10:20,42,77,-35,
9321,85,2022/4/15 10:30,41,76,-35,
9322,85,2022/4/15 10:40,41,124,-83,
9323,85,2022/4/15 10:50,42,98,-56,
9324,85,2022/4/15 11:00,41,67,-26,
9325,85,2022/4/15 11:10,42,93,-51,
9326,85,2022/4/15 11:20,43,105,-62,
9327,85,2022/4/15 11:30,47,98,-51,
9328,85,2022/4/15 11:40,61,93,-32,
9329,85,2022/4/15 11:50,61,66,-5,
9330,85,2022/4/15 12:00,44,123,-79,
9331,85,2022/4/15 12:10,58,92,-34,
9332,85,2022/4/15 12:20,47,90,-43,
9333,85,2022/4/15 12:30,55,91,-36,
9334,85,2022/4/15 12:40,45,118,-73,
9335,85,2022/4/15 12:50,46,106,-60,
9336,85,2022/4/15 13:00,37,97,-60,
9337,85,2022/4/15 13:10,47,103,-56,
9338,85,2022/4/15 13:20,49,114,-65,
9339,85,2022/4/15 13:30,43,100,-57,
9340,85,2022/4/15 13:40,39,105,-66,
9341,85,2022/4/15 13:50,40,82,-42,
9342,85,2022/4/15 14:00,41,108,-67,
9343,85,2022/4/15 14:10,49,89,-40,
9344,85,2022/4/15 14:20,54,99,-45,
9345,85,2022/4/15 14:30,52,100,-48,
9346,85,2022/4/15 14:40,44,119,-75,
9347,85,2022/4/15 14:50,55,83,-28,
9348,85,2022/4/15 15:00,45,89,-44,
9349,85,2022/4/15 15:10,49,102,-53,
9350,85,2022/4/15 15:20,50,108,-58,
9351,85,2022/4/15 15:30,45,97,-52,
9352,85,2022/4/15 15:40,44,117,-73,
9353,85,2022/4/15 15:50,41,99,-58,
9354,85,2022/4/15 16:00,43,110,-67,
9355,85,2022/4/15 16:10,54,146,-92,
9356,85,2022/4/15 16:20,44,119,-75,
9357,85,2022/4/15 16:30,54,119,-65,
9358,85,2022/4/15 16:40,43,179,-136,
9359,85,2022/4/15 16:50,55,105,-50,
9360,85,2022/4/15 17:00,51,283,-232,
9361,85,2022/4/15 17:10,62,110,-48,
9362,85,2022/4/15 17:20,46,180,-134,
9363,85,2022/4/15 17:30,44,125,-81,
9364,85,2022/4/15 17:40,38,116,-78,
9365,85,2022/4/15 17:50,35,233,-198,
9366,85,2022/4/15 18:00,32,110,-78,
9367,85,2022/4/15 18:10,33,235,-202,
9368,85,2022/4/15 18:20,29,104,-75,
9369,85,2022/4/15 18:30,28,198,-170,
9370,85,2022/4/15 18:40,30,180,-150,
9371,85,2022/4/15 18:50,25,119,-94,
9372,85,2022/4/15 19:00,24,330,-306,
9373,85,2022/4/15 19:10,22,110,-88,
9374,85,2022/4/15 19:20,28,256,-228,
9375,85,2022/4/15 19:30,25,128,-103,
9376,85,2022/4/15 19:40,23,192,-169,
9377,85,2022/4/15 19:50,22,121,-99,
9378,85,2022/4/15 20:00,21,109,-88,
9379,85,2022/4/15 20:10,25,101,-76,
9380,85,2022/4/15 20:20,21,106,-85,
9381,85,2022/4/15 20:30,24,93,-69,
9382,85,2022/4/15 20:40,17,123,-106,
9383,85,2022/4/15 20:50,18,87,-69,
9384,85,2022/4/15 21:00,19,95,-76,
9385,85,2022/4/15 21:10,19,77,-58,
9386,85,2022/4/15 21:20,15,76,-61,
9387,85,2022/4/15 21:30,12,101,-89,
9388,85,2022/4/15 21:40,12,98,-86,
9389,85,2022/4/15 21:50,7,17,-10,
9390,85,2022/4/15 22:00,6,91,-85,
9391,85,2022/4/15 22:10,5,89,-84,
9392,85,2022/4/15 22:20,1,7,-6,
9393,85,2022/4/15 22:30,0,90,-90,
9394,85,2022/4/15 22:40,0,89,-89,
9395,85,2022/4/15 22:50,0,3,-3,
9396,86,2022/4/15 5:00,0,1,-1,
9397,86,2022/4/15 5:10,0,1,-1,
9398,86,2022/4/15 5:20,0,1,-1,
9399,86,2022/4/15 5:30,0,1,-1,
9400,86,2022/4/15 5:40,0,1,-1,
9401,86,2022/4/15 5:50,0,1,-1,
9402,86,2022/4/15 6:00,24,1,23,
9403,86,2022/4/15 6:10,32,1,31,
9404,86,2022/4/15 6:20,30,2,28,
9405,86,2022/4/15 6:30,26,2,24,
9406,86,2022/4/15 6:40,35,1,34,
9407,86,2022/4/15 6:50,36,2,34,
9408,86,2022/4/15 7:00,55,8,47,
9409,86,2022/4/15 7:10,44,6,38,
9410,86,2022/4/15 7:20,37,14,23,
9411,86,2022/4/15 7:30,49,25,24,
9412,86,2022/4/15 7:40,34,23,11,
9413,86,2022/4/15 7:50,26,23,3,
9414,86,2022/4/15 8:00,29,23,6,
9415,86,2022/4/15 8:10,24,21,3,
9416,86,2022/4/15 8:20,19,19,0,
9417,86,2022/4/15 8:30,16,21,-5,
9418,86,2022/4/15 8:40,17,19,-2,
9419,86,2022/4/15 8:50,13,19,-6,
9420,86,2022/4/15 9:00,9,19,-10,
9421,86,2022/4/15 9:10,8,16,-8,
9422,86,2022/4/15 9:20,8,21,-13,
9423,86,2022/4/15 9:30,6,23,-17,
9424,86,2022/4/15 9:40,9,19,-10,
9425,86,2022/4/15 9:50,6,16,-10,
9426,86,2022/4/15 10:00,11,18,-7,
9427,86,2022/4/15 10:10,8,19,-11,
9428,86,2022/4/15 10:20,7,23,-16,
9429,86,2022/4/15 10:30,10,17,-7,
9430,86,2022/4/15 10:40,8,16,-8,
9431,86,2022/4/15 10:50,9,17,-8,
9432,86,2022/4/15 11:00,6,14,-8,
9433,86,2022/4/15 11:10,9,21,-12,
9434,86,2022/4/15 11:20,11,18,-7,
9435,86,2022/4/15 11:30,17,8,9,
9436,86,2022/4/15 11:40,16,16,0,
9437,86,2022/4/15 11:50,13,23,-10,
9438,86,2022/4/15 12:00,14,17,-3,
9439,86,2022/4/15 12:10,14,16,-2,
9440,86,2022/4/15 12:20,7,12,-5,
9441,86,2022/4/15 12:30,12,32,-20,
9442,86,2022/4/15 12:40,13,14,-1,
9443,86,2022/4/15 12:50,10,17,-7,
9444,86,2022/4/15 13:00,12,21,-9,
9445,86,2022/4/15 13:10,11,19,-8,
9446,86,2022/4/15 13:20,6,19,-13,
9447,86,2022/4/15 13:30,7,12,-5,
9448,86,2022/4/15 13:40,6,19,-13,
9449,86,2022/4/15 13:50,10,21,-11,
9450,86,2022/4/15 14:00,10,14,-4,
9451,86,2022/4/15 14:10,9,11,-2,
9452,86,2022/4/15 14:20,7,16,-9,
9453,86,2022/4/15 14:30,7,23,-16,
9454,86,2022/4/15 14:40,10,14,-4,
9455,86,2022/4/15 14:50,7,14,-7,
9456,86,2022/4/15 15:00,10,21,-11,
9457,86,2022/4/15 15:10,8,23,-15,
9458,86,2022/4/15 15:20,7,22,-15,
9459,86,2022/4/15 15:30,8,18,-10,
9460,86,2022/4/15 15:40,12,22,-10,
9461,86,2022/4/15 15:50,5,37,-32,
9462,86,2022/4/15 16:00,6,22,-16,
9463,86,2022/4/15 16:10,10,35,-25,
9464,86,2022/4/15 16:20,12,23,-11,
9465,86,2022/4/15 16:30,8,46,-38,
9466,86,2022/4/15 16:40,7,22,-15,
9467,86,2022/4/15 16:50,6,44,-38,
9468,86,2022/4/15 17:00,3,36,-33,
9469,86,2022/4/15 17:10,8,32,-24,
9470,86,2022/4/15 17:20,6,46,-40,
9471,86,2022/4/15 17:30,7,25,-18,
9472,86,2022/4/15 17:40,3,46,-43,
9473,86,2022/4/15 17:50,6,37,-31,
9474,86,2022/4/15 18:00,3,40,-37,
9475,86,2022/4/15 18:10,2,46,-44,
9476,86,2022/4/15 18:20,2,32,-30,
9477,86,2022/4/15 18:30,3,43,-40,
9478,86,2022/4/15 18:40,3,38,-35,
9479,86,2022/4/15 18:50,1,57,-56,
9480,86,2022/4/15 19:00,2,39,-37,
9481,86,2022/4/15 19:10,2,39,-37,
9482,86,2022/4/15 19:20,2,56,-54,
9483,86,2022/4/15 19:30,1,35,-34,
9484,86,2022/4/15 19:40,1,48,-47,
9485,86,2022/4/15 19:50,1,23,-22,
9486,86,2022/4/15 20:00,1,40,-39,
9487,86,2022/4/15 20:10,0,18,-18,
9488,86,2022/4/15 20:20,1,18,-17,
9489,86,2022/4/15 20:30,1,25,-24,
9490,86,2022/4/15 20:40,1,15,-14,
9491,86,2022/4/15 20:50,1,15,-14,
9492,86,2022/4/15 21:00,0,10,-10,
9493,86,2022/4/15 21:10,0,25,-25,
9494,86,2022/4/15 21:20,0,21,-21,
9495,86,2022/4/15 21:30,0,21,-21,
9496,86,2022/4/15 21:40,0,3,-3,
9497,86,2022/4/15 21:50,0,15,-15,
9498,86,2022/4/15 22:00,0,23,-23,
9499,86,2022/4/15 22:10,0,3,-3,
9500,86,2022/4/15 22:20,0,15,-15,
9501,86,2022/4/15 22:30,0,3,-3,
9502,86,2022/4/15 22:40,0,13,-13,
9503,86,2022/4/15 22:50,0,10,-10,
9504,90,2022/4/15 5:00,0,1,-1,
9505,90,2022/4/15 5:10,0,1,-1,
9506,90,2022/4/15 5:20,0,1,-1,
9507,90,2022/4/15 5:30,0,1,-1,
9508,90,2022/4/15 5:40,1,1,0,
9509,90,2022/4/15 5:50,36,1,35,
9510,90,2022/4/15 6:00,34,1,33,
9511,90,2022/4/15 6:10,32,1,31,
9512,90,2022/4/15 6:20,28,1,27,
9513,90,2022/4/15 6:30,43,1,42,
9514,90,2022/4/15 6:40,34,19,15,
9515,90,2022/4/15 6:50,55,6,49,
9516,90,2022/4/15 7:00,47,6,41,
9517,90,2022/4/15 7:10,51,19,32,
9518,90,2022/4/15 7:20,54,19,35,
9519,90,2022/4/15 7:30,38,19,19,
9520,90,2022/4/15 7:40,43,23,20,
9521,90,2022/4/15 7:50,29,32,-3,
9522,90,2022/4/15 8:00,29,22,7,
9523,90,2022/4/15 8:10,21,23,-2,
9524,90,2022/4/15 8:20,23,21,2,
9525,90,2022/4/15 8:30,15,29,-14,
9526,90,2022/4/15 8:40,15,32,-17,
9527,90,2022/4/15 8:50,11,23,-12,
9528,90,2022/4/15 9:00,13,30,-17,
9529,90,2022/4/15 9:10,6,32,-26,
9530,90,2022/4/15 9:20,15,21,-6,
9531,90,2022/4/15 9:30,8,23,-15,
9532,90,2022/4/15 9:40,9,31,-22,
9533,90,2022/4/15 9:50,8,23,-15,
9534,90,2022/4/15 10:00,12,23,-11,
9535,90,2022/4/15 10:10,6,31,-25,
9536,90,2022/4/15 10:20,3,32,-29,
9537,90,2022/4/15 10:30,5,38,-33,
9538,90,2022/4/15 10:40,9,23,-14,
9539,90,2022/4/15 10:50,6,25,-19,
9540,90,2022/4/15 11:00,6,27,-21,
9541,90,2022/4/15 11:10,7,37,-30,
9542,90,2022/4/15 11:20,12,23,-11,
9543,90,2022/4/15 11:30,7,23,-16,
9544,90,2022/4/15 11:40,8,18,-10,
9545,90,2022/4/15 11:50,9,37,-28,
9546,90,2022/4/15 12:00,8,21,-13,
9547,90,2022/4/15 12:10,7,23,-16,
9548,90,2022/4/15 12:20,6,23,-17,
9549,90,2022/4/15 12:30,7,32,-25,
9550,90,2022/4/15 12:40,15,23,-8,
9551,90,2022/4/15 12:50,5,15,-10,
9552,90,2022/4/15 13:00,10,29,-19,
9553,90,2022/4/15 13:10,9,37,-28,
9554,90,2022/4/15 13:20,12,23,-11,
9555,90,2022/4/15 13:30,7,31,-24,
9556,90,2022/4/15 13:40,6,22,-16,
9557,90,2022/4/15 13:50,6,37,-31,
9558,90,2022/4/15 14:00,10,19,-9,
9559,90,2022/4/15 14:10,8,34,-26,
9560,90,2022/4/15 14:20,7,28,-21,
9561,90,2022/4/15 14:30,8,40,-32,
9562,90,2022/4/15 14:40,9,31,-22,
9563,90,2022/4/15 14:50,9,23,-14,
9564,90,2022/4/15 15:00,6,32,-26,
9565,90,2022/4/15 15:10,7,43,-36,
9566,90,2022/4/15 15:20,11,34,-23,
9567,90,2022/4/15 15:30,8,31,-23,
9568,90,2022/4/15 15:40,6,29,-23,
9569,90,2022/4/15 15:50,8,60,-52,
9570,90,2022/4/15 16:00,9,36,-27,
9571,90,2022/4/15 16:10,13,40,-27,
9572,90,2022/4/15 16:20,13,38,-25,
9573,90,2022/4/15 16:30,9,63,-54,
9574,90,2022/4/15 16:40,9,51,-42,
9575,90,2022/4/15 16:50,14,38,-24,
9576,90,2022/4/15 17:00,9,59,-50,
9577,90,2022/4/15 17:10,9,48,-39,
9578,90,2022/4/15 17:20,9,68,-59,
9579,90,2022/4/15 17:30,9,51,-42,
9580,90,2022/4/15 17:40,6,57,-51,
9581,90,2022/4/15 17:50,10,71,-61,
9582,90,2022/4/15 18:00,8,52,-44,
9583,90,2022/4/15 18:10,7,72,-65,
9584,90,2022/4/15 18:20,5,47,-42,
9585,90,2022/4/15 18:30,6,72,-66,
9586,90,2022/4/15 18:40,4,49,-45,
9587,90,2022/4/15 18:50,2,58,-56,
9588,90,2022/4/15 19:00,2,73,-71,
9589,90,2022/4/15 19:10,4,53,-49,
9590,90,2022/4/15 19:20,2,66,-64,
9591,90,2022/4/15 19:30,2,47,-45,
9592,90,2022/4/15 19:40,1,62,-61,
9593,90,2022/4/15 19:50,4,63,-59,
9594,90,2022/4/15 20:00,1,52,-51,
9595,90,2022/4/15 20:10,3,42,-39,
9596,90,2022/4/15 20:20,1,33,-32,
9597,90,2022/4/15 20:30,2,54,-52,
9598,90,2022/4/15 20:40,1,27,-26,
9599,90,2022/4/15 20:50,1,32,-31,
9600,90,2022/4/15 21:00,1,25,-24,
9601,90,2022/4/15 21:10,2,47,-45,
9602,90,2022/4/15 21:20,2,32,-30,
9603,90,2022/4/15 21:30,0,25,-25,
9604,90,2022/4/15 21:40,0,40,-40,
9605,90,2022/4/15 21:50,0,4,-4,
9606,90,2022/4/15 22:00,0,39,-39,
9607,90,2022/4/15 22:10,0,31,-31,
9608,90,2022/4/15 22:20,0,3,-3,
9609,90,2022/4/15 22:30,0,32,-32,
9610,90,2022/4/15 22:40,0,27,-27,
9611,90,2022/4/15 22:50,0,7,-7,
9612,87,2022/4/15 5:00,0,1,-1,
9613,87,2022/4/15 5:10,0,1,-1,
9614,87,2022/4/15 5:20,0,1,-1,
9615,87,2022/4/15 5:30,0,1,-1,
9616,87,2022/4/15 5:40,1,1,0,
9617,87,2022/4/15 5:50,9,1,8,
9618,87,2022/4/15 6:00,7,1,6,
9619,87,2022/4/15 6:10,3,1,2,
9620,87,2022/4/15 6:20,30,1,29,
9621,87,2022/4/15 6:30,22,1,21,
9622,87,2022/4/15 6:40,30,1,29,
9623,87,2022/4/15 6:50,28,23,5,
9624,87,2022/4/15 7:00,29,11,18,
9625,87,2022/4/15 7:10,26,17,9,
9626,87,2022/4/15 7:20,51,36,15,
9627,87,2022/4/15 7:30,28,36,-8,
9628,87,2022/4/15 7:40,28,60,-32,
9629,87,2022/4/15 7:50,29,57,-28,
9630,87,2022/4/15 8:00,18,32,-14,
9631,87,2022/4/15 8:10,19,45,-26,
9632,87,2022/4/15 8:20,25,55,-30,
9633,87,2022/4/15 8:30,11,43,-32,
9634,87,2022/4/15 8:40,16,40,-24,
9635,87,2022/4/15 8:50,18,64,-46,
9636,87,2022/4/15 9:00,17,49,-32,
9637,87,2022/4/15 9:10,12,35,-23,
9638,87,2022/4/15 9:20,11,60,-49,
9639,87,2022/4/15 9:30,12,46,-34,
9640,87,2022/4/15 9:40,12,50,-38,
9641,87,2022/4/15 9:50,19,37,-18,
9642,87,2022/4/15 10:00,15,46,-31,
9643,87,2022/4/15 10:10,19,45,-26,
9644,87,2022/4/15 10:20,22,53,-31,
9645,87,2022/4/15 10:30,20,40,-20,
9646,87,2022/4/15 10:40,19,38,-19,
9647,87,2022/4/15 10:50,13,36,-23,
9648,87,2022/4/15 11:00,19,66,-47,
9649,87,2022/4/15 11:10,18,37,-19,
9650,87,2022/4/15 11:20,19,37,-18,
9651,87,2022/4/15 11:30,14,38,-24,
9652,87,2022/4/15 11:40,22,50,-28,
9653,87,2022/4/15 11:50,14,49,-35,
9654,87,2022/4/15 12:00,23,40,-17,
9655,87,2022/4/15 12:10,25,29,-4,
9656,87,2022/4/15 12:20,23,56,-33,
9657,87,2022/4/15 12:30,23,38,-15,
9658,87,2022/4/15 12:40,22,34,-12,
9659,87,2022/4/15 12:50,19,37,-18,
9660,87,2022/4/15 13:00,24,49,-25,
9661,87,2022/4/15 13:10,25,38,-13,
9662,87,2022/4/15 13:20,22,32,-10,
9663,87,2022/4/15 13:30,19,29,-10,
9664,87,2022/4/15 13:40,16,51,-35,
9665,87,2022/4/15 13:50,21,34,-13,
9666,87,2022/4/15 14:00,21,31,-10,
9667,87,2022/4/15 14:10,21,25,-4,
9668,87,2022/4/15 14:20,21,51,-30,
9669,87,2022/4/15 14:30,26,38,-12,
9670,87,2022/4/15 14:40,19,32,-13,
9671,87,2022/4/15 14:50,22,38,-16,
9672,87,2022/4/15 15:00,22,43,-21,
9673,87,2022/4/15 15:10,26,38,-12,
9674,87,2022/4/15 15:20,31,32,-1,
9675,87,2022/4/15 15:30,28,33,-5,
9676,87,2022/4/15 15:40,25,53,-28,
9677,87,2022/4/15 15:50,19,37,-18,
9678,87,2022/4/15 16:00,26,38,-12,
9679,87,2022/4/15 16:10,24,37,-13,
9680,87,2022/4/15 16:20,28,44,-16,
9681,87,2022/4/15 16:30,22,62,-40,
9682,87,2022/4/15 16:40,24,45,-21,
9683,87,2022/4/15 16:50,21,45,-24,
9684,87,2022/4/15 17:00,25,60,-35,
9685,87,2022/4/15 17:10,21,32,-11,
9686,87,2022/4/15 17:20,22,69,-47,
9687,87,2022/4/15 17:30,12,45,-33,
9688,87,2022/4/15 17:40,21,60,-39,
9689,87,2022/4/15 17:50,23,40,-17,
9690,87,2022/4/15 18:00,7,41,-34,
9691,87,2022/4/15 18:10,17,63,-46,
9692,87,2022/4/15 18:20,11,48,-37,
9693,87,2022/4/15 18:30,7,69,-62,
9694,87,2022/4/15 18:40,10,50,-40,
9695,87,2022/4/15 18:50,12,74,-62,
9696,87,2022/4/15 19:00,2,56,-54,
9697,87,2022/4/15 19:10,13,49,-36,
9698,87,2022/4/15 19:20,8,73,-65,
9699,87,2022/4/15 19:30,5,46,-41,
9700,87,2022/4/15 19:40,7,62,-55,
9701,87,2022/4/15 19:50,8,49,-41,
9702,87,2022/4/15 20:00,4,71,-67,
9703,87,2022/4/15 20:10,10,50,-40,
9704,87,2022/4/15 20:20,4,47,-43,
9705,87,2022/4/15 20:30,5,43,-38,
9706,87,2022/4/15 20:40,0,39,-39,
9707,87,2022/4/15 20:50,9,38,-29,
9708,87,2022/4/15 21:00,2,49,-47,
9709,87,2022/4/15 21:10,3,39,-36,
9710,87,2022/4/15 21:20,1,25,-24,
9711,87,2022/4/15 21:30,2,27,-25,
9712,87,2022/4/15 21:40,1,25,-24,
9713,87,2022/4/15 21:50,1,30,-29,
9714,87,2022/4/15 22:00,0,33,-33,
9715,87,2022/4/15 22:10,0,3,-3,
9716,87,2022/4/15 22:20,0,31,-31,
9717,87,2022/4/15 22:30,0,24,-24,
9718,87,2022/4/15 22:40,0,7,-7,
9719,87,2022/4/15 22:50,0,25,-25,
9720,81,2022/4/15 5:00,0,1,-1,
9721,81,2022/4/15 5:10,0,1,-1,
9722,81,2022/4/15 5:20,0,1,-1,
9723,81,2022/4/15 5:30,0,1,-1,
9724,81,2022/4/15 5:40,8,1,7,
9725,81,2022/4/15 5:50,5,1,4,
9726,81,2022/4/15 6:00,11,1,10,
9727,81,2022/4/15 6:10,18,1,17,
9728,81,2022/4/15 6:20,18,1,17,
9729,81,2022/4/15 6:30,22,1,21,
9730,81,2022/4/15 6:40,28,1,27,
9731,81,2022/4/15 6:50,29,68,-39,
9732,81,2022/4/15 7:00,41,52,-11,
9733,81,2022/4/15 7:10,24,71,-47,
9734,81,2022/4/15 7:20,34,76,-42,
9735,81,2022/4/15 7:30,19,70,-51,
9736,81,2022/4/15 7:40,26,50,-24,
9737,81,2022/4/15 7:50,22,62,-40,
9738,81,2022/4/15 8:00,23,75,-52,
9739,81,2022/4/15 8:10,21,78,-57,
9740,81,2022/4/15 8:20,16,82,-66,
9741,81,2022/4/15 8:30,18,75,-57,
9742,81,2022/4/15 8:40,13,76,-63,
9743,81,2022/4/15 8:50,22,81,-59,
9744,81,2022/4/15 9:00,12,69,-57,
9745,81,2022/4/15 9:10,13,61,-48,
9746,81,2022/4/15 9:20,11,62,-51,
9747,81,2022/4/15 9:30,13,38,-25,
9748,81,2022/4/15 9:40,14,57,-43,
9749,81,2022/4/15 9:50,20,51,-31,
9750,81,2022/4/15 10:00,12,49,-37,
9751,81,2022/4/15 10:10,24,47,-23,
9752,81,2022/4/15 10:20,18,49,-31,
9753,81,2022/4/15 10:30,21,52,-31,
9754,81,2022/4/15 10:40,18,69,-51,
9755,81,2022/4/15 10:50,22,51,-29,
9756,81,2022/4/15 11:00,18,48,-30,
9757,81,2022/4/15 11:10,20,48,-28,
9758,81,2022/4/15 11:20,17,66,-49,
9759,81,2022/4/15 11:30,23,46,-23,
9760,81,2022/4/15 11:40,17,48,-31,
9761,81,2022/4/15 11:50,23,33,-10,
9762,81,2022/4/15 12:00,19,60,-41,
9763,81,2022/4/15 12:10,23,34,-11,
9764,81,2022/4/15 12:20,20,40,-20,
9765,81,2022/4/15 12:30,20,38,-18,
9766,81,2022/4/15 12:40,18,53,-35,
9767,81,2022/4/15 12:50,20,45,-25,
9768,81,2022/4/15 13:00,21,35,-14,
9769,81,2022/4/15 13:10,22,38,-16,
9770,81,2022/4/15 13:20,20,53,-33,
9771,81,2022/4/15 13:30,23,38,-15,
9772,81,2022/4/15 13:40,21,44,-23,
9773,81,2022/4/15 13:50,20,37,-17,
9774,81,2022/4/15 14:00,24,67,-43,
9775,81,2022/4/15 14:10,25,41,-16,
9776,81,2022/4/15 14:20,25,38,-13,
9777,81,2022/4/15 14:30,22,38,-16,
9778,81,2022/4/15 14:40,22,50,-28,
9779,81,2022/4/15 14:50,23,38,-15,
9780,81,2022/4/15 15:00,26,36,-10,
9781,81,2022/4/15 15:10,29,35,-6,
9782,81,2022/4/15 15:20,23,40,-17,
9783,81,2022/4/15 15:30,30,50,-20,
9784,81,2022/4/15 15:40,42,35,7,
9785,81,2022/4/15 15:50,34,32,2,
9786,81,2022/4/15 16:00,26,62,-36,
9787,81,2022/4/15 16:10,39,32,7,
9788,81,2022/4/15 16:20,26,36,-10,
9789,81,2022/4/15 16:30,34,38,-4,
9790,81,2022/4/15 16:40,25,45,-20,
9791,81,2022/4/15 16:50,24,45,-21,
9792,81,2022/4/15 17:00,31,31,0,
9793,81,2022/4/15 17:10,21,45,-24,
9794,81,2022/4/15 17:20,26,35,-9,
9795,81,2022/4/15 17:30,23,53,-30,
9796,81,2022/4/15 17:40,22,37,-15,
9797,81,2022/4/15 17:50,11,34,-23,
9798,81,2022/4/15 18:00,17,69,-52,
9799,81,2022/4/15 18:10,16,47,-31,
9800,81,2022/4/15 18:20,14,55,-41,
9801,81,2022/4/15 18:30,8,39,-31,
9802,81,2022/4/15 18:40,13,59,-46,
9803,81,2022/4/15 18:50,14,49,-35,
9804,81,2022/4/15 19:00,5,41,-36,
9805,81,2022/4/15 19:10,4,60,-56,
9806,81,2022/4/15 19:20,10,38,-28,
9807,81,2022/4/15 19:30,10,63,-53,
9808,81,2022/4/15 19:40,4,34,-30,
9809,81,2022/4/15 19:50,6,34,-28,
9810,81,2022/4/15 20:00,1,56,-55,
9811,81,2022/4/15 20:10,7,39,-32,
9812,81,2022/4/15 20:20,4,40,-36,
9813,81,2022/4/15 20:30,4,25,-21,
9814,81,2022/4/15 20:40,2,41,-39,
9815,81,2022/4/15 20:50,1,25,-24,
9816,81,2022/4/15 21:00,1,25,-24,
9817,81,2022/4/15 21:10,2,25,-23,
9818,81,2022/4/15 21:20,0,33,-33,
9819,81,2022/4/15 21:30,1,23,-22,
9820,81,2022/4/15 21:40,0,25,-25,
9821,81,2022/4/15 21:50,1,29,-28,
9822,81,2022/4/15 22:00,0,3,-3,
9823,81,2022/4/15 22:10,0,25,-25,
9824,81,2022/4/15 22:20,0,34,-34,
9825,81,2022/4/15 22:30,0,3,-3,
9826,81,2022/4/15 22:40,0,27,-27,
9827,81,2022/4/15 22:50,0,4,-4,
9828,89,2022/4/15 5:00,0,1,-1,
9829,89,2022/4/15 5:10,0,1,-1,
9830,89,2022/4/15 5:20,0,1,-1,
9831,89,2022/4/15 5:30,0,1,-1,
9832,89,2022/4/15 5:40,0,1,-1,
9833,89,2022/4/15 5:50,1,1,0,
9834,89,2022/4/15 6:00,16,1,15,
9835,89,2022/4/15 6:10,51,1,50,
9836,89,2022/4/15 6:20,28,6,22,
9837,89,2022/4/15 6:30,35,6,29,
9838,89,2022/4/15 6:40,68,5,63,
9839,89,2022/4/15 6:50,55,23,32,
9840,89,2022/4/15 7:00,80,23,57,
9841,89,2022/4/15 7:10,85,23,62,
9842,89,2022/4/15 7:20,151,50,101,
9843,89,2022/4/15 7:30,150,66,84,
9844,89,2022/4/15 7:40,149,60,89,
9845,89,2022/4/15 7:50,54,65,-11,
9846,89,2022/4/15 8:00,77,68,9,
9847,89,2022/4/15 8:10,38,66,-28,
9848,89,2022/4/15 8:20,47,71,-24,
9849,89,2022/4/15 8:30,28,53,-25,
9850,89,2022/4/15 8:40,37,60,-23,
9851,89,2022/4/15 8:50,25,53,-28,
9852,89,2022/4/15 9:00,22,44,-22,
9853,89,2022/4/15 9:10,25,39,-14,
9854,89,2022/4/15 9:20,17,50,-33,
9855,89,2022/4/15 9:30,22,51,-29,
9856,89,2022/4/15 9:40,15,47,-32,
9857,89,2022/4/15 9:50,13,47,-34,
9858,89,2022/4/15 10:00,14,45,-31,
9859,89,2022/4/15 10:10,16,65,-49,
9860,89,2022/4/15 10:20,24,41,-17,
9861,89,2022/4/15 10:30,18,49,-31,
9862,89,2022/4/15 10:40,20,41,-21,
9863,89,2022/4/15 10:50,18,54,-36,
9864,89,2022/4/15 11:00,16,45,-29,
9865,89,2022/4/15 11:10,18,45,-27,
9866,89,2022/4/15 11:20,18,28,-10,
9867,89,2022/4/15 11:30,18,62,-44,
9868,89,2022/4/15 11:40,20,32,-12,
9869,89,2022/4/15 11:50,20,47,-27,
9870,89,2022/4/15 12:00,21,38,-17,
9871,89,2022/4/15 12:10,19,51,-32,
9872,89,2022/4/15 12:20,19,43,-24,
9873,89,2022/4/15 12:30,23,29,-6,
9874,89,2022/4/15 12:40,20,44,-24,
9875,89,2022/4/15 12:50,20,58,-38,
9876,89,2022/4/15 13:00,18,48,-30,
9877,89,2022/4/15 13:10,14,44,-30,
9878,89,2022/4/15 13:20,15,31,-16,
9879,89,2022/4/15 13:30,13,57,-44,
9880,89,2022/4/15 13:40,11,29,-18,
9881,89,2022/4/15 13:50,16,40,-24,
9882,89,2022/4/15 14:00,16,42,-26,
9883,89,2022/4/15 14:10,16,48,-32,
9884,89,2022/4/15 14:20,19,44,-25,
9885,89,2022/4/15 14:30,18,32,-14,
9886,89,2022/4/15 14:40,20,39,-19,
9887,89,2022/4/15 14:50,18,45,-27,
9888,89,2022/4/15 15:00,18,45,-27,
9889,89,2022/4/15 15:10,20,41,-21,
9890,89,2022/4/15 15:20,22,37,-15,
9891,89,2022/4/15 15:30,21,58,-37,
9892,89,2022/4/15 15:40,21,44,-23,
9893,89,2022/4/15 15:50,26,49,-23,
9894,89,2022/4/15 16:00,24,55,-31,
9895,89,2022/4/15 16:10,28,62,-34,
9896,89,2022/4/15 16:20,27,68,-41,
9897,89,2022/4/15 16:30,26,41,-15,
9898,89,2022/4/15 16:40,20,68,-48,
9899,89,2022/4/15 16:50,30,61,-31,
9900,89,2022/4/15 17:00,25,78,-53,
9901,89,2022/4/15 17:10,36,60,-24,
9902,89,2022/4/15 17:20,24,59,-35,
9903,89,2022/4/15 17:30,20,88,-68,
9904,89,2022/4/15 17:40,25,73,-48,
9905,89,2022/4/15 17:50,15,93,-78,
9906,89,2022/4/15 18:00,15,74,-59,
9907,89,2022/4/15 18:10,16,100,-84,
9908,89,2022/4/15 18:20,12,77,-65,
9909,89,2022/4/15 18:30,8,83,-75,
9910,89,2022/4/15 18:40,14,126,-112,
9911,89,2022/4/15 18:50,9,86,-77,
9912,89,2022/4/15 19:00,8,105,-97,
9913,89,2022/4/15 19:10,8,86,-78,
9914,89,2022/4/15 19:20,7,75,-68,
9915,89,2022/4/15 19:30,6,115,-109,
9916,89,2022/4/15 19:40,4,67,-63,
9917,89,2022/4/15 19:50,3,75,-72,
9918,89,2022/4/15 20:00,4,44,-40,
9919,89,2022/4/15 20:10,2,70,-68,
9920,89,2022/4/15 20:20,3,51,-48,
9921,89,2022/4/15 20:30,2,44,-42,
9922,89,2022/4/15 20:40,3,41,-38,
9923,89,2022/4/15 20:50,4,56,-52,
9924,89,2022/4/15 21:00,2,47,-45,
9925,89,2022/4/15 21:10,1,39,-38,
9926,89,2022/4/15 21:20,2,46,-44,
9927,89,2022/4/15 21:30,2,3,-1,
9928,89,2022/4/15 21:40,2,46,-44,
9929,89,2022/4/15 21:50,2,46,-44,
9930,89,2022/4/15 22:00,1,40,-39,
9931,89,2022/4/15 22:10,1,7,-6,
9932,89,2022/4/15 22:20,0,45,-45,
9933,89,2022/4/15 22:30,0,30,-30,
9934,89,2022/4/15 22:40,0,10,-10,
9935,89,2022/4/15 22:50,0,3,-3,
9936,96,2022/4/15 5:00,0,1,-1,-1
9937,96,2022/4/15 5:10,16,1,15,15
9938,96,2022/4/15 5:20,23,1,22,22
9939,96,2022/4/15 5:30,25,1,24,24
9940,96,2022/4/15 5:40,29,1,28,28
9941,96,2022/4/15 5:50,38,1,37,37
9942,96,2022/4/15 6:00,47,1,46,46
9943,96,2022/4/15 6:10,66,64,2,2
9944,96,2022/4/15 6:20,148,61,87,87
9945,96,2022/4/15 6:30,185,84,101,101
9946,96,2022/4/15 6:40,236,108,128,128
9947,96,2022/4/15 6:50,275,91,184,184
9948,96,2022/4/15 7:00,325,93,232,232
9949,96,2022/4/15 7:10,593,119,474,474
9950,96,2022/4/15 7:20,683,123,560,560
9951,96,2022/4/15 7:30,666,114,552,552
9952,96,2022/4/15 7:40,687,108,579,579
9953,96,2022/4/15 7:50,862,127,735,735
9954,96,2022/4/15 8:00,753,144,609,609
9955,96,2022/4/15 8:10,665,106,559,559
9956,96,2022/4/15 8:20,611,114,497,497
9957,96,2022/4/15 8:30,474,122,352,352
9958,96,2022/4/15 8:40,282,111,171,171
9959,96,2022/4/15 8:50,246,110,136,136
9960,96,2022/4/15 9:00,173,109,64,64
9961,96,2022/4/15 9:10,121,110,11,11
9962,96,2022/4/15 9:20,94,108,-14,-14
9963,96,2022/4/15 9:30,63,90,-27,-27
9964,96,2022/4/15 9:40,77,94,-17,-17
9965,96,2022/4/15 9:50,58,77,-19,-19
9966,96,2022/4/15 10:00,42,91,-49,-49
9967,96,2022/4/15 10:10,46,87,-41,-41
9968,96,2022/4/15 10:20,45,77,-32,-32
9969,96,2022/4/15 10:30,45,74,-29,-29
9970,96,2022/4/15 10:40,51,71,-20,-20
9971,96,2022/4/15 10:50,53,90,-37,-37
9972,96,2022/4/15 11:00,46,79,-33,-33
9973,96,2022/4/15 11:10,58,76,-18,-18
9974,96,2022/4/15 11:20,42,61,-19,-19
9975,96,2022/4/15 11:30,73,82,-9,-9
9976,96,2022/4/15 11:40,69,93,-24,-24
9977,96,2022/4/15 11:50,57,94,-37,-37
9978,96,2022/4/15 12:00,63,75,-12,-12
9979,96,2022/4/15 12:10,62,78,-16,-16
9980,96,2022/4/15 12:20,60,80,-20,-20
9981,96,2022/4/15 12:30,47,109,-62,-62
9982,96,2022/4/15 12:40,42,101,-59,-59
9983,96,2022/4/15 12:50,44,82,-38,-38
9984,96,2022/4/15 13:00,41,105,-64,-64
9985,96,2022/4/15 13:10,43,73,-30,-30
9986,96,2022/4/15 13:20,41,83,-42,-42
9987,96,2022/4/15 13:30,45,92,-47,-47
9988,96,2022/4/15 13:40,41,90,-49,-49
9989,96,2022/4/15 13:50,42,73,-31,-31
9990,96,2022/4/15 14:00,39,91,-52,-52
9991,96,2022/4/15 14:10,39,64,-25,-25
9992,96,2022/4/15 14:20,45,70,-25,-25
9993,96,2022/4/15 14:30,38,97,-59,-59
9994,96,2022/4/15 14:40,47,90,-43,-43
9995,96,2022/4/15 14:50,43,75,-32,-32
9996,96,2022/4/15 15:00,40,75,-35,-35
9997,96,2022/4/15 15:10,41,76,-35,-35
9998,96,2022/4/15 15:20,45,96,-51,-51
9999,96,2022/4/15 15:30,39,97,-58,-58
10000,96,2022/4/15 15:40,43,113,-70,-70
10001,96,2022/4/15 15:50,44,90,-46,-46
10002,96,2022/4/15 16:00,45,98,-53,-53
10003,96,2022/4/15 16:10,58,74,-16,-16
10004,96,2022/4/15 16:20,63,108,-45,-45
10005,96,2022/4/15 16:30,61,107,-46,-46
10006,96,2022/4/15 16:40,92,111,-19,-19
10007,96,2022/4/15 16:50,128,103,25,25
10008,96,2022/4/15 17:00,129,124,5,5
10009,96,2022/4/15 17:10,156,102,54,54
10010,96,2022/4/15 17:20,158,118,40,40
10011,96,2022/4/15 17:30,59,107,-48,-48
10012,96,2022/4/15 17:40,86,222,-136,-136
10013,96,2022/4/15 17:50,47,118,-71,-71
10014,96,2022/4/15 18:00,41,284,-243,-243
10015,96,2022/4/15 18:10,39,269,-230,-230
10016,96,2022/4/15 18:20,30,217,-187,-187
10017,96,2022/4/15 18:30,28,314,-286,-286
10018,96,2022/4/15 18:40,27,300,-273,-273
10019,96,2022/4/15 18:50,29,333,-304,-304
10020,96,2022/4/15 19:00,23,304,-281,-281
10021,96,2022/4/15 19:10,23,299,-276,-276
10022,96,2022/4/15 19:20,20,149,-129,-129
10023,96,2022/4/15 19:30,18,180,-162,-162
10024,96,2022/4/15 19:40,19,128,-109,-109
10025,96,2022/4/15 19:50,18,106,-88,-88
10026,96,2022/4/15 20:00,15,120,-105,-105
10027,96,2022/4/15 20:10,16,122,-106,-106
10028,96,2022/4/15 20:20,16,92,-76,-76
10029,96,2022/4/15 20:30,13,127,-114,-114
10030,96,2022/4/15 20:40,18,77,-59,-59
10031,96,2022/4/15 20:50,10,106,-96,-96
10032,96,2022/4/15 21:00,12,106,-94,-94
10033,96,2022/4/15 21:10,9,107,-98,-98
10034,96,2022/4/15 21:20,7,106,-99,-99
10035,96,2022/4/15 21:30,10,110,-100,-100
10036,96,2022/4/15 21:40,8,88,-80,-80
10037,96,2022/4/15 21:50,7,92,-85,-85
10038,96,2022/4/15 22:00,4,95,-91,-91
10039,96,2022/4/15 22:10,7,82,-75,-75
10040,96,2022/4/15 22:20,2,83,-81,-81
10041,96,2022/4/15 22:30,0,95,-95,-95
10042,96,2022/4/15 22:40,0,89,-89,-89
10043,96,2022/4/15 22:50,0,95,-95,-95
10044,119,2022/4/15 5:00,0,1,-1,
10045,119,2022/4/15 5:10,5,1,4,
10046,119,2022/4/15 5:20,11,1,10,
10047,119,2022/4/15 5:30,10,1,9,
10048,119,2022/4/15 5:40,14,1,13,
10049,119,2022/4/15 5:50,19,1,18,
10050,119,2022/4/15 6:00,26,1,25,
10051,119,2022/4/15 6:10,27,13,14,
10052,119,2022/4/15 6:20,32,6,26,
10053,119,2022/4/15 6:30,37,8,29,
10054,119,2022/4/15 6:40,48,14,34,
10055,119,2022/4/15 6:50,71,19,52,
10056,119,2022/4/15 7:00,85,23,62,
10057,119,2022/4/15 7:10,181,23,158,
10058,119,2022/4/15 7:20,222,34,188,
10059,119,2022/4/15 7:30,236,62,174,
10060,119,2022/4/15 7:40,236,53,183,
10061,119,2022/4/15 7:50,234,63,171,
10062,119,2022/4/15 8:00,224,61,163,
10063,119,2022/4/15 8:10,188,78,110,
10064,119,2022/4/15 8:20,122,67,55,
10065,119,2022/4/15 8:30,76,72,4,
10066,119,2022/4/15 8:40,63,72,-9,
10067,119,2022/4/15 8:50,50,72,-22,
10068,119,2022/4/15 9:00,39,38,1,
10069,119,2022/4/15 9:10,30,48,-18,
10070,119,2022/4/15 9:20,25,38,-13,
10071,119,2022/4/15 9:30,28,40,-12,
10072,119,2022/4/15 9:40,20,37,-17,
10073,119,2022/4/15 9:50,21,34,-13,
10074,119,2022/4/15 10:00,21,38,-17,
10075,119,2022/4/15 10:10,17,31,-14,
10076,119,2022/4/15 10:20,22,37,-15,
10077,119,2022/4/15 10:30,18,32,-14,
10078,119,2022/4/15 10:40,16,32,-16,
10079,119,2022/4/15 10:50,14,23,-9,
10080,119,2022/4/15 11:00,16,38,-22,
10081,119,2022/4/15 11:10,15,31,-16,
10082,119,2022/4/15 11:20,18,23,-5,
10083,119,2022/4/15 11:30,17,19,-2,
10084,119,2022/4/15 11:40,16,32,-16,
10085,119,2022/4/15 11:50,17,29,-12,
10086,119,2022/4/15 12:00,18,37,-19,
10087,119,2022/4/15 12:10,19,30,-11,
10088,119,2022/4/15 12:20,16,25,-9,
10089,119,2022/4/15 12:30,18,21,-3,
10090,119,2022/4/15 12:40,15,35,-20,
10091,119,2022/4/15 12:50,15,35,-20,
10092,119,2022/4/15 13:00,19,38,-19,
10093,119,2022/4/15 13:10,16,31,-15,
10094,119,2022/4/15 13:20,16,32,-16,
10095,119,2022/4/15 13:30,16,25,-9,
10096,119,2022/4/15 13:40,14,38,-24,
10097,119,2022/4/15 13:50,15,38,-23,
10098,119,2022/4/15 14:00,12,30,-18,
10099,119,2022/4/15 14:10,14,37,-23,
10100,119,2022/4/15 14:20,12,32,-20,
10101,119,2022/4/15 14:30,14,32,-18,
10102,119,2022/4/15 14:40,15,33,-18,
10103,119,2022/4/15 14:50,14,38,-24,
10104,119,2022/4/15 15:00,16,38,-22,
10105,119,2022/4/15 15:10,17,37,-20,
10106,119,2022/4/15 15:20,16,31,-15,
10107,119,2022/4/15 15:30,16,33,-17,
10108,119,2022/4/15 15:40,16,50,-34,
10109,119,2022/4/15 15:50,17,47,-30,
10110,119,2022/4/15 16:00,22,38,-16,
10111,119,2022/4/15 16:10,15,45,-30,
10112,119,2022/4/15 16:20,19,45,-26,
10113,119,2022/4/15 16:30,24,48,-24,
10114,119,2022/4/15 16:40,22,52,-30,
10115,119,2022/4/15 16:50,20,62,-42,
10116,119,2022/4/15 17:00,31,60,-29,
10117,119,2022/4/15 17:10,32,64,-32,
10118,119,2022/4/15 17:20,27,54,-27,
10119,119,2022/4/15 17:30,27,76,-49,
10120,119,2022/4/15 17:40,26,60,-34,
10121,119,2022/4/15 17:50,20,101,-81,
10122,119,2022/4/15 18:00,19,107,-88,
10123,119,2022/4/15 18:10,22,102,-80,
10124,119,2022/4/15 18:20,12,98,-86,
10125,119,2022/4/15 18:30,14,113,-99,
10126,119,2022/4/15 18:40,11,91,-80,
10127,119,2022/4/15 18:50,13,126,-113,
10128,119,2022/4/15 19:00,9,110,-101,
10129,119,2022/4/15 19:10,11,107,-96,
10130,119,2022/4/15 19:20,8,95,-87,
10131,119,2022/4/15 19:30,7,92,-85,
10132,119,2022/4/15 19:40,10,71,-61,
10133,119,2022/4/15 19:50,8,74,-66,
10134,119,2022/4/15 20:00,6,73,-67,
10135,119,2022/4/15 20:10,9,52,-43,
10136,119,2022/4/15 20:20,8,70,-62,
10137,119,2022/4/15 20:30,7,64,-57,
10138,119,2022/4/15 20:40,4,62,-58,
10139,119,2022/4/15 20:50,8,63,-55,
10140,119,2022/4/15 21:00,5,54,-49,
10141,119,2022/4/15 21:10,6,55,-49,
10142,119,2022/4/15 21:20,3,46,-43,
10143,119,2022/4/15 21:30,3,60,-57,
10144,119,2022/4/15 21:40,2,52,-50,
10145,119,2022/4/15 21:50,5,48,-43,
10146,119,2022/4/15 22:00,5,51,-46,
10147,119,2022/4/15 22:10,2,52,-50,
10148,119,2022/4/15 22:20,1,52,-51,
10149,119,2022/4/15 22:30,1,60,-59,
10150,119,2022/4/15 22:40,0,66,-66,
10151,119,2022/4/15 22:50,0,62,-62,
10152,93,2022/4/15 5:00,0,1,-1,
10153,93,2022/4/15 5:10,10,1,9,
10154,93,2022/4/15 5:20,26,1,25,
10155,93,2022/4/15 5:30,27,1,26,
10156,93,2022/4/15 5:40,31,2,29,
10157,93,2022/4/15 5:50,34,1,33,
10158,93,2022/4/15 6:00,52,25,27,
10159,93,2022/4/15 6:10,59,5,54,
10160,93,2022/4/15 6:20,81,6,75,
10161,93,2022/4/15 6:30,155,23,132,
10162,93,2022/4/15 6:40,227,23,204,
10163,93,2022/4/15 6:50,277,29,248,
10164,93,2022/4/15 7:00,316,51,265,
10165,93,2022/4/15 7:10,589,42,547,
10166,93,2022/4/15 7:20,706,101,605,
10167,93,2022/4/15 7:30,839,100,739,
10168,93,2022/4/15 7:40,1061,84,977,
10169,93,2022/4/15 7:50,1056,87,969,
10170,93,2022/4/15 8:00,1057,71,986,
10171,93,2022/4/15 8:10,857,73,784,
10172,93,2022/4/15 8:20,654,71,583,
10173,93,2022/4/15 8:30,573,73,500,
10174,93,2022/4/15 8:40,350,60,290,
10175,93,2022/4/15 8:50,281,75,206,
10176,93,2022/4/15 9:00,229,48,181,
10177,93,2022/4/15 9:10,162,69,93,
10178,93,2022/4/15 9:20,77,70,7,
10179,93,2022/4/15 9:30,62,75,-13,
10180,93,2022/4/15 9:40,50,68,-18,
10181,93,2022/4/15 9:50,45,85,-40,
10182,93,2022/4/15 10:00,42,69,-27,
10183,93,2022/4/15 10:10,35,67,-32,
10184,93,2022/4/15 10:20,35,62,-27,
10185,93,2022/4/15 10:30,36,59,-23,
10186,93,2022/4/15 10:40,30,60,-30,
10187,93,2022/4/15 10:50,35,51,-16,
10188,93,2022/4/15 11:00,29,67,-38,
10189,93,2022/4/15 11:10,30,66,-36,
10190,93,2022/4/15 11:20,30,57,-27,
10191,93,2022/4/15 11:30,45,66,-21,
10192,93,2022/4/15 11:40,42,38,4,
10193,93,2022/4/15 11:50,36,71,-35,
10194,93,2022/4/15 12:00,39,70,-31,
10195,93,2022/4/15 12:10,38,74,-36,
10196,93,2022/4/15 12:20,37,59,-22,
10197,93,2022/4/15 12:30,37,60,-23,
10198,93,2022/4/15 12:40,30,46,-16,
10199,93,2022/4/15 12:50,32,71,-39,
10200,93,2022/4/15 13:00,28,62,-34,
10201,93,2022/4/15 13:10,28,68,-40,
10202,93,2022/4/15 13:20,27,64,-37,
10203,93,2022/4/15 13:30,27,64,-37,
10204,93,2022/4/15 13:40,25,57,-32,
10205,93,2022/4/15 13:50,26,76,-50,
10206,93,2022/4/15 14:00,28,61,-33,
10207,93,2022/4/15 14:10,25,71,-46,
10208,93,2022/4/15 14:20,23,68,-45,
10209,93,2022/4/15 14:30,26,66,-40,
10210,93,2022/4/15 14:40,29,70,-41,
10211,93,2022/4/15 14:50,34,75,-41,
10212,93,2022/4/15 15:00,24,91,-67,
10213,93,2022/4/15 15:10,25,78,-53,
10214,93,2022/4/15 15:20,28,91,-63,
10215,93,2022/4/15 15:30,26,65,-39,
10216,93,2022/4/15 15:40,29,72,-43,
10217,93,2022/4/15 15:50,27,95,-68,
10218,93,2022/4/15 16:00,27,101,-74,
10219,93,2022/4/15 16:10,29,91,-62,
10220,93,2022/4/15 16:20,29,93,-64,
10221,93,2022/4/15 16:30,39,93,-54,
10222,93,2022/4/15 16:40,31,96,-65,
10223,93,2022/4/15 16:50,29,100,-71,
10224,93,2022/4/15 17:00,30,122,-92,
10225,93,2022/4/15 17:10,42,103,-61,
10226,93,2022/4/15 17:20,40,111,-71,
10227,93,2022/4/15 17:30,35,125,-90,
10228,93,2022/4/15 17:40,28,143,-115,
10229,93,2022/4/15 17:50,28,194,-166,
10230,93,2022/4/15 18:00,29,269,-240,
10231,93,2022/4/15 18:10,25,197,-172,
10232,93,2022/4/15 18:20,29,340,-311,
10233,93,2022/4/15 18:30,26,257,-231,
10234,93,2022/4/15 18:40,23,365,-342,
10235,93,2022/4/15 18:50,22,483,-461,
10236,93,2022/4/15 19:00,25,382,-357,
10237,93,2022/4/15 19:10,25,225,-200,
10238,93,2022/4/15 19:20,22,334,-312,
10239,93,2022/4/15 19:30,17,181,-164,
10240,93,2022/4/15 19:40,20,206,-186,
10241,93,2022/4/15 19:50,18,125,-107,
10242,93,2022/4/15 20:00,16,124,-108,
10243,93,2022/4/15 20:10,19,104,-85,
10244,93,2022/4/15 20:20,17,117,-100,
10245,93,2022/4/15 20:30,17,107,-90,
10246,93,2022/4/15 20:40,14,113,-99,
10247,93,2022/4/15 20:50,20,109,-89,
10248,93,2022/4/15 21:00,19,127,-108,
10249,93,2022/4/15 21:10,16,107,-91,
10250,93,2022/4/15 21:20,14,106,-92,
10251,93,2022/4/15 21:30,12,75,-63,
10252,93,2022/4/15 21:40,10,98,-88,
10253,93,2022/4/15 21:50,11,105,-94,
10254,93,2022/4/15 22:00,10,100,-90,
10255,93,2022/4/15 22:10,8,103,-95,
10256,93,2022/4/15 22:20,6,59,-53,
10257,93,2022/4/15 22:30,3,103,-100,
10258,93,2022/4/15 22:40,2,80,-78,
10259,93,2022/4/15 22:50,2,105,-103,
10260,97,2022/4/15 5:00,1,1,0,
10261,97,2022/4/15 5:10,7,1,6,
10262,97,2022/4/15 5:20,27,1,26,
10263,97,2022/4/15 5:30,34,2,32,
10264,97,2022/4/15 5:40,34,1,33,
10265,97,2022/4/15 5:50,54,1,53,
10266,97,2022/4/15 6:00,115,46,69,
10267,97,2022/4/15 6:10,225,38,187,
10268,97,2022/4/15 6:20,319,38,281,
10269,97,2022/4/15 6:30,391,39,352,
10270,97,2022/4/15 6:40,573,55,518,
10271,97,2022/4/15 6:50,638,76,562,
10272,97,2022/4/15 7:00,679,58,621,
10273,97,2022/4/15 7:10,1060,103,957,
10274,97,2022/4/15 7:20,1215,101,1114,
10275,97,2022/4/15 7:30,1581,117,1464,
10276,97,2022/4/15 7:40,1584,144,1440,
10277,97,2022/4/15 7:50,1979,117,1862,
10278,97,2022/4/15 8:00,1596,110,1486,
10279,97,2022/4/15 8:10,1595,114,1481,
10280,97,2022/4/15 8:20,1367,115,1252,
10281,97,2022/4/15 8:30,1060,128,932,
10282,97,2022/4/15 8:40,679,109,570,
10283,97,2022/4/15 8:50,600,108,492,
10284,97,2022/4/15 9:00,464,98,366,
10285,97,2022/4/15 9:10,289,100,189,
10286,97,2022/4/15 9:20,244,105,139,
10287,97,2022/4/15 9:30,220,100,120,
10288,97,2022/4/15 9:40,156,88,68,
10289,97,2022/4/15 9:50,148,103,45,
10290,97,2022/4/15 10:00,112,91,21,
10291,97,2022/4/15 10:10,73,81,-8,
10292,97,2022/4/15 10:20,80,83,-3,
10293,97,2022/4/15 10:30,55,96,-41,
10294,97,2022/4/15 10:40,60,97,-37,
10295,97,2022/4/15 10:50,47,65,-18,
10296,97,2022/4/15 11:00,43,87,-44,
10297,97,2022/4/15 11:10,52,97,-45,
10298,97,2022/4/15 11:20,52,97,-45,
10299,97,2022/4/15 11:30,42,76,-34,
10300,97,2022/4/15 11:40,59,93,-34,
10301,97,2022/4/15 11:50,66,73,-7,
10302,97,2022/4/15 12:00,62,93,-31,
10303,97,2022/4/15 12:10,68,108,-40,
10304,97,2022/4/15 12:20,74,111,-37,
10305,97,2022/4/15 12:30,51,80,-29,
10306,97,2022/4/15 12:40,69,104,-35,
10307,97,2022/4/15 12:50,54,71,-17,
10308,97,2022/4/15 13:00,58,106,-48,
10309,97,2022/4/15 13:10,54,108,-54,
10310,97,2022/4/15 13:20,42,103,-61,
10311,97,2022/4/15 13:30,43,96,-53,
10312,97,2022/4/15 13:40,44,91,-47,
10313,97,2022/4/15 13:50,45,102,-57,
10314,97,2022/4/15 14:00,37,100,-63,
10315,97,2022/4/15 14:10,38,105,-67,
10316,97,2022/4/15 14:20,37,109,-72,
10317,97,2022/4/15 14:30,39,98,-59,
10318,97,2022/4/15 14:40,35,101,-66,
10319,97,2022/4/15 14:50,41,98,-57,
10320,97,2022/4/15 15:00,35,99,-64,
10321,97,2022/4/15 15:10,35,119,-84,
10322,97,2022/4/15 15:20,37,119,-82,
10323,97,2022/4/15 15:30,32,121,-89,
10324,97,2022/4/15 15:40,46,108,-62,
10325,97,2022/4/15 15:50,42,123,-81,
10326,97,2022/4/15 16:00,43,129,-86,
10327,97,2022/4/15 16:10,47,137,-90,
10328,97,2022/4/15 16:20,42,111,-69,
10329,97,2022/4/15 16:30,46,169,-123,
10330,97,2022/4/15 16:40,45,132,-87,
10331,97,2022/4/15 16:50,51,128,-77,
10332,97,2022/4/15 17:00,135,214,-79,
10333,97,2022/4/15 17:10,202,279,-77,
10334,97,2022/4/15 17:20,76,230,-154,
10335,97,2022/4/15 17:30,157,367,-210,
10336,97,2022/4/15 17:40,130,371,-241,
10337,97,2022/4/15 17:50,111,484,-373,
10338,97,2022/4/15 18:00,79,434,-355,
10339,97,2022/4/15 18:10,132,314,-182,
10340,97,2022/4/15 18:20,76,595,-519,
10341,97,2022/4/15 18:30,55,407,-352,
10342,97,2022/4/15 18:40,46,1099,-1053,
10343,97,2022/4/15 18:50,43,621,-578,
10344,97,2022/4/15 19:00,35,492,-457,
10345,97,2022/4/15 19:10,29,292,-263,
10346,97,2022/4/15 19:20,28,484,-456,
10347,97,2022/4/15 19:30,27,223,-196,
10348,97,2022/4/15 19:40,25,385,-360,
10349,97,2022/4/15 19:50,28,254,-226,
10350,97,2022/4/15 20:00,25,128,-103,
10351,97,2022/4/15 20:10,28,234,-206,
10352,97,2022/4/15 20:20,26,123,-97,
10353,97,2022/4/15 20:30,25,179,-154,
10354,97,2022/4/15 20:40,25,171,-146,
10355,97,2022/4/15 20:50,23,151,-128,
10356,97,2022/4/15 21:00,22,128,-106,
10357,97,2022/4/15 21:10,25,126,-101,
10358,97,2022/4/15 21:20,24,119,-95,
10359,97,2022/4/15 21:30,16,128,-112,
10360,97,2022/4/15 21:40,19,110,-91,
10361,97,2022/4/15 21:50,14,124,-110,
10362,97,2022/4/15 22:00,14,136,-122,
10363,97,2022/4/15 22:10,13,114,-101,
10364,97,2022/4/15 22:20,12,115,-103,
10365,97,2022/4/15 22:30,6,120,-114,
10366,97,2022/4/15 22:40,2,155,-153,
10367,97,2022/4/15 22:50,1,123,-122,
10368,101,2022/4/15 5:00,0,1,-1,
10369,101,2022/4/15 5:10,1,1,0,
10370,101,2022/4/15 5:20,12,1,11,
10371,101,2022/4/15 5:30,25,1,24,
10372,101,2022/4/15 5:40,30,1,29,
10373,101,2022/4/15 5:50,36,1,35,
10374,101,2022/4/15 6:00,45,13,32,
10375,101,2022/4/15 6:10,61,11,50,
10376,101,2022/4/15 6:20,87,21,66,
10377,101,2022/4/15 6:30,108,42,66,
10378,101,2022/4/15 6:40,128,47,81,
10379,101,2022/4/15 6:50,215,66,149,
10380,101,2022/4/15 7:00,245,85,160,
10381,101,2022/4/15 7:10,304,71,233,
10382,101,2022/4/15 7:20,393,123,270,
10383,101,2022/4/15 7:30,630,109,521,
10384,101,2022/4/15 7:40,718,146,572,
10385,101,2022/4/15 7:50,687,108,579,
10386,101,2022/4/15 8:00,713,106,607,
10387,101,2022/4/15 8:10,630,108,522,
10388,101,2022/4/15 8:20,447,115,332,
10389,101,2022/4/15 8:30,317,119,198,
10390,101,2022/4/15 8:40,235,152,83,
10391,101,2022/4/15 8:50,188,108,80,
10392,101,2022/4/15 9:00,83,114,-31,
10393,101,2022/4/15 9:10,72,100,-28,
10394,101,2022/4/15 9:20,57,83,-26,
10395,101,2022/4/15 9:30,45,77,-32,
10396,101,2022/4/15 9:40,35,59,-24,
10397,101,2022/4/15 9:50,36,72,-36,
10398,101,2022/4/15 10:00,34,61,-27,
10399,101,2022/4/15 10:10,31,59,-28,
10400,101,2022/4/15 10:20,27,64,-37,
10401,101,2022/4/15 10:30,28,51,-23,
10402,101,2022/4/15 10:40,29,61,-32,
10403,101,2022/4/15 10:50,29,55,-26,
10404,101,2022/4/15 11:00,29,51,-22,
10405,101,2022/4/15 11:10,27,36,-9,
10406,101,2022/4/15 11:20,27,64,-37,
10407,101,2022/4/15 11:30,23,65,-42,
10408,101,2022/4/15 11:40,23,62,-39,
10409,101,2022/4/15 11:50,26,48,-22,
10410,101,2022/4/15 12:00,31,47,-16,
10411,101,2022/4/15 12:10,29,44,-15,
10412,101,2022/4/15 12:20,30,61,-31,
10413,101,2022/4/15 12:30,23,63,-40,
10414,101,2022/4/15 12:40,23,55,-32,
10415,101,2022/4/15 12:50,23,57,-34,
10416,101,2022/4/15 13:00,26,50,-24,
10417,101,2022/4/15 13:10,29,54,-25,
10418,101,2022/4/15 13:20,24,62,-38,
10419,101,2022/4/15 13:30,23,60,-37,
10420,101,2022/4/15 13:40,24,59,-35,
10421,101,2022/4/15 13:50,22,62,-40,
10422,101,2022/4/15 14:00,29,49,-20,
10423,101,2022/4/15 14:10,26,60,-34,
10424,101,2022/4/15 14:20,24,67,-43,
10425,101,2022/4/15 14:30,24,67,-43,
10426,101,2022/4/15 14:40,27,61,-34,
10427,101,2022/4/15 14:50,25,64,-39,
10428,101,2022/4/15 15:00,26,56,-30,
10429,101,2022/4/15 15:10,24,68,-44,
10430,101,2022/4/15 15:20,27,82,-55,
10431,101,2022/4/15 15:30,34,75,-41,
10432,101,2022/4/15 15:40,39,81,-42,
10433,101,2022/4/15 15:50,31,83,-52,
10434,101,2022/4/15 16:00,38,69,-31,
10435,101,2022/4/15 16:10,38,74,-36,
10436,101,2022/4/15 16:20,36,77,-41,
10437,101,2022/4/15 16:30,41,97,-56,
10438,101,2022/4/15 16:40,58,91,-33,
10439,101,2022/4/15 16:50,42,96,-54,
10440,101,2022/4/15 17:00,38,85,-47,
10441,101,2022/4/15 17:10,40,106,-66,
10442,101,2022/4/15 17:20,38,105,-67,
10443,101,2022/4/15 17:30,57,110,-53,
10444,101,2022/4/15 17:40,139,97,42,
10445,101,2022/4/15 17:50,60,225,-165,
10446,101,2022/4/15 18:00,75,152,-77,
10447,101,2022/4/15 18:10,86,127,-41,
10448,101,2022/4/15 18:20,52,198,-146,
10449,101,2022/4/15 18:30,43,143,-100,
10450,101,2022/4/15 18:40,29,209,-180,
10451,101,2022/4/15 18:50,28,174,-146,
10452,101,2022/4/15 19:00,28,213,-185,
10453,101,2022/4/15 19:10,30,105,-75,
10454,101,2022/4/15 19:20,27,137,-110,
10455,101,2022/4/15 19:30,28,127,-99,
10456,101,2022/4/15 19:40,23,95,-72,
10457,101,2022/4/15 19:50,19,102,-83,
10458,101,2022/4/15 20:00,17,106,-89,
10459,101,2022/4/15 20:10,22,66,-44,
10460,101,2022/4/15 20:20,17,110,-93,
10461,101,2022/4/15 20:30,15,73,-58,
10462,101,2022/4/15 20:40,16,85,-69,
10463,101,2022/4/15 20:50,16,78,-62,
10464,101,2022/4/15 21:00,17,89,-72,
10465,101,2022/4/15 21:10,22,76,-54,
10466,101,2022/4/15 21:20,12,80,-68,
10467,101,2022/4/15 21:30,12,83,-71,
10468,101,2022/4/15 21:40,10,72,-62,
10469,101,2022/4/15 21:50,9,85,-76,
10470,101,2022/4/15 22:00,9,78,-69,
10471,101,2022/4/15 22:10,8,76,-68,
10472,101,2022/4/15 22:20,5,80,-75,
10473,101,2022/4/15 22:30,4,80,-76,
10474,101,2022/4/15 22:40,2,84,-82,
10475,101,2022/4/15 22:50,1,78,-77,
10476,113,2022/4/15 5:00,0,1,-1,
10477,113,2022/4/15 5:10,5,1,4,
10478,113,2022/4/15 5:20,20,1,19,
10479,113,2022/4/15 5:30,50,1,49,
10480,113,2022/4/15 5:40,65,6,59,
10481,113,2022/4/15 5:50,99,14,85,
10482,113,2022/4/15 6:00,187,38,149,
10483,113,2022/4/15 6:10,277,33,244,
10484,113,2022/4/15 6:20,360,46,314,
10485,113,2022/4/15 6:30,574,51,523,
10486,113,2022/4/15 6:40,687,67,620,
10487,113,2022/4/15 6:50,866,80,786,
10488,113,2022/4/15 7:00,1177,75,1102,
10489,113,2022/4/15 7:10,1367,73,1294,
10490,113,2022/4/15 7:20,1983,112,1871,
10491,113,2022/4/15 7:30,1990,111,1879,
10492,113,2022/4/15 7:40,2479,105,2374,
10493,113,2022/4/15 7:50,2560,111,2449,
10494,113,2022/4/15 8:00,2570,104,2466,
10495,113,2022/4/15 8:10,2557,110,2447,
10496,113,2022/4/15 8:20,1990,107,1883,
10497,113,2022/4/15 8:30,1550,107,1443,
10498,113,2022/4/15 8:40,1215,107,1108,
10499,113,2022/4/15 8:50,858,97,761,
10500,113,2022/4/15 9:00,709,101,608,
10501,113,2022/4/15 9:10,578,90,488,
10502,113,2022/4/15 9:20,339,105,234,
10503,113,2022/4/15 9:30,275,91,184,
10504,113,2022/4/15 9:40,237,80,157,
10505,113,2022/4/15 9:50,205,104,101,
10506,113,2022/4/15 10:00,174,96,78,
10507,113,2022/4/15 10:10,147,87,60,
10508,113,2022/4/15 10:20,81,110,-29,
10509,113,2022/4/15 10:30,77,110,-33,
10510,113,2022/4/15 10:40,75,80,-5,
10511,113,2022/4/15 10:50,70,106,-36,
10512,113,2022/4/15 11:00,66,96,-30,
10513,113,2022/4/15 11:10,74,90,-16,
10514,113,2022/4/15 11:20,64,84,-20,
10515,113,2022/4/15 11:30,59,107,-48,
10516,113,2022/4/15 11:40,72,112,-40,
10517,113,2022/4/15 11:50,114,108,6,
10518,113,2022/4/15 12:00,75,90,-15,
10519,113,2022/4/15 12:10,93,77,16,
10520,113,2022/4/15 12:20,96,106,-10,
10521,113,2022/4/15 12:30,86,104,-18,
10522,113,2022/4/15 12:40,75,95,-20,
10523,113,2022/4/15 12:50,77,101,-24,
10524,113,2022/4/15 13:00,70,100,-30,
10525,113,2022/4/15 13:10,74,96,-22,
10526,113,2022/4/15 13:20,63,105,-42,
10527,113,2022/4/15 13:30,65,102,-37,
10528,113,2022/4/15 13:40,48,105,-57,
10529,113,2022/4/15 13:50,57,102,-45,
10530,113,2022/4/15 14:00,43,103,-60,
10531,113,2022/4/15 14:10,42,96,-54,
10532,113,2022/4/15 14:20,45,119,-74,
10533,113,2022/4/15 14:30,45,108,-63,
10534,113,2022/4/15 14:40,45,124,-79,
10535,113,2022/4/15 14:50,46,111,-65,
10536,113,2022/4/15 15:00,41,110,-69,
10537,113,2022/4/15 15:10,48,104,-56,
10538,113,2022/4/15 15:20,44,124,-80,
10539,113,2022/4/15 15:30,41,118,-77,
10540,113,2022/4/15 15:40,44,159,-115,
10541,113,2022/4/15 15:50,43,111,-68,
10542,113,2022/4/15 16:00,44,192,-148,
10543,113,2022/4/15 16:10,49,109,-60,
10544,113,2022/4/15 16:20,54,192,-138,
10545,113,2022/4/15 16:30,66,198,-132,
10546,113,2022/4/15 16:40,68,234,-166,
10547,113,2022/4/15 16:50,66,181,-115,
10548,113,2022/4/15 17:00,71,295,-224,
10549,113,2022/4/15 17:10,75,221,-146,
10550,113,2022/4/15 17:20,78,426,-348,
10551,113,2022/4/15 17:30,69,303,-234,
10552,113,2022/4/15 17:40,76,473,-397,
10553,113,2022/4/15 17:50,76,1140,-1064,
10554,113,2022/4/15 18:00,92,564,-472,
10555,113,2022/4/15 18:10,64,563,-499,
10556,113,2022/4/15 18:20,68,1589,-1521,
10557,113,2022/4/15 18:30,54,559,-505,
10558,113,2022/4/15 18:40,56,1915,-1859,
10559,113,2022/4/15 18:50,43,1067,-1024,
10560,113,2022/4/15 19:00,44,1164,-1120,
10561,113,2022/4/15 19:10,39,413,-374,
10562,113,2022/4/15 19:20,34,477,-443,
10563,113,2022/4/15 19:30,30,381,-351,
10564,113,2022/4/15 19:40,30,330,-300,
10565,113,2022/4/15 19:50,29,234,-205,
10566,113,2022/4/15 20:00,31,181,-150,
10567,113,2022/4/15 20:10,30,234,-204,
10568,113,2022/4/15 20:20,27,229,-202,
10569,113,2022/4/15 20:30,30,122,-92,
10570,113,2022/4/15 20:40,33,191,-158,
10571,113,2022/4/15 20:50,31,118,-87,
10572,113,2022/4/15 21:00,32,179,-147,
10573,113,2022/4/15 21:10,31,126,-95,
10574,113,2022/4/15 21:20,26,184,-158,
10575,113,2022/4/15 21:30,26,121,-95,
10576,113,2022/4/15 21:40,26,111,-85,
10577,113,2022/4/15 21:50,23,137,-114,
10578,113,2022/4/15 22:00,26,111,-85,
10579,113,2022/4/15 22:10,22,124,-102,
10580,113,2022/4/15 22:20,21,155,-134,
10581,113,2022/4/15 22:30,16,130,-114,
10582,113,2022/4/15 22:40,5,202,-197,
10583,113,2022/4/15 22:50,6,114,-108,
10584,98,2022/4/15 5:00,0,1,-1,
10585,98,2022/4/15 5:10,1,1,0,
10586,98,2022/4/15 5:20,10,1,9,
10587,98,2022/4/15 5:30,31,1,30,
10588,98,2022/4/15 5:40,33,2,31,
10589,98,2022/4/15 5:50,54,16,38,
10590,98,2022/4/15 6:00,72,19,53,
10591,98,2022/4/15 6:10,151,19,132,
10592,98,2022/4/15 6:20,225,25,200,
10593,98,2022/4/15 6:30,302,35,267,
10594,98,2022/4/15 6:40,468,46,422,
10595,98,2022/4/15 6:50,630,50,580,
10596,98,2022/4/15 7:00,672,61,611,
10597,98,2022/4/15 7:10,741,77,664,
10598,98,2022/4/15 7:20,1172,75,1097,
10599,98,2022/4/15 7:30,1578,99,1479,
10600,98,2022/4/15 7:40,1584,100,1484,
10601,98,2022/4/15 7:50,1584,98,1486,
10602,98,2022/4/15 8:00,1584,104,1480,
10603,98,2022/4/15 8:10,1604,133,1471,
10604,98,2022/4/15 8:20,1369,182,1187,
10605,98,2022/4/15 8:30,1060,150,910,
10606,98,2022/4/15 8:40,690,298,392,
10607,98,2022/4/15 8:50,596,108,488,
10608,98,2022/4/15 9:00,428,151,277,
10609,98,2022/4/15 9:10,341,122,219,
10610,98,2022/4/15 9:20,237,125,112,
10611,98,2022/4/15 9:30,193,102,91,
10612,98,2022/4/15 9:40,168,127,41,
10613,98,2022/4/15 9:50,106,110,-4,
10614,98,2022/4/15 10:00,84,102,-18,
10615,98,2022/4/15 10:10,76,99,-23,
10616,98,2022/4/15 10:20,57,103,-46,
10617,98,2022/4/15 10:30,54,103,-49,
10618,98,2022/4/15 10:40,45,77,-32,
10619,98,2022/4/15 10:50,41,107,-66,
10620,98,2022/4/15 11:00,46,101,-55,
10621,98,2022/4/15 11:10,46,101,-55,
10622,98,2022/4/15 11:20,48,108,-60,
10623,98,2022/4/15 11:30,47,81,-34,
10624,98,2022/4/15 11:40,43,105,-62,
10625,98,2022/4/15 11:50,56,106,-50,
10626,98,2022/4/15 12:00,61,110,-49,
10627,98,2022/4/15 12:10,67,101,-34,
10628,98,2022/4/15 12:20,65,103,-38,
10629,98,2022/4/15 12:30,63,84,-21,
10630,98,2022/4/15 12:40,64,107,-43,
10631,98,2022/4/15 12:50,54,126,-72,
10632,98,2022/4/15 13:00,68,100,-32,
10633,98,2022/4/15 13:10,50,111,-61,
10634,98,2022/4/15 13:20,56,108,-52,
10635,98,2022/4/15 13:30,45,87,-42,
10636,98,2022/4/15 13:40,46,107,-61,
10637,98,2022/4/15 13:50,45,85,-40,
10638,98,2022/4/15 14:00,47,106,-59,
10639,98,2022/4/15 14:10,46,106,-60,
10640,98,2022/4/15 14:20,46,109,-63,
10641,98,2022/4/15 14:30,44,104,-60,
10642,98,2022/4/15 14:40,46,107,-61,
10643,98,2022/4/15 14:50,45,111,-66,
10644,98,2022/4/15 15:00,47,107,-60,
10645,98,2022/4/15 15:10,45,122,-77,
10646,98,2022/4/15 15:20,48,103,-55,
10647,98,2022/4/15 15:30,44,109,-65,
10648,98,2022/4/15 15:40,47,108,-61,
10649,98,2022/4/15 15:50,47,115,-68,
10650,98,2022/4/15 16:00,43,133,-90,
10651,98,2022/4/15 16:10,53,116,-63,
10652,98,2022/4/15 16:20,59,111,-52,
10653,98,2022/4/15 16:30,64,104,-40,
10654,98,2022/4/15 16:40,63,159,-96,
10655,98,2022/4/15 16:50,70,233,-163,
10656,98,2022/4/15 17:00,114,150,-36,
10657,98,2022/4/15 17:10,154,316,-162,
10658,98,2022/4/15 17:20,84,317,-233,
10659,98,2022/4/15 17:30,97,317,-220,
10660,98,2022/4/15 17:40,204,478,-274,
10661,98,2022/4/15 17:50,132,486,-354,
10662,98,2022/4/15 18:00,148,412,-264,
10663,98,2022/4/15 18:10,213,574,-361,
10664,98,2022/4/15 18:20,176,462,-286,
10665,98,2022/4/15 18:30,116,565,-449,
10666,98,2022/4/15 18:40,89,1110,-1021,
10667,98,2022/4/15 18:50,64,563,-499,
10668,98,2022/4/15 19:00,58,486,-428,
10669,98,2022/4/15 19:10,60,491,-431,
10670,98,2022/4/15 19:20,44,328,-284,
10671,98,2022/4/15 19:30,43,383,-340,
10672,98,2022/4/15 19:40,43,196,-153,
10673,98,2022/4/15 19:50,36,114,-78,
10674,98,2022/4/15 20:00,44,179,-135,
10675,98,2022/4/15 20:10,45,115,-70,
10676,98,2022/4/15 20:20,38,159,-121,
10677,98,2022/4/15 20:30,44,122,-78,
10678,98,2022/4/15 20:40,41,104,-63,
10679,98,2022/4/15 20:50,43,125,-82,
10680,98,2022/4/15 21:00,56,109,-53,
10681,98,2022/4/15 21:10,48,112,-64,
10682,98,2022/4/15 21:20,37,95,-58,
10683,98,2022/4/15 21:30,40,126,-86,
10684,98,2022/4/15 21:40,37,117,-80,
10685,98,2022/4/15 21:50,31,104,-73,
10686,98,2022/4/15 22:00,31,116,-85,
10687,98,2022/4/15 22:10,26,66,-40,
10688,98,2022/4/15 22:20,23,109,-86,
10689,98,2022/4/15 22:30,19,107,-88,
10690,98,2022/4/15 22:40,12,108,-96,
10691,98,2022/4/15 22:50,8,122,-114,
10692,105,2022/4/15 5:00,0,1,-1,
10693,105,2022/4/15 5:10,6,1,5,
10694,105,2022/4/15 5:20,10,1,9,
10695,105,2022/4/15 5:30,35,1,34,
10696,105,2022/4/15 5:40,65,21,44,
10697,105,2022/4/15 5:50,145,29,116,
10698,105,2022/4/15 6:00,185,23,162,
10699,105,2022/4/15 6:10,279,38,241,
10700,105,2022/4/15 6:20,325,42,283,
10701,105,2022/4/15 6:30,688,55,633,
10702,105,2022/4/15 6:40,825,80,745,
10703,105,2022/4/15 6:50,1063,93,970,
10704,105,2022/4/15 7:00,1209,126,1083,
10705,105,2022/4/15 7:10,1363,103,1260,
10706,105,2022/4/15 7:20,1982,125,1857,
10707,105,2022/4/15 7:30,1980,123,1857,
10708,105,2022/4/15 7:40,2532,110,2422,
10709,105,2022/4/15 7:50,2005,105,1900,
10710,105,2022/4/15 8:00,2070,153,1917,
10711,105,2022/4/15 8:10,2468,182,2286,
10712,105,2022/4/15 8:20,1994,185,1809,
10713,105,2022/4/15 8:30,1992,109,1883,
10714,105,2022/4/15 8:40,1363,178,1185,
10715,105,2022/4/15 8:50,1226,117,1109,
10716,105,2022/4/15 9:00,852,110,742,
10717,105,2022/4/15 9:10,698,114,584,
10718,105,2022/4/15 9:20,581,114,467,
10719,105,2022/4/15 9:30,320,105,215,
10720,105,2022/4/15 9:40,274,121,153,
10721,105,2022/4/15 9:50,261,95,166,
10722,105,2022/4/15 10:00,232,104,128,
10723,105,2022/4/15 10:10,211,107,104,
10724,105,2022/4/15 10:20,176,108,68,
10725,105,2022/4/15 10:30,162,113,49,
10726,105,2022/4/15 10:40,112,97,15,
10727,105,2022/4/15 10:50,114,104,10,
10728,105,2022/4/15 11:00,91,103,-12,
10729,105,2022/4/15 11:10,88,124,-36,
10730,105,2022/4/15 11:20,80,105,-25,
10731,105,2022/4/15 11:30,76,104,-28,
10732,105,2022/4/15 11:40,108,99,9,
10733,105,2022/4/15 11:50,107,102,5,
10734,105,2022/4/15 12:00,137,117,20,
10735,105,2022/4/15 12:10,167,123,44,
10736,105,2022/4/15 12:20,176,102,74,
10737,105,2022/4/15 12:30,176,112,64,
10738,105,2022/4/15 12:40,131,106,25,
10739,105,2022/4/15 12:50,140,101,39,
10740,105,2022/4/15 13:00,141,119,22,
10741,105,2022/4/15 13:10,136,122,14,
10742,105,2022/4/15 13:20,88,83,5,
10743,105,2022/4/15 13:30,84,99,-15,
10744,105,2022/4/15 13:40,75,102,-27,
10745,105,2022/4/15 13:50,71,97,-26,
10746,105,2022/4/15 14:00,67,109,-42,
10747,105,2022/4/15 14:10,69,112,-43,
10748,105,2022/4/15 14:20,68,112,-44,
10749,105,2022/4/15 14:30,64,99,-35,
10750,105,2022/4/15 14:40,65,116,-51,
10751,105,2022/4/15 14:50,64,129,-65,
10752,105,2022/4/15 15:00,64,110,-46,
10753,105,2022/4/15 15:10,71,192,-121,
10754,105,2022/4/15 15:20,64,126,-62,
10755,105,2022/4/15 15:30,68,169,-101,
10756,105,2022/4/15 15:40,53,152,-99,
10757,105,2022/4/15 15:50,68,179,-111,
10758,105,2022/4/15 16:00,65,216,-151,
10759,105,2022/4/15 16:10,83,224,-141,
10760,105,2022/4/15 16:20,82,195,-113,
10761,105,2022/4/15 16:30,105,196,-91,
10762,105,2022/4/15 16:40,156,213,-57,
10763,105,2022/4/15 16:50,176,327,-151,
10764,105,2022/4/15 17:00,215,424,-209,
10765,105,2022/4/15 17:10,260,309,-49,
10766,105,2022/4/15 17:20,243,400,-157,
10767,105,2022/4/15 17:30,222,467,-245,
10768,105,2022/4/15 17:40,242,1488,-1246,
10769,105,2022/4/15 17:50,201,1099,-898,
10770,105,2022/4/15 18:00,184,403,-219,
10771,105,2022/4/15 18:10,222,2667,-2445,
10772,105,2022/4/15 18:20,198,568,-370,
10773,105,2022/4/15 18:30,166,1777,-1611,
10774,105,2022/4/15 18:40,181,1753,-1572,
10775,105,2022/4/15 18:50,139,1773,-1634,
10776,105,2022/4/15 19:00,71,423,-352,
10777,105,2022/4/15 19:10,137,1929,-1792,
10778,105,2022/4/15 19:20,66,366,-300,
10779,105,2022/4/15 19:30,64,469,-405,
10780,105,2022/4/15 19:40,46,384,-338,
10781,105,2022/4/15 19:50,41,307,-266,
10782,105,2022/4/15 20:00,46,314,-268,
10783,105,2022/4/15 20:10,43,217,-174,
10784,105,2022/4/15 20:20,41,293,-252,
10785,105,2022/4/15 20:30,41,269,-228,
10786,105,2022/4/15 20:40,40,269,-229,
10787,105,2022/4/15 20:50,37,269,-232,
10788,105,2022/4/15 21:00,41,234,-193,
10789,105,2022/4/15 21:10,34,178,-144,
10790,105,2022/4/15 21:20,29,198,-169,
10791,105,2022/4/15 21:30,27,227,-200,
10792,105,2022/4/15 21:40,28,236,-208,
10793,105,2022/4/15 21:50,26,229,-203,
10794,105,2022/4/15 22:00,25,185,-160,
10795,105,2022/4/15 22:10,28,218,-190,
10796,105,2022/4/15 22:20,24,213,-189,
10797,105,2022/4/15 22:30,17,291,-274,
10798,105,2022/4/15 22:40,11,151,-140,
10799,105,2022/4/15 22:50,8,116,-108,
10800,115,2022/4/15 5:00,0,1,-1,
10801,115,2022/4/15 5:10,0,1,-1,
10802,115,2022/4/15 5:20,3,1,2,
10803,115,2022/4/15 5:30,5,1,4,
10804,115,2022/4/15 5:40,15,1,14,
10805,115,2022/4/15 5:50,16,50,-34,
10806,115,2022/4/15 6:00,21,46,-25,
10807,115,2022/4/15 6:10,27,66,-39,
10808,115,2022/4/15 6:20,36,62,-26,
10809,115,2022/4/15 6:30,42,76,-34,
10810,115,2022/4/15 6:40,55,61,-6,
10811,115,2022/4/15 6:50,88,111,-23,
10812,115,2022/4/15 7:00,108,112,-4,
10813,115,2022/4/15 7:10,155,104,51,
10814,115,2022/4/15 7:20,223,127,96,
10815,115,2022/4/15 7:30,285,180,105,
10816,115,2022/4/15 7:40,319,300,19,
10817,115,2022/4/15 7:50,299,335,-36,
10818,115,2022/4/15 8:00,358,1069,-711,
10819,115,2022/4/15 8:10,333,1845,-1512,
10820,115,2022/4/15 8:20,346,1484,-1138,
10821,115,2022/4/15 8:30,315,1058,-743,
10822,115,2022/4/15 8:40,277,1709,-1432,
10823,115,2022/4/15 8:50,238,546,-308,
10824,115,2022/4/15 9:00,191,421,-230,
10825,115,2022/4/15 9:10,172,339,-167,
10826,115,2022/4/15 9:20,152,375,-223,
10827,115,2022/4/15 9:30,78,191,-113,
10828,115,2022/4/15 9:40,65,171,-106,
10829,115,2022/4/15 9:50,62,127,-65,
10830,115,2022/4/15 10:00,60,109,-49,
10831,115,2022/4/15 10:10,61,123,-62,
10832,115,2022/4/15 10:20,54,97,-43,
10833,115,2022/4/15 10:30,58,120,-62,
10834,115,2022/4/15 10:40,59,104,-45,
10835,115,2022/4/15 10:50,59,105,-46,
10836,115,2022/4/15 11:00,54,87,-33,
10837,115,2022/4/15 11:10,59,112,-53,
10838,115,2022/4/15 11:20,58,105,-47,
10839,115,2022/4/15 11:30,57,112,-55,
10840,115,2022/4/15 11:40,61,89,-28,
10841,115,2022/4/15 11:50,50,87,-37,
10842,115,2022/4/15 12:00,55,91,-36,
10843,115,2022/4/15 12:10,62,107,-45,
10844,115,2022/4/15 12:20,66,103,-37,
10845,115,2022/4/15 12:30,62,104,-42,
10846,115,2022/4/15 12:40,59,102,-43,
10847,115,2022/4/15 12:50,61,105,-44,
10848,115,2022/4/15 13:00,63,102,-39,
10849,115,2022/4/15 13:10,60,120,-60,
10850,115,2022/4/15 13:20,57,120,-63,
10851,115,2022/4/15 13:30,52,107,-55,
10852,115,2022/4/15 13:40,65,119,-54,
10853,115,2022/4/15 13:50,52,100,-48,
10854,115,2022/4/15 14:00,65,109,-44,
10855,115,2022/4/15 14:10,77,119,-42,
10856,115,2022/4/15 14:20,62,119,-57,
10857,115,2022/4/15 14:30,68,100,-32,
10858,115,2022/4/15 14:40,66,84,-18,
10859,115,2022/4/15 14:50,64,102,-38,
10860,115,2022/4/15 15:00,83,111,-28,
10861,115,2022/4/15 15:10,76,103,-27,
10862,115,2022/4/15 15:20,89,126,-37,
10863,115,2022/4/15 15:30,71,98,-27,
10864,115,2022/4/15 15:40,82,112,-30,
10865,115,2022/4/15 15:50,138,102,36,
10866,115,2022/4/15 16:00,132,86,46,
10867,115,2022/4/15 16:10,157,110,47,
10868,115,2022/4/15 16:20,156,119,37,
10869,115,2022/4/15 16:30,242,99,143,
10870,115,2022/4/15 16:40,235,109,126,
10871,115,2022/4/15 16:50,227,99,128,
10872,115,2022/4/15 17:00,269,123,146,
10873,115,2022/4/15 17:10,694,106,588,
10874,115,2022/4/15 17:20,630,114,516,
10875,115,2022/4/15 17:30,550,121,429,
10876,115,2022/4/15 17:40,847,190,657,
10877,115,2022/4/15 17:50,1171,136,1035,
10878,115,2022/4/15 18:00,660,122,538,
10879,115,2022/4/15 18:10,838,222,616,
10880,115,2022/4/15 18:20,1044,110,934,
10881,115,2022/4/15 18:30,639,182,457,
10882,115,2022/4/15 18:40,455,181,274,
10883,115,2022/4/15 18:50,278,192,86,
10884,115,2022/4/15 19:00,198,105,93,
10885,115,2022/4/15 19:10,184,111,73,
10886,115,2022/4/15 19:20,115,120,-5,
10887,115,2022/4/15 19:30,77,101,-24,
10888,115,2022/4/15 19:40,72,106,-34,
10889,115,2022/4/15 19:50,67,106,-39,
10890,115,2022/4/15 20:00,46,77,-31,
10891,115,2022/4/15 20:10,50,97,-47,
10892,115,2022/4/15 20:20,43,72,-29,
10893,115,2022/4/15 20:30,39,85,-46,
10894,115,2022/4/15 20:40,42,76,-34,
10895,115,2022/4/15 20:50,39,84,-45,
10896,115,2022/4/15 21:00,30,62,-32,
10897,115,2022/4/15 21:10,33,74,-41,
10898,115,2022/4/15 21:20,26,74,-48,
10899,115,2022/4/15 21:30,27,65,-38,
10900,115,2022/4/15 21:40,28,70,-42,
10901,115,2022/4/15 21:50,26,74,-48,
10902,115,2022/4/15 22:00,25,64,-39,
10903,115,2022/4/15 22:10,28,67,-39,
10904,115,2022/4/15 22:20,20,66,-46,
10905,115,2022/4/15 22:30,16,71,-55,
10906,115,2022/4/15 22:40,11,62,-51,
10907,115,2022/4/15 22:50,6,52,-46,
10908,109,2022/4/15 5:00,0,1,-1,
10909,109,2022/4/15 5:10,0,1,-1,
10910,109,2022/4/15 5:20,3,1,2,
10911,109,2022/4/15 5:30,7,1,6,
10912,109,2022/4/15 5:40,17,1,16,
10913,109,2022/4/15 5:50,19,23,-4,
10914,109,2022/4/15 6:00,32,31,1,
10915,109,2022/4/15 6:10,35,36,-1,
10916,109,2022/4/15 6:20,43,65,-22,
10917,109,2022/4/15 6:30,61,76,-15,
10918,109,2022/4/15 6:40,101,90,11,
10919,109,2022/4/15 6:50,186,109,77,
10920,109,2022/4/15 7:00,223,110,113,
10921,109,2022/4/15 7:10,277,85,192,
10922,109,2022/4/15 7:20,275,104,171,
10923,109,2022/4/15 7:30,436,171,265,
10924,109,2022/4/15 7:40,630,214,416,
10925,109,2022/4/15 7:50,721,300,421,
10926,109,2022/4/15 8:00,717,524,193,
10927,109,2022/4/15 8:10,734,557,177,
10928,109,2022/4/15 8:20,682,1076,-394,
10929,109,2022/4/15 8:30,652,1718,-1066,
10930,109,2022/4/15 8:40,392,1494,-1102,
10931,109,2022/4/15 8:50,355,1103,-748,
10932,109,2022/4/15 9:00,277,417,-140,
10933,109,2022/4/15 9:10,232,436,-204,
10934,109,2022/4/15 9:20,192,330,-138,
10935,109,2022/4/15 9:30,143,229,-86,
10936,109,2022/4/15 9:40,106,304,-198,
10937,109,2022/4/15 9:50,72,178,-106,
10938,109,2022/4/15 10:00,54,118,-64,
10939,109,2022/4/15 10:10,59,121,-62,
10940,109,2022/4/15 10:20,53,110,-57,
10941,109,2022/4/15 10:30,51,105,-54,
10942,109,2022/4/15 10:40,46,121,-75,
10943,109,2022/4/15 10:50,47,99,-52,
10944,109,2022/4/15 11:00,48,97,-49,
10945,109,2022/4/15 11:10,44,80,-36,
10946,109,2022/4/15 11:20,45,100,-55,
10947,109,2022/4/15 11:30,45,87,-42,
10948,109,2022/4/15 11:40,56,105,-49,
10949,109,2022/4/15 11:50,59,91,-32,
10950,109,2022/4/15 12:00,57,87,-30,
10951,109,2022/4/15 12:10,65,89,-24,
10952,109,2022/4/15 12:20,71,111,-40,
10953,109,2022/4/15 12:30,67,126,-59,
10954,109,2022/4/15 12:40,72,109,-37,
10955,109,2022/4/15 12:50,54,105,-51,
10956,109,2022/4/15 13:00,62,110,-48,
10957,109,2022/4/15 13:10,62,90,-28,
10958,109,2022/4/15 13:20,73,117,-44,
10959,109,2022/4/15 13:30,66,126,-60,
10960,109,2022/4/15 13:40,57,108,-51,
10961,109,2022/4/15 13:50,62,110,-48,
10962,109,2022/4/15 14:00,66,104,-38,
10963,109,2022/4/15 14:10,64,101,-37,
10964,109,2022/4/15 14:20,68,110,-42,
10965,109,2022/4/15 14:30,59,96,-37,
10966,109,2022/4/15 14:40,63,109,-46,
10967,109,2022/4/15 14:50,70,101,-31,
10968,109,2022/4/15 15:00,76,90,-14,
10969,109,2022/4/15 15:10,92,95,-3,
10970,109,2022/4/15 15:20,94,104,-10,
10971,109,2022/4/15 15:30,84,114,-30,
10972,109,2022/4/15 15:40,75,109,-34,
10973,109,2022/4/15 15:50,87,105,-18,
10974,109,2022/4/15 16:00,92,102,-10,
10975,109,2022/4/15 16:10,133,100,33,
10976,109,2022/4/15 16:20,142,120,22,
10977,109,2022/4/15 16:30,179,117,62,
10978,109,2022/4/15 16:40,190,107,83,
10979,109,2022/4/15 16:50,211,104,107,
10980,109,2022/4/15 17:00,288,108,180,
10981,109,2022/4/15 17:10,641,181,460,
10982,109,2022/4/15 17:20,547,123,424,
10983,109,2022/4/15 17:30,368,232,136,
10984,109,2022/4/15 17:40,1046,233,813,
10985,109,2022/4/15 17:50,806,207,599,
10986,109,2022/4/15 18:00,697,253,444,
10987,109,2022/4/15 18:10,1163,270,893,
10988,109,2022/4/15 18:20,1162,179,983,
10989,109,2022/4/15 18:30,648,329,319,
10990,109,2022/4/15 18:40,568,228,340,
10991,109,2022/4/15 18:50,462,206,256,
10992,109,2022/4/15 19:00,307,192,115,
10993,109,2022/4/15 19:10,268,193,75,
10994,109,2022/4/15 19:20,225,111,114,
10995,109,2022/4/15 19:30,188,112,76,
10996,109,2022/4/15 19:40,137,109,28,
10997,109,2022/4/15 19:50,132,104,28,
10998,109,2022/4/15 20:00,110,99,11,
10999,109,2022/4/15 20:10,129,100,29,
11000,109,2022/4/15 20:20,84,95,-11,
11001,109,2022/4/15 20:30,73,95,-22,
11002,109,2022/4/15 20:40,74,82,-8,
11003,109,2022/4/15 20:50,75,101,-26,
11004,109,2022/4/15 21:00,70,78,-8,
11005,109,2022/4/15 21:10,67,87,-20,
11006,109,2022/4/15 21:20,85,89,-4,
11007,109,2022/4/15 21:30,56,99,-43,
11008,109,2022/4/15 21:40,42,92,-50,
11009,109,2022/4/15 21:50,38,89,-51,
11010,109,2022/4/15 22:00,38,78,-40,
11011,109,2022/4/15 22:10,27,83,-56,
11012,109,2022/4/15 22:20,26,95,-69,
11013,109,2022/4/15 22:30,22,78,-56,
11014,109,2022/4/15 22:40,16,70,-54,
11015,109,2022/4/15 22:50,9,83,-74,
11016,118,2022/4/15 5:00,0,1,-1,
11017,118,2022/4/15 5:10,0,1,-1,
11018,118,2022/4/15 5:20,0,1,-1,
11019,118,2022/4/15 5:30,16,1,15,
11020,118,2022/4/15 5:40,28,12,16,
11021,118,2022/4/15 5:50,32,32,0,
11022,118,2022/4/15 6:00,41,38,3,
11023,118,2022/4/15 6:10,58,56,2,
11024,118,2022/4/15 6:20,83,83,0,
11025,118,2022/4/15 6:30,157,93,64,
11026,118,2022/4/15 6:40,234,117,117,
11027,118,2022/4/15 6:50,247,108,139,
11028,118,2022/4/15 7:00,322,336,-14,
11029,118,2022/4/15 7:10,367,378,-11,
11030,118,2022/4/15 7:20,440,297,143,
11031,118,2022/4/15 7:30,688,331,357,
11032,118,2022/4/15 7:40,1057,320,737,
11033,118,2022/4/15 7:50,1055,377,678,
11034,118,2022/4/15 8:00,1190,296,894,
11035,118,2022/4/15 8:10,1181,371,810,
11036,118,2022/4/15 8:20,1183,330,853,
11037,118,2022/4/15 8:30,1054,493,561,
11038,118,2022/4/15 8:40,829,338,491,
11039,118,2022/4/15 8:50,721,526,195,
11040,118,2022/4/15 9:00,579,327,252,
11041,118,2022/4/15 9:10,466,377,89,
11042,118,2022/4/15 9:20,351,206,145,
11043,118,2022/4/15 9:30,277,290,-13,
11044,118,2022/4/15 9:40,247,152,95,
11045,118,2022/4/15 9:50,227,179,48,
11046,118,2022/4/15 10:00,213,142,71,
11047,118,2022/4/15 10:10,208,118,90,
11048,118,2022/4/15 10:20,176,108,68,
11049,118,2022/4/15 10:30,173,100,73,
11050,118,2022/4/15 10:40,173,117,56,
11051,118,2022/4/15 10:50,148,111,37,
11052,118,2022/4/15 11:00,169,106,63,
11053,118,2022/4/15 11:10,160,121,39,
11054,118,2022/4/15 11:20,173,110,63,
11055,118,2022/4/15 11:30,173,102,71,
11056,118,2022/4/15 11:40,153,120,33,
11057,118,2022/4/15 11:50,166,117,49,
11058,118,2022/4/15 12:00,167,120,47,
11059,118,2022/4/15 12:10,161,100,61,
11060,118,2022/4/15 12:20,168,102,66,
11061,118,2022/4/15 12:30,142,104,38,
11062,118,2022/4/15 12:40,144,128,16,
11063,118,2022/4/15 12:50,137,109,28,
11064,118,2022/4/15 13:00,141,119,22,
11065,118,2022/4/15 13:10,161,108,53,
11066,118,2022/4/15 13:20,173,121,52,
11067,118,2022/4/15 13:30,156,120,36,
11068,118,2022/4/15 13:40,176,128,48,
11069,118,2022/4/15 13:50,166,109,57,
11070,118,2022/4/15 14:00,156,110,46,
11071,118,2022/4/15 14:10,174,119,55,
11072,118,2022/4/15 14:20,176,107,69,
11073,118,2022/4/15 14:30,174,109,65,
11074,118,2022/4/15 14:40,175,169,6,
11075,118,2022/4/15 14:50,185,114,71,
11076,118,2022/4/15 15:00,271,131,140,
11077,118,2022/4/15 15:10,258,100,158,
11078,118,2022/4/15 15:20,236,138,98,
11079,118,2022/4/15 15:30,219,117,102,
11080,118,2022/4/15 15:40,260,138,122,
11081,118,2022/4/15 15:50,244,119,125,
11082,118,2022/4/15 16:00,225,127,98,
11083,118,2022/4/15 16:10,223,127,96,
11084,118,2022/4/15 16:20,228,118,110,
11085,118,2022/4/15 16:30,266,170,96,
11086,118,2022/4/15 16:40,305,226,79,
11087,118,2022/4/15 16:50,274,108,166,
11088,118,2022/4/15 17:00,311,193,118,
11089,118,2022/4/15 17:10,577,227,350,
11090,118,2022/4/15 17:20,325,325,0,
11091,118,2022/4/15 17:30,328,479,-151,
11092,118,2022/4/15 17:40,576,428,148,
11093,118,2022/4/15 17:50,311,410,-99,
11094,118,2022/4/15 18:00,308,564,-256,
11095,118,2022/4/15 18:10,568,520,48,
11096,118,2022/4/15 18:20,321,406,-85,
11097,118,2022/4/15 18:30,316,559,-243,
11098,118,2022/4/15 18:40,271,470,-199,
11099,118,2022/4/15 18:50,214,367,-153,
11100,118,2022/4/15 19:00,208,433,-225,
11101,118,2022/4/15 19:10,206,328,-122,
11102,118,2022/4/15 19:20,156,383,-227,
11103,118,2022/4/15 19:30,131,232,-101,
11104,118,2022/4/15 19:40,113,139,-26,
11105,118,2022/4/15 19:50,90,197,-107,
11106,118,2022/4/15 20:00,97,108,-11,
11107,118,2022/4/15 20:10,111,153,-42,
11108,118,2022/4/15 20:20,111,128,-17,
11109,118,2022/4/15 20:30,92,110,-18,
11110,118,2022/4/15 20:40,129,112,17,
11111,118,2022/4/15 20:50,86,109,-23,
11112,118,2022/4/15 21:00,94,109,-15,
11113,118,2022/4/15 21:10,78,105,-27,
11114,118,2022/4/15 21:20,68,102,-34,
11115,118,2022/4/15 21:30,67,108,-41,
11116,118,2022/4/15 21:40,63,110,-47,
11117,118,2022/4/15 21:50,41,123,-82,
11118,118,2022/4/15 22:00,42,70,-28,
11119,118,2022/4/15 22:10,62,118,-56,
11120,118,2022/4/15 22:20,30,93,-63,
11121,118,2022/4/15 22:30,25,100,-75,
11122,118,2022/4/15 22:40,21,113,-92,
11123,118,2022/4/15 22:50,14,120,-106,
11124,120,2022/4/15 5:00,0,1,-1,
11125,120,2022/4/15 5:10,0,1,-1,
11126,120,2022/4/15 5:20,3,1,2,
11127,120,2022/4/15 5:30,11,1,10,
11128,120,2022/4/15 5:40,20,6,14,
11129,120,2022/4/15 5:50,27,33,-6,
11130,120,2022/4/15 6:00,37,32,5,
11131,120,2022/4/15 6:10,45,23,22,
11132,120,2022/4/15 6:20,58,68,-10,
11133,120,2022/4/15 6:30,83,75,8,
11134,120,2022/4/15 6:40,109,108,1,
11135,120,2022/4/15 6:50,156,155,1,
11136,120,2022/4/15 7:00,195,181,14,
11137,120,2022/4/15 7:10,244,142,102,
11138,120,2022/4/15 7:20,254,115,139,
11139,120,2022/4/15 7:30,303,139,164,
11140,120,2022/4/15 7:40,573,133,440,
11141,120,2022/4/15 7:50,600,138,462,
11142,120,2022/4/15 8:00,627,196,431,
11143,120,2022/4/15 8:10,663,326,337,
11144,120,2022/4/15 8:20,632,221,411,
11145,120,2022/4/15 8:30,598,268,330,
11146,120,2022/4/15 8:40,474,206,268,
11147,120,2022/4/15 8:50,350,205,145,
11148,120,2022/4/15 9:00,273,121,152,
11149,120,2022/4/15 9:10,233,129,104,
11150,120,2022/4/15 9:20,213,121,92,
11151,120,2022/4/15 9:30,178,125,53,
11152,120,2022/4/15 9:40,120,126,-6,
11153,120,2022/4/15 9:50,90,110,-20,
11154,120,2022/4/15 10:00,69,92,-23,
11155,120,2022/4/15 10:10,67,106,-39,
11156,120,2022/4/15 10:20,59,99,-40,
11157,120,2022/4/15 10:30,47,91,-44,
11158,120,2022/4/15 10:40,57,68,-11,
11159,120,2022/4/15 10:50,47,105,-58,
11160,120,2022/4/15 11:00,50,101,-51,
11161,120,2022/4/15 11:10,55,96,-41,
11162,120,2022/4/15 11:20,45,75,-30,
11163,120,2022/4/15 11:30,44,84,-40,
11164,120,2022/4/15 11:40,55,80,-25,
11165,120,2022/4/15 11:50,46,103,-57,
11166,120,2022/4/15 12:00,58,102,-44,
11167,120,2022/4/15 12:10,59,99,-40,
11168,120,2022/4/15 12:20,63,84,-21,
11169,120,2022/4/15 12:30,60,90,-30,
11170,120,2022/4/15 12:40,57,81,-24,
11171,120,2022/4/15 12:50,59,105,-46,
11172,120,2022/4/15 13:00,60,109,-49,
11173,120,2022/4/15 13:10,62,100,-38,
11174,120,2022/4/15 13:20,62,80,-18,
11175,120,2022/4/15 13:30,45,84,-39,
11176,120,2022/4/15 13:40,44,87,-43,
11177,120,2022/4/15 13:50,50,102,-52,
11178,120,2022/4/15 14:00,44,109,-65,
11179,120,2022/4/15 14:10,45,97,-52,
11180,120,2022/4/15 14:20,44,90,-46,
11181,120,2022/4/15 14:30,46,73,-27,
11182,120,2022/4/15 14:40,45,101,-56,
11183,120,2022/4/15 14:50,41,99,-58,
11184,120,2022/4/15 15:00,51,100,-49,
11185,120,2022/4/15 15:10,55,99,-44,
11186,120,2022/4/15 15:20,53,110,-57,
11187,120,2022/4/15 15:30,57,94,-37,
11188,120,2022/4/15 15:40,58,105,-47,
11189,120,2022/4/15 15:50,51,99,-48,
11190,120,2022/4/15 16:00,74,104,-30,
11191,120,2022/4/15 16:10,72,104,-32,
11192,120,2022/4/15 16:20,73,109,-36,
11193,120,2022/4/15 16:30,75,97,-22,
11194,120,2022/4/15 16:40,100,109,-9,
11195,120,2022/4/15 16:50,130,117,13,
11196,120,2022/4/15 17:00,207,121,86,
11197,120,2022/4/15 17:10,313,137,176,
11198,120,2022/4/15 17:20,257,152,105,
11199,120,2022/4/15 17:30,292,283,9,
11200,120,2022/4/15 17:40,461,213,248,
11201,120,2022/4/15 17:50,289,182,107,
11202,120,2022/4/15 18:00,276,318,-42,
11203,120,2022/4/15 18:10,234,192,42,
11204,120,2022/4/15 18:20,207,321,-114,
11205,120,2022/4/15 18:30,170,365,-195,
11206,120,2022/4/15 18:40,114,321,-207,
11207,120,2022/4/15 18:50,73,140,-67,
11208,120,2022/4/15 19:00,76,316,-240,
11209,120,2022/4/15 19:10,55,106,-51,
11210,120,2022/4/15 19:20,54,179,-125,
11211,120,2022/4/15 19:30,44,111,-67,
11212,120,2022/4/15 19:40,44,121,-77,
11213,120,2022/4/15 19:50,42,108,-66,
11214,120,2022/4/15 20:00,41,121,-80,
11215,120,2022/4/15 20:10,44,98,-54,
11216,120,2022/4/15 20:20,41,91,-50,
11217,120,2022/4/15 20:30,35,122,-87,
11218,120,2022/4/15 20:40,36,125,-89,
11219,120,2022/4/15 20:50,34,111,-77,
11220,120,2022/4/15 21:00,35,116,-81,
11221,120,2022/4/15 21:10,31,104,-73,
11222,120,2022/4/15 21:20,35,110,-75,
11223,120,2022/4/15 21:30,27,104,-77,
11224,120,2022/4/15 21:40,25,108,-83,
11225,120,2022/4/15 21:50,29,107,-78,
11226,120,2022/4/15 22:00,28,105,-77,
11227,120,2022/4/15 22:10,26,103,-77,
11228,120,2022/4/15 22:20,21,97,-76,
11229,120,2022/4/15 22:30,16,106,-90,
11230,120,2022/4/15 22:40,13,79,-66,
11231,120,2022/4/15 22:50,8,73,-65,
11232,108,2022/4/15 5:00,3,1,2,
11233,108,2022/4/15 5:10,43,1,42,
11234,108,2022/4/15 5:20,39,16,23,
11235,108,2022/4/15 5:30,35,13,22,
11236,108,2022/4/15 5:40,33,25,8,
11237,108,2022/4/15 5:50,31,28,3,
11238,108,2022/4/15 6:00,27,111,-84,
11239,108,2022/4/15 6:10,36,124,-88,
11240,108,2022/4/15 6:20,49,130,-81,
11241,108,2022/4/15 6:30,181,152,29,
11242,108,2022/4/15 6:40,129,335,-206,
11243,108,2022/4/15 6:50,147,218,-71,
11244,108,2022/4/15 7:00,228,286,-58,
11245,108,2022/4/15 7:10,257,411,-154,
11246,108,2022/4/15 7:20,362,560,-198,
11247,108,2022/4/15 7:30,708,1415,-707,
11248,108,2022/4/15 7:40,916,1603,-687,
11249,108,2022/4/15 7:50,1039,2206,-1167,
11250,108,2022/4/15 8:00,1043,1834,-791,
11251,108,2022/4/15 8:10,1272,4865,-3593,
11252,108,2022/4/15 8:20,1049,6873,-5824,
11253,108,2022/4/15 8:30,1654,4451,-2797,
11254,108,2022/4/15 8:40,1423,5303,-3880,
11255,108,2022/4/15 8:50,1154,4613,-3459,
11256,108,2022/4/15 9:00,666,2292,-1626,
11257,108,2022/4/15 9:10,697,1754,-1057,
11258,108,2022/4/15 9:20,671,1492,-821,
11259,108,2022/4/15 9:30,582,553,29,
11260,108,2022/4/15 9:40,650,395,255,
11261,108,2022/4/15 9:50,352,392,-40,
11262,108,2022/4/15 10:00,316,495,-179,
11263,108,2022/4/15 10:10,376,500,-124,
11264,108,2022/4/15 10:20,592,377,215,
11265,108,2022/4/15 10:30,422,314,108,
11266,108,2022/4/15 10:40,546,529,17,
11267,108,2022/4/15 10:50,548,317,231,
11268,108,2022/4/15 11:00,267,318,-51,
11269,108,2022/4/15 11:10,264,291,-27,
11270,108,2022/4/15 11:20,308,330,-22,
11271,108,2022/4/15 11:30,304,285,19,
11272,108,2022/4/15 11:40,551,318,233,
11273,108,2022/4/15 11:50,295,323,-28,
11274,108,2022/4/15 12:00,316,319,-3,
11275,108,2022/4/15 12:10,327,308,19,
11276,108,2022/4/15 12:20,329,295,34,
11277,108,2022/4/15 12:30,349,312,37,
11278,108,2022/4/15 12:40,587,401,186,
11279,108,2022/4/15 12:50,300,365,-65,
11280,108,2022/4/15 13:00,343,349,-6,
11281,108,2022/4/15 13:10,310,419,-109,
11282,108,2022/4/15 13:20,285,301,-16,
11283,108,2022/4/15 13:30,288,309,-21,
11284,108,2022/4/15 13:40,633,322,311,
11285,108,2022/4/15 13:50,351,345,6,
11286,108,2022/4/15 14:00,297,302,-5,
11287,108,2022/4/15 14:10,353,272,81,
11288,108,2022/4/15 14:20,288,305,-17,
11289,108,2022/4/15 14:30,301,303,-2,
11290,108,2022/4/15 14:40,585,326,259,
11291,108,2022/4/15 14:50,344,317,27,
11292,108,2022/4/15 15:00,312,275,37,
11293,108,2022/4/15 15:10,584,339,245,
11294,108,2022/4/15 15:20,369,290,79,
11295,108,2022/4/15 15:30,549,297,252,
11296,108,2022/4/15 15:40,651,306,345,
11297,108,2022/4/15 15:50,616,339,277,
11298,108,2022/4/15 16:00,543,284,259,
11299,108,2022/4/15 16:10,592,285,307,
11300,108,2022/4/15 16:20,584,270,314,
11301,108,2022/4/15 16:30,807,506,301,
11302,108,2022/4/15 16:40,812,467,345,
11303,108,2022/4/15 16:50,713,306,407,
11304,108,2022/4/15 17:00,1145,384,761,
11305,108,2022/4/15 17:10,1584,400,1184,
11306,108,2022/4/15 17:20,1590,458,1132,
11307,108,2022/4/15 17:30,1360,549,811,
11308,108,2022/4/15 17:40,2478,455,2023,
11309,108,2022/4/15 17:50,1970,550,1420,
11310,108,2022/4/15 18:00,1995,1067,928,
11311,108,2022/4/15 18:10,1994,563,1431,
11312,108,2022/4/15 18:20,1993,1057,936,
11313,108,2022/4/15 18:30,1972,566,1406,
11314,108,2022/4/15 18:40,1969,560,1409,
11315,108,2022/4/15 18:50,1397,482,915,
11316,108,2022/4/15 19:00,1165,386,779,
11317,108,2022/4/15 19:10,831,456,375,
11318,108,2022/4/15 19:20,727,349,378,
11319,108,2022/4/15 19:30,636,293,343,
11320,108,2022/4/15 19:40,676,242,434,
11321,108,2022/4/15 19:50,431,198,233,
11322,108,2022/4/15 20:00,314,203,111,
11323,108,2022/4/15 20:10,271,179,92,
11324,108,2022/4/15 20:20,246,174,72,
11325,108,2022/4/15 20:30,325,182,143,
11326,108,2022/4/15 20:40,325,181,144,
11327,108,2022/4/15 20:50,206,141,65,
11328,108,2022/4/15 21:00,273,108,165,
11329,108,2022/4/15 21:10,192,140,52,
11330,108,2022/4/15 21:20,188,204,-16,
11331,108,2022/4/15 21:30,200,192,8,
11332,108,2022/4/15 21:40,244,170,74,
11333,108,2022/4/15 21:50,175,120,55,
11334,108,2022/4/15 22:00,225,119,106,
11335,108,2022/4/15 22:10,117,152,-35,
11336,108,2022/4/15 22:20,109,153,-44,
11337,108,2022/4/15 22:30,83,120,-37,
11338,108,2022/4/15 22:40,59,112,-53,
11339,108,2022/4/15 22:50,30,88,-58,
11340,99,2022/4/15 5:00,0,1,-1,
11341,99,2022/4/15 5:10,1,1,0,
11342,99,2022/4/15 5:20,5,1,4,
11343,99,2022/4/15 5:30,6,2,4,
11344,99,2022/4/15 5:40,13,5,8,
11345,99,2022/4/15 5:50,16,12,4,
11346,99,2022/4/15 6:00,14,31,-17,
11347,99,2022/4/15 6:10,20,33,-13,
11348,99,2022/4/15 6:20,28,41,-13,
11349,99,2022/4/15 6:30,35,51,-16,
11350,99,2022/4/15 6:40,37,69,-32,
11351,99,2022/4/15 6:50,45,70,-25,
11352,99,2022/4/15 7:00,54,76,-22,
11353,99,2022/4/15 7:10,56,111,-55,
11354,99,2022/4/15 7:20,55,107,-52,
11355,99,2022/4/15 7:30,76,110,-34,
11356,99,2022/4/15 7:40,97,182,-85,
11357,99,2022/4/15 7:50,149,282,-133,
11358,99,2022/4/15 8:00,184,505,-321,
11359,99,2022/4/15 8:10,189,567,-378,
11360,99,2022/4/15 8:20,217,1091,-874,
11361,99,2022/4/15 8:30,221,1478,-1257,
11362,99,2022/4/15 8:40,238,2339,-2101,
11363,99,2022/4/15 8:50,238,2280,-2042,
11364,99,2022/4/15 9:00,207,1797,-1590,
11365,99,2022/4/15 9:10,192,1095,-903,
11366,99,2022/4/15 9:20,150,407,-257,
11367,99,2022/4/15 9:30,137,511,-374,
11368,99,2022/4/15 9:40,144,333,-189,
11369,99,2022/4/15 9:50,82,204,-122,
11370,99,2022/4/15 10:00,74,192,-118,
11371,99,2022/4/15 10:10,75,142,-67,
11372,99,2022/4/15 10:20,73,109,-36,
11373,99,2022/4/15 10:30,74,121,-47,
11374,99,2022/4/15 10:40,72,86,-14,
11375,99,2022/4/15 10:50,73,116,-43,
11376,99,2022/4/15 11:00,74,105,-31,
11377,99,2022/4/15 11:10,70,105,-35,
11378,99,2022/4/15 11:20,70,104,-34,
11379,99,2022/4/15 11:30,77,105,-28,
11380,99,2022/4/15 11:40,71,98,-27,
11381,99,2022/4/15 11:50,64,90,-26,
11382,99,2022/4/15 12:00,65,110,-45,
11383,99,2022/4/15 12:10,72,106,-34,
11384,99,2022/4/15 12:20,76,105,-29,
11385,99,2022/4/15 12:30,64,110,-46,
11386,99,2022/4/15 12:40,58,104,-46,
11387,99,2022/4/15 12:50,64,119,-55,
11388,99,2022/4/15 13:00,62,108,-46,
11389,99,2022/4/15 13:10,77,108,-31,
11390,99,2022/4/15 13:20,76,102,-26,
11391,99,2022/4/15 13:30,77,122,-45,
11392,99,2022/4/15 13:40,86,123,-37,
11393,99,2022/4/15 13:50,76,100,-24,
11394,99,2022/4/15 14:00,82,110,-28,
11395,99,2022/4/15 14:10,81,101,-20,
11396,99,2022/4/15 14:20,77,105,-28,
11397,99,2022/4/15 14:30,83,112,-29,
11398,99,2022/4/15 14:40,80,112,-32,
11399,99,2022/4/15 14:50,81,103,-22,
11400,99,2022/4/15 15:00,102,105,-3,
11401,99,2022/4/15 15:10,126,108,18,
11402,99,2022/4/15 15:20,92,109,-17,
11403,99,2022/4/15 15:30,79,99,-20,
11404,99,2022/4/15 15:40,134,111,23,
11405,99,2022/4/15 15:50,157,110,47,
11406,99,2022/4/15 16:00,173,112,61,
11407,99,2022/4/15 16:10,172,99,73,
11408,99,2022/4/15 16:20,145,106,39,
11409,99,2022/4/15 16:30,205,111,94,
11410,99,2022/4/15 16:40,216,109,107,
11411,99,2022/4/15 16:50,265,105,160,
11412,99,2022/4/15 17:00,651,105,546,
11413,99,2022/4/15 17:10,712,101,611,
11414,99,2022/4/15 17:20,574,125,449,
11415,99,2022/4/15 17:30,828,126,702,
11416,99,2022/4/15 17:40,1358,115,1243,
11417,99,2022/4/15 17:50,824,121,703,
11418,99,2022/4/15 18:00,1038,110,928,
11419,99,2022/4/15 18:10,1361,119,1242,
11420,99,2022/4/15 18:20,819,104,715,
11421,99,2022/4/15 18:30,607,124,483,
11422,99,2022/4/15 18:40,461,112,349,
11423,99,2022/4/15 18:50,270,114,156,
11424,99,2022/4/15 19:00,240,120,120,
11425,99,2022/4/15 19:10,222,110,112,
11426,99,2022/4/15 19:20,161,102,59,
11427,99,2022/4/15 19:30,131,89,42,
11428,99,2022/4/15 19:40,88,84,4,
11429,99,2022/4/15 19:50,70,83,-13,
11430,99,2022/4/15 20:00,77,76,1,
11431,99,2022/4/15 20:10,68,76,-8,
11432,99,2022/4/15 20:20,55,62,-7,
11433,99,2022/4/15 20:30,49,69,-20,
11434,99,2022/4/15 20:40,49,82,-33,
11435,99,2022/4/15 20:50,44,72,-28,
11436,99,2022/4/15 21:00,42,76,-34,
11437,99,2022/4/15 21:10,42,83,-41,
11438,99,2022/4/15 21:20,42,64,-22,
11439,99,2022/4/15 21:30,30,80,-50,
11440,99,2022/4/15 21:40,33,70,-37,
11441,99,2022/4/15 21:50,35,80,-45,
11442,99,2022/4/15 22:00,29,70,-41,
11443,99,2022/4/15 22:10,29,80,-51,
11444,99,2022/4/15 22:20,24,76,-52,
11445,99,2022/4/15 22:30,18,66,-48,
11446,99,2022/4/15 22:40,17,55,-38,
11447,99,2022/4/15 22:50,12,38,-26,
11448,102,2022/4/15 5:00,3,1,2,
11449,102,2022/4/15 5:10,7,5,2,
11450,102,2022/4/15 5:20,12,11,1,
11451,102,2022/4/15 5:30,15,8,7,
11452,102,2022/4/15 5:40,12,8,4,
11453,102,2022/4/15 5:50,16,25,-9,
11454,102,2022/4/15 6:00,21,69,-48,
11455,102,2022/4/15 6:10,23,66,-43,
11456,102,2022/4/15 6:20,34,63,-29,
11457,102,2022/4/15 6:30,32,97,-65,
11458,102,2022/4/15 6:40,38,101,-63,
11459,102,2022/4/15 6:50,41,117,-76,
11460,102,2022/4/15 7:00,47,106,-59,
11461,102,2022/4/15 7:10,53,142,-89,
11462,102,2022/4/15 7:20,58,230,-172,
11463,102,2022/4/15 7:30,60,325,-265,
11464,102,2022/4/15 7:40,83,507,-424,
11465,102,2022/4/15 7:50,76,417,-341,
11466,102,2022/4/15 8:00,99,878,-779,
11467,102,2022/4/15 8:10,150,2212,-2062,
11468,102,2022/4/15 8:20,167,2866,-2699,
11469,102,2022/4/15 8:30,150,2532,-2382,
11470,102,2022/4/15 8:40,128,4979,-4851,
11471,102,2022/4/15 8:50,128,5856,-5728,
11472,102,2022/4/15 9:00,108,5302,-5194,
11473,102,2022/4/15 9:10,139,2931,-2792,
11474,102,2022/4/15 9:20,88,3128,-3040,
11475,102,2022/4/15 9:30,79,1701,-1622,
11476,102,2022/4/15 9:40,92,1707,-1615,
11477,102,2022/4/15 9:50,71,719,-648,
11478,102,2022/4/15 10:00,74,430,-356,
11479,102,2022/4/15 10:10,75,374,-299,
11480,102,2022/4/15 10:20,79,332,-253,
11481,102,2022/4/15 10:30,73,298,-225,
11482,102,2022/4/15 10:40,109,281,-172,
11483,102,2022/4/15 10:50,82,177,-95,
11484,102,2022/4/15 11:00,128,227,-99,
11485,102,2022/4/15 11:10,89,139,-50,
11486,102,2022/4/15 11:20,113,153,-40,
11487,102,2022/4/15 11:30,136,170,-34,
11488,102,2022/4/15 11:40,141,192,-51,
11489,102,2022/4/15 11:50,137,146,-9,
11490,102,2022/4/15 12:00,137,146,-9,
11491,102,2022/4/15 12:10,162,117,45,
11492,102,2022/4/15 12:20,147,184,-37,
11493,102,2022/4/15 12:30,131,181,-50,
11494,102,2022/4/15 12:40,138,146,-8,
11495,102,2022/4/15 12:50,141,214,-73,
11496,102,2022/4/15 13:00,156,179,-23,
11497,102,2022/4/15 13:10,156,185,-29,
11498,102,2022/4/15 13:20,179,226,-47,
11499,102,2022/4/15 13:30,188,198,-10,
11500,102,2022/4/15 13:40,179,214,-35,
11501,102,2022/4/15 13:50,197,181,16,
11502,102,2022/4/15 14:00,206,184,22,
11503,102,2022/4/15 14:10,207,152,55,
11504,102,2022/4/15 14:20,205,152,53,
11505,102,2022/4/15 14:30,207,123,84,
11506,102,2022/4/15 14:40,191,110,81,
11507,102,2022/4/15 14:50,197,128,69,
11508,102,2022/4/15 15:00,208,133,75,
11509,102,2022/4/15 15:10,220,110,110,
11510,102,2022/4/15 15:20,238,105,133,
11511,102,2022/4/15 15:30,242,129,113,
11512,102,2022/4/15 15:40,269,125,144,
11513,102,2022/4/15 15:50,258,109,149,
11514,102,2022/4/15 16:00,267,108,159,
11515,102,2022/4/15 16:10,333,110,223,
11516,102,2022/4/15 16:20,311,108,203,
11517,102,2022/4/15 16:30,345,128,217,
11518,102,2022/4/15 16:40,428,105,323,
11519,102,2022/4/15 16:50,454,109,345,
11520,102,2022/4/15 17:00,712,115,597,
11521,102,2022/4/15 17:10,1140,152,988,
11522,102,2022/4/15 17:20,803,180,623,
11523,102,2022/4/15 17:30,1196,197,999,
11524,102,2022/4/15 17:40,1978,225,1753,
11525,102,2022/4/15 17:50,1352,217,1135,
11526,102,2022/4/15 18:00,1972,231,1741,
11527,102,2022/4/15 18:10,3023,219,2804,
11528,102,2022/4/15 18:20,1987,235,1752,
11529,102,2022/4/15 18:30,1359,256,1103,
11530,102,2022/4/15 18:40,1197,234,963,
11531,102,2022/4/15 18:50,1036,179,857,
11532,102,2022/4/15 19:00,803,181,622,
11533,102,2022/4/15 19:10,625,127,498,
11534,102,2022/4/15 19:20,566,125,441,
11535,102,2022/4/15 19:30,429,124,305,
11536,102,2022/4/15 19:40,310,104,206,
11537,102,2022/4/15 19:50,333,107,226,
11538,102,2022/4/15 20:00,327,96,231,
11539,102,2022/4/15 20:10,358,89,269,
11540,102,2022/4/15 20:20,316,95,221,
11541,102,2022/4/15 20:30,309,77,232,
11542,102,2022/4/15 20:40,331,77,254,
11543,102,2022/4/15 20:50,272,78,194,
11544,102,2022/4/15 21:00,319,75,244,
11545,102,2022/4/15 21:10,339,75,264,
11546,102,2022/4/15 21:20,317,80,237,
11547,102,2022/4/15 21:30,267,77,190,
11548,102,2022/4/15 21:40,267,72,195,
11549,102,2022/4/15 21:50,249,78,171,
11550,102,2022/4/15 22:00,595,74,521,
11551,102,2022/4/15 22:10,265,75,190,
11552,102,2022/4/15 22:20,131,83,48,
11553,102,2022/4/15 22:30,65,73,-8,
11554,102,2022/4/15 22:40,41,68,-27,
11555,102,2022/4/15 22:50,23,55,-32,
11556,107,2022/4/15 5:00,1,2,-1,
11557,107,2022/4/15 5:10,2,1,1,
11558,107,2022/4/15 5:20,4,2,2,
11559,107,2022/4/15 5:30,10,14,-4,
11560,107,2022/4/15 5:40,12,23,-11,
11561,107,2022/4/15 5:50,18,33,-15,
11562,107,2022/4/15 6:00,23,48,-25,
11563,107,2022/4/15 6:10,31,80,-49,
11564,107,2022/4/15 6:20,29,107,-78,
11565,107,2022/4/15 6:30,49,108,-59,
11566,107,2022/4/15 6:40,57,119,-62,
11567,107,2022/4/15 6:50,65,223,-158,
11568,107,2022/4/15 7:00,71,317,-246,
11569,107,2022/4/15 7:10,97,500,-403,
11570,107,2022/4/15 7:20,151,438,-287,
11571,107,2022/4/15 7:30,182,431,-249,
11572,107,2022/4/15 7:40,184,475,-291,
11573,107,2022/4/15 7:50,259,605,-346,
11574,107,2022/4/15 8:00,281,1172,-891,
11575,107,2022/4/15 8:10,361,1931,-1570,
11576,107,2022/4/15 8:20,339,2046,-1707,
11577,107,2022/4/15 8:30,357,2230,-1873,
11578,107,2022/4/15 8:40,357,2489,-2132,
11579,107,2022/4/15 8:50,280,2760,-2480,
11580,107,2022/4/15 9:00,271,2275,-2004,
11581,107,2022/4/15 9:10,248,2946,-2698,
11582,107,2022/4/15 9:20,228,1726,-1498,
11583,107,2022/4/15 9:30,192,565,-373,
11584,107,2022/4/15 9:40,188,578,-390,
11585,107,2022/4/15 9:50,174,391,-217,
11586,107,2022/4/15 10:00,173,421,-248,
11587,107,2022/4/15 10:10,171,427,-256,
11588,107,2022/4/15 10:20,176,320,-144,
11589,107,2022/4/15 10:30,173,432,-259,
11590,107,2022/4/15 10:40,178,334,-156,
11591,107,2022/4/15 10:50,181,319,-138,
11592,107,2022/4/15 11:00,173,282,-109,
11593,107,2022/4/15 11:10,203,266,-63,
11594,107,2022/4/15 11:20,172,232,-60,
11595,107,2022/4/15 11:30,203,268,-65,
11596,107,2022/4/15 11:40,208,283,-75,
11597,107,2022/4/15 11:50,216,284,-68,
11598,107,2022/4/15 12:00,222,231,-9,
11599,107,2022/4/15 12:10,234,267,-33,
11600,107,2022/4/15 12:20,236,231,5,
11601,107,2022/4/15 12:30,227,268,-41,
11602,107,2022/4/15 12:40,233,326,-93,
11603,107,2022/4/15 12:50,242,333,-91,
11604,107,2022/4/15 13:00,271,295,-24,
11605,107,2022/4/15 13:10,272,331,-59,
11606,107,2022/4/15 13:20,268,317,-49,
11607,107,2022/4/15 13:30,269,282,-13,
11608,107,2022/4/15 13:40,270,335,-65,
11609,107,2022/4/15 13:50,265,298,-33,
11610,107,2022/4/15 14:00,288,283,5,
11611,107,2022/4/15 14:10,334,254,80,
11612,107,2022/4/15 14:20,315,225,90,
11613,107,2022/4/15 14:30,336,196,140,
11614,107,2022/4/15 14:40,334,231,103,
11615,107,2022/4/15 14:50,327,218,109,
11616,107,2022/4/15 15:00,349,208,141,
11617,107,2022/4/15 15:10,350,181,169,
11618,107,2022/4/15 15:20,429,208,221,
11619,107,2022/4/15 15:30,461,233,228,
11620,107,2022/4/15 15:40,550,198,352,
11621,107,2022/4/15 15:50,576,226,350,
11622,107,2022/4/15 16:00,572,207,365,
11623,107,2022/4/15 16:10,637,180,457,
11624,107,2022/4/15 16:20,587,198,389,
11625,107,2022/4/15 16:30,638,180,458,
11626,107,2022/4/15 16:40,658,234,424,
11627,107,2022/4/15 16:50,657,197,460,
11628,107,2022/4/15 17:00,843,230,613,
11629,107,2022/4/15 17:10,1206,316,890,
11630,107,2022/4/15 17:20,1157,328,829,
11631,107,2022/4/15 17:30,1156,336,820,
11632,107,2022/4/15 17:40,1592,431,1161,
11633,107,2022/4/15 17:50,1360,498,862,
11634,107,2022/4/15 18:00,1585,492,1093,
11635,107,2022/4/15 18:10,1996,427,1569,
11636,107,2022/4/15 18:20,1564,425,1139,
11637,107,2022/4/15 18:30,1585,416,1169,
11638,107,2022/4/15 18:40,1351,520,831,
11639,107,2022/4/15 18:50,1160,370,790,
11640,107,2022/4/15 19:00,816,321,495,
11641,107,2022/4/15 19:10,659,279,380,
11642,107,2022/4/15 19:20,616,180,436,
11643,107,2022/4/15 19:30,579,137,442,
11644,107,2022/4/15 19:40,457,120,337,
11645,107,2022/4/15 19:50,350,124,226,
11646,107,2022/4/15 20:00,422,126,296,
11647,107,2022/4/15 20:10,578,105,473,
11648,107,2022/4/15 20:20,455,106,349,
11649,107,2022/4/15 20:30,422,98,324,
11650,107,2022/4/15 20:40,592,108,484,
11651,107,2022/4/15 20:50,457,100,357,
11652,107,2022/4/15 21:00,597,106,491,
11653,107,2022/4/15 21:10,641,109,532,
11654,107,2022/4/15 21:20,573,106,467,
11655,107,2022/4/15 21:30,570,111,459,
11656,107,2022/4/15 21:40,573,108,465,
11657,107,2022/4/15 21:50,582,112,470,
11658,107,2022/4/15 22:00,674,97,577,
11659,107,2022/4/15 22:10,842,102,740,
11660,107,2022/4/15 22:20,272,82,190,
11661,107,2022/4/15 22:30,159,70,89,
11662,107,2022/4/15 22:40,70,72,-2,
11663,107,2022/4/15 22:50,34,52,-18,
11664,95,2022/4/15 5:00,2,1,1,
11665,95,2022/4/15 5:10,4,1,3,
11666,95,2022/4/15 5:20,8,1,7,
11667,95,2022/4/15 5:30,7,1,6,
11668,95,2022/4/15 5:40,7,5,2,
11669,95,2022/4/15 5:50,9,19,-10,
11670,95,2022/4/15 6:00,7,23,-16,
11671,95,2022/4/15 6:10,13,53,-40,
11672,95,2022/4/15 6:20,14,74,-60,
11673,95,2022/4/15 6:30,22,73,-51,
11674,95,2022/4/15 6:40,29,102,-73,
11675,95,2022/4/15 6:50,31,109,-78,
11676,95,2022/4/15 7:00,36,108,-72,
11677,95,2022/4/15 7:10,36,112,-76,
11678,95,2022/4/15 7:20,35,152,-117,
11679,95,2022/4/15 7:30,32,227,-195,
11680,95,2022/4/15 7:40,34,256,-222,
11681,95,2022/4/15 7:50,38,299,-261,
11682,95,2022/4/15 8:00,54,267,-213,
11683,95,2022/4/15 8:10,52,332,-280,
11684,95,2022/4/15 8:20,57,316,-259,
11685,95,2022/4/15 8:30,57,436,-379,
11686,95,2022/4/15 8:40,51,422,-371,
11687,95,2022/4/15 8:50,55,503,-448,
11688,95,2022/4/15 9:00,42,318,-276,
11689,95,2022/4/15 9:10,43,284,-241,
11690,95,2022/4/15 9:20,38,256,-218,
11691,95,2022/4/15 9:30,40,192,-152,
11692,95,2022/4/15 9:40,39,150,-111,
11693,95,2022/4/15 9:50,37,108,-71,
11694,95,2022/4/15 10:00,35,99,-64,
11695,95,2022/4/15 10:10,30,111,-81,
11696,95,2022/4/15 10:20,29,103,-74,
11697,95,2022/4/15 10:30,33,109,-76,
11698,95,2022/4/15 10:40,29,106,-77,
11699,95,2022/4/15 10:50,28,93,-65,
11700,95,2022/4/15 11:00,27,93,-66,
11701,95,2022/4/15 11:10,33,81,-48,
11702,95,2022/4/15 11:20,37,76,-39,
11703,95,2022/4/15 11:30,29,75,-46,
11704,95,2022/4/15 11:40,30,91,-61,
11705,95,2022/4/15 11:50,30,75,-45,
11706,95,2022/4/15 12:00,32,73,-41,
11707,95,2022/4/15 12:10,31,76,-45,
11708,95,2022/4/15 12:20,29,77,-48,
11709,95,2022/4/15 12:30,31,91,-60,
11710,95,2022/4/15 12:40,31,108,-77,
11711,95,2022/4/15 12:50,36,98,-62,
11712,95,2022/4/15 13:00,29,105,-76,
11713,95,2022/4/15 13:10,31,101,-70,
11714,95,2022/4/15 13:20,30,109,-79,
11715,95,2022/4/15 13:30,32,93,-61,
11716,95,2022/4/15 13:40,32,93,-61,
11717,95,2022/4/15 13:50,32,88,-56,
11718,95,2022/4/15 14:00,37,94,-57,
11719,95,2022/4/15 14:10,38,76,-38,
11720,95,2022/4/15 14:20,38,76,-38,
11721,95,2022/4/15 14:30,37,76,-39,
11722,95,2022/4/15 14:40,40,81,-41,
11723,95,2022/4/15 14:50,37,76,-39,
11724,95,2022/4/15 15:00,41,75,-34,
11725,95,2022/4/15 15:10,41,84,-43,
11726,95,2022/4/15 15:20,44,81,-37,
11727,95,2022/4/15 15:30,55,77,-22,
11728,95,2022/4/15 15:40,50,75,-25,
11729,95,2022/4/15 15:50,56,85,-29,
11730,95,2022/4/15 16:00,57,76,-19,
11731,95,2022/4/15 16:10,68,72,-4,
11732,95,2022/4/15 16:20,64,71,-7,
11733,95,2022/4/15 16:30,83,86,-3,
11734,95,2022/4/15 16:40,140,79,61,
11735,95,2022/4/15 16:50,242,74,168,
11736,95,2022/4/15 17:00,325,85,240,
11737,95,2022/4/15 17:10,344,76,268,
11738,95,2022/4/15 17:20,224,90,134,
11739,95,2022/4/15 17:30,270,98,172,
11740,95,2022/4/15 17:40,344,110,234,
11741,95,2022/4/15 17:50,230,104,126,
11742,95,2022/4/15 18:00,240,106,134,
11743,95,2022/4/15 18:10,352,107,245,
11744,95,2022/4/15 18:20,249,104,145,
11745,95,2022/4/15 18:30,170,105,65,
11746,95,2022/4/15 18:40,139,104,35,
11747,95,2022/4/15 18:50,81,96,-15,
11748,95,2022/4/15 19:00,65,78,-13,
11749,95,2022/4/15 19:10,55,81,-26,
11750,95,2022/4/15 19:20,43,77,-34,
11751,95,2022/4/15 19:30,43,64,-21,
11752,95,2022/4/15 19:40,38,69,-31,
11753,95,2022/4/15 19:50,37,58,-21,
11754,95,2022/4/15 20:00,36,58,-22,
11755,95,2022/4/15 20:10,37,54,-17,
11756,95,2022/4/15 20:20,30,55,-25,
11757,95,2022/4/15 20:30,33,49,-16,
11758,95,2022/4/15 20:40,31,43,-12,
11759,95,2022/4/15 20:50,31,52,-21,
11760,95,2022/4/15 21:00,25,48,-23,
11761,95,2022/4/15 21:10,35,52,-17,
11762,95,2022/4/15 21:20,25,61,-36,
11763,95,2022/4/15 21:30,29,51,-22,
11764,95,2022/4/15 21:40,25,50,-25,
11765,95,2022/4/15 21:50,26,51,-25,
11766,95,2022/4/15 22:00,26,47,-21,
11767,95,2022/4/15 22:10,24,49,-25,
11768,95,2022/4/15 22:20,23,49,-26,
11769,95,2022/4/15 22:30,18,34,-16,
11770,95,2022/4/15 22:40,15,32,-17,
11771,95,2022/4/15 22:50,10,25,-15,
11772,100,2022/4/15 5:00,0,1,-1,
11773,100,2022/4/15 5:10,2,1,1,
11774,100,2022/4/15 5:20,3,1,2,
11775,100,2022/4/15 5:30,5,1,4,
11776,100,2022/4/15 5:40,9,5,4,
11777,100,2022/4/15 5:50,6,6,0,
11778,100,2022/4/15 6:00,6,21,-15,
11779,100,2022/4/15 6:10,10,32,-22,
11780,100,2022/4/15 6:20,19,46,-27,
11781,100,2022/4/15 6:30,23,50,-27,
11782,100,2022/4/15 6:40,30,71,-41,
11783,100,2022/4/15 6:50,33,106,-73,
11784,100,2022/4/15 7:00,37,109,-72,
11785,100,2022/4/15 7:10,46,139,-93,
11786,100,2022/4/15 7:20,38,117,-79,
11787,100,2022/4/15 7:30,42,154,-112,
11788,100,2022/4/15 7:40,41,227,-186,
11789,100,2022/4/15 7:50,59,208,-149,
11790,100,2022/4/15 8:00,64,208,-144,
11791,100,2022/4/15 8:10,63,226,-163,
11792,100,2022/4/15 8:20,57,192,-135,
11793,100,2022/4/15 8:30,60,218,-158,
11794,100,2022/4/15 8:40,58,284,-226,
11795,100,2022/4/15 8:50,54,198,-144,
11796,100,2022/4/15 9:00,41,144,-103,
11797,100,2022/4/15 9:10,40,117,-77,
11798,100,2022/4/15 9:20,33,121,-88,
11799,100,2022/4/15 9:30,30,124,-94,
11800,100,2022/4/15 9:40,28,102,-74,
11801,100,2022/4/15 9:50,29,105,-76,
11802,100,2022/4/15 10:00,26,96,-70,
11803,100,2022/4/15 10:10,28,76,-48,
11804,100,2022/4/15 10:20,28,76,-48,
11805,100,2022/4/15 10:30,29,73,-44,
11806,100,2022/4/15 10:40,28,83,-55,
11807,100,2022/4/15 10:50,29,64,-35,
11808,100,2022/4/15 11:00,27,70,-43,
11809,100,2022/4/15 11:10,28,66,-38,
11810,100,2022/4/15 11:20,28,75,-47,
11811,100,2022/4/15 11:30,29,72,-43,
11812,100,2022/4/15 11:40,27,70,-43,
11813,100,2022/4/15 11:50,28,63,-35,
11814,100,2022/4/15 12:00,29,71,-42,
11815,100,2022/4/15 12:10,27,66,-39,
11816,100,2022/4/15 12:20,27,71,-44,
11817,100,2022/4/15 12:30,25,68,-43,
11818,100,2022/4/15 12:40,28,76,-48,
11819,100,2022/4/15 12:50,28,77,-49,
11820,100,2022/4/15 13:00,28,75,-47,
11821,100,2022/4/15 13:10,30,76,-46,
11822,100,2022/4/15 13:20,30,89,-59,
11823,100,2022/4/15 13:30,30,93,-63,
11824,100,2022/4/15 13:40,29,77,-48,
11825,100,2022/4/15 13:50,32,77,-45,
11826,100,2022/4/15 14:00,24,85,-61,
11827,100,2022/4/15 14:10,31,81,-50,
11828,100,2022/4/15 14:20,27,81,-54,
11829,100,2022/4/15 14:30,30,71,-41,
11830,100,2022/4/15 14:40,32,77,-45,
11831,100,2022/4/15 14:50,33,72,-39,
11832,100,2022/4/15 15:00,41,69,-28,
11833,100,2022/4/15 15:10,40,83,-43,
11834,100,2022/4/15 15:20,42,75,-33,
11835,100,2022/4/15 15:30,43,82,-39,
11836,100,2022/4/15 15:40,38,73,-35,
11837,100,2022/4/15 15:50,42,85,-43,
11838,100,2022/4/15 16:00,59,69,-10,
11839,100,2022/4/15 16:10,59,69,-10,
11840,100,2022/4/15 16:20,57,74,-17,
11841,100,2022/4/15 16:30,129,69,60,
11842,100,2022/4/15 16:40,195,85,110,
11843,100,2022/4/15 16:50,162,76,86,
11844,100,2022/4/15 17:00,201,77,124,
11845,100,2022/4/15 17:10,293,75,218,
11846,100,2022/4/15 17:20,271,97,174,
11847,100,2022/4/15 17:30,264,102,162,
11848,100,2022/4/15 17:40,274,105,169,
11849,100,2022/4/15 17:50,177,106,71,
11850,100,2022/4/15 18:00,173,89,84,
11851,100,2022/4/15 18:10,224,108,116,
11852,100,2022/4/15 18:20,174,106,68,
11853,100,2022/4/15 18:30,99,104,-5,
11854,100,2022/4/15 18:40,75,104,-29,
11855,100,2022/4/15 18:50,55,105,-50,
11856,100,2022/4/15 19:00,44,105,-61,
11857,100,2022/4/15 19:10,47,89,-42,
11858,100,2022/4/15 19:20,39,80,-41,
11859,100,2022/4/15 19:30,35,73,-38,
11860,100,2022/4/15 19:40,32,80,-48,
11861,100,2022/4/15 19:50,29,68,-39,
11862,100,2022/4/15 20:00,38,61,-23,
11863,100,2022/4/15 20:10,36,62,-26,
11864,100,2022/4/15 20:20,42,59,-17,
11865,100,2022/4/15 20:30,30,62,-32,
11866,100,2022/4/15 20:40,36,64,-28,
11867,100,2022/4/15 20:50,32,56,-24,
11868,100,2022/4/15 21:00,28,57,-29,
11869,100,2022/4/15 21:10,29,62,-33,
11870,100,2022/4/15 21:20,33,53,-20,
11871,100,2022/4/15 21:30,26,66,-40,
11872,100,2022/4/15 21:40,23,62,-39,
11873,100,2022/4/15 21:50,27,56,-29,
11874,100,2022/4/15 22:00,26,52,-26,
11875,100,2022/4/15 22:10,25,55,-30,
11876,100,2022/4/15 22:20,22,50,-28,
11877,100,2022/4/15 22:30,22,45,-23,
11878,100,2022/4/15 22:40,14,38,-24,
11879,100,2022/4/15 22:50,4,25,-21,
11880,117,2022/4/15 5:00,2,1,1,
11881,117,2022/4/15 5:10,5,1,4,
11882,117,2022/4/15 5:20,7,1,6,
11883,117,2022/4/15 5:30,8,2,6,
11884,117,2022/4/15 5:40,15,22,-7,
11885,117,2022/4/15 5:50,22,16,6,
11886,117,2022/4/15 6:00,25,21,4,
11887,117,2022/4/15 6:10,32,68,-36,
11888,117,2022/4/15 6:20,32,70,-38,
11889,117,2022/4/15 6:30,36,104,-68,
11890,117,2022/4/15 6:40,58,114,-56,
11891,117,2022/4/15 6:50,60,159,-99,
11892,117,2022/4/15 7:00,85,195,-110,
11893,117,2022/4/15 7:10,128,435,-307,
11894,117,2022/4/15 7:20,157,435,-278,
11895,117,2022/4/15 7:30,215,509,-294,
11896,117,2022/4/15 7:40,234,421,-187,
11897,117,2022/4/15 7:50,279,588,-309,
11898,117,2022/4/15 8:00,277,1550,-1273,
11899,117,2022/4/15 8:10,346,3229,-2883,
11900,117,2022/4/15 8:20,344,4136,-3792,
11901,117,2022/4/15 8:30,334,6610,-6276,
11902,117,2022/4/15 8:40,316,7797,-7481,
11903,117,2022/4/15 8:50,286,6941,-6655,
11904,117,2022/4/15 9:00,277,6583,-6306,
11905,117,2022/4/15 9:10,260,4899,-4639,
11906,117,2022/4/15 9:20,239,2864,-2625,
11907,117,2022/4/15 9:30,232,2192,-1960,
11908,117,2022/4/15 9:40,225,1713,-1488,
11909,117,2022/4/15 9:50,207,1208,-1001,
11910,117,2022/4/15 10:00,223,556,-333,
11911,117,2022/4/15 10:10,232,416,-184,
11912,117,2022/4/15 10:20,254,434,-180,
11913,117,2022/4/15 10:30,273,422,-149,
11914,117,2022/4/15 10:40,269,425,-156,
11915,117,2022/4/15 10:50,274,427,-153,
11916,117,2022/4/15 11:00,271,315,-44,
11917,117,2022/4/15 11:10,270,518,-248,
11918,117,2022/4/15 11:20,268,378,-110,
11919,117,2022/4/15 11:30,270,532,-262,
11920,117,2022/4/15 11:40,303,432,-129,
11921,117,2022/4/15 11:50,335,434,-99,
11922,117,2022/4/15 12:00,334,373,-39,
11923,117,2022/4/15 12:10,326,317,9,
11924,117,2022/4/15 12:20,368,431,-63,
11925,117,2022/4/15 12:30,348,432,-84,
11926,117,2022/4/15 12:40,368,499,-131,
11927,117,2022/4/15 12:50,456,432,24,
11928,117,2022/4/15 13:00,570,532,38,
11929,117,2022/4/15 13:10,569,527,42,
11930,117,2022/4/15 13:20,578,531,47,
11931,117,2022/4/15 13:30,569,525,44,
11932,117,2022/4/15 13:40,569,500,69,
11933,117,2022/4/15 13:50,587,492,95,
11934,117,2022/4/15 14:00,609,431,178,
11935,117,2022/4/15 14:10,609,431,178,
11936,117,2022/4/15 14:20,592,433,159,
11937,117,2022/4/15 14:30,620,376,244,
11938,117,2022/4/15 14:40,587,379,208,
11939,117,2022/4/15 14:50,587,319,268,
11940,117,2022/4/15 15:00,637,431,206,
11941,117,2022/4/15 15:10,638,339,299,
11942,117,2022/4/15 15:20,648,315,333,
11943,117,2022/4/15 15:30,657,319,338,
11944,117,2022/4/15 15:40,673,377,296,
11945,117,2022/4/15 15:50,680,332,348,
11946,117,2022/4/15 16:00,807,372,435,
11947,117,2022/4/15 16:10,832,378,454,
11948,117,2022/4/15 16:20,845,371,474,
11949,117,2022/4/15 16:30,1151,374,777,
11950,117,2022/4/15 16:40,1160,377,783,
11951,117,2022/4/15 16:50,1169,520,649,
11952,117,2022/4/15 17:00,1584,489,1095,
11953,117,2022/4/15 17:10,1973,425,1548,
11954,117,2022/4/15 17:20,1966,402,1564,
11955,117,2022/4/15 17:30,2477,558,1919,
11956,117,2022/4/15 17:40,3302,561,2741,
11957,117,2022/4/15 17:50,1989,584,1405,
11958,117,2022/4/15 18:00,2546,1091,1455,
11959,117,2022/4/15 18:10,3366,1094,2272,
11960,117,2022/4/15 18:20,2539,1090,1449,
11961,117,2022/4/15 18:30,1982,1089,893,
11962,117,2022/4/15 18:40,1969,1096,873,
11963,117,2022/4/15 18:50,1583,558,1025,
11964,117,2022/4/15 19:00,1366,419,947,
11965,117,2022/4/15 19:10,1197,427,770,
11966,117,2022/4/15 19:20,1148,314,834,
11967,117,2022/4/15 19:30,1035,314,721,
11968,117,2022/4/15 19:40,823,233,590,
11969,117,2022/4/15 19:50,806,183,623,
11970,117,2022/4/15 20:00,1027,159,868,
11971,117,2022/4/15 20:10,835,114,721,
11972,117,2022/4/15 20:20,821,108,713,
11973,117,2022/4/15 20:30,1027,122,905,
11974,117,2022/4/15 20:40,1019,101,918,
11975,117,2022/4/15 20:50,837,101,736,
11976,117,2022/4/15 21:00,1257,121,1136,
11977,117,2022/4/15 21:10,1218,105,1113,
11978,117,2022/4/15 21:20,827,117,710,
11979,117,2022/4/15 21:30,1208,86,1122,
11980,117,2022/4/15 21:40,812,88,724,
11981,117,2022/4/15 21:50,647,111,536,
11982,117,2022/4/15 22:00,1649,111,1538,
11983,117,2022/4/15 22:10,1028,105,923,
11984,117,2022/4/15 22:20,608,107,501,
11985,117,2022/4/15 22:30,75,74,1,
11986,117,2022/4/15 22:40,31,67,-36,
11987,117,2022/4/15 22:50,15,71,-56,
11988,111,2022/4/15 5:00,0,1,-1,
11989,111,2022/4/15 5:10,4,1,3,
11990,111,2022/4/15 5:20,6,1,5,
11991,111,2022/4/15 5:30,6,1,5,
11992,111,2022/4/15 5:40,7,13,-6,
11993,111,2022/4/15 5:50,13,12,1,
11994,111,2022/4/15 6:00,16,21,-5,
11995,111,2022/4/15 6:10,18,38,-20,
11996,111,2022/4/15 6:20,22,45,-23,
11997,111,2022/4/15 6:30,31,76,-45,
11998,111,2022/4/15 6:40,32,111,-79,
11999,111,2022/4/15 6:50,47,112,-65,
12000,111,2022/4/15 7:00,47,127,-80,
12001,111,2022/4/15 7:10,57,114,-57,
12002,111,2022/4/15 7:20,63,108,-45,
12003,111,2022/4/15 7:30,88,144,-56,
12004,111,2022/4/15 7:40,95,192,-97,
12005,111,2022/4/15 7:50,187,326,-139,
12006,111,2022/4/15 8:00,194,508,-314,
12007,111,2022/4/15 8:10,230,564,-334,
12008,111,2022/4/15 8:20,213,418,-205,
12009,111,2022/4/15 8:30,169,1128,-959,
12010,111,2022/4/15 8:40,143,1565,-1422,
12011,111,2022/4/15 8:50,87,595,-508,
12012,111,2022/4/15 9:00,71,424,-353,
12013,111,2022/4/15 9:10,65,500,-435,
12014,111,2022/4/15 9:20,46,377,-331,
12015,111,2022/4/15 9:30,43,298,-255,
12016,111,2022/4/15 9:40,38,179,-141,
12017,111,2022/4/15 9:50,39,151,-112,
12018,111,2022/4/15 10:00,34,125,-91,
12019,111,2022/4/15 10:10,37,109,-72,
12020,111,2022/4/15 10:20,34,121,-87,
12021,111,2022/4/15 10:30,35,115,-80,
12022,111,2022/4/15 10:40,31,120,-89,
12023,111,2022/4/15 10:50,33,100,-67,
12024,111,2022/4/15 11:00,30,125,-95,
12025,111,2022/4/15 11:10,30,99,-69,
12026,111,2022/4/15 11:20,26,108,-82,
12027,111,2022/4/15 11:30,31,88,-57,
12028,111,2022/4/15 11:40,32,84,-52,
12029,111,2022/4/15 11:50,36,102,-66,
12030,111,2022/4/15 12:00,36,126,-90,
12031,111,2022/4/15 12:10,35,108,-73,
12032,111,2022/4/15 12:20,37,122,-85,
12033,111,2022/4/15 12:30,38,122,-84,
12034,111,2022/4/15 12:40,40,117,-77,
12035,111,2022/4/15 12:50,38,103,-65,
12036,111,2022/4/15 13:00,39,125,-86,
12037,111,2022/4/15 13:10,42,109,-67,
12038,111,2022/4/15 13:20,37,119,-82,
12039,111,2022/4/15 13:30,40,114,-74,
12040,111,2022/4/15 13:40,41,104,-63,
12041,111,2022/4/15 13:50,43,106,-63,
12042,111,2022/4/15 14:00,38,100,-62,
12043,111,2022/4/15 14:10,38,120,-82,
12044,111,2022/4/15 14:20,41,116,-75,
12045,111,2022/4/15 14:30,41,124,-83,
12046,111,2022/4/15 14:40,44,123,-79,
12047,111,2022/4/15 14:50,48,102,-54,
12048,111,2022/4/15 15:00,41,104,-63,
12049,111,2022/4/15 15:10,41,122,-81,
12050,111,2022/4/15 15:20,42,109,-67,
12051,111,2022/4/15 15:30,43,126,-83,
12052,111,2022/4/15 15:40,42,126,-84,
12053,111,2022/4/15 15:50,46,103,-57,
12054,111,2022/4/15 16:00,45,102,-57,
12055,111,2022/4/15 16:10,47,108,-61,
12056,111,2022/4/15 16:20,62,121,-59,
12057,111,2022/4/15 16:30,67,103,-36,
12058,111,2022/4/15 16:40,104,110,-6,
12059,111,2022/4/15 16:50,80,117,-37,
12060,111,2022/4/15 17:00,163,127,36,
12061,111,2022/4/15 17:10,236,152,84,
12062,111,2022/4/15 17:20,214,178,36,
12063,111,2022/4/15 17:30,247,207,40,
12064,111,2022/4/15 17:40,551,224,327,
12065,111,2022/4/15 17:50,324,268,56,
12066,111,2022/4/15 18:00,259,320,-61,
12067,111,2022/4/15 18:10,421,255,166,
12068,111,2022/4/15 18:20,305,320,-15,
12069,111,2022/4/15 18:30,216,322,-106,
12070,111,2022/4/15 18:40,198,308,-110,
12071,111,2022/4/15 18:50,174,287,-113,
12072,111,2022/4/15 19:00,77,215,-138,
12073,111,2022/4/15 19:10,70,109,-39,
12074,111,2022/4/15 19:20,56,117,-61,
12075,111,2022/4/15 19:30,46,122,-76,
12076,111,2022/4/15 19:40,45,121,-76,
12077,111,2022/4/15 19:50,35,114,-79,
12078,111,2022/4/15 20:00,37,108,-71,
12079,111,2022/4/15 20:10,35,111,-76,
12080,111,2022/4/15 20:20,36,100,-64,
12081,111,2022/4/15 20:30,35,92,-57,
12082,111,2022/4/15 20:40,37,100,-63,
12083,111,2022/4/15 20:50,35,95,-60,
12084,111,2022/4/15 21:00,37,95,-58,
12085,111,2022/4/15 21:10,40,89,-49,
12086,111,2022/4/15 21:20,30,94,-64,
12087,111,2022/4/15 21:30,31,97,-66,
12088,111,2022/4/15 21:40,29,99,-70,
12089,111,2022/4/15 21:50,24,92,-68,
12090,111,2022/4/15 22:00,37,94,-57,
12091,111,2022/4/15 22:10,24,89,-65,
12092,111,2022/4/15 22:20,20,92,-72,
12093,111,2022/4/15 22:30,13,89,-76,
12094,111,2022/4/15 22:40,9,66,-57,
12095,111,2022/4/15 22:50,6,64,-58,
12096,94,2022/4/15 5:00,2,1,1,
12097,94,2022/4/15 5:10,6,1,5,
12098,94,2022/4/15 5:20,14,1,13,
12099,94,2022/4/15 5:30,18,1,17,
12100,94,2022/4/15 5:40,24,2,22,
12101,94,2022/4/15 5:50,30,23,7,
12102,94,2022/4/15 6:00,42,19,23,
12103,94,2022/4/15 6:10,54,38,16,
12104,94,2022/4/15 6:20,75,59,16,
12105,94,2022/4/15 6:30,184,71,113,
12106,94,2022/4/15 6:40,256,98,158,
12107,94,2022/4/15 6:50,317,105,212,
12108,94,2022/4/15 7:00,386,118,268,
12109,94,2022/4/15 7:10,598,138,460,
12110,94,2022/4/15 7:20,656,177,479,
12111,94,2022/4/15 7:30,741,325,416,
12112,94,2022/4/15 7:40,870,378,492,
12113,94,2022/4/15 7:50,1193,439,754,
12114,94,2022/4/15 8:00,1054,554,500,
12115,94,2022/4/15 8:10,1063,1779,-716,
12116,94,2022/4/15 8:20,837,1013,-176,
12117,94,2022/4/15 8:30,705,1707,-1002,
12118,94,2022/4/15 8:40,720,1674,-954,
12119,94,2022/4/15 8:50,722,1457,-735,
12120,94,2022/4/15 9:00,584,578,6,
12121,94,2022/4/15 9:10,466,415,51,
12122,94,2022/4/15 9:20,363,519,-156,
12123,94,2022/4/15 9:30,297,319,-22,
12124,94,2022/4/15 9:40,269,298,-29,
12125,94,2022/4/15 9:50,212,224,-12,
12126,94,2022/4/15 10:00,202,145,57,
12127,94,2022/4/15 10:10,202,170,32,
12128,94,2022/4/15 10:20,176,115,61,
12129,94,2022/4/15 10:30,167,106,61,
12130,94,2022/4/15 10:40,153,105,48,
12131,94,2022/4/15 10:50,143,106,37,
12132,94,2022/4/15 11:00,149,103,46,
12133,94,2022/4/15 11:10,149,109,40,
12134,94,2022/4/15 11:20,137,102,35,
12135,94,2022/4/15 11:30,173,100,73,
12136,94,2022/4/15 11:40,135,105,30,
12137,94,2022/4/15 11:50,164,121,43,
12138,94,2022/4/15 12:00,167,120,47,
12139,94,2022/4/15 12:10,170,108,62,
12140,94,2022/4/15 12:20,174,115,59,
12141,94,2022/4/15 12:30,187,111,76,
12142,94,2022/4/15 12:40,176,103,73,
12143,94,2022/4/15 12:50,173,121,52,
12144,94,2022/4/15 13:00,162,112,50,
12145,94,2022/4/15 13:10,173,125,48,
12146,94,2022/4/15 13:20,162,121,41,
12147,94,2022/4/15 13:30,166,117,49,
12148,94,2022/4/15 13:40,160,115,45,
12149,94,2022/4/15 13:50,158,117,41,
12150,94,2022/4/15 14:00,167,109,58,
12151,94,2022/4/15 14:10,142,138,4,
12152,94,2022/4/15 14:20,141,108,33,
12153,94,2022/4/15 14:30,157,111,46,
12154,94,2022/4/15 14:40,157,121,36,
12155,94,2022/4/15 14:50,166,110,56,
12156,94,2022/4/15 15:00,199,133,66,
12157,94,2022/4/15 15:10,220,108,112,
12158,94,2022/4/15 15:20,196,133,63,
12159,94,2022/4/15 15:30,204,111,93,
12160,94,2022/4/15 15:40,207,128,79,
12161,94,2022/4/15 15:50,204,108,96,
12162,94,2022/4/15 16:00,268,119,149,
12163,94,2022/4/15 16:10,272,115,157,
12164,94,2022/4/15 16:20,263,145,118,
12165,94,2022/4/15 16:30,331,109,222,
12166,94,2022/4/15 16:40,585,159,426,
12167,94,2022/4/15 16:50,606,154,452,
12168,94,2022/4/15 17:00,680,193,487,
12169,94,2022/4/15 17:10,1037,230,807,
12170,94,2022/4/15 17:20,810,295,515,
12171,94,2022/4/15 17:30,838,377,461,
12172,94,2022/4/15 17:40,1163,372,791,
12173,94,2022/4/15 17:50,848,492,356,
12174,94,2022/4/15 18:00,654,506,148,
12175,94,2022/4/15 18:10,1039,535,504,
12176,94,2022/4/15 18:20,804,534,270,
12177,94,2022/4/15 18:30,571,493,78,
12178,94,2022/4/15 18:40,350,504,-154,
12179,94,2022/4/15 18:50,317,365,-48,
12180,94,2022/4/15 19:00,266,342,-76,
12181,94,2022/4/15 19:10,222,285,-63,
12182,94,2022/4/15 19:20,187,217,-30,
12183,94,2022/4/15 19:30,156,177,-21,
12184,94,2022/4/15 19:40,114,190,-76,
12185,94,2022/4/15 19:50,133,126,7,
12186,94,2022/4/15 20:00,73,142,-69,
12187,94,2022/4/15 20:10,91,128,-37,
12188,94,2022/4/15 20:20,84,107,-23,
12189,94,2022/4/15 20:30,76,111,-35,
12190,94,2022/4/15 20:40,70,128,-58,
12191,94,2022/4/15 20:50,82,103,-21,
12192,94,2022/4/15 21:00,77,121,-44,
12193,94,2022/4/15 21:10,61,107,-46,
12194,94,2022/4/15 21:20,59,109,-50,
12195,94,2022/4/15 21:30,44,116,-72,
12196,94,2022/4/15 21:40,47,119,-72,
12197,94,2022/4/15 21:50,37,121,-84,
12198,94,2022/4/15 22:00,27,102,-75,
12199,94,2022/4/15 22:10,29,105,-76,
12200,94,2022/4/15 22:20,21,120,-99,
12201,94,2022/4/15 22:30,24,106,-82,
12202,94,2022/4/15 22:40,12,103,-91,
12203,94,2022/4/15 22:50,1,77,-76,
12204,110,2022/4/15 5:00,26,1,25,
12205,110,2022/4/15 5:10,32,1,31,
12206,110,2022/4/15 5:20,31,1,30,
12207,110,2022/4/15 5:30,29,1,28,
12208,110,2022/4/15 5:40,28,8,20,
12209,110,2022/4/15 5:50,27,38,-11,
12210,110,2022/4/15 6:00,31,38,-7,
12211,110,2022/4/15 6:10,53,47,6,
12212,110,2022/4/15 6:20,91,76,15,
12213,110,2022/4/15 6:30,162,89,73,
12214,110,2022/4/15 6:40,155,108,47,
12215,110,2022/4/15 6:50,186,111,75,
12216,110,2022/4/15 7:00,271,119,152,
12217,110,2022/4/15 7:10,286,125,161,
12218,110,2022/4/15 7:20,608,135,473,
12219,110,2022/4/15 7:30,679,145,534,
12220,110,2022/4/15 7:40,746,152,594,
12221,110,2022/4/15 7:50,843,152,691,
12222,110,2022/4/15 8:00,1240,213,1027,
12223,110,2022/4/15 8:10,1051,197,854,
12224,110,2022/4/15 8:20,682,178,504,
12225,110,2022/4/15 8:30,1164,197,967,
12226,110,2022/4/15 8:40,592,219,373,
12227,110,2022/4/15 8:50,324,192,132,
12228,110,2022/4/15 9:00,586,139,447,
12229,110,2022/4/15 9:10,346,110,236,
12230,110,2022/4/15 9:20,266,118,148,
12231,110,2022/4/15 9:30,278,110,168,
12232,110,2022/4/15 9:40,187,118,69,
12233,110,2022/4/15 9:50,140,127,13,
12234,110,2022/4/15 10:00,62,108,-46,
12235,110,2022/4/15 10:10,135,123,12,
12236,110,2022/4/15 10:20,86,96,-10,
12237,110,2022/4/15 10:30,53,112,-59,
12238,110,2022/4/15 10:40,106,94,12,
12239,110,2022/4/15 10:50,133,114,19,
12240,110,2022/4/15 11:00,89,103,-14,
12241,110,2022/4/15 11:10,74,111,-37,
12242,110,2022/4/15 11:20,93,102,-9,
12243,110,2022/4/15 11:30,80,115,-35,
12244,110,2022/4/15 11:40,62,86,-24,
12245,110,2022/4/15 11:50,65,111,-46,
12246,110,2022/4/15 12:00,122,98,24,
12247,110,2022/4/15 12:10,66,124,-58,
12248,110,2022/4/15 12:20,74,97,-23,
12249,110,2022/4/15 12:30,164,109,55,
12250,110,2022/4/15 12:40,54,119,-65,
12251,110,2022/4/15 12:50,108,107,1,
12252,110,2022/4/15 13:00,115,108,7,
12253,110,2022/4/15 13:10,129,109,20,
12254,110,2022/4/15 13:20,75,113,-38,
12255,110,2022/4/15 13:30,79,108,-29,
12256,110,2022/4/15 13:40,60,97,-37,
12257,110,2022/4/15 13:50,53,117,-64,
12258,110,2022/4/15 14:00,108,123,-15,
12259,110,2022/4/15 14:10,70,117,-47,
12260,110,2022/4/15 14:20,56,109,-53,
12261,110,2022/4/15 14:30,68,102,-34,
12262,110,2022/4/15 14:40,41,121,-80,
12263,110,2022/4/15 14:50,61,129,-68,
12264,110,2022/4/15 15:00,78,114,-36,
12265,110,2022/4/15 15:10,112,104,8,
12266,110,2022/4/15 15:20,63,117,-54,
12267,110,2022/4/15 15:30,89,120,-31,
12268,110,2022/4/15 15:40,51,150,-99,
12269,110,2022/4/15 15:50,68,172,-104,
12270,110,2022/4/15 16:00,96,168,-72,
12271,110,2022/4/15 16:10,194,169,25,
12272,110,2022/4/15 16:20,74,156,-82,
12273,110,2022/4/15 16:30,94,160,-66,
12274,110,2022/4/15 16:40,177,191,-14,
12275,110,2022/4/15 16:50,202,225,-23,
12276,110,2022/4/15 17:00,240,213,27,
12277,110,2022/4/15 17:10,270,251,19,
12278,110,2022/4/15 17:20,207,295,-88,
12279,110,2022/4/15 17:30,262,301,-39,
12280,110,2022/4/15 17:40,238,427,-189,
12281,110,2022/4/15 17:50,228,401,-173,
12282,110,2022/4/15 18:00,270,515,-245,
12283,110,2022/4/15 18:10,256,471,-215,
12284,110,2022/4/15 18:20,227,471,-244,
12285,110,2022/4/15 18:30,209,420,-211,
12286,110,2022/4/15 18:40,153,414,-261,
12287,110,2022/4/15 18:50,125,366,-241,
12288,110,2022/4/15 19:00,85,417,-332,
12289,110,2022/4/15 19:10,50,322,-272,
12290,110,2022/4/15 19:20,45,285,-240,
12291,110,2022/4/15 19:30,44,219,-175,
12292,110,2022/4/15 19:40,36,191,-155,
12293,110,2022/4/15 19:50,40,150,-110,
12294,110,2022/4/15 20:00,39,109,-70,
12295,110,2022/4/15 20:10,33,137,-104,
12296,110,2022/4/15 20:20,42,151,-109,
12297,110,2022/4/15 20:30,37,110,-73,
12298,110,2022/4/15 20:40,64,122,-58,
12299,110,2022/4/15 20:50,56,119,-63,
12300,110,2022/4/15 21:00,131,111,20,
12301,110,2022/4/15 21:10,56,115,-59,
12302,110,2022/4/15 21:20,31,106,-75,
12303,110,2022/4/15 21:30,28,108,-80,
12304,110,2022/4/15 21:40,24,124,-100,
12305,110,2022/4/15 21:50,25,118,-93,
12306,110,2022/4/15 22:00,30,102,-72,
12307,110,2022/4/15 22:10,25,105,-80,
12308,110,2022/4/15 22:20,15,120,-105,
12309,110,2022/4/15 22:30,18,112,-94,
12310,110,2022/4/15 22:40,3,82,-79,
12311,110,2022/4/15 22:50,0,69,-69,
12312,103,2022/4/15 5:00,0,1,-1,
12313,103,2022/4/15 5:10,2,1,1,
12314,103,2022/4/15 5:20,16,1,15,
12315,103,2022/4/15 5:30,24,1,23,
12316,103,2022/4/15 5:40,30,2,28,
12317,103,2022/4/15 5:50,33,43,-10,
12318,103,2022/4/15 6:00,53,23,30,
12319,103,2022/4/15 6:10,67,23,44,
12320,103,2022/4/15 6:20,91,65,26,
12321,103,2022/4/15 6:30,227,70,157,
12322,103,2022/4/15 6:40,280,104,176,
12323,103,2022/4/15 6:50,389,105,284,
12324,103,2022/4/15 7:00,475,100,375,
12325,103,2022/4/15 7:10,686,110,576,
12326,103,2022/4/15 7:20,738,152,586,
12327,103,2022/4/15 7:30,1180,234,946,
12328,103,2022/4/15 7:40,1370,223,1147,
12329,103,2022/4/15 7:50,1370,192,1178,
12330,103,2022/4/15 8:00,1576,197,1379,
12331,103,2022/4/15 8:10,1214,233,981,
12332,103,2022/4/15 8:20,1175,213,962,
12333,103,2022/4/15 8:30,870,198,672,
12334,103,2022/4/15 8:40,844,180,664,
12335,103,2022/4/15 8:50,684,146,538,
12336,103,2022/4/15 9:00,615,150,465,
12337,103,2022/4/15 9:10,367,120,247,
12338,103,2022/4/15 9:20,311,121,190,
12339,103,2022/4/15 9:30,245,107,138,
12340,103,2022/4/15 9:40,216,106,110,
12341,103,2022/4/15 9:50,188,114,74,
12342,103,2022/4/15 10:00,132,101,31,
12343,103,2022/4/15 10:10,96,106,-10,
12344,103,2022/4/15 10:20,86,105,-19,
12345,103,2022/4/15 10:30,66,91,-25,
12346,103,2022/4/15 10:40,58,105,-47,
12347,103,2022/4/15 10:50,59,97,-38,
12348,103,2022/4/15 11:00,43,117,-74,
12349,103,2022/4/15 11:10,53,92,-39,
12350,103,2022/4/15 11:20,56,109,-53,
12351,103,2022/4/15 11:30,51,109,-58,
12352,103,2022/4/15 11:40,46,104,-58,
12353,103,2022/4/15 11:50,44,104,-60,
12354,103,2022/4/15 12:00,69,105,-36,
12355,103,2022/4/15 12:10,67,103,-36,
12356,103,2022/4/15 12:20,78,108,-30,
12357,103,2022/4/15 12:30,75,102,-27,
12358,103,2022/4/15 12:40,70,99,-29,
12359,103,2022/4/15 12:50,71,112,-41,
12360,103,2022/4/15 13:00,66,110,-44,
12361,103,2022/4/15 13:10,76,86,-10,
12362,103,2022/4/15 13:20,60,117,-57,
12363,103,2022/4/15 13:30,59,104,-45,
12364,103,2022/4/15 13:40,44,102,-58,
12365,103,2022/4/15 13:50,55,126,-71,
12366,103,2022/4/15 14:00,45,108,-63,
12367,103,2022/4/15 14:10,53,104,-51,
12368,103,2022/4/15 14:20,45,117,-72,
12369,103,2022/4/15 14:30,53,119,-66,
12370,103,2022/4/15 14:40,48,106,-58,
12371,103,2022/4/15 14:50,52,110,-58,
12372,103,2022/4/15 15:00,46,121,-75,
12373,103,2022/4/15 15:10,45,109,-64,
12374,103,2022/4/15 15:20,53,117,-64,
12375,103,2022/4/15 15:30,45,126,-81,
12376,103,2022/4/15 15:40,56,142,-86,
12377,103,2022/4/15 15:50,58,150,-92,
12378,103,2022/4/15 16:00,65,117,-52,
12379,103,2022/4/15 16:10,73,179,-106,
12380,103,2022/4/15 16:20,86,185,-99,
12381,103,2022/4/15 16:30,129,198,-69,
12382,103,2022/4/15 16:40,134,234,-100,
12383,103,2022/4/15 16:50,136,208,-72,
12384,103,2022/4/15 17:00,208,316,-108,
12385,103,2022/4/15 17:10,265,320,-55,
12386,103,2022/4/15 17:20,223,432,-209,
12387,103,2022/4/15 17:30,256,432,-176,
12388,103,2022/4/15 17:40,264,428,-164,
12389,103,2022/4/15 17:50,196,471,-275,
12390,103,2022/4/15 18:00,221,421,-200,
12391,103,2022/4/15 18:10,208,560,-352,
12392,103,2022/4/15 18:20,174,421,-247,
12393,103,2022/4/15 18:30,164,565,-401,
12394,103,2022/4/15 18:40,134,584,-450,
12395,103,2022/4/15 18:50,73,568,-495,
12396,103,2022/4/15 19:00,56,413,-357,
12397,103,2022/4/15 19:10,44,495,-451,
12398,103,2022/4/15 19:20,41,318,-277,
12399,103,2022/4/15 19:30,34,322,-288,
12400,103,2022/4/15 19:40,30,224,-194,
12401,103,2022/4/15 19:50,27,207,-180,
12402,103,2022/4/15 20:00,25,128,-103,
12403,103,2022/4/15 20:10,30,192,-162,
12404,103,2022/4/15 20:20,31,132,-101,
12405,103,2022/4/15 20:30,27,119,-92,
12406,103,2022/4/15 20:40,29,198,-169,
12407,103,2022/4/15 20:50,28,109,-81,
12408,103,2022/4/15 21:00,24,133,-109,
12409,103,2022/4/15 21:10,31,116,-85,
12410,103,2022/4/15 21:20,31,118,-87,
12411,103,2022/4/15 21:30,27,137,-110,
12412,103,2022/4/15 21:40,28,109,-81,
12413,103,2022/4/15 21:50,21,112,-91,
12414,103,2022/4/15 22:00,16,122,-106,
12415,103,2022/4/15 22:10,21,116,-95,
12416,103,2022/4/15 22:20,12,104,-92,
12417,103,2022/4/15 22:30,9,119,-110,
12418,103,2022/4/15 22:40,1,99,-98,
12419,103,2022/4/15 22:50,1,80,-79,
12420,104,2022/4/15 5:00,1,1,0,
12421,104,2022/4/15 5:10,7,1,6,
12422,104,2022/4/15 5:20,21,1,20,
12423,104,2022/4/15 5:30,40,1,39,
12424,104,2022/4/15 5:40,75,2,73,
12425,104,2022/4/15 5:50,149,5,144,
12426,104,2022/4/15 6:00,211,60,151,
12427,104,2022/4/15 6:10,280,43,237,
12428,104,2022/4/15 6:20,580,83,497,
12429,104,2022/4/15 6:30,653,95,558,
12430,104,2022/4/15 6:40,735,137,598,
12431,104,2022/4/15 6:50,1166,233,933,
12432,104,2022/4/15 7:00,1213,216,997,
12433,104,2022/4/15 7:10,1967,326,1641,
12434,104,2022/4/15 7:20,2043,378,1665,
12435,104,2022/4/15 7:30,3211,432,2779,
12436,104,2022/4/15 7:40,3181,533,2648,
12437,104,2022/4/15 7:50,3264,494,2770,
12438,104,2022/4/15 8:00,3372,494,2878,
12439,104,2022/4/15 8:10,3339,420,2919,
12440,104,2022/4/15 8:20,3279,499,2780,
12441,104,2022/4/15 8:30,2571,428,2143,
12442,104,2022/4/15 8:40,2479,434,2045,
12443,104,2022/4/15 8:50,2075,439,1636,
12444,104,2022/4/15 9:00,1632,420,1212,
12445,104,2022/4/15 9:10,1387,315,1072,
12446,104,2022/4/15 9:20,1155,297,858,
12447,104,2022/4/15 9:30,830,297,533,
12448,104,2022/4/15 9:40,660,232,428,
12449,104,2022/4/15 9:50,613,177,436,
12450,104,2022/4/15 10:00,456,208,248,
12451,104,2022/4/15 10:10,461,179,282,
12452,104,2022/4/15 10:20,310,198,112,
12453,104,2022/4/15 10:30,314,170,144,
12454,104,2022/4/15 10:40,311,181,130,
12455,104,2022/4/15 10:50,305,227,78,
12456,104,2022/4/15 11:00,273,192,81,
12457,104,2022/4/15 11:10,289,223,66,
12458,104,2022/4/15 11:20,270,145,125,
12459,104,2022/4/15 11:30,270,180,90,
12460,104,2022/4/15 11:40,268,192,76,
12461,104,2022/4/15 11:50,285,193,92,
12462,104,2022/4/15 12:00,311,223,88,
12463,104,2022/4/15 12:10,333,185,148,
12464,104,2022/4/15 12:20,333,196,137,
12465,104,2022/4/15 12:30,325,222,103,
12466,104,2022/4/15 12:40,376,234,142,
12467,104,2022/4/15 12:50,312,225,87,
12468,104,2022/4/15 13:00,332,233,99,
12469,104,2022/4/15 13:10,332,213,119,
12470,104,2022/4/15 13:20,288,208,80,
12471,104,2022/4/15 13:30,265,180,85,
12472,104,2022/4/15 13:40,271,254,17,
12473,104,2022/4/15 13:50,267,178,89,
12474,104,2022/4/15 14:00,270,254,16,
12475,104,2022/4/15 14:10,261,207,54,
12476,104,2022/4/15 14:20,274,297,-23,
12477,104,2022/4/15 14:30,267,206,61,
12478,104,2022/4/15 14:40,265,325,-60,
12479,104,2022/4/15 14:50,270,217,53,
12480,104,2022/4/15 15:00,272,322,-50,
12481,104,2022/4/15 15:10,315,290,25,
12482,104,2022/4/15 15:20,264,379,-115,
12483,104,2022/4/15 15:30,268,317,-49,
12484,104,2022/4/15 15:40,287,364,-77,
12485,104,2022/4/15 15:50,262,421,-159,
12486,104,2022/4/15 16:00,332,427,-95,
12487,104,2022/4/15 16:10,346,310,36,
12488,104,2022/4/15 16:20,326,408,-82,
12489,104,2022/4/15 16:30,430,410,20,
12490,104,2022/4/15 16:40,421,408,13,
12491,104,2022/4/15 16:50,587,414,173,
12492,104,2022/4/15 17:00,617,552,65,
12493,104,2022/4/15 17:10,697,550,147,
12494,104,2022/4/15 17:20,696,1413,-717,
12495,104,2022/4/15 17:30,679,1474,-795,
12496,104,2022/4/15 17:40,709,1640,-931,
12497,104,2022/4/15 17:50,652,1627,-975,
12498,104,2022/4/15 18:00,639,2051,-1412,
12499,104,2022/4/15 18:10,712,2436,-1724,
12500,104,2022/4/15 18:20,617,2441,-1824,
12501,104,2022/4/15 18:30,609,2387,-1778,
12502,104,2022/4/15 18:40,457,2621,-2164,
12503,104,2022/4/15 18:50,335,2167,-1832,
12504,104,2022/4/15 19:00,264,1980,-1716,
12505,104,2022/4/15 19:10,227,2106,-1879,
12506,104,2022/4/15 19:20,192,1101,-909,
12507,104,2022/4/15 19:30,182,556,-374,
12508,104,2022/4/15 19:40,159,454,-295,
12509,104,2022/4/15 19:50,168,399,-231,
12510,104,2022/4/15 20:00,139,417,-278,
12511,104,2022/4/15 20:10,169,430,-261,
12512,104,2022/4/15 20:20,146,340,-194,
12513,104,2022/4/15 20:30,128,340,-212,
12514,104,2022/4/15 20:40,160,320,-160,
12515,104,2022/4/15 20:50,140,506,-366,
12516,104,2022/4/15 21:00,127,338,-211,
12517,104,2022/4/15 21:10,151,326,-175,
12518,104,2022/4/15 21:20,132,263,-131,
12519,104,2022/4/15 21:30,225,196,29,
12520,104,2022/4/15 21:40,132,316,-184,
12521,104,2022/4/15 21:50,44,314,-270,
12522,104,2022/4/15 22:00,45,238,-193,
12523,104,2022/4/15 22:10,35,288,-253,
12524,104,2022/4/15 22:20,28,319,-291,
12525,104,2022/4/15 22:30,12,202,-190,
12526,104,2022/4/15 22:40,2,217,-215,
12527,104,2022/4/15 22:50,2,136,-134,
12528,114,2022/4/15 5:00,0,1,-1,
12529,114,2022/4/15 5:10,3,1,2,
12530,114,2022/4/15 5:20,12,1,11,
12531,114,2022/4/15 5:30,13,1,12,
12532,114,2022/4/15 5:40,19,1,18,
12533,114,2022/4/15 5:50,25,1,24,
12534,114,2022/4/15 6:00,32,22,10,
12535,114,2022/4/15 6:10,48,14,34,
12536,114,2022/4/15 6:20,76,23,53,
12537,114,2022/4/15 6:30,128,38,90,
12538,114,2022/4/15 6:40,186,64,122,
12539,114,2022/4/15 6:50,245,69,176,
12540,114,2022/4/15 7:00,302,97,205,
12541,114,2022/4/15 7:10,474,98,376,
12542,114,2022/4/15 7:20,661,127,534,
12543,114,2022/4/15 7:30,820,146,674,
12544,114,2022/4/15 7:40,1062,109,953,
12545,114,2022/4/15 7:50,1374,104,1270,
12546,114,2022/4/15 8:00,1371,110,1261,
12547,114,2022/4/15 8:10,1173,113,1060,
12548,114,2022/4/15 8:20,874,97,777,
12549,114,2022/4/15 8:30,818,104,714,
12550,114,2022/4/15 8:40,661,95,566,
12551,114,2022/4/15 8:50,570,83,487,
12552,114,2022/4/15 9:00,354,85,269,
12553,114,2022/4/15 9:10,278,72,206,
12554,114,2022/4/15 9:20,207,76,131,
12555,114,2022/4/15 9:30,141,71,70,
12556,114,2022/4/15 9:40,90,69,21,
12557,114,2022/4/15 9:50,71,66,5,
12558,114,2022/4/15 10:00,59,72,-13,
12559,114,2022/4/15 10:10,49,67,-18,
12560,114,2022/4/15 10:20,43,63,-20,
12561,114,2022/4/15 10:30,46,61,-15,
12562,114,2022/4/15 10:40,36,69,-33,
12563,114,2022/4/15 10:50,36,66,-30,
12564,114,2022/4/15 11:00,29,72,-43,
12565,114,2022/4/15 11:10,31,68,-37,
12566,114,2022/4/15 11:20,36,62,-26,
12567,114,2022/4/15 11:30,35,62,-27,
12568,114,2022/4/15 11:40,36,67,-31,
12569,114,2022/4/15 11:50,34,68,-34,
12570,114,2022/4/15 12:00,42,63,-21,
12571,114,2022/4/15 12:10,42,74,-32,
12572,114,2022/4/15 12:20,36,66,-30,
12573,114,2022/4/15 12:30,43,84,-41,
12574,114,2022/4/15 12:40,37,60,-23,
12575,114,2022/4/15 12:50,34,85,-51,
12576,114,2022/4/15 13:00,39,77,-38,
12577,114,2022/4/15 13:10,33,76,-43,
12578,114,2022/4/15 13:20,28,65,-37,
12579,114,2022/4/15 13:30,30,78,-48,
12580,114,2022/4/15 13:40,32,85,-53,
12581,114,2022/4/15 13:50,30,75,-45,
12582,114,2022/4/15 14:00,27,80,-53,
12583,114,2022/4/15 14:10,26,75,-49,
12584,114,2022/4/15 14:20,48,93,-45,
12585,114,2022/4/15 14:30,43,90,-47,
12586,114,2022/4/15 14:40,31,77,-46,
12587,114,2022/4/15 14:50,24,90,-66,
12588,114,2022/4/15 15:00,31,90,-59,
12589,114,2022/4/15 15:10,38,103,-65,
12590,114,2022/4/15 15:20,38,102,-64,
12591,114,2022/4/15 15:30,35,110,-75,
12592,114,2022/4/15 15:40,28,103,-75,
12593,114,2022/4/15 15:50,26,106,-80,
12594,114,2022/4/15 16:00,45,105,-60,
12595,114,2022/4/15 16:10,46,117,-71,
12596,114,2022/4/15 16:20,37,122,-85,
12597,114,2022/4/15 16:30,31,121,-90,
12598,114,2022/4/15 16:40,38,133,-95,
12599,114,2022/4/15 16:50,47,132,-85,
12600,114,2022/4/15 17:00,56,115,-59,
12601,114,2022/4/15 17:10,65,195,-130,
12602,114,2022/4/15 17:20,46,175,-129,
12603,114,2022/4/15 17:30,45,204,-159,
12604,114,2022/4/15 17:40,58,339,-281,
12605,114,2022/4/15 17:50,45,340,-295,
12606,114,2022/4/15 18:00,60,426,-366,
12607,114,2022/4/15 18:10,58,427,-369,
12608,114,2022/4/15 18:20,48,421,-373,
12609,114,2022/4/15 18:30,38,495,-457,
12610,114,2022/4/15 18:40,35,534,-499,
12611,114,2022/4/15 18:50,29,440,-411,
12612,114,2022/4/15 19:00,26,430,-404,
12613,114,2022/4/15 19:10,23,318,-295,
12614,114,2022/4/15 19:20,29,234,-205,
12615,114,2022/4/15 19:30,25,179,-154,
12616,114,2022/4/15 19:40,23,142,-119,
12617,114,2022/4/15 19:50,21,115,-94,
12618,114,2022/4/15 20:00,20,111,-91,
12619,114,2022/4/15 20:10,18,125,-107,
12620,114,2022/4/15 20:20,22,118,-96,
12621,114,2022/4/15 20:30,17,126,-109,
12622,114,2022/4/15 20:40,20,121,-101,
12623,114,2022/4/15 20:50,14,103,-89,
12624,114,2022/4/15 21:00,16,105,-89,
12625,114,2022/4/15 21:10,15,103,-88,
12626,114,2022/4/15 21:20,18,106,-88,
12627,114,2022/4/15 21:30,14,126,-112,
12628,114,2022/4/15 21:40,13,124,-111,
12629,114,2022/4/15 21:50,13,106,-93,
12630,114,2022/4/15 22:00,11,106,-95,
12631,114,2022/4/15 22:10,8,110,-102,
12632,114,2022/4/15 22:20,4,97,-93,
12633,114,2022/4/15 22:30,1,89,-88,
12634,114,2022/4/15 22:40,0,77,-77,
12635,114,2022/4/15 22:50,1,62,-61,
12636,112,2022/4/15 5:00,5,1,4,
12637,112,2022/4/15 5:10,24,1,23,
12638,112,2022/4/15 5:20,45,1,44,
12639,112,2022/4/15 5:30,34,2,32,
12640,112,2022/4/15 5:40,57,1,56,
12641,112,2022/4/15 5:50,109,1,108,
12642,112,2022/4/15 6:00,173,67,106,
12643,112,2022/4/15 6:10,390,56,334,
12644,112,2022/4/15 6:20,598,111,487,
12645,112,2022/4/15 6:30,742,108,634,
12646,112,2022/4/15 6:40,1401,191,1210,
12647,112,2022/4/15 6:50,1399,340,1059,
12648,112,2022/4/15 7:00,1993,429,1564,
12649,112,2022/4/15 7:10,3074,430,2644,
12650,112,2022/4/15 7:20,3335,415,2920,
12651,112,2022/4/15 7:30,3430,568,2862,
12652,112,2022/4/15 7:40,3426,1130,2296,
12653,112,2022/4/15 7:50,3540,1121,2419,
12654,112,2022/4/15 8:00,3462,1514,1948,
12655,112,2022/4/15 8:10,3429,1467,1962,
12656,112,2022/4/15 8:20,3357,1498,1859,
12657,112,2022/4/15 8:30,3407,1711,1696,
12658,112,2022/4/15 8:40,3092,1435,1657,
12659,112,2022/4/15 8:50,2550,552,1998,
12660,112,2022/4/15 9:00,1976,426,1550,
12661,112,2022/4/15 9:10,1709,433,1276,
12662,112,2022/4/15 9:20,1347,490,857,
12663,112,2022/4/15 9:30,1151,516,635,
12664,112,2022/4/15 9:40,811,316,495,
12665,112,2022/4/15 9:50,672,343,329,
12666,112,2022/4/15 10:00,701,320,381,
12667,112,2022/4/15 10:10,608,221,387,
12668,112,2022/4/15 10:20,577,333,244,
12669,112,2022/4/15 10:30,551,312,239,
12670,112,2022/4/15 10:40,377,268,109,
12671,112,2022/4/15 10:50,455,221,234,
12672,112,2022/4/15 11:00,325,266,59,
12673,112,2022/4/15 11:10,309,318,-9,
12674,112,2022/4/15 11:20,372,297,75,
12675,112,2022/4/15 11:30,332,297,35,
12676,112,2022/4/15 11:40,336,332,4,
12677,112,2022/4/15 11:50,366,318,48,
12678,112,2022/4/15 12:00,462,290,172,
12679,112,2022/4/15 12:10,544,317,227,
12680,112,2022/4/15 12:20,576,326,250,
12681,112,2022/4/15 12:30,580,327,253,
12682,112,2022/4/15 12:40,576,341,235,
12683,112,2022/4/15 12:50,426,339,87,
12684,112,2022/4/15 13:00,563,309,254,
12685,112,2022/4/15 13:10,421,427,-6,
12686,112,2022/4/15 13:20,455,288,167,
12687,112,2022/4/15 13:30,367,378,-11,
12688,112,2022/4/15 13:40,308,320,-12,
12689,112,2022/4/15 13:50,308,357,-49,
12690,112,2022/4/15 14:00,308,318,-10,
12691,112,2022/4/15 14:10,327,376,-49,
12692,112,2022/4/15 14:20,309,325,-16,
12693,112,2022/4/15 14:30,335,432,-97,
12694,112,2022/4/15 14:40,333,430,-97,
12695,112,2022/4/15 14:50,334,377,-43,
12696,112,2022/4/15 15:00,345,364,-19,
12697,112,2022/4/15 15:10,327,417,-90,
12698,112,2022/4/15 15:20,339,337,2,
12699,112,2022/4/15 15:30,326,428,-102,
12700,112,2022/4/15 15:40,308,486,-178,
12701,112,2022/4/15 15:50,371,427,-56,
12702,112,2022/4/15 16:00,313,419,-106,
12703,112,2022/4/15 16:10,457,472,-15,
12704,112,2022/4/15 16:20,580,413,167,
12705,112,2022/4/15 16:30,623,582,41,
12706,112,2022/4/15 16:40,635,570,65,
12707,112,2022/4/15 16:50,673,1140,-467,
12708,112,2022/4/15 17:00,804,1081,-277,
12709,112,2022/4/15 17:10,1157,1696,-539,
12710,112,2022/4/15 17:20,1034,1730,-696,
12711,112,2022/4/15 17:30,1158,1683,-525,
12712,112,2022/4/15 17:40,1369,2409,-1040,
12713,112,2022/4/15 17:50,1396,2295,-899,
12714,112,2022/4/15 18:00,1160,3869,-2709,
12715,112,2022/4/15 18:10,1215,1746,-531,
12716,112,2022/4/15 18:20,1025,3586,-2561,
12717,112,2022/4/15 18:30,812,4338,-3526,
12718,112,2022/4/15 18:40,672,2859,-2187,
12719,112,2022/4/15 18:50,607,5038,-4431,
12720,112,2022/4/15 19:00,455,4584,-4129,
12721,112,2022/4/15 19:10,345,2076,-1731,
12722,112,2022/4/15 19:20,303,2359,-2056,
12723,112,2022/4/15 19:30,269,1824,-1555,
12724,112,2022/4/15 19:40,263,1572,-1309,
12725,112,2022/4/15 19:50,225,593,-368,
12726,112,2022/4/15 20:00,217,574,-357,
12727,112,2022/4/15 20:10,263,424,-161,
12728,112,2022/4/15 20:20,273,378,-105,
12729,112,2022/4/15 20:30,235,485,-250,
12730,112,2022/4/15 20:40,230,425,-195,
12731,112,2022/4/15 20:50,267,427,-160,
12732,112,2022/4/15 21:00,228,502,-274,
12733,112,2022/4/15 21:10,275,519,-244,
12734,112,2022/4/15 21:20,229,504,-275,
12735,112,2022/4/15 21:30,198,360,-162,
12736,112,2022/4/15 21:40,190,416,-226,
12737,112,2022/4/15 21:50,143,495,-352,
12738,112,2022/4/15 22:00,138,371,-233,
12739,112,2022/4/15 22:10,183,339,-156,
12740,112,2022/4/15 22:20,33,323,-290,
12741,112,2022/4/15 22:30,2,431,-429,
12742,112,2022/4/15 22:40,2,374,-372,
12743,112,2022/4/15 22:50,2,297,-295,
12744,106,2022/4/15 5:00,1,1,0,
12745,106,2022/4/15 5:10,6,6,0,
12746,106,2022/4/15 5:20,16,1,15,
12747,106,2022/4/15 5:30,14,17,-3,
12748,106,2022/4/15 5:40,20,29,-9,
12749,106,2022/4/15 5:50,29,23,6,
12750,106,2022/4/15 6:00,32,113,-81,
12751,106,2022/4/15 6:10,37,112,-75,
12752,106,2022/4/15 6:20,37,117,-80,
12753,106,2022/4/15 6:30,39,102,-63,
12754,106,2022/4/15 6:40,52,121,-69,
12755,106,2022/4/15 6:50,75,121,-46,
12756,106,2022/4/15 7:00,69,224,-155,
12757,106,2022/4/15 7:10,80,267,-187,
12758,106,2022/4/15 7:20,85,345,-260,
12759,106,2022/4/15 7:30,150,509,-359,
12760,106,2022/4/15 7:40,146,436,-290,
12761,106,2022/4/15 7:50,195,578,-383,
12762,106,2022/4/15 8:00,230,1792,-1562,
12763,106,2022/4/15 8:10,232,2954,-2722,
12764,106,2022/4/15 8:20,226,2619,-2393,
12765,106,2022/4/15 8:30,231,4745,-4514,
12766,106,2022/4/15 8:40,192,6335,-6143,
12767,106,2022/4/15 8:50,202,5623,-5421,
12768,106,2022/4/15 9:00,185,4993,-4808,
12769,106,2022/4/15 9:10,188,2869,-2681,
12770,106,2022/4/15 9:20,169,1712,-1543,
12771,106,2022/4/15 9:30,156,563,-407,
12772,106,2022/4/15 9:40,155,553,-398,
12773,106,2022/4/15 9:50,147,417,-270,
12774,106,2022/4/15 10:00,160,531,-371,
12775,106,2022/4/15 10:10,153,318,-165,
12776,106,2022/4/15 10:20,175,332,-157,
12777,106,2022/4/15 10:30,183,332,-149,
12778,106,2022/4/15 10:40,181,331,-150,
12779,106,2022/4/15 10:50,211,298,-87,
12780,106,2022/4/15 11:00,216,232,-16,
12781,106,2022/4/15 11:10,215,254,-39,
12782,106,2022/4/15 11:20,218,254,-36,
12783,106,2022/4/15 11:30,218,233,-15,
12784,106,2022/4/15 11:40,266,255,11,
12785,106,2022/4/15 11:50,262,269,-7,
12786,106,2022/4/15 12:00,263,195,68,
12787,106,2022/4/15 12:10,267,217,50,
12788,106,2022/4/15 12:20,300,255,45,
12789,106,2022/4/15 12:30,346,268,78,
12790,106,2022/4/15 12:40,343,299,44,
12791,106,2022/4/15 12:50,333,299,34,
12792,106,2022/4/15 13:00,367,283,84,
12793,106,2022/4/15 13:10,367,318,49,
12794,106,2022/4/15 13:20,454,318,136,
12795,106,2022/4/15 13:30,457,298,159,
12796,106,2022/4/15 13:40,422,298,124,
12797,106,2022/4/15 13:50,456,299,157,
12798,106,2022/4/15 14:00,545,267,278,
12799,106,2022/4/15 14:10,549,232,317,
12800,106,2022/4/15 14:20,574,232,342,
12801,106,2022/4/15 14:30,558,197,361,
12802,106,2022/4/15 14:40,580,207,373,
12803,106,2022/4/15 14:50,570,232,338,
12804,106,2022/4/15 15:00,573,223,350,
12805,106,2022/4/15 15:10,591,223,368,
12806,106,2022/4/15 15:20,587,233,354,
12807,106,2022/4/15 15:30,639,226,413,
12808,106,2022/4/15 15:40,637,226,411,
12809,106,2022/4/15 15:50,596,214,382,
12810,106,2022/4/15 16:00,638,225,413,
12811,106,2022/4/15 16:10,640,223,417,
12812,106,2022/4/15 16:20,686,208,478,
12813,106,2022/4/15 16:30,635,198,437,
12814,106,2022/4/15 16:40,708,226,482,
12815,106,2022/4/15 16:50,705,233,472,
12816,106,2022/4/15 17:00,1145,265,880,
12817,106,2022/4/15 17:10,1576,294,1282,
12818,106,2022/4/15 17:20,1377,336,1041,
12819,106,2022/4/15 17:30,1967,363,1604,
12820,106,2022/4/15 17:40,3043,363,2680,
12821,106,2022/4/15 17:50,1988,494,1494,
12822,106,2022/4/15 18:00,1966,414,1552,
12823,106,2022/4/15 18:10,3308,411,2897,
12824,106,2022/4/15 18:20,3001,418,2583,
12825,106,2022/4/15 18:30,1609,417,1192,
12826,106,2022/4/15 18:40,1360,424,936,
12827,106,2022/4/15 18:50,1140,459,681,
12828,106,2022/4/15 19:00,1034,321,713,
12829,106,2022/4/15 19:10,833,212,621,
12830,106,2022/4/15 19:20,711,180,531,
12831,106,2022/4/15 19:30,658,150,508,
12832,106,2022/4/15 19:40,645,116,529,
12833,106,2022/4/15 19:50,627,111,516,
12834,106,2022/4/15 20:00,645,105,540,
12835,106,2022/4/15 20:10,726,108,618,
12836,106,2022/4/15 20:20,637,106,531,
12837,106,2022/4/15 20:30,658,85,573,
12838,106,2022/4/15 20:40,726,104,622,
12839,106,2022/4/15 20:50,721,99,622,
12840,106,2022/4/15 21:00,817,104,713,
12841,106,2022/4/15 21:10,840,97,743,
12842,106,2022/4/15 21:20,723,97,626,
12843,106,2022/4/15 21:30,679,102,577,
12844,106,2022/4/15 21:40,673,88,585,
12845,106,2022/4/15 21:50,642,95,547,
12846,106,2022/4/15 22:00,1404,92,1312,
12847,106,2022/4/15 22:10,1248,94,1154,
12848,106,2022/4/15 22:20,238,89,149,
12849,106,2022/4/15 22:30,124,79,45,
12850,106,2022/4/15 22:40,60,83,-23,
12851,106,2022/4/15 22:50,26,72,-46,
12852,116,2022/4/15 5:00,1,1,0,
12853,116,2022/4/15 5:10,6,6,0,
12854,116,2022/4/15 5:20,7,5,2,
12855,116,2022/4/15 5:30,11,2,9,
12856,116,2022/4/15 5:40,16,5,11,
12857,116,2022/4/15 5:50,19,6,13,
12858,116,2022/4/15 6:00,26,42,-16,
12859,116,2022/4/15 6:10,30,47,-17,
12860,116,2022/4/15 6:20,31,38,-7,
12861,116,2022/4/15 6:30,40,65,-25,
12862,116,2022/4/15 6:40,49,62,-13,
12863,116,2022/4/15 6:50,57,93,-36,
12864,116,2022/4/15 7:00,67,106,-39,
12865,116,2022/4/15 7:10,70,107,-37,
12866,116,2022/4/15 7:20,86,119,-33,
12867,116,2022/4/15 7:30,84,126,-42,
12868,116,2022/4/15 7:40,104,147,-43,
12869,116,2022/4/15 7:50,162,197,-35,
12870,116,2022/4/15 8:00,183,296,-113,
12871,116,2022/4/15 8:10,204,431,-227,
12872,116,2022/4/15 8:20,199,432,-233,
12873,116,2022/4/15 8:30,188,431,-243,
12874,116,2022/4/15 8:40,179,578,-399,
12875,116,2022/4/15 8:50,155,425,-270,
12876,116,2022/4/15 9:00,136,502,-366,
12877,116,2022/4/15 9:10,105,317,-212,
12878,116,2022/4/15 9:20,79,266,-187,
12879,116,2022/4/15 9:30,74,178,-104,
12880,116,2022/4/15 9:40,62,149,-87,
12881,116,2022/4/15 9:50,59,116,-57,
12882,116,2022/4/15 10:00,48,117,-69,
12883,116,2022/4/15 10:10,45,110,-65,
12884,116,2022/4/15 10:20,49,113,-64,
12885,116,2022/4/15 10:30,47,106,-59,
12886,116,2022/4/15 10:40,45,108,-63,
12887,116,2022/4/15 10:50,42,91,-49,
12888,116,2022/4/15 11:00,40,96,-56,
12889,116,2022/4/15 11:10,41,87,-46,
12890,116,2022/4/15 11:20,41,90,-49,
12891,116,2022/4/15 11:30,43,77,-34,
12892,116,2022/4/15 11:40,43,93,-50,
12893,116,2022/4/15 11:50,40,81,-41,
12894,116,2022/4/15 12:00,45,74,-29,
12895,116,2022/4/15 12:10,48,90,-42,
12896,116,2022/4/15 12:20,45,105,-60,
12897,116,2022/4/15 12:30,45,98,-53,
12898,116,2022/4/15 12:40,47,90,-43,
12899,116,2022/4/15 12:50,43,109,-66,
12900,116,2022/4/15 13:00,45,98,-53,
12901,116,2022/4/15 13:10,48,108,-60,
12902,116,2022/4/15 13:20,44,103,-59,
12903,116,2022/4/15 13:30,45,93,-48,
12904,116,2022/4/15 13:40,44,109,-65,
12905,116,2022/4/15 13:50,44,90,-46,
12906,116,2022/4/15 14:00,48,91,-43,
12907,116,2022/4/15 14:10,50,96,-46,
12908,116,2022/4/15 14:20,49,88,-39,
12909,116,2022/4/15 14:30,42,99,-57,
12910,116,2022/4/15 14:40,48,82,-34,
12911,116,2022/4/15 14:50,45,93,-48,
12912,116,2022/4/15 15:00,69,86,-17,
12913,116,2022/4/15 15:10,61,93,-32,
12914,116,2022/4/15 15:20,66,91,-25,
12915,116,2022/4/15 15:30,61,97,-36,
12916,116,2022/4/15 15:40,65,93,-28,
12917,116,2022/4/15 15:50,69,101,-32,
12918,116,2022/4/15 16:00,83,88,-5,
12919,116,2022/4/15 16:10,128,96,32,
12920,116,2022/4/15 16:20,131,93,38,
12921,116,2022/4/15 16:30,147,109,38,
12922,116,2022/4/15 16:40,169,96,73,
12923,116,2022/4/15 16:50,190,109,81,
12924,116,2022/4/15 17:00,273,105,168,
12925,116,2022/4/15 17:10,269,112,157,
12926,116,2022/4/15 17:20,272,121,151,
12927,116,2022/4/15 17:30,425,100,325,
12928,116,2022/4/15 17:40,575,112,463,
12929,116,2022/4/15 17:50,311,106,205,
12930,116,2022/4/15 18:00,327,124,203,
12931,116,2022/4/15 18:10,550,123,427,
12932,116,2022/4/15 18:20,336,128,208,
12933,116,2022/4/15 18:30,275,107,168,
12934,116,2022/4/15 18:40,214,111,103,
12935,116,2022/4/15 18:50,170,113,57,
12936,116,2022/4/15 19:00,132,109,23,
12937,116,2022/4/15 19:10,105,107,-2,
12938,116,2022/4/15 19:20,70,102,-32,
12939,116,2022/4/15 19:30,55,99,-44,
12940,116,2022/4/15 19:40,50,81,-31,
12941,116,2022/4/15 19:50,40,86,-46,
12942,116,2022/4/15 20:00,41,76,-35,
12943,116,2022/4/15 20:10,42,77,-35,
12944,116,2022/4/15 20:20,40,83,-43,
12945,116,2022/4/15 20:30,43,83,-40,
12946,116,2022/4/15 20:40,34,78,-44,
12947,116,2022/4/15 20:50,34,79,-45,
12948,116,2022/4/15 21:00,42,73,-31,
12949,116,2022/4/15 21:10,40,77,-37,
12950,116,2022/4/15 21:20,37,74,-37,
12951,116,2022/4/15 21:30,31,79,-48,
12952,116,2022/4/15 21:40,27,93,-66,
12953,116,2022/4/15 21:50,27,69,-42,
12954,116,2022/4/15 22:00,25,77,-52,
12955,116,2022/4/15 22:10,27,78,-51,
12956,116,2022/4/15 22:20,23,100,-77,
12957,116,2022/4/15 22:30,17,78,-61,
12958,116,2022/4/15 22:40,15,75,-60,
12959,116,2022/4/15 22:50,10,68,-58,
12960,145,2022/4/15 5:00,2,1,1,1
12961,145,2022/4/15 5:10,15,1,14,14
12962,145,2022/4/15 5:20,32,1,31,31
12963,145,2022/4/15 5:30,36,1,35,35
12964,145,2022/4/15 5:40,44,1,43,43
12965,145,2022/4/15 5:50,51,1,50,50
12966,145,2022/4/15 6:00,142,5,137,137
12967,145,2022/4/15 6:10,128,66,62,62
12968,145,2022/4/15 6:20,246,57,189,189
12969,145,2022/4/15 6:30,301,62,239,239
12970,145,2022/4/15 6:40,385,105,280,280
12971,145,2022/4/15 6:50,652,92,560,560
12972,145,2022/4/15 7:00,681,121,560,560
12973,145,2022/4/15 7:10,1201,128,1073,1073
12974,145,2022/4/15 7:20,1357,136,1221,1221
12975,145,2022/4/15 7:30,1968,178,1790,1790
12976,145,2022/4/15 7:40,1982,268,1714,1714
12977,145,2022/4/15 7:50,2049,305,1744,1744
12978,145,2022/4/15 8:00,2554,418,2136,2136
12979,145,2022/4/15 8:10,2551,287,2264,2264
12980,145,2022/4/15 8:20,1979,383,1596,1596
12981,145,2022/4/15 8:30,1406,417,989,989
12982,145,2022/4/15 8:40,1019,262,757,757
12983,145,2022/4/15 8:50,679,460,219,219
12984,145,2022/4/15 9:00,694,309,385,385
12985,145,2022/4/15 9:10,481,278,203,203
12986,145,2022/4/15 9:20,314,260,54,54
12987,145,2022/4/15 9:30,293,314,-21,-21
12988,145,2022/4/15 9:40,271,265,6,6
12989,145,2022/4/15 9:50,218,173,45,45
12990,145,2022/4/15 10:00,225,213,12,12
12991,145,2022/4/15 10:10,211,178,33,33
12992,145,2022/4/15 10:20,215,172,43,43
12993,145,2022/4/15 10:30,213,214,-1,-1
12994,145,2022/4/15 10:40,159,118,41,41
12995,145,2022/4/15 10:50,201,168,33,33
12996,145,2022/4/15 11:00,135,110,25,25
12997,145,2022/4/15 11:10,217,108,109,109
12998,145,2022/4/15 11:20,180,169,11,11
12999,145,2022/4/15 11:30,171,118,53,53
13000,145,2022/4/15 11:40,186,124,62,62
13001,145,2022/4/15 11:50,229,120,109,109
13002,145,2022/4/15 12:00,231,139,92,92
13003,145,2022/4/15 12:10,183,104,79,79
13004,145,2022/4/15 12:20,262,124,138,138
13005,145,2022/4/15 12:30,265,115,150,150
13006,145,2022/4/15 12:40,231,180,51,51
13007,145,2022/4/15 12:50,247,111,136,136
13008,145,2022/4/15 13:00,197,110,87,87
13009,145,2022/4/15 13:10,248,126,122,122
13010,145,2022/4/15 13:20,181,158,23,23
13011,145,2022/4/15 13:30,266,129,137,137
13012,145,2022/4/15 13:40,142,120,22,22
13013,145,2022/4/15 13:50,164,142,22,22
13014,145,2022/4/15 14:00,128,193,-65,-65
13015,145,2022/4/15 14:10,137,119,18,18
13016,145,2022/4/15 14:20,177,108,69,69
13017,145,2022/4/15 14:30,143,154,-11,-11
13018,145,2022/4/15 14:40,121,193,-72,-72
13019,145,2022/4/15 14:50,203,109,94,94
13020,145,2022/4/15 15:00,118,110,8,8
13021,145,2022/4/15 15:10,166,233,-67,-67
13022,145,2022/4/15 15:20,176,159,17,17
13023,145,2022/4/15 15:30,175,181,-6,-6
13024,145,2022/4/15 15:40,163,151,12,12
13025,145,2022/4/15 15:50,163,223,-60,-60
13026,145,2022/4/15 16:00,158,224,-66,-66
13027,145,2022/4/15 16:10,188,217,-29,-29
13028,145,2022/4/15 16:20,188,216,-28,-28
13029,145,2022/4/15 16:30,255,206,49,49
13030,145,2022/4/15 16:40,272,268,4,4
13031,145,2022/4/15 16:50,317,283,34,34
13032,145,2022/4/15 17:00,261,204,57,57
13033,145,2022/4/15 17:10,336,228,108,108
13034,145,2022/4/15 17:20,442,214,228,228
13035,145,2022/4/15 17:30,443,429,14,14
13036,145,2022/4/15 17:40,301,281,20,20
13037,145,2022/4/15 17:50,327,486,-159,-159
13038,145,2022/4/15 18:00,308,484,-176,-176
13039,145,2022/4/15 18:10,308,419,-111,-111
13040,145,2022/4/15 18:20,227,2058,-1831,-1831
13041,145,2022/4/15 18:30,192,416,-224,-224
13042,145,2022/4/15 18:40,162,1957,-1795,-1795
13043,145,2022/4/15 18:50,109,1583,-1474,-1474
13044,145,2022/4/15 19:00,65,1570,-1505,-1505
13045,145,2022/4/15 19:10,57,600,-543,-543
13046,145,2022/4/15 19:20,62,476,-414,-414
13047,145,2022/4/15 19:30,45,406,-361,-361
13048,145,2022/4/15 19:40,37,300,-263,-263
13049,145,2022/4/15 19:50,41,466,-425,-425
13050,145,2022/4/15 20:00,35,232,-197,-197
13051,145,2022/4/15 20:10,39,528,-489,-489
13052,145,2022/4/15 20:20,37,197,-160,-160
13053,145,2022/4/15 20:30,28,336,-308,-308
13054,145,2022/4/15 20:40,38,271,-233,-233
13055,145,2022/4/15 20:50,35,189,-154,-154
13056,145,2022/4/15 21:00,27,218,-191,-191
13057,145,2022/4/15 21:10,35,382,-347,-347
13058,145,2022/4/15 21:20,28,196,-168,-168
13059,145,2022/4/15 21:30,24,226,-202,-202
13060,145,2022/4/15 21:40,25,198,-173,-173
13061,145,2022/4/15 21:50,23,207,-184,-184
13062,145,2022/4/15 22:00,21,149,-128,-128
13063,145,2022/4/15 22:10,14,132,-118,-118
13064,145,2022/4/15 22:20,17,184,-167,-167
13065,145,2022/4/15 22:30,11,224,-213,-213
13066,145,2022/4/15 22:40,4,105,-101,-101
13067,145,2022/4/15 22:50,1,119,-118,-118
13068,128,2022/4/15 5:00,0,1,-1,
13069,128,2022/4/15 5:10,4,1,3,
13070,128,2022/4/15 5:20,4,1,3,
13071,128,2022/4/15 5:30,6,21,-15,
13072,128,2022/4/15 5:40,14,15,-1,
13073,128,2022/4/15 5:50,13,23,-10,
13074,128,2022/4/15 6:00,24,106,-82,
13075,128,2022/4/15 6:10,21,103,-82,
13076,128,2022/4/15 6:20,31,259,-228,
13077,128,2022/4/15 6:30,39,378,-339,
13078,128,2022/4/15 6:40,45,491,-446,
13079,128,2022/4/15 6:50,59,490,-431,
13080,128,2022/4/15 7:00,82,410,-328,
13081,128,2022/4/15 7:10,182,516,-334,
13082,128,2022/4/15 7:20,196,411,-215,
13083,128,2022/4/15 7:30,250,590,-340,
13084,128,2022/4/15 7:40,302,1136,-834,
13085,128,2022/4/15 7:50,449,1123,-674,
13086,128,2022/4/15 8:00,367,560,-193,
13087,128,2022/4/15 8:10,650,1428,-778,
13088,128,2022/4/15 8:20,915,1475,-560,
13089,128,2022/4/15 8:30,347,1029,-682,
13090,128,2022/4/15 8:40,616,1478,-862,
13091,128,2022/4/15 8:50,281,551,-270,
13092,128,2022/4/15 9:00,280,568,-288,
13093,128,2022/4/15 9:10,587,466,121,
13094,128,2022/4/15 9:20,270,558,-288,
13095,128,2022/4/15 9:30,364,465,-101,
13096,128,2022/4/15 9:40,211,411,-200,
13097,128,2022/4/15 9:50,83,395,-312,
13098,128,2022/4/15 10:00,68,420,-352,
13099,128,2022/4/15 10:10,272,476,-204,
13100,128,2022/4/15 10:20,203,315,-112,
13101,128,2022/4/15 10:30,206,460,-254,
13102,128,2022/4/15 10:40,270,324,-54,
13103,128,2022/4/15 10:50,184,271,-87,
13104,128,2022/4/15 11:00,160,323,-163,
13105,128,2022/4/15 11:10,170,272,-102,
13106,128,2022/4/15 11:20,255,240,15,
13107,128,2022/4/15 11:30,195,212,-17,
13108,128,2022/4/15 11:40,230,276,-46,
13109,128,2022/4/15 11:50,200,288,-88,
13110,128,2022/4/15 12:00,160,232,-72,
13111,128,2022/4/15 12:10,130,172,-42,
13112,128,2022/4/15 12:20,195,297,-102,
13113,128,2022/4/15 12:30,143,319,-176,
13114,128,2022/4/15 12:40,265,290,-25,
13115,128,2022/4/15 12:50,238,280,-42,
13116,128,2022/4/15 13:00,256,469,-213,
13117,128,2022/4/15 13:10,607,437,170,
13118,128,2022/4/15 13:20,336,475,-139,
13119,128,2022/4/15 13:30,621,295,326,
13120,128,2022/4/15 13:40,336,360,-24,
13121,128,2022/4/15 13:50,636,367,269,
13122,128,2022/4/15 14:00,339,311,28,
13123,128,2022/4/15 14:10,367,290,77,
13124,128,2022/4/15 14:20,456,465,-9,
13125,128,2022/4/15 14:30,589,351,238,
13126,128,2022/4/15 14:40,564,328,236,
13127,128,2022/4/15 14:50,455,290,165,
13128,128,2022/4/15 15:00,679,472,207,
13129,128,2022/4/15 15:10,638,473,165,
13130,128,2022/4/15 15:20,572,367,205,
13131,128,2022/4/15 15:30,655,467,188,
13132,128,2022/4/15 15:40,583,360,223,
13133,128,2022/4/15 15:50,336,468,-132,
13134,128,2022/4/15 16:00,637,287,350,
13135,128,2022/4/15 16:10,839,456,383,
13136,128,2022/4/15 16:20,637,288,349,
13137,128,2022/4/15 16:30,820,456,364,
13138,128,2022/4/15 16:40,620,309,311,
13139,128,2022/4/15 16:50,428,315,113,
13140,128,2022/4/15 17:00,830,331,499,
13141,128,2022/4/15 17:10,834,284,550,
13142,128,2022/4/15 17:20,600,364,236,
13143,128,2022/4/15 17:30,1247,415,832,
13144,128,2022/4/15 17:40,1415,324,1091,
13145,128,2022/4/15 17:50,643,344,299,
13146,128,2022/4/15 18:00,457,371,86,
13147,128,2022/4/15 18:10,697,644,53,
13148,128,2022/4/15 18:20,735,418,317,
13149,128,2022/4/15 18:30,611,518,93,
13150,128,2022/4/15 18:40,336,734,-398,
13151,128,2022/4/15 18:50,828,376,452,
13152,128,2022/4/15 19:00,1204,371,833,
13153,128,2022/4/15 19:10,733,453,280,
13154,128,2022/4/15 19:20,649,344,305,
13155,128,2022/4/15 19:30,326,269,57,
13156,128,2022/4/15 19:40,721,272,449,
13157,128,2022/4/15 19:50,679,239,440,
13158,128,2022/4/15 20:00,801,220,581,
13159,128,2022/4/15 20:10,845,117,728,
13160,128,2022/4/15 20:20,813,116,697,
13161,128,2022/4/15 20:30,637,172,465,
13162,128,2022/4/15 20:40,817,110,707,
13163,128,2022/4/15 20:50,643,139,504,
13164,128,2022/4/15 21:00,615,112,503,
13165,128,2022/4/15 21:10,583,117,466,
13166,128,2022/4/15 21:20,812,100,712,
13167,128,2022/4/15 21:30,321,100,221,
13168,128,2022/4/15 21:40,582,101,481,
13169,128,2022/4/15 21:50,248,72,176,
13170,128,2022/4/15 22:00,193,92,101,
13171,128,2022/4/15 22:10,434,92,342,
13172,128,2022/4/15 22:20,326,88,238,
13173,128,2022/4/15 22:30,129,74,55,
13174,128,2022/4/15 22:40,78,73,5,
13175,128,2022/4/15 22:50,56,60,-4,
13176,127,2022/4/15 5:00,2,1,1,
13177,127,2022/4/15 5:10,5,1,4,
13178,127,2022/4/15 5:20,8,1,7,
13179,127,2022/4/15 5:30,9,6,3,
13180,127,2022/4/15 5:40,20,5,15,
13181,127,2022/4/15 5:50,22,8,14,
13182,127,2022/4/15 6:00,26,83,-57,
13183,127,2022/4/15 6:10,31,69,-38,
13184,127,2022/4/15 6:20,29,85,-56,
13185,127,2022/4/15 6:30,45,118,-73,
13186,127,2022/4/15 6:40,51,101,-50,
13187,127,2022/4/15 6:50,68,119,-51,
13188,127,2022/4/15 7:00,87,105,-18,
13189,127,2022/4/15 7:10,146,128,18,
13190,127,2022/4/15 7:20,146,109,37,
13191,127,2022/4/15 7:30,185,151,34,
13192,127,2022/4/15 7:40,302,159,143,
13193,127,2022/4/15 7:50,326,335,-9,
13194,127,2022/4/15 8:00,601,510,91,
13195,127,2022/4/15 8:10,609,315,294,
13196,127,2022/4/15 8:20,475,492,-17,
13197,127,2022/4/15 8:30,321,327,-6,
13198,127,2022/4/15 8:40,327,176,151,
13199,127,2022/4/15 8:50,276,195,81,
13200,127,2022/4/15 9:00,203,119,84,
13201,127,2022/4/15 9:10,201,142,59,
13202,127,2022/4/15 9:20,179,113,66,
13203,127,2022/4/15 9:30,137,109,28,
13204,127,2022/4/15 9:40,79,108,-29,
13205,127,2022/4/15 9:50,72,108,-36,
13206,127,2022/4/15 10:00,54,113,-59,
13207,127,2022/4/15 10:10,62,121,-59,
13208,127,2022/4/15 10:20,44,121,-77,
13209,127,2022/4/15 10:30,51,123,-72,
13210,127,2022/4/15 10:40,48,124,-76,
13211,127,2022/4/15 10:50,50,119,-69,
13212,127,2022/4/15 11:00,54,119,-65,
13213,127,2022/4/15 11:10,53,108,-55,
13214,127,2022/4/15 11:20,58,110,-52,
13215,127,2022/4/15 11:30,63,124,-61,
13216,127,2022/4/15 11:40,59,110,-51,
13217,127,2022/4/15 11:50,58,107,-49,
13218,127,2022/4/15 12:00,70,99,-29,
13219,127,2022/4/15 12:10,110,123,-13,
13220,127,2022/4/15 12:20,86,112,-26,
13221,127,2022/4/15 12:30,59,106,-47,
13222,127,2022/4/15 12:40,59,104,-45,
13223,127,2022/4/15 12:50,63,123,-60,
13224,127,2022/4/15 13:00,55,103,-48,
13225,127,2022/4/15 13:10,52,105,-53,
13226,127,2022/4/15 13:20,52,100,-48,
13227,127,2022/4/15 13:30,59,122,-63,
13228,127,2022/4/15 13:40,55,114,-59,
13229,127,2022/4/15 13:50,67,102,-35,
13230,127,2022/4/15 14:00,53,102,-49,
13231,127,2022/4/15 14:10,57,104,-47,
13232,127,2022/4/15 14:20,56,113,-57,
13233,127,2022/4/15 14:30,64,99,-35,
13234,127,2022/4/15 14:40,56,102,-46,
13235,127,2022/4/15 14:50,50,126,-76,
13236,127,2022/4/15 15:00,65,100,-35,
13237,127,2022/4/15 15:10,70,102,-32,
13238,127,2022/4/15 15:20,64,107,-43,
13239,127,2022/4/15 15:30,69,101,-32,
13240,127,2022/4/15 15:40,72,120,-48,
13241,127,2022/4/15 15:50,87,101,-14,
13242,127,2022/4/15 16:00,105,101,4,
13243,127,2022/4/15 16:10,175,123,52,
13244,127,2022/4/15 16:20,136,104,32,
13245,127,2022/4/15 16:30,173,121,52,
13246,127,2022/4/15 16:40,161,96,65,
13247,127,2022/4/15 16:50,202,108,94,
13248,127,2022/4/15 17:00,330,115,215,
13249,127,2022/4/15 17:10,310,108,202,
13250,127,2022/4/15 17:20,304,122,182,
13251,127,2022/4/15 17:30,270,103,167,
13252,127,2022/4/15 17:40,273,183,90,
13253,127,2022/4/15 17:50,267,196,71,
13254,127,2022/4/15 18:00,264,235,29,
13255,127,2022/4/15 18:10,211,116,95,
13256,127,2022/4/15 18:20,203,271,-68,
13257,127,2022/4/15 18:30,211,198,13,
13258,127,2022/4/15 18:40,177,170,7,
13259,127,2022/4/15 18:50,173,209,-36,
13260,127,2022/4/15 19:00,150,118,32,
13261,127,2022/4/15 19:10,137,151,-14,
13262,127,2022/4/15 19:20,123,111,12,
13263,127,2022/4/15 19:30,120,112,8,
13264,127,2022/4/15 19:40,126,103,23,
13265,127,2022/4/15 19:50,74,112,-38,
13266,127,2022/4/15 20:00,96,103,-7,
13267,127,2022/4/15 20:10,110,77,33,
13268,127,2022/4/15 20:20,81,103,-22,
13269,127,2022/4/15 20:30,71,77,-6,
13270,127,2022/4/15 20:40,57,99,-42,
13271,127,2022/4/15 20:50,63,71,-8,
13272,127,2022/4/15 21:00,65,81,-16,
13273,127,2022/4/15 21:10,57,50,7,
13274,127,2022/4/15 21:20,47,77,-30,
13275,127,2022/4/15 21:30,46,79,-33,
13276,127,2022/4/15 21:40,43,62,-19,
13277,127,2022/4/15 21:50,44,71,-27,
13278,127,2022/4/15 22:00,42,63,-21,
13279,127,2022/4/15 22:10,42,71,-29,
13280,127,2022/4/15 22:20,34,68,-34,
13281,127,2022/4/15 22:30,29,66,-37,
13282,127,2022/4/15 22:40,23,49,-26,
13283,127,2022/4/15 22:50,20,51,-31,
13284,142,2022/4/15 5:00,1,1,0,
13285,142,2022/4/15 5:10,5,1,4,
13286,142,2022/4/15 5:20,20,1,19,
13287,142,2022/4/15 5:30,36,1,35,
13288,142,2022/4/15 5:40,38,6,32,
13289,142,2022/4/15 5:50,57,25,32,
13290,142,2022/4/15 6:00,124,21,103,
13291,142,2022/4/15 6:10,151,47,104,
13292,142,2022/4/15 6:20,227,62,165,
13293,142,2022/4/15 6:30,350,99,251,
13294,142,2022/4/15 6:40,662,113,549,
13295,142,2022/4/15 6:50,722,93,629,
13296,142,2022/4/15 7:00,829,100,729,
13297,142,2022/4/15 7:10,1206,110,1096,
13298,142,2022/4/15 7:20,1380,115,1265,
13299,142,2022/4/15 7:30,1977,323,1654,
13300,142,2022/4/15 7:40,2071,537,1534,
13301,142,2022/4/15 7:50,2559,493,2066,
13302,142,2022/4/15 8:00,3341,732,2609,
13303,142,2022/4/15 8:10,3326,1875,1451,
13304,142,2022/4/15 8:20,3237,2194,1043,
13305,142,2022/4/15 8:30,1978,6106,-4128,
13306,142,2022/4/15 8:40,1578,6142,-4564,
13307,142,2022/4/15 8:50,1357,4332,-2975,
13308,142,2022/4/15 9:00,1028,1875,-847,
13309,142,2022/4/15 9:10,720,1099,-379,
13310,142,2022/4/15 9:20,649,581,68,
13311,142,2022/4/15 9:30,553,427,126,
13312,142,2022/4/15 9:40,351,515,-164,
13313,142,2022/4/15 9:50,276,386,-110,
13314,142,2022/4/15 10:00,220,276,-56,
13315,142,2022/4/15 10:10,221,197,24,
13316,142,2022/4/15 10:20,189,181,8,
13317,142,2022/4/15 10:30,212,119,93,
13318,142,2022/4/15 10:40,175,116,59,
13319,142,2022/4/15 10:50,174,118,56,
13320,142,2022/4/15 11:00,174,108,66,
13321,142,2022/4/15 11:10,174,122,52,
13322,142,2022/4/15 11:20,180,105,75,
13323,142,2022/4/15 11:30,182,116,66,
13324,142,2022/4/15 11:40,216,109,107,
13325,142,2022/4/15 11:50,214,118,96,
13326,142,2022/4/15 12:00,209,108,101,
13327,142,2022/4/15 12:10,272,114,158,
13328,142,2022/4/15 12:20,199,116,83,
13329,142,2022/4/15 12:30,214,110,104,
13330,142,2022/4/15 12:40,209,150,59,
13331,142,2022/4/15 12:50,205,128,77,
13332,142,2022/4/15 13:00,197,184,13,
13333,142,2022/4/15 13:10,196,130,66,
13334,142,2022/4/15 13:20,174,184,-10,
13335,142,2022/4/15 13:30,174,117,57,
13336,142,2022/4/15 13:40,150,184,-34,
13337,142,2022/4/15 13:50,148,126,22,
13338,142,2022/4/15 14:00,114,152,-38,
13339,142,2022/4/15 14:10,173,122,51,
13340,142,2022/4/15 14:20,143,146,-3,
13341,142,2022/4/15 14:30,134,127,7,
13342,142,2022/4/15 14:40,147,150,-3,
13343,142,2022/4/15 14:50,144,115,29,
13344,142,2022/4/15 15:00,137,150,-13,
13345,142,2022/4/15 15:10,173,138,35,
13346,142,2022/4/15 15:20,173,185,-12,
13347,142,2022/4/15 15:30,165,185,-20,
13348,142,2022/4/15 15:40,214,181,33,
13349,142,2022/4/15 15:50,166,192,-26,
13350,142,2022/4/15 16:00,182,207,-25,
13351,142,2022/4/15 16:10,201,145,56,
13352,142,2022/4/15 16:20,224,231,-7,
13353,142,2022/4/15 16:30,235,196,39,
13354,142,2022/4/15 16:40,269,296,-27,
13355,142,2022/4/15 16:50,270,298,-28,
13356,142,2022/4/15 17:00,456,331,125,
13357,142,2022/4/15 17:10,703,376,327,
13358,142,2022/4/15 17:20,633,424,209,
13359,142,2022/4/15 17:30,802,492,310,
13360,142,2022/4/15 17:40,1592,569,1023,
13361,142,2022/4/15 17:50,1561,593,968,
13362,142,2022/4/15 18:00,1589,1074,515,
13363,142,2022/4/15 18:10,3331,1084,2247,
13364,142,2022/4/15 18:20,3213,557,2656,
13365,142,2022/4/15 18:30,1982,1479,503,
13366,142,2022/4/15 18:40,1361,1471,-110,
13367,142,2022/4/15 18:50,828,1013,-185,
13368,142,2022/4/15 19:00,696,1078,-382,
13369,142,2022/4/15 19:10,575,593,-18,
13370,142,2022/4/15 19:20,423,428,-5,
13371,142,2022/4/15 19:30,294,430,-136,
13372,142,2022/4/15 19:40,277,534,-257,
13373,142,2022/4/15 19:50,223,328,-105,
13374,142,2022/4/15 20:00,217,328,-111,
13375,142,2022/4/15 20:10,234,322,-88,
13376,142,2022/4/15 20:20,207,334,-127,
13377,142,2022/4/15 20:30,142,336,-194,
13378,142,2022/4/15 20:40,137,207,-70,
13379,142,2022/4/15 20:50,87,329,-242,
13380,142,2022/4/15 21:00,70,231,-161,
13381,142,2022/4/15 21:10,148,207,-59,
13382,142,2022/4/15 21:20,78,298,-220,
13383,142,2022/4/15 21:30,47,270,-223,
13384,142,2022/4/15 21:40,47,328,-281,
13385,142,2022/4/15 21:50,36,300,-264,
13386,142,2022/4/15 22:00,29,237,-208,
13387,142,2022/4/15 22:10,31,224,-193,
13388,142,2022/4/15 22:20,26,232,-206,
13389,142,2022/4/15 22:30,20,276,-256,
13390,142,2022/4/15 22:40,13,185,-172,
13391,142,2022/4/15 22:50,9,133,-124,
13392,121,2022/4/15 5:00,0,1,-1,
13393,121,2022/4/15 5:10,2,1,1,
13394,121,2022/4/15 5:20,15,1,14,
13395,121,2022/4/15 5:30,24,1,23,
13396,121,2022/4/15 5:40,31,5,26,
13397,121,2022/4/15 5:50,35,16,19,
13398,121,2022/4/15 6:00,52,16,36,
13399,121,2022/4/15 6:10,60,11,49,
13400,121,2022/4/15 6:20,89,40,49,
13401,121,2022/4/15 6:30,183,32,151,
13402,121,2022/4/15 6:40,231,63,168,
13403,121,2022/4/15 6:50,277,73,204,
13404,121,2022/4/15 7:00,337,80,257,
13405,121,2022/4/15 7:10,325,83,242,
13406,121,2022/4/15 7:20,475,108,367,
13407,121,2022/4/15 7:30,682,127,555,
13408,121,2022/4/15 7:40,869,122,747,
13409,121,2022/4/15 7:50,1234,122,1112,
13410,121,2022/4/15 8:00,1577,110,1467,
13411,121,2022/4/15 8:10,1582,159,1423,
13412,121,2022/4/15 8:20,1389,222,1167,
13413,121,2022/4/15 8:30,1217,180,1037,
13414,121,2022/4/15 8:40,862,213,649,
13415,121,2022/4/15 8:50,705,178,527,
13416,121,2022/4/15 9:00,614,133,481,
13417,121,2022/4/15 9:10,434,109,325,
13418,121,2022/4/15 9:20,314,113,201,
13419,121,2022/4/15 9:30,229,121,108,
13420,121,2022/4/15 9:40,219,103,116,
13421,121,2022/4/15 9:50,181,104,77,
13422,121,2022/4/15 10:00,139,101,38,
13423,121,2022/4/15 10:10,96,108,-12,
13424,121,2022/4/15 10:20,86,92,-6,
13425,121,2022/4/15 10:30,70,98,-28,
13426,121,2022/4/15 10:40,62,96,-34,
13427,121,2022/4/15 10:50,58,93,-35,
13428,121,2022/4/15 11:00,57,90,-33,
13429,121,2022/4/15 11:10,53,96,-43,
13430,121,2022/4/15 11:20,60,93,-33,
13431,121,2022/4/15 11:30,54,93,-39,
13432,121,2022/4/15 11:40,51,98,-47,
13433,121,2022/4/15 11:50,55,111,-56,
13434,121,2022/4/15 12:00,69,101,-32,
13435,121,2022/4/15 12:10,62,109,-47,
13436,121,2022/4/15 12:20,72,105,-33,
13437,121,2022/4/15 12:30,77,108,-31,
13438,121,2022/4/15 12:40,70,109,-39,
13439,121,2022/4/15 12:50,76,99,-23,
13440,121,2022/4/15 13:00,76,106,-30,
13441,121,2022/4/15 13:10,70,111,-41,
13442,121,2022/4/15 13:20,62,102,-40,
13443,121,2022/4/15 13:30,62,101,-39,
13444,121,2022/4/15 13:40,59,103,-44,
13445,121,2022/4/15 13:50,56,102,-46,
13446,121,2022/4/15 14:00,46,105,-59,
13447,121,2022/4/15 14:10,48,106,-58,
13448,121,2022/4/15 14:20,47,103,-56,
13449,121,2022/4/15 14:30,48,106,-58,
13450,121,2022/4/15 14:40,46,116,-70,
13451,121,2022/4/15 14:50,46,103,-57,
13452,121,2022/4/15 15:00,45,104,-59,
13453,121,2022/4/15 15:10,48,107,-59,
13454,121,2022/4/15 15:20,45,119,-74,
13455,121,2022/4/15 15:30,49,104,-55,
13456,121,2022/4/15 15:40,44,109,-65,
13457,121,2022/4/15 15:50,45,129,-84,
13458,121,2022/4/15 16:00,60,125,-65,
13459,121,2022/4/15 16:10,71,114,-43,
13460,121,2022/4/15 16:20,65,121,-56,
13461,121,2022/4/15 16:30,76,133,-57,
13462,121,2022/4/15 16:40,96,159,-63,
13463,121,2022/4/15 16:50,79,170,-91,
13464,121,2022/4/15 17:00,219,155,64,
13465,121,2022/4/15 17:10,207,229,-22,
13466,121,2022/4/15 17:20,147,296,-149,
13467,121,2022/4/15 17:30,206,318,-112,
13468,121,2022/4/15 17:40,240,498,-258,
13469,121,2022/4/15 17:50,198,416,-218,
13470,121,2022/4/15 18:00,201,434,-233,
13471,121,2022/4/15 18:10,202,432,-230,
13472,121,2022/4/15 18:20,164,430,-266,
13473,121,2022/4/15 18:30,96,570,-474,
13474,121,2022/4/15 18:40,75,424,-349,
13475,121,2022/4/15 18:50,68,429,-361,
13476,121,2022/4/15 19:00,53,418,-365,
13477,121,2022/4/15 19:10,48,528,-480,
13478,121,2022/4/15 19:20,47,326,-279,
13479,121,2022/4/15 19:30,42,256,-214,
13480,121,2022/4/15 19:40,37,179,-142,
13481,121,2022/4/15 19:50,34,177,-143,
13482,121,2022/4/15 20:00,37,159,-122,
13483,121,2022/4/15 20:10,35,185,-150,
13484,121,2022/4/15 20:20,36,181,-145,
13485,121,2022/4/15 20:30,40,109,-69,
13486,121,2022/4/15 20:40,37,192,-155,
13487,121,2022/4/15 20:50,29,109,-80,
13488,121,2022/4/15 21:00,28,180,-152,
13489,121,2022/4/15 21:10,28,109,-81,
13490,121,2022/4/15 21:20,31,124,-93,
13491,121,2022/4/15 21:30,24,109,-85,
13492,121,2022/4/15 21:40,33,119,-86,
13493,121,2022/4/15 21:50,26,116,-90,
13494,121,2022/4/15 22:00,24,105,-81,
13495,121,2022/4/15 22:10,25,112,-87,
13496,121,2022/4/15 22:20,17,102,-85,
13497,121,2022/4/15 22:30,12,111,-99,
13498,121,2022/4/15 22:40,9,111,-102,
13499,121,2022/4/15 22:50,5,98,-93,
13500,144,2022/4/15 5:00,0,1,-1,
13501,144,2022/4/15 5:10,0,1,-1,
13502,144,2022/4/15 5:20,6,1,5,
13503,144,2022/4/15 5:30,13,1,12,
13504,144,2022/4/15 5:40,20,2,18,
13505,144,2022/4/15 5:50,21,19,2,
13506,144,2022/4/15 6:00,32,11,21,
13507,144,2022/4/15 6:10,36,16,20,
13508,144,2022/4/15 6:20,48,47,1,
13509,144,2022/4/15 6:30,56,60,-4,
13510,144,2022/4/15 6:40,94,68,26,
13511,144,2022/4/15 6:50,184,99,85,
13512,144,2022/4/15 7:00,248,102,146,
13513,144,2022/4/15 7:10,282,128,154,
13514,144,2022/4/15 7:20,346,120,226,
13515,144,2022/4/15 7:30,590,116,474,
13516,144,2022/4/15 7:40,686,128,558,
13517,144,2022/4/15 7:50,861,198,663,
13518,144,2022/4/15 8:00,864,267,597,
13519,144,2022/4/15 8:10,1055,321,734,
13520,144,2022/4/15 8:20,859,431,428,
13521,144,2022/4/15 8:30,740,579,161,
13522,144,2022/4/15 8:40,627,482,145,
13523,144,2022/4/15 8:50,572,520,52,
13524,144,2022/4/15 9:00,340,299,41,
13525,144,2022/4/15 9:10,271,198,73,
13526,144,2022/4/15 9:20,219,139,80,
13527,144,2022/4/15 9:30,183,117,66,
13528,144,2022/4/15 9:40,143,110,33,
13529,144,2022/4/15 9:50,93,119,-26,
13530,144,2022/4/15 10:00,80,105,-25,
13531,144,2022/4/15 10:10,69,105,-36,
13532,144,2022/4/15 10:20,60,105,-45,
13533,144,2022/4/15 10:30,44,98,-54,
13534,144,2022/4/15 10:40,44,93,-49,
13535,144,2022/4/15 10:50,46,104,-58,
13536,144,2022/4/15 11:00,47,93,-46,
13537,144,2022/4/15 11:10,47,93,-46,
13538,144,2022/4/15 11:20,46,93,-47,
13539,144,2022/4/15 11:30,47,106,-59,
13540,144,2022/4/15 11:40,48,105,-57,
13541,144,2022/4/15 11:50,48,104,-56,
13542,144,2022/4/15 12:00,55,105,-50,
13543,144,2022/4/15 12:10,57,106,-49,
13544,144,2022/4/15 12:20,55,104,-49,
13545,144,2022/4/15 12:30,62,104,-42,
13546,144,2022/4/15 12:40,64,108,-44,
13547,144,2022/4/15 12:50,53,104,-51,
13548,144,2022/4/15 13:00,61,105,-44,
13549,144,2022/4/15 13:10,67,113,-46,
13550,144,2022/4/15 13:20,60,105,-45,
13551,144,2022/4/15 13:30,56,107,-51,
13552,144,2022/4/15 13:40,58,104,-46,
13553,144,2022/4/15 13:50,56,112,-56,
13554,144,2022/4/15 14:00,52,101,-49,
13555,144,2022/4/15 14:10,48,98,-50,
13556,144,2022/4/15 14:20,56,105,-49,
13557,144,2022/4/15 14:30,49,108,-59,
13558,144,2022/4/15 14:40,55,108,-53,
13559,144,2022/4/15 14:50,58,126,-68,
13560,144,2022/4/15 15:00,63,108,-45,
13561,144,2022/4/15 15:10,77,124,-47,
13562,144,2022/4/15 15:20,68,100,-32,
13563,144,2022/4/15 15:30,57,116,-59,
13564,144,2022/4/15 15:40,60,123,-63,
13565,144,2022/4/15 15:50,65,117,-52,
13566,144,2022/4/15 16:00,64,104,-40,
13567,144,2022/4/15 16:10,83,105,-22,
13568,144,2022/4/15 16:20,82,110,-28,
13569,144,2022/4/15 16:30,144,127,17,
13570,144,2022/4/15 16:40,224,110,114,
13571,144,2022/4/15 16:50,212,159,53,
13572,144,2022/4/15 17:00,223,117,106,
13573,144,2022/4/15 17:10,331,195,136,
13574,144,2022/4/15 17:20,272,194,78,
13575,144,2022/4/15 17:30,272,297,-25,
13576,144,2022/4/15 17:40,579,329,250,
13577,144,2022/4/15 17:50,371,315,56,
13578,144,2022/4/15 18:00,316,326,-10,
13579,144,2022/4/15 18:10,576,380,196,
13580,144,2022/4/15 18:20,616,506,110,
13581,144,2022/4/15 18:30,291,510,-219,
13582,144,2022/4/15 18:40,230,535,-305,
13583,144,2022/4/15 18:50,188,320,-132,
13584,144,2022/4/15 19:00,128,351,-223,
13585,144,2022/4/15 19:10,92,257,-165,
13586,144,2022/4/15 19:20,72,158,-86,
13587,144,2022/4/15 19:30,55,158,-103,
13588,144,2022/4/15 19:40,47,108,-61,
13589,144,2022/4/15 19:50,44,116,-72,
13590,144,2022/4/15 20:00,44,107,-63,
13591,144,2022/4/15 20:10,57,110,-53,
13592,144,2022/4/15 20:20,57,118,-61,
13593,144,2022/4/15 20:30,46,105,-59,
13594,144,2022/4/15 20:40,45,109,-64,
13595,144,2022/4/15 20:50,43,122,-79,
13596,144,2022/4/15 21:00,43,106,-63,
13597,144,2022/4/15 21:10,45,104,-59,
13598,144,2022/4/15 21:20,37,98,-61,
13599,144,2022/4/15 21:30,32,109,-77,
13600,144,2022/4/15 21:40,28,101,-73,
13601,144,2022/4/15 21:50,29,84,-55,
13602,144,2022/4/15 22:00,35,89,-54,
13603,144,2022/4/15 22:10,25,111,-86,
13604,144,2022/4/15 22:20,22,107,-85,
13605,144,2022/4/15 22:30,13,113,-100,
13606,144,2022/4/15 22:40,13,82,-69,
13607,144,2022/4/15 22:50,9,70,-61,
13608,135,2022/4/15 5:00,0,1,-1,
13609,135,2022/4/15 5:10,5,1,4,
13610,135,2022/4/15 5:20,8,1,7,
13611,135,2022/4/15 5:30,19,1,18,
13612,135,2022/4/15 5:40,34,2,32,
13613,135,2022/4/15 5:50,35,33,2,
13614,135,2022/4/15 6:00,53,19,34,
13615,135,2022/4/15 6:10,66,41,25,
13616,135,2022/4/15 6:20,85,40,45,
13617,135,2022/4/15 6:30,155,68,87,
13618,135,2022/4/15 6:40,216,92,124,
13619,135,2022/4/15 6:50,273,103,170,
13620,135,2022/4/15 7:00,348,121,227,
13621,135,2022/4/15 7:10,443,114,329,
13622,135,2022/4/15 7:20,597,206,391,
13623,135,2022/4/15 7:30,629,343,286,
13624,135,2022/4/15 7:40,821,441,380,
13625,135,2022/4/15 7:50,1177,1156,21,
13626,135,2022/4/15 8:00,1216,2741,-1525,
13627,135,2022/4/15 8:10,1363,2566,-1203,
13628,135,2022/4/15 8:20,1387,2504,-1117,
13629,135,2022/4/15 8:30,1216,3899,-2683,
13630,135,2022/4/15 8:40,870,5928,-5058,
13631,135,2022/4/15 8:50,695,5126,-4431,
13632,135,2022/4/15 9:00,709,2882,-2173,
13633,135,2022/4/15 9:10,582,2032,-1450,
13634,135,2022/4/15 9:20,374,1084,-710,
13635,135,2022/4/15 9:30,344,551,-207,
13636,135,2022/4/15 9:40,274,410,-136,
13637,135,2022/4/15 9:50,217,379,-162,
13638,135,2022/4/15 10:00,211,327,-116,
13639,135,2022/4/15 10:10,208,209,-1,
13640,135,2022/4/15 10:20,184,180,4,
13641,135,2022/4/15 10:30,208,179,29,
13642,135,2022/4/15 10:40,187,214,-27,
13643,135,2022/4/15 10:50,174,140,34,
13644,135,2022/4/15 11:00,184,198,-14,
13645,135,2022/4/15 11:10,185,115,70,
13646,135,2022/4/15 11:20,178,179,-1,
13647,135,2022/4/15 11:30,185,146,39,
13648,135,2022/4/15 11:40,204,198,6,
13649,135,2022/4/15 11:50,181,146,35,
13650,135,2022/4/15 12:00,202,192,10,
13651,135,2022/4/15 12:10,214,160,54,
13652,135,2022/4/15 12:20,241,223,18,
13653,135,2022/4/15 12:30,238,154,84,
13654,135,2022/4/15 12:40,257,198,59,
13655,135,2022/4/15 12:50,246,213,33,
13656,135,2022/4/15 13:00,272,223,49,
13657,135,2022/4/15 13:10,264,181,83,
13658,135,2022/4/15 13:20,257,218,39,
13659,135,2022/4/15 13:30,224,181,43,
13660,135,2022/4/15 13:40,234,233,1,
13661,135,2022/4/15 13:50,224,180,44,
13662,135,2022/4/15 14:00,235,197,38,
13663,135,2022/4/15 14:10,228,192,36,
13664,135,2022/4/15 14:20,226,180,46,
13665,135,2022/4/15 14:30,225,185,40,
13666,135,2022/4/15 14:40,226,198,28,
13667,135,2022/4/15 14:50,265,159,106,
13668,135,2022/4/15 15:00,241,180,61,
13669,135,2022/4/15 15:10,258,192,66,
13670,135,2022/4/15 15:20,239,214,25,
13671,135,2022/4/15 15:30,240,214,26,
13672,135,2022/4/15 15:40,266,197,69,
13673,135,2022/4/15 15:50,243,198,45,
13674,135,2022/4/15 16:00,272,207,65,
13675,135,2022/4/15 16:10,306,212,94,
13676,135,2022/4/15 16:20,304,216,88,
13677,135,2022/4/15 16:30,345,218,127,
13678,135,2022/4/15 16:40,371,284,87,
13679,135,2022/4/15 16:50,556,255,301,
13680,135,2022/4/15 17:00,670,314,356,
13681,135,2022/4/15 17:10,1205,381,824,
13682,135,2022/4/15 17:20,1140,503,637,
13683,135,2022/4/15 17:30,1149,426,723,
13684,135,2022/4/15 17:40,2484,426,2058,
13685,135,2022/4/15 17:50,2057,568,1489,
13686,135,2022/4/15 18:00,1987,575,1412,
13687,135,2022/4/15 18:10,2551,575,1976,
13688,135,2022/4/15 18:20,2004,574,1430,
13689,135,2022/4/15 18:30,1590,1093,497,
13690,135,2022/4/15 18:40,1149,570,579,
13691,135,2022/4/15 18:50,815,577,238,
13692,135,2022/4/15 19:00,638,421,217,
13693,135,2022/4/15 19:10,636,417,219,
13694,135,2022/4/15 19:20,587,519,68,
13695,135,2022/4/15 19:30,456,379,77,
13696,135,2022/4/15 19:40,353,299,54,
13697,135,2022/4/15 19:50,332,257,75,
13698,135,2022/4/15 20:00,324,223,101,
13699,135,2022/4/15 20:10,327,184,143,
13700,135,2022/4/15 20:20,336,169,167,
13701,135,2022/4/15 20:30,301,199,102,
13702,135,2022/4/15 20:40,275,120,155,
13703,135,2022/4/15 20:50,269,191,78,
13704,135,2022/4/15 21:00,292,180,112,
13705,135,2022/4/15 21:10,317,137,180,
13706,135,2022/4/15 21:20,236,181,55,
13707,135,2022/4/15 21:30,225,137,88,
13708,135,2022/4/15 21:40,215,150,65,
13709,135,2022/4/15 21:50,189,116,73,
13710,135,2022/4/15 22:00,274,109,165,
13711,135,2022/4/15 22:10,314,120,194,
13712,135,2022/4/15 22:20,150,109,41,
13713,135,2022/4/15 22:30,40,126,-86,
13714,135,2022/4/15 22:40,24,112,-88,
13715,135,2022/4/15 22:50,24,101,-77,
13716,148,2022/4/15 5:00,0,1,-1,
13717,148,2022/4/15 5:10,1,1,0,
13718,148,2022/4/15 5:20,9,1,8,
13719,148,2022/4/15 5:30,16,1,15,
13720,148,2022/4/15 5:40,30,8,22,
13721,148,2022/4/15 5:50,29,23,6,
13722,148,2022/4/15 6:00,38,30,8,
13723,148,2022/4/15 6:10,51,39,12,
13724,148,2022/4/15 6:20,60,64,-4,
13725,148,2022/4/15 6:30,74,77,-3,
13726,148,2022/4/15 6:40,147,110,37,
13727,148,2022/4/15 6:50,227,112,115,
13728,148,2022/4/15 7:00,284,126,158,
13729,148,2022/4/15 7:10,275,112,163,
13730,148,2022/4/15 7:20,383,159,224,
13731,148,2022/4/15 7:30,596,197,399,
13732,148,2022/4/15 7:40,678,269,409,
13733,148,2022/4/15 7:50,871,329,542,
13734,148,2022/4/15 8:00,1170,420,750,
13735,148,2022/4/15 8:10,1208,553,655,
13736,148,2022/4/15 8:20,1213,1089,124,
13737,148,2022/4/15 8:30,1184,1117,67,
13738,148,2022/4/15 8:40,868,2006,-1138,
13739,148,2022/4/15 8:50,678,1582,-904,
13740,148,2022/4/15 9:00,615,1124,-509,
13741,148,2022/4/15 9:10,586,1127,-541,
13742,148,2022/4/15 9:20,330,589,-259,
13743,148,2022/4/15 9:30,309,417,-108,
13744,148,2022/4/15 9:40,246,426,-180,
13745,148,2022/4/15 9:50,217,436,-219,
13746,148,2022/4/15 10:00,215,334,-119,
13747,148,2022/4/15 10:10,190,297,-107,
13748,148,2022/4/15 10:20,196,221,-25,
13749,148,2022/4/15 10:30,184,197,-13,
13750,148,2022/4/15 10:40,174,222,-48,
13751,148,2022/4/15 10:50,168,207,-39,
13752,148,2022/4/15 11:00,175,222,-47,
13753,148,2022/4/15 11:10,185,223,-38,
13754,148,2022/4/15 11:20,187,180,7,
13755,148,2022/4/15 11:30,206,233,-27,
13756,148,2022/4/15 11:40,212,218,-6,
13757,148,2022/4/15 11:50,208,234,-26,
13758,148,2022/4/15 12:00,236,232,4,
13759,148,2022/4/15 12:10,257,196,61,
13760,148,2022/4/15 12:20,264,232,32,
13761,148,2022/4/15 12:30,274,255,19,
13762,148,2022/4/15 12:40,269,283,-14,
13763,148,2022/4/15 12:50,273,283,-10,
13764,148,2022/4/15 13:00,271,216,55,
13765,148,2022/4/15 13:10,262,232,30,
13766,148,2022/4/15 13:20,270,217,53,
13767,148,2022/4/15 13:30,265,232,33,
13768,148,2022/4/15 13:40,286,233,53,
13769,148,2022/4/15 13:50,267,269,-2,
13770,148,2022/4/15 14:00,269,232,37,
13771,148,2022/4/15 14:10,265,196,69,
13772,148,2022/4/15 14:20,268,233,35,
13773,148,2022/4/15 14:30,268,196,72,
13774,148,2022/4/15 14:40,264,218,46,
13775,148,2022/4/15 14:50,260,218,42,
13776,148,2022/4/15 15:00,262,232,30,
13777,148,2022/4/15 15:10,317,267,50,
13778,148,2022/4/15 15:20,261,216,45,
13779,148,2022/4/15 15:30,288,297,-9,
13780,148,2022/4/15 15:40,316,290,26,
13781,148,2022/4/15 15:50,291,320,-29,
13782,148,2022/4/15 16:00,312,318,-6,
13783,148,2022/4/15 16:10,329,297,32,
13784,148,2022/4/15 16:20,310,339,-29,
13785,148,2022/4/15 16:30,309,311,-2,
13786,148,2022/4/15 16:40,368,316,52,
13787,148,2022/4/15 16:50,350,318,32,
13788,148,2022/4/15 17:00,634,500,134,
13789,148,2022/4/15 17:10,794,498,296,
13790,148,2022/4/15 17:20,637,419,218,
13791,148,2022/4/15 17:30,836,560,276,
13792,148,2022/4/15 17:40,1156,561,595,
13793,148,2022/4/15 17:50,832,1115,-283,
13794,148,2022/4/15 18:00,1025,1784,-759,
13795,148,2022/4/15 18:10,1352,1110,242,
13796,148,2022/4/15 18:20,1163,1694,-531,
13797,148,2022/4/15 18:30,831,1519,-688,
13798,148,2022/4/15 18:40,706,1752,-1046,
13799,148,2022/4/15 18:50,646,1479,-833,
13800,148,2022/4/15 19:00,615,606,9,
13801,148,2022/4/15 19:10,587,469,118,
13802,148,2022/4/15 19:20,542,415,127,
13803,148,2022/4/15 19:30,422,494,-72,
13804,148,2022/4/15 19:40,425,341,84,
13805,148,2022/4/15 19:50,314,327,-13,
13806,148,2022/4/15 20:00,429,236,193,
13807,148,2022/4/15 20:10,549,218,331,
13808,148,2022/4/15 20:20,369,234,135,
13809,148,2022/4/15 20:30,550,221,329,
13810,148,2022/4/15 20:40,585,179,406,
13811,148,2022/4/15 20:50,571,150,421,
13812,148,2022/4/15 21:00,591,192,399,
13813,148,2022/4/15 21:10,614,191,423,
13814,148,2022/4/15 21:20,558,142,416,
13815,148,2022/4/15 21:30,585,192,393,
13816,148,2022/4/15 21:40,466,110,356,
13817,148,2022/4/15 21:50,322,115,207,
13818,148,2022/4/15 22:00,576,128,448,
13819,148,2022/4/15 22:10,258,133,125,
13820,148,2022/4/15 22:20,124,110,14,
13821,148,2022/4/15 22:30,44,112,-68,
13822,148,2022/4/15 22:40,26,103,-77,
13823,148,2022/4/15 22:50,23,94,-71,
13824,130,2022/4/15 5:00,0,1,-1,
13825,130,2022/4/15 5:10,0,1,-1,
13826,130,2022/4/15 5:20,3,1,2,
13827,130,2022/4/15 5:30,11,1,10,
13828,130,2022/4/15 5:40,21,6,15,
13829,130,2022/4/15 5:50,26,21,5,
13830,130,2022/4/15 6:00,26,23,3,
13831,130,2022/4/15 6:10,34,49,-15,
13832,130,2022/4/15 6:20,40,48,-8,
13833,130,2022/4/15 6:30,54,72,-18,
13834,130,2022/4/15 6:40,69,76,-7,
13835,130,2022/4/15 6:50,85,96,-11,
13836,130,2022/4/15 7:00,102,102,0,
13837,130,2022/4/15 7:10,190,183,7,
13838,130,2022/4/15 7:20,215,224,-9,
13839,130,2022/4/15 7:30,242,232,10,
13840,130,2022/4/15 7:40,317,316,1,
13841,130,2022/4/15 7:50,367,505,-138,
13842,130,2022/4/15 8:00,571,584,-13,
13843,130,2022/4/15 8:10,598,1537,-939,
13844,130,2022/4/15 8:20,628,1757,-1129,
13845,130,2022/4/15 8:30,572,2665,-2093,
13846,130,2022/4/15 8:40,350,2349,-1999,
13847,130,2022/4/15 8:50,282,2742,-2460,
13848,130,2022/4/15 9:00,270,1537,-1267,
13849,130,2022/4/15 9:10,237,1124,-887,
13850,130,2022/4/15 9:20,216,561,-345,
13851,130,2022/4/15 9:30,190,405,-215,
13852,130,2022/4/15 9:40,187,376,-189,
13853,130,2022/4/15 9:50,156,254,-98,
13854,130,2022/4/15 10:00,108,233,-125,
13855,130,2022/4/15 10:10,89,183,-94,
13856,130,2022/4/15 10:20,95,181,-86,
13857,130,2022/4/15 10:30,91,117,-26,
13858,130,2022/4/15 10:40,84,122,-38,
13859,130,2022/4/15 10:50,101,108,-7,
13860,130,2022/4/15 11:00,81,124,-43,
13861,130,2022/4/15 11:10,98,108,-10,
13862,130,2022/4/15 11:20,123,125,-2,
13863,130,2022/4/15 11:30,131,122,9,
13864,130,2022/4/15 11:40,148,102,46,
13865,130,2022/4/15 11:50,131,104,27,
13866,130,2022/4/15 12:00,135,121,14,
13867,130,2022/4/15 12:10,131,106,25,
13868,130,2022/4/15 12:20,128,123,5,
13869,130,2022/4/15 12:30,132,108,24,
13870,130,2022/4/15 12:40,132,108,24,
13871,130,2022/4/15 12:50,109,119,-10,
13872,130,2022/4/15 13:00,132,129,3,
13873,130,2022/4/15 13:10,137,170,-33,
13874,130,2022/4/15 13:20,170,139,31,
13875,130,2022/4/15 13:30,144,128,16,
13876,130,2022/4/15 13:40,148,126,22,
13877,130,2022/4/15 13:50,153,117,36,
13878,130,2022/4/15 14:00,156,111,45,
13879,130,2022/4/15 14:10,156,108,48,
13880,130,2022/4/15 14:20,173,109,64,
13881,130,2022/4/15 14:30,169,106,63,
13882,130,2022/4/15 14:40,171,120,51,
13883,130,2022/4/15 14:50,164,109,55,
13884,130,2022/4/15 15:00,206,114,92,
13885,130,2022/4/15 15:10,192,121,71,
13886,130,2022/4/15 15:20,196,109,87,
13887,130,2022/4/15 15:30,216,108,108,
13888,130,2022/4/15 15:40,207,105,102,
13889,130,2022/4/15 15:50,218,109,109,
13890,130,2022/4/15 16:00,216,122,94,
13891,130,2022/4/15 16:10,221,109,112,
13892,130,2022/4/15 16:20,224,121,103,
13893,130,2022/4/15 16:30,265,108,157,
13894,130,2022/4/15 16:40,329,125,204,
13895,130,2022/4/15 16:50,336,128,208,
13896,130,2022/4/15 17:00,697,138,559,
13897,130,2022/4/15 17:10,1044,142,902,
13898,130,2022/4/15 17:20,696,145,551,
13899,130,2022/4/15 17:30,713,196,517,
13900,130,2022/4/15 17:40,1594,298,1296,
13901,130,2022/4/15 17:50,1206,298,908,
13902,130,2022/4/15 18:00,1033,301,732,
13903,130,2022/4/15 18:10,1992,284,1708,
13904,130,2022/4/15 18:20,1568,300,1268,
13905,130,2022/4/15 18:30,1035,301,734,
13906,130,2022/4/15 18:40,698,301,397,
13907,130,2022/4/15 18:50,575,300,275,
13908,130,2022/4/15 19:00,310,224,86,
13909,130,2022/4/15 19:10,347,179,168,
13910,130,2022/4/15 19:20,270,111,159,
13911,130,2022/4/15 19:30,220,107,113,
13912,130,2022/4/15 19:40,218,125,93,
13913,130,2022/4/15 19:50,173,117,56,
13914,130,2022/4/15 20:00,174,88,86,
13915,130,2022/4/15 20:10,175,108,67,
13916,130,2022/4/15 20:20,137,103,34,
13917,130,2022/4/15 20:30,137,114,23,
13918,130,2022/4/15 20:40,114,107,7,
13919,130,2022/4/15 20:50,96,104,-8,
13920,130,2022/4/15 21:00,101,106,-5,
13921,130,2022/4/15 21:10,133,108,25,
13922,130,2022/4/15 21:20,77,121,-44,
13923,130,2022/4/15 21:30,66,112,-46,
13924,130,2022/4/15 21:40,49,110,-61,
13925,130,2022/4/15 21:50,42,111,-69,
13926,130,2022/4/15 22:00,39,103,-64,
13927,130,2022/4/15 22:10,41,105,-64,
13928,130,2022/4/15 22:20,28,112,-84,
13929,130,2022/4/15 22:30,27,98,-71,
13930,130,2022/4/15 22:40,23,79,-56,
13931,130,2022/4/15 22:50,14,73,-59,
13932,132,2022/4/15 5:00,0,1,-1,
13933,132,2022/4/15 5:10,4,1,3,
13934,132,2022/4/15 5:20,7,1,6,
13935,132,2022/4/15 5:30,15,1,14,
13936,132,2022/4/15 5:40,22,15,7,
13937,132,2022/4/15 5:50,25,30,-5,
13938,132,2022/4/15 6:00,31,53,-22,
13939,132,2022/4/15 6:10,36,65,-29,
13940,132,2022/4/15 6:20,31,107,-76,
13941,132,2022/4/15 6:30,42,109,-67,
13942,132,2022/4/15 6:40,54,108,-54,
13943,132,2022/4/15 6:50,72,121,-49,
13944,132,2022/4/15 7:00,99,266,-167,
13945,132,2022/4/15 7:10,148,313,-165,
13946,132,2022/4/15 7:20,190,439,-249,
13947,132,2022/4/15 7:30,227,426,-199,
13948,132,2022/4/15 7:40,274,572,-298,
13949,132,2022/4/15 7:50,343,1120,-777,
13950,132,2022/4/15 8:00,436,2063,-1627,
13951,132,2022/4/15 8:10,468,2811,-2343,
13952,132,2022/4/15 8:20,571,2437,-1866,
13953,132,2022/4/15 8:30,383,4184,-3801,
13954,132,2022/4/15 8:40,339,6572,-6233,
13955,132,2022/4/15 8:50,303,5902,-5599,
13956,132,2022/4/15 9:00,275,4439,-4164,
13957,132,2022/4/15 9:10,271,6273,-6002,
13958,132,2022/4/15 9:20,275,4112,-3837,
13959,132,2022/4/15 9:30,229,2394,-2165,
13960,132,2022/4/15 9:40,237,2506,-2269,
13961,132,2022/4/15 9:50,228,1497,-1269,
13962,132,2022/4/15 10:00,212,601,-389,
13963,132,2022/4/15 10:10,221,482,-261,
13964,132,2022/4/15 10:20,233,415,-182,
13965,132,2022/4/15 10:30,237,499,-262,
13966,132,2022/4/15 10:40,244,427,-183,
13967,132,2022/4/15 10:50,263,324,-61,
13968,132,2022/4/15 11:00,268,379,-111,
13969,132,2022/4/15 11:10,266,336,-70,
13970,132,2022/4/15 11:20,267,378,-111,
13971,132,2022/4/15 11:30,263,334,-71,
13972,132,2022/4/15 11:40,298,432,-134,
13973,132,2022/4/15 11:50,298,317,-19,
13974,132,2022/4/15 12:00,335,433,-98,
13975,132,2022/4/15 12:10,327,378,-51,
13976,132,2022/4/15 12:20,328,424,-96,
13977,132,2022/4/15 12:30,332,419,-87,
13978,132,2022/4/15 12:40,333,499,-166,
13979,132,2022/4/15 12:50,327,344,-17,
13980,132,2022/4/15 13:00,327,500,-173,
13981,132,2022/4/15 13:10,310,417,-107,
13982,132,2022/4/15 13:20,349,516,-167,
13983,132,2022/4/15 13:30,312,380,-68,
13984,132,2022/4/15 13:40,421,499,-78,
13985,132,2022/4/15 13:50,370,338,32,
13986,132,2022/4/15 14:00,463,433,30,
13987,132,2022/4/15 14:10,547,337,210,
13988,132,2022/4/15 14:20,544,376,168,
13989,132,2022/4/15 14:30,590,316,274,
13990,132,2022/4/15 14:40,455,332,123,
13991,132,2022/4/15 14:50,573,267,306,
13992,132,2022/4/15 15:00,580,332,248,
13993,132,2022/4/15 15:10,581,282,299,
13994,132,2022/4/15 15:20,588,318,270,
13995,132,2022/4/15 15:30,678,254,424,
13996,132,2022/4/15 15:40,679,338,341,
13997,132,2022/4/15 15:50,622,298,324,
13998,132,2022/4/15 16:00,678,318,360,
13999,132,2022/4/15 16:10,655,282,373,
14000,132,2022/4/15 16:20,659,298,361,
14001,132,2022/4/15 16:30,703,233,470,
14002,132,2022/4/15 16:40,804,298,506,
14003,132,2022/4/15 16:50,829,319,510,
14004,132,2022/4/15 17:00,1344,313,1031,
14005,132,2022/4/15 17:10,1971,312,1659,
14006,132,2022/4/15 17:20,1557,489,1068,
14007,132,2022/4/15 17:30,1977,409,1568,
14008,132,2022/4/15 17:40,2555,472,2083,
14009,132,2022/4/15 17:50,1986,472,1514,
14010,132,2022/4/15 18:00,1993,565,1428,
14011,132,2022/4/15 18:10,3368,561,2807,
14012,132,2022/4/15 18:20,3030,560,2470,
14013,132,2022/4/15 18:30,1986,565,1421,
14014,132,2022/4/15 18:40,1974,558,1416,
14015,132,2022/4/15 18:50,1584,561,1023,
14016,132,2022/4/15 19:00,1353,418,935,
14017,132,2022/4/15 19:10,1199,374,825,
14018,132,2022/4/15 19:20,1036,321,715,
14019,132,2022/4/15 19:30,798,232,566,
14020,132,2022/4/15 19:40,668,179,489,
14021,132,2022/4/15 19:50,653,158,495,
14022,132,2022/4/15 20:00,657,115,542,
14023,132,2022/4/15 20:10,668,116,552,
14024,132,2022/4/15 20:20,678,104,574,
14025,132,2022/4/15 20:30,694,124,570,
14026,132,2022/4/15 20:40,647,124,523,
14027,132,2022/4/15 20:50,675,122,553,
14028,132,2022/4/15 21:00,682,120,562,
14029,132,2022/4/15 21:10,672,100,572,
14030,132,2022/4/15 21:20,623,114,509,
14031,132,2022/4/15 21:30,574,102,472,
14032,132,2022/4/15 21:40,685,115,570,
14033,132,2022/4/15 21:50,561,111,450,
14034,132,2022/4/15 22:00,607,110,497,
14035,132,2022/4/15 22:10,729,103,626,
14036,132,2022/4/15 22:20,306,103,203,
14037,132,2022/4/15 22:30,132,92,40,
14038,132,2022/4/15 22:40,54,79,-25,
14039,132,2022/4/15 22:50,26,77,-51,
14040,138,2022/4/15 5:00,0,1,-1,
14041,138,2022/4/15 5:10,3,1,2,
14042,138,2022/4/15 5:20,7,1,6,
14043,138,2022/4/15 5:30,15,1,14,
14044,138,2022/4/15 5:40,19,21,-2,
14045,138,2022/4/15 5:50,29,14,15,
14046,138,2022/4/15 6:00,28,50,-22,
14047,138,2022/4/15 6:10,33,73,-40,
14048,138,2022/4/15 6:20,37,75,-38,
14049,138,2022/4/15 6:30,51,110,-59,
14050,138,2022/4/15 6:40,59,121,-62,
14051,138,2022/4/15 6:50,91,133,-42,
14052,138,2022/4/15 7:00,123,183,-60,
14053,138,2022/4/15 7:10,169,331,-162,
14054,138,2022/4/15 7:20,185,435,-250,
14055,138,2022/4/15 7:30,232,509,-277,
14056,138,2022/4/15 7:40,278,492,-214,
14057,138,2022/4/15 7:50,367,1152,-785,
14058,138,2022/4/15 8:00,596,1926,-1330,
14059,138,2022/4/15 8:10,589,4236,-3647,
14060,138,2022/4/15 8:20,598,4076,-3478,
14061,138,2022/4/15 8:30,475,5453,-4978,
14062,138,2022/4/15 8:40,354,5392,-5038,
14063,138,2022/4/15 8:50,346,5351,-5005,
14064,138,2022/4/15 9:00,274,6341,-6067,
14065,138,2022/4/15 9:10,260,5964,-5704,
14066,138,2022/4/15 9:20,225,4214,-3989,
14067,138,2022/4/15 9:30,232,2729,-2497,
14068,138,2022/4/15 9:40,226,2301,-2075,
14069,138,2022/4/15 9:50,200,1777,-1577,
14070,138,2022/4/15 10:00,211,610,-399,
14071,138,2022/4/15 10:10,226,421,-195,
14072,138,2022/4/15 10:20,218,425,-207,
14073,138,2022/4/15 10:30,225,524,-299,
14074,138,2022/4/15 10:40,227,502,-275,
14075,138,2022/4/15 10:50,226,314,-88,
14076,138,2022/4/15 11:00,238,316,-78,
14077,138,2022/4/15 11:10,266,332,-66,
14078,138,2022/4/15 11:20,270,331,-61,
14079,138,2022/4/15 11:30,271,318,-47,
14080,138,2022/4/15 11:40,273,333,-60,
14081,138,2022/4/15 11:50,268,333,-65,
14082,138,2022/4/15 12:00,291,322,-31,
14083,138,2022/4/15 12:10,333,332,1,
14084,138,2022/4/15 12:20,304,317,-13,
14085,138,2022/4/15 12:30,299,428,-129,
14086,138,2022/4/15 12:40,311,339,-28,
14087,138,2022/4/15 12:50,311,492,-181,
14088,138,2022/4/15 13:00,330,319,11,
14089,138,2022/4/15 13:10,343,486,-143,
14090,138,2022/4/15 13:20,348,377,-29,
14091,138,2022/4/15 13:30,326,373,-47,
14092,138,2022/4/15 13:40,333,432,-99,
14093,138,2022/4/15 13:50,325,318,7,
14094,138,2022/4/15 14:00,326,316,10,
14095,138,2022/4/15 14:10,422,317,105,
14096,138,2022/4/15 14:20,309,332,-23,
14097,138,2022/4/15 14:30,352,325,27,
14098,138,2022/4/15 14:40,367,326,41,
14099,138,2022/4/15 14:50,370,232,138,
14100,138,2022/4/15 15:00,426,253,173,
14101,138,2022/4/15 15:10,552,297,255,
14102,138,2022/4/15 15:20,544,232,312,
14103,138,2022/4/15 15:30,579,233,346,
14104,138,2022/4/15 15:40,584,268,316,
14105,138,2022/4/15 15:50,590,195,395,
14106,138,2022/4/15 16:00,636,195,441,
14107,138,2022/4/15 16:10,686,216,470,
14108,138,2022/4/15 16:20,627,282,345,
14109,138,2022/4/15 16:30,709,207,502,
14110,138,2022/4/15 16:40,823,255,568,
14111,138,2022/4/15 16:50,1023,327,696,
14112,138,2022/4/15 17:00,1571,330,1241,
14113,138,2022/4/15 17:10,1988,315,1673,
14114,138,2022/4/15 17:20,1634,368,1266,
14115,138,2022/4/15 17:30,1986,427,1559,
14116,138,2022/4/15 17:40,3338,423,2915,
14117,138,2022/4/15 17:50,2558,410,2148,
14118,138,2022/4/15 18:00,2487,426,2061,
14119,138,2022/4/15 18:10,3391,482,2909,
14120,138,2022/4/15 18:20,3342,412,2930,
14121,138,2022/4/15 18:30,2071,417,1654,
14122,138,2022/4/15 18:40,1994,481,1513,
14123,138,2022/4/15 18:50,1645,424,1221,
14124,138,2022/4/15 19:00,1350,514,836,
14125,138,2022/4/15 19:10,1150,318,832,
14126,138,2022/4/15 19:20,839,270,569,
14127,138,2022/4/15 19:30,650,226,424,
14128,138,2022/4/15 19:40,654,179,475,
14129,138,2022/4/15 19:50,692,136,556,
14130,138,2022/4/15 20:00,637,128,509,
14131,138,2022/4/15 20:10,694,109,585,
14132,138,2022/4/15 20:20,615,100,515,
14133,138,2022/4/15 20:30,585,123,462,
14134,138,2022/4/15 20:40,617,119,498,
14135,138,2022/4/15 20:50,589,107,482,
14136,138,2022/4/15 21:00,682,107,575,
14137,138,2022/4/15 21:10,648,102,546,
14138,138,2022/4/15 21:20,594,122,472,
14139,138,2022/4/15 21:30,601,112,489,
14140,138,2022/4/15 21:40,648,104,544,
14141,138,2022/4/15 21:50,595,104,491,
14142,138,2022/4/15 22:00,628,100,528,
14143,138,2022/4/15 22:10,372,106,266,
14144,138,2022/4/15 22:20,203,95,108,
14145,138,2022/4/15 22:30,119,85,34,
14146,138,2022/4/15 22:40,41,69,-28,
14147,138,2022/4/15 22:50,24,69,-45,
14148,137,2022/4/15 5:00,0,1,-1,
14149,137,2022/4/15 5:10,2,1,1,
14150,137,2022/4/15 5:20,10,1,9,
14151,137,2022/4/15 5:30,14,8,6,
14152,137,2022/4/15 5:40,18,6,12,
14153,137,2022/4/15 5:50,23,11,12,
14154,137,2022/4/15 6:00,22,40,-18,
14155,137,2022/4/15 6:10,27,64,-37,
14156,137,2022/4/15 6:20,31,62,-31,
14157,137,2022/4/15 6:30,38,74,-36,
14158,137,2022/4/15 6:40,41,111,-70,
14159,137,2022/4/15 6:50,40,105,-65,
14160,137,2022/4/15 7:00,47,120,-73,
14161,137,2022/4/15 7:10,56,126,-70,
14162,137,2022/4/15 7:20,74,212,-138,
14163,137,2022/4/15 7:30,76,323,-247,
14164,137,2022/4/15 7:40,94,508,-414,
14165,137,2022/4/15 7:50,169,484,-315,
14166,137,2022/4/15 8:00,183,1810,-1627,
14167,137,2022/4/15 8:10,226,2426,-2200,
14168,137,2022/4/15 8:20,224,2142,-1918,
14169,137,2022/4/15 8:30,216,2545,-2329,
14170,137,2022/4/15 8:40,184,8977,-8793,
14171,137,2022/4/15 8:50,157,4543,-4386,
14172,137,2022/4/15 9:00,145,2814,-2669,
14173,137,2022/4/15 9:10,142,2158,-2016,
14174,137,2022/4/15 9:20,137,1555,-1418,
14175,137,2022/4/15 9:30,155,1098,-943,
14176,137,2022/4/15 9:40,136,571,-435,
14177,137,2022/4/15 9:50,100,475,-375,
14178,137,2022/4/15 10:00,137,427,-290,
14179,137,2022/4/15 10:10,153,433,-280,
14180,137,2022/4/15 10:20,147,374,-227,
14181,137,2022/4/15 10:30,172,347,-175,
14182,137,2022/4/15 10:40,174,324,-150,
14183,137,2022/4/15 10:50,162,318,-156,
14184,137,2022/4/15 11:00,180,297,-117,
14185,137,2022/4/15 11:10,205,232,-27,
14186,137,2022/4/15 11:20,218,298,-80,
14187,137,2022/4/15 11:30,211,298,-87,
14188,137,2022/4/15 11:40,221,299,-78,
14189,137,2022/4/15 11:50,225,318,-93,
14190,137,2022/4/15 12:00,243,268,-25,
14191,137,2022/4/15 12:10,254,267,-13,
14192,137,2022/4/15 12:20,258,318,-60,
14193,137,2022/4/15 12:30,267,298,-31,
14194,137,2022/4/15 12:40,276,326,-50,
14195,137,2022/4/15 12:50,272,333,-61,
14196,137,2022/4/15 13:00,287,326,-39,
14197,137,2022/4/15 13:10,309,326,-17,
14198,137,2022/4/15 13:20,315,318,-3,
14199,137,2022/4/15 13:30,333,326,7,
14200,137,2022/4/15 13:40,330,298,32,
14201,137,2022/4/15 13:50,344,326,18,
14202,137,2022/4/15 14:00,332,325,7,
14203,137,2022/4/15 14:10,348,232,116,
14204,137,2022/4/15 14:20,333,325,8,
14205,137,2022/4/15 14:30,343,254,89,
14206,137,2022/4/15 14:40,330,233,97,
14207,137,2022/4/15 14:50,332,269,63,
14208,137,2022/4/15 15:00,371,226,145,
14209,137,2022/4/15 15:10,372,218,154,
14210,137,2022/4/15 15:20,349,226,123,
14211,137,2022/4/15 15:30,352,219,133,
14212,137,2022/4/15 15:40,369,208,161,
14213,137,2022/4/15 15:50,461,223,238,
14214,137,2022/4/15 16:00,576,178,398,
14215,137,2022/4/15 16:10,570,180,390,
14216,137,2022/4/15 16:20,579,198,381,
14217,137,2022/4/15 16:30,621,180,441,
14218,137,2022/4/15 16:40,687,214,473,
14219,137,2022/4/15 16:50,696,198,498,
14220,137,2022/4/15 17:00,1193,178,1015,
14221,137,2022/4/15 17:10,1555,228,1327,
14222,137,2022/4/15 17:20,1202,316,886,
14223,137,2022/4/15 17:30,1586,325,1261,
14224,137,2022/4/15 17:40,2008,326,1682,
14225,137,2022/4/15 17:50,1562,339,1223,
14226,137,2022/4/15 18:00,1583,521,1062,
14227,137,2022/4/15 18:10,1978,522,1456,
14228,137,2022/4/15 18:20,1534,366,1168,
14229,137,2022/4/15 18:30,1143,523,620,
14230,137,2022/4/15 18:40,1146,482,664,
14231,137,2022/4/15 18:50,798,325,473,
14232,137,2022/4/15 19:00,670,256,414,
14233,137,2022/4/15 19:10,655,229,426,
14234,137,2022/4/15 19:20,575,148,427,
14235,137,2022/4/15 19:30,565,108,457,
14236,137,2022/4/15 19:40,588,113,475,
14237,137,2022/4/15 19:50,548,109,439,
14238,137,2022/4/15 20:00,559,116,443,
14239,137,2022/4/15 20:10,582,102,480,
14240,137,2022/4/15 20:20,551,105,446,
14241,137,2022/4/15 20:30,553,104,449,
14242,137,2022/4/15 20:40,571,104,467,
14243,137,2022/4/15 20:50,465,106,359,
14244,137,2022/4/15 21:00,588,89,499,
14245,137,2022/4/15 21:10,590,102,488,
14246,137,2022/4/15 21:20,582,95,487,
14247,137,2022/4/15 21:30,593,95,498,
14248,137,2022/4/15 21:40,353,91,262,
14249,137,2022/4/15 21:50,339,85,254,
14250,137,2022/4/15 22:00,714,93,621,
14251,137,2022/4/15 22:10,267,78,189,
14252,137,2022/4/15 22:20,116,93,23,
14253,137,2022/4/15 22:30,101,75,26,
14254,137,2022/4/15 22:40,33,84,-51,
14255,137,2022/4/15 22:50,24,70,-46,
14256,136,2022/4/15 5:00,4,1,3,
14257,136,2022/4/15 5:10,6,1,5,
14258,136,2022/4/15 5:20,26,1,25,
14259,136,2022/4/15 5:30,19,1,18,
14260,136,2022/4/15 5:40,32,6,26,
14261,136,2022/4/15 5:50,31,14,17,
14262,136,2022/4/15 6:00,42,82,-40,
14263,136,2022/4/15 6:10,42,76,-34,
14264,136,2022/4/15 6:20,30,105,-75,
14265,136,2022/4/15 6:30,45,112,-67,
14266,136,2022/4/15 6:40,53,105,-52,
14267,136,2022/4/15 6:50,58,192,-134,
14268,136,2022/4/15 7:00,77,281,-204,
14269,136,2022/4/15 7:10,95,287,-192,
14270,136,2022/4/15 7:20,99,376,-277,
14271,136,2022/4/15 7:30,156,1528,-1372,
14272,136,2022/4/15 7:40,182,2801,-2619,
14273,136,2022/4/15 7:50,216,5057,-4841,
14274,136,2022/4/15 8:00,275,4121,-3846,
14275,136,2022/4/15 8:10,274,14814,-14540,
14276,136,2022/4/15 8:20,274,12876,-12602,
14277,136,2022/4/15 8:30,280,11749,-11469,
14278,136,2022/4/15 8:40,278,14995,-14717,
14279,136,2022/4/15 8:50,227,8814,-8587,
14280,136,2022/4/15 9:00,267,13667,-13400,
14281,136,2022/4/15 9:10,267,6907,-6640,
14282,136,2022/4/15 9:20,220,4308,-4088,
14283,136,2022/4/15 9:30,220,3506,-3286,
14284,136,2022/4/15 9:40,205,4116,-3911,
14285,136,2022/4/15 9:50,198,2125,-1927,
14286,136,2022/4/15 10:00,211,599,-388,
14287,136,2022/4/15 10:10,213,422,-209,
14288,136,2022/4/15 10:20,215,430,-215,
14289,136,2022/4/15 10:30,259,428,-169,
14290,136,2022/4/15 10:40,257,491,-234,
14291,136,2022/4/15 10:50,242,518,-276,
14292,136,2022/4/15 11:00,269,376,-107,
14293,136,2022/4/15 11:10,270,375,-105,
14294,136,2022/4/15 11:20,289,379,-90,
14295,136,2022/4/15 11:30,332,379,-47,
14296,136,2022/4/15 11:40,366,380,-14,
14297,136,2022/4/15 11:50,347,315,32,
14298,136,2022/4/15 12:00,310,325,-15,
14299,136,2022/4/15 12:10,425,337,88,
14300,136,2022/4/15 12:20,368,332,36,
14301,136,2022/4/15 12:30,325,516,-191,
14302,136,2022/4/15 12:40,333,501,-168,
14303,136,2022/4/15 12:50,308,508,-200,
14304,136,2022/4/15 13:00,308,490,-182,
14305,136,2022/4/15 13:10,422,425,-3,
14306,136,2022/4/15 13:20,426,427,-1,
14307,136,2022/4/15 13:30,422,417,5,
14308,136,2022/4/15 13:40,422,427,-5,
14309,136,2022/4/15 13:50,461,497,-36,
14310,136,2022/4/15 14:00,423,428,-5,
14311,136,2022/4/15 14:10,457,431,26,
14312,136,2022/4/15 14:20,463,383,80,
14313,136,2022/4/15 14:30,554,381,173,
14314,136,2022/4/15 14:40,460,339,121,
14315,136,2022/4/15 14:50,454,345,109,
14316,136,2022/4/15 15:00,568,317,251,
14317,136,2022/4/15 15:10,639,317,322,
14318,136,2022/4/15 15:20,610,322,288,
14319,136,2022/4/15 15:30,618,322,296,
14320,136,2022/4/15 15:40,637,324,313,
14321,136,2022/4/15 15:50,616,318,298,
14322,136,2022/4/15 16:00,693,331,362,
14323,136,2022/4/15 16:10,709,317,392,
14324,136,2022/4/15 16:20,714,289,425,
14325,136,2022/4/15 16:30,800,333,467,
14326,136,2022/4/15 16:40,1163,326,837,
14327,136,2022/4/15 16:50,1164,324,840,
14328,136,2022/4/15 17:00,1659,324,1335,
14329,136,2022/4/15 17:10,3407,316,3091,
14330,136,2022/4/15 17:20,3328,485,2843,
14331,136,2022/4/15 17:30,3332,398,2934,
14332,136,2022/4/15 17:40,3705,410,3295,
14333,136,2022/4/15 17:50,3670,412,3258,
14334,136,2022/4/15 18:00,3488,454,3034,
14335,136,2022/4/15 18:10,3730,468,3262,
14336,136,2022/4/15 18:20,3669,407,3262,
14337,136,2022/4/15 18:30,3466,470,2996,
14338,136,2022/4/15 18:40,3413,471,2942,
14339,136,2022/4/15 18:50,3468,393,3075,
14340,136,2022/4/15 19:00,2551,471,2080,
14341,136,2022/4/15 19:10,2549,319,2230,
14342,136,2022/4/15 19:20,1982,249,1733,
14343,136,2022/4/15 19:30,1583,227,1356,
14344,136,2022/4/15 19:40,1340,225,1115,
14345,136,2022/4/15 19:50,1191,106,1085,
14346,136,2022/4/15 20:00,1197,119,1078,
14347,136,2022/4/15 20:10,1192,120,1072,
14348,136,2022/4/15 20:20,1151,120,1031,
14349,136,2022/4/15 20:30,1012,121,891,
14350,136,2022/4/15 20:40,1016,128,888,
14351,136,2022/4/15 20:50,1010,100,910,
14352,136,2022/4/15 21:00,1021,121,900,
14353,136,2022/4/15 21:10,1180,119,1061,
14354,136,2022/4/15 21:20,1013,116,897,
14355,136,2022/4/15 21:30,889,127,762,
14356,136,2022/4/15 21:40,836,104,732,
14357,136,2022/4/15 21:50,668,117,551,
14358,136,2022/4/15 22:00,1258,105,1153,
14359,136,2022/4/15 22:10,802,105,697,
14360,136,2022/4/15 22:20,363,86,277,
14361,136,2022/4/15 22:30,201,104,97,
14362,136,2022/4/15 22:40,119,82,37,
14363,136,2022/4/15 22:50,34,73,-39,
14364,124,2022/4/15 5:00,1,1,0,
14365,124,2022/4/15 5:10,8,1,7,
14366,124,2022/4/15 5:20,20,1,19,
14367,124,2022/4/15 5:30,20,6,14,
14368,124,2022/4/15 5:40,23,1,22,
14369,124,2022/4/15 5:50,32,1,31,
14370,124,2022/4/15 6:00,33,21,12,
14371,124,2022/4/15 6:10,40,75,-35,
14372,124,2022/4/15 6:20,56,77,-21,
14373,124,2022/4/15 6:30,79,68,11,
14374,124,2022/4/15 6:40,108,105,3,
14375,124,2022/4/15 6:50,155,160,-5,
14376,124,2022/4/15 7:00,196,216,-20,
14377,124,2022/4/15 7:10,233,157,76,
14378,124,2022/4/15 7:20,280,190,90,
14379,124,2022/4/15 7:30,340,386,-46,
14380,124,2022/4/15 7:40,597,431,166,
14381,124,2022/4/15 7:50,722,580,142,
14382,124,2022/4/15 8:00,819,1870,-1051,
14383,124,2022/4/15 8:10,868,2581,-1713,
14384,124,2022/4/15 8:20,1183,2167,-984,
14385,124,2022/4/15 8:30,1054,6395,-5341,
14386,124,2022/4/15 8:40,734,7344,-6610,
14387,124,2022/4/15 8:50,715,6363,-5648,
14388,124,2022/4/15 9:00,579,2599,-2020,
14389,124,2022/4/15 9:10,434,1917,-1483,
14390,124,2022/4/15 9:20,340,571,-231,
14391,124,2022/4/15 9:30,269,557,-288,
14392,124,2022/4/15 9:40,252,414,-162,
14393,124,2022/4/15 9:50,219,320,-101,
14394,124,2022/4/15 10:00,204,255,-51,
14395,124,2022/4/15 10:10,212,214,-2,
14396,124,2022/4/15 10:20,190,154,36,
14397,124,2022/4/15 10:30,190,193,-3,
14398,124,2022/4/15 10:40,188,152,36,
14399,124,2022/4/15 10:50,161,112,49,
14400,124,2022/4/15 11:00,168,119,49,
14401,124,2022/4/15 11:10,173,119,54,
14402,124,2022/4/15 11:20,173,119,54,
14403,124,2022/4/15 11:30,200,112,88,
14404,124,2022/4/15 11:40,209,111,98,
14405,124,2022/4/15 11:50,203,121,82,
14406,124,2022/4/15 12:00,209,144,65,
14407,124,2022/4/15 12:10,226,119,107,
14408,124,2022/4/15 12:20,206,144,62,
14409,124,2022/4/15 12:30,209,144,65,
14410,124,2022/4/15 12:40,194,144,50,
14411,124,2022/4/15 12:50,226,153,73,
14412,124,2022/4/15 13:00,216,192,24,
14413,124,2022/4/15 13:10,227,145,82,
14414,124,2022/4/15 13:20,229,179,50,
14415,124,2022/4/15 13:30,217,178,39,
14416,124,2022/4/15 13:40,213,180,33,
14417,124,2022/4/15 13:50,191,151,40,
14418,124,2022/4/15 14:00,197,150,47,
14419,124,2022/4/15 14:10,208,146,62,
14420,124,2022/4/15 14:20,198,151,47,
14421,124,2022/4/15 14:30,204,181,23,
14422,124,2022/4/15 14:40,208,154,54,
14423,124,2022/4/15 14:50,203,127,76,
14424,124,2022/4/15 15:00,224,150,74,
14425,124,2022/4/15 15:10,261,117,144,
14426,124,2022/4/15 15:20,263,169,94,
14427,124,2022/4/15 15:30,260,143,117,
14428,124,2022/4/15 15:40,265,192,73,
14429,124,2022/4/15 15:50,224,138,86,
14430,124,2022/4/15 16:00,259,170,89,
14431,124,2022/4/15 16:10,307,181,126,
14432,124,2022/4/15 16:20,272,155,117,
14433,124,2022/4/15 16:30,343,138,205,
14434,124,2022/4/15 16:40,578,179,399,
14435,124,2022/4/15 16:50,638,198,440,
14436,124,2022/4/15 17:00,802,219,583,
14437,124,2022/4/15 17:10,1189,194,995,
14438,124,2022/4/15 17:20,1027,296,731,
14439,124,2022/4/15 17:30,1148,324,824,
14440,124,2022/4/15 17:40,1987,382,1605,
14441,124,2022/4/15 17:50,1988,503,1485,
14442,124,2022/4/15 18:00,1559,420,1139,
14443,124,2022/4/15 18:10,2541,505,2036,
14444,124,2022/4/15 18:20,2482,415,2067,
14445,124,2022/4/15 18:30,1350,493,857,
14446,124,2022/4/15 18:40,1355,437,918,
14447,124,2022/4/15 18:50,1035,510,525,
14448,124,2022/4/15 19:00,634,381,253,
14449,124,2022/4/15 19:10,694,286,408,
14450,124,2022/4/15 19:20,577,209,368,
14451,124,2022/4/15 19:30,333,191,142,
14452,124,2022/4/15 19:40,341,127,214,
14453,124,2022/4/15 19:50,270,109,161,
14454,124,2022/4/15 20:00,268,125,143,
14455,124,2022/4/15 20:10,292,113,179,
14456,124,2022/4/15 20:20,272,124,148,
14457,124,2022/4/15 20:30,228,121,107,
14458,124,2022/4/15 20:40,276,121,155,
14459,124,2022/4/15 20:50,227,109,118,
14460,124,2022/4/15 21:00,232,109,123,
14461,124,2022/4/15 21:10,224,109,115,
14462,124,2022/4/15 21:20,183,128,55,
14463,124,2022/4/15 21:30,175,133,42,
14464,124,2022/4/15 21:40,137,122,15,
14465,124,2022/4/15 21:50,82,119,-37,
14466,124,2022/4/15 22:00,67,112,-45,
14467,124,2022/4/15 22:10,75,124,-49,
14468,124,2022/4/15 22:20,42,111,-69,
14469,124,2022/4/15 22:30,28,122,-94,
14470,124,2022/4/15 22:40,29,112,-83,
14471,124,2022/4/15 22:50,18,96,-78,
14472,140,2022/4/15 5:00,1,1,0,
14473,140,2022/4/15 5:10,3,1,2,
14474,140,2022/4/15 5:20,4,1,3,
14475,140,2022/4/15 5:30,6,1,5,
14476,140,2022/4/15 5:40,7,2,5,
14477,140,2022/4/15 5:50,7,1,6,
14478,140,2022/4/15 6:00,12,19,-7,
14479,140,2022/4/15 6:10,15,62,-47,
14480,140,2022/4/15 6:20,17,53,-36,
14481,140,2022/4/15 6:30,30,34,-4,
14482,140,2022/4/15 6:40,32,72,-40,
14483,140,2022/4/15 6:50,43,90,-47,
14484,140,2022/4/15 7:00,47,105,-58,
14485,140,2022/4/15 7:10,70,105,-35,
14486,140,2022/4/15 7:20,138,122,16,
14487,140,2022/4/15 7:30,156,128,28,
14488,140,2022/4/15 7:40,249,197,52,
14489,140,2022/4/15 7:50,251,233,18,
14490,140,2022/4/15 8:00,303,319,-16,
14491,140,2022/4/15 8:10,280,500,-220,
14492,140,2022/4/15 8:20,277,437,-160,
14493,140,2022/4/15 8:30,278,428,-150,
14494,140,2022/4/15 8:40,232,426,-194,
14495,140,2022/4/15 8:50,217,486,-269,
14496,140,2022/4/15 9:00,163,284,-121,
14497,140,2022/4/15 9:10,143,178,-35,
14498,140,2022/4/15 9:20,140,161,-21,
14499,140,2022/4/15 9:30,89,154,-65,
14500,140,2022/4/15 9:40,64,125,-61,
14501,140,2022/4/15 9:50,48,125,-77,
14502,140,2022/4/15 10:00,44,114,-70,
14503,140,2022/4/15 10:10,46,126,-80,
14504,140,2022/4/15 10:20,50,123,-73,
14505,140,2022/4/15 10:30,47,105,-58,
14506,140,2022/4/15 10:40,44,109,-65,
14507,140,2022/4/15 10:50,46,104,-58,
14508,140,2022/4/15 11:00,55,109,-54,
14509,140,2022/4/15 11:10,43,112,-69,
14510,140,2022/4/15 11:20,49,99,-50,
14511,140,2022/4/15 11:30,55,108,-53,
14512,140,2022/4/15 11:40,53,102,-49,
14513,140,2022/4/15 11:50,57,105,-48,
14514,140,2022/4/15 12:00,53,106,-53,
14515,140,2022/4/15 12:10,65,106,-41,
14516,140,2022/4/15 12:20,45,105,-60,
14517,140,2022/4/15 12:30,53,116,-63,
14518,140,2022/4/15 12:40,52,102,-50,
14519,140,2022/4/15 12:50,44,110,-66,
14520,140,2022/4/15 13:00,55,123,-68,
14521,140,2022/4/15 13:10,45,109,-64,
14522,140,2022/4/15 13:20,53,122,-69,
14523,140,2022/4/15 13:30,55,109,-54,
14524,140,2022/4/15 13:40,57,97,-40,
14525,140,2022/4/15 13:50,60,118,-58,
14526,140,2022/4/15 14:00,62,123,-61,
14527,140,2022/4/15 14:10,63,117,-54,
14528,140,2022/4/15 14:20,61,100,-39,
14529,140,2022/4/15 14:30,76,120,-44,
14530,140,2022/4/15 14:40,68,95,-27,
14531,140,2022/4/15 14:50,87,123,-36,
14532,140,2022/4/15 15:00,70,98,-28,
14533,140,2022/4/15 15:10,119,104,15,
14534,140,2022/4/15 15:20,127,103,24,
14535,140,2022/4/15 15:30,104,95,9,
14536,140,2022/4/15 15:40,129,104,25,
14537,140,2022/4/15 15:50,85,126,-41,
14538,140,2022/4/15 16:00,149,98,51,
14539,140,2022/4/15 16:10,155,102,53,
14540,140,2022/4/15 16:20,158,105,53,
14541,140,2022/4/15 16:30,172,103,69,
14542,140,2022/4/15 16:40,228,105,123,
14543,140,2022/4/15 16:50,197,103,94,
14544,140,2022/4/15 17:00,210,119,91,
14545,140,2022/4/15 17:10,268,107,161,
14546,140,2022/4/15 17:20,305,130,175,
14547,140,2022/4/15 17:30,374,119,255,
14548,140,2022/4/15 17:40,578,108,470,
14549,140,2022/4/15 17:50,337,149,188,
14550,140,2022/4/15 18:00,305,192,113,
14551,140,2022/4/15 18:10,319,182,137,
14552,140,2022/4/15 18:20,337,180,157,
14553,140,2022/4/15 18:30,265,192,73,
14554,140,2022/4/15 18:40,209,180,29,
14555,140,2022/4/15 18:50,176,151,25,
14556,140,2022/4/15 19:00,132,117,15,
14557,140,2022/4/15 19:10,84,121,-37,
14558,140,2022/4/15 19:20,82,121,-39,
14559,140,2022/4/15 19:30,60,103,-43,
14560,140,2022/4/15 19:40,65,106,-41,
14561,140,2022/4/15 19:50,50,91,-41,
14562,140,2022/4/15 20:00,45,88,-43,
14563,140,2022/4/15 20:10,44,78,-34,
14564,140,2022/4/15 20:20,38,72,-34,
14565,140,2022/4/15 20:30,38,77,-39,
14566,140,2022/4/15 20:40,29,66,-37,
14567,140,2022/4/15 20:50,30,65,-35,
14568,140,2022/4/15 21:00,25,70,-45,
14569,140,2022/4/15 21:10,26,67,-41,
14570,140,2022/4/15 21:20,22,70,-48,
14571,140,2022/4/15 21:30,27,70,-43,
14572,140,2022/4/15 21:40,41,61,-20,
14573,140,2022/4/15 21:50,18,60,-42,
14574,140,2022/4/15 22:00,21,66,-45,
14575,140,2022/4/15 22:10,17,71,-54,
14576,140,2022/4/15 22:20,13,53,-40,
14577,140,2022/4/15 22:30,8,49,-41,
14578,140,2022/4/15 22:40,7,44,-37,
14579,140,2022/4/15 22:50,4,40,-36,
14580,141,2022/4/15 5:00,2,1,1,
14581,141,2022/4/15 5:10,8,1,7,
14582,141,2022/4/15 5:20,7,1,6,
14583,141,2022/4/15 5:30,10,1,9,
14584,141,2022/4/15 5:40,13,1,12,
14585,141,2022/4/15 5:50,18,1,17,
14586,141,2022/4/15 6:00,29,1,28,
14587,141,2022/4/15 6:10,35,22,13,
14588,141,2022/4/15 6:20,43,23,20,
14589,141,2022/4/15 6:30,59,40,19,
14590,141,2022/4/15 6:40,62,62,0,
14591,141,2022/4/15 6:50,122,73,49,
14592,141,2022/4/15 7:00,176,88,88,
14593,141,2022/4/15 7:10,234,103,131,
14594,141,2022/4/15 7:20,343,124,219,
14595,141,2022/4/15 7:30,598,110,488,
14596,141,2022/4/15 7:40,825,108,717,
14597,141,2022/4/15 7:50,1050,144,906,
14598,141,2022/4/15 8:00,1361,110,1251,
14599,141,2022/4/15 8:10,1361,111,1250,
14600,141,2022/4/15 8:20,1214,153,1061,
14601,141,2022/4/15 8:30,1054,111,943,
14602,141,2022/4/15 8:40,738,150,588,
14603,141,2022/4/15 8:50,650,119,531,
14604,141,2022/4/15 9:00,575,103,472,
14605,141,2022/4/15 9:10,325,104,221,
14606,141,2022/4/15 9:20,271,93,178,
14607,141,2022/4/15 9:30,200,99,101,
14608,141,2022/4/15 9:40,156,90,66,
14609,141,2022/4/15 9:50,72,92,-20,
14610,141,2022/4/15 10:00,52,79,-27,
14611,141,2022/4/15 10:10,44,83,-39,
14612,141,2022/4/15 10:20,42,78,-36,
14613,141,2022/4/15 10:30,37,74,-37,
14614,141,2022/4/15 10:40,39,82,-43,
14615,141,2022/4/15 10:50,34,84,-50,
14616,141,2022/4/15 11:00,31,82,-51,
14617,141,2022/4/15 11:10,32,80,-48,
14618,141,2022/4/15 11:20,35,75,-40,
14619,141,2022/4/15 11:30,29,77,-48,
14620,141,2022/4/15 11:40,33,84,-51,
14621,141,2022/4/15 11:50,37,91,-54,
14622,141,2022/4/15 12:00,37,77,-40,
14623,141,2022/4/15 12:10,34,76,-42,
14624,141,2022/4/15 12:20,41,79,-38,
14625,141,2022/4/15 12:30,41,93,-52,
14626,141,2022/4/15 12:40,37,87,-50,
14627,141,2022/4/15 12:50,38,90,-52,
14628,141,2022/4/15 13:00,38,93,-55,
14629,141,2022/4/15 13:10,36,94,-58,
14630,141,2022/4/15 13:20,40,88,-48,
14631,141,2022/4/15 13:30,36,92,-56,
14632,141,2022/4/15 13:40,37,95,-58,
14633,141,2022/4/15 13:50,35,97,-62,
14634,141,2022/4/15 14:00,38,90,-52,
14635,141,2022/4/15 14:10,33,93,-60,
14636,141,2022/4/15 14:20,30,102,-72,
14637,141,2022/4/15 14:30,35,99,-64,
14638,141,2022/4/15 14:40,32,93,-61,
14639,141,2022/4/15 14:50,32,93,-61,
14640,141,2022/4/15 15:00,34,101,-67,
14641,141,2022/4/15 15:10,37,97,-60,
14642,141,2022/4/15 15:20,42,101,-59,
14643,141,2022/4/15 15:30,41,105,-64,
14644,141,2022/4/15 15:40,37,100,-63,
14645,141,2022/4/15 15:50,38,102,-64,
14646,141,2022/4/15 16:00,43,111,-68,
14647,141,2022/4/15 16:10,42,101,-59,
14648,141,2022/4/15 16:20,42,103,-61,
14649,141,2022/4/15 16:30,52,99,-47,
14650,141,2022/4/15 16:40,86,124,-38,
14651,141,2022/4/15 16:50,81,114,-33,
14652,141,2022/4/15 17:00,110,108,2,
14653,141,2022/4/15 17:10,147,114,33,
14654,141,2022/4/15 17:20,174,230,-56,
14655,141,2022/4/15 17:30,222,324,-102,
14656,141,2022/4/15 17:40,181,332,-151,
14657,141,2022/4/15 17:50,132,334,-202,
14658,141,2022/4/15 18:00,161,502,-341,
14659,141,2022/4/15 18:10,128,507,-379,
14660,141,2022/4/15 18:20,66,496,-430,
14661,141,2022/4/15 18:30,50,421,-371,
14662,141,2022/4/15 18:40,44,421,-377,
14663,141,2022/4/15 18:50,38,508,-470,
14664,141,2022/4/15 19:00,40,497,-457,
14665,141,2022/4/15 19:10,28,320,-292,
14666,141,2022/4/15 19:20,31,232,-201,
14667,141,2022/4/15 19:30,32,179,-147,
14668,141,2022/4/15 19:40,25,183,-158,
14669,141,2022/4/15 19:50,29,183,-154,
14670,141,2022/4/15 20:00,28,111,-83,
14671,141,2022/4/15 20:10,27,117,-90,
14672,141,2022/4/15 20:20,26,119,-93,
14673,141,2022/4/15 20:30,23,111,-88,
14674,141,2022/4/15 20:40,28,121,-93,
14675,141,2022/4/15 20:50,26,110,-84,
14676,141,2022/4/15 21:00,27,104,-77,
14677,141,2022/4/15 21:10,30,107,-77,
14678,141,2022/4/15 21:20,26,104,-78,
14679,141,2022/4/15 21:30,25,110,-85,
14680,141,2022/4/15 21:40,23,111,-88,
14681,141,2022/4/15 21:50,22,104,-82,
14682,141,2022/4/15 22:00,19,123,-104,
14683,141,2022/4/15 22:10,20,125,-105,
14684,141,2022/4/15 22:20,10,110,-100,
14685,141,2022/4/15 22:30,7,111,-104,
14686,141,2022/4/15 22:40,7,97,-90,
14687,141,2022/4/15 22:50,4,74,-70,
14688,134,2022/4/15 5:00,10,1,9,
14689,134,2022/4/15 5:10,17,1,16,
14690,134,2022/4/15 5:20,19,1,18,
14691,134,2022/4/15 5:30,26,1,25,
14692,134,2022/4/15 5:40,31,2,29,
14693,134,2022/4/15 5:50,55,1,54,
14694,134,2022/4/15 6:00,54,6,48,
14695,134,2022/4/15 6:10,143,23,120,
14696,134,2022/4/15 6:20,87,95,-8,
14697,134,2022/4/15 6:30,256,88,168,
14698,134,2022/4/15 6:40,277,112,165,
14699,134,2022/4/15 6:50,302,110,192,
14700,134,2022/4/15 7:00,345,104,241,
14701,134,2022/4/15 7:10,639,217,422,
14702,134,2022/4/15 7:20,663,298,365,
14703,134,2022/4/15 7:30,869,299,570,
14704,134,2022/4/15 7:40,1215,269,946,
14705,134,2022/4/15 7:50,1632,327,1305,
14706,134,2022/4/15 8:00,1980,331,1649,
14707,134,2022/4/15 8:10,1976,333,1643,
14708,134,2022/4/15 8:20,1977,298,1679,
14709,134,2022/4/15 8:30,1583,233,1350,
14710,134,2022/4/15 8:40,1201,221,980,
14711,134,2022/4/15 8:50,1167,196,971,
14712,134,2022/4/15 9:00,678,192,486,
14713,134,2022/4/15 9:10,653,153,500,
14714,134,2022/4/15 9:20,580,112,468,
14715,134,2022/4/15 9:30,338,151,187,
14716,134,2022/4/15 9:40,270,117,153,
14717,134,2022/4/15 9:50,209,105,104,
14718,134,2022/4/15 10:00,165,109,56,
14719,134,2022/4/15 10:10,142,113,29,
14720,134,2022/4/15 10:20,100,123,-23,
14721,134,2022/4/15 10:30,76,110,-34,
14722,134,2022/4/15 10:40,75,111,-36,
14723,134,2022/4/15 10:50,70,118,-48,
14724,134,2022/4/15 11:00,73,123,-50,
14725,134,2022/4/15 11:10,71,106,-35,
14726,134,2022/4/15 11:20,72,108,-36,
14727,134,2022/4/15 11:30,56,123,-67,
14728,134,2022/4/15 11:40,78,118,-40,
14729,134,2022/4/15 11:50,108,111,-3,
14730,134,2022/4/15 12:00,82,109,-27,
14731,134,2022/4/15 12:10,136,110,26,
14732,134,2022/4/15 12:20,162,127,35,
14733,134,2022/4/15 12:30,135,115,20,
14734,134,2022/4/15 12:40,163,122,41,
14735,134,2022/4/15 12:50,155,108,47,
14736,134,2022/4/15 13:00,137,111,26,
14737,134,2022/4/15 13:10,119,109,10,
14738,134,2022/4/15 13:20,126,112,14,
14739,134,2022/4/15 13:30,137,114,23,
14740,134,2022/4/15 13:40,125,117,8,
14741,134,2022/4/15 13:50,85,121,-36,
14742,134,2022/4/15 14:00,71,106,-35,
14743,134,2022/4/15 14:10,84,111,-27,
14744,134,2022/4/15 14:20,109,107,2,
14745,134,2022/4/15 14:30,68,124,-56,
14746,134,2022/4/15 14:40,69,116,-47,
14747,134,2022/4/15 14:50,64,127,-63,
14748,134,2022/4/15 15:00,78,111,-33,
14749,134,2022/4/15 15:10,89,110,-21,
14750,134,2022/4/15 15:20,81,181,-100,
14751,134,2022/4/15 15:30,71,181,-110,
14752,134,2022/4/15 15:40,124,185,-61,
14753,134,2022/4/15 15:50,118,159,-41,
14754,134,2022/4/15 16:00,132,178,-46,
14755,134,2022/4/15 16:10,176,185,-9,
14756,134,2022/4/15 16:20,174,197,-23,
14757,134,2022/4/15 16:30,148,180,-32,
14758,134,2022/4/15 16:40,195,197,-2,
14759,134,2022/4/15 16:50,197,285,-88,
14760,134,2022/4/15 17:00,273,296,-23,
14761,134,2022/4/15 17:10,297,320,-23,
14762,134,2022/4/15 17:20,341,377,-36,
14763,134,2022/4/15 17:30,305,415,-110,
14764,134,2022/4/15 17:40,455,421,34,
14765,134,2022/4/15 17:50,370,603,-233,
14766,134,2022/4/15 18:00,263,559,-296,
14767,134,2022/4/15 18:10,285,1477,-1192,
14768,134,2022/4/15 18:20,267,1097,-830,
14769,134,2022/4/15 18:30,196,1539,-1343,
14770,134,2022/4/15 18:40,183,1485,-1302,
14771,134,2022/4/15 18:50,174,1094,-920,
14772,134,2022/4/15 19:00,168,597,-429,
14773,134,2022/4/15 19:10,138,422,-284,
14774,134,2022/4/15 19:20,89,508,-419,
14775,134,2022/4/15 19:30,137,381,-244,
14776,134,2022/4/15 19:40,58,329,-271,
14777,134,2022/4/15 19:50,127,284,-157,
14778,134,2022/4/15 20:00,70,257,-187,
14779,134,2022/4/15 20:10,89,180,-91,
14780,134,2022/4/15 20:20,64,224,-160,
14781,134,2022/4/15 20:30,93,159,-66,
14782,134,2022/4/15 20:40,54,224,-170,
14783,134,2022/4/15 20:50,83,146,-63,
14784,134,2022/4/15 21:00,69,185,-116,
14785,134,2022/4/15 21:10,76,139,-63,
14786,134,2022/4/15 21:20,63,184,-121,
14787,134,2022/4/15 21:30,68,169,-101,
14788,134,2022/4/15 21:40,42,169,-127,
14789,134,2022/4/15 21:50,43,119,-76,
14790,134,2022/4/15 22:00,30,153,-123,
14791,134,2022/4/15 22:10,25,121,-96,
14792,134,2022/4/15 22:20,27,134,-107,
14793,134,2022/4/15 22:30,15,120,-105,
14794,134,2022/4/15 22:40,9,111,-102,
14795,134,2022/4/15 22:50,14,107,-93,
14796,147,2022/4/15 5:00,0,1,-1,
14797,147,2022/4/15 5:10,2,1,1,
14798,147,2022/4/15 5:20,10,1,9,
14799,147,2022/4/15 5:30,21,1,20,
14800,147,2022/4/15 5:40,16,1,15,
14801,147,2022/4/15 5:50,25,1,24,
14802,147,2022/4/15 6:00,26,1,25,
14803,147,2022/4/15 6:10,29,1,28,
14804,147,2022/4/15 6:20,44,59,-15,
14805,147,2022/4/15 6:30,77,73,4,
14806,147,2022/4/15 6:40,59,109,-50,
14807,147,2022/4/15 6:50,81,104,-23,
14808,147,2022/4/15 7:00,149,175,-26,
14809,147,2022/4/15 7:10,188,229,-41,
14810,147,2022/4/15 7:20,190,501,-311,
14811,147,2022/4/15 7:30,282,558,-276,
14812,147,2022/4/15 7:40,320,1521,-1201,
14813,147,2022/4/15 7:50,436,2526,-2090,
14814,147,2022/4/15 8:00,467,3161,-2694,
14815,147,2022/4/15 8:10,443,4070,-3627,
14816,147,2022/4/15 8:20,324,5045,-4721,
14817,147,2022/4/15 8:30,280,4302,-4022,
14818,147,2022/4/15 8:40,267,3560,-3293,
14819,147,2022/4/15 8:50,231,3243,-3012,
14820,147,2022/4/15 9:00,215,3274,-3059,
14821,147,2022/4/15 9:10,168,2827,-2659,
14822,147,2022/4/15 9:20,162,2520,-2358,
14823,147,2022/4/15 9:30,92,1684,-1592,
14824,147,2022/4/15 9:40,116,624,-508,
14825,147,2022/4/15 9:50,76,499,-423,
14826,147,2022/4/15 10:00,65,363,-298,
14827,147,2022/4/15 10:10,67,196,-129,
14828,147,2022/4/15 10:20,63,179,-116,
14829,147,2022/4/15 10:30,65,137,-72,
14830,147,2022/4/15 10:40,58,107,-49,
14831,147,2022/4/15 10:50,69,104,-35,
14832,147,2022/4/15 11:00,69,109,-40,
14833,147,2022/4/15 11:10,81,124,-43,
14834,147,2022/4/15 11:20,88,111,-23,
14835,147,2022/4/15 11:30,132,110,22,
14836,147,2022/4/15 11:40,147,105,42,
14837,147,2022/4/15 11:50,149,111,38,
14838,147,2022/4/15 12:00,169,108,61,
14839,147,2022/4/15 12:10,186,133,53,
14840,147,2022/4/15 12:20,157,125,32,
14841,147,2022/4/15 12:30,175,109,66,
14842,147,2022/4/15 12:40,148,117,31,
14843,147,2022/4/15 12:50,162,152,10,
14844,147,2022/4/15 13:00,125,108,17,
14845,147,2022/4/15 13:10,137,111,26,
14846,147,2022/4/15 13:20,136,107,29,
14847,147,2022/4/15 13:30,139,129,10,
14848,147,2022/4/15 13:40,145,125,20,
14849,147,2022/4/15 13:50,137,110,27,
14850,147,2022/4/15 14:00,136,108,28,
14851,147,2022/4/15 14:10,120,109,11,
14852,147,2022/4/15 14:20,129,121,8,
14853,147,2022/4/15 14:30,161,102,59,
14854,147,2022/4/15 14:40,124,111,13,
14855,147,2022/4/15 14:50,113,119,-6,
14856,147,2022/4/15 15:00,141,126,15,
14857,147,2022/4/15 15:10,184,122,62,
14858,147,2022/4/15 15:20,197,121,76,
14859,147,2022/4/15 15:30,265,104,161,
14860,147,2022/4/15 15:40,230,116,114,
14861,147,2022/4/15 15:50,215,129,86,
14862,147,2022/4/15 16:00,271,116,155,
14863,147,2022/4/15 16:10,338,109,229,
14864,147,2022/4/15 16:20,272,122,150,
14865,147,2022/4/15 16:30,568,105,463,
14866,147,2022/4/15 16:40,637,108,529,
14867,147,2022/4/15 16:50,638,133,505,
14868,147,2022/4/15 17:00,814,152,662,
14869,147,2022/4/15 17:10,1558,150,1408,
14870,147,2022/4/15 17:20,1620,183,1437,
14871,147,2022/4/15 17:30,1354,231,1123,
14872,147,2022/4/15 17:40,2546,255,2291,
14873,147,2022/4/15 17:50,2534,268,2266,
14874,147,2022/4/15 18:00,1557,323,1234,
14875,147,2022/4/15 18:10,2534,329,2205,
14876,147,2022/4/15 18:20,2530,319,2211,
14877,147,2022/4/15 18:30,1610,319,1291,
14878,147,2022/4/15 18:40,1641,494,1147,
14879,147,2022/4/15 18:50,1191,318,873,
14880,147,2022/4/15 19:00,825,377,448,
14881,147,2022/4/15 19:10,805,319,486,
14882,147,2022/4/15 19:20,655,222,433,
14883,147,2022/4/15 19:30,587,222,365,
14884,147,2022/4/15 19:40,583,98,485,
14885,147,2022/4/15 19:50,309,177,132,
14886,147,2022/4/15 20:00,318,109,209,
14887,147,2022/4/15 20:10,315,150,165,
14888,147,2022/4/15 20:20,268,111,157,
14889,147,2022/4/15 20:30,258,120,138,
14890,147,2022/4/15 20:40,276,104,172,
14891,147,2022/4/15 20:50,202,114,88,
14892,147,2022/4/15 21:00,203,123,80,
14893,147,2022/4/15 21:10,237,105,132,
14894,147,2022/4/15 21:20,178,109,69,
14895,147,2022/4/15 21:30,77,111,-34,
14896,147,2022/4/15 21:40,66,121,-55,
14897,147,2022/4/15 21:50,44,122,-78,
14898,147,2022/4/15 22:00,42,123,-81,
14899,147,2022/4/15 22:10,35,96,-61,
14900,147,2022/4/15 22:20,30,126,-96,
14901,147,2022/4/15 22:30,19,105,-86,
14902,147,2022/4/15 22:40,13,70,-57,
14903,147,2022/4/15 22:50,4,105,-101,
14904,131,2022/4/15 5:00,0,1,-1,
14905,131,2022/4/15 5:10,3,1,2,
14906,131,2022/4/15 5:20,17,1,16,
14907,131,2022/4/15 5:30,10,1,9,
14908,131,2022/4/15 5:40,18,1,17,
14909,131,2022/4/15 5:50,19,2,17,
14910,131,2022/4/15 6:00,31,2,29,
14911,131,2022/4/15 6:10,30,1,29,
14912,131,2022/4/15 6:20,55,47,8,
14913,131,2022/4/15 6:30,46,68,-22,
14914,131,2022/4/15 6:40,88,77,11,
14915,131,2022/4/15 6:50,87,100,-13,
14916,131,2022/4/15 7:00,170,105,65,
14917,131,2022/4/15 7:10,233,122,111,
14918,131,2022/4/15 7:20,352,297,55,
14919,131,2022/4/15 7:30,662,536,126,
14920,131,2022/4/15 7:40,680,477,203,
14921,131,2022/4/15 7:50,1181,1532,-351,
14922,131,2022/4/15 8:00,1165,2378,-1213,
14923,131,2022/4/15 8:10,1062,3335,-2273,
14924,131,2022/4/15 8:20,691,2896,-2205,
14925,131,2022/4/15 8:30,591,4883,-4292,
14926,131,2022/4/15 8:40,371,6126,-5755,
14927,131,2022/4/15 8:50,365,4759,-4394,
14928,131,2022/4/15 9:00,271,2353,-2082,
14929,131,2022/4/15 9:10,273,3085,-2812,
14930,131,2022/4/15 9:20,215,2861,-2646,
14931,131,2022/4/15 9:30,145,2091,-1946,
14932,131,2022/4/15 9:40,79,1637,-1558,
14933,131,2022/4/15 9:50,59,699,-640,
14934,131,2022/4/15 10:00,58,432,-374,
14935,131,2022/4/15 10:10,53,268,-215,
14936,131,2022/4/15 10:20,41,208,-167,
14937,131,2022/4/15 10:30,44,115,-71,
14938,131,2022/4/15 10:40,45,150,-105,
14939,131,2022/4/15 10:50,46,109,-63,
14940,131,2022/4/15 11:00,48,115,-67,
14941,131,2022/4/15 11:10,51,115,-64,
14942,131,2022/4/15 11:20,48,123,-75,
14943,131,2022/4/15 11:30,64,117,-53,
14944,131,2022/4/15 11:40,65,123,-58,
14945,131,2022/4/15 11:50,75,119,-44,
14946,131,2022/4/15 12:00,86,106,-20,
14947,131,2022/4/15 12:10,109,121,-12,
14948,131,2022/4/15 12:20,130,96,34,
14949,131,2022/4/15 12:30,84,103,-19,
14950,131,2022/4/15 12:40,84,130,-46,
14951,131,2022/4/15 12:50,137,117,20,
14952,131,2022/4/15 13:00,91,108,-17,
14953,131,2022/4/15 13:10,91,114,-23,
14954,131,2022/4/15 13:20,125,114,11,
14955,131,2022/4/15 13:30,71,108,-37,
14956,131,2022/4/15 13:40,70,108,-38,
14957,131,2022/4/15 13:50,72,87,-15,
14958,131,2022/4/15 14:00,64,123,-59,
14959,131,2022/4/15 14:10,72,127,-55,
14960,131,2022/4/15 14:20,71,117,-46,
14961,131,2022/4/15 14:30,66,103,-37,
14962,131,2022/4/15 14:40,81,118,-37,
14963,131,2022/4/15 14:50,80,86,-6,
14964,131,2022/4/15 15:00,82,106,-24,
14965,131,2022/4/15 15:10,126,105,21,
14966,131,2022/4/15 15:20,133,104,29,
14967,131,2022/4/15 15:30,125,107,18,
14968,131,2022/4/15 15:40,127,104,23,
14969,131,2022/4/15 15:50,124,104,20,
14970,131,2022/4/15 16:00,196,114,82,
14971,131,2022/4/15 16:10,211,105,106,
14972,131,2022/4/15 16:20,214,99,115,
14973,131,2022/4/15 16:30,275,98,177,
14974,131,2022/4/15 16:40,696,103,593,
14975,131,2022/4/15 16:50,575,122,453,
14976,131,2022/4/15 17:00,803,111,692,
14977,131,2022/4/15 17:10,1587,116,1471,
14978,131,2022/4/15 17:20,1349,182,1167,
14979,131,2022/4/15 17:30,1587,158,1429,
14980,131,2022/4/15 17:40,2555,212,2343,
14981,131,2022/4/15 17:50,1990,268,1722,
14982,131,2022/4/15 18:00,1618,334,1284,
14983,131,2022/4/15 18:10,3061,377,2684,
14984,131,2022/4/15 18:20,2558,382,2176,
14985,131,2022/4/15 18:30,1989,435,1554,
14986,131,2022/4/15 18:40,1591,378,1213,
14987,131,2022/4/15 18:50,1194,532,662,
14988,131,2022/4/15 19:00,809,383,426,
14989,131,2022/4/15 19:10,703,336,367,
14990,131,2022/4/15 19:20,574,269,305,
14991,131,2022/4/15 19:30,574,219,355,
14992,131,2022/4/15 19:40,577,118,459,
14993,131,2022/4/15 19:50,318,212,106,
14994,131,2022/4/15 20:00,429,115,314,
14995,131,2022/4/15 20:10,324,117,207,
14996,131,2022/4/15 20:20,271,125,146,
14997,131,2022/4/15 20:30,271,110,161,
14998,131,2022/4/15 20:40,268,109,159,
14999,131,2022/4/15 20:50,277,103,174,
15000,131,2022/4/15 21:00,267,97,170,
15001,131,2022/4/15 21:10,274,90,184,
15002,131,2022/4/15 21:20,239,102,137,
15003,131,2022/4/15 21:30,187,85,102,
15004,131,2022/4/15 21:40,165,104,61,
15005,131,2022/4/15 21:50,81,104,-23,
15006,131,2022/4/15 22:00,169,103,66,
15007,131,2022/4/15 22:10,46,109,-63,
15008,131,2022/4/15 22:20,24,104,-80,
15009,131,2022/4/15 22:30,25,100,-75,
15010,131,2022/4/15 22:40,12,80,-68,
15011,131,2022/4/15 22:50,5,75,-70,
15012,125,2022/4/15 5:00,0,1,-1,
15013,125,2022/4/15 5:10,19,1,18,
15014,125,2022/4/15 5:20,40,1,39,
15015,125,2022/4/15 5:30,32,1,31,
15016,125,2022/4/15 5:40,54,1,53,
15017,125,2022/4/15 5:50,77,1,76,
15018,125,2022/4/15 6:00,86,1,85,
15019,125,2022/4/15 6:10,108,1,107,
15020,125,2022/4/15 6:20,194,45,149,
15021,125,2022/4/15 6:30,185,50,135,
15022,125,2022/4/15 6:40,281,72,209,
15023,125,2022/4/15 6:50,347,63,284,
15024,125,2022/4/15 7:00,602,106,496,
15025,125,2022/4/15 7:10,684,92,592,
15026,125,2022/4/15 7:20,1158,177,981,
15027,125,2022/4/15 7:30,1982,268,1714,
15028,125,2022/4/15 7:40,2555,512,2043,
15029,125,2022/4/15 7:50,3279,441,2838,
15030,125,2022/4/15 8:00,3287,1075,2212,
15031,125,2022/4/15 8:10,3262,1489,1773,
15032,125,2022/4/15 8:20,2544,1493,1051,
15033,125,2022/4/15 8:30,1969,1717,252,
15034,125,2022/4/15 8:40,1553,1680,-127,
15035,125,2022/4/15 8:50,1047,1061,-14,
15036,125,2022/4/15 9:00,861,573,288,
15037,125,2022/4/15 9:10,690,573,117,
15038,125,2022/4/15 9:20,357,421,-64,
15039,125,2022/4/15 9:30,269,524,-255,
15040,125,2022/4/15 9:40,237,368,-131,
15041,125,2022/4/15 9:50,201,216,-15,
15042,125,2022/4/15 10:00,108,121,-13,
15043,125,2022/4/15 10:10,131,119,12,
15044,125,2022/4/15 10:20,75,108,-33,
15045,125,2022/4/15 10:30,65,100,-35,
15046,125,2022/4/15 10:40,73,104,-31,
15047,125,2022/4/15 10:50,71,101,-30,
15048,125,2022/4/15 11:00,58,112,-54,
15049,125,2022/4/15 11:10,79,93,-14,
15050,125,2022/4/15 11:20,66,113,-47,
15051,125,2022/4/15 11:30,72,108,-36,
15052,125,2022/4/15 11:40,75,113,-38,
15053,125,2022/4/15 11:50,89,103,-14,
15054,125,2022/4/15 12:00,86,105,-19,
15055,125,2022/4/15 12:10,128,110,18,
15056,125,2022/4/15 12:20,136,102,34,
15057,125,2022/4/15 12:30,95,104,-9,
15058,125,2022/4/15 12:40,94,114,-20,
15059,125,2022/4/15 12:50,110,103,7,
15060,125,2022/4/15 13:00,97,99,-2,
15061,125,2022/4/15 13:10,79,103,-24,
15062,125,2022/4/15 13:20,83,106,-23,
15063,125,2022/4/15 13:30,82,111,-29,
15064,125,2022/4/15 13:40,72,102,-30,
15065,125,2022/4/15 13:50,71,100,-29,
15066,125,2022/4/15 14:00,57,116,-59,
15067,125,2022/4/15 14:10,61,105,-44,
15068,125,2022/4/15 14:20,57,107,-50,
15069,125,2022/4/15 14:30,60,119,-59,
15070,125,2022/4/15 14:40,68,102,-34,
15071,125,2022/4/15 14:50,53,124,-71,
15072,125,2022/4/15 15:00,59,126,-67,
15073,125,2022/4/15 15:10,71,107,-36,
15074,125,2022/4/15 15:20,64,118,-54,
15075,125,2022/4/15 15:30,60,106,-46,
15076,125,2022/4/15 15:40,64,109,-45,
15077,125,2022/4/15 15:50,73,98,-25,
15078,125,2022/4/15 16:00,69,125,-56,
15079,125,2022/4/15 16:10,132,124,8,
15080,125,2022/4/15 16:20,114,133,-19,
15081,125,2022/4/15 16:30,130,133,-3,
15082,125,2022/4/15 16:40,225,144,81,
15083,125,2022/4/15 16:50,259,138,121,
15084,125,2022/4/15 17:00,349,175,174,
15085,125,2022/4/15 17:10,653,219,434,
15086,125,2022/4/15 17:20,1156,252,904,
15087,125,2022/4/15 17:30,1148,281,867,
15088,125,2022/4/15 17:40,1564,383,1181,
15089,125,2022/4/15 17:50,1589,424,1165,
15090,125,2022/4/15 18:00,1396,398,998,
15091,125,2022/4/15 18:10,1367,572,795,
15092,125,2022/4/15 18:20,1406,572,834,
15093,125,2022/4/15 18:30,833,1079,-246,
15094,125,2022/4/15 18:40,633,1498,-865,
15095,125,2022/4/15 18:50,587,1576,-989,
15096,125,2022/4/15 19:00,359,1533,-1174,
15097,125,2022/4/15 19:10,307,1510,-1203,
15098,125,2022/4/15 19:20,258,557,-299,
15099,125,2022/4/15 19:30,208,426,-218,
15100,125,2022/4/15 19:40,138,377,-239,
15101,125,2022/4/15 19:50,152,430,-278,
15102,125,2022/4/15 20:00,115,321,-206,
15103,125,2022/4/15 20:10,160,318,-158,
15104,125,2022/4/15 20:20,174,148,26,
15105,125,2022/4/15 20:30,92,378,-286,
15106,125,2022/4/15 20:40,93,321,-228,
15107,125,2022/4/15 20:50,79,256,-177,
15108,125,2022/4/15 21:00,70,225,-155,
15109,125,2022/4/15 21:10,98,277,-179,
15110,125,2022/4/15 21:20,63,233,-170,
15111,125,2022/4/15 21:30,48,197,-149,
15112,125,2022/4/15 21:40,35,257,-222,
15113,125,2022/4/15 21:50,33,196,-163,
15114,125,2022/4/15 22:00,24,186,-162,
15115,125,2022/4/15 22:10,23,186,-163,
15116,125,2022/4/15 22:20,22,186,-164,
15117,125,2022/4/15 22:30,13,240,-227,
15118,125,2022/4/15 22:40,2,221,-219,
15119,125,2022/4/15 22:50,0,124,-124,
15120,143,2022/4/15 5:00,0,1,-1,
15121,143,2022/4/15 5:10,0,1,-1,
15122,143,2022/4/15 5:20,0,1,-1,
15123,143,2022/4/15 5:30,0,1,-1,
15124,143,2022/4/15 5:40,1,1,0,
15125,143,2022/4/15 5:50,13,1,12,
15126,143,2022/4/15 6:00,14,2,12,
15127,143,2022/4/15 6:10,30,2,28,
15128,143,2022/4/15 6:20,59,6,53,
15129,143,2022/4/15 6:30,112,47,65,
15130,143,2022/4/15 6:40,162,51,111,
15131,143,2022/4/15 6:50,213,44,169,
15132,143,2022/4/15 7:00,283,73,210,
15133,143,2022/4/15 7:10,442,68,374,
15134,143,2022/4/15 7:20,705,108,597,
15135,143,2022/4/15 7:30,1216,100,1116,
15136,143,2022/4/15 7:40,1366,150,1216,
15137,143,2022/4/15 7:50,1367,114,1253,
15138,143,2022/4/15 8:00,1177,193,984,
15139,143,2022/4/15 8:10,734,222,512,
15140,143,2022/4/15 8:20,740,115,625,
15141,143,2022/4/15 8:30,720,153,567,
15142,143,2022/4/15 8:40,594,153,441,
15143,143,2022/4/15 8:50,457,102,355,
15144,143,2022/4/15 9:00,340,95,245,
15145,143,2022/4/15 9:10,227,105,122,
15146,143,2022/4/15 9:20,177,73,104,
15147,143,2022/4/15 9:30,122,93,29,
15148,143,2022/4/15 9:40,72,97,-25,
15149,143,2022/4/15 9:50,44,70,-26,
15150,143,2022/4/15 10:00,52,75,-23,
15151,143,2022/4/15 10:10,36,82,-46,
15152,143,2022/4/15 10:20,29,45,-16,
15153,143,2022/4/15 10:30,32,75,-43,
15154,143,2022/4/15 10:40,36,68,-32,
15155,143,2022/4/15 10:50,28,75,-47,
15156,143,2022/4/15 11:00,29,62,-33,
15157,143,2022/4/15 11:10,36,69,-33,
15158,143,2022/4/15 11:20,40,64,-24,
15159,143,2022/4/15 11:30,37,69,-32,
15160,143,2022/4/15 11:40,35,76,-41,
15161,143,2022/4/15 11:50,40,110,-70,
15162,143,2022/4/15 12:00,54,72,-18,
15163,143,2022/4/15 12:10,40,72,-32,
15164,143,2022/4/15 12:20,47,72,-25,
15165,143,2022/4/15 12:30,59,71,-12,
15166,143,2022/4/15 12:40,44,92,-48,
15167,143,2022/4/15 12:50,40,93,-53,
15168,143,2022/4/15 13:00,43,72,-29,
15169,143,2022/4/15 13:10,36,69,-33,
15170,143,2022/4/15 13:20,44,72,-28,
15171,143,2022/4/15 13:30,32,69,-37,
15172,143,2022/4/15 13:40,26,109,-83,
15173,143,2022/4/15 13:50,40,72,-32,
15174,143,2022/4/15 14:00,32,73,-41,
15175,143,2022/4/15 14:10,26,68,-42,
15176,143,2022/4/15 14:20,24,81,-57,
15177,143,2022/4/15 14:30,33,76,-43,
15178,143,2022/4/15 14:40,26,99,-73,
15179,143,2022/4/15 14:50,23,72,-49,
15180,143,2022/4/15 15:00,22,90,-68,
15181,143,2022/4/15 15:10,31,78,-47,
15182,143,2022/4/15 15:20,25,76,-51,
15183,143,2022/4/15 15:30,33,121,-88,
15184,143,2022/4/15 15:40,25,87,-62,
15185,143,2022/4/15 15:50,28,91,-63,
15186,143,2022/4/15 16:00,33,88,-55,
15187,143,2022/4/15 16:10,30,109,-79,
15188,143,2022/4/15 16:20,41,108,-67,
15189,143,2022/4/15 16:30,30,110,-80,
15190,143,2022/4/15 16:40,41,105,-64,
15191,143,2022/4/15 16:50,39,105,-66,
15192,143,2022/4/15 17:00,38,123,-85,
15193,143,2022/4/15 17:10,73,106,-33,
15194,143,2022/4/15 17:20,82,190,-108,
15195,143,2022/4/15 17:30,156,111,45,
15196,143,2022/4/15 17:40,140,195,-55,
15197,143,2022/4/15 17:50,126,297,-171,
15198,143,2022/4/15 18:00,63,224,-161,
15199,143,2022/4/15 18:10,58,508,-450,
15200,143,2022/4/15 18:20,64,268,-204,
15201,143,2022/4/15 18:30,57,492,-435,
15202,143,2022/4/15 18:40,44,484,-440,
15203,143,2022/4/15 18:50,38,429,-391,
15204,143,2022/4/15 19:00,33,433,-400,
15205,143,2022/4/15 19:10,29,364,-335,
15206,143,2022/4/15 19:20,30,434,-404,
15207,143,2022/4/15 19:30,22,224,-202,
15208,143,2022/4/15 19:40,26,340,-314,
15209,143,2022/4/15 19:50,25,191,-166,
15210,143,2022/4/15 20:00,25,215,-190,
15211,143,2022/4/15 20:10,27,191,-164,
15212,143,2022/4/15 20:20,24,110,-86,
15213,143,2022/4/15 20:30,25,169,-144,
15214,143,2022/4/15 20:40,23,122,-99,
15215,143,2022/4/15 20:50,22,119,-97,
15216,143,2022/4/15 21:00,17,191,-174,
15217,143,2022/4/15 21:10,17,91,-74,
15218,143,2022/4/15 21:20,18,178,-160,
15219,143,2022/4/15 21:30,16,106,-90,
15220,143,2022/4/15 21:40,12,151,-139,
15221,143,2022/4/15 21:50,12,115,-103,
15222,143,2022/4/15 22:00,6,104,-98,
15223,143,2022/4/15 22:10,4,105,-101,
15224,143,2022/4/15 22:20,2,107,-105,
15225,143,2022/4/15 22:30,1,47,-46,
15226,143,2022/4/15 22:40,0,3,-3,
15227,143,2022/4/15 22:50,0,3,-3,
15228,123,2022/4/15 5:00,0,1,-1,
15229,123,2022/4/15 5:10,0,1,-1,
15230,123,2022/4/15 5:20,0,1,-1,
15231,123,2022/4/15 5:30,0,1,-1,
15232,123,2022/4/15 5:40,0,1,-1,
15233,123,2022/4/15 5:50,1,1,0,
15234,123,2022/4/15 6:00,4,1,3,
15235,123,2022/4/15 6:10,16,1,15,
15236,123,2022/4/15 6:20,27,2,25,
15237,123,2022/4/15 6:30,19,6,13,
15238,123,2022/4/15 6:40,27,16,11,
15239,123,2022/4/15 6:50,29,8,21,
15240,123,2022/4/15 7:00,28,14,14,
15241,123,2022/4/15 7:10,34,33,1,
15242,123,2022/4/15 7:20,35,21,14,
15243,123,2022/4/15 7:30,41,50,-9,
15244,123,2022/4/15 7:40,59,34,25,
15245,123,2022/4/15 7:50,73,53,20,
15246,123,2022/4/15 8:00,57,48,9,
15247,123,2022/4/15 8:10,42,42,0,
15248,123,2022/4/15 8:20,31,56,-25,
15249,123,2022/4/15 8:30,28,47,-19,
15250,123,2022/4/15 8:40,21,32,-11,
15251,123,2022/4/15 8:50,16,44,-28,
15252,123,2022/4/15 9:00,12,33,-21,
15253,123,2022/4/15 9:10,11,22,-11,
15254,123,2022/4/15 9:20,9,23,-14,
15255,123,2022/4/15 9:30,10,22,-12,
15256,123,2022/4/15 9:40,11,19,-8,
15257,123,2022/4/15 9:50,8,30,-22,
15258,123,2022/4/15 10:00,7,23,-16,
15259,123,2022/4/15 10:10,8,11,-3,
15260,123,2022/4/15 10:20,6,21,-15,
15261,123,2022/4/15 10:30,5,19,-14,
15262,123,2022/4/15 10:40,5,16,-11,
15263,123,2022/4/15 10:50,6,11,-5,
15264,123,2022/4/15 11:00,5,19,-14,
15265,123,2022/4/15 11:10,7,23,-16,
15266,123,2022/4/15 11:20,6,12,-6,
15267,123,2022/4/15 11:30,7,19,-12,
15268,123,2022/4/15 11:40,8,19,-11,
15269,123,2022/4/15 11:50,5,16,-11,
15270,123,2022/4/15 12:00,9,19,-10,
15271,123,2022/4/15 12:10,8,21,-13,
15272,123,2022/4/15 12:20,8,19,-11,
15273,123,2022/4/15 12:30,9,16,-7,
15274,123,2022/4/15 12:40,7,14,-7,
15275,123,2022/4/15 12:50,7,19,-12,
15276,123,2022/4/15 13:00,7,23,-16,
15277,123,2022/4/15 13:10,7,23,-16,
15278,123,2022/4/15 13:20,6,14,-8,
15279,123,2022/4/15 13:30,7,18,-11,
15280,123,2022/4/15 13:40,6,21,-15,
15281,123,2022/4/15 13:50,8,19,-11,
15282,123,2022/4/15 14:00,6,25,-19,
15283,123,2022/4/15 14:10,6,23,-17,
15284,123,2022/4/15 14:20,6,19,-13,
15285,123,2022/4/15 14:30,4,23,-19,
15286,123,2022/4/15 14:40,6,21,-15,
15287,123,2022/4/15 14:50,6,31,-25,
15288,123,2022/4/15 15:00,6,19,-13,
15289,123,2022/4/15 15:10,5,23,-18,
15290,123,2022/4/15 15:20,6,21,-15,
15291,123,2022/4/15 15:30,6,21,-15,
15292,123,2022/4/15 15:40,5,21,-16,
15293,123,2022/4/15 15:50,6,25,-19,
15294,123,2022/4/15 16:00,7,23,-16,
15295,123,2022/4/15 16:10,8,21,-13,
15296,123,2022/4/15 16:20,9,25,-16,
15297,123,2022/4/15 16:30,11,23,-12,
15298,123,2022/4/15 16:40,21,23,-2,
15299,123,2022/4/15 16:50,14,42,-28,
15300,123,2022/4/15 17:00,14,23,-9,
15301,123,2022/4/15 17:10,18,38,-20,
15302,123,2022/4/15 17:20,15,25,-10,
15303,123,2022/4/15 17:30,12,46,-34,
15304,123,2022/4/15 17:40,16,50,-34,
15305,123,2022/4/15 17:50,19,42,-23,
15306,123,2022/4/15 18:00,14,51,-37,
15307,123,2022/4/15 18:10,9,38,-29,
15308,123,2022/4/15 18:20,10,73,-63,
15309,123,2022/4/15 18:30,7,50,-43,
15310,123,2022/4/15 18:40,6,69,-63,
15311,123,2022/4/15 18:50,7,75,-68,
15312,123,2022/4/15 19:00,8,50,-42,
15313,123,2022/4/15 19:10,5,67,-62,
15314,123,2022/4/15 19:20,5,39,-34,
15315,123,2022/4/15 19:30,5,60,-55,
15316,123,2022/4/15 19:40,3,38,-35,
15317,123,2022/4/15 19:50,3,40,-37,
15318,123,2022/4/15 20:00,3,40,-37,
15319,123,2022/4/15 20:10,2,25,-23,
15320,123,2022/4/15 20:20,2,33,-31,
15321,123,2022/4/15 20:30,2,25,-23,
15322,123,2022/4/15 20:40,2,40,-38,
15323,123,2022/4/15 20:50,1,25,-24,
15324,123,2022/4/15 21:00,1,39,-38,
15325,123,2022/4/15 21:10,2,31,-29,
15326,123,2022/4/15 21:20,1,32,-31,
15327,123,2022/4/15 21:30,2,36,-34,
15328,123,2022/4/15 21:40,1,21,-20,
15329,123,2022/4/15 21:50,1,35,-34,
15330,123,2022/4/15 22:00,0,32,-32,
15331,123,2022/4/15 22:10,0,21,-21,
15332,123,2022/4/15 22:20,0,18,-18,
15333,123,2022/4/15 22:30,0,21,-21,
15334,123,2022/4/15 22:40,0,3,-3,
15335,123,2022/4/15 22:50,0,3,-3,
15336,129,2022/4/15 5:00,0,1,-1,
15337,129,2022/4/15 5:10,0,1,-1,
15338,129,2022/4/15 5:20,0,1,-1,
15339,129,2022/4/15 5:30,0,1,-1,
15340,129,2022/4/15 5:40,0,1,-1,
15341,129,2022/4/15 5:50,7,1,6,
15342,129,2022/4/15 6:00,23,1,22,
15343,129,2022/4/15 6:10,50,1,49,
15344,129,2022/4/15 6:20,79,8,71,
15345,129,2022/4/15 6:30,87,8,79,
15346,129,2022/4/15 6:40,168,50,118,
15347,129,2022/4/15 6:50,206,47,159,
15348,129,2022/4/15 7:00,245,62,183,
15349,129,2022/4/15 7:10,344,60,284,
15350,129,2022/4/15 7:20,590,73,517,
15351,129,2022/4/15 7:30,722,40,682,
15352,129,2022/4/15 7:40,830,75,755,
15353,129,2022/4/15 7:50,838,62,776,
15354,129,2022/4/15 8:00,735,84,651,
15355,129,2022/4/15 8:10,688,87,601,
15356,129,2022/4/15 8:20,593,51,542,
15357,129,2022/4/15 8:30,347,85,262,
15358,129,2022/4/15 8:40,236,75,161,
15359,129,2022/4/15 8:50,223,57,166,
15360,129,2022/4/15 9:00,149,68,81,
15361,129,2022/4/15 9:10,77,65,12,
15362,129,2022/4/15 9:20,60,54,6,
15363,129,2022/4/15 9:30,48,68,-20,
15364,129,2022/4/15 9:40,41,70,-29,
15365,129,2022/4/15 9:50,36,49,-13,
15366,129,2022/4/15 10:00,31,62,-31,
15367,129,2022/4/15 10:10,30,73,-43,
15368,129,2022/4/15 10:20,28,50,-22,
15369,129,2022/4/15 10:30,27,64,-37,
15370,129,2022/4/15 10:40,25,59,-34,
15371,129,2022/4/15 10:50,30,45,-15,
15372,129,2022/4/15 11:00,25,53,-28,
15373,129,2022/4/15 11:10,26,52,-26,
15374,129,2022/4/15 11:20,29,54,-25,
15375,129,2022/4/15 11:30,30,68,-38,
15376,129,2022/4/15 11:40,31,57,-26,
15377,129,2022/4/15 11:50,29,57,-28,
15378,129,2022/4/15 12:00,25,52,-27,
15379,129,2022/4/15 12:10,28,51,-23,
15380,129,2022/4/15 12:20,33,55,-22,
15381,129,2022/4/15 12:30,27,86,-59,
15382,129,2022/4/15 12:40,29,57,-28,
15383,129,2022/4/15 12:50,27,64,-37,
15384,129,2022/4/15 13:00,27,59,-32,
15385,129,2022/4/15 13:10,28,49,-21,
15386,129,2022/4/15 13:20,28,69,-41,
15387,129,2022/4/15 13:30,29,72,-43,
15388,129,2022/4/15 13:40,28,61,-33,
15389,129,2022/4/15 13:50,24,53,-29,
15390,129,2022/4/15 14:00,24,52,-28,
15391,129,2022/4/15 14:10,25,63,-38,
15392,129,2022/4/15 14:20,24,77,-53,
15393,129,2022/4/15 14:30,22,72,-50,
15394,129,2022/4/15 14:40,22,64,-42,
15395,129,2022/4/15 14:50,23,60,-37,
15396,129,2022/4/15 15:00,22,67,-45,
15397,129,2022/4/15 15:10,24,67,-43,
15398,129,2022/4/15 15:20,22,96,-74,
15399,129,2022/4/15 15:30,22,75,-53,
15400,129,2022/4/15 15:40,24,68,-44,
15401,129,2022/4/15 15:50,28,75,-47,
15402,129,2022/4/15 16:00,29,75,-46,
15403,129,2022/4/15 16:10,27,90,-63,
15404,129,2022/4/15 16:20,27,113,-86,
15405,129,2022/4/15 16:30,33,96,-63,
15406,129,2022/4/15 16:40,33,93,-60,
15407,129,2022/4/15 16:50,29,99,-70,
15408,129,2022/4/15 17:00,25,108,-83,
15409,129,2022/4/15 17:10,32,91,-59,
15410,129,2022/4/15 17:20,24,150,-126,
15411,129,2022/4/15 17:30,29,104,-75,
15412,129,2022/4/15 17:40,28,180,-152,
15413,129,2022/4/15 17:50,28,196,-168,
15414,129,2022/4/15 18:00,27,182,-155,
15415,129,2022/4/15 18:10,28,268,-240,
15416,129,2022/4/15 18:20,24,197,-173,
15417,129,2022/4/15 18:30,21,383,-362,
15418,129,2022/4/15 18:40,20,203,-183,
15419,129,2022/4/15 18:50,23,386,-363,
15420,129,2022/4/15 19:00,20,327,-307,
15421,129,2022/4/15 19:10,20,222,-202,
15422,129,2022/4/15 19:20,18,335,-317,
15423,129,2022/4/15 19:30,14,128,-114,
15424,129,2022/4/15 19:40,15,224,-209,
15425,129,2022/4/15 19:50,13,120,-107,
15426,129,2022/4/15 20:00,14,93,-79,
15427,129,2022/4/15 20:10,15,153,-138,
15428,129,2022/4/15 20:20,13,74,-61,
15429,129,2022/4/15 20:30,12,110,-98,
15430,129,2022/4/15 20:40,13,91,-78,
15431,129,2022/4/15 20:50,14,122,-108,
15432,129,2022/4/15 21:00,13,107,-94,
15433,129,2022/4/15 21:10,12,121,-109,
15434,129,2022/4/15 21:20,12,122,-110,
15435,129,2022/4/15 21:30,8,82,-74,
15436,129,2022/4/15 21:40,11,104,-93,
15437,129,2022/4/15 21:50,4,107,-103,
15438,129,2022/4/15 22:00,4,100,-96,
15439,129,2022/4/15 22:10,2,72,-70,
15440,129,2022/4/15 22:20,2,104,-102,
15441,129,2022/4/15 22:30,0,64,-64,
15442,129,2022/4/15 22:40,0,3,-3,
15443,129,2022/4/15 22:50,0,3,-3,
15444,122,2022/4/15 5:00,0,1,-1,
15445,122,2022/4/15 5:10,0,1,-1,
15446,122,2022/4/15 5:20,0,1,-1,
15447,122,2022/4/15 5:30,0,1,-1,
15448,122,2022/4/15 5:40,0,1,-1,
15449,122,2022/4/15 5:50,28,1,27,
15450,122,2022/4/15 6:00,55,2,53,
15451,122,2022/4/15 6:10,148,13,135,
15452,122,2022/4/15 6:20,152,8,144,
15453,122,2022/4/15 6:30,222,15,207,
15454,122,2022/4/15 6:40,227,66,161,
15455,122,2022/4/15 6:50,247,66,181,
15456,122,2022/4/15 7:00,346,108,238,
15457,122,2022/4/15 7:10,436,90,346,
15458,122,2022/4/15 7:20,722,100,622,
15459,122,2022/4/15 7:30,741,98,643,
15460,122,2022/4/15 7:40,1177,106,1071,
15461,122,2022/4/15 7:50,865,119,746,
15462,122,2022/4/15 8:00,732,93,639,
15463,122,2022/4/15 8:10,723,115,608,
15464,122,2022/4/15 8:20,589,101,488,
15465,122,2022/4/15 8:30,357,87,270,
15466,122,2022/4/15 8:40,278,114,164,
15467,122,2022/4/15 8:50,250,102,148,
15468,122,2022/4/15 9:00,206,93,113,
15469,122,2022/4/15 9:10,151,109,42,
15470,122,2022/4/15 9:20,115,105,10,
15471,122,2022/4/15 9:30,60,97,-37,
15472,122,2022/4/15 9:40,57,105,-48,
15473,122,2022/4/15 9:50,48,105,-57,
15474,122,2022/4/15 10:00,48,94,-46,
15475,122,2022/4/15 10:10,43,103,-60,
15476,122,2022/4/15 10:20,42,93,-51,
15477,122,2022/4/15 10:30,42,68,-26,
15478,122,2022/4/15 10:40,40,100,-60,
15479,122,2022/4/15 10:50,40,75,-35,
15480,122,2022/4/15 11:00,45,102,-57,
15481,122,2022/4/15 11:10,39,103,-64,
15482,122,2022/4/15 11:20,43,76,-33,
15483,122,2022/4/15 11:30,41,83,-42,
15484,122,2022/4/15 11:40,41,77,-36,
15485,122,2022/4/15 11:50,47,84,-37,
15486,122,2022/4/15 12:00,46,100,-54,
15487,122,2022/4/15 12:10,44,81,-37,
15488,122,2022/4/15 12:20,48,77,-29,
15489,122,2022/4/15 12:30,47,78,-31,
15490,122,2022/4/15 12:40,41,80,-39,
15491,122,2022/4/15 12:50,35,76,-41,
15492,122,2022/4/15 13:00,43,106,-63,
15493,122,2022/4/15 13:10,34,89,-55,
15494,122,2022/4/15 13:20,39,80,-41,
15495,122,2022/4/15 13:30,34,83,-49,
15496,122,2022/4/15 13:40,37,78,-41,
15497,122,2022/4/15 13:50,39,102,-63,
15498,122,2022/4/15 14:00,35,93,-58,
15499,122,2022/4/15 14:10,37,93,-56,
15500,122,2022/4/15 14:20,37,86,-49,
15501,122,2022/4/15 14:30,32,92,-60,
15502,122,2022/4/15 14:40,39,90,-51,
15503,122,2022/4/15 14:50,29,118,-89,
15504,122,2022/4/15 15:00,34,105,-71,
15505,122,2022/4/15 15:10,37,107,-70,
15506,122,2022/4/15 15:20,35,90,-55,
15507,122,2022/4/15 15:30,37,98,-61,
15508,122,2022/4/15 15:40,33,101,-68,
15509,122,2022/4/15 15:50,38,109,-71,
15510,122,2022/4/15 16:00,37,104,-67,
15511,122,2022/4/15 16:10,38,111,-73,
15512,122,2022/4/15 16:20,45,113,-68,
15513,122,2022/4/15 16:30,44,103,-59,
15514,122,2022/4/15 16:40,70,150,-80,
15515,122,2022/4/15 16:50,133,117,16,
15516,122,2022/4/15 17:00,74,110,-36,
15517,122,2022/4/15 17:10,49,145,-96,
15518,122,2022/4/15 17:20,47,110,-63,
15519,122,2022/4/15 17:30,42,268,-226,
15520,122,2022/4/15 17:40,41,108,-67,
15521,122,2022/4/15 17:50,42,324,-282,
15522,122,2022/4/15 18:00,45,232,-187,
15523,122,2022/4/15 18:10,40,341,-301,
15524,122,2022/4/15 18:20,37,379,-342,
15525,122,2022/4/15 18:30,28,217,-189,
15526,122,2022/4/15 18:40,27,428,-401,
15527,122,2022/4/15 18:50,28,229,-201,
15528,122,2022/4/15 19:00,27,439,-412,
15529,122,2022/4/15 19:10,27,231,-204,
15530,122,2022/4/15 19:20,25,300,-275,
15531,122,2022/4/15 19:30,26,285,-259,
15532,122,2022/4/15 19:40,25,118,-93,
15533,122,2022/4/15 19:50,25,213,-188,
15534,122,2022/4/15 20:00,29,101,-72,
15535,122,2022/4/15 20:10,28,150,-122,
15536,122,2022/4/15 20:20,22,111,-89,
15537,122,2022/4/15 20:30,28,106,-78,
15538,122,2022/4/15 20:40,23,110,-87,
15539,122,2022/4/15 20:50,24,107,-83,
15540,122,2022/4/15 21:00,24,110,-86,
15541,122,2022/4/15 21:10,22,104,-82,
15542,122,2022/4/15 21:20,18,111,-93,
15543,122,2022/4/15 21:30,17,132,-115,
15544,122,2022/4/15 21:40,16,94,-78,
15545,122,2022/4/15 21:50,11,111,-100,
15546,122,2022/4/15 22:00,7,89,-82,
15547,122,2022/4/15 22:10,5,104,-99,
15548,122,2022/4/15 22:20,2,78,-76,
15549,122,2022/4/15 22:30,0,66,-66,
15550,122,2022/4/15 22:40,0,56,-56,
15551,122,2022/4/15 22:50,0,3,-3,
15552,133,2022/4/15 5:00,0,1,-1,
15553,133,2022/4/15 5:10,0,1,-1,
15554,133,2022/4/15 5:20,0,1,-1,
15555,133,2022/4/15 5:30,0,1,-1,
15556,133,2022/4/15 5:40,0,1,-1,
15557,133,2022/4/15 5:50,14,1,13,
15558,133,2022/4/15 6:00,29,1,28,
15559,133,2022/4/15 6:10,47,1,46,
15560,133,2022/4/15 6:20,31,1,30,
15561,133,2022/4/15 6:30,51,1,50,
15562,133,2022/4/15 6:40,48,5,43,
15563,133,2022/4/15 6:50,48,19,29,
15564,133,2022/4/15 7:00,57,6,51,
15565,133,2022/4/15 7:10,76,19,57,
15566,133,2022/4/15 7:20,147,14,133,
15567,133,2022/4/15 7:30,156,23,133,
15568,133,2022/4/15 7:40,148,25,123,
15569,133,2022/4/15 7:50,150,23,127,
15570,133,2022/4/15 8:00,144,40,104,
15571,133,2022/4/15 8:10,82,21,61,
15572,133,2022/4/15 8:20,62,47,15,
15573,133,2022/4/15 8:30,44,31,13,
15574,133,2022/4/15 8:40,35,19,16,
15575,133,2022/4/15 8:50,32,38,-6,
15576,133,2022/4/15 9:00,27,37,-10,
15577,133,2022/4/15 9:10,25,23,2,
15578,133,2022/4/15 9:20,12,39,-27,
15579,133,2022/4/15 9:30,20,23,-3,
15580,133,2022/4/15 9:40,16,23,-7,
15581,133,2022/4/15 9:50,14,30,-16,
15582,133,2022/4/15 10:00,16,33,-17,
15583,133,2022/4/15 10:10,16,17,-1,
15584,133,2022/4/15 10:20,9,30,-21,
15585,133,2022/4/15 10:30,13,24,-11,
15586,133,2022/4/15 10:40,7,21,-14,
15587,133,2022/4/15 10:50,15,25,-10,
15588,133,2022/4/15 11:00,9,19,-10,
15589,133,2022/4/15 11:10,11,25,-14,
15590,133,2022/4/15 11:20,10,22,-12,
15591,133,2022/4/15 11:30,12,34,-22,
15592,133,2022/4/15 11:40,14,23,-9,
15593,133,2022/4/15 11:50,11,25,-14,
15594,133,2022/4/15 12:00,10,23,-13,
15595,133,2022/4/15 12:10,15,23,-8,
15596,133,2022/4/15 12:20,12,23,-11,
15597,133,2022/4/15 12:30,19,32,-13,
15598,133,2022/4/15 12:40,6,23,-17,
15599,133,2022/4/15 12:50,13,23,-10,
15600,133,2022/4/15 13:00,10,23,-13,
15601,133,2022/4/15 13:10,9,23,-14,
15602,133,2022/4/15 13:20,10,37,-27,
15603,133,2022/4/15 13:30,10,33,-23,
15604,133,2022/4/15 13:40,7,23,-16,
15605,133,2022/4/15 13:50,12,23,-11,
15606,133,2022/4/15 14:00,9,23,-14,
15607,133,2022/4/15 14:10,10,30,-20,
15608,133,2022/4/15 14:20,8,40,-32,
15609,133,2022/4/15 14:30,9,25,-16,
15610,133,2022/4/15 14:40,6,32,-26,
15611,133,2022/4/15 14:50,10,30,-20,
15612,133,2022/4/15 15:00,7,31,-24,
15613,133,2022/4/15 15:10,9,32,-23,
15614,133,2022/4/15 15:20,10,59,-49,
15615,133,2022/4/15 15:30,11,39,-28,
15616,133,2022/4/15 15:40,9,37,-28,
15617,133,2022/4/15 15:50,7,39,-32,
15618,133,2022/4/15 16:00,6,44,-38,
15619,133,2022/4/15 16:10,11,65,-54,
15620,133,2022/4/15 16:20,10,38,-28,
15621,133,2022/4/15 16:30,12,44,-32,
15622,133,2022/4/15 16:40,11,48,-37,
15623,133,2022/4/15 16:50,10,46,-36,
15624,133,2022/4/15 17:00,7,54,-47,
15625,133,2022/4/15 17:10,16,68,-52,
15626,133,2022/4/15 17:20,12,62,-50,
15627,133,2022/4/15 17:30,11,60,-49,
15628,133,2022/4/15 17:40,11,73,-62,
15629,133,2022/4/15 17:50,12,65,-53,
15630,133,2022/4/15 18:00,11,93,-82,
15631,133,2022/4/15 18:10,12,71,-59,
15632,133,2022/4/15 18:20,10,92,-82,
15633,133,2022/4/15 18:30,8,102,-94,
15634,133,2022/4/15 18:40,8,79,-71,
15635,133,2022/4/15 18:50,9,107,-98,
15636,133,2022/4/15 19:00,6,75,-69,
15637,133,2022/4/15 19:10,9,108,-99,
15638,133,2022/4/15 19:20,3,73,-70,
15639,133,2022/4/15 19:30,9,95,-86,
15640,133,2022/4/15 19:40,4,80,-76,
15641,133,2022/4/15 19:50,6,51,-45,
15642,133,2022/4/15 20:00,4,73,-69,
15643,133,2022/4/15 20:10,5,39,-34,
15644,133,2022/4/15 20:20,3,71,-68,
15645,133,2022/4/15 20:30,3,51,-48,
15646,133,2022/4/15 20:40,3,53,-50,
15647,133,2022/4/15 20:50,2,63,-61,
15648,133,2022/4/15 21:00,2,41,-39,
15649,133,2022/4/15 21:10,1,67,-66,
15650,133,2022/4/15 21:20,2,51,-49,
15651,133,2022/4/15 21:30,1,45,-44,
15652,133,2022/4/15 21:40,2,55,-53,
15653,133,2022/4/15 21:50,1,39,-38,
15654,133,2022/4/15 22:00,1,62,-61,
15655,133,2022/4/15 22:10,0,30,-30,
15656,133,2022/4/15 22:20,0,46,-46,
15657,133,2022/4/15 22:30,0,20,-20,
15658,133,2022/4/15 22:40,0,18,-18,
15659,133,2022/4/15 22:50,0,3,-3,
15660,146,2022/4/15 5:00,0,1,-1,
15661,146,2022/4/15 5:10,0,1,-1,
15662,146,2022/4/15 5:20,0,1,-1,
15663,146,2022/4/15 5:30,0,1,-1,
15664,146,2022/4/15 5:40,0,1,-1,
15665,146,2022/4/15 5:50,9,1,8,
15666,146,2022/4/15 6:00,20,1,19,
15667,146,2022/4/15 6:10,20,1,19,
15668,146,2022/4/15 6:20,27,1,26,
15669,146,2022/4/15 6:30,23,1,22,
15670,146,2022/4/15 6:40,27,1,26,
15671,146,2022/4/15 6:50,29,19,10,
15672,146,2022/4/15 7:00,30,8,22,
15673,146,2022/4/15 7:10,32,11,21,
15674,146,2022/4/15 7:20,30,8,22,
15675,146,2022/4/15 7:30,32,11,21,
15676,146,2022/4/15 7:40,32,33,-1,
15677,146,2022/4/15 7:50,32,16,16,
15678,146,2022/4/15 8:00,29,31,-2,
15679,146,2022/4/15 8:10,23,31,-8,
15680,146,2022/4/15 8:20,17,23,-6,
15681,146,2022/4/15 8:30,19,45,-26,
15682,146,2022/4/15 8:40,14,63,-49,
15683,146,2022/4/15 8:50,11,40,-29,
15684,146,2022/4/15 9:00,10,60,-50,
15685,146,2022/4/15 9:10,9,67,-58,
15686,146,2022/4/15 9:20,8,38,-30,
15687,146,2022/4/15 9:30,5,46,-41,
15688,146,2022/4/15 9:40,6,48,-42,
15689,146,2022/4/15 9:50,4,28,-24,
15690,146,2022/4/15 10:00,7,46,-39,
15691,146,2022/4/15 10:10,5,39,-34,
15692,146,2022/4/15 10:20,5,31,-26,
15693,146,2022/4/15 10:30,7,38,-31,
15694,146,2022/4/15 10:40,6,33,-27,
15695,146,2022/4/15 10:50,6,23,-17,
15696,146,2022/4/15 11:00,4,32,-28,
15697,146,2022/4/15 11:10,4,23,-19,
15698,146,2022/4/15 11:20,7,19,-12,
15699,146,2022/4/15 11:30,7,29,-22,
15700,146,2022/4/15 11:40,8,21,-13,
15701,146,2022/4/15 11:50,7,19,-12,
15702,146,2022/4/15 12:00,7,38,-31,
15703,146,2022/4/15 12:10,9,23,-14,
15704,146,2022/4/15 12:20,6,23,-17,
15705,146,2022/4/15 12:30,10,21,-11,
15706,146,2022/4/15 12:40,9,14,-5,
15707,146,2022/4/15 12:50,6,32,-26,
15708,146,2022/4/15 13:00,8,23,-15,
15709,146,2022/4/15 13:10,6,25,-19,
15710,146,2022/4/15 13:20,7,23,-16,
15711,146,2022/4/15 13:30,7,19,-12,
15712,146,2022/4/15 13:40,9,21,-12,
15713,146,2022/4/15 13:50,5,29,-24,
15714,146,2022/4/15 14:00,8,23,-15,
15715,146,2022/4/15 14:10,8,21,-13,
15716,146,2022/4/15 14:20,5,23,-18,
15717,146,2022/4/15 14:30,5,23,-18,
15718,146,2022/4/15 14:40,8,21,-13,
15719,146,2022/4/15 14:50,6,23,-17,
15720,146,2022/4/15 15:00,8,23,-15,
15721,146,2022/4/15 15:10,10,19,-9,
15722,146,2022/4/15 15:20,7,19,-12,
15723,146,2022/4/15 15:30,10,21,-11,
15724,146,2022/4/15 15:40,9,21,-12,
15725,146,2022/4/15 15:50,8,31,-23,
15726,146,2022/4/15 16:00,9,19,-10,
15727,146,2022/4/15 16:10,12,25,-13,
15728,146,2022/4/15 16:20,10,23,-13,
15729,146,2022/4/15 16:30,10,28,-18,
15730,146,2022/4/15 16:40,10,38,-28,
15731,146,2022/4/15 16:50,14,37,-23,
15732,146,2022/4/15 17:00,12,33,-21,
15733,146,2022/4/15 17:10,16,35,-19,
15734,146,2022/4/15 17:20,10,38,-28,
15735,146,2022/4/15 17:30,14,24,-10,
15736,146,2022/4/15 17:40,14,50,-36,
15737,146,2022/4/15 17:50,10,49,-39,
15738,146,2022/4/15 18:00,17,43,-26,
15739,146,2022/4/15 18:10,14,65,-51,
15740,146,2022/4/15 18:20,11,43,-32,
15741,146,2022/4/15 18:30,8,63,-55,
15742,146,2022/4/15 18:40,8,43,-35,
15743,146,2022/4/15 18:50,5,58,-53,
15744,146,2022/4/15 19:00,8,47,-39,
15745,146,2022/4/15 19:10,7,40,-33,
15746,146,2022/4/15 19:20,5,52,-47,
15747,146,2022/4/15 19:30,3,32,-29,
15748,146,2022/4/15 19:40,3,41,-38,
15749,146,2022/4/15 19:50,3,40,-37,
15750,146,2022/4/15 20:00,6,32,-26,
15751,146,2022/4/15 20:10,4,33,-29,
15752,146,2022/4/15 20:20,4,23,-19,
15753,146,2022/4/15 20:30,4,30,-26,
15754,146,2022/4/15 20:40,4,25,-21,
15755,146,2022/4/15 20:50,4,27,-23,
15756,146,2022/4/15 21:00,17,25,-8,
15757,146,2022/4/15 21:10,29,25,4,
15758,146,2022/4/15 21:20,13,40,-27,
15759,146,2022/4/15 21:30,4,21,-17,
15760,146,2022/4/15 21:40,2,31,-29,
15761,146,2022/4/15 21:50,2,26,-24,
15762,146,2022/4/15 22:00,1,21,-20,
15763,146,2022/4/15 22:10,0,25,-25,
15764,146,2022/4/15 22:20,0,13,-13,
15765,146,2022/4/15 22:30,0,34,-34,
15766,146,2022/4/15 22:40,0,22,-22,
15767,146,2022/4/15 22:50,0,21,-21,
15768,126,2022/4/15 5:00,0,1,-1,
15769,126,2022/4/15 5:10,0,1,-1,
15770,126,2022/4/15 5:20,0,1,-1,
15771,126,2022/4/15 5:30,0,1,-1,
15772,126,2022/4/15 5:40,3,1,2,
15773,126,2022/4/15 5:50,7,1,6,
15774,126,2022/4/15 6:00,4,1,3,
15775,126,2022/4/15 6:10,6,1,5,
15776,126,2022/4/15 6:20,7,1,6,
15777,126,2022/4/15 6:30,8,12,-4,
15778,126,2022/4/15 6:40,10,6,4,
15779,126,2022/4/15 6:50,6,14,-8,
15780,126,2022/4/15 7:00,10,31,-21,
15781,126,2022/4/15 7:10,9,42,-33,
15782,126,2022/4/15 7:20,7,51,-44,
15783,126,2022/4/15 7:30,13,50,-37,
15784,126,2022/4/15 7:40,12,75,-63,
15785,126,2022/4/15 7:50,13,68,-55,
15786,126,2022/4/15 8:00,13,113,-100,
15787,126,2022/4/15 8:10,16,98,-82,
15788,126,2022/4/15 8:20,14,114,-100,
15789,126,2022/4/15 8:30,18,102,-84,
15790,126,2022/4/15 8:40,17,71,-54,
15791,126,2022/4/15 8:50,14,88,-74,
15792,126,2022/4/15 9:00,12,72,-60,
15793,126,2022/4/15 9:10,12,48,-36,
15794,126,2022/4/15 9:20,9,61,-52,
15795,126,2022/4/15 9:30,15,51,-36,
15796,126,2022/4/15 9:40,8,33,-25,
15797,126,2022/4/15 9:50,10,45,-35,
15798,126,2022/4/15 10:00,7,33,-26,
15799,126,2022/4/15 10:10,10,25,-15,
15800,126,2022/4/15 10:20,5,24,-19,
15801,126,2022/4/15 10:30,13,31,-18,
15802,126,2022/4/15 10:40,9,7,2,
15803,126,2022/4/15 10:50,6,34,-28,
15804,126,2022/4/15 11:00,8,22,-14,
15805,126,2022/4/15 11:10,12,21,-9,
15806,126,2022/4/15 11:20,12,23,-11,
15807,126,2022/4/15 11:30,10,19,-9,
15808,126,2022/4/15 11:40,9,16,-7,
15809,126,2022/4/15 11:50,8,23,-15,
15810,126,2022/4/15 12:00,9,23,-14,
15811,126,2022/4/15 12:10,12,23,-11,
15812,126,2022/4/15 12:20,10,19,-9,
15813,126,2022/4/15 12:30,7,25,-18,
15814,126,2022/4/15 12:40,6,21,-15,
15815,126,2022/4/15 12:50,7,29,-22,
15816,126,2022/4/15 13:00,5,23,-18,
15817,126,2022/4/15 13:10,11,16,-5,
15818,126,2022/4/15 13:20,10,23,-13,
15819,126,2022/4/15 13:30,9,19,-10,
15820,126,2022/4/15 13:40,9,16,-7,
15821,126,2022/4/15 13:50,9,21,-12,
15822,126,2022/4/15 14:00,11,12,-1,
15823,126,2022/4/15 14:10,12,17,-5,
15824,126,2022/4/15 14:20,8,14,-6,
15825,126,2022/4/15 14:30,8,19,-11,
15826,126,2022/4/15 14:40,13,19,-6,
15827,126,2022/4/15 14:50,12,16,-4,
15828,126,2022/4/15 15:00,12,19,-7,
15829,126,2022/4/15 15:10,13,19,-6,
15830,126,2022/4/15 15:20,15,14,1,
15831,126,2022/4/15 15:30,17,19,-2,
15832,126,2022/4/15 15:40,21,23,-2,
15833,126,2022/4/15 15:50,24,18,6,
15834,126,2022/4/15 16:00,27,14,13,
15835,126,2022/4/15 16:10,27,19,8,
15836,126,2022/4/15 16:20,28,12,16,
15837,126,2022/4/15 16:30,37,21,16,
15838,126,2022/4/15 16:40,29,18,11,
15839,126,2022/4/15 16:50,16,12,4,
15840,126,2022/4/15 17:00,23,14,9,
15841,126,2022/4/15 17:10,23,12,11,
15842,126,2022/4/15 17:20,26,21,5,
15843,126,2022/4/15 17:30,23,7,16,
15844,126,2022/4/15 17:40,17,16,1,
15845,126,2022/4/15 17:50,11,12,-1,
15846,126,2022/4/15 18:00,9,25,-16,
15847,126,2022/4/15 18:10,8,23,-15,
15848,126,2022/4/15 18:20,7,21,-14,
15849,126,2022/4/15 18:30,12,21,-9,
15850,126,2022/4/15 18:40,3,15,-12,
15851,126,2022/4/15 18:50,5,22,-17,
15852,126,2022/4/15 19:00,6,15,-9,
15853,126,2022/4/15 19:10,4,25,-21,
15854,126,2022/4/15 19:20,7,32,-25,
15855,126,2022/4/15 19:30,5,25,-20,
15856,126,2022/4/15 19:40,4,24,-20,
15857,126,2022/4/15 19:50,4,15,-11,
15858,126,2022/4/15 20:00,6,30,-24,
15859,126,2022/4/15 20:10,7,31,-24,
15860,126,2022/4/15 20:20,7,25,-18,
15861,126,2022/4/15 20:30,8,23,-15,
15862,126,2022/4/15 20:40,5,13,-8,
15863,126,2022/4/15 20:50,5,22,-17,
15864,126,2022/4/15 21:00,2,15,-13,
15865,126,2022/4/15 21:10,4,21,-17,
15866,126,2022/4/15 21:20,2,21,-19,
15867,126,2022/4/15 21:30,2,16,-14,
15868,126,2022/4/15 21:40,1,23,-22,
15869,126,2022/4/15 21:50,2,18,-16,
15870,126,2022/4/15 22:00,1,21,-20,
15871,126,2022/4/15 22:10,0,10,-10,
15872,126,2022/4/15 22:20,0,13,-13,
15873,126,2022/4/15 22:30,0,8,-8,
15874,126,2022/4/15 22:40,0,3,-3,
15875,126,2022/4/15 22:50,0,3,-3,
15876,139,2022/4/15 5:00,0,1,-1,
15877,139,2022/4/15 5:10,0,1,-1,
15878,139,2022/4/15 5:20,0,1,-1,
15879,139,2022/4/15 5:30,0,1,-1,
15880,139,2022/4/15 5:40,47,1,46,
15881,139,2022/4/15 5:50,29,1,28,
15882,139,2022/4/15 6:00,27,1,26,
15883,139,2022/4/15 6:10,24,1,23,
15884,139,2022/4/15 6:20,20,1,19,
15885,139,2022/4/15 6:30,23,80,-57,
15886,139,2022/4/15 6:40,25,70,-45,
15887,139,2022/4/15 6:50,25,45,-20,
15888,139,2022/4/15 7:00,23,108,-85,
15889,139,2022/4/15 7:10,27,102,-75,
15890,139,2022/4/15 7:20,27,110,-83,
15891,139,2022/4/15 7:30,29,120,-91,
15892,139,2022/4/15 7:40,30,110,-80,
15893,139,2022/4/15 7:50,28,110,-82,
15894,139,2022/4/15 8:00,26,110,-84,
15895,139,2022/4/15 8:10,41,213,-172,
15896,139,2022/4/15 8:20,41,126,-85,
15897,139,2022/4/15 8:30,45,152,-107,
15898,139,2022/4/15 8:40,54,117,-63,
15899,139,2022/4/15 8:50,59,108,-49,
15900,139,2022/4/15 9:00,61,111,-50,
15901,139,2022/4/15 9:10,47,103,-56,
15902,139,2022/4/15 9:20,37,109,-72,
15903,139,2022/4/15 9:30,35,122,-87,
15904,139,2022/4/15 9:40,28,110,-82,
15905,139,2022/4/15 9:50,25,110,-85,
15906,139,2022/4/15 10:00,29,107,-78,
15907,139,2022/4/15 10:10,30,142,-112,
15908,139,2022/4/15 10:20,32,54,-22,
15909,139,2022/4/15 10:30,38,108,-70,
15910,139,2022/4/15 10:40,40,77,-37,
15911,139,2022/4/15 10:50,39,102,-63,
15912,139,2022/4/15 11:00,34,107,-73,
15913,139,2022/4/15 11:10,41,76,-35,
15914,139,2022/4/15 11:20,43,112,-69,
15915,139,2022/4/15 11:30,36,103,-67,
15916,139,2022/4/15 11:40,42,91,-49,
15917,139,2022/4/15 11:50,37,83,-46,
15918,139,2022/4/15 12:00,37,93,-56,
15919,139,2022/4/15 12:10,39,93,-54,
15920,139,2022/4/15 12:20,35,103,-68,
15921,139,2022/4/15 12:30,34,98,-64,
15922,139,2022/4/15 12:40,33,77,-44,
15923,139,2022/4/15 12:50,24,77,-53,
15924,139,2022/4/15 13:00,27,77,-50,
15925,139,2022/4/15 13:10,31,73,-42,
15926,139,2022/4/15 13:20,31,106,-75,
15927,139,2022/4/15 13:30,35,98,-63,
15928,139,2022/4/15 13:40,28,98,-70,
15929,139,2022/4/15 13:50,29,90,-61,
15930,139,2022/4/15 14:00,29,93,-64,
15931,139,2022/4/15 14:10,32,120,-88,
15932,139,2022/4/15 14:20,34,102,-68,
15933,139,2022/4/15 14:30,38,110,-72,
15934,139,2022/4/15 14:40,38,97,-59,
15935,139,2022/4/15 14:50,35,101,-66,
15936,139,2022/4/15 15:00,46,106,-60,
15937,139,2022/4/15 15:10,47,119,-72,
15938,139,2022/4/15 15:20,58,105,-47,
15939,139,2022/4/15 15:30,47,108,-61,
15940,139,2022/4/15 15:40,56,93,-37,
15941,139,2022/4/15 15:50,66,94,-28,
15942,139,2022/4/15 16:00,66,100,-34,
15943,139,2022/4/15 16:10,62,103,-41,
15944,139,2022/4/15 16:20,58,103,-45,
15945,139,2022/4/15 16:30,66,83,-17,
15946,139,2022/4/15 16:40,44,95,-51,
15947,139,2022/4/15 16:50,52,90,-38,
15948,139,2022/4/15 17:00,59,110,-51,
15949,139,2022/4/15 17:10,73,98,-25,
15950,139,2022/4/15 17:20,42,94,-52,
15951,139,2022/4/15 17:30,46,107,-61,
15952,139,2022/4/15 17:40,45,74,-29,
15953,139,2022/4/15 17:50,44,103,-59,
15954,139,2022/4/15 18:00,47,77,-30,
15955,139,2022/4/15 18:10,45,106,-61,
15956,139,2022/4/15 18:20,40,89,-49,
15957,139,2022/4/15 18:30,44,99,-55,
15958,139,2022/4/15 18:40,45,102,-57,
15959,139,2022/4/15 18:50,35,87,-52,
15960,139,2022/4/15 19:00,41,95,-54,
15961,139,2022/4/15 19:10,34,97,-63,
15962,139,2022/4/15 19:20,37,122,-85,
15963,139,2022/4/15 19:30,42,84,-42,
15964,139,2022/4/15 19:40,35,100,-65,
15965,139,2022/4/15 19:50,40,119,-79,
15966,139,2022/4/15 20:00,44,88,-44,
15967,139,2022/4/15 20:10,49,124,-75,
15968,139,2022/4/15 20:20,57,70,-13,
15969,139,2022/4/15 20:30,71,106,-35,
15970,139,2022/4/15 20:40,63,92,-29,
15971,139,2022/4/15 20:50,62,76,-14,
15972,139,2022/4/15 21:00,44,75,-31,
15973,139,2022/4/15 21:10,49,60,-11,
15974,139,2022/4/15 21:20,40,72,-32,
15975,139,2022/4/15 21:30,51,72,-21,
15976,139,2022/4/15 21:40,39,60,-21,
15977,139,2022/4/15 21:50,21,69,-48,
15978,139,2022/4/15 22:00,0,50,-50,
15979,139,2022/4/15 22:10,0,69,-69,
15980,139,2022/4/15 22:20,0,57,-57,
15981,139,2022/4/15 22:30,0,58,-58,
15982,139,2022/4/15 22:40,0,3,-3,
15983,139,2022/4/15 22:50,0,3,-3,
15984,163,2022/4/15 5:00,16,1,15,15
15985,163,2022/4/15 5:10,31,1,30,30
15986,163,2022/4/15 5:20,26,1,25,25
15987,163,2022/4/15 5:30,28,1,27,27
15988,163,2022/4/15 5:40,31,6,25,25
15989,163,2022/4/15 5:50,29,23,6,6
15990,163,2022/4/15 6:00,41,23,18,18
15991,163,2022/4/15 6:10,57,34,23,23
15992,163,2022/4/15 6:20,155,64,91,91
15993,163,2022/4/15 6:30,201,114,87,87
15994,163,2022/4/15 6:40,278,120,158,158
15995,163,2022/4/15 6:50,276,111,165,165
15996,163,2022/4/15 7:00,661,182,479,479
15997,163,2022/4/15 7:10,602,111,491,491
15998,163,2022/4/15 7:20,1382,208,1174,1174
15999,163,2022/4/15 7:30,1574,300,1274,1274
16000,163,2022/4/15 7:40,1981,233,1748,1748
16001,163,2022/4/15 7:50,2000,198,1802,1802
16002,163,2022/4/15 8:00,2058,196,1862,1862
16003,163,2022/4/15 8:10,1984,208,1776,1776
16004,163,2022/4/15 8:20,1975,198,1777,1777
16005,163,2022/4/15 8:30,2059,181,1878,1878
16006,163,2022/4/15 8:40,1175,197,978,978
16007,163,2022/4/15 8:50,822,214,608,608
16008,163,2022/4/15 9:00,1155,178,977,977
16009,163,2022/4/15 9:10,585,181,404,404
16010,163,2022/4/15 9:20,653,150,503,503
16011,163,2022/4/15 9:30,349,151,198,198
16012,163,2022/4/15 9:40,234,119,115,115
16013,163,2022/4/15 9:50,209,118,91,91
16014,163,2022/4/15 10:00,160,123,37,37
16015,163,2022/4/15 10:10,316,110,206,206
16016,163,2022/4/15 10:20,165,108,57,57
16017,163,2022/4/15 10:30,164,107,57,57
16018,163,2022/4/15 10:40,172,118,54,54
16019,163,2022/4/15 10:50,172,122,50,50
16020,163,2022/4/15 11:00,212,120,92,92
16021,163,2022/4/15 11:10,141,121,20,20
16022,163,2022/4/15 11:20,136,120,16,16
16023,163,2022/4/15 11:30,129,117,12,12
16024,163,2022/4/15 11:40,126,110,16,16
16025,163,2022/4/15 11:50,207,106,101,101
16026,163,2022/4/15 12:00,177,118,59,59
16027,163,2022/4/15 12:10,158,117,41,41
16028,163,2022/4/15 12:20,220,114,106,106
16029,163,2022/4/15 12:30,267,152,115,115
16030,163,2022/4/15 12:40,173,140,33,33
16031,163,2022/4/15 12:50,206,149,57,57
16032,163,2022/4/15 13:00,194,126,68,68
16033,163,2022/4/15 13:10,173,103,70,70
16034,163,2022/4/15 13:20,151,166,-15,-15
16035,163,2022/4/15 13:30,198,120,78,78
16036,163,2022/4/15 13:40,110,185,-75,-75
16037,163,2022/4/15 13:50,184,124,60,60
16038,163,2022/4/15 14:00,158,151,7,7
16039,163,2022/4/15 14:10,146,143,3,3
16040,163,2022/4/15 14:20,125,118,7,7
16041,163,2022/4/15 14:30,142,194,-52,-52
16042,163,2022/4/15 14:40,82,149,-67,-67
16043,163,2022/4/15 14:50,125,191,-66,-66
16044,163,2022/4/15 15:00,144,145,-1,-1
16045,163,2022/4/15 15:10,142,206,-64,-64
16046,163,2022/4/15 15:20,130,172,-42,-42
16047,163,2022/4/15 15:30,266,152,114,114
16048,163,2022/4/15 15:40,118,295,-177,-177
16049,163,2022/4/15 15:50,258,197,61,61
16050,163,2022/4/15 16:00,214,263,-49,-49
16051,163,2022/4/15 16:10,253,275,-22,-22
16052,163,2022/4/15 16:20,183,296,-113,-113
16053,163,2022/4/15 16:30,195,303,-108,-108
16054,163,2022/4/15 16:40,268,261,7,7
16055,163,2022/4/15 16:50,267,470,-203,-203
16056,163,2022/4/15 17:00,270,307,-37,-37
16057,163,2022/4/15 17:10,333,484,-151,-151
16058,163,2022/4/15 17:20,264,411,-147,-147
16059,163,2022/4/15 17:30,327,473,-146,-146
16060,163,2022/4/15 17:40,255,582,-327,-327
16061,163,2022/4/15 17:50,237,1142,-905,-905
16062,163,2022/4/15 18:00,274,1567,-1293,-1293
16063,163,2022/4/15 18:10,216,1061,-845,-845
16064,163,2022/4/15 18:20,191,1070,-879,-879
16065,163,2022/4/15 18:30,225,1996,-1771,-1771
16066,163,2022/4/15 18:40,231,1530,-1299,-1299
16067,163,2022/4/15 18:50,146,1071,-925,-925
16068,163,2022/4/15 19:00,149,480,-331,-331
16069,163,2022/4/15 19:10,119,432,-313,-313
16070,163,2022/4/15 19:20,64,432,-368,-368
16071,163,2022/4/15 19:30,79,522,-443,-443
16072,163,2022/4/15 19:40,56,341,-285,-285
16073,163,2022/4/15 19:50,68,327,-259,-259
16074,163,2022/4/15 20:00,54,209,-155,-155
16075,163,2022/4/15 20:10,45,209,-164,-164
16076,163,2022/4/15 20:20,82,198,-116,-116
16077,163,2022/4/15 20:30,57,146,-89,-89
16078,163,2022/4/15 20:40,57,191,-134,-134
16079,163,2022/4/15 20:50,57,178,-121,-121
16080,163,2022/4/15 21:00,97,153,-56,-56
16081,163,2022/4/15 21:10,62,192,-130,-130
16082,163,2022/4/15 21:20,45,128,-83,-83
16083,163,2022/4/15 21:30,37,117,-80,-80
16084,163,2022/4/15 21:40,28,193,-165,-165
16085,163,2022/4/15 21:50,25,117,-92,-92
16086,163,2022/4/15 22:00,25,126,-101,-101
16087,163,2022/4/15 22:10,25,125,-100,-100
16088,163,2022/4/15 22:20,21,115,-94,-94
16089,163,2022/4/15 22:30,13,122,-109,-109
16090,163,2022/4/15 22:40,1,103,-102,-102
16091,163,2022/4/15 22:50,1,111,-110,-110
16092,164,2022/4/15 5:00,0,1,-1,
16093,164,2022/4/15 5:10,3,1,2,
16094,164,2022/4/15 5:20,10,1,9,
16095,164,2022/4/15 5:30,13,1,12,
16096,164,2022/4/15 5:40,16,1,15,
16097,164,2022/4/15 5:50,19,1,18,
16098,164,2022/4/15 6:00,29,1,28,
16099,164,2022/4/15 6:10,30,6,24,
16100,164,2022/4/15 6:20,57,12,45,
16101,164,2022/4/15 6:30,55,51,4,
16102,164,2022/4/15 6:40,88,84,4,
16103,164,2022/4/15 6:50,143,88,55,
16104,164,2022/4/15 7:00,171,91,80,
16105,164,2022/4/15 7:10,187,134,53,
16106,164,2022/4/15 7:20,182,109,73,
16107,164,2022/4/15 7:30,227,111,116,
16108,164,2022/4/15 7:40,276,100,176,
16109,164,2022/4/15 7:50,332,102,230,
16110,164,2022/4/15 8:00,435,110,325,
16111,164,2022/4/15 8:10,392,169,223,
16112,164,2022/4/15 8:20,324,104,220,
16113,164,2022/4/15 8:30,317,110,207,
16114,164,2022/4/15 8:40,280,110,170,
16115,164,2022/4/15 8:50,226,109,117,
16116,164,2022/4/15 9:00,188,121,67,
16117,164,2022/4/15 9:10,138,104,34,
16118,164,2022/4/15 9:20,100,102,-2,
16119,164,2022/4/15 9:30,68,96,-28,
16120,164,2022/4/15 9:40,45,87,-42,
16121,164,2022/4/15 9:50,38,94,-56,
16122,164,2022/4/15 10:00,37,73,-36,
16123,164,2022/4/15 10:10,36,57,-21,
16124,164,2022/4/15 10:20,35,80,-45,
16125,164,2022/4/15 10:30,29,71,-42,
16126,164,2022/4/15 10:40,36,65,-29,
16127,164,2022/4/15 10:50,29,65,-36,
16128,164,2022/4/15 11:00,33,62,-29,
16129,164,2022/4/15 11:10,32,77,-45,
16130,164,2022/4/15 11:20,27,70,-43,
16131,164,2022/4/15 11:30,30,72,-42,
16132,164,2022/4/15 11:40,25,60,-35,
16133,164,2022/4/15 11:50,28,67,-39,
16134,164,2022/4/15 12:00,32,68,-36,
16135,164,2022/4/15 12:10,39,62,-23,
16136,164,2022/4/15 12:20,32,84,-52,
16137,164,2022/4/15 12:30,34,66,-32,
16138,164,2022/4/15 12:40,30,65,-35,
16139,164,2022/4/15 12:50,30,81,-51,
16140,164,2022/4/15 13:00,32,71,-39,
16141,164,2022/4/15 13:10,31,88,-57,
16142,164,2022/4/15 13:20,34,59,-25,
16143,164,2022/4/15 13:30,31,76,-45,
16144,164,2022/4/15 13:40,27,73,-46,
16145,164,2022/4/15 13:50,32,77,-45,
16146,164,2022/4/15 14:00,25,72,-47,
16147,164,2022/4/15 14:10,35,71,-36,
16148,164,2022/4/15 14:20,32,77,-45,
16149,164,2022/4/15 14:30,41,68,-27,
16150,164,2022/4/15 14:40,44,78,-34,
16151,164,2022/4/15 14:50,44,69,-25,
16152,164,2022/4/15 15:00,44,64,-20,
16153,164,2022/4/15 15:10,42,77,-35,
16154,164,2022/4/15 15:20,44,65,-21,
16155,164,2022/4/15 15:30,60,82,-22,
16156,164,2022/4/15 15:40,43,70,-27,
16157,164,2022/4/15 15:50,42,97,-55,
16158,164,2022/4/15 16:00,43,75,-32,
16159,164,2022/4/15 16:10,43,77,-34,
16160,164,2022/4/15 16:20,52,101,-49,
16161,164,2022/4/15 16:30,72,92,-20,
16162,164,2022/4/15 16:40,73,91,-18,
16163,164,2022/4/15 16:50,67,97,-30,
16164,164,2022/4/15 17:00,77,108,-31,
16165,164,2022/4/15 17:10,132,111,21,
16166,164,2022/4/15 17:20,90,114,-24,
16167,164,2022/4/15 17:30,74,123,-49,
16168,164,2022/4/15 17:40,102,136,-34,
16169,164,2022/4/15 17:50,85,129,-44,
16170,164,2022/4/15 18:00,59,214,-155,
16171,164,2022/4/15 18:10,127,184,-57,
16172,164,2022/4/15 18:20,89,227,-138,
16173,164,2022/4/15 18:30,66,180,-114,
16174,164,2022/4/15 18:40,45,215,-170,
16175,164,2022/4/15 18:50,33,153,-120,
16176,164,2022/4/15 19:00,33,133,-100,
16177,164,2022/4/15 19:10,32,121,-89,
16178,164,2022/4/15 19:20,25,126,-101,
16179,164,2022/4/15 19:30,26,114,-88,
16180,164,2022/4/15 19:40,24,114,-90,
16181,164,2022/4/15 19:50,23,95,-72,
16182,164,2022/4/15 20:00,23,95,-72,
16183,164,2022/4/15 20:10,21,93,-72,
16184,164,2022/4/15 20:20,20,77,-57,
16185,164,2022/4/15 20:30,19,78,-59,
16186,164,2022/4/15 20:40,20,95,-75,
16187,164,2022/4/15 20:50,22,79,-57,
16188,164,2022/4/15 21:00,18,92,-74,
16189,164,2022/4/15 21:10,21,88,-67,
16190,164,2022/4/15 21:20,20,66,-46,
16191,164,2022/4/15 21:30,15,83,-68,
16192,164,2022/4/15 21:40,13,99,-86,
16193,164,2022/4/15 21:50,12,73,-61,
16194,164,2022/4/15 22:00,10,81,-71,
16195,164,2022/4/15 22:10,13,73,-60,
16196,164,2022/4/15 22:20,9,69,-60,
16197,164,2022/4/15 22:30,2,70,-68,
16198,164,2022/4/15 22:40,0,66,-66,
16199,164,2022/4/15 22:50,0,35,-35,
16200,161,2022/4/15 5:00,0,1,-1,
16201,161,2022/4/15 5:10,8,1,7,
16202,161,2022/4/15 5:20,14,1,13,
16203,161,2022/4/15 5:30,18,5,13,
16204,161,2022/4/15 5:40,20,1,19,
16205,161,2022/4/15 5:50,28,1,27,
16206,161,2022/4/15 6:00,31,1,30,
16207,161,2022/4/15 6:10,34,1,33,
16208,161,2022/4/15 6:20,45,69,-24,
16209,161,2022/4/15 6:30,68,20,48,
16210,161,2022/4/15 6:40,75,110,-35,
16211,161,2022/4/15 6:50,140,125,15,
16212,161,2022/4/15 7:00,199,124,75,
16213,161,2022/4/15 7:10,205,179,26,
16214,161,2022/4/15 7:20,278,152,126,
16215,161,2022/4/15 7:30,360,208,152,
16216,161,2022/4/15 7:40,389,222,167,
16217,161,2022/4/15 7:50,642,269,373,
16218,161,2022/4/15 8:00,704,253,451,
16219,161,2022/4/15 8:10,613,313,300,
16220,161,2022/4/15 8:20,661,316,345,
16221,161,2022/4/15 8:30,599,253,346,
16222,161,2022/4/15 8:40,565,418,147,
16223,161,2022/4/15 8:50,357,321,36,
16224,161,2022/4/15 9:00,278,181,97,
16225,161,2022/4/15 9:10,214,122,92,
16226,161,2022/4/15 9:20,212,150,62,
16227,161,2022/4/15 9:30,140,105,35,
16228,161,2022/4/15 9:40,86,104,-18,
16229,161,2022/4/15 9:50,76,108,-32,
16230,161,2022/4/15 10:00,67,98,-31,
16231,161,2022/4/15 10:10,59,90,-31,
16232,161,2022/4/15 10:20,50,93,-43,
16233,161,2022/4/15 10:30,43,77,-34,
16234,161,2022/4/15 10:40,44,93,-49,
16235,161,2022/4/15 10:50,44,70,-26,
16236,161,2022/4/15 11:00,37,65,-28,
16237,161,2022/4/15 11:10,41,76,-35,
16238,161,2022/4/15 11:20,38,83,-45,
16239,161,2022/4/15 11:30,43,78,-35,
16240,161,2022/4/15 11:40,42,69,-27,
16241,161,2022/4/15 11:50,38,94,-56,
16242,161,2022/4/15 12:00,45,72,-27,
16243,161,2022/4/15 12:10,49,83,-34,
16244,161,2022/4/15 12:20,54,96,-42,
16245,161,2022/4/15 12:30,54,75,-21,
16246,161,2022/4/15 12:40,49,105,-56,
16247,161,2022/4/15 12:50,45,78,-33,
16248,161,2022/4/15 13:00,44,108,-64,
16249,161,2022/4/15 13:10,45,97,-52,
16250,161,2022/4/15 13:20,43,81,-38,
16251,161,2022/4/15 13:30,43,93,-50,
16252,161,2022/4/15 13:40,37,78,-41,
16253,161,2022/4/15 13:50,40,105,-65,
16254,161,2022/4/15 14:00,42,75,-33,
16255,161,2022/4/15 14:10,40,103,-63,
16256,161,2022/4/15 14:20,42,81,-39,
16257,161,2022/4/15 14:30,45,73,-28,
16258,161,2022/4/15 14:40,47,102,-55,
16259,161,2022/4/15 14:50,43,82,-39,
16260,161,2022/4/15 15:00,47,93,-46,
16261,161,2022/4/15 15:10,45,94,-49,
16262,161,2022/4/15 15:20,45,87,-42,
16263,161,2022/4/15 15:30,49,98,-49,
16264,161,2022/4/15 15:40,66,104,-38,
16265,161,2022/4/15 15:50,69,93,-24,
16266,161,2022/4/15 16:00,70,110,-40,
16267,161,2022/4/15 16:10,75,122,-47,
16268,161,2022/4/15 16:20,74,93,-19,
16269,161,2022/4/15 16:30,136,112,24,
16270,161,2022/4/15 16:40,140,112,28,
16271,161,2022/4/15 16:50,135,105,30,
16272,161,2022/4/15 17:00,199,127,72,
16273,161,2022/4/15 17:10,230,143,87,
16274,161,2022/4/15 17:20,164,145,19,
16275,161,2022/4/15 17:30,204,232,-28,
16276,161,2022/4/15 17:40,217,207,10,
16277,161,2022/4/15 17:50,138,333,-195,
16278,161,2022/4/15 18:00,211,333,-122,
16279,161,2022/4/15 18:10,271,318,-47,
16280,161,2022/4/15 18:20,217,380,-163,
16281,161,2022/4/15 18:30,175,323,-148,
16282,161,2022/4/15 18:40,110,323,-213,
16283,161,2022/4/15 18:50,58,319,-261,
16284,161,2022/4/15 19:00,43,256,-213,
16285,161,2022/4/15 19:10,48,179,-131,
16286,161,2022/4/15 19:20,36,192,-156,
16287,161,2022/4/15 19:30,35,151,-116,
16288,161,2022/4/15 19:40,27,119,-92,
16289,161,2022/4/15 19:50,33,124,-91,
16290,161,2022/4/15 20:00,33,114,-81,
16291,161,2022/4/15 20:10,33,124,-91,
16292,161,2022/4/15 20:20,29,121,-92,
16293,161,2022/4/15 20:30,38,105,-67,
16294,161,2022/4/15 20:40,35,88,-53,
16295,161,2022/4/15 20:50,28,113,-85,
16296,161,2022/4/15 21:00,30,121,-91,
16297,161,2022/4/15 21:10,29,105,-76,
16298,161,2022/4/15 21:20,27,122,-95,
16299,161,2022/4/15 21:30,26,125,-99,
16300,161,2022/4/15 21:40,22,114,-92,
16301,161,2022/4/15 21:50,19,107,-88,
16302,161,2022/4/15 22:00,25,125,-100,
16303,161,2022/4/15 22:10,20,106,-86,
16304,161,2022/4/15 22:20,12,77,-65,
16305,161,2022/4/15 22:30,2,115,-113,
16306,161,2022/4/15 22:40,1,88,-87,
16307,161,2022/4/15 22:50,0,66,-66,
16308,152,2022/4/15 5:00,0,1,-1,
16309,152,2022/4/15 5:10,1,1,0,
16310,152,2022/4/15 5:20,4,1,3,
16311,152,2022/4/15 5:30,2,1,1,
16312,152,2022/4/15 5:40,5,1,4,
16313,152,2022/4/15 5:50,8,1,7,
16314,152,2022/4/15 6:00,9,2,7,
16315,152,2022/4/15 6:10,21,1,20,
16316,152,2022/4/15 6:20,20,38,-18,
16317,152,2022/4/15 6:30,23,6,17,
16318,152,2022/4/15 6:40,24,67,-43,
16319,152,2022/4/15 6:50,34,69,-35,
16320,152,2022/4/15 7:00,36,69,-33,
16321,152,2022/4/15 7:10,38,76,-38,
16322,152,2022/4/15 7:20,52,71,-19,
16323,152,2022/4/15 7:30,55,93,-38,
16324,152,2022/4/15 7:40,76,90,-14,
16325,152,2022/4/15 7:50,95,120,-25,
16326,152,2022/4/15 8:00,151,119,32,
16327,152,2022/4/15 8:10,156,144,12,
16328,152,2022/4/15 8:20,149,282,-133,
16329,152,2022/4/15 8:30,103,317,-214,
16330,152,2022/4/15 8:40,80,490,-410,
16331,152,2022/4/15 8:50,65,334,-269,
16332,152,2022/4/15 9:00,49,191,-142,
16333,152,2022/4/15 9:10,48,180,-132,
16334,152,2022/4/15 9:20,35,115,-80,
16335,152,2022/4/15 9:30,35,104,-69,
16336,152,2022/4/15 9:40,29,108,-79,
16337,152,2022/4/15 9:50,34,105,-71,
16338,152,2022/4/15 10:00,26,97,-71,
16339,152,2022/4/15 10:10,27,80,-53,
16340,152,2022/4/15 10:20,27,71,-44,
16341,152,2022/4/15 10:30,27,72,-45,
16342,152,2022/4/15 10:40,24,69,-45,
16343,152,2022/4/15 10:50,28,65,-37,
16344,152,2022/4/15 11:00,28,75,-47,
16345,152,2022/4/15 11:10,29,52,-23,
16346,152,2022/4/15 11:20,28,76,-48,
16347,152,2022/4/15 11:30,27,59,-32,
16348,152,2022/4/15 11:40,30,65,-35,
16349,152,2022/4/15 11:50,30,71,-41,
16350,152,2022/4/15 12:00,28,57,-29,
16351,152,2022/4/15 12:10,31,77,-46,
16352,152,2022/4/15 12:20,32,62,-30,
16353,152,2022/4/15 12:30,25,81,-56,
16354,152,2022/4/15 12:40,35,68,-33,
16355,152,2022/4/15 12:50,29,69,-40,
16356,152,2022/4/15 13:00,26,75,-49,
16357,152,2022/4/15 13:10,29,71,-42,
16358,152,2022/4/15 13:20,35,77,-42,
16359,152,2022/4/15 13:30,32,68,-36,
16360,152,2022/4/15 13:40,25,93,-68,
16361,152,2022/4/15 13:50,26,60,-34,
16362,152,2022/4/15 14:00,26,62,-36,
16363,152,2022/4/15 14:10,25,77,-52,
16364,152,2022/4/15 14:20,24,71,-47,
16365,152,2022/4/15 14:30,28,75,-47,
16366,152,2022/4/15 14:40,31,64,-33,
16367,152,2022/4/15 14:50,28,76,-48,
16368,152,2022/4/15 15:00,29,62,-33,
16369,152,2022/4/15 15:10,35,69,-34,
16370,152,2022/4/15 15:20,27,84,-57,
16371,152,2022/4/15 15:30,29,69,-40,
16372,152,2022/4/15 15:40,37,80,-43,
16373,152,2022/4/15 15:50,33,64,-31,
16374,152,2022/4/15 16:00,37,91,-54,
16375,152,2022/4/15 16:10,47,64,-17,
16376,152,2022/4/15 16:20,38,72,-34,
16377,152,2022/4/15 16:30,44,77,-33,
16378,152,2022/4/15 16:40,45,81,-36,
16379,152,2022/4/15 16:50,44,87,-43,
16380,152,2022/4/15 17:00,64,87,-23,
16381,152,2022/4/15 17:10,215,93,122,
16382,152,2022/4/15 17:20,130,93,37,
16383,152,2022/4/15 17:30,140,108,32,
16384,152,2022/4/15 17:40,233,103,130,
16385,152,2022/4/15 17:50,198,106,92,
16386,152,2022/4/15 18:00,177,125,52,
16387,152,2022/4/15 18:10,552,100,452,
16388,152,2022/4/15 18:20,270,107,163,
16389,152,2022/4/15 18:30,213,111,102,
16390,152,2022/4/15 18:40,187,126,61,
16391,152,2022/4/15 18:50,94,122,-28,
16392,152,2022/4/15 19:00,61,105,-44,
16393,152,2022/4/15 19:10,54,112,-58,
16394,152,2022/4/15 19:20,41,92,-51,
16395,152,2022/4/15 19:30,38,92,-54,
16396,152,2022/4/15 19:40,33,71,-38,
16397,152,2022/4/15 19:50,30,69,-39,
16398,152,2022/4/15 20:00,29,74,-45,
16399,152,2022/4/15 20:10,39,62,-23,
16400,152,2022/4/15 20:20,31,63,-32,
16401,152,2022/4/15 20:30,29,72,-43,
16402,152,2022/4/15 20:40,29,46,-17,
16403,152,2022/4/15 20:50,26,67,-41,
16404,152,2022/4/15 21:00,29,65,-36,
16405,152,2022/4/15 21:10,40,52,-12,
16406,152,2022/4/15 21:20,28,75,-47,
16407,152,2022/4/15 21:30,28,55,-27,
16408,152,2022/4/15 21:40,28,55,-27,
16409,152,2022/4/15 21:50,19,62,-43,
16410,152,2022/4/15 22:00,29,49,-20,
16411,152,2022/4/15 22:10,28,52,-24,
16412,152,2022/4/15 22:20,12,47,-35,
16413,152,2022/4/15 22:30,6,38,-32,
16414,152,2022/4/15 22:40,2,41,-39,
16415,152,2022/4/15 22:50,0,38,-38,
16416,170,2022/4/15 5:00,0,1,-1,
16417,170,2022/4/15 5:10,0,1,-1,
16418,170,2022/4/15 5:20,4,1,3,
16419,170,2022/4/15 5:30,5,2,3,
16420,170,2022/4/15 5:40,6,1,5,
16421,170,2022/4/15 5:50,7,2,5,
16422,170,2022/4/15 6:00,9,5,4,
16423,170,2022/4/15 6:10,15,2,13,
16424,170,2022/4/15 6:20,20,58,-38,
16425,170,2022/4/15 6:30,25,48,-23,
16426,170,2022/4/15 6:40,29,66,-37,
16427,170,2022/4/15 6:50,30,79,-49,
16428,170,2022/4/15 7:00,39,90,-51,
16429,170,2022/4/15 7:10,32,112,-80,
16430,170,2022/4/15 7:20,37,119,-82,
16431,170,2022/4/15 7:30,39,109,-70,
16432,170,2022/4/15 7:40,47,170,-123,
16433,170,2022/4/15 7:50,53,197,-144,
16434,170,2022/4/15 8:00,60,297,-237,
16435,170,2022/4/15 8:10,55,316,-261,
16436,170,2022/4/15 8:20,54,318,-264,
16437,170,2022/4/15 8:30,54,504,-450,
16438,170,2022/4/15 8:40,50,481,-431,
16439,170,2022/4/15 8:50,42,426,-384,
16440,170,2022/4/15 9:00,37,327,-290,
16441,170,2022/4/15 9:10,35,218,-183,
16442,170,2022/4/15 9:20,29,214,-185,
16443,170,2022/4/15 9:30,32,105,-73,
16444,170,2022/4/15 9:40,30,152,-122,
16445,170,2022/4/15 9:50,30,124,-94,
16446,170,2022/4/15 10:00,26,105,-79,
16447,170,2022/4/15 10:10,27,104,-77,
16448,170,2022/4/15 10:20,27,106,-79,
16449,170,2022/4/15 10:30,26,91,-65,
16450,170,2022/4/15 10:40,28,69,-41,
16451,170,2022/4/15 10:50,28,93,-65,
16452,170,2022/4/15 11:00,28,68,-40,
16453,170,2022/4/15 11:10,28,71,-43,
16454,170,2022/4/15 11:20,30,87,-57,
16455,170,2022/4/15 11:30,29,67,-38,
16456,170,2022/4/15 11:40,35,81,-46,
16457,170,2022/4/15 11:50,33,73,-40,
16458,170,2022/4/15 12:00,27,72,-45,
16459,170,2022/4/15 12:10,40,83,-43,
16460,170,2022/4/15 12:20,36,77,-41,
16461,170,2022/4/15 12:30,34,100,-66,
16462,170,2022/4/15 12:40,33,92,-59,
16463,170,2022/4/15 12:50,33,93,-60,
16464,170,2022/4/15 13:00,31,73,-42,
16465,170,2022/4/15 13:10,29,94,-65,
16466,170,2022/4/15 13:20,27,87,-60,
16467,170,2022/4/15 13:30,31,80,-49,
16468,170,2022/4/15 13:40,29,82,-53,
16469,170,2022/4/15 13:50,30,75,-45,
16470,170,2022/4/15 14:00,30,76,-46,
16471,170,2022/4/15 14:10,31,74,-43,
16472,170,2022/4/15 14:20,39,91,-52,
16473,170,2022/4/15 14:30,31,76,-45,
16474,170,2022/4/15 14:40,33,70,-37,
16475,170,2022/4/15 14:50,34,83,-49,
16476,170,2022/4/15 15:00,46,65,-19,
16477,170,2022/4/15 15:10,52,79,-27,
16478,170,2022/4/15 15:20,44,70,-26,
16479,170,2022/4/15 15:30,38,81,-43,
16480,170,2022/4/15 15:40,42,73,-31,
16481,170,2022/4/15 15:50,46,69,-23,
16482,170,2022/4/15 16:00,44,80,-36,
16483,170,2022/4/15 16:10,45,69,-24,
16484,170,2022/4/15 16:20,47,92,-45,
16485,170,2022/4/15 16:30,47,60,-13,
16486,170,2022/4/15 16:40,57,83,-26,
16487,170,2022/4/15 16:50,64,69,-5,
16488,170,2022/4/15 17:00,114,93,21,
16489,170,2022/4/15 17:10,188,105,83,
16490,170,2022/4/15 17:20,168,103,65,
16491,170,2022/4/15 17:30,214,105,109,
16492,170,2022/4/15 17:40,428,105,323,
16493,170,2022/4/15 17:50,223,106,117,
16494,170,2022/4/15 18:00,234,111,123,
16495,170,2022/4/15 18:10,361,112,249,
16496,170,2022/4/15 18:20,274,120,154,
16497,170,2022/4/15 18:30,205,110,95,
16498,170,2022/4/15 18:40,162,107,55,
16499,170,2022/4/15 18:50,87,104,-17,
16500,170,2022/4/15 19:00,59,82,-23,
16501,170,2022/4/15 19:10,58,76,-18,
16502,170,2022/4/15 19:20,47,72,-25,
16503,170,2022/4/15 19:30,41,70,-29,
16504,170,2022/4/15 19:40,43,64,-21,
16505,170,2022/4/15 19:50,36,67,-31,
16506,170,2022/4/15 20:00,31,58,-27,
16507,170,2022/4/15 20:10,35,62,-27,
16508,170,2022/4/15 20:20,33,62,-29,
16509,170,2022/4/15 20:30,29,51,-22,
16510,170,2022/4/15 20:40,27,60,-33,
16511,170,2022/4/15 20:50,27,63,-36,
16512,170,2022/4/15 21:00,28,40,-12,
16513,170,2022/4/15 21:10,37,62,-25,
16514,170,2022/4/15 21:20,30,52,-22,
16515,170,2022/4/15 21:30,31,51,-20,
16516,170,2022/4/15 21:40,30,63,-33,
16517,170,2022/4/15 21:50,25,51,-26,
16518,170,2022/4/15 22:00,23,43,-20,
16519,170,2022/4/15 22:10,22,50,-28,
16520,170,2022/4/15 22:20,22,46,-24,
16521,170,2022/4/15 22:30,14,36,-22,
16522,170,2022/4/15 22:40,3,71,-68,
16523,170,2022/4/15 22:50,1,38,-37,
16524,157,2022/4/15 5:00,0,1,-1,
16525,157,2022/4/15 5:10,2,1,1,
16526,157,2022/4/15 5:20,10,1,9,
16527,157,2022/4/15 5:30,5,5,0,
16528,157,2022/4/15 5:40,10,1,9,
16529,157,2022/4/15 5:50,13,5,8,
16530,157,2022/4/15 6:00,20,2,18,
16531,157,2022/4/15 6:10,25,5,20,
16532,157,2022/4/15 6:20,35,59,-24,
16533,157,2022/4/15 6:30,47,61,-14,
16534,157,2022/4/15 6:40,62,75,-13,
16535,157,2022/4/15 6:50,61,90,-29,
16536,157,2022/4/15 7:00,80,111,-31,
16537,157,2022/4/15 7:10,129,107,22,
16538,157,2022/4/15 7:20,152,130,22,
16539,157,2022/4/15 7:30,175,178,-3,
16540,157,2022/4/15 7:40,226,298,-72,
16541,157,2022/4/15 7:50,266,381,-115,
16542,157,2022/4/15 8:00,276,429,-153,
16543,157,2022/4/15 8:10,330,580,-250,
16544,157,2022/4/15 8:20,279,577,-298,
16545,157,2022/4/15 8:30,275,1558,-1283,
16546,157,2022/4/15 8:40,240,1983,-1743,
16547,157,2022/4/15 8:50,206,1588,-1382,
16548,157,2022/4/15 9:00,178,489,-311,
16549,157,2022/4/15 9:10,162,492,-330,
16550,157,2022/4/15 9:20,91,332,-241,
16551,157,2022/4/15 9:30,72,231,-159,
16552,157,2022/4/15 9:40,58,177,-119,
16553,157,2022/4/15 9:50,50,138,-88,
16554,157,2022/4/15 10:00,46,104,-58,
16555,157,2022/4/15 10:10,44,127,-83,
16556,157,2022/4/15 10:20,42,87,-45,
16557,157,2022/4/15 10:30,44,106,-62,
16558,157,2022/4/15 10:40,41,105,-64,
16559,157,2022/4/15 10:50,36,101,-65,
16560,157,2022/4/15 11:00,40,108,-68,
16561,157,2022/4/15 11:10,41,90,-49,
16562,157,2022/4/15 11:20,35,93,-58,
16563,157,2022/4/15 11:30,35,108,-73,
16564,157,2022/4/15 11:40,44,96,-52,
16565,157,2022/4/15 11:50,46,109,-63,
16566,157,2022/4/15 12:00,45,113,-68,
16567,157,2022/4/15 12:10,65,94,-29,
16568,157,2022/4/15 12:20,58,112,-54,
16569,157,2022/4/15 12:30,54,99,-45,
16570,157,2022/4/15 12:40,53,109,-56,
16571,157,2022/4/15 12:50,50,106,-56,
16572,157,2022/4/15 13:00,47,100,-53,
16573,157,2022/4/15 13:10,63,109,-46,
16574,157,2022/4/15 13:20,60,111,-51,
16575,157,2022/4/15 13:30,44,112,-68,
16576,157,2022/4/15 13:40,43,92,-49,
16577,157,2022/4/15 13:50,45,105,-60,
16578,157,2022/4/15 14:00,45,100,-55,
16579,157,2022/4/15 14:10,56,93,-37,
16580,157,2022/4/15 14:20,53,111,-58,
16581,157,2022/4/15 14:30,46,90,-44,
16582,157,2022/4/15 14:40,47,106,-59,
16583,157,2022/4/15 14:50,60,93,-33,
16584,157,2022/4/15 15:00,68,104,-36,
16585,157,2022/4/15 15:10,98,93,5,
16586,157,2022/4/15 15:20,73,102,-29,
16587,157,2022/4/15 15:30,59,109,-50,
16588,157,2022/4/15 15:40,63,100,-37,
16589,157,2022/4/15 15:50,68,103,-35,
16590,157,2022/4/15 16:00,77,108,-31,
16591,157,2022/4/15 16:10,109,100,9,
16592,157,2022/4/15 16:20,97,100,-3,
16593,157,2022/4/15 16:30,132,97,35,
16594,157,2022/4/15 16:40,205,112,93,
16595,157,2022/4/15 16:50,222,124,98,
16596,157,2022/4/15 17:00,269,121,148,
16597,157,2022/4/15 17:10,610,100,510,
16598,157,2022/4/15 17:20,428,122,306,
16599,157,2022/4/15 17:30,462,144,318,
16600,157,2022/4/15 17:40,1039,149,890,
16601,157,2022/4/15 17:50,715,159,556,
16602,157,2022/4/15 18:00,658,192,466,
16603,157,2022/4/15 18:10,1200,198,1002,
16604,157,2022/4/15 18:20,1030,178,852,
16605,157,2022/4/15 18:30,608,178,430,
16606,157,2022/4/15 18:40,349,184,165,
16607,157,2022/4/15 18:50,305,184,121,
16608,157,2022/4/15 19:00,222,128,94,
16609,157,2022/4/15 19:10,185,110,75,
16610,157,2022/4/15 19:20,151,105,46,
16611,157,2022/4/15 19:30,111,112,-1,
16612,157,2022/4/15 19:40,76,114,-38,
16613,157,2022/4/15 19:50,65,95,-30,
16614,157,2022/4/15 20:00,64,95,-31,
16615,157,2022/4/15 20:10,68,97,-29,
16616,157,2022/4/15 20:20,64,88,-24,
16617,157,2022/4/15 20:30,45,90,-45,
16618,157,2022/4/15 20:40,61,95,-34,
16619,157,2022/4/15 20:50,46,99,-53,
16620,157,2022/4/15 21:00,47,92,-45,
16621,157,2022/4/15 21:10,67,95,-28,
16622,157,2022/4/15 21:20,43,95,-52,
16623,157,2022/4/15 21:30,41,93,-52,
16624,157,2022/4/15 21:40,35,92,-57,
16625,157,2022/4/15 21:50,36,75,-39,
16626,157,2022/4/15 22:00,27,72,-45,
16627,157,2022/4/15 22:10,33,92,-59,
16628,157,2022/4/15 22:20,27,75,-48,
16629,157,2022/4/15 22:30,17,70,-53,
16630,157,2022/4/15 22:40,10,71,-61,
16631,157,2022/4/15 22:50,3,48,-45,
16632,169,2022/4/15 5:00,0,1,-1,
16633,169,2022/4/15 5:10,1,1,0,
16634,169,2022/4/15 5:20,8,1,7,
16635,169,2022/4/15 5:30,10,5,5,
16636,169,2022/4/15 5:40,13,6,7,
16637,169,2022/4/15 5:50,14,2,12,
16638,169,2022/4/15 6:00,26,16,10,
16639,169,2022/4/15 6:10,32,22,10,
16640,169,2022/4/15 6:20,45,69,-24,
16641,169,2022/4/15 6:30,55,105,-50,
16642,169,2022/4/15 6:40,65,110,-45,
16643,169,2022/4/15 6:50,84,109,-25,
16644,169,2022/4/15 7:00,164,107,57,
16645,169,2022/4/15 7:10,208,108,100,
16646,169,2022/4/15 7:20,217,220,-3,
16647,169,2022/4/15 7:30,227,254,-27,
16648,169,2022/4/15 7:40,281,504,-223,
16649,169,2022/4/15 7:50,325,438,-113,
16650,169,2022/4/15 8:00,475,1164,-689,
16651,169,2022/4/15 8:10,597,1924,-1327,
16652,169,2022/4/15 8:20,574,2038,-1464,
16653,169,2022/4/15 8:30,392,2233,-1841,
16654,169,2022/4/15 8:40,345,3834,-3489,
16655,169,2022/4/15 8:50,282,1898,-1616,
16656,169,2022/4/15 9:00,239,1993,-1754,
16657,169,2022/4/15 9:10,220,1571,-1351,
16658,169,2022/4/15 9:20,206,586,-380,
16659,169,2022/4/15 9:30,172,415,-243,
16660,169,2022/4/15 9:40,140,493,-353,
16661,169,2022/4/15 9:50,122,348,-226,
16662,169,2022/4/15 10:00,82,256,-174,
16663,169,2022/4/15 10:10,94,180,-86,
16664,169,2022/4/15 10:20,82,180,-98,
16665,169,2022/4/15 10:30,89,128,-39,
16666,169,2022/4/15 10:40,74,105,-31,
16667,169,2022/4/15 10:50,73,121,-48,
16668,169,2022/4/15 11:00,71,129,-58,
16669,169,2022/4/15 11:10,67,122,-55,
16670,169,2022/4/15 11:20,72,122,-50,
16671,169,2022/4/15 11:30,84,107,-23,
16672,169,2022/4/15 11:40,83,100,-17,
16673,169,2022/4/15 11:50,93,117,-24,
16674,169,2022/4/15 12:00,102,118,-16,
16675,169,2022/4/15 12:10,156,125,31,
16676,169,2022/4/15 12:20,142,113,29,
16677,169,2022/4/15 12:30,137,121,16,
16678,169,2022/4/15 12:40,113,131,-18,
16679,169,2022/4/15 12:50,96,108,-12,
16680,169,2022/4/15 13:00,131,121,10,
16681,169,2022/4/15 13:10,132,108,24,
16682,169,2022/4/15 13:20,174,108,66,
16683,169,2022/4/15 13:30,128,125,3,
16684,169,2022/4/15 13:40,113,108,5,
16685,169,2022/4/15 13:50,94,119,-25,
16686,169,2022/4/15 14:00,110,109,1,
16687,169,2022/4/15 14:10,139,110,29,
16688,169,2022/4/15 14:20,149,102,47,
16689,169,2022/4/15 14:30,133,113,20,
16690,169,2022/4/15 14:40,140,121,19,
16691,169,2022/4/15 14:50,156,116,40,
16692,169,2022/4/15 15:00,170,118,52,
16693,169,2022/4/15 15:10,216,124,92,
16694,169,2022/4/15 15:20,179,116,63,
16695,169,2022/4/15 15:30,195,116,79,
16696,169,2022/4/15 15:40,198,112,86,
16697,169,2022/4/15 15:50,204,118,86,
16698,169,2022/4/15 16:00,216,103,113,
16699,169,2022/4/15 16:10,263,109,154,
16700,169,2022/4/15 16:20,223,110,113,
16701,169,2022/4/15 16:30,270,125,145,
16702,169,2022/4/15 16:40,336,122,214,
16703,169,2022/4/15 16:50,343,139,204,
16704,169,2022/4/15 17:00,692,108,584,
16705,169,2022/4/15 17:10,1033,149,884,
16706,169,2022/4/15 17:20,790,190,600,
16707,169,2022/4/15 17:30,787,217,570,
16708,169,2022/4/15 17:40,1626,233,1393,
16709,169,2022/4/15 17:50,1588,268,1320,
16710,169,2022/4/15 18:00,1202,301,901,
16711,169,2022/4/15 18:10,1997,328,1669,
16712,169,2022/4/15 18:20,1998,299,1699,
16713,169,2022/4/15 18:30,1155,329,826,
16714,169,2022/4/15 18:40,710,327,383,
16715,169,2022/4/15 18:50,608,286,322,
16716,169,2022/4/15 19:00,375,180,195,
16717,169,2022/4/15 19:10,336,145,191,
16718,169,2022/4/15 19:20,271,116,155,
16719,169,2022/4/15 19:30,244,111,133,
16720,169,2022/4/15 19:40,217,89,128,
16721,169,2022/4/15 19:50,199,115,84,
16722,169,2022/4/15 20:00,187,99,88,
16723,169,2022/4/15 20:10,203,104,99,
16724,169,2022/4/15 20:20,205,102,103,
16725,169,2022/4/15 20:30,190,107,83,
16726,169,2022/4/15 20:40,161,108,53,
16727,169,2022/4/15 20:50,157,116,41,
16728,169,2022/4/15 21:00,175,108,67,
16729,169,2022/4/15 21:10,207,112,95,
16730,169,2022/4/15 21:20,110,110,0,
16731,169,2022/4/15 21:30,127,104,23,
16732,169,2022/4/15 21:40,65,110,-45,
16733,169,2022/4/15 21:50,61,110,-49,
16734,169,2022/4/15 22:00,44,92,-48,
16735,169,2022/4/15 22:10,46,105,-59,
16736,169,2022/4/15 22:20,33,92,-59,
16737,169,2022/4/15 22:30,31,78,-47,
16738,169,2022/4/15 22:40,22,61,-39,
16739,169,2022/4/15 22:50,4,47,-43,
16740,176,2022/4/15 5:00,0,1,-1,
16741,176,2022/4/15 5:10,1,1,0,
16742,176,2022/4/15 5:20,2,1,1,
16743,176,2022/4/15 5:30,8,1,7,
16744,176,2022/4/15 5:40,11,8,3,
16745,176,2022/4/15 5:50,16,6,10,
16746,176,2022/4/15 6:00,29,11,18,
16747,176,2022/4/15 6:10,40,59,-19,
16748,176,2022/4/15 6:20,32,41,-9,
16749,176,2022/4/15 6:30,50,108,-58,
16750,176,2022/4/15 6:40,85,102,-17,
16751,176,2022/4/15 6:50,150,124,26,
16752,176,2022/4/15 7:00,181,105,76,
16753,176,2022/4/15 7:10,231,181,50,
16754,176,2022/4/15 7:20,254,226,28,
16755,176,2022/4/15 7:30,275,196,79,
16756,176,2022/4/15 7:40,340,320,20,
16757,176,2022/4/15 7:50,469,341,128,
16758,176,2022/4/15 8:00,594,404,190,
16759,176,2022/4/15 8:10,720,557,163,
16760,176,2022/4/15 8:20,589,565,24,
16761,176,2022/4/15 8:30,573,1080,-507,
16762,176,2022/4/15 8:40,346,1784,-1438,
16763,176,2022/4/15 8:50,282,1479,-1197,
16764,176,2022/4/15 9:00,239,1129,-890,
16765,176,2022/4/15 9:10,208,590,-382,
16766,176,2022/4/15 9:20,187,593,-406,
16767,176,2022/4/15 9:30,169,427,-258,
16768,176,2022/4/15 9:40,95,427,-332,
16769,176,2022/4/15 9:50,80,377,-297,
16770,176,2022/4/15 10:00,76,256,-180,
16771,176,2022/4/15 10:10,64,227,-163,
16772,176,2022/4/15 10:20,63,185,-122,
16773,176,2022/4/15 10:30,67,181,-114,
16774,176,2022/4/15 10:40,58,117,-59,
16775,176,2022/4/15 10:50,59,146,-87,
16776,176,2022/4/15 11:00,55,127,-72,
16777,176,2022/4/15 11:10,58,144,-86,
16778,176,2022/4/15 11:20,63,144,-81,
16779,176,2022/4/15 11:30,65,119,-54,
16780,176,2022/4/15 11:40,73,170,-97,
16781,176,2022/4/15 11:50,74,109,-35,
16782,176,2022/4/15 12:00,83,128,-45,
16783,176,2022/4/15 12:10,129,119,10,
16784,176,2022/4/15 12:20,109,110,-1,
16785,176,2022/4/15 12:30,109,181,-72,
16786,176,2022/4/15 12:40,133,111,22,
16787,176,2022/4/15 12:50,132,192,-60,
16788,176,2022/4/15 13:00,147,117,30,
16789,176,2022/4/15 13:10,149,128,21,
16790,176,2022/4/15 13:20,174,170,4,
16791,176,2022/4/15 13:30,174,128,46,
16792,176,2022/4/15 13:40,175,170,5,
16793,176,2022/4/15 13:50,175,109,66,
16794,176,2022/4/15 14:00,149,128,21,
16795,176,2022/4/15 14:10,156,121,35,
16796,176,2022/4/15 14:20,174,110,64,
16797,176,2022/4/15 14:30,174,117,57,
16798,176,2022/4/15 14:40,174,115,59,
16799,176,2022/4/15 14:50,174,129,45,
16800,176,2022/4/15 15:00,207,111,96,
16801,176,2022/4/15 15:10,197,110,87,
16802,176,2022/4/15 15:20,204,134,70,
16803,176,2022/4/15 15:30,208,108,100,
16804,176,2022/4/15 15:40,202,170,32,
16805,176,2022/4/15 15:50,206,119,87,
16806,176,2022/4/15 16:00,224,138,86,
16807,176,2022/4/15 16:10,204,127,77,
16808,176,2022/4/15 16:20,223,181,42,
16809,176,2022/4/15 16:30,268,179,89,
16810,176,2022/4/15 16:40,287,145,142,
16811,176,2022/4/15 16:50,291,234,57,
16812,176,2022/4/15 17:00,575,177,398,
16813,176,2022/4/15 17:10,713,296,417,
16814,176,2022/4/15 17:20,696,316,380,
16815,176,2022/4/15 17:30,704,374,330,
16816,176,2022/4/15 17:40,1158,491,667,
16817,176,2022/4/15 17:50,805,427,378,
16818,176,2022/4/15 18:00,836,420,416,
16819,176,2022/4/15 18:10,1352,421,931,
16820,176,2022/4/15 18:20,1154,431,723,
16821,176,2022/4/15 18:30,793,433,360,
16822,176,2022/4/15 18:40,670,502,168,
16823,176,2022/4/15 18:50,575,521,54,
16824,176,2022/4/15 19:00,542,329,213,
16825,176,2022/4/15 19:10,422,220,202,
16826,176,2022/4/15 19:20,346,179,167,
16827,176,2022/4/15 19:30,302,126,176,
16828,176,2022/4/15 19:40,310,111,199,
16829,176,2022/4/15 19:50,300,110,190,
16830,176,2022/4/15 20:00,336,108,228,
16831,176,2022/4/15 20:10,345,104,241,
16832,176,2022/4/15 20:20,335,88,247,
16833,176,2022/4/15 20:30,344,107,237,
16834,176,2022/4/15 20:40,336,108,228,
16835,176,2022/4/15 20:50,328,104,224,
16836,176,2022/4/15 21:00,318,105,213,
16837,176,2022/4/15 21:10,428,111,317,
16838,176,2022/4/15 21:20,353,97,256,
16839,176,2022/4/15 21:30,338,114,224,
16840,176,2022/4/15 21:40,305,100,205,
16841,176,2022/4/15 21:50,314,92,222,
16842,176,2022/4/15 22:00,432,80,352,
16843,176,2022/4/15 22:10,205,93,112,
16844,176,2022/4/15 22:20,52,79,-27,
16845,176,2022/4/15 22:30,28,87,-59,
16846,176,2022/4/15 22:40,24,67,-43,
16847,176,2022/4/15 22:50,8,70,-62,
16848,160,2022/4/15 5:00,0,1,-1,
16849,160,2022/4/15 5:10,0,1,-1,
16850,160,2022/4/15 5:20,6,1,5,
16851,160,2022/4/15 5:30,19,1,18,
16852,160,2022/4/15 5:40,20,6,14,
16853,160,2022/4/15 5:50,20,5,15,
16854,160,2022/4/15 6:00,32,5,27,
16855,160,2022/4/15 6:10,36,33,3,
16856,160,2022/4/15 6:20,54,38,16,
16857,160,2022/4/15 6:30,62,38,24,
16858,160,2022/4/15 6:40,126,73,53,
16859,160,2022/4/15 6:50,149,69,80,
16860,160,2022/4/15 7:00,229,77,152,
16861,160,2022/4/15 7:10,255,69,186,
16862,160,2022/4/15 7:20,332,84,248,
16863,160,2022/4/15 7:30,327,95,232,
16864,160,2022/4/15 7:40,678,108,570,
16865,160,2022/4/15 7:50,664,108,556,
16866,160,2022/4/15 8:00,864,126,738,
16867,160,2022/4/15 8:10,824,109,715,
16868,160,2022/4/15 8:20,826,128,698,
16869,160,2022/4/15 8:30,628,150,478,
16870,160,2022/4/15 8:40,597,226,371,
16871,160,2022/4/15 8:50,328,171,157,
16872,160,2022/4/15 9:00,275,130,145,
16873,160,2022/4/15 9:10,236,129,107,
16874,160,2022/4/15 9:20,190,122,68,
16875,160,2022/4/15 9:30,92,106,-14,
16876,160,2022/4/15 9:40,71,110,-39,
16877,160,2022/4/15 9:50,50,105,-55,
16878,160,2022/4/15 10:00,49,92,-43,
16879,160,2022/4/15 10:10,43,90,-47,
16880,160,2022/4/15 10:20,38,84,-46,
16881,160,2022/4/15 10:30,35,76,-41,
16882,160,2022/4/15 10:40,35,92,-57,
16883,160,2022/4/15 10:50,29,75,-46,
16884,160,2022/4/15 11:00,31,86,-55,
16885,160,2022/4/15 11:10,29,85,-56,
16886,160,2022/4/15 11:20,31,75,-44,
16887,160,2022/4/15 11:30,33,84,-51,
16888,160,2022/4/15 11:40,34,83,-49,
16889,160,2022/4/15 11:50,34,75,-41,
16890,160,2022/4/15 12:00,37,91,-54,
16891,160,2022/4/15 12:10,37,83,-46,
16892,160,2022/4/15 12:20,43,90,-47,
16893,160,2022/4/15 12:30,40,77,-37,
16894,160,2022/4/15 12:40,42,93,-51,
16895,160,2022/4/15 12:50,40,99,-59,
16896,160,2022/4/15 13:00,43,96,-53,
16897,160,2022/4/15 13:10,43,87,-44,
16898,160,2022/4/15 13:20,43,77,-34,
16899,160,2022/4/15 13:30,39,76,-37,
16900,160,2022/4/15 13:40,40,76,-36,
16901,160,2022/4/15 13:50,34,81,-47,
16902,160,2022/4/15 14:00,36,90,-54,
16903,160,2022/4/15 14:10,37,92,-55,
16904,160,2022/4/15 14:20,38,98,-60,
16905,160,2022/4/15 14:30,36,78,-42,
16906,160,2022/4/15 14:40,39,87,-48,
16907,160,2022/4/15 14:50,33,87,-54,
16908,160,2022/4/15 15:00,35,107,-72,
16909,160,2022/4/15 15:10,37,96,-59,
16910,160,2022/4/15 15:20,37,102,-65,
16911,160,2022/4/15 15:30,39,103,-64,
16912,160,2022/4/15 15:40,37,93,-56,
16913,160,2022/4/15 15:50,31,106,-75,
16914,160,2022/4/15 16:00,45,102,-57,
16915,160,2022/4/15 16:10,45,104,-59,
16916,160,2022/4/15 16:20,43,105,-62,
16917,160,2022/4/15 16:30,47,87,-40,
16918,160,2022/4/15 16:40,72,118,-46,
16919,160,2022/4/15 16:50,73,115,-42,
16920,160,2022/4/15 17:00,175,112,63,
16921,160,2022/4/15 17:10,163,151,12,
16922,160,2022/4/15 17:20,102,168,-66,
16923,160,2022/4/15 17:30,131,225,-94,
16924,160,2022/4/15 17:40,183,269,-86,
16925,160,2022/4/15 17:50,73,298,-225,
16926,160,2022/4/15 18:00,92,334,-242,
16927,160,2022/4/15 18:10,129,323,-194,
16928,160,2022/4/15 18:20,97,333,-236,
16929,160,2022/4/15 18:30,73,319,-246,
16930,160,2022/4/15 18:40,67,334,-267,
16931,160,2022/4/15 18:50,45,299,-254,
16932,160,2022/4/15 19:00,45,223,-178,
16933,160,2022/4/15 19:10,40,147,-107,
16934,160,2022/4/15 19:20,37,109,-72,
16935,160,2022/4/15 19:30,34,105,-71,
16936,160,2022/4/15 19:40,27,124,-97,
16937,160,2022/4/15 19:50,27,104,-77,
16938,160,2022/4/15 20:00,33,104,-71,
16939,160,2022/4/15 20:10,32,114,-82,
16940,160,2022/4/15 20:20,30,107,-77,
16941,160,2022/4/15 20:30,35,103,-68,
16942,160,2022/4/15 20:40,37,114,-77,
16943,160,2022/4/15 20:50,32,101,-69,
16944,160,2022/4/15 21:00,32,112,-80,
16945,160,2022/4/15 21:10,42,108,-66,
16946,160,2022/4/15 21:20,34,102,-68,
16947,160,2022/4/15 21:30,34,102,-68,
16948,160,2022/4/15 21:40,35,106,-71,
16949,160,2022/4/15 21:50,29,94,-65,
16950,160,2022/4/15 22:00,31,95,-64,
16951,160,2022/4/15 22:10,40,93,-53,
16952,160,2022/4/15 22:20,26,94,-68,
16953,160,2022/4/15 22:30,16,94,-78,
16954,160,2022/4/15 22:40,17,96,-79,
16955,160,2022/4/15 22:50,10,73,-63,
16956,151,2022/4/15 5:00,0,1,-1,
16957,151,2022/4/15 5:10,1,1,0,
16958,151,2022/4/15 5:20,13,1,12,
16959,151,2022/4/15 5:30,25,1,24,
16960,151,2022/4/15 5:40,20,16,4,
16961,151,2022/4/15 5:50,40,12,28,
16962,151,2022/4/15 6:00,53,11,42,
16963,151,2022/4/15 6:10,58,60,-2,
16964,151,2022/4/15 6:20,93,48,45,
16965,151,2022/4/15 6:30,162,72,90,
16966,151,2022/4/15 6:40,225,109,116,
16967,151,2022/4/15 6:50,266,108,158,
16968,151,2022/4/15 7:00,318,106,212,
16969,151,2022/4/15 7:10,365,107,258,
16970,151,2022/4/15 7:20,393,144,249,
16971,151,2022/4/15 7:30,597,192,405,
16972,151,2022/4/15 7:40,693,284,409,
16973,151,2022/4/15 7:50,827,331,496,
16974,151,2022/4/15 8:00,1041,413,628,
16975,151,2022/4/15 8:10,1213,572,641,
16976,151,2022/4/15 8:20,1049,1102,-53,
16977,151,2022/4/15 8:30,862,1115,-253,
16978,151,2022/4/15 8:40,666,1543,-877,
16979,151,2022/4/15 8:50,588,558,30,
16980,151,2022/4/15 9:00,359,501,-142,
16981,151,2022/4/15 9:10,339,532,-193,
16982,151,2022/4/15 9:20,269,330,-61,
16983,151,2022/4/15 9:30,230,195,35,
16984,151,2022/4/15 9:40,212,254,-42,
16985,151,2022/4/15 9:50,170,190,-20,
16986,151,2022/4/15 10:00,162,144,18,
16987,151,2022/4/15 10:10,114,111,3,
16988,151,2022/4/15 10:20,101,110,-9,
16989,151,2022/4/15 10:30,77,127,-50,
16990,151,2022/4/15 10:40,76,123,-47,
16991,151,2022/4/15 10:50,80,123,-43,
16992,151,2022/4/15 11:00,73,104,-31,
16993,151,2022/4/15 11:10,72,119,-47,
16994,151,2022/4/15 11:20,74,125,-51,
16995,151,2022/4/15 11:30,76,116,-40,
16996,151,2022/4/15 11:40,80,108,-28,
16997,151,2022/4/15 11:50,76,123,-47,
16998,151,2022/4/15 12:00,90,120,-30,
16999,151,2022/4/15 12:10,113,117,-4,
17000,151,2022/4/15 12:20,129,115,14,
17001,151,2022/4/15 12:30,110,122,-12,
17002,151,2022/4/15 12:40,104,110,-6,
17003,151,2022/4/15 12:50,92,124,-32,
17004,151,2022/4/15 13:00,112,125,-13,
17005,151,2022/4/15 13:10,140,120,20,
17006,151,2022/4/15 13:20,128,111,17,
17007,151,2022/4/15 13:30,96,123,-27,
17008,151,2022/4/15 13:40,93,104,-11,
17009,151,2022/4/15 13:50,84,105,-21,
17010,151,2022/4/15 14:00,113,123,-10,
17011,151,2022/4/15 14:10,102,121,-19,
17012,151,2022/4/15 14:20,82,111,-29,
17013,151,2022/4/15 14:30,77,109,-32,
17014,151,2022/4/15 14:40,92,122,-30,
17015,151,2022/4/15 14:50,82,110,-28,
17016,151,2022/4/15 15:00,130,104,26,
17017,151,2022/4/15 15:10,118,118,0,
17018,151,2022/4/15 15:20,126,108,18,
17019,151,2022/4/15 15:30,138,125,13,
17020,151,2022/4/15 15:40,137,133,4,
17021,151,2022/4/15 15:50,174,117,57,
17022,151,2022/4/15 16:00,176,128,48,
17023,151,2022/4/15 16:10,199,125,74,
17024,151,2022/4/15 16:20,201,119,82,
17025,151,2022/4/15 16:30,229,153,76,
17026,151,2022/4/15 16:40,262,181,81,
17027,151,2022/4/15 16:50,330,159,171,
17028,151,2022/4/15 17:00,576,176,400,
17029,151,2022/4/15 17:10,697,214,483,
17030,151,2022/4/15 17:20,569,322,247,
17031,151,2022/4/15 17:30,614,377,237,
17032,151,2022/4/15 17:40,658,431,227,
17033,151,2022/4/15 17:50,618,500,118,
17034,151,2022/4/15 18:00,608,501,107,
17035,151,2022/4/15 18:10,671,431,240,
17036,151,2022/4/15 18:20,579,503,76,
17037,151,2022/4/15 18:30,338,502,-164,
17038,151,2022/4/15 18:40,294,502,-208,
17039,151,2022/4/15 18:50,274,434,-160,
17040,151,2022/4/15 19:00,237,336,-99,
17041,151,2022/4/15 19:10,195,209,-14,
17042,151,2022/4/15 19:20,180,191,-11,
17043,151,2022/4/15 19:30,138,137,1,
17044,151,2022/4/15 19:40,114,107,7,
17045,151,2022/4/15 19:50,78,111,-33,
17046,151,2022/4/15 20:00,74,122,-48,
17047,151,2022/4/15 20:10,79,124,-45,
17048,151,2022/4/15 20:20,74,119,-45,
17049,151,2022/4/15 20:30,72,107,-35,
17050,151,2022/4/15 20:40,64,123,-59,
17051,151,2022/4/15 20:50,74,110,-36,
17052,151,2022/4/15 21:00,85,129,-44,
17053,151,2022/4/15 21:10,115,122,-7,
17054,151,2022/4/15 21:20,71,123,-52,
17055,151,2022/4/15 21:30,74,123,-49,
17056,151,2022/4/15 21:40,56,101,-45,
17057,151,2022/4/15 21:50,42,103,-61,
17058,151,2022/4/15 22:00,41,109,-68,
17059,151,2022/4/15 22:10,37,110,-73,
17060,151,2022/4/15 22:20,24,105,-81,
17061,151,2022/4/15 22:30,22,99,-77,
17062,151,2022/4/15 22:40,16,77,-61,
17063,151,2022/4/15 22:50,11,76,-65,
17064,175,2022/4/15 5:00,0,1,-1,
17065,175,2022/4/15 5:10,0,1,-1,
17066,175,2022/4/15 5:20,0,1,-1,
17067,175,2022/4/15 5:30,20,1,19,
17068,175,2022/4/15 5:40,25,6,19,
17069,175,2022/4/15 5:50,31,6,25,
17070,175,2022/4/15 6:00,43,11,32,
17071,175,2022/4/15 6:10,57,40,17,
17072,175,2022/4/15 6:20,71,45,26,
17073,175,2022/4/15 6:30,147,55,92,
17074,175,2022/4/15 6:40,213,74,139,
17075,175,2022/4/15 6:50,243,67,176,
17076,175,2022/4/15 7:00,278,67,211,
17077,175,2022/4/15 7:10,337,76,261,
17078,175,2022/4/15 7:20,574,90,484,
17079,175,2022/4/15 7:30,723,88,635,
17080,175,2022/4/15 7:40,818,104,714,
17081,175,2022/4/15 7:50,1059,107,952,
17082,175,2022/4/15 8:00,1207,224,983,
17083,175,2022/4/15 8:10,1361,326,1035,
17084,175,2022/4/15 8:20,1213,375,838,
17085,175,2022/4/15 8:30,1053,533,520,
17086,175,2022/4/15 8:40,677,507,170,
17087,175,2022/4/15 8:50,590,318,272,
17088,175,2022/4/15 9:00,560,197,363,
17089,175,2022/4/15 9:10,326,159,167,
17090,175,2022/4/15 9:20,280,121,159,
17091,175,2022/4/15 9:30,219,122,97,
17092,175,2022/4/15 9:40,177,123,54,
17093,175,2022/4/15 9:50,145,88,57,
17094,175,2022/4/15 10:00,94,109,-15,
17095,175,2022/4/15 10:10,76,105,-29,
17096,175,2022/4/15 10:20,69,109,-40,
17097,175,2022/4/15 10:30,69,106,-37,
17098,175,2022/4/15 10:40,49,100,-51,
17099,175,2022/4/15 10:50,43,101,-58,
17100,175,2022/4/15 11:00,45,108,-63,
17101,175,2022/4/15 11:10,50,96,-46,
17102,175,2022/4/15 11:20,58,105,-47,
17103,175,2022/4/15 11:30,59,101,-42,
17104,175,2022/4/15 11:40,62,111,-49,
17105,175,2022/4/15 11:50,63,105,-42,
17106,175,2022/4/15 12:00,74,105,-31,
17107,175,2022/4/15 12:10,74,103,-29,
17108,175,2022/4/15 12:20,85,111,-26,
17109,175,2022/4/15 12:30,74,105,-31,
17110,175,2022/4/15 12:40,73,111,-38,
17111,175,2022/4/15 12:50,70,108,-38,
17112,175,2022/4/15 13:00,81,108,-27,
17113,175,2022/4/15 13:10,75,106,-31,
17114,175,2022/4/15 13:20,69,105,-36,
17115,175,2022/4/15 13:30,74,111,-37,
17116,175,2022/4/15 13:40,60,108,-48,
17117,175,2022/4/15 13:50,62,105,-43,
17118,175,2022/4/15 14:00,53,108,-55,
17119,175,2022/4/15 14:10,51,107,-56,
17120,175,2022/4/15 14:20,50,104,-54,
17121,175,2022/4/15 14:30,57,106,-49,
17122,175,2022/4/15 14:40,47,106,-59,
17123,175,2022/4/15 14:50,43,106,-63,
17124,175,2022/4/15 15:00,67,108,-41,
17125,175,2022/4/15 15:10,71,122,-51,
17126,175,2022/4/15 15:20,64,102,-38,
17127,175,2022/4/15 15:30,66,127,-61,
17128,175,2022/4/15 15:40,76,109,-33,
17129,175,2022/4/15 15:50,69,124,-55,
17130,175,2022/4/15 16:00,76,110,-34,
17131,175,2022/4/15 16:10,92,123,-31,
17132,175,2022/4/15 16:20,83,105,-22,
17133,175,2022/4/15 16:30,133,110,23,
17134,175,2022/4/15 16:40,174,110,64,
17135,175,2022/4/15 16:50,148,159,-11,
17136,175,2022/4/15 17:00,258,189,69,
17137,175,2022/4/15 17:10,344,210,134,
17138,175,2022/4/15 17:20,244,295,-51,
17139,175,2022/4/15 17:30,268,322,-54,
17140,175,2022/4/15 17:40,568,531,37,
17141,175,2022/4/15 17:50,310,434,-124,
17142,175,2022/4/15 18:00,269,418,-149,
17143,175,2022/4/15 18:10,349,420,-71,
17144,175,2022/4/15 18:20,263,440,-177,
17145,175,2022/4/15 18:30,220,420,-200,
17146,175,2022/4/15 18:40,191,436,-245,
17147,175,2022/4/15 18:50,155,534,-379,
17148,175,2022/4/15 19:00,129,349,-220,
17149,175,2022/4/15 19:10,131,322,-191,
17150,175,2022/4/15 19:20,77,198,-121,
17151,175,2022/4/15 19:30,65,184,-119,
17152,175,2022/4/15 19:40,60,143,-83,
17153,175,2022/4/15 19:50,54,111,-57,
17154,175,2022/4/15 20:00,53,110,-57,
17155,175,2022/4/15 20:10,58,110,-52,
17156,175,2022/4/15 20:20,46,121,-75,
17157,175,2022/4/15 20:30,47,113,-66,
17158,175,2022/4/15 20:40,43,114,-71,
17159,175,2022/4/15 20:50,46,103,-57,
17160,175,2022/4/15 21:00,44,125,-81,
17161,175,2022/4/15 21:10,42,126,-84,
17162,175,2022/4/15 21:20,38,110,-72,
17163,175,2022/4/15 21:30,34,122,-88,
17164,175,2022/4/15 21:40,30,122,-92,
17165,175,2022/4/15 21:50,27,109,-82,
17166,175,2022/4/15 22:00,29,122,-93,
17167,175,2022/4/15 22:10,26,102,-76,
17168,175,2022/4/15 22:20,24,120,-96,
17169,175,2022/4/15 22:30,20,108,-88,
17170,175,2022/4/15 22:40,13,93,-80,
17171,175,2022/4/15 22:50,8,87,-79,
17172,177,2022/4/15 5:00,0,1,-1,
17173,177,2022/4/15 5:10,1,1,0,
17174,177,2022/4/15 5:20,4,1,3,
17175,177,2022/4/15 5:30,13,1,12,
17176,177,2022/4/15 5:40,18,8,10,
17177,177,2022/4/15 5:50,25,12,13,
17178,177,2022/4/15 6:00,31,23,8,
17179,177,2022/4/15 6:10,45,31,14,
17180,177,2022/4/15 6:20,61,38,23,
17181,177,2022/4/15 6:30,98,54,44,
17182,177,2022/4/15 6:40,194,61,133,
17183,177,2022/4/15 6:50,234,62,172,
17184,177,2022/4/15 7:00,278,93,185,
17185,177,2022/4/15 7:10,340,105,235,
17186,177,2022/4/15 7:20,600,108,492,
17187,177,2022/4/15 7:30,698,108,590,
17188,177,2022/4/15 7:40,1059,126,933,
17189,177,2022/4/15 7:50,1219,110,1109,
17190,177,2022/4/15 8:00,1365,112,1253,
17191,177,2022/4/15 8:10,1573,128,1445,
17192,177,2022/4/15 8:20,1361,184,1177,
17193,177,2022/4/15 8:30,1177,256,921,
17194,177,2022/4/15 8:40,815,327,488,
17195,177,2022/4/15 8:50,720,208,512,
17196,177,2022/4/15 9:00,583,185,398,
17197,177,2022/4/15 9:10,317,144,173,
17198,177,2022/4/15 9:20,277,121,156,
17199,177,2022/4/15 9:30,239,126,113,
17200,177,2022/4/15 9:40,186,122,64,
17201,177,2022/4/15 9:50,156,109,47,
17202,177,2022/4/15 10:00,95,111,-16,
17203,177,2022/4/15 10:10,76,105,-29,
17204,177,2022/4/15 10:20,69,93,-24,
17205,177,2022/4/15 10:30,52,93,-41,
17206,177,2022/4/15 10:40,48,80,-32,
17207,177,2022/4/15 10:50,47,84,-37,
17208,177,2022/4/15 11:00,47,101,-54,
17209,177,2022/4/15 11:10,48,91,-43,
17210,177,2022/4/15 11:20,45,87,-42,
17211,177,2022/4/15 11:30,45,75,-30,
17212,177,2022/4/15 11:40,45,93,-48,
17213,177,2022/4/15 11:50,45,87,-42,
17214,177,2022/4/15 12:00,48,96,-48,
17215,177,2022/4/15 12:10,55,88,-33,
17216,177,2022/4/15 12:20,70,93,-23,
17217,177,2022/4/15 12:30,46,96,-50,
17218,177,2022/4/15 12:40,55,91,-36,
17219,177,2022/4/15 12:50,56,104,-48,
17220,177,2022/4/15 13:00,57,91,-34,
17221,177,2022/4/15 13:10,58,106,-48,
17222,177,2022/4/15 13:20,48,104,-56,
17223,177,2022/4/15 13:30,43,99,-56,
17224,177,2022/4/15 13:40,46,99,-53,
17225,177,2022/4/15 13:50,45,93,-48,
17226,177,2022/4/15 14:00,45,105,-60,
17227,177,2022/4/15 14:10,44,97,-53,
17228,177,2022/4/15 14:20,44,102,-58,
17229,177,2022/4/15 14:30,44,114,-70,
17230,177,2022/4/15 14:40,52,108,-56,
17231,177,2022/4/15 14:50,54,105,-51,
17232,177,2022/4/15 15:00,45,108,-63,
17233,177,2022/4/15 15:10,50,87,-37,
17234,177,2022/4/15 15:20,47,102,-55,
17235,177,2022/4/15 15:30,58,122,-64,
17236,177,2022/4/15 15:40,46,125,-79,
17237,177,2022/4/15 15:50,47,122,-75,
17238,177,2022/4/15 16:00,49,123,-74,
17239,177,2022/4/15 16:10,76,106,-30,
17240,177,2022/4/15 16:20,67,125,-58,
17241,177,2022/4/15 16:30,70,110,-40,
17242,177,2022/4/15 16:40,97,154,-57,
17243,177,2022/4/15 16:50,74,110,-36,
17244,177,2022/4/15 17:00,181,229,-48,
17245,177,2022/4/15 17:10,244,220,24,
17246,177,2022/4/15 17:20,220,316,-96,
17247,177,2022/4/15 17:30,216,376,-160,
17248,177,2022/4/15 17:40,268,534,-266,
17249,177,2022/4/15 17:50,237,499,-262,
17250,177,2022/4/15 18:00,197,430,-233,
17251,177,2022/4/15 18:10,234,434,-200,
17252,177,2022/4/15 18:20,179,432,-253,
17253,177,2022/4/15 18:30,157,435,-278,
17254,177,2022/4/15 18:40,176,428,-252,
17255,177,2022/4/15 18:50,131,429,-298,
17256,177,2022/4/15 19:00,72,380,-308,
17257,177,2022/4/15 19:10,68,326,-258,
17258,177,2022/4/15 19:20,46,232,-186,
17259,177,2022/4/15 19:30,44,178,-134,
17260,177,2022/4/15 19:40,41,184,-143,
17261,177,2022/4/15 19:50,39,115,-76,
17262,177,2022/4/15 20:00,39,116,-77,
17263,177,2022/4/15 20:10,39,111,-72,
17264,177,2022/4/15 20:20,38,121,-83,
17265,177,2022/4/15 20:30,32,111,-79,
17266,177,2022/4/15 20:40,35,124,-89,
17267,177,2022/4/15 20:50,39,119,-80,
17268,177,2022/4/15 21:00,38,104,-66,
17269,177,2022/4/15 21:10,33,113,-80,
17270,177,2022/4/15 21:20,35,134,-99,
17271,177,2022/4/15 21:30,32,124,-92,
17272,177,2022/4/15 21:40,33,116,-83,
17273,177,2022/4/15 21:50,24,123,-99,
17274,177,2022/4/15 22:00,27,113,-86,
17275,177,2022/4/15 22:10,25,106,-81,
17276,177,2022/4/15 22:20,19,121,-102,
17277,177,2022/4/15 22:30,18,105,-87,
17278,177,2022/4/15 22:40,14,93,-79,
17279,177,2022/4/15 22:50,8,72,-64,
17280,162,2022/4/15 5:00,0,1,-1,
17281,162,2022/4/15 5:10,0,1,-1,
17282,162,2022/4/15 5:20,0,1,-1,
17283,162,2022/4/15 5:30,64,1,63,
17284,162,2022/4/15 5:40,53,37,16,
17285,162,2022/4/15 5:50,32,31,1,
17286,162,2022/4/15 6:00,54,97,-43,
17287,162,2022/4/15 6:10,54,121,-67,
17288,162,2022/4/15 6:20,67,100,-33,
17289,162,2022/4/15 6:30,147,182,-35,
17290,162,2022/4/15 6:40,175,282,-107,
17291,162,2022/4/15 6:50,247,312,-65,
17292,162,2022/4/15 7:00,288,376,-88,
17293,162,2022/4/15 7:10,326,441,-115,
17294,162,2022/4/15 7:20,655,464,191,
17295,162,2022/4/15 7:30,732,582,150,
17296,162,2022/4/15 7:40,1469,1124,345,
17297,162,2022/4/15 7:50,2011,1555,456,
17298,162,2022/4/15 8:00,1968,1822,146,
17299,162,2022/4/15 8:10,1981,2548,-567,
17300,162,2022/4/15 8:20,2006,2185,-179,
17301,162,2022/4/15 8:30,1999,2370,-371,
17302,162,2022/4/15 8:40,1645,2157,-512,
17303,162,2022/4/15 8:50,1220,2487,-1267,
17304,162,2022/4/15 9:00,1145,1651,-506,
17305,162,2022/4/15 9:10,672,1108,-436,
17306,162,2022/4/15 9:20,668,587,81,
17307,162,2022/4/15 9:30,579,404,175,
17308,162,2022/4/15 9:40,587,411,176,
17309,162,2022/4/15 9:50,381,522,-141,
17310,162,2022/4/15 10:00,335,487,-152,
17311,162,2022/4/15 10:10,315,368,-53,
17312,162,2022/4/15 10:20,434,336,98,
17313,162,2022/4/15 10:30,370,325,45,
17314,162,2022/4/15 10:40,343,337,6,
17315,162,2022/4/15 10:50,311,260,51,
17316,162,2022/4/15 11:00,348,324,24,
17317,162,2022/4/15 11:10,264,321,-57,
17318,162,2022/4/15 11:20,267,290,-23,
17319,162,2022/4/15 11:30,267,274,-7,
17320,162,2022/4/15 11:40,343,232,111,
17321,162,2022/4/15 11:50,334,275,59,
17322,162,2022/4/15 12:00,291,268,23,
17323,162,2022/4/15 12:10,327,296,31,
17324,162,2022/4/15 12:20,325,311,14,
17325,162,2022/4/15 12:30,306,307,-1,
17326,162,2022/4/15 12:40,357,469,-112,
17327,162,2022/4/15 12:50,312,292,20,
17328,162,2022/4/15 13:00,261,367,-106,
17329,162,2022/4/15 13:10,307,304,3,
17330,162,2022/4/15 13:20,318,273,45,
17331,162,2022/4/15 13:30,270,313,-43,
17332,162,2022/4/15 13:40,300,304,-4,
17333,162,2022/4/15 13:50,461,274,187,
17334,162,2022/4/15 14:00,290,276,14,
17335,162,2022/4/15 14:10,265,297,-32,
17336,162,2022/4/15 14:20,329,291,38,
17337,162,2022/4/15 14:30,272,300,-28,
17338,162,2022/4/15 14:40,313,289,24,
17339,162,2022/4/15 14:50,333,293,40,
17340,162,2022/4/15 15:00,269,296,-27,
17341,162,2022/4/15 15:10,334,288,46,
17342,162,2022/4/15 15:20,550,359,191,
17343,162,2022/4/15 15:30,368,291,77,
17344,162,2022/4/15 15:40,458,273,185,
17345,162,2022/4/15 15:50,589,468,121,
17346,162,2022/4/15 16:00,546,307,239,
17347,162,2022/4/15 16:10,455,315,140,
17348,162,2022/4/15 16:20,462,463,-1,
17349,162,2022/4/15 16:30,591,469,122,
17350,162,2022/4/15 16:40,656,478,178,
17351,162,2022/4/15 16:50,663,460,203,
17352,162,2022/4/15 17:00,708,479,229,
17353,162,2022/4/15 17:10,1139,480,659,
17354,162,2022/4/15 17:20,1195,570,625,
17355,162,2022/4/15 17:30,1152,1365,-213,
17356,162,2022/4/15 17:40,1364,1368,-4,
17357,162,2022/4/15 17:50,1591,1467,124,
17358,162,2022/4/15 18:00,1360,1847,-487,
17359,162,2022/4/15 18:10,1564,1839,-275,
17360,162,2022/4/15 18:20,1360,1683,-323,
17361,162,2022/4/15 18:30,1560,1806,-246,
17362,162,2022/4/15 18:40,1210,1759,-549,
17363,162,2022/4/15 18:50,1019,931,88,
17364,162,2022/4/15 19:00,638,568,70,
17365,162,2022/4/15 19:10,661,415,246,
17366,162,2022/4/15 19:20,577,474,103,
17367,162,2022/4/15 19:30,573,322,251,
17368,162,2022/4/15 19:40,350,320,30,
17369,162,2022/4/15 19:50,570,242,328,
17370,162,2022/4/15 20:00,267,214,53,
17371,162,2022/4/15 20:10,248,292,-44,
17372,162,2022/4/15 20:20,205,176,29,
17373,162,2022/4/15 20:30,263,198,65,
17374,162,2022/4/15 20:40,254,198,56,
17375,162,2022/4/15 20:50,267,181,86,
17376,162,2022/4/15 21:00,170,186,-16,
17377,162,2022/4/15 21:10,212,234,-22,
17378,162,2022/4/15 21:20,172,208,-36,
17379,162,2022/4/15 21:30,167,155,12,
17380,162,2022/4/15 21:40,145,234,-89,
17381,162,2022/4/15 21:50,167,147,20,
17382,162,2022/4/15 22:00,120,108,12,
17383,162,2022/4/15 22:10,77,146,-69,
17384,162,2022/4/15 22:20,62,149,-87,
17385,162,2022/4/15 22:30,49,119,-70,
17386,162,2022/4/15 22:40,34,98,-64,
17387,162,2022/4/15 22:50,25,72,-47,
17388,149,2022/4/15 5:00,0,1,-1,
17389,149,2022/4/15 5:10,0,1,-1,
17390,149,2022/4/15 5:20,2,1,1,
17391,149,2022/4/15 5:30,7,1,6,
17392,149,2022/4/15 5:40,22,1,21,
17393,149,2022/4/15 5:50,32,23,9,
17394,149,2022/4/15 6:00,27,51,-24,
17395,149,2022/4/15 6:10,34,38,-4,
17396,149,2022/4/15 6:20,37,50,-13,
17397,149,2022/4/15 6:30,48,62,-14,
17398,149,2022/4/15 6:40,59,73,-14,
17399,149,2022/4/15 6:50,86,99,-13,
17400,149,2022/4/15 7:00,92,113,-21,
17401,149,2022/4/15 7:10,124,105,19,
17402,149,2022/4/15 7:20,166,120,46,
17403,149,2022/4/15 7:30,217,197,20,
17404,149,2022/4/15 7:40,242,256,-14,
17405,149,2022/4/15 7:50,276,299,-23,
17406,149,2022/4/15 8:00,277,230,47,
17407,149,2022/4/15 8:10,332,317,15,
17408,149,2022/4/15 8:20,279,297,-18,
17409,149,2022/4/15 8:30,253,334,-81,
17410,149,2022/4/15 8:40,221,346,-125,
17411,149,2022/4/15 8:50,187,298,-111,
17412,149,2022/4/15 9:00,105,198,-93,
17413,149,2022/4/15 9:10,79,128,-49,
17414,149,2022/4/15 9:20,68,127,-59,
17415,149,2022/4/15 9:30,56,109,-53,
17416,149,2022/4/15 9:40,51,114,-63,
17417,149,2022/4/15 9:50,48,108,-60,
17418,149,2022/4/15 10:00,45,106,-61,
17419,149,2022/4/15 10:10,44,117,-73,
17420,149,2022/4/15 10:20,46,105,-59,
17421,149,2022/4/15 10:30,42,104,-62,
17422,149,2022/4/15 10:40,43,103,-60,
17423,149,2022/4/15 10:50,43,105,-62,
17424,149,2022/4/15 11:00,43,110,-67,
17425,149,2022/4/15 11:10,46,99,-53,
17426,149,2022/4/15 11:20,45,105,-60,
17427,149,2022/4/15 11:30,44,98,-54,
17428,149,2022/4/15 11:40,41,101,-60,
17429,149,2022/4/15 11:50,47,92,-45,
17430,149,2022/4/15 12:00,48,100,-52,
17431,149,2022/4/15 12:10,49,99,-50,
17432,149,2022/4/15 12:20,47,105,-58,
17433,149,2022/4/15 12:30,48,112,-64,
17434,149,2022/4/15 12:40,54,101,-47,
17435,149,2022/4/15 12:50,47,106,-59,
17436,149,2022/4/15 13:00,45,110,-65,
17437,149,2022/4/15 13:10,52,108,-56,
17438,149,2022/4/15 13:20,49,105,-56,
17439,149,2022/4/15 13:30,51,104,-53,
17440,149,2022/4/15 13:40,56,88,-32,
17441,149,2022/4/15 13:50,51,99,-48,
17442,149,2022/4/15 14:00,55,110,-55,
17443,149,2022/4/15 14:10,47,101,-54,
17444,149,2022/4/15 14:20,57,106,-49,
17445,149,2022/4/15 14:30,56,104,-48,
17446,149,2022/4/15 14:40,54,112,-58,
17447,149,2022/4/15 14:50,54,112,-58,
17448,149,2022/4/15 15:00,59,96,-37,
17449,149,2022/4/15 15:10,70,111,-41,
17450,149,2022/4/15 15:20,62,99,-37,
17451,149,2022/4/15 15:30,75,110,-35,
17452,149,2022/4/15 15:40,73,105,-32,
17453,149,2022/4/15 15:50,68,97,-29,
17454,149,2022/4/15 16:00,76,102,-26,
17455,149,2022/4/15 16:10,77,112,-35,
17456,149,2022/4/15 16:20,74,103,-29,
17457,149,2022/4/15 16:30,91,112,-21,
17458,149,2022/4/15 16:40,179,108,71,
17459,149,2022/4/15 16:50,197,105,92,
17460,149,2022/4/15 17:00,269,109,160,
17461,149,2022/4/15 17:10,330,102,228,
17462,149,2022/4/15 17:20,269,123,146,
17463,149,2022/4/15 17:30,232,120,112,
17464,149,2022/4/15 17:40,270,108,162,
17465,149,2022/4/15 17:50,272,118,154,
17466,149,2022/4/15 18:00,235,151,84,
17467,149,2022/4/15 18:10,243,182,61,
17468,149,2022/4/15 18:20,215,116,99,
17469,149,2022/4/15 18:30,143,119,24,
17470,149,2022/4/15 18:40,97,128,-31,
17471,149,2022/4/15 18:50,77,125,-48,
17472,149,2022/4/15 19:00,49,100,-51,
17473,149,2022/4/15 19:10,55,107,-52,
17474,149,2022/4/15 19:20,41,100,-59,
17475,149,2022/4/15 19:30,43,101,-58,
17476,149,2022/4/15 19:40,38,91,-53,
17477,149,2022/4/15 19:50,38,89,-51,
17478,149,2022/4/15 20:00,35,78,-43,
17479,149,2022/4/15 20:10,36,74,-38,
17480,149,2022/4/15 20:20,33,72,-39,
17481,149,2022/4/15 20:30,28,78,-50,
17482,149,2022/4/15 20:40,27,87,-60,
17483,149,2022/4/15 20:50,25,77,-52,
17484,149,2022/4/15 21:00,26,76,-50,
17485,149,2022/4/15 21:10,28,79,-51,
17486,149,2022/4/15 21:20,27,79,-52,
17487,149,2022/4/15 21:30,26,79,-53,
17488,149,2022/4/15 21:40,27,75,-48,
17489,149,2022/4/15 21:50,22,75,-53,
17490,149,2022/4/15 22:00,22,70,-48,
17491,149,2022/4/15 22:10,16,73,-57,
17492,149,2022/4/15 22:20,15,53,-38,
17493,149,2022/4/15 22:30,11,71,-60,
17494,149,2022/4/15 22:40,10,62,-52,
17495,149,2022/4/15 22:50,6,40,-34,
17496,155,2022/4/15 5:00,0,1,-1,
17497,155,2022/4/15 5:10,0,1,-1,
17498,155,2022/4/15 5:20,0,1,-1,
17499,155,2022/4/15 5:30,1,1,0,
17500,155,2022/4/15 5:40,9,1,8,
17501,155,2022/4/15 5:50,28,8,20,
17502,155,2022/4/15 6:00,27,15,12,
17503,155,2022/4/15 6:10,27,21,6,
17504,155,2022/4/15 6:20,36,39,-3,
17505,155,2022/4/15 6:30,53,49,4,
17506,155,2022/4/15 6:40,57,86,-29,
17507,155,2022/4/15 6:50,79,89,-10,
17508,155,2022/4/15 7:00,101,108,-7,
17509,155,2022/4/15 7:10,92,123,-31,
17510,155,2022/4/15 7:20,169,129,40,
17511,155,2022/4/15 7:30,180,133,47,
17512,155,2022/4/15 7:40,191,169,22,
17513,155,2022/4/15 7:50,215,144,71,
17514,155,2022/4/15 8:00,238,179,59,
17515,155,2022/4/15 8:10,246,253,-7,
17516,155,2022/4/15 8:20,224,324,-100,
17517,155,2022/4/15 8:30,191,382,-191,
17518,155,2022/4/15 8:40,185,428,-243,
17519,155,2022/4/15 8:50,151,422,-271,
17520,155,2022/4/15 9:00,89,314,-225,
17521,155,2022/4/15 9:10,77,297,-220,
17522,155,2022/4/15 9:20,58,232,-174,
17523,155,2022/4/15 9:30,47,133,-86,
17524,155,2022/4/15 9:40,40,97,-57,
17525,155,2022/4/15 9:50,38,108,-70,
17526,155,2022/4/15 10:00,37,104,-67,
17527,155,2022/4/15 10:10,36,108,-72,
17528,155,2022/4/15 10:20,36,77,-41,
17529,155,2022/4/15 10:30,35,92,-57,
17530,155,2022/4/15 10:40,28,91,-63,
17531,155,2022/4/15 10:50,36,92,-56,
17532,155,2022/4/15 11:00,29,68,-39,
17533,155,2022/4/15 11:10,36,93,-57,
17534,155,2022/4/15 11:20,35,93,-58,
17535,155,2022/4/15 11:30,29,84,-55,
17536,155,2022/4/15 11:40,35,79,-44,
17537,155,2022/4/15 11:50,37,79,-42,
17538,155,2022/4/15 12:00,31,73,-42,
17539,155,2022/4/15 12:10,35,90,-55,
17540,155,2022/4/15 12:20,38,69,-31,
17541,155,2022/4/15 12:30,39,101,-62,
17542,155,2022/4/15 12:40,38,83,-45,
17543,155,2022/4/15 12:50,40,91,-51,
17544,155,2022/4/15 13:00,40,91,-51,
17545,155,2022/4/15 13:10,43,97,-54,
17546,155,2022/4/15 13:20,38,98,-60,
17547,155,2022/4/15 13:30,38,83,-45,
17548,155,2022/4/15 13:40,37,110,-73,
17549,155,2022/4/15 13:50,38,74,-36,
17550,155,2022/4/15 14:00,35,83,-48,
17551,155,2022/4/15 14:10,41,90,-49,
17552,155,2022/4/15 14:20,45,76,-31,
17553,155,2022/4/15 14:30,43,97,-54,
17554,155,2022/4/15 14:40,34,76,-42,
17555,155,2022/4/15 14:50,43,109,-66,
17556,155,2022/4/15 15:00,43,76,-33,
17557,155,2022/4/15 15:10,54,91,-37,
17558,155,2022/4/15 15:20,52,87,-35,
17559,155,2022/4/15 15:30,47,91,-44,
17560,155,2022/4/15 15:40,47,97,-50,
17561,155,2022/4/15 15:50,57,81,-24,
17562,155,2022/4/15 16:00,59,105,-46,
17563,155,2022/4/15 16:10,94,90,4,
17564,155,2022/4/15 16:20,133,89,44,
17565,155,2022/4/15 16:30,136,103,33,
17566,155,2022/4/15 16:40,194,92,102,
17567,155,2022/4/15 16:50,141,102,39,
17568,155,2022/4/15 17:00,338,97,241,
17569,155,2022/4/15 17:10,286,123,163,
17570,155,2022/4/15 17:20,234,113,121,
17571,155,2022/4/15 17:30,336,110,226,
17572,155,2022/4/15 17:40,576,118,458,
17573,155,2022/4/15 17:50,291,115,176,
17574,155,2022/4/15 18:00,267,111,156,
17575,155,2022/4/15 18:10,378,116,262,
17576,155,2022/4/15 18:20,257,150,107,
17577,155,2022/4/15 18:30,177,133,44,
17578,155,2022/4/15 18:40,138,104,34,
17579,155,2022/4/15 18:50,101,137,-36,
17580,155,2022/4/15 19:00,72,121,-49,
17581,155,2022/4/15 19:10,67,107,-40,
17582,155,2022/4/15 19:20,57,104,-47,
17583,155,2022/4/15 19:30,46,111,-65,
17584,155,2022/4/15 19:40,48,85,-37,
17585,155,2022/4/15 19:50,42,83,-41,
17586,155,2022/4/15 20:00,45,75,-30,
17587,155,2022/4/15 20:10,47,71,-24,
17588,155,2022/4/15 20:20,44,71,-27,
17589,155,2022/4/15 20:30,49,82,-33,
17590,155,2022/4/15 20:40,45,74,-29,
17591,155,2022/4/15 20:50,44,78,-34,
17592,155,2022/4/15 21:00,48,72,-24,
17593,155,2022/4/15 21:10,46,62,-16,
17594,155,2022/4/15 21:20,43,71,-28,
17595,155,2022/4/15 21:30,37,85,-48,
17596,155,2022/4/15 21:40,35,72,-37,
17597,155,2022/4/15 21:50,38,72,-34,
17598,155,2022/4/15 22:00,41,71,-30,
17599,155,2022/4/15 22:10,38,69,-31,
17600,155,2022/4/15 22:20,22,63,-41,
17601,155,2022/4/15 22:30,22,67,-45,
17602,155,2022/4/15 22:40,15,62,-47,
17603,155,2022/4/15 22:50,8,33,-25,
17604,156,2022/4/15 5:00,0,1,-1,
17605,156,2022/4/15 5:10,0,1,-1,
17606,156,2022/4/15 5:20,0,1,-1,
17607,156,2022/4/15 5:30,4,1,3,
17608,156,2022/4/15 5:40,12,1,11,
17609,156,2022/4/15 5:50,19,14,5,
17610,156,2022/4/15 6:00,17,21,-4,
17611,156,2022/4/15 6:10,19,27,-8,
17612,156,2022/4/15 6:20,27,49,-22,
17613,156,2022/4/15 6:30,32,63,-31,
17614,156,2022/4/15 6:40,35,66,-31,
17615,156,2022/4/15 6:50,47,67,-20,
17616,156,2022/4/15 7:00,58,76,-18,
17617,156,2022/4/15 7:10,62,106,-44,
17618,156,2022/4/15 7:20,65,101,-36,
17619,156,2022/4/15 7:30,87,110,-23,
17620,156,2022/4/15 7:40,153,114,39,
17621,156,2022/4/15 7:50,181,120,61,
17622,156,2022/4/15 8:00,186,168,18,
17623,156,2022/4/15 8:10,183,206,-23,
17624,156,2022/4/15 8:20,155,295,-140,
17625,156,2022/4/15 8:30,111,317,-206,
17626,156,2022/4/15 8:40,88,494,-406,
17627,156,2022/4/15 8:50,68,324,-256,
17628,156,2022/4/15 9:00,48,290,-242,
17629,156,2022/4/15 9:10,47,268,-221,
17630,156,2022/4/15 9:20,42,169,-127,
17631,156,2022/4/15 9:30,36,128,-92,
17632,156,2022/4/15 9:40,28,108,-80,
17633,156,2022/4/15 9:50,30,126,-96,
17634,156,2022/4/15 10:00,31,90,-59,
17635,156,2022/4/15 10:10,28,97,-69,
17636,156,2022/4/15 10:20,30,96,-66,
17637,156,2022/4/15 10:30,31,76,-45,
17638,156,2022/4/15 10:40,29,74,-45,
17639,156,2022/4/15 10:50,32,91,-59,
17640,156,2022/4/15 11:00,28,65,-37,
17641,156,2022/4/15 11:10,29,74,-45,
17642,156,2022/4/15 11:20,28,76,-48,
17643,156,2022/4/15 11:30,29,76,-47,
17644,156,2022/4/15 11:40,29,69,-40,
17645,156,2022/4/15 11:50,28,78,-50,
17646,156,2022/4/15 12:00,27,69,-42,
17647,156,2022/4/15 12:10,32,93,-61,
17648,156,2022/4/15 12:20,28,62,-34,
17649,156,2022/4/15 12:30,36,68,-32,
17650,156,2022/4/15 12:40,35,93,-58,
17651,156,2022/4/15 12:50,33,77,-44,
17652,156,2022/4/15 13:00,31,101,-70,
17653,156,2022/4/15 13:10,33,77,-44,
17654,156,2022/4/15 13:20,35,90,-55,
17655,156,2022/4/15 13:30,30,71,-41,
17656,156,2022/4/15 13:40,32,90,-58,
17657,156,2022/4/15 13:50,31,92,-61,
17658,156,2022/4/15 14:00,30,69,-39,
17659,156,2022/4/15 14:10,33,76,-43,
17660,156,2022/4/15 14:20,31,73,-42,
17661,156,2022/4/15 14:30,36,80,-44,
17662,156,2022/4/15 14:40,38,70,-32,
17663,156,2022/4/15 14:50,38,75,-37,
17664,156,2022/4/15 15:00,35,78,-43,
17665,156,2022/4/15 15:10,38,68,-30,
17666,156,2022/4/15 15:20,35,80,-45,
17667,156,2022/4/15 15:30,34,85,-51,
17668,156,2022/4/15 15:40,40,75,-35,
17669,156,2022/4/15 15:50,41,72,-31,
17670,156,2022/4/15 16:00,41,80,-39,
17671,156,2022/4/15 16:10,45,72,-27,
17672,156,2022/4/15 16:20,41,91,-50,
17673,156,2022/4/15 16:30,45,84,-39,
17674,156,2022/4/15 16:40,50,75,-25,
17675,156,2022/4/15 16:50,47,101,-54,
17676,156,2022/4/15 17:00,68,89,-21,
17677,156,2022/4/15 17:10,128,105,23,
17678,156,2022/4/15 17:20,77,104,-27,
17679,156,2022/4/15 17:30,109,100,9,
17680,156,2022/4/15 17:40,149,99,50,
17681,156,2022/4/15 17:50,86,109,-23,
17682,156,2022/4/15 18:00,132,111,21,
17683,156,2022/4/15 18:10,176,111,65,
17684,156,2022/4/15 18:20,136,119,17,
17685,156,2022/4/15 18:30,66,121,-55,
17686,156,2022/4/15 18:40,76,115,-39,
17687,156,2022/4/15 18:50,52,111,-59,
17688,156,2022/4/15 19:00,49,107,-58,
17689,156,2022/4/15 19:10,43,104,-61,
17690,156,2022/4/15 19:20,43,101,-58,
17691,156,2022/4/15 19:30,42,80,-38,
17692,156,2022/4/15 19:40,43,69,-26,
17693,156,2022/4/15 19:50,37,83,-46,
17694,156,2022/4/15 20:00,39,71,-32,
17695,156,2022/4/15 20:10,47,66,-19,
17696,156,2022/4/15 20:20,41,49,-8,
17697,156,2022/4/15 20:30,43,76,-33,
17698,156,2022/4/15 20:40,51,68,-17,
17699,156,2022/4/15 20:50,42,52,-10,
17700,156,2022/4/15 21:00,42,65,-23,
17701,156,2022/4/15 21:10,55,62,-7,
17702,156,2022/4/15 21:20,39,47,-8,
17703,156,2022/4/15 21:30,36,61,-25,
17704,156,2022/4/15 21:40,34,49,-15,
17705,156,2022/4/15 21:50,29,52,-23,
17706,156,2022/4/15 22:00,51,66,-15,
17707,156,2022/4/15 22:10,44,61,-17,
17708,156,2022/4/15 22:20,25,66,-41,
17709,156,2022/4/15 22:30,23,58,-35,
17710,156,2022/4/15 22:40,16,47,-31,
17711,156,2022/4/15 22:50,11,45,-34,
17712,153,2022/4/15 5:00,0,1,-1,
17713,153,2022/4/15 5:10,0,1,-1,
17714,153,2022/4/15 5:20,0,1,-1,
17715,153,2022/4/15 5:30,5,1,4,
17716,153,2022/4/15 5:40,18,1,17,
17717,153,2022/4/15 5:50,24,19,5,
17718,153,2022/4/15 6:00,32,25,7,
17719,153,2022/4/15 6:10,40,23,17,
17720,153,2022/4/15 6:20,43,38,5,
17721,153,2022/4/15 6:30,61,63,-2,
17722,153,2022/4/15 6:40,154,90,64,
17723,153,2022/4/15 6:50,186,127,59,
17724,153,2022/4/15 7:00,217,106,111,
17725,153,2022/4/15 7:10,271,117,154,
17726,153,2022/4/15 7:20,328,121,207,
17727,153,2022/4/15 7:30,351,152,199,
17728,153,2022/4/15 7:40,361,192,169,
17729,153,2022/4/15 7:50,361,213,148,
17730,153,2022/4/15 8:00,277,154,123,
17731,153,2022/4/15 8:10,280,197,83,
17732,153,2022/4/15 8:20,277,197,80,
17733,153,2022/4/15 8:30,239,208,31,
17734,153,2022/4/15 8:40,237,214,23,
17735,153,2022/4/15 8:50,222,150,72,
17736,153,2022/4/15 9:00,187,129,58,
17737,153,2022/4/15 9:10,174,121,53,
17738,153,2022/4/15 9:20,100,107,-7,
17739,153,2022/4/15 9:30,75,104,-29,
17740,153,2022/4/15 9:40,68,104,-36,
17741,153,2022/4/15 9:50,57,112,-55,
17742,153,2022/4/15 10:00,46,76,-30,
17743,153,2022/4/15 10:10,44,98,-54,
17744,153,2022/4/15 10:20,43,87,-44,
17745,153,2022/4/15 10:30,43,75,-32,
17746,153,2022/4/15 10:40,41,81,-40,
17747,153,2022/4/15 10:50,38,92,-54,
17748,153,2022/4/15 11:00,40,61,-21,
17749,153,2022/4/15 11:10,42,87,-45,
17750,153,2022/4/15 11:20,44,77,-33,
17751,153,2022/4/15 11:30,56,76,-20,
17752,153,2022/4/15 11:40,53,93,-40,
17753,153,2022/4/15 11:50,47,62,-15,
17754,153,2022/4/15 12:00,54,101,-47,
17755,153,2022/4/15 12:10,52,70,-18,
17756,153,2022/4/15 12:20,53,100,-47,
17757,153,2022/4/15 12:30,52,74,-22,
17758,153,2022/4/15 12:40,47,97,-50,
17759,153,2022/4/15 12:50,56,105,-49,
17760,153,2022/4/15 13:00,47,80,-33,
17761,153,2022/4/15 13:10,43,100,-57,
17762,153,2022/4/15 13:20,40,78,-38,
17763,153,2022/4/15 13:30,46,103,-57,
17764,153,2022/4/15 13:40,42,84,-42,
17765,153,2022/4/15 13:50,42,102,-60,
17766,153,2022/4/15 14:00,41,90,-49,
17767,153,2022/4/15 14:10,41,75,-34,
17768,153,2022/4/15 14:20,45,102,-57,
17769,153,2022/4/15 14:30,40,94,-54,
17770,153,2022/4/15 14:40,42,104,-62,
17771,153,2022/4/15 14:50,52,90,-38,
17772,153,2022/4/15 15:00,53,108,-55,
17773,153,2022/4/15 15:10,65,104,-39,
17774,153,2022/4/15 15:20,64,92,-28,
17775,153,2022/4/15 15:30,60,123,-63,
17776,153,2022/4/15 15:40,59,108,-49,
17777,153,2022/4/15 15:50,61,110,-49,
17778,153,2022/4/15 16:00,157,98,59,
17779,153,2022/4/15 16:10,273,106,167,
17780,153,2022/4/15 16:20,180,108,72,
17781,153,2022/4/15 16:30,183,122,61,
17782,153,2022/4/15 16:40,196,98,98,
17783,153,2022/4/15 16:50,213,123,90,
17784,153,2022/4/15 17:00,264,138,126,
17785,153,2022/4/15 17:10,315,118,197,
17786,153,2022/4/15 17:20,272,153,119,
17787,153,2022/4/15 17:30,213,212,1,
17788,153,2022/4/15 17:40,270,283,-13,
17789,153,2022/4/15 17:50,244,196,48,
17790,153,2022/4/15 18:00,205,283,-78,
17791,153,2022/4/15 18:10,174,300,-126,
17792,153,2022/4/15 18:20,154,294,-140,
17793,153,2022/4/15 18:30,89,213,-124,
17794,153,2022/4/15 18:40,71,285,-214,
17795,153,2022/4/15 18:50,69,279,-210,
17796,153,2022/4/15 19:00,53,214,-161,
17797,153,2022/4/15 19:10,52,191,-139,
17798,153,2022/4/15 19:20,45,111,-66,
17799,153,2022/4/15 19:30,42,105,-63,
17800,153,2022/4/15 19:40,39,104,-65,
17801,153,2022/4/15 19:50,39,124,-85,
17802,153,2022/4/15 20:00,35,108,-73,
17803,153,2022/4/15 20:10,33,103,-70,
17804,153,2022/4/15 20:20,38,124,-86,
17805,153,2022/4/15 20:30,48,98,-50,
17806,153,2022/4/15 20:40,57,85,-28,
17807,153,2022/4/15 20:50,46,106,-60,
17808,153,2022/4/15 21:00,35,106,-71,
17809,153,2022/4/15 21:10,35,104,-69,
17810,153,2022/4/15 21:20,34,114,-80,
17811,153,2022/4/15 21:30,29,100,-71,
17812,153,2022/4/15 21:40,29,100,-71,
17813,153,2022/4/15 21:50,24,108,-84,
17814,153,2022/4/15 22:00,27,98,-71,
17815,153,2022/4/15 22:10,24,85,-61,
17816,153,2022/4/15 22:20,21,97,-76,
17817,153,2022/4/15 22:30,14,85,-71,
17818,153,2022/4/15 22:40,12,82,-70,
17819,153,2022/4/15 22:50,8,99,-91,
17820,154,2022/4/15 5:00,0,1,-1,
17821,154,2022/4/15 5:10,0,1,-1,
17822,154,2022/4/15 5:20,0,1,-1,
17823,154,2022/4/15 5:30,14,1,13,
17824,154,2022/4/15 5:40,30,1,29,
17825,154,2022/4/15 5:50,31,8,23,
17826,154,2022/4/15 6:00,33,38,-5,
17827,154,2022/4/15 6:10,54,23,31,
17828,154,2022/4/15 6:20,77,33,44,
17829,154,2022/4/15 6:30,150,60,90,
17830,154,2022/4/15 6:40,244,97,147,
17831,154,2022/4/15 6:50,299,100,199,
17832,154,2022/4/15 7:00,367,110,257,
17833,154,2022/4/15 7:10,633,122,511,
17834,154,2022/4/15 7:20,688,111,577,
17835,154,2022/4/15 7:30,689,184,505,
17836,154,2022/4/15 7:40,733,179,554,
17837,154,2022/4/15 7:50,699,292,407,
17838,154,2022/4/15 8:00,702,320,382,
17839,154,2022/4/15 8:10,687,338,349,
17840,154,2022/4/15 8:20,631,474,157,
17841,154,2022/4/15 8:30,475,497,-22,
17842,154,2022/4/15 8:40,393,563,-170,
17843,154,2022/4/15 8:50,327,476,-149,
17844,154,2022/4/15 9:00,271,425,-154,
17845,154,2022/4/15 9:10,231,297,-66,
17846,154,2022/4/15 9:20,177,268,-91,
17847,154,2022/4/15 9:30,149,169,-20,
17848,154,2022/4/15 9:40,100,117,-17,
17849,154,2022/4/15 9:50,78,99,-21,
17850,154,2022/4/15 10:00,76,111,-35,
17851,154,2022/4/15 10:10,56,121,-65,
17852,154,2022/4/15 10:20,59,112,-53,
17853,154,2022/4/15 10:30,43,105,-62,
17854,154,2022/4/15 10:40,45,73,-28,
17855,154,2022/4/15 10:50,48,105,-57,
17856,154,2022/4/15 11:00,50,93,-43,
17857,154,2022/4/15 11:10,45,93,-48,
17858,154,2022/4/15 11:20,58,91,-33,
17859,154,2022/4/15 11:30,55,71,-16,
17860,154,2022/4/15 11:40,55,106,-51,
17861,154,2022/4/15 11:50,58,80,-22,
17862,154,2022/4/15 12:00,70,98,-28,
17863,154,2022/4/15 12:10,76,97,-21,
17864,154,2022/4/15 12:20,67,87,-20,
17865,154,2022/4/15 12:30,67,107,-40,
17866,154,2022/4/15 12:40,63,114,-51,
17867,154,2022/4/15 12:50,58,123,-65,
17868,154,2022/4/15 13:00,54,111,-57,
17869,154,2022/4/15 13:10,65,106,-41,
17870,154,2022/4/15 13:20,54,102,-48,
17871,154,2022/4/15 13:30,53,96,-43,
17872,154,2022/4/15 13:40,46,114,-68,
17873,154,2022/4/15 13:50,45,93,-48,
17874,154,2022/4/15 14:00,49,124,-75,
17875,154,2022/4/15 14:10,54,98,-44,
17876,154,2022/4/15 14:20,47,103,-56,
17877,154,2022/4/15 14:30,51,103,-52,
17878,154,2022/4/15 14:40,65,91,-26,
17879,154,2022/4/15 14:50,69,121,-52,
17880,154,2022/4/15 15:00,128,94,34,
17881,154,2022/4/15 15:10,113,117,-4,
17882,154,2022/4/15 15:20,69,102,-33,
17883,154,2022/4/15 15:30,72,108,-36,
17884,154,2022/4/15 15:40,73,114,-41,
17885,154,2022/4/15 15:50,72,108,-36,
17886,154,2022/4/15 16:00,82,108,-26,
17887,154,2022/4/15 16:10,111,114,-3,
17888,154,2022/4/15 16:20,113,102,11,
17889,154,2022/4/15 16:30,175,123,52,
17890,154,2022/4/15 16:40,206,126,80,
17891,154,2022/4/15 16:50,212,125,87,
17892,154,2022/4/15 17:00,271,189,82,
17893,154,2022/4/15 17:10,429,105,324,
17894,154,2022/4/15 17:20,342,295,47,
17895,154,2022/4/15 17:30,456,266,190,
17896,154,2022/4/15 17:40,569,323,246,
17897,154,2022/4/15 17:50,334,364,-30,
17898,154,2022/4/15 18:00,268,320,-52,
17899,154,2022/4/15 18:10,350,370,-20,
17900,154,2022/4/15 18:20,264,315,-51,
17901,154,2022/4/15 18:30,222,319,-97,
17902,154,2022/4/15 18:40,216,316,-100,
17903,154,2022/4/15 18:50,158,341,-183,
17904,154,2022/4/15 19:00,79,342,-263,
17905,154,2022/4/15 19:10,73,257,-184,
17906,154,2022/4/15 19:20,57,227,-170,
17907,154,2022/4/15 19:30,42,149,-107,
17908,154,2022/4/15 19:40,45,126,-81,
17909,154,2022/4/15 19:50,40,120,-80,
17910,154,2022/4/15 20:00,41,123,-82,
17911,154,2022/4/15 20:10,45,106,-61,
17912,154,2022/4/15 20:20,35,110,-75,
17913,154,2022/4/15 20:30,41,106,-65,
17914,154,2022/4/15 20:40,44,106,-62,
17915,154,2022/4/15 20:50,38,111,-73,
17916,154,2022/4/15 21:00,37,112,-75,
17917,154,2022/4/15 21:10,35,92,-57,
17918,154,2022/4/15 21:20,36,110,-74,
17919,154,2022/4/15 21:30,38,101,-63,
17920,154,2022/4/15 21:40,31,97,-66,
17921,154,2022/4/15 21:50,28,111,-83,
17922,154,2022/4/15 22:00,35,107,-72,
17923,154,2022/4/15 22:10,26,78,-52,
17924,154,2022/4/15 22:20,24,95,-71,
17925,154,2022/4/15 22:30,15,92,-77,
17926,154,2022/4/15 22:40,12,83,-71,
17927,154,2022/4/15 22:50,10,105,-95,
17928,158,2022/4/15 5:00,0,1,-1,
17929,158,2022/4/15 5:10,0,1,-1,
17930,158,2022/4/15 5:20,1,1,0,
17931,158,2022/4/15 5:30,29,1,28,
17932,158,2022/4/15 5:40,45,1,44,
17933,158,2022/4/15 5:50,45,16,29,
17934,158,2022/4/15 6:00,54,47,7,
17935,158,2022/4/15 6:10,85,32,53,
17936,158,2022/4/15 6:20,185,50,135,
17937,158,2022/4/15 6:30,226,66,160,
17938,158,2022/4/15 6:40,324,77,247,
17939,158,2022/4/15 6:50,590,107,483,
17940,158,2022/4/15 7:00,685,110,575,
17941,158,2022/4/15 7:10,860,108,752,
17942,158,2022/4/15 7:20,1223,159,1064,
17943,158,2022/4/15 7:30,1360,111,1249,
17944,158,2022/4/15 7:40,1362,125,1237,
17945,158,2022/4/15 7:50,1206,150,1056,
17946,158,2022/4/15 8:00,1170,180,990,
17947,158,2022/4/15 8:10,1178,116,1062,
17948,158,2022/4/15 8:20,1152,169,983,
17949,158,2022/4/15 8:30,833,153,680,
17950,158,2022/4/15 8:40,717,108,609,
17951,158,2022/4/15 8:50,592,129,463,
17952,158,2022/4/15 9:00,434,108,326,
17953,158,2022/4/15 9:10,324,100,224,
17954,158,2022/4/15 9:20,263,83,180,
17955,158,2022/4/15 9:30,217,103,114,
17956,158,2022/4/15 9:40,157,105,52,
17957,158,2022/4/15 9:50,136,75,61,
17958,158,2022/4/15 10:00,101,120,-19,
17959,158,2022/4/15 10:10,74,89,-15,
17960,158,2022/4/15 10:20,69,106,-37,
17961,158,2022/4/15 10:30,58,87,-29,
17962,158,2022/4/15 10:40,55,94,-39,
17963,158,2022/4/15 10:50,60,96,-36,
17964,158,2022/4/15 11:00,59,92,-33,
17965,158,2022/4/15 11:10,55,67,-12,
17966,158,2022/4/15 11:20,47,107,-60,
17967,158,2022/4/15 11:30,59,99,-40,
17968,158,2022/4/15 11:40,63,92,-29,
17969,158,2022/4/15 11:50,68,112,-44,
17970,158,2022/4/15 12:00,73,77,-4,
17971,158,2022/4/15 12:10,75,108,-33,
17972,158,2022/4/15 12:20,76,98,-22,
17973,158,2022/4/15 12:30,70,112,-42,
17974,158,2022/4/15 12:40,73,100,-27,
17975,158,2022/4/15 12:50,68,114,-46,
17976,158,2022/4/15 13:00,64,106,-42,
17977,158,2022/4/15 13:10,59,109,-50,
17978,158,2022/4/15 13:20,62,123,-61,
17979,158,2022/4/15 13:30,54,93,-39,
17980,158,2022/4/15 13:40,47,109,-62,
17981,158,2022/4/15 13:50,48,107,-59,
17982,158,2022/4/15 14:00,49,105,-56,
17983,158,2022/4/15 14:10,53,120,-67,
17984,158,2022/4/15 14:20,41,96,-55,
17985,158,2022/4/15 14:30,60,111,-51,
17986,158,2022/4/15 14:40,77,102,-25,
17987,158,2022/4/15 14:50,59,102,-43,
17988,158,2022/4/15 15:00,58,124,-66,
17989,158,2022/4/15 15:10,88,100,-12,
17990,158,2022/4/15 15:20,85,109,-24,
17991,158,2022/4/15 15:30,74,100,-26,
17992,158,2022/4/15 15:40,93,142,-49,
17993,158,2022/4/15 15:50,91,121,-30,
17994,158,2022/4/15 16:00,77,133,-56,
17995,158,2022/4/15 16:10,84,118,-34,
17996,158,2022/4/15 16:20,83,144,-61,
17997,158,2022/4/15 16:30,140,109,31,
17998,158,2022/4/15 16:40,167,269,-102,
17999,158,2022/4/15 16:50,135,183,-48,
18000,158,2022/4/15 17:00,204,182,22,
18001,158,2022/4/15 17:10,214,214,0,
18002,158,2022/4/15 17:20,213,489,-276,
18003,158,2022/4/15 17:30,194,376,-182,
18004,158,2022/4/15 17:40,231,423,-192,
18005,158,2022/4/15 17:50,219,484,-265,
18006,158,2022/4/15 18:00,150,417,-267,
18007,158,2022/4/15 18:10,168,425,-257,
18008,158,2022/4/15 18:20,128,414,-286,
18009,158,2022/4/15 18:30,90,581,-491,
18010,158,2022/4/15 18:40,70,417,-347,
18011,158,2022/4/15 18:50,53,400,-347,
18012,158,2022/4/15 19:00,49,577,-528,
18013,158,2022/4/15 19:10,46,489,-443,
18014,158,2022/4/15 19:20,44,319,-275,
18015,158,2022/4/15 19:30,38,314,-276,
18016,158,2022/4/15 19:40,40,219,-179,
18017,158,2022/4/15 19:50,34,190,-156,
18018,158,2022/4/15 20:00,41,178,-137,
18019,158,2022/4/15 20:10,38,112,-74,
18020,158,2022/4/15 20:20,36,117,-81,
18021,158,2022/4/15 20:30,37,137,-100,
18022,158,2022/4/15 20:40,33,109,-76,
18023,158,2022/4/15 20:50,33,107,-74,
18024,158,2022/4/15 21:00,29,192,-163,
18025,158,2022/4/15 21:10,27,114,-87,
18026,158,2022/4/15 21:20,27,115,-88,
18027,158,2022/4/15 21:30,26,150,-124,
18028,158,2022/4/15 21:40,25,120,-95,
18029,158,2022/4/15 21:50,25,124,-99,
18030,158,2022/4/15 22:00,25,109,-84,
18031,158,2022/4/15 22:10,21,108,-87,
18032,158,2022/4/15 22:20,16,109,-93,
18033,158,2022/4/15 22:30,13,103,-90,
18034,158,2022/4/15 22:40,13,106,-93,
18035,158,2022/4/15 22:50,11,106,-95,
18036,171,2022/4/15 5:00,0,1,-1,
18037,171,2022/4/15 5:10,0,1,-1,
18038,171,2022/4/15 5:20,0,1,-1,
18039,171,2022/4/15 5:30,33,1,32,
18040,171,2022/4/15 5:40,32,5,27,
18041,171,2022/4/15 5:50,54,1,53,
18042,171,2022/4/15 6:00,54,6,48,
18043,171,2022/4/15 6:10,73,30,43,
18044,171,2022/4/15 6:20,185,23,162,
18045,171,2022/4/15 6:30,267,65,202,
18046,171,2022/4/15 6:40,348,63,285,
18047,171,2022/4/15 6:50,596,91,505,
18048,171,2022/4/15 7:00,685,109,576,
18049,171,2022/4/15 7:10,863,98,765,
18050,171,2022/4/15 7:20,841,75,766,
18051,171,2022/4/15 7:30,862,79,783,
18052,171,2022/4/15 7:40,1055,93,962,
18053,171,2022/4/15 7:50,1049,79,970,
18054,171,2022/4/15 8:00,869,105,764,
18055,171,2022/4/15 8:10,851,107,744,
18056,171,2022/4/15 8:20,826,108,718,
18057,171,2022/4/15 8:30,740,115,625,
18058,171,2022/4/15 8:40,599,96,503,
18059,171,2022/4/15 8:50,323,110,213,
18060,171,2022/4/15 9:00,340,112,228,
18061,171,2022/4/15 9:10,227,85,142,
18062,171,2022/4/15 9:20,199,97,102,
18063,171,2022/4/15 9:30,143,96,47,
18064,171,2022/4/15 9:40,97,76,21,
18065,171,2022/4/15 9:50,67,81,-14,
18066,171,2022/4/15 10:00,45,90,-45,
18067,171,2022/4/15 10:10,47,68,-21,
18068,171,2022/4/15 10:20,44,72,-28,
18069,171,2022/4/15 10:30,41,77,-36,
18070,171,2022/4/15 10:40,39,77,-38,
18071,171,2022/4/15 10:50,43,72,-29,
18072,171,2022/4/15 11:00,40,72,-32,
18073,171,2022/4/15 11:10,43,62,-19,
18074,171,2022/4/15 11:20,42,92,-50,
18075,171,2022/4/15 11:30,42,85,-43,
18076,171,2022/4/15 11:40,43,73,-30,
18077,171,2022/4/15 11:50,43,72,-29,
18078,171,2022/4/15 12:00,48,92,-44,
18079,171,2022/4/15 12:10,42,65,-23,
18080,171,2022/4/15 12:20,45,98,-53,
18081,171,2022/4/15 12:30,44,77,-33,
18082,171,2022/4/15 12:40,42,90,-48,
18083,171,2022/4/15 12:50,45,75,-30,
18084,171,2022/4/15 13:00,44,68,-24,
18085,171,2022/4/15 13:10,37,104,-67,
18086,171,2022/4/15 13:20,45,70,-25,
18087,171,2022/4/15 13:30,37,96,-59,
18088,171,2022/4/15 13:40,39,83,-44,
18089,171,2022/4/15 13:50,35,87,-52,
18090,171,2022/4/15 14:00,41,76,-35,
18091,171,2022/4/15 14:10,34,78,-44,
18092,171,2022/4/15 14:20,39,106,-67,
18093,171,2022/4/15 14:30,28,79,-51,
18094,171,2022/4/15 14:40,30,107,-77,
18095,171,2022/4/15 14:50,41,92,-51,
18096,171,2022/4/15 15:00,39,101,-62,
18097,171,2022/4/15 15:10,44,94,-50,
18098,171,2022/4/15 15:20,32,93,-61,
18099,171,2022/4/15 15:30,35,118,-83,
18100,171,2022/4/15 15:40,34,87,-53,
18101,171,2022/4/15 15:50,40,104,-64,
18102,171,2022/4/15 16:00,42,102,-60,
18103,171,2022/4/15 16:10,45,118,-73,
18104,171,2022/4/15 16:20,38,83,-45,
18105,171,2022/4/15 16:30,46,125,-79,
18106,171,2022/4/15 16:40,67,121,-54,
18107,171,2022/4/15 16:50,66,111,-45,
18108,171,2022/4/15 17:00,77,112,-35,
18109,171,2022/4/15 17:10,89,204,-115,
18110,171,2022/4/15 17:20,70,227,-157,
18111,171,2022/4/15 17:30,71,279,-208,
18112,171,2022/4/15 17:40,129,327,-198,
18113,171,2022/4/15 17:50,57,418,-361,
18114,171,2022/4/15 18:00,51,426,-375,
18115,171,2022/4/15 18:10,54,504,-450,
18116,171,2022/4/15 18:20,41,431,-390,
18117,171,2022/4/15 18:30,36,415,-379,
18118,171,2022/4/15 18:40,30,494,-464,
18119,171,2022/4/15 18:50,27,423,-396,
18120,171,2022/4/15 19:00,24,434,-410,
18121,171,2022/4/15 19:10,28,324,-296,
18122,171,2022/4/15 19:20,26,330,-304,
18123,171,2022/4/15 19:30,22,219,-197,
18124,171,2022/4/15 19:40,27,178,-151,
18125,171,2022/4/15 19:50,22,125,-103,
18126,171,2022/4/15 20:00,21,116,-95,
18127,171,2022/4/15 20:10,23,112,-89,
18128,171,2022/4/15 20:20,23,121,-98,
18129,171,2022/4/15 20:30,22,109,-87,
18130,171,2022/4/15 20:40,20,182,-162,
18131,171,2022/4/15 20:50,21,116,-95,
18132,171,2022/4/15 21:00,20,87,-67,
18133,171,2022/4/15 21:10,23,116,-93,
18134,171,2022/4/15 21:20,22,100,-78,
18135,171,2022/4/15 21:30,20,111,-91,
18136,171,2022/4/15 21:40,15,104,-89,
18137,171,2022/4/15 21:50,16,102,-86,
18138,171,2022/4/15 22:00,13,107,-94,
18139,171,2022/4/15 22:10,12,112,-100,
18140,171,2022/4/15 22:20,9,97,-88,
18141,171,2022/4/15 22:30,9,107,-98,
18142,171,2022/4/15 22:40,4,114,-110,
18143,171,2022/4/15 22:50,2,99,-97,
18144,174,2022/4/15 5:00,0,1,-1,
18145,174,2022/4/15 5:10,0,1,-1,
18146,174,2022/4/15 5:20,0,1,-1,
18147,174,2022/4/15 5:30,38,1,37,
18148,174,2022/4/15 5:40,29,6,23,
18149,174,2022/4/15 5:50,45,2,43,
18150,174,2022/4/15 6:00,53,2,51,
18151,174,2022/4/15 6:10,80,23,57,
18152,174,2022/4/15 6:20,185,23,162,
18153,174,2022/4/15 6:30,280,38,242,
18154,174,2022/4/15 6:40,346,46,300,
18155,174,2022/4/15 6:50,654,47,607,
18156,174,2022/4/15 7:00,823,77,746,
18157,174,2022/4/15 7:10,854,75,779,
18158,174,2022/4/15 7:20,850,73,777,
18159,174,2022/4/15 7:30,858,93,765,
18160,174,2022/4/15 7:40,869,90,779,
18161,174,2022/4/15 7:50,850,76,774,
18162,174,2022/4/15 8:00,834,108,726,
18163,174,2022/4/15 8:10,825,120,705,
18164,174,2022/4/15 8:20,730,128,602,
18165,174,2022/4/15 8:30,617,152,465,
18166,174,2022/4/15 8:40,442,197,245,
18167,174,2022/4/15 8:50,346,108,238,
18168,174,2022/4/15 9:00,273,117,156,
18169,174,2022/4/15 9:10,184,109,75,
18170,174,2022/4/15 9:20,148,101,47,
18171,174,2022/4/15 9:30,76,103,-27,
18172,174,2022/4/15 9:40,64,90,-26,
18173,174,2022/4/15 9:50,51,76,-25,
18174,174,2022/4/15 10:00,47,70,-23,
18175,174,2022/4/15 10:10,43,65,-22,
18176,174,2022/4/15 10:20,38,75,-37,
18177,174,2022/4/15 10:30,36,71,-35,
18178,174,2022/4/15 10:40,37,64,-27,
18179,174,2022/4/15 10:50,34,69,-35,
18180,174,2022/4/15 11:00,33,75,-42,
18181,174,2022/4/15 11:10,28,58,-30,
18182,174,2022/4/15 11:20,31,69,-38,
18183,174,2022/4/15 11:30,37,70,-33,
18184,174,2022/4/15 11:40,33,63,-30,
18185,174,2022/4/15 11:50,39,65,-26,
18186,174,2022/4/15 12:00,37,64,-27,
18187,174,2022/4/15 12:10,37,87,-50,
18188,174,2022/4/15 12:20,42,59,-17,
18189,174,2022/4/15 12:30,38,79,-41,
18190,174,2022/4/15 12:40,43,74,-31,
18191,174,2022/4/15 12:50,38,79,-41,
18192,174,2022/4/15 13:00,39,72,-33,
18193,174,2022/4/15 13:10,36,62,-26,
18194,174,2022/4/15 13:20,34,92,-58,
18195,174,2022/4/15 13:30,36,66,-30,
18196,174,2022/4/15 13:40,28,97,-69,
18197,174,2022/4/15 13:50,29,69,-40,
18198,174,2022/4/15 14:00,29,84,-55,
18199,174,2022/4/15 14:10,27,81,-54,
18200,174,2022/4/15 14:20,29,63,-34,
18201,174,2022/4/15 14:30,33,90,-57,
18202,174,2022/4/15 14:40,28,77,-49,
18203,174,2022/4/15 14:50,27,97,-70,
18204,174,2022/4/15 15:00,26,75,-49,
18205,174,2022/4/15 15:10,29,81,-52,
18206,174,2022/4/15 15:20,33,99,-66,
18207,174,2022/4/15 15:30,31,93,-62,
18208,174,2022/4/15 15:40,33,101,-68,
18209,174,2022/4/15 15:50,26,76,-50,
18210,174,2022/4/15 16:00,32,117,-85,
18211,174,2022/4/15 16:10,38,98,-60,
18212,174,2022/4/15 16:20,41,123,-82,
18213,174,2022/4/15 16:30,37,110,-73,
18214,174,2022/4/15 16:40,43,110,-67,
18215,174,2022/4/15 16:50,41,106,-65,
18216,174,2022/4/15 17:00,55,118,-63,
18217,174,2022/4/15 17:10,77,230,-153,
18218,174,2022/4/15 17:20,49,178,-129,
18219,174,2022/4/15 17:30,77,254,-177,
18220,174,2022/4/15 17:40,153,254,-101,
18221,174,2022/4/15 17:50,71,332,-261,
18222,174,2022/4/15 18:00,58,375,-317,
18223,174,2022/4/15 18:10,208,364,-156,
18224,174,2022/4/15 18:20,132,489,-357,
18225,174,2022/4/15 18:30,66,425,-359,
18226,174,2022/4/15 18:40,58,315,-257,
18227,174,2022/4/15 18:50,43,495,-452,
18228,174,2022/4/15 19:00,36,518,-482,
18229,174,2022/4/15 19:10,34,330,-296,
18230,174,2022/4/15 19:20,33,314,-281,
18231,174,2022/4/15 19:30,25,213,-188,
18232,174,2022/4/15 19:40,29,180,-151,
18233,174,2022/4/15 19:50,25,117,-92,
18234,174,2022/4/15 20:00,24,129,-105,
18235,174,2022/4/15 20:10,26,108,-82,
18236,174,2022/4/15 20:20,22,98,-76,
18237,174,2022/4/15 20:30,22,110,-88,
18238,174,2022/4/15 20:40,19,104,-85,
18239,174,2022/4/15 20:50,22,103,-81,
18240,174,2022/4/15 21:00,20,122,-102,
18241,174,2022/4/15 21:10,26,114,-88,
18242,174,2022/4/15 21:20,27,109,-82,
18243,174,2022/4/15 21:30,20,110,-90,
18244,174,2022/4/15 21:40,16,112,-96,
18245,174,2022/4/15 21:50,12,123,-111,
18246,174,2022/4/15 22:00,14,106,-92,
18247,174,2022/4/15 22:10,13,100,-87,
18248,174,2022/4/15 22:20,10,77,-67,
18249,174,2022/4/15 22:30,8,99,-91,
18250,174,2022/4/15 22:40,3,92,-89,
18251,174,2022/4/15 22:50,1,107,-106,
18252,167,2022/4/15 5:00,0,1,-1,
18253,167,2022/4/15 5:10,0,1,-1,
18254,167,2022/4/15 5:20,6,1,5,
18255,167,2022/4/15 5:30,24,1,23,
18256,167,2022/4/15 5:40,16,1,15,
18257,167,2022/4/15 5:50,20,5,15,
18258,167,2022/4/15 6:00,29,1,28,
18259,167,2022/4/15 6:10,32,19,13,
18260,167,2022/4/15 6:20,53,14,39,
18261,167,2022/4/15 6:30,55,19,36,
18262,167,2022/4/15 6:40,52,32,20,
18263,167,2022/4/15 6:50,101,14,87,
18264,167,2022/4/15 7:00,156,46,110,
18265,167,2022/4/15 7:10,87,84,3,
18266,167,2022/4/15 7:20,180,64,116,
18267,167,2022/4/15 7:30,199,39,160,
18268,167,2022/4/15 7:40,146,77,69,
18269,167,2022/4/15 7:50,149,61,88,
18270,167,2022/4/15 8:00,162,20,142,
18271,167,2022/4/15 8:10,69,66,3,
18272,167,2022/4/15 8:20,71,48,23,
18273,167,2022/4/15 8:30,57,68,-11,
18274,167,2022/4/15 8:40,32,77,-45,
18275,167,2022/4/15 8:50,40,29,11,
18276,167,2022/4/15 9:00,30,66,-36,
18277,167,2022/4/15 9:10,26,63,-37,
18278,167,2022/4/15 9:20,26,16,10,
18279,167,2022/4/15 9:30,19,50,-31,
18280,167,2022/4/15 9:40,21,46,-25,
18281,167,2022/4/15 9:50,18,19,-1,
18282,167,2022/4/15 10:00,16,45,-29,
18283,167,2022/4/15 10:10,14,32,-18,
18284,167,2022/4/15 10:20,15,38,-23,
18285,167,2022/4/15 10:30,16,38,-22,
18286,167,2022/4/15 10:40,14,25,-11,
18287,167,2022/4/15 10:50,16,12,4,
18288,167,2022/4/15 11:00,15,38,-23,
18289,167,2022/4/15 11:10,16,35,-19,
18290,167,2022/4/15 11:20,13,10,3,
18291,167,2022/4/15 11:30,15,38,-23,
18292,167,2022/4/15 11:40,17,33,-16,
18293,167,2022/4/15 11:50,15,29,-14,
18294,167,2022/4/15 12:00,15,18,-3,
18295,167,2022/4/15 12:10,18,38,-20,
18296,167,2022/4/15 12:20,17,37,-20,
18297,167,2022/4/15 12:30,16,7,9,
18298,167,2022/4/15 12:40,15,38,-23,
18299,167,2022/4/15 12:50,15,44,-29,
18300,167,2022/4/15 13:00,15,31,-16,
18301,167,2022/4/15 13:10,15,20,-5,
18302,167,2022/4/15 13:20,14,44,-30,
18303,167,2022/4/15 13:30,12,40,-28,
18304,167,2022/4/15 13:40,18,8,10,
18305,167,2022/4/15 13:50,19,47,-28,
18306,167,2022/4/15 14:00,18,44,-26,
18307,167,2022/4/15 14:10,13,33,-20,
18308,167,2022/4/15 14:20,12,21,-9,
18309,167,2022/4/15 14:30,13,45,-32,
18310,167,2022/4/15 14:40,13,44,-31,
18311,167,2022/4/15 14:50,11,17,-6,
18312,167,2022/4/15 15:00,12,45,-33,
18313,167,2022/4/15 15:10,15,50,-35,
18314,167,2022/4/15 15:20,25,32,-7,
18315,167,2022/4/15 15:30,28,35,-7,
18316,167,2022/4/15 15:40,21,69,-48,
18317,167,2022/4/15 15:50,17,65,-48,
18318,167,2022/4/15 16:00,22,5,17,
18319,167,2022/4/15 16:10,22,73,-51,
18320,167,2022/4/15 16:20,21,71,-50,
18321,167,2022/4/15 16:30,22,71,-49,
18322,167,2022/4/15 16:40,16,31,-15,
18323,167,2022/4/15 16:50,18,69,-51,
18324,167,2022/4/15 17:00,20,76,-56,
18325,167,2022/4/15 17:10,20,40,-20,
18326,167,2022/4/15 17:20,24,76,-52,
18327,167,2022/4/15 17:30,17,99,-82,
18328,167,2022/4/15 17:40,26,20,6,
18329,167,2022/4/15 17:50,24,103,-79,
18330,167,2022/4/15 18:00,15,122,-107,
18331,167,2022/4/15 18:10,20,19,1,
18332,167,2022/4/15 18:20,28,105,-77,
18333,167,2022/4/15 18:30,16,110,-94,
18334,167,2022/4/15 18:40,17,25,-8,
18335,167,2022/4/15 18:50,17,110,-93,
18336,167,2022/4/15 19:00,11,111,-100,
18337,167,2022/4/15 19:10,10,27,-17,
18338,167,2022/4/15 19:20,9,114,-105,
18339,167,2022/4/15 19:30,11,110,-99,
18340,167,2022/4/15 19:40,6,43,-37,
18341,167,2022/4/15 19:50,9,78,-69,
18342,167,2022/4/15 20:00,7,71,-64,
18343,167,2022/4/15 20:10,7,59,-52,
18344,167,2022/4/15 20:20,7,77,-70,
18345,167,2022/4/15 20:30,7,69,-62,
18346,167,2022/4/15 20:40,6,21,-15,
18347,167,2022/4/15 20:50,5,85,-80,
18348,167,2022/4/15 21:00,6,73,-67,
18349,167,2022/4/15 21:10,6,13,-7,
18350,167,2022/4/15 21:20,5,71,-66,
18351,167,2022/4/15 21:30,5,67,-62,
18352,167,2022/4/15 21:40,6,15,-9,
18353,167,2022/4/15 21:50,5,74,-69,
18354,167,2022/4/15 22:00,5,66,-61,
18355,167,2022/4/15 22:10,2,13,-11,
18356,167,2022/4/15 22:20,3,70,-67,
18357,167,2022/4/15 22:30,1,48,-47,
18358,167,2022/4/15 22:40,1,50,-49,
18359,167,2022/4/15 22:50,0,66,-66,
18360,173,2022/4/15 5:00,0,1,-1,
18361,173,2022/4/15 5:10,0,1,-1,
18362,173,2022/4/15 5:20,0,1,-1,
18363,173,2022/4/15 5:30,7,1,6,
18364,173,2022/4/15 5:40,6,5,1,
18365,173,2022/4/15 5:50,9,1,8,
18366,173,2022/4/15 6:00,11,1,10,
18367,173,2022/4/15 6:10,10,23,-13,
18368,173,2022/4/15 6:20,17,5,12,
18369,173,2022/4/15 6:30,16,19,-3,
18370,173,2022/4/15 6:40,18,33,-15,
18371,173,2022/4/15 6:50,27,8,19,
18372,173,2022/4/15 7:00,26,38,-12,
18373,173,2022/4/15 7:10,32,62,-30,
18374,173,2022/4/15 7:20,32,23,9,
18375,173,2022/4/15 7:30,29,72,-43,
18376,173,2022/4/15 7:40,33,68,-35,
18377,173,2022/4/15 7:50,31,19,12,
18378,173,2022/4/15 8:00,35,70,-35,
18379,173,2022/4/15 8:10,24,66,-42,
18380,173,2022/4/15 8:20,21,30,-9,
18381,173,2022/4/15 8:30,24,62,-38,
18382,173,2022/4/15 8:40,15,50,-35,
18383,173,2022/4/15 8:50,15,16,-1,
18384,173,2022/4/15 9:00,13,46,-33,
18385,173,2022/4/15 9:10,9,25,-16,
18386,173,2022/4/15 9:20,11,16,-5,
18387,173,2022/4/15 9:30,7,25,-18,
18388,173,2022/4/15 9:40,8,25,-17,
18389,173,2022/4/15 9:50,7,7,0,
18390,173,2022/4/15 10:00,6,23,-17,
18391,173,2022/4/15 10:10,5,19,-14,
18392,173,2022/4/15 10:20,6,23,-17,
18393,173,2022/4/15 10:30,8,12,-4,
18394,173,2022/4/15 10:40,6,22,-16,
18395,173,2022/4/15 10:50,6,14,-8,
18396,173,2022/4/15 11:00,6,19,-13,
18397,173,2022/4/15 11:10,6,14,-8,
18398,173,2022/4/15 11:20,6,8,-2,
18399,173,2022/4/15 11:30,6,23,-17,
18400,173,2022/4/15 11:40,7,19,-12,
18401,173,2022/4/15 11:50,9,7,2,
18402,173,2022/4/15 12:00,8,16,-8,
18403,173,2022/4/15 12:10,7,23,-16,
18404,173,2022/4/15 12:20,8,19,-11,
18405,173,2022/4/15 12:30,8,8,0,
18406,173,2022/4/15 12:40,8,23,-15,
18407,173,2022/4/15 12:50,7,21,-14,
18408,173,2022/4/15 13:00,8,2,6,
18409,173,2022/4/15 13:10,9,19,-10,
18410,173,2022/4/15 13:20,7,21,-14,
18411,173,2022/4/15 13:30,9,21,-12,
18412,173,2022/4/15 13:40,8,7,1,
18413,173,2022/4/15 13:50,7,23,-16,
18414,173,2022/4/15 14:00,7,21,-14,
18415,173,2022/4/15 14:10,7,2,5,
18416,173,2022/4/15 14:20,7,21,-14,
18417,173,2022/4/15 14:30,7,21,-14,
18418,173,2022/4/15 14:40,7,18,-11,
18419,173,2022/4/15 14:50,9,12,-3,
18420,173,2022/4/15 15:00,7,21,-14,
18421,173,2022/4/15 15:10,12,19,-7,
18422,173,2022/4/15 15:20,9,6,3,
18423,173,2022/4/15 15:30,12,19,-7,
18424,173,2022/4/15 15:40,10,23,-13,
18425,173,2022/4/15 15:50,11,23,-12,
18426,173,2022/4/15 16:00,11,15,-4,
18427,173,2022/4/15 16:10,14,23,-9,
18428,173,2022/4/15 16:20,18,30,-12,
18429,173,2022/4/15 16:30,29,32,-3,
18430,173,2022/4/15 16:40,22,18,4,
18431,173,2022/4/15 16:50,15,23,-8,
18432,173,2022/4/15 17:00,29,46,-17,
18433,173,2022/4/15 17:10,16,31,-15,
18434,173,2022/4/15 17:20,18,29,-11,
18435,173,2022/4/15 17:30,12,62,-50,
18436,173,2022/4/15 17:40,12,30,-18,
18437,173,2022/4/15 17:50,12,37,-25,
18438,173,2022/4/15 18:00,11,63,-52,
18439,173,2022/4/15 18:10,11,21,-10,
18440,173,2022/4/15 18:20,10,56,-46,
18441,173,2022/4/15 18:30,7,46,-39,
18442,173,2022/4/15 18:40,6,21,-15,
18443,173,2022/4/15 18:50,7,56,-49,
18444,173,2022/4/15 19:00,6,38,-32,
18445,173,2022/4/15 19:10,7,41,-34,
18446,173,2022/4/15 19:20,6,68,-62,
18447,173,2022/4/15 19:30,5,56,-51,
18448,173,2022/4/15 19:40,5,16,-11,
18449,173,2022/4/15 19:50,3,49,-46,
18450,173,2022/4/15 20:00,4,36,-32,
18451,173,2022/4/15 20:10,3,34,-31,
18452,173,2022/4/15 20:20,5,36,-31,
18453,173,2022/4/15 20:30,2,7,-5,
18454,173,2022/4/15 20:40,3,34,-31,
18455,173,2022/4/15 20:50,3,34,-31,
18456,173,2022/4/15 21:00,2,7,-5,
18457,173,2022/4/15 21:10,2,25,-23,
18458,173,2022/4/15 21:20,1,33,-32,
18459,173,2022/4/15 21:30,2,4,-2,
18460,173,2022/4/15 21:40,2,25,-23,
18461,173,2022/4/15 21:50,1,31,-30,
18462,173,2022/4/15 22:00,1,7,-6,
18463,173,2022/4/15 22:10,1,32,-31,
18464,173,2022/4/15 22:20,1,24,-23,
18465,173,2022/4/15 22:30,1,21,-20,
18466,173,2022/4/15 22:40,0,21,-21,
18467,173,2022/4/15 22:50,0,18,-18,
18468,165,2022/4/15 5:00,0,1,-1,
18469,165,2022/4/15 5:10,0,1,-1,
18470,165,2022/4/15 5:20,22,1,21,
18471,165,2022/4/15 5:30,16,1,15,
18472,165,2022/4/15 5:40,27,1,26,
18473,165,2022/4/15 5:50,30,1,29,
18474,165,2022/4/15 6:00,32,1,31,
18475,165,2022/4/15 6:10,36,6,30,
18476,165,2022/4/15 6:20,49,45,4,
18477,165,2022/4/15 6:30,47,40,7,
18478,165,2022/4/15 6:40,87,2,85,
18479,165,2022/4/15 6:50,106,61,45,
18480,165,2022/4/15 7:00,106,72,34,
18481,165,2022/4/15 7:10,254,13,241,
18482,165,2022/4/15 7:20,215,87,128,
18483,165,2022/4/15 7:30,222,100,122,
18484,165,2022/4/15 7:40,254,35,219,
18485,165,2022/4/15 7:50,233,112,121,
18486,165,2022/4/15 8:00,103,112,-9,
18487,165,2022/4/15 8:10,151,48,103,
18488,165,2022/4/15 8:20,73,120,-47,
18489,165,2022/4/15 8:30,48,105,-57,
18490,165,2022/4/15 8:40,56,15,41,
18491,165,2022/4/15 8:50,31,82,-51,
18492,165,2022/4/15 9:00,28,70,-42,
18493,165,2022/4/15 9:10,31,32,-1,
18494,165,2022/4/15 9:20,25,84,-59,
18495,165,2022/4/15 9:30,28,70,-42,
18496,165,2022/4/15 9:40,28,12,16,
18497,165,2022/4/15 9:50,20,74,-54,
18498,165,2022/4/15 10:00,23,59,-36,
18499,165,2022/4/15 10:10,22,60,-38,
18500,165,2022/4/15 10:20,20,27,-7,
18501,165,2022/4/15 10:30,21,34,-13,
18502,165,2022/4/15 10:40,21,57,-36,
18503,165,2022/4/15 10:50,17,48,-31,
18504,165,2022/4/15 11:00,19,44,-25,
18505,165,2022/4/15 11:10,21,31,-10,
18506,165,2022/4/15 11:20,24,52,-28,
18507,165,2022/4/15 11:30,22,31,-9,
18508,165,2022/4/15 11:40,22,36,-14,
18509,165,2022/4/15 11:50,28,51,-23,
18510,165,2022/4/15 12:00,26,57,-31,
18511,165,2022/4/15 12:10,23,22,1,
18512,165,2022/4/15 12:20,27,50,-23,
18513,165,2022/4/15 12:30,24,61,-37,
18514,165,2022/4/15 12:40,25,59,-34,
18515,165,2022/4/15 12:50,24,18,6,
18516,165,2022/4/15 13:00,23,65,-42,
18517,165,2022/4/15 13:10,22,61,-39,
18518,165,2022/4/15 13:20,26,23,3,
18519,165,2022/4/15 13:30,21,53,-32,
18520,165,2022/4/15 13:40,21,62,-41,
18521,165,2022/4/15 13:50,21,68,-47,
18522,165,2022/4/15 14:00,19,12,7,
18523,165,2022/4/15 14:10,19,68,-49,
18524,165,2022/4/15 14:20,21,70,-49,
18525,165,2022/4/15 14:30,25,19,6,
18526,165,2022/4/15 14:40,22,63,-41,
18527,165,2022/4/15 14:50,25,66,-41,
18528,165,2022/4/15 15:00,24,60,-36,
18529,165,2022/4/15 15:10,25,20,5,
18530,165,2022/4/15 15:20,26,69,-43,
18531,165,2022/4/15 15:30,21,77,-56,
18532,165,2022/4/15 15:40,23,62,-39,
18533,165,2022/4/15 15:50,25,47,-22,
18534,165,2022/4/15 16:00,26,78,-52,
18535,165,2022/4/15 16:10,27,81,-54,
18536,165,2022/4/15 16:20,30,19,11,
18537,165,2022/4/15 16:30,40,82,-42,
18538,165,2022/4/15 16:40,34,77,-43,
18539,165,2022/4/15 16:50,36,87,-51,
18540,165,2022/4/15 17:00,105,25,80,
18541,165,2022/4/15 17:10,38,108,-70,
18542,165,2022/4/15 17:20,46,109,-63,
18543,165,2022/4/15 17:30,32,7,25,
18544,165,2022/4/15 17:40,29,119,-90,
18545,165,2022/4/15 17:50,28,100,-72,
18546,165,2022/4/15 18:00,26,30,-4,
18547,165,2022/4/15 18:10,25,119,-94,
18548,165,2022/4/15 18:20,22,103,-81,
18549,165,2022/4/15 18:30,18,53,-35,
18550,165,2022/4/15 18:40,17,143,-126,
18551,165,2022/4/15 18:50,20,103,-83,
18552,165,2022/4/15 19:00,13,66,-53,
18553,165,2022/4/15 19:10,14,116,-102,
18554,165,2022/4/15 19:20,12,102,-90,
18555,165,2022/4/15 19:30,11,51,-40,
18556,165,2022/4/15 19:40,13,107,-94,
18557,165,2022/4/15 19:50,13,92,-79,
18558,165,2022/4/15 20:00,13,83,-70,
18559,165,2022/4/15 20:10,10,73,-63,
18560,165,2022/4/15 20:20,14,10,4,
18561,165,2022/4/15 20:30,11,79,-68,
18562,165,2022/4/15 20:40,14,87,-73,
18563,165,2022/4/15 20:50,13,6,7,
18564,165,2022/4/15 21:00,10,80,-70,
18565,165,2022/4/15 21:10,11,77,-66,
18566,165,2022/4/15 21:20,9,13,-4,
18567,165,2022/4/15 21:30,9,72,-63,
18568,165,2022/4/15 21:40,11,69,-58,
18569,165,2022/4/15 21:50,19,7,12,
18570,165,2022/4/15 22:00,12,75,-63,
18571,165,2022/4/15 22:10,8,71,-63,
18572,165,2022/4/15 22:20,6,4,2,
18573,165,2022/4/15 22:30,3,67,-64,
18574,165,2022/4/15 22:40,2,55,-53,
18575,165,2022/4/15 22:50,0,35,-35,
18576,150,2022/4/15 5:00,0,1,-1,
18577,150,2022/4/15 5:10,7,1,6,
18578,150,2022/4/15 5:20,12,1,11,
18579,150,2022/4/15 5:30,7,1,6,
18580,150,2022/4/15 5:40,13,1,12,
18581,150,2022/4/15 5:50,22,1,21,
18582,150,2022/4/15 6:00,27,1,26,
18583,150,2022/4/15 6:10,41,1,40,
18584,150,2022/4/15 6:20,43,21,22,
18585,150,2022/4/15 6:30,37,21,16,
18586,150,2022/4/15 6:40,58,6,52,
18587,150,2022/4/15 6:50,79,38,41,
18588,150,2022/4/15 7:00,83,47,36,
18589,150,2022/4/15 7:10,147,23,124,
18590,150,2022/4/15 7:20,193,68,125,
18591,150,2022/4/15 7:30,145,58,87,
18592,150,2022/4/15 7:40,108,69,39,
18593,150,2022/4/15 7:50,155,93,62,
18594,150,2022/4/15 8:00,80,94,-14,
18595,150,2022/4/15 8:10,72,72,0,
18596,150,2022/4/15 8:20,68,105,-37,
18597,150,2022/4/15 8:30,44,55,-11,
18598,150,2022/4/15 8:40,35,75,-40,
18599,150,2022/4/15 8:50,45,76,-31,
18600,150,2022/4/15 9:00,20,16,4,
18601,150,2022/4/15 9:10,25,66,-41,
18602,150,2022/4/15 9:20,21,62,-41,
18603,150,2022/4/15 9:30,23,35,-12,
18604,150,2022/4/15 9:40,24,60,-36,
18605,150,2022/4/15 9:50,21,61,-40,
18606,150,2022/4/15 10:00,24,40,-16,
18607,150,2022/4/15 10:10,19,51,-32,
18608,150,2022/4/15 10:20,22,38,-16,
18609,150,2022/4/15 10:30,23,62,-39,
18610,150,2022/4/15 10:40,20,57,-37,
18611,150,2022/4/15 10:50,25,47,-22,
18612,150,2022/4/15 11:00,23,10,13,
18613,150,2022/4/15 11:10,23,57,-34,
18614,150,2022/4/15 11:20,24,50,-26,
18615,150,2022/4/15 11:30,25,18,7,
18616,150,2022/4/15 11:40,23,60,-37,
18617,150,2022/4/15 11:50,26,48,-22,
18618,150,2022/4/15 12:00,21,47,-26,
18619,150,2022/4/15 12:10,25,18,7,
18620,150,2022/4/15 12:20,22,58,-36,
18621,150,2022/4/15 12:30,21,62,-41,
18622,150,2022/4/15 12:40,18,12,6,
18623,150,2022/4/15 12:50,24,65,-41,
18624,150,2022/4/15 13:00,24,71,-47,
18625,150,2022/4/15 13:10,22,51,-29,
18626,150,2022/4/15 13:20,17,37,-20,
18627,150,2022/4/15 13:30,16,64,-48,
18628,150,2022/4/15 13:40,22,64,-42,
18629,150,2022/4/15 13:50,24,14,10,
18630,150,2022/4/15 14:00,23,57,-34,
18631,150,2022/4/15 14:10,22,63,-41,
18632,150,2022/4/15 14:20,21,59,-38,
18633,150,2022/4/15 14:30,23,19,4,
18634,150,2022/4/15 14:40,18,68,-50,
18635,150,2022/4/15 14:50,26,60,-34,
18636,150,2022/4/15 15:00,24,8,16,
18637,150,2022/4/15 15:10,26,70,-44,
18638,150,2022/4/15 15:20,25,69,-44,
18639,150,2022/4/15 15:30,28,61,-33,
18640,150,2022/4/15 15:40,26,33,-7,
18641,150,2022/4/15 15:50,31,68,-37,
18642,150,2022/4/15 16:00,24,64,-40,
18643,150,2022/4/15 16:10,30,11,19,
18644,150,2022/4/15 16:20,33,72,-39,
18645,150,2022/4/15 16:30,39,63,-24,
18646,150,2022/4/15 16:40,35,70,-35,
18647,150,2022/4/15 16:50,38,22,16,
18648,150,2022/4/15 17:00,39,64,-25,
18649,150,2022/4/15 17:10,43,91,-48,
18650,150,2022/4/15 17:20,28,63,-35,
18651,150,2022/4/15 17:30,26,58,-32,
18652,150,2022/4/15 17:40,23,105,-82,
18653,150,2022/4/15 17:50,25,42,-17,
18654,150,2022/4/15 18:00,22,97,-75,
18655,150,2022/4/15 18:10,22,127,-105,
18656,150,2022/4/15 18:20,20,27,-7,
18657,150,2022/4/15 18:30,18,105,-87,
18658,150,2022/4/15 18:40,16,106,-90,
18659,150,2022/4/15 18:50,13,36,-23,
18660,150,2022/4/15 19:00,12,110,-98,
18661,150,2022/4/15 19:10,13,105,-92,
18662,150,2022/4/15 19:20,8,39,-31,
18663,150,2022/4/15 19:30,10,95,-85,
18664,150,2022/4/15 19:40,10,77,-67,
18665,150,2022/4/15 19:50,11,60,-49,
18666,150,2022/4/15 20:00,8,78,-70,
18667,150,2022/4/15 20:10,12,50,-38,
18668,150,2022/4/15 20:20,8,33,-25,
18669,150,2022/4/15 20:30,9,67,-58,
18670,150,2022/4/15 20:40,8,64,-56,
18671,150,2022/4/15 20:50,9,8,1,
18672,150,2022/4/15 21:00,8,69,-61,
18673,150,2022/4/15 21:10,7,61,-54,
18674,150,2022/4/15 21:20,6,8,-2,
18675,150,2022/4/15 21:30,5,62,-57,
18676,150,2022/4/15 21:40,2,59,-57,
18677,150,2022/4/15 21:50,4,10,-6,
18678,150,2022/4/15 22:00,4,63,-59,
18679,150,2022/4/15 22:10,3,53,-50,
18680,150,2022/4/15 22:20,2,8,-6,
18681,150,2022/4/15 22:30,2,49,-47,
18682,150,2022/4/15 22:40,0,40,-40,
18683,150,2022/4/15 22:50,0,36,-36,
18684,172,2022/4/15 5:00,0,1,-1,
18685,172,2022/4/15 5:10,10,1,9,
18686,172,2022/4/15 5:20,19,1,18,
18687,172,2022/4/15 5:30,12,1,11,
18688,172,2022/4/15 5:40,19,1,18,
18689,172,2022/4/15 5:50,32,1,31,
18690,172,2022/4/15 6:00,32,1,31,
18691,172,2022/4/15 6:10,49,1,48,
18692,172,2022/4/15 6:20,80,36,44,
18693,172,2022/4/15 6:30,54,5,49,
18694,172,2022/4/15 6:40,87,47,40,
18695,172,2022/4/15 6:50,157,64,93,
18696,172,2022/4/15 7:00,156,19,137,
18697,172,2022/4/15 7:10,215,75,140,
18698,172,2022/4/15 7:20,274,121,153,
18699,172,2022/4/15 7:30,254,17,237,
18700,172,2022/4/15 7:40,174,104,70,
18701,172,2022/4/15 7:50,225,117,108,
18702,172,2022/4/15 8:00,158,46,112,
18703,172,2022/4/15 8:10,82,178,-96,
18704,172,2022/4/15 8:20,90,117,-27,
18705,172,2022/4/15 8:30,56,25,31,
18706,172,2022/4/15 8:40,54,133,-79,
18707,172,2022/4/15 8:50,46,108,-62,
18708,172,2022/4/15 9:00,32,13,19,
18709,172,2022/4/15 9:10,32,105,-73,
18710,172,2022/4/15 9:20,32,73,-41,
18711,172,2022/4/15 9:30,27,30,-3,
18712,172,2022/4/15 9:40,27,76,-49,
18713,172,2022/4/15 9:50,27,68,-41,
18714,172,2022/4/15 10:00,27,12,15,
18715,172,2022/4/15 10:10,25,76,-51,
18716,172,2022/4/15 10:20,26,65,-39,
18717,172,2022/4/15 10:30,27,63,-36,
18718,172,2022/4/15 10:40,25,69,-44,
18719,172,2022/4/15 10:50,29,47,-18,
18720,172,2022/4/15 11:00,26,39,-13,
18721,172,2022/4/15 11:10,24,71,-47,
18722,172,2022/4/15 11:20,26,46,-20,
18723,172,2022/4/15 11:30,28,37,-9,
18724,172,2022/4/15 11:40,27,71,-44,
18725,172,2022/4/15 11:50,31,67,-36,
18726,172,2022/4/15 12:00,28,28,0,
18727,172,2022/4/15 12:10,28,50,-22,
18728,172,2022/4/15 12:20,27,64,-37,
18729,172,2022/4/15 12:30,26,62,-36,
18730,172,2022/4/15 12:40,28,28,0,
18731,172,2022/4/15 12:50,29,62,-33,
18732,172,2022/4/15 13:00,26,82,-56,
18733,172,2022/4/15 13:10,27,15,12,
18734,172,2022/4/15 13:20,22,83,-61,
18735,172,2022/4/15 13:30,26,82,-56,
18736,172,2022/4/15 13:40,24,71,-47,
18737,172,2022/4/15 13:50,26,19,7,
18738,172,2022/4/15 14:00,22,72,-50,
18739,172,2022/4/15 14:10,28,81,-53,
18740,172,2022/4/15 14:20,26,15,11,
18741,172,2022/4/15 14:30,28,70,-42,
18742,172,2022/4/15 14:40,25,72,-47,
18743,172,2022/4/15 14:50,28,62,-34,
18744,172,2022/4/15 15:00,25,33,-8,
18745,172,2022/4/15 15:10,29,78,-49,
18746,172,2022/4/15 15:20,27,72,-45,
18747,172,2022/4/15 15:30,27,14,13,
18748,172,2022/4/15 15:40,29,81,-52,
18749,172,2022/4/15 15:50,32,79,-47,
18750,172,2022/4/15 16:00,33,68,-35,
18751,172,2022/4/15 16:10,40,33,7,
18752,172,2022/4/15 16:20,45,92,-47,
18753,172,2022/4/15 16:30,46,73,-27,
18754,172,2022/4/15 16:40,45,85,-40,
18755,172,2022/4/15 16:50,61,35,26,
18756,172,2022/4/15 17:00,74,108,-34,
18757,172,2022/4/15 17:10,137,105,32,
18758,172,2022/4/15 17:20,62,25,37,
18759,172,2022/4/15 17:30,47,99,-52,
18760,172,2022/4/15 17:40,37,111,-74,
18761,172,2022/4/15 17:50,30,23,7,
18762,172,2022/4/15 18:00,26,109,-83,
18763,172,2022/4/15 18:10,27,147,-120,
18764,172,2022/4/15 18:20,22,29,-7,
18765,172,2022/4/15 18:30,22,192,-170,
18766,172,2022/4/15 18:40,18,121,-103,
18767,172,2022/4/15 18:50,18,88,-70,
18768,172,2022/4/15 19:00,16,154,-138,
18769,172,2022/4/15 19:10,17,98,-81,
18770,172,2022/4/15 19:20,16,98,-82,
18771,172,2022/4/15 19:30,13,110,-97,
18772,172,2022/4/15 19:40,13,123,-110,
18773,172,2022/4/15 19:50,13,22,-9,
18774,172,2022/4/15 20:00,14,113,-99,
18775,172,2022/4/15 20:10,19,79,-60,
18776,172,2022/4/15 20:20,17,82,-65,
18777,172,2022/4/15 20:30,14,80,-66,
18778,172,2022/4/15 20:40,14,31,-17,
18779,172,2022/4/15 20:50,11,70,-59,
18780,172,2022/4/15 21:00,13,78,-65,
18781,172,2022/4/15 21:10,13,21,-8,
18782,172,2022/4/15 21:20,8,87,-79,
18783,172,2022/4/15 21:30,7,86,-79,
18784,172,2022/4/15 21:40,8,13,-5,
18785,172,2022/4/15 21:50,9,79,-70,
18786,172,2022/4/15 22:00,5,78,-73,
18787,172,2022/4/15 22:10,5,21,-16,
18788,172,2022/4/15 22:20,4,70,-66,
18789,172,2022/4/15 22:30,1,75,-74,
18790,172,2022/4/15 22:40,0,55,-55,
18791,172,2022/4/15 22:50,0,53,-53,
18792,168,2022/4/15 5:00,0,1,-1,
18793,168,2022/4/15 5:10,3,1,2,
18794,168,2022/4/15 5:20,4,1,3,
18795,168,2022/4/15 5:30,5,1,4,
18796,168,2022/4/15 5:40,4,1,3,
18797,168,2022/4/15 5:50,6,1,5,
18798,168,2022/4/15 6:00,5,1,4,
18799,168,2022/4/15 6:10,16,1,15,
18800,168,2022/4/15 6:20,17,5,12,
18801,168,2022/4/15 6:30,20,55,-35,
18802,168,2022/4/15 6:40,27,69,-42,
18803,168,2022/4/15 6:50,34,101,-67,
18804,168,2022/4/15 7:00,39,18,21,
18805,168,2022/4/15 7:10,29,87,-58,
18806,168,2022/4/15 7:20,36,102,-66,
18807,168,2022/4/15 7:30,36,102,-66,
18808,168,2022/4/15 7:40,28,198,-170,
18809,168,2022/4/15 7:50,32,106,-74,
18810,168,2022/4/15 8:00,32,94,-62,
18811,168,2022/4/15 8:10,24,299,-275,
18812,168,2022/4/15 8:20,29,105,-76,
18813,168,2022/4/15 8:30,24,52,-28,
18814,168,2022/4/15 8:40,21,93,-72,
18815,168,2022/4/15 8:50,22,58,-36,
18816,168,2022/4/15 9:00,14,18,-4,
18817,168,2022/4/15 9:10,15,65,-50,
18818,168,2022/4/15 9:20,14,31,-17,
18819,168,2022/4/15 9:30,13,27,-14,
18820,168,2022/4/15 9:40,13,46,-33,
18821,168,2022/4/15 9:50,11,33,-22,
18822,168,2022/4/15 10:00,10,15,-5,
18823,168,2022/4/15 10:10,14,29,-15,
18824,168,2022/4/15 10:20,10,32,-22,
18825,168,2022/4/15 10:30,15,28,-13,
18826,168,2022/4/15 10:40,13,1,12,
18827,168,2022/4/15 10:50,12,25,-13,
18828,168,2022/4/15 11:00,15,23,-8,
18829,168,2022/4/15 11:10,20,33,-13,
18830,168,2022/4/15 11:20,20,1,19,
18831,168,2022/4/15 11:30,19,34,-15,
18832,168,2022/4/15 11:40,19,37,-18,
18833,168,2022/4/15 11:50,18,23,-5,
18834,168,2022/4/15 12:00,17,1,16,
18835,168,2022/4/15 12:10,18,36,-18,
18836,168,2022/4/15 12:20,17,35,-18,
18837,168,2022/4/15 12:30,16,1,15,
18838,168,2022/4/15 12:40,19,35,-16,
18839,168,2022/4/15 12:50,17,29,-12,
18840,168,2022/4/15 13:00,16,30,-14,
18841,168,2022/4/15 13:10,17,5,12,
18842,168,2022/4/15 13:20,12,34,-22,
18843,168,2022/4/15 13:30,13,33,-20,
18844,168,2022/4/15 13:40,11,1,10,
18845,168,2022/4/15 13:50,15,29,-14,
18846,168,2022/4/15 14:00,12,25,-13,
18847,168,2022/4/15 14:10,12,25,-13,
18848,168,2022/4/15 14:20,12,2,10,
18849,168,2022/4/15 14:30,16,23,-7,
18850,168,2022/4/15 14:40,20,31,-11,
18851,168,2022/4/15 14:50,20,1,19,
18852,168,2022/4/15 15:00,18,29,-11,
18853,168,2022/4/15 15:10,16,30,-14,
18854,168,2022/4/15 15:20,19,23,-4,
18855,168,2022/4/15 15:30,22,12,10,
18856,168,2022/4/15 15:40,23,32,-9,
18857,168,2022/4/15 15:50,26,38,-12,
18858,168,2022/4/15 16:00,32,2,30,
18859,168,2022/4/15 16:10,32,33,-1,
18860,168,2022/4/15 16:20,31,35,-4,
18861,168,2022/4/15 16:30,33,35,-2,
18862,168,2022/4/15 16:40,70,10,60,
18863,168,2022/4/15 16:50,179,33,146,
18864,168,2022/4/15 17:00,268,38,230,
18865,168,2022/4/15 17:10,243,42,201,
18866,168,2022/4/15 17:20,49,10,39,
18867,168,2022/4/15 17:30,43,46,-3,
18868,168,2022/4/15 17:40,31,49,-18,
18869,168,2022/4/15 17:50,25,10,15,
18870,168,2022/4/15 18:00,23,55,-32,
18871,168,2022/4/15 18:10,22,44,-22,
18872,168,2022/4/15 18:20,18,46,-28,
18873,168,2022/4/15 18:30,17,73,-56,
18874,168,2022/4/15 18:40,17,14,3,
18875,168,2022/4/15 18:50,14,68,-54,
18876,168,2022/4/15 19:00,12,83,-71,
18877,168,2022/4/15 19:10,11,6,5,
18878,168,2022/4/15 19:20,9,75,-66,
18879,168,2022/4/15 19:30,8,56,-48,
18880,168,2022/4/15 19:40,8,40,-32,
18881,168,2022/4/15 19:50,11,19,-8,
18882,168,2022/4/15 20:00,19,40,-21,
18883,168,2022/4/15 20:10,21,36,-15,
18884,168,2022/4/15 20:20,23,33,-10,
18885,168,2022/4/15 20:30,15,36,-21,
18886,168,2022/4/15 20:40,13,3,10,
18887,168,2022/4/15 20:50,8,41,-33,
18888,168,2022/4/15 21:00,4,34,-30,
18889,168,2022/4/15 21:10,4,3,1,
18890,168,2022/4/15 21:20,2,39,-37,
18891,168,2022/4/15 21:30,1,27,-26,
18892,168,2022/4/15 21:40,4,7,-3,
18893,168,2022/4/15 21:50,2,40,-38,
18894,168,2022/4/15 22:00,2,34,-32,
18895,168,2022/4/15 22:10,2,7,-5,
18896,168,2022/4/15 22:20,2,34,-32,
18897,168,2022/4/15 22:30,0,30,-30,
18898,168,2022/4/15 22:40,0,21,-21,
18899,168,2022/4/15 22:50,0,21,-21,
18900,159,2022/4/15 5:00,0,1,-1,
18901,159,2022/4/15 5:10,19,1,18,
18902,159,2022/4/15 5:20,18,1,17,
18903,159,2022/4/15 5:30,20,1,19,
18904,159,2022/4/15 5:40,26,1,25,
18905,159,2022/4/15 5:50,34,1,33,
18906,159,2022/4/15 6:00,47,1,46,
18907,159,2022/4/15 6:10,57,1,56,
18908,159,2022/4/15 6:20,86,1,85,
18909,159,2022/4/15 6:30,149,65,84,
18910,159,2022/4/15 6:40,216,70,146,
18911,159,2022/4/15 6:50,232,6,226,
18912,159,2022/4/15 7:00,280,79,201,
18913,159,2022/4/15 7:10,282,96,186,
18914,159,2022/4/15 7:20,283,13,270,
18915,159,2022/4/15 7:30,280,109,171,
18916,159,2022/4/15 7:40,302,100,202,
18917,159,2022/4/15 7:50,253,19,234,
18918,159,2022/4/15 8:00,270,90,180,
18919,159,2022/4/15 8:10,227,69,158,
18920,159,2022/4/15 8:20,144,16,128,
18921,159,2022/4/15 8:30,143,67,76,
18922,159,2022/4/15 8:40,60,60,0,
18923,159,2022/4/15 8:50,53,21,32,
18924,159,2022/4/15 9:00,41,65,-24,
18925,159,2022/4/15 9:10,29,48,-19,
18926,159,2022/4/15 9:20,28,25,3,
18927,159,2022/4/15 9:30,32,64,-32,
18928,159,2022/4/15 9:40,28,50,-22,
18929,159,2022/4/15 9:50,29,19,10,
18930,159,2022/4/15 10:00,28,61,-33,
18931,159,2022/4/15 10:10,23,58,-35,
18932,159,2022/4/15 10:20,24,47,-23,
18933,159,2022/4/15 10:30,21,22,-1,
18934,159,2022/4/15 10:40,28,49,-21,
18935,159,2022/4/15 10:50,26,55,-29,
18936,159,2022/4/15 11:00,25,50,-25,
18937,159,2022/4/15 11:10,24,24,0,
18938,159,2022/4/15 11:20,27,48,-21,
18939,159,2022/4/15 11:30,25,61,-36,
18940,159,2022/4/15 11:40,25,7,18,
18941,159,2022/4/15 11:50,28,57,-29,
18942,159,2022/4/15 12:00,25,51,-26,
18943,159,2022/4/15 12:10,27,54,-27,
18944,159,2022/4/15 12:20,27,7,20,
18945,159,2022/4/15 12:30,26,60,-34,
18946,159,2022/4/15 12:40,28,60,-32,
18947,159,2022/4/15 12:50,26,44,-18,
18948,159,2022/4/15 13:00,23,34,-11,
18949,159,2022/4/15 13:10,25,68,-43,
18950,159,2022/4/15 13:20,22,62,-40,
18951,159,2022/4/15 13:30,22,5,17,
18952,159,2022/4/15 13:40,22,62,-40,
18953,159,2022/4/15 13:50,16,64,-48,
18954,159,2022/4/15 14:00,22,68,-46,
18955,159,2022/4/15 14:10,23,17,6,
18956,159,2022/4/15 14:20,22,67,-45,
18957,159,2022/4/15 14:30,17,68,-51,
18958,159,2022/4/15 14:40,20,5,15,
18959,159,2022/4/15 14:50,18,63,-45,
18960,159,2022/4/15 15:00,18,71,-53,
18961,159,2022/4/15 15:10,24,57,-33,
18962,159,2022/4/15 15:20,27,43,-16,
18963,159,2022/4/15 15:30,28,84,-56,
18964,159,2022/4/15 15:40,21,87,-66,
18965,159,2022/4/15 15:50,21,47,-26,
18966,159,2022/4/15 16:00,27,75,-48,
18967,159,2022/4/15 16:10,28,109,-81,
18968,159,2022/4/15 16:20,26,93,-67,
18969,159,2022/4/15 16:30,27,42,-15,
18970,159,2022/4/15 16:40,27,105,-78,
18971,159,2022/4/15 16:50,27,105,-78,
18972,159,2022/4/15 17:00,33,102,-69,
18973,159,2022/4/15 17:10,38,33,5,
18974,159,2022/4/15 17:20,32,123,-91,
18975,159,2022/4/15 17:30,28,109,-81,
18976,159,2022/4/15 17:40,28,14,14,
18977,159,2022/4/15 17:50,25,143,-118,
18978,159,2022/4/15 18:00,17,138,-121,
18979,159,2022/4/15 18:10,19,49,-30,
18980,159,2022/4/15 18:20,15,197,-182,
18981,159,2022/4/15 18:30,13,107,-94,
18982,159,2022/4/15 18:40,15,97,-82,
18983,159,2022/4/15 18:50,12,198,-186,
18984,159,2022/4/15 19:00,9,81,-72,
18985,159,2022/4/15 19:10,10,105,-95,
18986,159,2022/4/15 19:20,10,179,-169,
18987,159,2022/4/15 19:30,11,99,-88,
18988,159,2022/4/15 19:40,9,80,-71,
18989,159,2022/4/15 19:50,7,123,-116,
18990,159,2022/4/15 20:00,9,115,-106,
18991,159,2022/4/15 20:10,12,92,-80,
18992,159,2022/4/15 20:20,12,92,-80,
18993,159,2022/4/15 20:30,12,8,4,
18994,159,2022/4/15 20:40,12,98,-86,
18995,159,2022/4/15 20:50,8,97,-89,
18996,159,2022/4/15 21:00,6,4,2,
18997,159,2022/4/15 21:10,6,98,-92,
18998,159,2022/4/15 21:20,7,103,-96,
18999,159,2022/4/15 21:30,8,3,5,
19000,159,2022/4/15 21:40,7,91,-84,
19001,159,2022/4/15 21:50,4,95,-91,
19002,159,2022/4/15 22:00,2,3,-1,
19003,159,2022/4/15 22:10,3,95,-92,
19004,159,2022/4/15 22:20,2,80,-78,
19005,159,2022/4/15 22:30,0,3,-3,
19006,159,2022/4/15 22:40,0,86,-86,
19007,159,2022/4/15 22:50,0,61,-61,
19008,166,2022/4/15 5:00,0,1,-1,
19009,166,2022/4/15 5:10,0,1,-1,
19010,166,2022/4/15 5:20,21,1,20,
19011,166,2022/4/15 5:30,21,2,19,
19012,166,2022/4/15 5:40,27,1,26,
19013,166,2022/4/15 5:50,27,1,26,
19014,166,2022/4/15 6:00,33,5,28,
19015,166,2022/4/15 6:10,32,5,27,
19016,166,2022/4/15 6:20,54,41,13,
19017,166,2022/4/15 6:30,67,42,25,
19018,166,2022/4/15 6:40,79,47,32,
19019,166,2022/4/15 6:50,98,38,60,
19020,166,2022/4/15 7:00,215,93,122,
19021,166,2022/4/15 7:10,247,55,192,
19022,166,2022/4/15 7:20,199,75,124,
19023,166,2022/4/15 7:30,236,107,129,
19024,166,2022/4/15 7:40,285,88,197,
19025,166,2022/4/15 7:50,222,57,165,
19026,166,2022/4/15 8:00,176,117,59,
19027,166,2022/4/15 8:10,188,81,107,
19028,166,2022/4/15 8:20,79,105,-26,
19029,166,2022/4/15 8:30,80,119,-39,
19030,166,2022/4/15 8:40,61,71,-10,
19031,166,2022/4/15 8:50,45,102,-57,
19032,166,2022/4/15 9:00,46,111,-65,
19033,166,2022/4/15 9:10,29,59,-30,
19034,166,2022/4/15 9:20,36,93,-57,
19035,166,2022/4/15 9:30,27,91,-64,
19036,166,2022/4/15 9:40,32,58,-26,
19037,166,2022/4/15 9:50,26,74,-48,
19038,166,2022/4/15 10:00,32,75,-43,
19039,166,2022/4/15 10:10,27,73,-46,
19040,166,2022/4/15 10:20,27,71,-44,
19041,166,2022/4/15 10:30,27,21,6,
19042,166,2022/4/15 10:40,28,85,-57,
19043,166,2022/4/15 10:50,27,67,-40,
19044,166,2022/4/15 11:00,30,77,-47,
19045,166,2022/4/15 11:10,27,15,12,
19046,166,2022/4/15 11:20,25,85,-60,
19047,166,2022/4/15 11:30,30,71,-41,
19048,166,2022/4/15 11:40,32,51,-19,
19049,166,2022/4/15 11:50,29,48,-19,
19050,166,2022/4/15 12:00,29,65,-36,
19051,166,2022/4/15 12:10,31,69,-38,
19052,166,2022/4/15 12:20,25,19,6,
19053,166,2022/4/15 12:30,29,82,-53,
19054,166,2022/4/15 12:40,24,77,-53,
19055,166,2022/4/15 12:50,25,39,-14,
19056,166,2022/4/15 13:00,24,84,-60,
19057,166,2022/4/15 13:10,27,77,-50,
19058,166,2022/4/15 13:20,30,78,-48,
19059,166,2022/4/15 13:30,28,21,7,
19060,166,2022/4/15 13:40,28,79,-51,
19061,166,2022/4/15 13:50,27,80,-53,
19062,166,2022/4/15 14:00,32,39,-7,
19063,166,2022/4/15 14:10,27,81,-54,
19064,166,2022/4/15 14:20,27,97,-70,
19065,166,2022/4/15 14:30,25,76,-51,
19066,166,2022/4/15 14:40,24,27,-3,
19067,166,2022/4/15 14:50,26,90,-64,
19068,166,2022/4/15 15:00,29,75,-46,
19069,166,2022/4/15 15:10,22,37,-15,
19070,166,2022/4/15 15:20,25,75,-50,
19071,166,2022/4/15 15:30,35,90,-55,
19072,166,2022/4/15 15:40,28,96,-68,
19073,166,2022/4/15 15:50,26,19,7,
19074,166,2022/4/15 16:00,36,99,-63,
19075,166,2022/4/15 16:10,35,108,-73,
19076,166,2022/4/15 16:20,38,72,-34,
19077,166,2022/4/15 16:30,41,45,-4,
19078,166,2022/4/15 16:40,45,101,-56,
19079,166,2022/4/15 16:50,40,104,-64,
19080,166,2022/4/15 17:00,48,67,-19,
19081,166,2022/4/15 17:10,44,107,-63,
19082,166,2022/4/15 17:20,47,118,-71,
19083,166,2022/4/15 17:30,42,68,-26,
19084,166,2022/4/15 17:40,38,124,-86,
19085,166,2022/4/15 17:50,36,110,-74,
19086,166,2022/4/15 18:00,34,68,-34,
19087,166,2022/4/15 18:10,31,180,-149,
19088,166,2022/4/15 18:20,32,215,-183,
19089,166,2022/4/15 18:30,24,31,-7,
19090,166,2022/4/15 18:40,26,219,-193,
19091,166,2022/4/15 18:50,27,209,-182,
19092,166,2022/4/15 19:00,23,23,0,
19093,166,2022/4/15 19:10,23,234,-211,
19094,166,2022/4/15 19:20,21,128,-107,
19095,166,2022/4/15 19:30,17,67,-50,
19096,166,2022/4/15 19:40,16,122,-106,
19097,166,2022/4/15 19:50,17,125,-108,
19098,166,2022/4/15 20:00,19,83,-64,
19099,166,2022/4/15 20:10,17,94,-77,
19100,166,2022/4/15 20:20,17,78,-61,
19101,166,2022/4/15 20:30,14,46,-32,
19102,166,2022/4/15 20:40,17,100,-83,
19103,166,2022/4/15 20:50,16,95,-79,
19104,166,2022/4/15 21:00,16,13,3,
19105,166,2022/4/15 21:10,16,100,-84,
19106,166,2022/4/15 21:20,15,76,-61,
19107,166,2022/4/15 21:30,15,14,1,
19108,166,2022/4/15 21:40,12,97,-85,
19109,166,2022/4/15 21:50,10,76,-66,
19110,166,2022/4/15 22:00,12,33,-21,
19111,166,2022/4/15 22:10,10,93,-83,
19112,166,2022/4/15 22:20,7,75,-68,
19113,166,2022/4/15 22:30,3,62,-59,
19114,166,2022/4/15 22:40,2,70,-68,
19115,166,2022/4/15 22:50,0,70,-70,
19116,181,2022/4/15 5:00,0,1,-1,-1
19117,181,2022/4/15 5:10,0,1,-1,-1
19118,181,2022/4/15 5:20,0,1,-1,-1
19119,181,2022/4/15 5:30,1,1,0,0
19120,181,2022/4/15 5:40,15,1,14,14
19121,181,2022/4/15 5:50,21,12,9,9
19122,181,2022/4/15 6:00,27,6,21,21
19123,181,2022/4/15 6:10,26,17,9,9
19124,181,2022/4/15 6:20,37,29,8,8
19125,181,2022/4/15 6:30,47,38,9,9
19126,181,2022/4/15 6:40,55,29,26,26
19127,181,2022/4/15 6:50,59,51,8,8
19128,181,2022/4/15 7:00,72,67,5,5
19129,181,2022/4/15 7:10,103,72,31,31
19130,181,2022/4/15 7:20,96,84,12,12
19131,181,2022/4/15 7:30,123,95,28,28
19132,181,2022/4/15 7:40,180,103,77,77
19133,181,2022/4/15 7:50,234,101,133,133
19134,181,2022/4/15 8:00,243,86,157,157
19135,181,2022/4/15 8:10,254,110,144,144
19136,181,2022/4/15 8:20,244,111,133,133
19137,181,2022/4/15 8:30,214,146,68,68
19138,181,2022/4/15 8:40,187,297,-110,-110
19139,181,2022/4/15 8:50,151,180,-29,-29
19140,181,2022/4/15 9:00,76,116,-40,-40
19141,181,2022/4/15 9:10,57,110,-53,-53
19142,181,2022/4/15 9:20,50,133,-83,-83
19143,181,2022/4/15 9:30,41,123,-82,-82
19144,181,2022/4/15 9:40,31,99,-68,-68
19145,181,2022/4/15 9:50,28,112,-84,-84
19146,181,2022/4/15 10:00,29,99,-70,-70
19147,181,2022/4/15 10:10,39,73,-34,-34
19148,181,2022/4/15 10:20,30,84,-54,-54
19149,181,2022/4/15 10:30,30,73,-43,-43
19150,181,2022/4/15 10:40,28,73,-45,-45
19151,181,2022/4/15 10:50,28,69,-41,-41
19152,181,2022/4/15 11:00,28,71,-43,-43
19153,181,2022/4/15 11:10,29,66,-37,-37
19154,181,2022/4/15 11:20,27,59,-32,-32
19155,181,2022/4/15 11:30,27,73,-46,-46
19156,181,2022/4/15 11:40,29,66,-37,-37
19157,181,2022/4/15 11:50,27,72,-45,-45
19158,181,2022/4/15 12:00,30,67,-37,-37
19159,181,2022/4/15 12:10,32,55,-23,-23
19160,181,2022/4/15 12:20,27,77,-50,-50
19161,181,2022/4/15 12:30,28,58,-30,-30
19162,181,2022/4/15 12:40,33,79,-46,-46
19163,181,2022/4/15 12:50,30,73,-43,-43
19164,181,2022/4/15 13:00,24,71,-47,-47
19165,181,2022/4/15 13:10,29,78,-49,-49
19166,181,2022/4/15 13:20,27,70,-43,-43
19167,181,2022/4/15 13:30,30,93,-63,-63
19168,181,2022/4/15 13:40,28,67,-39,-39
19169,181,2022/4/15 13:50,28,77,-49,-49
19170,181,2022/4/15 14:00,28,72,-44,-44
19171,181,2022/4/15 14:10,31,70,-39,-39
19172,181,2022/4/15 14:20,28,69,-41,-41
19173,181,2022/4/15 14:30,23,67,-44,-44
19174,181,2022/4/15 14:40,24,83,-59,-59
19175,181,2022/4/15 14:50,26,67,-41,-41
19176,181,2022/4/15 15:00,31,77,-46,-46
19177,181,2022/4/15 15:10,29,72,-43,-43
19178,181,2022/4/15 15:20,28,69,-41,-41
19179,181,2022/4/15 15:30,32,88,-56,-56
19180,181,2022/4/15 15:40,26,71,-45,-45
19181,181,2022/4/15 15:50,30,81,-51,-51
19182,181,2022/4/15 16:00,37,66,-29,-29
19183,181,2022/4/15 16:10,45,77,-32,-32
19184,181,2022/4/15 16:20,42,91,-49,-49
19185,181,2022/4/15 16:30,46,85,-39,-39
19186,181,2022/4/15 16:40,45,87,-42,-42
19187,181,2022/4/15 16:50,42,105,-63,-63
19188,181,2022/4/15 17:00,167,113,54,54
19189,181,2022/4/15 17:10,186,105,81,81
19190,181,2022/4/15 17:20,93,99,-6,-6
19191,181,2022/4/15 17:30,96,123,-27,-27
19192,181,2022/4/15 17:40,224,117,107,107
19193,181,2022/4/15 17:50,156,109,47,47
19194,181,2022/4/15 18:00,143,119,24,24
19195,181,2022/4/15 18:10,223,111,112,112
19196,181,2022/4/15 18:20,174,111,63,63
19197,181,2022/4/15 18:30,102,124,-22,-22
19198,181,2022/4/15 18:40,77,128,-51,-51
19199,181,2022/4/15 18:50,49,111,-62,-62
19200,181,2022/4/15 19:00,46,125,-79,-79
19201,181,2022/4/15 19:10,50,107,-57,-57
19202,181,2022/4/15 19:20,39,115,-76,-76
19203,181,2022/4/15 19:30,32,95,-63,-63
19204,181,2022/4/15 19:40,29,78,-49,-49
19205,181,2022/4/15 19:50,28,77,-49,-49
19206,181,2022/4/15 20:00,29,71,-42,-42
19207,181,2022/4/15 20:10,25,87,-62,-62
19208,181,2022/4/15 20:20,27,66,-39,-39
19209,181,2022/4/15 20:30,27,74,-47,-47
19210,181,2022/4/15 20:40,29,78,-49,-49
19211,181,2022/4/15 20:50,29,77,-48,-48
19212,181,2022/4/15 21:00,25,74,-49,-49
19213,181,2022/4/15 21:10,27,78,-51,-51
19214,181,2022/4/15 21:20,21,68,-47,-47
19215,181,2022/4/15 21:30,22,83,-61,-61
19216,181,2022/4/15 21:40,22,78,-56,-56
19217,181,2022/4/15 21:50,23,70,-47,-47
19218,181,2022/4/15 22:00,23,76,-53,-53
19219,181,2022/4/15 22:10,19,67,-48,-48
19220,181,2022/4/15 22:20,10,66,-56,-56
19221,181,2022/4/15 22:30,11,67,-56,-56
19222,181,2022/4/15 22:40,8,56,-48,-48
19223,181,2022/4/15 22:50,5,62,-57,-57
19224,183,2022/4/15 5:00,0,1,-1,
19225,183,2022/4/15 5:10,0,1,-1,
19226,183,2022/4/15 5:20,0,1,-1,
19227,183,2022/4/15 5:30,5,1,4,
19228,183,2022/4/15 5:40,22,1,21,
19229,183,2022/4/15 5:50,44,8,36,
19230,183,2022/4/15 6:00,38,11,27,
19231,183,2022/4/15 6:10,51,23,28,
19232,183,2022/4/15 6:20,58,38,20,
19233,183,2022/4/15 6:30,84,45,39,
19234,183,2022/4/15 6:40,87,40,47,
19235,183,2022/4/15 6:50,226,82,144,
19236,183,2022/4/15 7:00,240,75,165,
19237,183,2022/4/15 7:10,281,110,171,
19238,183,2022/4/15 7:20,317,113,204,
19239,183,2022/4/15 7:30,567,106,461,
19240,183,2022/4/15 7:40,654,122,532,
19241,183,2022/4/15 7:50,685,133,552,
19242,183,2022/4/15 8:00,740,152,588,
19243,183,2022/4/15 8:10,741,267,474,
19244,183,2022/4/15 8:20,699,215,484,
19245,183,2022/4/15 8:30,631,231,400,
19246,183,2022/4/15 8:40,598,378,220,
19247,183,2022/4/15 8:50,349,321,28,
19248,183,2022/4/15 9:00,275,192,83,
19249,183,2022/4/15 9:10,236,146,90,
19250,183,2022/4/15 9:20,215,111,104,
19251,183,2022/4/15 9:30,166,109,57,
19252,183,2022/4/15 9:40,115,108,7,
19253,183,2022/4/15 9:50,71,122,-51,
19254,183,2022/4/15 10:00,62,93,-31,
19255,183,2022/4/15 10:10,54,108,-54,
19256,183,2022/4/15 10:20,53,81,-28,
19257,183,2022/4/15 10:30,47,92,-45,
19258,183,2022/4/15 10:40,44,84,-40,
19259,183,2022/4/15 10:50,45,91,-46,
19260,183,2022/4/15 11:00,45,99,-54,
19261,183,2022/4/15 11:10,43,69,-26,
19262,183,2022/4/15 11:20,44,110,-66,
19263,183,2022/4/15 11:30,43,76,-33,
19264,183,2022/4/15 11:40,41,102,-61,
19265,183,2022/4/15 11:50,41,99,-58,
19266,183,2022/4/15 12:00,46,88,-42,
19267,183,2022/4/15 12:10,45,106,-61,
19268,183,2022/4/15 12:20,48,75,-27,
19269,183,2022/4/15 12:30,48,112,-64,
19270,183,2022/4/15 12:40,49,93,-44,
19271,183,2022/4/15 12:50,48,106,-58,
19272,183,2022/4/15 13:00,54,105,-51,
19273,183,2022/4/15 13:10,48,93,-45,
19274,183,2022/4/15 13:20,44,108,-64,
19275,183,2022/4/15 13:30,47,84,-37,
19276,183,2022/4/15 13:40,43,97,-54,
19277,183,2022/4/15 13:50,42,93,-51,
19278,183,2022/4/15 14:00,45,104,-59,
19279,183,2022/4/15 14:10,42,105,-63,
19280,183,2022/4/15 14:20,44,93,-49,
19281,183,2022/4/15 14:30,46,105,-59,
19282,183,2022/4/15 14:40,44,87,-43,
19283,183,2022/4/15 14:50,43,100,-57,
19284,183,2022/4/15 15:00,46,100,-54,
19285,183,2022/4/15 15:10,60,104,-44,
19286,183,2022/4/15 15:20,59,107,-48,
19287,183,2022/4/15 15:30,53,106,-53,
19288,183,2022/4/15 15:40,57,118,-61,
19289,183,2022/4/15 15:50,55,103,-48,
19290,183,2022/4/15 16:00,76,121,-45,
19291,183,2022/4/15 16:10,64,121,-57,
19292,183,2022/4/15 16:20,67,118,-51,
19293,183,2022/4/15 16:30,74,108,-34,
19294,183,2022/4/15 16:40,133,107,26,
19295,183,2022/4/15 16:50,160,154,6,
19296,183,2022/4/15 17:00,207,115,92,
19297,183,2022/4/15 17:10,269,182,87,
19298,183,2022/4/15 17:20,216,221,-5,
19299,183,2022/4/15 17:30,224,296,-72,
19300,183,2022/4/15 17:40,375,317,58,
19301,183,2022/4/15 17:50,273,330,-57,
19302,183,2022/4/15 18:00,214,378,-164,
19303,183,2022/4/15 18:10,293,380,-87,
19304,183,2022/4/15 18:20,243,429,-186,
19305,183,2022/4/15 18:30,177,381,-204,
19306,183,2022/4/15 18:40,157,319,-162,
19307,183,2022/4/15 18:50,138,319,-181,
19308,183,2022/4/15 19:00,77,198,-121,
19309,183,2022/4/15 19:10,55,223,-168,
19310,183,2022/4/15 19:20,47,146,-99,
19311,183,2022/4/15 19:30,42,119,-77,
19312,183,2022/4/15 19:40,44,111,-67,
19313,183,2022/4/15 19:50,39,126,-87,
19314,183,2022/4/15 20:00,41,113,-72,
19315,183,2022/4/15 20:10,43,113,-70,
19316,183,2022/4/15 20:20,37,129,-92,
19317,183,2022/4/15 20:30,41,104,-63,
19318,183,2022/4/15 20:40,36,126,-90,
19319,183,2022/4/15 20:50,38,110,-72,
19320,183,2022/4/15 21:00,37,111,-74,
19321,183,2022/4/15 21:10,42,109,-67,
19322,183,2022/4/15 21:20,35,122,-87,
19323,183,2022/4/15 21:30,33,106,-73,
19324,183,2022/4/15 21:40,31,113,-82,
19325,183,2022/4/15 21:50,31,115,-84,
19326,183,2022/4/15 22:00,28,106,-78,
19327,183,2022/4/15 22:10,24,110,-86,
19328,183,2022/4/15 22:20,22,94,-72,
19329,183,2022/4/15 22:30,13,108,-95,
19330,183,2022/4/15 22:40,10,90,-80,
19331,183,2022/4/15 22:50,4,67,-63,
19332,178,2022/4/15 5:00,0,1,-1,
19333,178,2022/4/15 5:10,0,1,-1,
19334,178,2022/4/15 5:20,0,1,-1,
19335,178,2022/4/15 5:30,10,1,9,
19336,178,2022/4/15 5:40,23,1,22,
19337,178,2022/4/15 5:50,42,5,37,
19338,178,2022/4/15 6:00,33,29,4,
19339,178,2022/4/15 6:10,53,25,28,
19340,178,2022/4/15 6:20,53,45,8,
19341,178,2022/4/15 6:30,65,64,1,
19342,178,2022/4/15 6:40,101,77,24,
19343,178,2022/4/15 6:50,176,102,74,
19344,178,2022/4/15 7:00,215,101,114,
19345,178,2022/4/15 7:10,244,118,126,
19346,178,2022/4/15 7:20,300,110,190,
19347,178,2022/4/15 7:30,347,192,155,
19348,178,2022/4/15 7:40,598,298,300,
19349,178,2022/4/15 7:50,596,327,269,
19350,178,2022/4/15 8:00,663,424,239,
19351,178,2022/4/15 8:10,664,470,194,
19352,178,2022/4/15 8:20,664,564,100,
19353,178,2022/4/15 8:30,474,1085,-611,
19354,178,2022/4/15 8:40,367,1507,-1140,
19355,178,2022/4/15 8:50,361,1671,-1310,
19356,178,2022/4/15 9:00,273,1136,-863,
19357,178,2022/4/15 9:10,220,571,-351,
19358,178,2022/4/15 9:20,200,479,-279,
19359,178,2022/4/15 9:30,179,498,-319,
19360,178,2022/4/15 9:40,136,431,-295,
19361,178,2022/4/15 9:50,108,254,-146,
19362,178,2022/4/15 10:00,76,146,-70,
19363,178,2022/4/15 10:10,75,124,-49,
19364,178,2022/4/15 10:20,72,108,-36,
19365,178,2022/4/15 10:30,63,116,-53,
19366,178,2022/4/15 10:40,60,112,-52,
19367,178,2022/4/15 10:50,52,124,-72,
19368,178,2022/4/15 11:00,66,114,-48,
19369,178,2022/4/15 11:10,66,99,-33,
19370,178,2022/4/15 11:20,68,100,-32,
19371,178,2022/4/15 11:30,71,105,-34,
19372,178,2022/4/15 11:40,69,114,-45,
19373,178,2022/4/15 11:50,76,102,-26,
19374,178,2022/4/15 12:00,92,108,-16,
19375,178,2022/4/15 12:10,86,121,-35,
19376,178,2022/4/15 12:20,92,105,-13,
19377,178,2022/4/15 12:30,74,119,-45,
19378,178,2022/4/15 12:40,78,125,-47,
19379,178,2022/4/15 12:50,71,115,-44,
19380,178,2022/4/15 13:00,76,123,-47,
19381,178,2022/4/15 13:10,77,116,-39,
19382,178,2022/4/15 13:20,77,124,-47,
19383,178,2022/4/15 13:30,86,103,-17,
19384,178,2022/4/15 13:40,78,112,-34,
19385,178,2022/4/15 13:50,76,106,-30,
19386,178,2022/4/15 14:00,75,114,-39,
19387,178,2022/4/15 14:10,89,123,-34,
19388,178,2022/4/15 14:20,77,113,-36,
19389,178,2022/4/15 14:30,75,122,-47,
19390,178,2022/4/15 14:40,75,108,-33,
19391,178,2022/4/15 14:50,73,124,-51,
19392,178,2022/4/15 15:00,103,106,-3,
19393,178,2022/4/15 15:10,128,125,3,
19394,178,2022/4/15 15:20,126,120,6,
19395,178,2022/4/15 15:30,113,124,-11,
19396,178,2022/4/15 15:40,138,126,12,
19397,178,2022/4/15 15:50,132,123,9,
19398,178,2022/4/15 16:00,175,126,49,
19399,178,2022/4/15 16:10,194,107,87,
19400,178,2022/4/15 16:20,200,105,95,
19401,178,2022/4/15 16:30,235,107,128,
19402,178,2022/4/15 16:40,221,109,112,
19403,178,2022/4/15 16:50,289,144,145,
19404,178,2022/4/15 17:00,674,137,537,
19405,178,2022/4/15 17:10,713,151,562,
19406,178,2022/4/15 17:20,637,216,421,
19407,178,2022/4/15 17:30,837,195,642,
19408,178,2022/4/15 17:40,1158,254,904,
19409,178,2022/4/15 17:50,667,322,345,
19410,178,2022/4/15 18:00,668,336,332,
19411,178,2022/4/15 18:10,1158,336,822,
19412,178,2022/4/15 18:20,711,328,383,
19413,178,2022/4/15 18:30,577,335,242,
19414,178,2022/4/15 18:40,422,301,121,
19415,178,2022/4/15 18:50,314,301,13,
19416,178,2022/4/15 19:00,273,209,64,
19417,178,2022/4/15 19:10,226,184,42,
19418,178,2022/4/15 19:20,209,144,65,
19419,178,2022/4/15 19:30,175,111,64,
19420,178,2022/4/15 19:40,149,117,32,
19421,178,2022/4/15 19:50,129,124,5,
19422,178,2022/4/15 20:00,102,108,-6,
19423,178,2022/4/15 20:10,129,102,27,
19424,178,2022/4/15 20:20,73,112,-39,
19425,178,2022/4/15 20:30,75,124,-49,
19426,178,2022/4/15 20:40,74,102,-28,
19427,178,2022/4/15 20:50,73,106,-33,
19428,178,2022/4/15 21:00,69,124,-55,
19429,178,2022/4/15 21:10,86,106,-20,
19430,178,2022/4/15 21:20,63,107,-44,
19431,178,2022/4/15 21:30,48,124,-76,
19432,178,2022/4/15 21:40,47,112,-65,
19433,178,2022/4/15 21:50,39,99,-60,
19434,178,2022/4/15 22:00,40,107,-67,
19435,178,2022/4/15 22:10,35,91,-56,
19436,178,2022/4/15 22:20,31,92,-61,
19437,178,2022/4/15 22:30,24,123,-99,
19438,178,2022/4/15 22:40,15,103,-88,
19439,178,2022/4/15 22:50,11,70,-59,
19440,192,2022/4/15 5:00,0,1,-1,
19441,192,2022/4/15 5:10,0,1,-1,
19442,192,2022/4/15 5:20,0,1,-1,
19443,192,2022/4/15 5:30,1,1,0,
19444,192,2022/4/15 5:40,36,1,35,
19445,192,2022/4/15 5:50,54,21,33,
19446,192,2022/4/15 6:00,47,19,28,
19447,192,2022/4/15 6:10,66,33,33,
19448,192,2022/4/15 6:20,87,64,23,
19449,192,2022/4/15 6:30,120,59,61,
19450,192,2022/4/15 6:40,186,76,110,
19451,192,2022/4/15 6:50,215,105,110,
19452,192,2022/4/15 7:00,268,115,153,
19453,192,2022/4/15 7:10,346,122,224,
19454,192,2022/4/15 7:20,383,133,250,
19455,192,2022/4/15 7:30,593,178,415,
19456,192,2022/4/15 7:40,662,219,443,
19457,192,2022/4/15 7:50,741,346,395,
19458,192,2022/4/15 8:00,1043,419,624,
19459,192,2022/4/15 8:10,859,478,381,
19460,192,2022/4/15 8:20,862,577,285,
19461,192,2022/4/15 8:30,678,422,256,
19462,192,2022/4/15 8:40,599,420,179,
19463,192,2022/4/15 8:50,435,421,14,
19464,192,2022/4/15 9:00,347,364,-17,
19465,192,2022/4/15 9:10,261,207,54,
19466,192,2022/4/15 9:20,222,191,31,
19467,192,2022/4/15 9:30,182,133,49,
19468,192,2022/4/15 9:40,103,109,-6,
19469,192,2022/4/15 9:50,104,118,-14,
19470,192,2022/4/15 10:00,73,98,-25,
19471,192,2022/4/15 10:10,63,87,-24,
19472,192,2022/4/15 10:20,67,117,-50,
19473,192,2022/4/15 10:30,62,92,-30,
19474,192,2022/4/15 10:40,44,97,-53,
19475,192,2022/4/15 10:50,47,104,-57,
19476,192,2022/4/15 11:00,45,97,-52,
19477,192,2022/4/15 11:10,43,105,-62,
19478,192,2022/4/15 11:20,54,82,-28,
19479,192,2022/4/15 11:30,54,103,-49,
19480,192,2022/4/15 11:40,51,85,-34,
19481,192,2022/4/15 11:50,62,88,-26,
19482,192,2022/4/15 12:00,59,105,-46,
19483,192,2022/4/15 12:10,70,77,-7,
19484,192,2022/4/15 12:20,63,108,-45,
19485,192,2022/4/15 12:30,64,93,-29,
19486,192,2022/4/15 12:40,65,100,-35,
19487,192,2022/4/15 12:50,48,91,-43,
19488,192,2022/4/15 13:00,47,109,-62,
19489,192,2022/4/15 13:10,50,97,-47,
19490,192,2022/4/15 13:20,59,88,-29,
19491,192,2022/4/15 13:30,45,102,-57,
19492,192,2022/4/15 13:40,57,88,-31,
19493,192,2022/4/15 13:50,41,123,-82,
19494,192,2022/4/15 14:00,52,76,-24,
19495,192,2022/4/15 14:10,47,106,-59,
19496,192,2022/4/15 14:20,45,105,-60,
19497,192,2022/4/15 14:30,47,90,-43,
19498,192,2022/4/15 14:40,44,104,-60,
19499,192,2022/4/15 14:50,52,87,-35,
19500,192,2022/4/15 15:00,59,106,-47,
19501,192,2022/4/15 15:10,64,94,-30,
19502,192,2022/4/15 15:20,64,110,-46,
19503,192,2022/4/15 15:30,64,118,-54,
19504,192,2022/4/15 15:40,64,97,-33,
19505,192,2022/4/15 15:50,83,121,-38,
19506,192,2022/4/15 16:00,83,95,-12,
19507,192,2022/4/15 16:10,175,124,51,
19508,192,2022/4/15 16:20,197,102,95,
19509,192,2022/4/15 16:30,198,108,90,
19510,192,2022/4/15 16:40,238,103,135,
19511,192,2022/4/15 16:50,237,121,116,
19512,192,2022/4/15 17:00,315,138,177,
19513,192,2022/4/15 17:10,352,138,214,
19514,192,2022/4/15 17:20,347,212,135,
19515,192,2022/4/15 17:30,577,233,344,
19516,192,2022/4/15 17:40,1032,197,835,
19517,192,2022/4/15 17:50,621,326,295,
19518,192,2022/4/15 18:00,335,327,8,
19519,192,2022/4/15 18:10,462,347,115,
19520,192,2022/4/15 18:20,271,348,-77,
19521,192,2022/4/15 18:30,224,348,-124,
19522,192,2022/4/15 18:40,181,326,-145,
19523,192,2022/4/15 18:50,144,322,-178,
19524,192,2022/4/15 19:00,74,234,-160,
19525,192,2022/4/15 19:10,67,199,-132,
19526,192,2022/4/15 19:20,59,137,-78,
19527,192,2022/4/15 19:30,46,116,-70,
19528,192,2022/4/15 19:40,45,110,-65,
19529,192,2022/4/15 19:50,40,110,-70,
19530,192,2022/4/15 20:00,40,123,-83,
19531,192,2022/4/15 20:10,33,113,-80,
19532,192,2022/4/15 20:20,34,115,-81,
19533,192,2022/4/15 20:30,37,121,-84,
19534,192,2022/4/15 20:40,32,111,-79,
19535,192,2022/4/15 20:50,26,108,-82,
19536,192,2022/4/15 21:00,27,118,-91,
19537,192,2022/4/15 21:10,29,103,-74,
19538,192,2022/4/15 21:20,25,125,-100,
19539,192,2022/4/15 21:30,24,122,-98,
19540,192,2022/4/15 21:40,25,108,-83,
19541,192,2022/4/15 21:50,21,102,-81,
19542,192,2022/4/15 22:00,20,120,-100,
19543,192,2022/4/15 22:10,17,103,-86,
19544,192,2022/4/15 22:20,15,85,-70,
19545,192,2022/4/15 22:30,9,122,-113,
19546,192,2022/4/15 22:40,6,102,-96,
19547,192,2022/4/15 22:50,3,77,-74,
19548,187,2022/4/15 5:00,0,1,-1,
19549,187,2022/4/15 5:10,0,1,-1,
19550,187,2022/4/15 5:20,0,1,-1,
19551,187,2022/4/15 5:30,7,1,6,
19552,187,2022/4/15 5:40,23,1,22,
19553,187,2022/4/15 5:50,32,16,16,
19554,187,2022/4/15 6:00,31,38,-7,
19555,187,2022/4/15 6:10,35,38,-3,
19556,187,2022/4/15 6:20,45,59,-14,
19557,187,2022/4/15 6:30,54,70,-16,
19558,187,2022/4/15 6:40,76,126,-50,
19559,187,2022/4/15 6:50,108,110,-2,
19560,187,2022/4/15 7:00,182,143,39,
19561,187,2022/4/15 7:10,191,144,47,
19562,187,2022/4/15 7:20,226,158,68,
19563,187,2022/4/15 7:30,280,196,84,
19564,187,2022/4/15 7:40,324,324,0,
19565,187,2022/4/15 7:50,475,426,49,
19566,187,2022/4/15 8:00,630,1038,-408,
19567,187,2022/4/15 8:10,598,1429,-831,
19568,187,2022/4/15 8:20,600,1570,-970,
19569,187,2022/4/15 8:30,475,1569,-1094,
19570,187,2022/4/15 8:40,315,1408,-1093,
19571,187,2022/4/15 8:50,318,1912,-1594,
19572,187,2022/4/15 9:00,292,1558,-1266,
19573,187,2022/4/15 9:10,240,617,-377,
19574,187,2022/4/15 9:20,210,394,-184,
19575,187,2022/4/15 9:30,144,333,-189,
19576,187,2022/4/15 9:40,148,252,-104,
19577,187,2022/4/15 9:50,106,190,-84,
19578,187,2022/4/15 10:00,66,99,-33,
19579,187,2022/4/15 10:10,64,110,-46,
19580,187,2022/4/15 10:20,67,109,-42,
19581,187,2022/4/15 10:30,58,100,-42,
19582,187,2022/4/15 10:40,55,105,-50,
19583,187,2022/4/15 10:50,58,112,-54,
19584,187,2022/4/15 11:00,51,105,-54,
19585,187,2022/4/15 11:10,64,105,-41,
19586,187,2022/4/15 11:20,60,98,-38,
19587,187,2022/4/15 11:30,62,108,-46,
19588,187,2022/4/15 11:40,65,103,-38,
19589,187,2022/4/15 11:50,68,106,-38,
19590,187,2022/4/15 12:00,62,111,-49,
19591,187,2022/4/15 12:10,74,105,-31,
19592,187,2022/4/15 12:20,77,106,-29,
19593,187,2022/4/15 12:30,72,108,-36,
19594,187,2022/4/15 12:40,65,105,-40,
19595,187,2022/4/15 12:50,72,120,-48,
19596,187,2022/4/15 13:00,68,104,-36,
19597,187,2022/4/15 13:10,68,97,-29,
19598,187,2022/4/15 13:20,65,126,-61,
19599,187,2022/4/15 13:30,64,105,-41,
19600,187,2022/4/15 13:40,70,104,-34,
19601,187,2022/4/15 13:50,62,106,-44,
19602,187,2022/4/15 14:00,66,108,-42,
19603,187,2022/4/15 14:10,62,118,-56,
19604,187,2022/4/15 14:20,65,108,-43,
19605,187,2022/4/15 14:30,58,109,-51,
19606,187,2022/4/15 14:40,65,108,-43,
19607,187,2022/4/15 14:50,72,103,-31,
19608,187,2022/4/15 15:00,74,105,-31,
19609,187,2022/4/15 15:10,113,113,0,
19610,187,2022/4/15 15:20,94,109,-15,
19611,187,2022/4/15 15:30,99,108,-9,
19612,187,2022/4/15 15:40,79,124,-45,
19613,187,2022/4/15 15:50,85,105,-20,
19614,187,2022/4/15 16:00,111,101,10,
19615,187,2022/4/15 16:10,133,108,25,
19616,187,2022/4/15 16:20,170,103,67,
19617,187,2022/4/15 16:30,206,111,95,
19618,187,2022/4/15 16:40,238,106,132,
19619,187,2022/4/15 16:50,262,113,149,
19620,187,2022/4/15 17:00,423,115,308,
19621,187,2022/4/15 17:10,804,124,680,
19622,187,2022/4/15 17:20,788,152,636,
19623,187,2022/4/15 17:30,842,178,664,
19624,187,2022/4/15 17:40,1353,190,1163,
19625,187,2022/4/15 17:50,1156,207,949,
19626,187,2022/4/15 18:00,813,255,558,
19627,187,2022/4/15 18:10,1198,226,972,
19628,187,2022/4/15 18:20,837,285,552,
19629,187,2022/4/15 18:30,639,257,382,
19630,187,2022/4/15 18:40,568,218,350,
19631,187,2022/4/15 18:50,311,208,103,
19632,187,2022/4/15 19:00,269,224,45,
19633,187,2022/4/15 19:10,265,127,138,
19634,187,2022/4/15 19:20,208,116,92,
19635,187,2022/4/15 19:30,162,111,51,
19636,187,2022/4/15 19:40,177,126,51,
19637,187,2022/4/15 19:50,133,100,33,
19638,187,2022/4/15 20:00,109,78,31,
19639,187,2022/4/15 20:10,109,106,3,
19640,187,2022/4/15 20:20,80,103,-23,
19641,187,2022/4/15 20:30,80,82,-2,
19642,187,2022/4/15 20:40,84,123,-39,
19643,187,2022/4/15 20:50,77,110,-33,
19644,187,2022/4/15 21:00,71,102,-31,
19645,187,2022/4/15 21:10,74,104,-30,
19646,187,2022/4/15 21:20,56,107,-51,
19647,187,2022/4/15 21:30,53,101,-48,
19648,187,2022/4/15 21:40,43,123,-80,
19649,187,2022/4/15 21:50,39,102,-63,
19650,187,2022/4/15 22:00,39,93,-54,
19651,187,2022/4/15 22:10,25,113,-88,
19652,187,2022/4/15 22:20,26,102,-76,
19653,187,2022/4/15 22:30,25,79,-54,
19654,187,2022/4/15 22:40,19,78,-59,
19655,187,2022/4/15 22:50,8,66,-58,
19656,190,2022/4/15 5:00,5,1,4,
19657,190,2022/4/15 5:10,11,1,10,
19658,190,2022/4/15 5:20,20,1,19,
19659,190,2022/4/15 5:30,24,2,22,
19660,190,2022/4/15 5:40,30,11,19,
19661,190,2022/4/15 5:50,36,16,20,
19662,190,2022/4/15 6:00,45,48,-3,
19663,190,2022/4/15 6:10,53,74,-21,
19664,190,2022/4/15 6:20,66,98,-32,
19665,190,2022/4/15 6:30,112,107,5,
19666,190,2022/4/15 6:40,184,110,74,
19667,190,2022/4/15 6:50,231,197,34,
19668,190,2022/4/15 7:00,281,342,-61,
19669,190,2022/4/15 7:10,319,378,-59,
19670,190,2022/4/15 7:20,566,436,130,
19671,190,2022/4/15 7:30,686,557,129,
19672,190,2022/4/15 7:40,1059,1590,-531,
19673,190,2022/4/15 7:50,1366,1821,-455,
19674,190,2022/4/15 8:00,1577,2818,-1241,
19675,190,2022/4/15 8:10,1979,4730,-2751,
19676,190,2022/4/15 8:20,1577,3610,-2033,
19677,190,2022/4/15 8:30,1572,6277,-4705,
19678,190,2022/4/15 8:40,1213,6301,-5088,
19679,190,2022/4/15 8:50,865,3497,-2632,
19680,190,2022/4/15 9:00,726,2594,-1868,
19681,190,2022/4/15 9:10,673,1504,-831,
19682,190,2022/4/15 9:20,582,554,28,
19683,190,2022/4/15 9:30,467,428,39,
19684,190,2022/4/15 9:40,330,374,-44,
19685,190,2022/4/15 9:50,320,322,-2,
19686,190,2022/4/15 10:00,269,268,1,
19687,190,2022/4/15 10:10,253,227,26,
19688,190,2022/4/15 10:20,240,181,59,
19689,190,2022/4/15 10:30,240,179,61,
19690,190,2022/4/15 10:40,216,192,24,
19691,190,2022/4/15 10:50,212,147,65,
19692,190,2022/4/15 11:00,216,192,24,
19693,190,2022/4/15 11:10,225,150,75,
19694,190,2022/4/15 11:20,224,192,32,
19695,190,2022/4/15 11:30,223,192,31,
19696,190,2022/4/15 11:40,238,214,24,
19697,190,2022/4/15 11:50,232,192,40,
19698,190,2022/4/15 12:00,227,154,73,
19699,190,2022/4/15 12:10,242,192,50,
19700,190,2022/4/15 12:20,222,180,42,
19701,190,2022/4/15 12:30,260,178,82,
19702,190,2022/4/15 12:40,257,214,43,
19703,190,2022/4/15 12:50,269,179,90,
19704,190,2022/4/15 13:00,271,198,73,
19705,190,2022/4/15 13:10,272,213,59,
19706,190,2022/4/15 13:20,269,233,36,
19707,190,2022/4/15 13:30,274,180,94,
19708,190,2022/4/15 13:40,272,219,53,
19709,190,2022/4/15 13:50,275,180,95,
19710,190,2022/4/15 14:00,270,198,72,
19711,190,2022/4/15 14:10,272,226,46,
19712,190,2022/4/15 14:20,267,180,87,
19713,190,2022/4/15 14:30,267,213,54,
19714,190,2022/4/15 14:40,271,214,57,
19715,190,2022/4/15 14:50,274,197,77,
19716,190,2022/4/15 15:00,267,198,69,
19717,190,2022/4/15 15:10,330,180,150,
19718,190,2022/4/15 15:20,331,208,123,
19719,190,2022/4/15 15:30,343,179,164,
19720,190,2022/4/15 15:40,428,198,230,
19721,190,2022/4/15 15:50,335,214,121,
19722,190,2022/4/15 16:00,309,232,77,
19723,190,2022/4/15 16:10,350,180,170,
19724,190,2022/4/15 16:20,351,231,120,
19725,190,2022/4/15 16:30,554,218,336,
19726,190,2022/4/15 16:40,648,196,452,
19727,190,2022/4/15 16:50,661,300,361,
19728,190,2022/4/15 17:00,1147,330,817,
19729,190,2022/4/15 17:10,1977,376,1601,
19730,190,2022/4/15 17:20,1341,415,926,
19731,190,2022/4/15 17:30,1583,423,1160,
19732,190,2022/4/15 17:40,3341,484,2857,
19733,190,2022/4/15 17:50,2528,622,1906,
19734,190,2022/4/15 18:00,1979,1126,853,
19735,190,2022/4/15 18:10,3311,1138,2173,
19736,190,2022/4/15 18:20,2513,1130,1383,
19737,190,2022/4/15 18:30,1560,1134,426,
19738,190,2022/4/15 18:40,1190,1140,50,
19739,190,2022/4/15 18:50,822,568,254,
19740,190,2022/4/15 19:00,702,430,272,
19741,190,2022/4/15 19:10,637,501,136,
19742,190,2022/4/15 19:20,575,320,255,
19743,190,2022/4/15 19:30,462,321,141,
19744,190,2022/4/15 19:40,369,256,113,
19745,190,2022/4/15 19:50,376,207,169,
19746,190,2022/4/15 20:00,358,184,174,
19747,190,2022/4/15 20:10,320,159,161,
19748,190,2022/4/15 20:20,354,154,200,
19749,190,2022/4/15 20:30,350,152,198,
19750,190,2022/4/15 20:40,427,150,277,
19751,190,2022/4/15 20:50,554,153,401,
19752,190,2022/4/15 21:00,558,117,441,
19753,190,2022/4/15 21:10,579,153,426,
19754,190,2022/4/15 21:20,434,141,293,
19755,190,2022/4/15 21:30,357,184,173,
19756,190,2022/4/15 21:40,265,169,96,
19757,190,2022/4/15 21:50,223,126,97,
19758,190,2022/4/15 22:00,200,119,81,
19759,190,2022/4/15 22:10,130,123,7,
19760,190,2022/4/15 22:20,62,113,-51,
19761,190,2022/4/15 22:30,43,112,-69,
19762,190,2022/4/15 22:40,26,99,-73,
19763,190,2022/4/15 22:50,26,100,-74,
19764,186,2022/4/15 5:00,0,1,-1,
19765,186,2022/4/15 5:10,0,1,-1,
19766,186,2022/4/15 5:20,0,1,-1,
19767,186,2022/4/15 5:30,2,1,1,
19768,186,2022/4/15 5:40,7,1,6,
19769,186,2022/4/15 5:50,9,14,-5,
19770,186,2022/4/15 6:00,8,33,-25,
19771,186,2022/4/15 6:10,11,46,-35,
19772,186,2022/4/15 6:20,15,47,-32,
19773,186,2022/4/15 6:30,18,71,-53,
19774,186,2022/4/15 6:40,20,73,-53,
19775,186,2022/4/15 6:50,24,70,-46,
19776,186,2022/4/15 7:00,26,107,-81,
19777,186,2022/4/15 7:10,29,122,-93,
19778,186,2022/4/15 7:20,32,158,-126,
19779,186,2022/4/15 7:30,47,297,-250,
19780,186,2022/4/15 7:40,56,415,-359,
19781,186,2022/4/15 7:50,59,1635,-1576,
19782,186,2022/4/15 8:00,83,2125,-2042,
19783,186,2022/4/15 8:10,91,4412,-4321,
19784,186,2022/4/15 8:20,77,4257,-4180,
19785,186,2022/4/15 8:30,75,5743,-5668,
19786,186,2022/4/15 8:40,69,3843,-3774,
19787,186,2022/4/15 8:50,66,4893,-4827,
19788,186,2022/4/15 9:00,44,4317,-4273,
19789,186,2022/4/15 9:10,56,3276,-3220,
19790,186,2022/4/15 9:20,64,1447,-1383,
19791,186,2022/4/15 9:30,51,632,-581,
19792,186,2022/4/15 9:40,47,518,-471,
19793,186,2022/4/15 9:50,51,373,-322,
19794,186,2022/4/15 10:00,48,299,-251,
19795,186,2022/4/15 10:10,60,109,-49,
19796,186,2022/4/15 10:20,54,198,-144,
19797,186,2022/4/15 10:30,59,109,-50,
19798,186,2022/4/15 10:40,59,142,-83,
19799,186,2022/4/15 10:50,71,122,-51,
19800,186,2022/4/15 11:00,75,105,-30,
19801,186,2022/4/15 11:10,67,128,-61,
19802,186,2022/4/15 11:20,69,93,-24,
19803,186,2022/4/15 11:30,86,120,-34,
19804,186,2022/4/15 11:40,107,111,-4,
19805,186,2022/4/15 11:50,76,107,-31,
19806,186,2022/4/15 12:00,82,112,-30,
19807,186,2022/4/15 12:10,89,99,-10,
19808,186,2022/4/15 12:20,69,125,-56,
19809,186,2022/4/15 12:30,69,109,-40,
19810,186,2022/4/15 12:40,67,170,-103,
19811,186,2022/4/15 12:50,70,107,-37,
19812,186,2022/4/15 13:00,75,135,-60,
19813,186,2022/4/15 13:10,84,121,-37,
19814,186,2022/4/15 13:20,88,104,-16,
19815,186,2022/4/15 13:30,97,180,-83,
19816,186,2022/4/15 13:40,91,121,-30,
19817,186,2022/4/15 13:50,85,146,-61,
19818,186,2022/4/15 14:00,88,106,-18,
19819,186,2022/4/15 14:10,132,105,27,
19820,186,2022/4/15 14:20,92,99,-7,
19821,186,2022/4/15 14:30,110,106,4,
19822,186,2022/4/15 14:40,129,120,9,
19823,186,2022/4/15 14:50,133,106,27,
19824,186,2022/4/15 15:00,155,121,34,
19825,186,2022/4/15 15:10,194,101,93,
19826,186,2022/4/15 15:20,179,121,58,
19827,186,2022/4/15 15:30,173,107,66,
19828,186,2022/4/15 15:40,144,105,39,
19829,186,2022/4/15 15:50,179,112,67,
19830,186,2022/4/15 16:00,207,95,112,
19831,186,2022/4/15 16:10,216,118,98,
19832,186,2022/4/15 16:20,225,97,128,
19833,186,2022/4/15 16:30,270,93,177,
19834,186,2022/4/15 16:40,345,105,240,
19835,186,2022/4/15 16:50,338,101,237,
19836,186,2022/4/15 17:00,1021,112,909,
19837,186,2022/4/15 17:10,1605,105,1500,
19838,186,2022/4/15 17:20,1198,109,1089,
19839,186,2022/4/15 17:30,1606,120,1486,
19840,186,2022/4/15 17:40,2550,127,2423,
19841,186,2022/4/15 17:50,1974,107,1867,
19842,186,2022/4/15 18:00,2004,123,1881,
19843,186,2022/4/15 18:10,3328,122,3206,
19844,186,2022/4/15 18:20,2472,124,2348,
19845,186,2022/4/15 18:30,1560,110,1450,
19846,186,2022/4/15 18:40,1146,105,1041,
19847,186,2022/4/15 18:50,799,109,690,
19848,186,2022/4/15 19:00,686,104,582,
19849,186,2022/4/15 19:10,569,80,489,
19850,186,2022/4/15 19:20,326,78,248,
19851,186,2022/4/15 19:30,277,73,204,
19852,186,2022/4/15 19:40,235,74,161,
19853,186,2022/4/15 19:50,197,62,135,
19854,186,2022/4/15 20:00,205,67,138,
19855,186,2022/4/15 20:10,193,53,140,
19856,186,2022/4/15 20:20,175,51,124,
19857,186,2022/4/15 20:30,174,62,112,
19858,186,2022/4/15 20:40,149,42,107,
19859,186,2022/4/15 20:50,102,46,56,
19860,186,2022/4/15 21:00,96,60,36,
19861,186,2022/4/15 21:10,175,47,128,
19862,186,2022/4/15 21:20,116,39,77,
19863,186,2022/4/15 21:30,65,63,2,
19864,186,2022/4/15 21:40,50,39,11,
19865,186,2022/4/15 21:50,37,40,-3,
19866,186,2022/4/15 22:00,35,59,-24,
19867,186,2022/4/15 22:10,36,37,-1,
19868,186,2022/4/15 22:20,28,34,-6,
19869,186,2022/4/15 22:30,18,35,-17,
19870,186,2022/4/15 22:40,17,35,-18,
19871,186,2022/4/15 22:50,3,23,-20,
19872,182,2022/4/15 5:00,0,1,-1,
19873,182,2022/4/15 5:10,0,1,-1,
19874,182,2022/4/15 5:20,0,1,-1,
19875,182,2022/4/15 5:30,7,1,6,
19876,182,2022/4/15 5:40,11,1,10,
19877,182,2022/4/15 5:50,20,16,4,
19878,182,2022/4/15 6:00,24,11,13,
19879,182,2022/4/15 6:10,31,38,-7,
19880,182,2022/4/15 6:20,31,32,-1,
19881,182,2022/4/15 6:30,54,38,16,
19882,182,2022/4/15 6:40,87,58,29,
19883,182,2022/4/15 6:50,89,75,14,
19884,182,2022/4/15 7:00,105,87,18,
19885,182,2022/4/15 7:10,196,111,85,
19886,182,2022/4/15 7:20,222,110,112,
19887,182,2022/4/15 7:30,281,155,126,
19888,182,2022/4/15 7:40,327,112,215,
19889,182,2022/4/15 7:50,573,179,394,
19890,182,2022/4/15 8:00,589,214,375,
19891,182,2022/4/15 8:10,629,504,125,
19892,182,2022/4/15 8:20,594,430,164,
19893,182,2022/4/15 8:30,356,1143,-787,
19894,182,2022/4/15 8:40,325,1143,-818,
19895,182,2022/4/15 8:50,283,596,-313,
19896,182,2022/4/15 9:00,239,425,-186,
19897,182,2022/4/15 9:10,177,490,-313,
19898,182,2022/4/15 9:20,155,330,-175,
19899,182,2022/4/15 9:30,85,221,-136,
19900,182,2022/4/15 9:40,66,169,-103,
19901,182,2022/4/15 9:50,68,131,-63,
19902,182,2022/4/15 10:00,46,103,-57,
19903,182,2022/4/15 10:10,47,103,-56,
19904,182,2022/4/15 10:20,46,97,-51,
19905,182,2022/4/15 10:30,38,104,-66,
19906,182,2022/4/15 10:40,42,92,-50,
19907,182,2022/4/15 10:50,36,93,-57,
19908,182,2022/4/15 11:00,41,76,-35,
19909,182,2022/4/15 11:10,42,93,-51,
19910,182,2022/4/15 11:20,44,83,-39,
19911,182,2022/4/15 11:30,38,96,-58,
19912,182,2022/4/15 11:40,41,96,-55,
19913,182,2022/4/15 11:50,42,87,-45,
19914,182,2022/4/15 12:00,43,92,-49,
19915,182,2022/4/15 12:10,43,87,-44,
19916,182,2022/4/15 12:20,43,93,-50,
19917,182,2022/4/15 12:30,46,99,-53,
19918,182,2022/4/15 12:40,47,110,-63,
19919,182,2022/4/15 12:50,44,106,-62,
19920,182,2022/4/15 13:00,46,93,-47,
19921,182,2022/4/15 13:10,49,106,-57,
19922,182,2022/4/15 13:20,46,106,-60,
19923,182,2022/4/15 13:30,41,101,-60,
19924,182,2022/4/15 13:40,40,102,-62,
19925,182,2022/4/15 13:50,46,101,-55,
19926,182,2022/4/15 14:00,46,109,-63,
19927,182,2022/4/15 14:10,56,101,-45,
19928,182,2022/4/15 14:20,44,100,-56,
19929,182,2022/4/15 14:30,45,93,-48,
19930,182,2022/4/15 14:40,43,96,-53,
19931,182,2022/4/15 14:50,47,108,-61,
19932,182,2022/4/15 15:00,46,93,-47,
19933,182,2022/4/15 15:10,48,111,-63,
19934,182,2022/4/15 15:20,55,97,-42,
19935,182,2022/4/15 15:30,55,112,-57,
19936,182,2022/4/15 15:40,55,102,-47,
19937,182,2022/4/15 15:50,54,109,-55,
19938,182,2022/4/15 16:00,68,106,-38,
19939,182,2022/4/15 16:10,91,97,-6,
19940,182,2022/4/15 16:20,76,110,-34,
19941,182,2022/4/15 16:30,86,85,1,
19942,182,2022/4/15 16:40,132,103,29,
19943,182,2022/4/15 16:50,109,122,-13,
19944,182,2022/4/15 17:00,237,118,119,
19945,182,2022/4/15 17:10,319,115,204,
19946,182,2022/4/15 17:20,257,125,132,
19947,182,2022/4/15 17:30,291,181,110,
19948,182,2022/4/15 17:40,682,190,492,
19949,182,2022/4/15 17:50,576,177,399,
19950,182,2022/4/15 18:00,426,227,199,
19951,182,2022/4/15 18:10,655,213,442,
19952,182,2022/4/15 18:20,668,213,455,
19953,182,2022/4/15 18:30,551,180,371,
19954,182,2022/4/15 18:40,350,215,135,
19955,182,2022/4/15 18:50,275,146,129,
19956,182,2022/4/15 19:00,214,111,103,
19957,182,2022/4/15 19:10,176,123,53,
19958,182,2022/4/15 19:20,103,119,-16,
19959,182,2022/4/15 19:30,69,102,-33,
19960,182,2022/4/15 19:40,66,106,-40,
19961,182,2022/4/15 19:50,55,106,-51,
19962,182,2022/4/15 20:00,46,92,-46,
19963,182,2022/4/15 20:10,54,95,-41,
19964,182,2022/4/15 20:20,42,82,-40,
19965,182,2022/4/15 20:30,45,86,-41,
19966,182,2022/4/15 20:40,47,95,-48,
19967,182,2022/4/15 20:50,44,99,-55,
19968,182,2022/4/15 21:00,43,71,-28,
19969,182,2022/4/15 21:10,48,95,-47,
19970,182,2022/4/15 21:20,38,96,-58,
19971,182,2022/4/15 21:30,34,75,-41,
19972,182,2022/4/15 21:40,31,93,-62,
19973,182,2022/4/15 21:50,30,83,-53,
19974,182,2022/4/15 22:00,25,79,-54,
19975,182,2022/4/15 22:10,27,78,-51,
19976,182,2022/4/15 22:20,17,73,-56,
19977,182,2022/4/15 22:30,16,65,-49,
19978,182,2022/4/15 22:40,12,52,-40,
19979,182,2022/4/15 22:50,4,54,-50,
19980,191,2022/4/15 5:00,0,1,-1,
19981,191,2022/4/15 5:10,0,1,-1,
19982,191,2022/4/15 5:20,3,1,2,
19983,191,2022/4/15 5:30,13,1,12,
19984,191,2022/4/15 5:40,16,16,0,
19985,191,2022/4/15 5:50,22,2,20,
19986,191,2022/4/15 6:00,32,8,24,
19987,191,2022/4/15 6:10,36,60,-24,
19988,191,2022/4/15 6:20,48,41,7,
19989,191,2022/4/15 6:30,65,76,-11,
19990,191,2022/4/15 6:40,85,85,0,
19991,191,2022/4/15 6:50,153,121,32,
19992,191,2022/4/15 7:00,156,133,23,
19993,191,2022/4/15 7:10,207,192,15,
19994,191,2022/4/15 7:20,250,209,41,
19995,191,2022/4/15 7:30,302,234,68,
19996,191,2022/4/15 7:40,599,298,301,
19997,191,2022/4/15 7:50,596,300,296,
19998,191,2022/4/15 8:00,703,318,385,
19999,191,2022/4/15 8:10,736,492,244,
20000,191,2022/4/15 8:20,690,425,265,
20001,191,2022/4/15 8:30,721,426,295,
20002,191,2022/4/15 8:40,573,582,-9,
20003,191,2022/4/15 8:50,324,482,-158,
20004,191,2022/4/15 9:00,312,413,-101,
20005,191,2022/4/15 9:10,275,313,-38,
20006,191,2022/4/15 9:20,227,316,-89,
20007,191,2022/4/15 9:30,209,231,-22,
20008,191,2022/4/15 9:40,173,190,-17,
20009,191,2022/4/15 9:50,141,179,-38,
20010,191,2022/4/15 10:00,131,109,22,
20011,191,2022/4/15 10:10,108,121,-13,
20012,191,2022/4/15 10:20,89,124,-35,
20013,191,2022/4/15 10:30,91,120,-29,
20014,191,2022/4/15 10:40,80,121,-41,
20015,191,2022/4/15 10:50,76,120,-44,
20016,191,2022/4/15 11:00,83,86,-3,
20017,191,2022/4/15 11:10,76,108,-32,
20018,191,2022/4/15 11:20,81,103,-22,
20019,191,2022/4/15 11:30,74,111,-37,
20020,191,2022/4/15 11:40,71,121,-50,
20021,191,2022/4/15 11:50,76,101,-25,
20022,191,2022/4/15 12:00,85,114,-29,
20023,191,2022/4/15 12:10,134,113,21,
20024,191,2022/4/15 12:20,114,114,0,
20025,191,2022/4/15 12:30,101,117,-16,
20026,191,2022/4/15 12:40,103,103,0,
20027,191,2022/4/15 12:50,103,112,-9,
20028,191,2022/4/15 13:00,88,126,-38,
20029,191,2022/4/15 13:10,110,86,24,
20030,191,2022/4/15 13:20,101,111,-10,
20031,191,2022/4/15 13:30,84,102,-18,
20032,191,2022/4/15 13:40,88,181,-93,
20033,191,2022/4/15 13:50,88,114,-26,
20034,191,2022/4/15 14:00,123,128,-5,
20035,191,2022/4/15 14:10,134,104,30,
20036,191,2022/4/15 14:20,116,105,11,
20037,191,2022/4/15 14:30,96,105,-9,
20038,191,2022/4/15 14:40,102,98,4,
20039,191,2022/4/15 14:50,128,128,0,
20040,191,2022/4/15 15:00,132,105,27,
20041,191,2022/4/15 15:10,143,128,15,
20042,191,2022/4/15 15:20,136,120,16,
20043,191,2022/4/15 15:30,154,121,33,
20044,191,2022/4/15 15:40,156,125,31,
20045,191,2022/4/15 15:50,133,125,8,
20046,191,2022/4/15 16:00,177,144,33,
20047,191,2022/4/15 16:10,210,107,103,
20048,191,2022/4/15 16:20,205,121,84,
20049,191,2022/4/15 16:30,269,108,161,
20050,191,2022/4/15 16:40,269,111,158,
20051,191,2022/4/15 16:50,262,153,109,
20052,191,2022/4/15 17:00,326,108,218,
20053,191,2022/4/15 17:10,459,210,249,
20054,191,2022/4/15 17:20,347,280,67,
20055,191,2022/4/15 17:30,336,296,40,
20056,191,2022/4/15 17:40,571,337,234,
20057,191,2022/4/15 17:50,348,378,-30,
20058,191,2022/4/15 18:00,334,322,12,
20059,191,2022/4/15 18:10,609,494,115,
20060,191,2022/4/15 18:20,335,377,-42,
20061,191,2022/4/15 18:30,266,507,-241,
20062,191,2022/4/15 18:40,223,434,-211,
20063,191,2022/4/15 18:50,176,325,-149,
20064,191,2022/4/15 19:00,156,301,-145,
20065,191,2022/4/15 19:10,161,209,-48,
20066,191,2022/4/15 19:20,77,192,-115,
20067,191,2022/4/15 19:30,74,151,-77,
20068,191,2022/4/15 19:40,70,110,-40,
20069,191,2022/4/15 19:50,61,127,-66,
20070,191,2022/4/15 20:00,60,125,-65,
20071,191,2022/4/15 20:10,66,115,-49,
20072,191,2022/4/15 20:20,61,105,-44,
20073,191,2022/4/15 20:30,62,110,-48,
20074,191,2022/4/15 20:40,57,122,-65,
20075,191,2022/4/15 20:50,56,106,-50,
20076,191,2022/4/15 21:00,68,107,-39,
20077,191,2022/4/15 21:10,62,103,-41,
20078,191,2022/4/15 21:20,45,111,-66,
20079,191,2022/4/15 21:30,42,111,-69,
20080,191,2022/4/15 21:40,38,124,-86,
20081,191,2022/4/15 21:50,31,110,-79,
20082,191,2022/4/15 22:00,37,100,-63,
20083,191,2022/4/15 22:10,44,107,-63,
20084,191,2022/4/15 22:20,22,105,-83,
20085,191,2022/4/15 22:30,16,92,-76,
20086,191,2022/4/15 22:40,8,59,-51,
20087,191,2022/4/15 22:50,6,55,-49,
20088,185,2022/4/15 5:00,0,1,-1,
20089,185,2022/4/15 5:10,0,1,-1,
20090,185,2022/4/15 5:20,2,1,1,
20091,185,2022/4/15 5:30,7,1,6,
20092,185,2022/4/15 5:40,8,1,7,
20093,185,2022/4/15 5:50,13,1,12,
20094,185,2022/4/15 6:00,22,21,1,
20095,185,2022/4/15 6:10,25,40,-15,
20096,185,2022/4/15 6:20,32,45,-13,
20097,185,2022/4/15 6:30,39,69,-30,
20098,185,2022/4/15 6:40,46,83,-37,
20099,185,2022/4/15 6:50,57,90,-33,
20100,185,2022/4/15 7:00,51,90,-39,
20101,185,2022/4/15 7:10,72,93,-21,
20102,185,2022/4/15 7:20,79,105,-26,
20103,185,2022/4/15 7:30,98,119,-21,
20104,185,2022/4/15 7:40,183,111,72,
20105,185,2022/4/15 7:50,232,139,93,
20106,185,2022/4/15 8:00,234,267,-33,
20107,185,2022/4/15 8:10,243,334,-91,
20108,185,2022/4/15 8:20,244,381,-137,
20109,185,2022/4/15 8:30,206,433,-227,
20110,185,2022/4/15 8:40,155,432,-277,
20111,185,2022/4/15 8:50,92,379,-287,
20112,185,2022/4/15 9:00,70,255,-185,
20113,185,2022/4/15 9:10,70,207,-137,
20114,185,2022/4/15 9:20,58,154,-96,
20115,185,2022/4/15 9:30,46,119,-73,
20116,185,2022/4/15 9:40,41,108,-67,
20117,185,2022/4/15 9:50,38,104,-66,
20118,185,2022/4/15 10:00,38,111,-73,
20119,185,2022/4/15 10:10,33,98,-65,
20120,185,2022/4/15 10:20,35,97,-62,
20121,185,2022/4/15 10:30,37,92,-55,
20122,185,2022/4/15 10:40,32,97,-65,
20123,185,2022/4/15 10:50,35,90,-55,
20124,185,2022/4/15 11:00,38,76,-38,
20125,185,2022/4/15 11:10,34,92,-58,
20126,185,2022/4/15 11:20,37,68,-31,
20127,185,2022/4/15 11:30,37,87,-50,
20128,185,2022/4/15 11:40,36,70,-34,
20129,185,2022/4/15 11:50,38,76,-38,
20130,185,2022/4/15 12:00,38,76,-38,
20131,185,2022/4/15 12:10,38,68,-30,
20132,185,2022/4/15 12:20,37,110,-73,
20133,185,2022/4/15 12:30,38,72,-34,
20134,185,2022/4/15 12:40,37,105,-68,
20135,185,2022/4/15 12:50,37,74,-37,
20136,185,2022/4/15 13:00,38,93,-55,
20137,185,2022/4/15 13:10,41,103,-62,
20138,185,2022/4/15 13:20,36,74,-38,
20139,185,2022/4/15 13:30,37,96,-59,
20140,185,2022/4/15 13:40,44,84,-40,
20141,185,2022/4/15 13:50,39,106,-67,
20142,185,2022/4/15 14:00,39,81,-42,
20143,185,2022/4/15 14:10,45,83,-38,
20144,185,2022/4/15 14:20,40,100,-60,
20145,185,2022/4/15 14:30,38,76,-38,
20146,185,2022/4/15 14:40,45,102,-57,
20147,185,2022/4/15 14:50,43,78,-35,
20148,185,2022/4/15 15:00,44,103,-59,
20149,185,2022/4/15 15:10,53,84,-31,
20150,185,2022/4/15 15:20,49,82,-33,
20151,185,2022/4/15 15:30,50,94,-44,
20152,185,2022/4/15 15:40,67,91,-24,
20153,185,2022/4/15 15:50,57,100,-43,
20154,185,2022/4/15 16:00,83,76,7,
20155,185,2022/4/15 16:10,96,101,-5,
20156,185,2022/4/15 16:20,74,77,-3,
20157,185,2022/4/15 16:30,114,90,24,
20158,185,2022/4/15 16:40,148,103,45,
20159,185,2022/4/15 16:50,169,81,88,
20160,185,2022/4/15 17:00,277,103,174,
20161,185,2022/4/15 17:10,273,107,166,
20162,185,2022/4/15 17:20,217,123,94,
20163,185,2022/4/15 17:30,319,111,208,
20164,185,2022/4/15 17:40,607,102,505,
20165,185,2022/4/15 17:50,265,106,159,
20166,185,2022/4/15 18:00,218,126,92,
20167,185,2022/4/15 18:10,291,107,184,
20168,185,2022/4/15 18:20,221,112,109,
20169,185,2022/4/15 18:30,170,128,42,
20170,185,2022/4/15 18:40,167,126,41,
20171,185,2022/4/15 18:50,75,123,-48,
20172,185,2022/4/15 19:00,57,109,-52,
20173,185,2022/4/15 19:10,46,107,-61,
20174,185,2022/4/15 19:20,46,110,-64,
20175,185,2022/4/15 19:30,34,90,-56,
20176,185,2022/4/15 19:40,31,87,-56,
20177,185,2022/4/15 19:50,31,74,-43,
20178,185,2022/4/15 20:00,30,79,-49,
20179,185,2022/4/15 20:10,27,69,-42,
20180,185,2022/4/15 20:20,29,69,-40,
20181,185,2022/4/15 20:30,25,95,-70,
20182,185,2022/4/15 20:40,28,67,-39,
20183,185,2022/4/15 20:50,29,72,-43,
20184,185,2022/4/15 21:00,26,95,-69,
20185,185,2022/4/15 21:10,23,73,-50,
20186,185,2022/4/15 21:20,29,68,-39,
20187,185,2022/4/15 21:30,27,100,-73,
20188,185,2022/4/15 21:40,23,73,-50,
20189,185,2022/4/15 21:50,22,67,-45,
20190,185,2022/4/15 22:00,22,85,-63,
20191,185,2022/4/15 22:10,18,62,-44,
20192,185,2022/4/15 22:20,11,69,-58,
20193,185,2022/4/15 22:30,8,68,-60,
20194,185,2022/4/15 22:40,1,48,-47,
20195,185,2022/4/15 22:50,1,25,-24,
20196,184,2022/4/15 5:00,0,1,-1,
20197,184,2022/4/15 5:10,0,1,-1,
20198,184,2022/4/15 5:20,3,1,2,
20199,184,2022/4/15 5:30,11,1,10,
20200,184,2022/4/15 5:40,13,2,11,
20201,184,2022/4/15 5:50,19,2,17,
20202,184,2022/4/15 6:00,26,11,15,
20203,184,2022/4/15 6:10,38,20,18,
20204,184,2022/4/15 6:20,50,46,4,
20205,184,2022/4/15 6:30,63,63,0,
20206,184,2022/4/15 6:40,87,62,25,
20207,184,2022/4/15 6:50,157,87,70,
20208,184,2022/4/15 7:00,186,105,81,
20209,184,2022/4/15 7:10,207,150,57,
20210,184,2022/4/15 7:20,244,217,27,
20211,184,2022/4/15 7:30,275,325,-50,
20212,184,2022/4/15 7:40,359,324,35,
20213,184,2022/4/15 7:50,437,298,139,
20214,184,2022/4/15 8:00,475,523,-48,
20215,184,2022/4/15 8:10,598,431,167,
20216,184,2022/4/15 8:20,598,472,126,
20217,184,2022/4/15 8:30,390,1092,-702,
20218,184,2022/4/15 8:40,299,1131,-832,
20219,184,2022/4/15 8:50,246,418,-172,
20220,184,2022/4/15 9:00,216,479,-263,
20221,184,2022/4/15 9:10,177,414,-237,
20222,184,2022/4/15 9:20,167,434,-267,
20223,184,2022/4/15 9:30,104,326,-222,
20224,184,2022/4/15 9:40,77,298,-221,
20225,184,2022/4/15 9:50,65,191,-126,
20226,184,2022/4/15 10:00,65,159,-94,
20227,184,2022/4/15 10:10,59,128,-69,
20228,184,2022/4/15 10:20,53,116,-63,
20229,184,2022/4/15 10:30,53,108,-55,
20230,184,2022/4/15 10:40,49,123,-74,
20231,184,2022/4/15 10:50,47,104,-57,
20232,184,2022/4/15 11:00,44,112,-68,
20233,184,2022/4/15 11:10,48,101,-53,
20234,184,2022/4/15 11:20,54,87,-33,
20235,184,2022/4/15 11:30,50,98,-48,
20236,184,2022/4/15 11:40,54,122,-68,
20237,184,2022/4/15 11:50,56,112,-56,
20238,184,2022/4/15 12:00,66,107,-41,
20239,184,2022/4/15 12:10,68,109,-41,
20240,184,2022/4/15 12:20,66,108,-42,
20241,184,2022/4/15 12:30,73,116,-43,
20242,184,2022/4/15 12:40,68,126,-58,
20243,184,2022/4/15 12:50,58,117,-59,
20244,184,2022/4/15 13:00,67,88,-21,
20245,184,2022/4/15 13:10,66,118,-52,
20246,184,2022/4/15 13:20,57,116,-59,
20247,184,2022/4/15 13:30,72,102,-30,
20248,184,2022/4/15 13:40,67,125,-58,
20249,184,2022/4/15 13:50,62,125,-63,
20250,184,2022/4/15 14:00,64,119,-55,
20251,184,2022/4/15 14:10,67,120,-53,
20252,184,2022/4/15 14:20,64,102,-38,
20253,184,2022/4/15 14:30,97,121,-24,
20254,184,2022/4/15 14:40,96,109,-13,
20255,184,2022/4/15 14:50,88,96,-8,
20256,184,2022/4/15 15:00,109,126,-17,
20257,184,2022/4/15 15:10,132,121,11,
20258,184,2022/4/15 15:20,128,121,7,
20259,184,2022/4/15 15:30,110,116,-6,
20260,184,2022/4/15 15:40,110,126,-16,
20261,184,2022/4/15 15:50,109,124,-15,
20262,184,2022/4/15 16:00,190,123,67,
20263,184,2022/4/15 16:10,268,119,149,
20264,184,2022/4/15 16:20,275,121,154,
20265,184,2022/4/15 16:30,289,119,170,
20266,184,2022/4/15 16:40,329,117,212,
20267,184,2022/4/15 16:50,271,110,161,
20268,184,2022/4/15 17:00,552,127,425,
20269,184,2022/4/15 17:10,621,213,408,
20270,184,2022/4/15 17:20,353,169,184,
20271,184,2022/4/15 17:30,590,283,307,
20272,184,2022/4/15 17:40,659,283,376,
20273,184,2022/4/15 17:50,579,298,281,
20274,184,2022/4/15 18:00,422,300,122,
20275,184,2022/4/15 18:10,692,319,373,
20276,184,2022/4/15 18:20,584,300,284,
20277,184,2022/4/15 18:30,349,335,14,
20278,184,2022/4/15 18:40,270,285,-15,
20279,184,2022/4/15 18:50,229,222,7,
20280,184,2022/4/15 19:00,224,191,33,
20281,184,2022/4/15 19:10,185,180,5,
20282,184,2022/4/15 19:20,154,111,43,
20283,184,2022/4/15 19:30,129,120,9,
20284,184,2022/4/15 19:40,80,126,-46,
20285,184,2022/4/15 19:50,73,110,-37,
20286,184,2022/4/15 20:00,72,103,-31,
20287,184,2022/4/15 20:10,70,109,-39,
20288,184,2022/4/15 20:20,64,114,-50,
20289,184,2022/4/15 20:30,68,77,-9,
20290,184,2022/4/15 20:40,63,111,-48,
20291,184,2022/4/15 20:50,62,115,-53,
20292,184,2022/4/15 21:00,58,95,-37,
20293,184,2022/4/15 21:10,56,106,-50,
20294,184,2022/4/15 21:20,59,109,-50,
20295,184,2022/4/15 21:30,43,92,-49,
20296,184,2022/4/15 21:40,48,112,-64,
20297,184,2022/4/15 21:50,43,101,-58,
20298,184,2022/4/15 22:00,35,79,-44,
20299,184,2022/4/15 22:10,31,84,-53,
20300,184,2022/4/15 22:20,22,112,-90,
20301,184,2022/4/15 22:30,16,77,-61,
20302,184,2022/4/15 22:40,4,86,-82,
20303,184,2022/4/15 22:50,2,3,-1,
20304,179,2022/4/15 5:00,0,1,-1,
20305,179,2022/4/15 5:10,1,1,0,
20306,179,2022/4/15 5:20,6,1,5,
20307,179,2022/4/15 5:30,10,1,9,
20308,179,2022/4/15 5:40,7,1,6,
20309,179,2022/4/15 5:50,12,5,7,
20310,179,2022/4/15 6:00,21,5,16,
20311,179,2022/4/15 6:10,38,11,27,
20312,179,2022/4/15 6:20,43,46,-3,
20313,179,2022/4/15 6:30,59,54,5,
20314,179,2022/4/15 6:40,78,75,3,
20315,179,2022/4/15 6:50,146,100,46,
20316,179,2022/4/15 7:00,152,118,34,
20317,179,2022/4/15 7:10,170,103,67,
20318,179,2022/4/15 7:20,234,89,145,
20319,179,2022/4/15 7:30,273,124,149,
20320,179,2022/4/15 7:40,281,127,154,
20321,179,2022/4/15 7:50,324,197,127,
20322,179,2022/4/15 8:00,339,331,8,
20323,179,2022/4/15 8:10,392,435,-43,
20324,179,2022/4/15 8:20,385,432,-47,
20325,179,2022/4/15 8:30,349,362,-13,
20326,179,2022/4/15 8:40,270,339,-69,
20327,179,2022/4/15 8:50,239,280,-41,
20328,179,2022/4/15 9:00,199,233,-34,
20329,179,2022/4/15 9:10,167,152,15,
20330,179,2022/4/15 9:20,120,117,3,
20331,179,2022/4/15 9:30,82,102,-20,
20332,179,2022/4/15 9:40,67,126,-59,
20333,179,2022/4/15 9:50,49,86,-37,
20334,179,2022/4/15 10:00,57,95,-38,
20335,179,2022/4/15 10:10,47,96,-49,
20336,179,2022/4/15 10:20,48,101,-53,
20337,179,2022/4/15 10:30,44,75,-31,
20338,179,2022/4/15 10:40,46,101,-55,
20339,179,2022/4/15 10:50,44,66,-22,
20340,179,2022/4/15 11:00,43,69,-26,
20341,179,2022/4/15 11:10,41,82,-41,
20342,179,2022/4/15 11:20,42,67,-25,
20343,179,2022/4/15 11:30,43,93,-50,
20344,179,2022/4/15 11:40,43,74,-31,
20345,179,2022/4/15 11:50,46,75,-29,
20346,179,2022/4/15 12:00,46,87,-41,
20347,179,2022/4/15 12:10,43,62,-19,
20348,179,2022/4/15 12:20,44,112,-68,
20349,179,2022/4/15 12:30,47,77,-30,
20350,179,2022/4/15 12:40,45,124,-79,
20351,179,2022/4/15 12:50,45,91,-46,
20352,179,2022/4/15 13:00,42,101,-59,
20353,179,2022/4/15 13:10,45,104,-59,
20354,179,2022/4/15 13:20,43,77,-34,
20355,179,2022/4/15 13:30,43,109,-66,
20356,179,2022/4/15 13:40,43,77,-34,
20357,179,2022/4/15 13:50,45,102,-57,
20358,179,2022/4/15 14:00,45,76,-31,
20359,179,2022/4/15 14:10,47,97,-50,
20360,179,2022/4/15 14:20,43,105,-62,
20361,179,2022/4/15 14:30,48,76,-28,
20362,179,2022/4/15 14:40,45,88,-43,
20363,179,2022/4/15 14:50,48,72,-24,
20364,179,2022/4/15 15:00,57,111,-54,
20365,179,2022/4/15 15:10,70,73,-3,
20366,179,2022/4/15 15:20,52,91,-39,
20367,179,2022/4/15 15:30,58,103,-45,
20368,179,2022/4/15 15:40,63,87,-24,
20369,179,2022/4/15 15:50,64,102,-38,
20370,179,2022/4/15 16:00,73,81,-8,
20371,179,2022/4/15 16:10,75,112,-37,
20372,179,2022/4/15 16:20,78,92,-14,
20373,179,2022/4/15 16:30,163,114,49,
20374,179,2022/4/15 16:40,208,105,103,
20375,179,2022/4/15 16:50,206,100,106,
20376,179,2022/4/15 17:00,278,100,178,
20377,179,2022/4/15 17:10,312,127,185,
20378,179,2022/4/15 17:20,216,108,108,
20379,179,2022/4/15 17:30,204,190,14,
20380,179,2022/4/15 17:40,334,221,113,
20381,179,2022/4/15 17:50,224,177,47,
20382,179,2022/4/15 18:00,178,218,-40,
20383,179,2022/4/15 18:10,264,214,50,
20384,179,2022/4/15 18:20,233,193,40,
20385,179,2022/4/15 18:30,170,198,-28,
20386,179,2022/4/15 18:40,114,180,-66,
20387,179,2022/4/15 18:50,73,150,-77,
20388,179,2022/4/15 19:00,55,126,-71,
20389,179,2022/4/15 19:10,49,112,-63,
20390,179,2022/4/15 19:20,43,104,-61,
20391,179,2022/4/15 19:30,45,122,-77,
20392,179,2022/4/15 19:40,44,99,-55,
20393,179,2022/4/15 19:50,39,95,-56,
20394,179,2022/4/15 20:00,37,114,-77,
20395,179,2022/4/15 20:10,36,85,-49,
20396,179,2022/4/15 20:20,36,92,-56,
20397,179,2022/4/15 20:30,35,103,-68,
20398,179,2022/4/15 20:40,39,83,-44,
20399,179,2022/4/15 20:50,35,102,-67,
20400,179,2022/4/15 21:00,35,103,-68,
20401,179,2022/4/15 21:10,38,82,-44,
20402,179,2022/4/15 21:20,29,107,-78,
20403,179,2022/4/15 21:30,30,104,-74,
20404,179,2022/4/15 21:40,27,94,-67,
20405,179,2022/4/15 21:50,25,95,-70,
20406,179,2022/4/15 22:00,21,97,-76,
20407,179,2022/4/15 22:10,16,86,-70,
20408,179,2022/4/15 22:20,13,89,-76,
20409,179,2022/4/15 22:30,5,83,-78,
20410,179,2022/4/15 22:40,2,7,-5,
20411,179,2022/4/15 22:50,1,31,-30,
20412,180,2022/4/15 5:00,0,1,-1,
20413,180,2022/4/15 5:10,0,1,-1,
20414,180,2022/4/15 5:20,4,1,3,
20415,180,2022/4/15 5:30,5,1,4,
20416,180,2022/4/15 5:40,11,1,10,
20417,180,2022/4/15 5:50,15,22,-7,
20418,180,2022/4/15 6:00,22,36,-14,
20419,180,2022/4/15 6:10,31,41,-10,
20420,180,2022/4/15 6:20,33,74,-41,
20421,180,2022/4/15 6:30,45,76,-31,
20422,180,2022/4/15 6:40,57,123,-66,
20423,180,2022/4/15 6:50,60,111,-51,
20424,180,2022/4/15 7:00,84,297,-213,
20425,180,2022/4/15 7:10,99,342,-243,
20426,180,2022/4/15 7:20,108,298,-190,
20427,180,2022/4/15 7:30,191,323,-132,
20428,180,2022/4/15 7:40,217,328,-111,
20429,180,2022/4/15 7:50,238,318,-80,
20430,180,2022/4/15 8:00,284,267,17,
20431,180,2022/4/15 8:10,329,318,11,
20432,180,2022/4/15 8:20,315,298,17,
20433,180,2022/4/15 8:30,276,283,-7,
20434,180,2022/4/15 8:40,274,268,6,
20435,180,2022/4/15 8:50,243,217,26,
20436,180,2022/4/15 9:00,220,208,12,
20437,180,2022/4/15 9:10,211,178,33,
20438,180,2022/4/15 9:20,183,161,22,
20439,180,2022/4/15 9:30,177,159,18,
20440,180,2022/4/15 9:40,146,117,29,
20441,180,2022/4/15 9:50,105,110,-5,
20442,180,2022/4/15 10:00,82,120,-38,
20443,180,2022/4/15 10:10,80,109,-29,
20444,180,2022/4/15 10:20,76,105,-29,
20445,180,2022/4/15 10:30,81,109,-28,
20446,180,2022/4/15 10:40,69,109,-40,
20447,180,2022/4/15 10:50,74,98,-24,
20448,180,2022/4/15 11:00,77,96,-19,
20449,180,2022/4/15 11:10,75,90,-15,
20450,180,2022/4/15 11:20,69,93,-24,
20451,180,2022/4/15 11:30,70,97,-27,
20452,180,2022/4/15 11:40,76,79,-3,
20453,180,2022/4/15 11:50,65,96,-31,
20454,180,2022/4/15 12:00,63,91,-28,
20455,180,2022/4/15 12:10,63,110,-47,
20456,180,2022/4/15 12:20,53,108,-55,
20457,180,2022/4/15 12:30,54,100,-46,
20458,180,2022/4/15 12:40,52,121,-69,
20459,180,2022/4/15 12:50,44,125,-81,
20460,180,2022/4/15 13:00,46,121,-75,
20461,180,2022/4/15 13:10,50,105,-55,
20462,180,2022/4/15 13:20,52,118,-66,
20463,180,2022/4/15 13:30,65,106,-41,
20464,180,2022/4/15 13:40,66,106,-40,
20465,180,2022/4/15 13:50,64,102,-38,
20466,180,2022/4/15 14:00,77,103,-26,
20467,180,2022/4/15 14:10,77,105,-28,
20468,180,2022/4/15 14:20,78,102,-24,
20469,180,2022/4/15 14:30,74,103,-29,
20470,180,2022/4/15 14:40,73,100,-27,
20471,180,2022/4/15 14:50,77,109,-32,
20472,180,2022/4/15 15:00,109,111,-2,
20473,180,2022/4/15 15:10,132,105,27,
20474,180,2022/4/15 15:20,128,110,18,
20475,180,2022/4/15 15:30,110,112,-2,
20476,180,2022/4/15 15:40,117,102,15,
20477,180,2022/4/15 15:50,125,106,19,
20478,180,2022/4/15 16:00,171,110,61,
20479,180,2022/4/15 16:10,182,99,83,
20480,180,2022/4/15 16:20,168,101,67,
20481,180,2022/4/15 16:30,235,106,129,
20482,180,2022/4/15 16:40,310,114,196,
20483,180,2022/4/15 16:50,265,103,162,
20484,180,2022/4/15 17:00,334,112,222,
20485,180,2022/4/15 17:10,310,127,183,
20486,180,2022/4/15 17:20,291,116,175,
20487,180,2022/4/15 17:30,263,109,154,
20488,180,2022/4/15 17:40,228,142,86,
20489,180,2022/4/15 17:50,186,115,71,
20490,180,2022/4/15 18:00,182,117,65,
20491,180,2022/4/15 18:10,216,143,73,
20492,180,2022/4/15 18:20,137,111,26,
20493,180,2022/4/15 18:30,70,117,-47,
20494,180,2022/4/15 18:40,73,171,-98,
20495,180,2022/4/15 18:50,60,109,-49,
20496,180,2022/4/15 19:00,48,122,-74,
20497,180,2022/4/15 19:10,47,104,-57,
20498,180,2022/4/15 19:20,48,105,-57,
20499,180,2022/4/15 19:30,40,107,-67,
20500,180,2022/4/15 19:40,39,95,-56,
20501,180,2022/4/15 19:50,35,102,-67,
20502,180,2022/4/15 20:00,35,76,-41,
20503,180,2022/4/15 20:10,40,86,-46,
20504,180,2022/4/15 20:20,32,76,-44,
20505,180,2022/4/15 20:30,30,78,-48,
20506,180,2022/4/15 20:40,33,87,-54,
20507,180,2022/4/15 20:50,37,90,-53,
20508,180,2022/4/15 21:00,28,76,-48,
20509,180,2022/4/15 21:10,29,71,-42,
20510,180,2022/4/15 21:20,29,94,-65,
20511,180,2022/4/15 21:30,27,94,-67,
20512,180,2022/4/15 21:40,28,87,-59,
20513,180,2022/4/15 21:50,23,78,-55,
20514,180,2022/4/15 22:00,21,87,-66,
20515,180,2022/4/15 22:10,21,72,-51,
20516,180,2022/4/15 22:20,14,71,-57,
20517,180,2022/4/15 22:30,8,87,-79,
20518,180,2022/4/15 22:40,10,57,-47,
20519,180,2022/4/15 22:50,4,43,-39,
20520,188,2022/4/15 5:00,0,1,-1,
20521,188,2022/4/15 5:10,1,1,0,
20522,188,2022/4/15 5:20,7,1,6,
20523,188,2022/4/15 5:30,7,1,6,
20524,188,2022/4/15 5:40,8,1,7,
20525,188,2022/4/15 5:50,14,5,9,
20526,188,2022/4/15 6:00,16,13,3,
20527,188,2022/4/15 6:10,28,8,20,
20528,188,2022/4/15 6:20,32,60,-28,
20529,188,2022/4/15 6:30,33,69,-36,
20530,188,2022/4/15 6:40,57,83,-26,
20531,188,2022/4/15 6:50,71,113,-42,
20532,188,2022/4/15 7:00,145,102,43,
20533,188,2022/4/15 7:10,157,103,54,
20534,188,2022/4/15 7:20,196,120,76,
20535,188,2022/4/15 7:30,239,160,79,
20536,188,2022/4/15 7:40,282,179,103,
20537,188,2022/4/15 7:50,328,319,9,
20538,188,2022/4/15 8:00,339,323,16,
20539,188,2022/4/15 8:10,367,430,-63,
20540,188,2022/4/15 8:20,375,430,-55,
20541,188,2022/4/15 8:30,357,577,-220,
20542,188,2022/4/15 8:40,282,1162,-880,
20543,188,2022/4/15 8:50,223,612,-389,
20544,188,2022/4/15 9:00,217,490,-273,
20545,188,2022/4/15 9:10,182,424,-242,
20546,188,2022/4/15 9:20,155,491,-336,
20547,188,2022/4/15 9:30,105,317,-212,
20548,188,2022/4/15 9:40,77,318,-241,
20549,188,2022/4/15 9:50,75,223,-148,
20550,188,2022/4/15 10:00,65,111,-46,
20551,188,2022/4/15 10:10,63,214,-151,
20552,188,2022/4/15 10:20,57,109,-52,
20553,188,2022/4/15 10:30,52,119,-67,
20554,188,2022/4/15 10:40,52,118,-66,
20555,188,2022/4/15 10:50,48,111,-63,
20556,188,2022/4/15 11:00,50,104,-54,
20557,188,2022/4/15 11:10,48,100,-52,
20558,188,2022/4/15 11:20,45,108,-63,
20559,188,2022/4/15 11:30,50,93,-43,
20560,188,2022/4/15 11:40,52,114,-62,
20561,188,2022/4/15 11:50,59,124,-65,
20562,188,2022/4/15 12:00,59,88,-29,
20563,188,2022/4/15 12:10,69,122,-53,
20564,188,2022/4/15 12:20,71,96,-25,
20565,188,2022/4/15 12:30,75,128,-53,
20566,188,2022/4/15 12:40,74,106,-32,
20567,188,2022/4/15 12:50,70,110,-40,
20568,188,2022/4/15 13:00,83,125,-42,
20569,188,2022/4/15 13:10,76,104,-28,
20570,188,2022/4/15 13:20,88,108,-20,
20571,188,2022/4/15 13:30,78,106,-28,
20572,188,2022/4/15 13:40,72,117,-45,
20573,188,2022/4/15 13:50,75,101,-26,
20574,188,2022/4/15 14:00,77,122,-45,
20575,188,2022/4/15 14:10,72,113,-41,
20576,188,2022/4/15 14:20,73,119,-46,
20577,188,2022/4/15 14:30,76,121,-45,
20578,188,2022/4/15 14:40,67,112,-45,
20579,188,2022/4/15 14:50,74,108,-34,
20580,188,2022/4/15 15:00,98,104,-6,
20581,188,2022/4/15 15:10,130,121,9,
20582,188,2022/4/15 15:20,131,122,9,
20583,188,2022/4/15 15:30,119,123,-4,
20584,188,2022/4/15 15:40,135,109,26,
20585,188,2022/4/15 15:50,109,113,-4,
20586,188,2022/4/15 16:00,134,123,11,
20587,188,2022/4/15 16:10,164,108,56,
20588,188,2022/4/15 16:20,170,130,40,
20589,188,2022/4/15 16:30,214,113,101,
20590,188,2022/4/15 16:40,236,121,115,
20591,188,2022/4/15 16:50,223,192,31,
20592,188,2022/4/15 17:00,344,127,217,
20593,188,2022/4/15 17:10,578,170,408,
20594,188,2022/4/15 17:20,325,212,113,
20595,188,2022/4/15 17:30,620,212,408,
20596,188,2022/4/15 17:40,703,333,370,
20597,188,2022/4/15 17:50,576,298,278,
20598,188,2022/4/15 18:00,607,337,270,
20599,188,2022/4/15 18:10,813,381,432,
20600,188,2022/4/15 18:20,579,378,201,
20601,188,2022/4/15 18:30,332,342,-10,
20602,188,2022/4/15 18:40,339,327,12,
20603,188,2022/4/15 18:50,269,321,-52,
20604,188,2022/4/15 19:00,240,257,-17,
20605,188,2022/4/15 19:10,215,184,31,
20606,188,2022/4/15 19:20,190,138,52,
20607,188,2022/4/15 19:30,175,111,64,
20608,188,2022/4/15 19:40,137,105,32,
20609,188,2022/4/15 19:50,135,104,31,
20610,188,2022/4/15 20:00,136,103,33,
20611,188,2022/4/15 20:10,161,112,49,
20612,188,2022/4/15 20:20,135,100,35,
20613,188,2022/4/15 20:30,138,97,41,
20614,188,2022/4/15 20:40,174,129,45,
20615,188,2022/4/15 20:50,138,94,44,
20616,188,2022/4/15 21:00,177,95,82,
20617,188,2022/4/15 21:10,176,103,73,
20618,188,2022/4/15 21:20,130,105,25,
20619,188,2022/4/15 21:30,129,80,49,
20620,188,2022/4/15 21:40,160,104,56,
20621,188,2022/4/15 21:50,71,95,-24,
20622,188,2022/4/15 22:00,56,79,-23,
20623,188,2022/4/15 22:10,35,101,-66,
20624,188,2022/4/15 22:20,25,84,-59,
20625,188,2022/4/15 22:30,13,86,-73,
20626,188,2022/4/15 22:40,0,48,-48,
20627,188,2022/4/15 22:50,1,40,-39,
20628,189,2022/4/15 5:00,0,1,-1,
20629,189,2022/4/15 5:10,2,1,1,
20630,189,2022/4/15 5:20,7,1,6,
20631,189,2022/4/15 5:30,9,1,8,
20632,189,2022/4/15 5:40,13,5,8,
20633,189,2022/4/15 5:50,15,1,14,
20634,189,2022/4/15 6:00,21,5,16,
20635,189,2022/4/15 6:10,33,2,31,
20636,189,2022/4/15 6:20,35,30,5,
20637,189,2022/4/15 6:30,46,39,7,
20638,189,2022/4/15 6:40,53,51,2,
20639,189,2022/4/15 6:50,77,52,25,
20640,189,2022/4/15 7:00,88,70,18,
20641,189,2022/4/15 7:10,105,68,37,
20642,189,2022/4/15 7:20,105,88,17,
20643,189,2022/4/15 7:30,169,93,76,
20644,189,2022/4/15 7:40,215,101,114,
20645,189,2022/4/15 7:50,251,104,147,
20646,189,2022/4/15 8:00,280,103,177,
20647,189,2022/4/15 8:10,281,224,57,
20648,189,2022/4/15 8:20,276,178,98,
20649,189,2022/4/15 8:30,235,253,-18,
20650,189,2022/4/15 8:40,220,328,-108,
20651,189,2022/4/15 8:50,197,373,-176,
20652,189,2022/4/15 9:00,167,233,-66,
20653,189,2022/4/15 9:10,180,231,-51,
20654,189,2022/4/15 9:20,116,185,-69,
20655,189,2022/4/15 9:30,91,108,-17,
20656,189,2022/4/15 9:40,76,125,-49,
20657,189,2022/4/15 9:50,68,124,-56,
20658,189,2022/4/15 10:00,61,104,-43,
20659,189,2022/4/15 10:10,62,101,-39,
20660,189,2022/4/15 10:20,56,101,-45,
20661,189,2022/4/15 10:30,54,75,-21,
20662,189,2022/4/15 10:40,44,87,-43,
20663,189,2022/4/15 10:50,47,83,-36,
20664,189,2022/4/15 11:00,42,75,-33,
20665,189,2022/4/15 11:10,44,79,-35,
20666,189,2022/4/15 11:20,45,80,-35,
20667,189,2022/4/15 11:30,46,84,-38,
20668,189,2022/4/15 11:40,55,73,-18,
20669,189,2022/4/15 11:50,57,87,-30,
20670,189,2022/4/15 12:00,57,77,-20,
20671,189,2022/4/15 12:10,71,72,-1,
20672,189,2022/4/15 12:20,77,93,-16,
20673,189,2022/4/15 12:30,73,77,-4,
20674,189,2022/4/15 12:40,77,91,-14,
20675,189,2022/4/15 12:50,76,80,-4,
20676,189,2022/4/15 13:00,90,73,17,
20677,189,2022/4/15 13:10,72,91,-19,
20678,189,2022/4/15 13:20,74,73,1,
20679,189,2022/4/15 13:30,73,101,-28,
20680,189,2022/4/15 13:40,75,85,-10,
20681,189,2022/4/15 13:50,75,98,-23,
20682,189,2022/4/15 14:00,67,74,-7,
20683,189,2022/4/15 14:10,76,74,2,
20684,189,2022/4/15 14:20,82,87,-5,
20685,189,2022/4/15 14:30,74,70,4,
20686,189,2022/4/15 14:40,79,92,-13,
20687,189,2022/4/15 14:50,76,69,7,
20688,189,2022/4/15 15:00,103,76,27,
20689,189,2022/4/15 15:10,113,82,31,
20690,189,2022/4/15 15:20,111,76,35,
20691,189,2022/4/15 15:30,141,76,65,
20692,189,2022/4/15 15:40,171,78,93,
20693,189,2022/4/15 15:50,136,93,43,
20694,189,2022/4/15 16:00,157,77,80,
20695,189,2022/4/15 16:10,153,78,75,
20696,189,2022/4/15 16:20,175,76,99,
20697,189,2022/4/15 16:30,214,76,138,
20698,189,2022/4/15 16:40,264,87,177,
20699,189,2022/4/15 16:50,223,87,136,
20700,189,2022/4/15 17:00,379,111,268,
20701,189,2022/4/15 17:10,552,93,459,
20702,189,2022/4/15 17:20,331,108,223,
20703,189,2022/4/15 17:30,552,111,441,
20704,189,2022/4/15 17:40,676,122,554,
20705,189,2022/4/15 17:50,376,126,250,
20706,189,2022/4/15 18:00,577,122,455,
20707,189,2022/4/15 18:10,715,116,599,
20708,189,2022/4/15 18:20,578,108,470,
20709,189,2022/4/15 18:30,328,110,218,
20710,189,2022/4/15 18:40,272,126,146,
20711,189,2022/4/15 18:50,265,106,159,
20712,189,2022/4/15 19:00,212,100,112,
20713,189,2022/4/15 19:10,216,98,118,
20714,189,2022/4/15 19:20,157,87,70,
20715,189,2022/4/15 19:30,151,75,76,
20716,189,2022/4/15 19:40,129,72,57,
20717,189,2022/4/15 19:50,129,64,65,
20718,189,2022/4/15 20:00,143,66,77,
20719,189,2022/4/15 20:10,130,68,62,
20720,189,2022/4/15 20:20,114,51,63,
20721,189,2022/4/15 20:30,134,56,78,
20722,189,2022/4/15 20:40,131,62,69,
20723,189,2022/4/15 20:50,68,63,5,
20724,189,2022/4/15 21:00,85,51,34,
20725,189,2022/4/15 21:10,102,51,51,
20726,189,2022/4/15 21:20,74,56,18,
20727,189,2022/4/15 21:30,68,48,20,
20728,189,2022/4/15 21:40,64,52,12,
20729,189,2022/4/15 21:50,58,49,9,
20730,189,2022/4/15 22:00,271,42,229,
20731,189,2022/4/15 22:10,40,40,0,
20732,189,2022/4/15 22:20,23,39,-16,
20733,189,2022/4/15 22:30,21,40,-19,
20734,189,2022/4/15 22:40,13,26,-13,
20735,189,2022/4/15 22:50,5,23,-18,
20736,193,2022/4/15 5:00,0,1,-1,
20737,193,2022/4/15 5:10,4,1,3,
20738,193,2022/4/15 5:20,5,1,4,
20739,193,2022/4/15 5:30,7,1,6,
20740,193,2022/4/15 5:40,7,1,6,
20741,193,2022/4/15 5:50,12,1,11,
20742,193,2022/4/15 6:00,18,1,17,
20743,193,2022/4/15 6:10,17,1,16,
20744,193,2022/4/15 6:20,25,20,5,
20745,193,2022/4/15 6:30,31,65,-34,
20746,193,2022/4/15 6:40,39,70,-31,
20747,193,2022/4/15 6:50,44,76,-32,
20748,193,2022/4/15 7:00,58,99,-41,
20749,193,2022/4/15 7:10,56,105,-49,
20750,193,2022/4/15 7:20,84,101,-17,
20751,193,2022/4/15 7:30,87,109,-22,
20752,193,2022/4/15 7:40,187,180,7,
20753,193,2022/4/15 7:50,224,218,6,
20754,193,2022/4/15 8:00,243,380,-137,
20755,193,2022/4/15 8:10,274,405,-131,
20756,193,2022/4/15 8:20,259,593,-334,
20757,193,2022/4/15 8:30,222,1932,-1710,
20758,193,2022/4/15 8:40,150,1936,-1786,
20759,193,2022/4/15 8:50,100,1537,-1437,
20760,193,2022/4/15 9:00,75,483,-408,
20761,193,2022/4/15 9:10,77,489,-412,
20762,193,2022/4/15 9:20,65,378,-313,
20763,193,2022/4/15 9:30,51,324,-273,
20764,193,2022/4/15 9:40,47,231,-184,
20765,193,2022/4/15 9:50,48,157,-109,
20766,193,2022/4/15 10:00,44,105,-61,
20767,193,2022/4/15 10:10,43,123,-80,
20768,193,2022/4/15 10:20,42,114,-72,
20769,193,2022/4/15 10:30,38,88,-50,
20770,193,2022/4/15 10:40,46,101,-55,
20771,193,2022/4/15 10:50,43,112,-69,
20772,193,2022/4/15 11:00,35,90,-55,
20773,193,2022/4/15 11:10,41,96,-55,
20774,193,2022/4/15 11:20,38,93,-55,
20775,193,2022/4/15 11:30,35,75,-40,
20776,193,2022/4/15 11:40,41,93,-52,
20777,193,2022/4/15 11:50,45,97,-52,
20778,193,2022/4/15 12:00,44,91,-47,
20779,193,2022/4/15 12:10,44,95,-51,
20780,193,2022/4/15 12:20,48,77,-29,
20781,193,2022/4/15 12:30,46,112,-66,
20782,193,2022/4/15 12:40,48,90,-42,
20783,193,2022/4/15 12:50,46,105,-59,
20784,193,2022/4/15 13:00,46,112,-66,
20785,193,2022/4/15 13:10,50,93,-43,
20786,193,2022/4/15 13:20,40,103,-63,
20787,193,2022/4/15 13:30,45,90,-45,
20788,193,2022/4/15 13:40,47,111,-64,
20789,193,2022/4/15 13:50,46,97,-51,
20790,193,2022/4/15 14:00,45,105,-60,
20791,193,2022/4/15 14:10,48,101,-53,
20792,193,2022/4/15 14:20,46,93,-47,
20793,193,2022/4/15 14:30,47,105,-58,
20794,193,2022/4/15 14:40,49,78,-29,
20795,193,2022/4/15 14:50,53,108,-55,
20796,193,2022/4/15 15:00,69,76,-7,
20797,193,2022/4/15 15:10,94,103,-9,
20798,193,2022/4/15 15:20,75,104,-29,
20799,193,2022/4/15 15:30,62,76,-14,
20800,193,2022/4/15 15:40,72,103,-31,
20801,193,2022/4/15 15:50,70,82,-12,
20802,193,2022/4/15 16:00,75,105,-30,
20803,193,2022/4/15 16:10,95,91,4,
20804,193,2022/4/15 16:20,92,114,-22,
20805,193,2022/4/15 16:30,137,97,40,
20806,193,2022/4/15 16:40,187,102,85,
20807,193,2022/4/15 16:50,185,123,62,
20808,193,2022/4/15 17:00,262,102,160,
20809,193,2022/4/15 17:10,324,102,222,
20810,193,2022/4/15 17:20,314,110,204,
20811,193,2022/4/15 17:30,462,125,337,
20812,193,2022/4/15 17:40,1158,106,1052,
20813,193,2022/4/15 17:50,653,138,515,
20814,193,2022/4/15 18:00,645,143,502,
20815,193,2022/4/15 18:10,1561,150,1411,
20816,193,2022/4/15 18:20,821,184,637,
20817,193,2022/4/15 18:30,570,151,419,
20818,193,2022/4/15 18:40,354,181,173,
20819,193,2022/4/15 18:50,256,130,126,
20820,193,2022/4/15 19:00,210,103,107,
20821,193,2022/4/15 19:10,211,125,86,
20822,193,2022/4/15 19:20,148,104,44,
20823,193,2022/4/15 19:30,96,92,4,
20824,193,2022/4/15 19:40,163,92,71,
20825,193,2022/4/15 19:50,81,84,-3,
20826,193,2022/4/15 20:00,67,76,-9,
20827,193,2022/4/15 20:10,71,82,-11,
20828,193,2022/4/15 20:20,57,67,-10,
20829,193,2022/4/15 20:30,55,77,-22,
20830,193,2022/4/15 20:40,59,73,-14,
20831,193,2022/4/15 20:50,45,70,-25,
20832,193,2022/4/15 21:00,73,88,-15,
20833,193,2022/4/15 21:10,97,67,30,
20834,193,2022/4/15 21:20,44,63,-19,
20835,193,2022/4/15 21:30,42,88,-46,
20836,193,2022/4/15 21:40,37,70,-33,
20837,193,2022/4/15 21:50,33,65,-32,
20838,193,2022/4/15 22:00,33,78,-45,
20839,193,2022/4/15 22:10,29,67,-38,
20840,193,2022/4/15 22:20,17,62,-45,
20841,193,2022/4/15 22:30,0,74,-74,
20842,193,2022/4/15 22:40,0,79,-79,
20843,193,2022/4/15 22:50,0,50,-50,
20844,195,2022/4/15 5:00,0,1,-1,-1
20845,195,2022/4/15 5:10,0,1,-1,-1
20846,195,2022/4/15 5:20,0,1,-1,-1
20847,195,2022/4/15 5:30,0,1,-1,-1
20848,195,2022/4/15 5:40,1,1,0,0
20849,195,2022/4/15 5:50,3,1,2,2
20850,195,2022/4/15 6:00,8,1,7,7
20851,195,2022/4/15 6:10,19,5,14,14
20852,195,2022/4/15 6:20,32,29,3,3
20853,195,2022/4/15 6:30,42,41,1,1
20854,195,2022/4/15 6:40,46,29,17,17
20855,195,2022/4/15 6:50,56,51,5,5
20856,195,2022/4/15 7:00,77,63,14,14
20857,195,2022/4/15 7:10,100,63,37,37
20858,195,2022/4/15 7:20,168,61,107,107
20859,195,2022/4/15 7:30,215,62,153,153
20860,195,2022/4/15 7:40,223,69,154,154
20861,195,2022/4/15 7:50,224,72,152,152
20862,195,2022/4/15 8:00,183,76,107,107
20863,195,2022/4/15 8:10,190,105,85,85
20864,195,2022/4/15 8:20,175,91,84,84
20865,195,2022/4/15 8:30,110,80,30,30
20866,195,2022/4/15 8:40,84,83,1,1
20867,195,2022/4/15 8:50,63,76,-13,-13
20868,195,2022/4/15 9:00,46,67,-21,-21
20869,195,2022/4/15 9:10,33,51,-18,-18
20870,195,2022/4/15 9:20,30,50,-20,-20
20871,195,2022/4/15 9:30,28,48,-20,-20
20872,195,2022/4/15 9:40,28,41,-13,-13
20873,195,2022/4/15 9:50,23,33,-10,-10
20874,195,2022/4/15 10:00,22,31,-9,-9
20875,195,2022/4/15 10:10,21,34,-13,-13
20876,195,2022/4/15 10:20,19,34,-15,-15
20877,195,2022/4/15 10:30,18,37,-19,-19
20878,195,2022/4/15 10:40,16,23,-7,-7
20879,195,2022/4/15 10:50,17,32,-15,-15
20880,195,2022/4/15 11:00,15,33,-18,-18
20881,195,2022/4/15 11:10,18,23,-5,-5
20882,195,2022/4/15 11:20,19,39,-20,-20
20883,195,2022/4/15 11:30,14,33,-19,-19
20884,195,2022/4/15 11:40,17,23,-6,-6
20885,195,2022/4/15 11:50,17,40,-23,-23
20886,195,2022/4/15 12:00,17,37,-20,-20
20887,195,2022/4/15 12:10,16,25,-9,-9
20888,195,2022/4/15 12:20,17,41,-24,-24
20889,195,2022/4/15 12:30,16,41,-25,-25
20890,195,2022/4/15 12:40,16,31,-15,-15
20891,195,2022/4/15 12:50,18,46,-28,-28
20892,195,2022/4/15 13:00,17,42,-25,-25
20893,195,2022/4/15 13:10,20,32,-12,-12
20894,195,2022/4/15 13:20,15,51,-36,-36
20895,195,2022/4/15 13:30,16,38,-22,-22
20896,195,2022/4/15 13:40,19,32,-13,-13
20897,195,2022/4/15 13:50,16,45,-29,-29
20898,195,2022/4/15 14:00,15,38,-23,-23
20899,195,2022/4/15 14:10,18,33,-15,-15
20900,195,2022/4/15 14:20,15,38,-23,-23
20901,195,2022/4/15 14:30,16,44,-28,-28
20902,195,2022/4/15 14:40,17,29,-12,-12
20903,195,2022/4/15 14:50,16,48,-32,-32
20904,195,2022/4/15 15:00,15,40,-25,-25
20905,195,2022/4/15 15:10,21,35,-14,-14
20906,195,2022/4/15 15:20,16,47,-31,-31
20907,195,2022/4/15 15:30,22,51,-29,-29
20908,195,2022/4/15 15:40,21,35,-14,-14
20909,195,2022/4/15 15:50,19,54,-35,-35
20910,195,2022/4/15 16:00,19,51,-32,-32
20911,195,2022/4/15 16:10,25,41,-16,-16
20912,195,2022/4/15 16:20,24,62,-38,-38
20913,195,2022/4/15 16:30,28,71,-43,-43
20914,195,2022/4/15 16:40,35,53,-18,-18
20915,195,2022/4/15 16:50,36,79,-43,-43
20916,195,2022/4/15 17:00,27,79,-52,-52
20917,195,2022/4/15 17:10,35,83,-48,-48
20918,195,2022/4/15 17:20,47,90,-43,-43
20919,195,2022/4/15 17:30,41,102,-61,-61
20920,195,2022/4/15 17:40,39,105,-66,-66
20921,195,2022/4/15 17:50,37,102,-65,-65
20922,195,2022/4/15 18:00,30,121,-91,-91
20923,195,2022/4/15 18:10,34,108,-74,-74
20924,195,2022/4/15 18:20,28,112,-84,-84
20925,195,2022/4/15 18:30,22,89,-67,-67
20926,195,2022/4/15 18:40,25,111,-86,-86
20927,195,2022/4/15 18:50,22,104,-82,-82
20928,195,2022/4/15 19:00,17,113,-96,-96
20929,195,2022/4/15 19:10,18,107,-89,-89
20930,195,2022/4/15 19:20,13,101,-88,-88
20931,195,2022/4/15 19:30,12,99,-87,-87
20932,195,2022/4/15 19:40,16,77,-61,-61
20933,195,2022/4/15 19:50,10,80,-70,-70
20934,195,2022/4/15 20:00,11,64,-53,-53
20935,195,2022/4/15 20:10,13,68,-55,-55
20936,195,2022/4/15 20:20,12,70,-58,-58
20937,195,2022/4/15 20:30,12,62,-50,-50
20938,195,2022/4/15 20:40,11,61,-50,-50
20939,195,2022/4/15 20:50,9,46,-37,-37
20940,195,2022/4/15 21:00,11,64,-53,-53
20941,195,2022/4/15 21:10,11,67,-56,-56
20942,195,2022/4/15 21:20,11,46,-35,-35
20943,195,2022/4/15 21:30,10,62,-52,-52
20944,195,2022/4/15 21:40,5,66,-61,-61
20945,195,2022/4/15 21:50,7,40,-33,-33
20946,195,2022/4/15 22:00,4,59,-55,-55
20947,195,2022/4/15 22:10,4,43,-39,-39
20948,195,2022/4/15 22:20,2,52,-50,-50
20949,195,2022/4/15 22:30,0,32,-32,-32
20950,195,2022/4/15 22:40,0,3,-3,-3
20951,195,2022/4/15 22:50,0,3,-3,-3
20952,202,2022/4/15 5:00,0,1,-1,
20953,202,2022/4/15 5:10,0,1,-1,
20954,202,2022/4/15 5:20,0,1,-1,
20955,202,2022/4/15 5:30,0,1,-1,
20956,202,2022/4/15 5:40,0,1,-1,
20957,202,2022/4/15 5:50,4,1,3,
20958,202,2022/4/15 6:00,4,1,3,
20959,202,2022/4/15 6:10,18,6,12,
20960,202,2022/4/15 6:20,32,21,11,
20961,202,2022/4/15 6:30,41,21,20,
20962,202,2022/4/15 6:40,56,23,33,
20963,202,2022/4/15 6:50,59,45,14,
20964,202,2022/4/15 7:00,56,62,-6,
20965,202,2022/4/15 7:10,91,85,6,
20966,202,2022/4/15 7:20,156,93,63,
20967,202,2022/4/15 7:30,163,108,55,
20968,202,2022/4/15 7:40,217,126,91,
20969,202,2022/4/15 7:50,189,139,50,
20970,202,2022/4/15 8:00,205,267,-62,
20971,202,2022/4/15 8:10,183,332,-149,
20972,202,2022/4/15 8:20,145,268,-123,
20973,202,2022/4/15 8:30,83,197,-114,
20974,202,2022/4/15 8:40,75,268,-193,
20975,202,2022/4/15 8:50,53,116,-63,
20976,202,2022/4/15 9:00,39,76,-37,
20977,202,2022/4/15 9:10,35,105,-70,
20978,202,2022/4/15 9:20,29,84,-55,
20979,202,2022/4/15 9:30,28,81,-53,
20980,202,2022/4/15 9:40,28,76,-48,
20981,202,2022/4/15 9:50,26,67,-41,
20982,202,2022/4/15 10:00,23,63,-40,
20983,202,2022/4/15 10:10,26,69,-43,
20984,202,2022/4/15 10:20,23,36,-13,
20985,202,2022/4/15 10:30,24,67,-43,
20986,202,2022/4/15 10:40,25,48,-23,
20987,202,2022/4/15 10:50,23,41,-18,
20988,202,2022/4/15 11:00,24,55,-31,
20989,202,2022/4/15 11:10,24,45,-21,
20990,202,2022/4/15 11:20,28,32,-4,
20991,202,2022/4/15 11:30,28,45,-17,
20992,202,2022/4/15 11:40,25,43,-18,
20993,202,2022/4/15 11:50,26,38,-12,
20994,202,2022/4/15 12:00,27,48,-21,
20995,202,2022/4/15 12:10,26,45,-19,
20996,202,2022/4/15 12:20,21,38,-17,
20997,202,2022/4/15 12:30,27,61,-34,
20998,202,2022/4/15 12:40,21,49,-28,
20999,202,2022/4/15 12:50,22,42,-20,
21000,202,2022/4/15 13:00,20,65,-45,
21001,202,2022/4/15 13:10,21,49,-28,
21002,202,2022/4/15 13:20,22,38,-16,
21003,202,2022/4/15 13:30,18,64,-46,
21004,202,2022/4/15 13:40,18,51,-33,
21005,202,2022/4/15 13:50,20,45,-25,
21006,202,2022/4/15 14:00,23,64,-41,
21007,202,2022/4/15 14:10,20,54,-34,
21008,202,2022/4/15 14:20,20,37,-17,
21009,202,2022/4/15 14:30,20,52,-32,
21010,202,2022/4/15 14:40,23,49,-26,
21011,202,2022/4/15 14:50,22,37,-15,
21012,202,2022/4/15 15:00,22,51,-29,
21013,202,2022/4/15 15:10,21,50,-29,
21014,202,2022/4/15 15:20,25,41,-16,
21015,202,2022/4/15 15:30,21,57,-36,
21016,202,2022/4/15 15:40,24,67,-43,
21017,202,2022/4/15 15:50,26,45,-19,
21018,202,2022/4/15 16:00,27,61,-34,
21019,202,2022/4/15 16:10,25,69,-44,
21020,202,2022/4/15 16:20,29,63,-34,
21021,202,2022/4/15 16:30,33,70,-37,
21022,202,2022/4/15 16:40,58,62,-4,
21023,202,2022/4/15 16:50,88,71,17,
21024,202,2022/4/15 17:00,132,76,56,
21025,202,2022/4/15 17:10,175,75,100,
21026,202,2022/4/15 17:20,175,87,88,
21027,202,2022/4/15 17:30,175,103,72,
21028,202,2022/4/15 17:40,227,105,122,
21029,202,2022/4/15 17:50,206,105,101,
21030,202,2022/4/15 18:00,129,110,19,
21031,202,2022/4/15 18:10,174,101,73,
21032,202,2022/4/15 18:20,72,110,-38,
21033,202,2022/4/15 18:30,46,107,-61,
21034,202,2022/4/15 18:40,30,89,-59,
21035,202,2022/4/15 18:50,33,109,-76,
21036,202,2022/4/15 19:00,28,106,-78,
21037,202,2022/4/15 19:10,28,105,-77,
21038,202,2022/4/15 19:20,23,111,-88,
21039,202,2022/4/15 19:30,22,95,-73,
21040,202,2022/4/15 19:40,17,77,-60,
21041,202,2022/4/15 19:50,17,71,-54,
21042,202,2022/4/15 20:00,15,74,-59,
21043,202,2022/4/15 20:10,21,63,-42,
21044,202,2022/4/15 20:20,20,62,-42,
21045,202,2022/4/15 20:30,18,66,-48,
21046,202,2022/4/15 20:40,17,53,-36,
21047,202,2022/4/15 20:50,14,64,-50,
21048,202,2022/4/15 21:00,11,48,-37,
21049,202,2022/4/15 21:10,15,61,-46,
21050,202,2022/4/15 21:20,13,65,-52,
21051,202,2022/4/15 21:30,13,45,-32,
21052,202,2022/4/15 21:40,10,48,-38,
21053,202,2022/4/15 21:50,7,47,-40,
21054,202,2022/4/15 22:00,9,40,-31,
21055,202,2022/4/15 22:10,4,51,-47,
21056,202,2022/4/15 22:20,2,40,-38,
21057,202,2022/4/15 22:30,0,40,-40,
21058,202,2022/4/15 22:40,0,3,-3,
21059,202,2022/4/15 22:50,0,3,-3,
21060,203,2022/4/15 5:00,0,1,-1,
21061,203,2022/4/15 5:10,0,1,-1,
21062,203,2022/4/15 5:20,0,1,-1,
21063,203,2022/4/15 5:30,0,1,-1,
21064,203,2022/4/15 5:40,0,1,-1,
21065,203,2022/4/15 5:50,9,1,8,
21066,203,2022/4/15 6:00,26,1,25,
21067,203,2022/4/15 6:10,47,32,15,
21068,203,2022/4/15 6:20,62,41,21,
21069,203,2022/4/15 6:30,147,53,94,
21070,203,2022/4/15 6:40,199,64,135,
21071,203,2022/4/15 6:50,253,87,166,
21072,203,2022/4/15 7:00,279,116,163,
21073,203,2022/4/15 7:10,349,178,171,
21074,203,2022/4/15 7:20,576,267,309,
21075,203,2022/4/15 7:30,598,332,266,
21076,203,2022/4/15 7:40,598,333,265,
21077,203,2022/4/15 7:50,390,196,194,
21078,203,2022/4/15 8:00,436,318,118,
21079,203,2022/4/15 8:10,357,195,162,
21080,203,2022/4/15 8:20,330,216,114,
21081,203,2022/4/15 8:30,280,318,-38,
21082,203,2022/4/15 8:40,215,207,8,
21083,203,2022/4/15 8:50,174,107,67,
21084,203,2022/4/15 9:00,100,105,-5,
21085,203,2022/4/15 9:10,74,108,-34,
21086,203,2022/4/15 9:20,62,108,-46,
21087,203,2022/4/15 9:30,47,97,-50,
21088,203,2022/4/15 9:40,44,72,-28,
21089,203,2022/4/15 9:50,36,93,-57,
21090,203,2022/4/15 10:00,35,73,-38,
21091,203,2022/4/15 10:10,35,70,-35,
21092,203,2022/4/15 10:20,35,77,-42,
21093,203,2022/4/15 10:30,37,68,-31,
21094,203,2022/4/15 10:40,32,66,-34,
21095,203,2022/4/15 10:50,30,76,-46,
21096,203,2022/4/15 11:00,30,66,-36,
21097,203,2022/4/15 11:10,36,66,-30,
21098,203,2022/4/15 11:20,33,72,-39,
21099,203,2022/4/15 11:30,30,69,-39,
21100,203,2022/4/15 11:40,35,68,-33,
21101,203,2022/4/15 11:50,34,75,-41,
21102,203,2022/4/15 12:00,36,67,-31,
21103,203,2022/4/15 12:10,33,64,-31,
21104,203,2022/4/15 12:20,38,84,-46,
21105,203,2022/4/15 12:30,32,73,-41,
21106,203,2022/4/15 12:40,35,70,-35,
21107,203,2022/4/15 12:50,31,82,-51,
21108,203,2022/4/15 13:00,28,68,-40,
21109,203,2022/4/15 13:10,33,60,-27,
21110,203,2022/4/15 13:20,33,87,-54,
21111,203,2022/4/15 13:30,29,74,-45,
21112,203,2022/4/15 13:40,32,67,-35,
21113,203,2022/4/15 13:50,26,85,-59,
21114,203,2022/4/15 14:00,35,84,-49,
21115,203,2022/4/15 14:10,28,63,-35,
21116,203,2022/4/15 14:20,29,83,-54,
21117,203,2022/4/15 14:30,32,82,-50,
21118,203,2022/4/15 14:40,32,67,-35,
21119,203,2022/4/15 14:50,27,91,-64,
21120,203,2022/4/15 15:00,31,77,-46,
21121,203,2022/4/15 15:10,28,67,-39,
21122,203,2022/4/15 15:20,35,93,-58,
21123,203,2022/4/15 15:30,35,79,-44,
21124,203,2022/4/15 15:40,35,84,-49,
21125,203,2022/4/15 15:50,34,106,-72,
21126,203,2022/4/15 16:00,43,96,-53,
21127,203,2022/4/15 16:10,61,87,-26,
21128,203,2022/4/15 16:20,45,108,-63,
21129,203,2022/4/15 16:30,93,105,-12,
21130,203,2022/4/15 16:40,316,108,208,
21131,203,2022/4/15 16:50,334,102,232,
21132,203,2022/4/15 17:00,165,125,40,
21133,203,2022/4/15 17:10,274,122,152,
21134,203,2022/4/15 17:20,234,118,116,
21135,203,2022/4/15 17:30,198,127,71,
21136,203,2022/4/15 17:40,268,149,119,
21137,203,2022/4/15 17:50,276,190,86,
21138,203,2022/4/15 18:00,208,178,30,
21139,203,2022/4/15 18:10,105,198,-93,
21140,203,2022/4/15 18:20,76,214,-138,
21141,203,2022/4/15 18:30,50,223,-173,
21142,203,2022/4/15 18:40,48,215,-167,
21143,203,2022/4/15 18:50,40,228,-188,
21144,203,2022/4/15 19:00,29,223,-194,
21145,203,2022/4/15 19:10,35,178,-143,
21146,203,2022/4/15 19:20,30,192,-162,
21147,203,2022/4/15 19:30,25,109,-84,
21148,203,2022/4/15 19:40,35,121,-86,
21149,203,2022/4/15 19:50,24,125,-101,
21150,203,2022/4/15 20:00,26,102,-76,
21151,203,2022/4/15 20:10,27,106,-79,
21152,203,2022/4/15 20:20,25,107,-82,
21153,203,2022/4/15 20:30,25,98,-73,
21154,203,2022/4/15 20:40,27,94,-67,
21155,203,2022/4/15 20:50,20,92,-72,
21156,203,2022/4/15 21:00,23,106,-83,
21157,203,2022/4/15 21:10,23,103,-80,
21158,203,2022/4/15 21:20,17,75,-58,
21159,203,2022/4/15 21:30,19,100,-81,
21160,203,2022/4/15 21:40,18,91,-73,
21161,203,2022/4/15 21:50,11,71,-60,
21162,203,2022/4/15 22:00,10,110,-100,
21163,203,2022/4/15 22:10,6,79,-73,
21164,203,2022/4/15 22:20,4,84,-80,
21165,203,2022/4/15 22:30,1,77,-76,
21166,203,2022/4/15 22:40,0,10,-10,
21167,203,2022/4/15 22:50,0,3,-3,
21168,194,2022/4/15 5:00,0,1,-1,
21169,194,2022/4/15 5:10,0,1,-1,
21170,194,2022/4/15 5:20,0,1,-1,
21171,194,2022/4/15 5:30,0,1,-1,
21172,194,2022/4/15 5:40,0,1,-1,
21173,194,2022/4/15 5:50,17,1,16,
21174,194,2022/4/15 6:00,33,1,32,
21175,194,2022/4/15 6:10,57,23,34,
21176,194,2022/4/15 6:20,77,33,44,
21177,194,2022/4/15 6:30,127,36,91,
21178,194,2022/4/15 6:40,183,43,140,
21179,194,2022/4/15 6:50,201,63,138,
21180,194,2022/4/15 7:00,280,65,215,
21181,194,2022/4/15 7:10,300,77,223,
21182,194,2022/4/15 7:20,365,104,261,
21183,194,2022/4/15 7:30,390,105,285,
21184,194,2022/4/15 7:40,365,108,257,
21185,194,2022/4/15 7:50,364,97,267,
21186,194,2022/4/15 8:00,336,122,214,
21187,194,2022/4/15 8:10,343,126,217,
21188,194,2022/4/15 8:20,317,125,192,
21189,194,2022/4/15 8:30,269,111,158,
21190,194,2022/4/15 8:40,187,105,82,
21191,194,2022/4/15 8:50,106,105,1,
21192,194,2022/4/15 9:00,100,77,23,
21193,194,2022/4/15 9:10,67,76,-9,
21194,194,2022/4/15 9:20,48,63,-15,
21195,194,2022/4/15 9:30,48,61,-13,
21196,194,2022/4/15 9:40,40,72,-32,
21197,194,2022/4/15 9:50,39,64,-25,
21198,194,2022/4/15 10:00,33,60,-27,
21199,194,2022/4/15 10:10,37,63,-26,
21200,194,2022/4/15 10:20,31,62,-31,
21201,194,2022/4/15 10:30,30,65,-35,
21202,194,2022/4/15 10:40,27,64,-37,
21203,194,2022/4/15 10:50,29,46,-17,
21204,194,2022/4/15 11:00,26,67,-41,
21205,194,2022/4/15 11:10,31,66,-35,
21206,194,2022/4/15 11:20,31,54,-23,
21207,194,2022/4/15 11:30,26,70,-44,
21208,194,2022/4/15 11:40,26,63,-37,
21209,194,2022/4/15 11:50,36,48,-12,
21210,194,2022/4/15 12:00,32,63,-31,
21211,194,2022/4/15 12:10,35,63,-28,
21212,194,2022/4/15 12:20,29,49,-20,
21213,194,2022/4/15 12:30,35,60,-25,
21214,194,2022/4/15 12:40,26,61,-35,
21215,194,2022/4/15 12:50,35,47,-12,
21216,194,2022/4/15 13:00,26,64,-38,
21217,194,2022/4/15 13:10,23,64,-41,
21218,194,2022/4/15 13:20,28,54,-26,
21219,194,2022/4/15 13:30,26,71,-45,
21220,194,2022/4/15 13:40,25,61,-36,
21221,194,2022/4/15 13:50,26,49,-23,
21222,194,2022/4/15 14:00,27,70,-43,
21223,194,2022/4/15 14:10,25,69,-44,
21224,194,2022/4/15 14:20,31,50,-19,
21225,194,2022/4/15 14:30,24,63,-39,
21226,194,2022/4/15 14:40,25,66,-41,
21227,194,2022/4/15 14:50,29,58,-29,
21228,194,2022/4/15 15:00,23,74,-51,
21229,194,2022/4/15 15:10,26,64,-38,
21230,194,2022/4/15 15:20,24,60,-36,
21231,194,2022/4/15 15:30,31,75,-44,
21232,194,2022/4/15 15:40,28,73,-45,
21233,194,2022/4/15 15:50,31,61,-30,
21234,194,2022/4/15 16:00,28,76,-48,
21235,194,2022/4/15 16:10,30,93,-63,
21236,194,2022/4/15 16:20,36,78,-42,
21237,194,2022/4/15 16:30,42,91,-49,
21238,194,2022/4/15 16:40,47,105,-58,
21239,194,2022/4/15 16:50,40,93,-53,
21240,194,2022/4/15 17:00,44,103,-59,
21241,194,2022/4/15 17:10,74,101,-27,
21242,194,2022/4/15 17:20,67,121,-54,
21243,194,2022/4/15 17:30,88,123,-35,
21244,194,2022/4/15 17:40,169,127,42,
21245,194,2022/4/15 17:50,71,118,-47,
21246,194,2022/4/15 18:00,51,145,-94,
21247,194,2022/4/15 18:10,48,144,-96,
21248,194,2022/4/15 18:20,40,182,-142,
21249,194,2022/4/15 18:30,28,139,-111,
21250,194,2022/4/15 18:40,26,169,-143,
21251,194,2022/4/15 18:50,27,181,-154,
21252,194,2022/4/15 19:00,26,147,-121,
21253,194,2022/4/15 19:10,27,144,-117,
21254,194,2022/4/15 19:20,25,116,-91,
21255,194,2022/4/15 19:30,27,105,-78,
21256,194,2022/4/15 19:40,23,109,-86,
21257,194,2022/4/15 19:50,20,109,-89,
21258,194,2022/4/15 20:00,22,107,-85,
21259,194,2022/4/15 20:10,21,100,-79,
21260,194,2022/4/15 20:20,15,102,-87,
21261,194,2022/4/15 20:30,20,95,-75,
21262,194,2022/4/15 20:40,17,82,-65,
21263,194,2022/4/15 20:50,13,94,-81,
21264,194,2022/4/15 21:00,22,74,-52,
21265,194,2022/4/15 21:10,13,99,-86,
21266,194,2022/4/15 21:20,16,85,-69,
21267,194,2022/4/15 21:30,10,75,-65,
21268,194,2022/4/15 21:40,10,77,-67,
21269,194,2022/4/15 21:50,10,77,-67,
21270,194,2022/4/15 22:00,6,64,-58,
21271,194,2022/4/15 22:10,2,94,-92,
21272,194,2022/4/15 22:20,1,67,-66,
21273,194,2022/4/15 22:30,1,69,-68,
21274,194,2022/4/15 22:40,0,38,-38,
21275,194,2022/4/15 22:50,0,3,-3,
21276,198,2022/4/15 5:00,0,1,-1,
21277,198,2022/4/15 5:10,0,1,-1,
21278,198,2022/4/15 5:20,0,1,-1,
21279,198,2022/4/15 5:30,0,1,-1,
21280,198,2022/4/15 5:40,0,1,-1,
21281,198,2022/4/15 5:50,13,1,12,
21282,198,2022/4/15 6:00,29,1,28,
21283,198,2022/4/15 6:10,31,21,10,
21284,198,2022/4/15 6:20,36,28,8,
21285,198,2022/4/15 6:30,53,37,16,
21286,198,2022/4/15 6:40,86,41,45,
21287,198,2022/4/15 6:50,113,62,51,
21288,198,2022/4/15 7:00,149,72,77,
21289,198,2022/4/15 7:10,224,87,137,
21290,198,2022/4/15 7:20,232,104,128,
21291,198,2022/4/15 7:30,283,102,181,
21292,198,2022/4/15 7:40,286,120,166,
21293,198,2022/4/15 7:50,235,123,112,
21294,198,2022/4/15 8:00,220,127,93,
21295,198,2022/4/15 8:10,207,118,89,
21296,198,2022/4/15 8:20,166,107,59,
21297,198,2022/4/15 8:30,123,105,18,
21298,198,2022/4/15 8:40,67,95,-28,
21299,198,2022/4/15 8:50,51,106,-55,
21300,198,2022/4/15 9:00,39,75,-36,
21301,198,2022/4/15 9:10,32,49,-17,
21302,198,2022/4/15 9:20,34,74,-40,
21303,198,2022/4/15 9:30,27,61,-34,
21304,198,2022/4/15 9:40,26,69,-43,
21305,198,2022/4/15 9:50,25,72,-47,
21306,198,2022/4/15 10:00,24,60,-36,
21307,198,2022/4/15 10:10,23,49,-26,
21308,198,2022/4/15 10:20,22,65,-43,
21309,198,2022/4/15 10:30,21,46,-25,
21310,198,2022/4/15 10:40,22,51,-29,
21311,198,2022/4/15 10:50,19,65,-46,
21312,198,2022/4/15 11:00,17,61,-44,
21313,198,2022/4/15 11:10,21,50,-29,
21314,198,2022/4/15 11:20,19,63,-44,
21315,198,2022/4/15 11:30,22,45,-23,
21316,198,2022/4/15 11:40,24,61,-37,
21317,198,2022/4/15 11:50,19,62,-43,
21318,198,2022/4/15 12:00,22,59,-37,
21319,198,2022/4/15 12:10,21,48,-27,
21320,198,2022/4/15 12:20,21,62,-41,
21321,198,2022/4/15 12:30,22,51,-29,
21322,198,2022/4/15 12:40,22,61,-39,
21323,198,2022/4/15 12:50,19,62,-43,
21324,198,2022/4/15 13:00,21,52,-31,
21325,198,2022/4/15 13:10,22,64,-42,
21326,198,2022/4/15 13:20,26,68,-42,
21327,198,2022/4/15 13:30,22,51,-29,
21328,198,2022/4/15 13:40,22,54,-32,
21329,198,2022/4/15 13:50,24,61,-37,
21330,198,2022/4/15 14:00,22,51,-29,
21331,198,2022/4/15 14:10,23,52,-29,
21332,198,2022/4/15 14:20,22,73,-51,
21333,198,2022/4/15 14:30,21,53,-32,
21334,198,2022/4/15 14:40,23,66,-43,
21335,198,2022/4/15 14:50,21,67,-46,
21336,198,2022/4/15 15:00,22,55,-33,
21337,198,2022/4/15 15:10,24,65,-41,
21338,198,2022/4/15 15:20,20,70,-50,
21339,198,2022/4/15 15:30,22,60,-38,
21340,198,2022/4/15 15:40,23,60,-37,
21341,198,2022/4/15 15:50,25,82,-57,
21342,198,2022/4/15 16:00,35,63,-28,
21343,198,2022/4/15 16:10,32,71,-39,
21344,198,2022/4/15 16:20,24,93,-69,
21345,198,2022/4/15 16:30,28,77,-49,
21346,198,2022/4/15 16:40,34,76,-42,
21347,198,2022/4/15 16:50,27,93,-66,
21348,198,2022/4/15 17:00,35,105,-70,
21349,198,2022/4/15 17:10,67,108,-41,
21350,198,2022/4/15 17:20,54,105,-51,
21351,198,2022/4/15 17:30,40,107,-67,
21352,198,2022/4/15 17:40,53,109,-56,
21353,198,2022/4/15 17:50,41,97,-56,
21354,198,2022/4/15 18:00,36,121,-85,
21355,198,2022/4/15 18:10,35,111,-76,
21356,198,2022/4/15 18:20,26,110,-84,
21357,198,2022/4/15 18:30,27,109,-82,
21358,198,2022/4/15 18:40,26,121,-95,
21359,198,2022/4/15 18:50,23,124,-101,
21360,198,2022/4/15 19:00,25,119,-94,
21361,198,2022/4/15 19:10,18,133,-115,
21362,198,2022/4/15 19:20,21,107,-86,
21363,198,2022/4/15 19:30,14,122,-108,
21364,198,2022/4/15 19:40,20,126,-106,
21365,198,2022/4/15 19:50,15,102,-87,
21366,198,2022/4/15 20:00,13,99,-86,
21367,198,2022/4/15 20:10,16,100,-84,
21368,198,2022/4/15 20:20,14,98,-84,
21369,198,2022/4/15 20:30,14,76,-62,
21370,198,2022/4/15 20:40,15,79,-64,
21371,198,2022/4/15 20:50,14,64,-50,
21372,198,2022/4/15 21:00,16,95,-79,
21373,198,2022/4/15 21:10,12,79,-67,
21374,198,2022/4/15 21:20,10,67,-57,
21375,198,2022/4/15 21:30,8,92,-84,
21376,198,2022/4/15 21:40,8,63,-55,
21377,198,2022/4/15 21:50,7,62,-55,
21378,198,2022/4/15 22:00,4,77,-73,
21379,198,2022/4/15 22:10,2,71,-69,
21380,198,2022/4/15 22:20,1,72,-71,
21381,198,2022/4/15 22:30,1,72,-71,
21382,198,2022/4/15 22:40,0,49,-49,
21383,198,2022/4/15 22:50,0,3,-3,
21384,196,2022/4/15 5:00,0,1,-1,
21385,196,2022/4/15 5:10,0,1,-1,
21386,196,2022/4/15 5:20,0,1,-1,
21387,196,2022/4/15 5:30,0,1,-1,
21388,196,2022/4/15 5:40,0,1,-1,
21389,196,2022/4/15 5:50,25,1,24,
21390,196,2022/4/15 6:00,53,5,48,
21391,196,2022/4/15 6:10,58,33,25,
21392,196,2022/4/15 6:20,91,38,53,
21393,196,2022/4/15 6:30,147,76,71,
21394,196,2022/4/15 6:40,225,77,148,
21395,196,2022/4/15 6:50,281,108,173,
21396,196,2022/4/15 7:00,348,93,255,
21397,196,2022/4/15 7:10,596,114,482,
21398,196,2022/4/15 7:20,629,123,506,
21399,196,2022/4/15 7:30,722,146,576,
21400,196,2022/4/15 7:40,722,184,538,
21401,196,2022/4/15 7:50,722,145,577,
21402,196,2022/4/15 8:00,599,144,455,
21403,196,2022/4/15 8:10,601,179,422,
21404,196,2022/4/15 8:20,376,153,223,
21405,196,2022/4/15 8:30,279,153,126,
21406,196,2022/4/15 8:40,227,121,106,
21407,196,2022/4/15 8:50,177,116,61,
21408,196,2022/4/15 9:00,142,87,55,
21409,196,2022/4/15 9:10,72,103,-31,
21410,196,2022/4/15 9:20,63,100,-37,
21411,196,2022/4/15 9:30,55,93,-38,
21412,196,2022/4/15 9:40,40,90,-50,
21413,196,2022/4/15 9:50,39,72,-33,
21414,196,2022/4/15 10:00,41,96,-55,
21415,196,2022/4/15 10:10,27,92,-65,
21416,196,2022/4/15 10:20,35,76,-41,
21417,196,2022/4/15 10:30,28,75,-47,
21418,196,2022/4/15 10:40,35,90,-55,
21419,196,2022/4/15 10:50,26,78,-52,
21420,196,2022/4/15 11:00,37,72,-35,
21421,196,2022/4/15 11:10,36,87,-51,
21422,196,2022/4/15 11:20,38,77,-39,
21423,196,2022/4/15 11:30,36,84,-48,
21424,196,2022/4/15 11:40,41,91,-50,
21425,196,2022/4/15 11:50,43,76,-33,
21426,196,2022/4/15 12:00,48,77,-29,
21427,196,2022/4/15 12:10,40,90,-50,
21428,196,2022/4/15 12:20,51,75,-24,
21429,196,2022/4/15 12:30,52,73,-21,
21430,196,2022/4/15 12:40,40,96,-56,
21431,196,2022/4/15 12:50,42,77,-35,
21432,196,2022/4/15 13:00,42,73,-31,
21433,196,2022/4/15 13:10,41,98,-57,
21434,196,2022/4/15 13:20,38,84,-46,
21435,196,2022/4/15 13:30,34,81,-47,
21436,196,2022/4/15 13:40,42,101,-59,
21437,196,2022/4/15 13:50,29,81,-52,
21438,196,2022/4/15 14:00,32,75,-43,
21439,196,2022/4/15 14:10,28,101,-73,
21440,196,2022/4/15 14:20,31,79,-48,
21441,196,2022/4/15 14:30,33,76,-43,
21442,196,2022/4/15 14:40,26,106,-80,
21443,196,2022/4/15 14:50,33,79,-46,
21444,196,2022/4/15 15:00,37,92,-55,
21445,196,2022/4/15 15:10,32,110,-78,
21446,196,2022/4/15 15:20,43,86,-43,
21447,196,2022/4/15 15:30,40,97,-57,
21448,196,2022/4/15 15:40,43,109,-66,
21449,196,2022/4/15 15:50,42,109,-67,
21450,196,2022/4/15 16:00,47,98,-51,
21451,196,2022/4/15 16:10,53,122,-69,
21452,196,2022/4/15 16:20,78,99,-21,
21453,196,2022/4/15 16:30,106,99,7,
21454,196,2022/4/15 16:40,195,108,87,
21455,196,2022/4/15 16:50,123,129,-6,
21456,196,2022/4/15 17:00,183,149,34,
21457,196,2022/4/15 17:10,211,143,68,
21458,196,2022/4/15 17:20,261,178,83,
21459,196,2022/4/15 17:30,208,213,-5,
21460,196,2022/4/15 17:40,205,197,8,
21461,196,2022/4/15 17:50,198,232,-34,
21462,196,2022/4/15 18:00,157,208,-51,
21463,196,2022/4/15 18:10,206,218,-12,
21464,196,2022/4/15 18:20,170,217,-47,
21465,196,2022/4/15 18:30,103,234,-131,
21466,196,2022/4/15 18:40,76,233,-157,
21467,196,2022/4/15 18:50,45,256,-211,
21468,196,2022/4/15 19:00,35,219,-184,
21469,196,2022/4/15 19:10,36,198,-162,
21470,196,2022/4/15 19:20,27,208,-181,
21471,196,2022/4/15 19:30,31,179,-148,
21472,196,2022/4/15 19:40,25,158,-133,
21473,196,2022/4/15 19:50,33,128,-95,
21474,196,2022/4/15 20:00,29,111,-82,
21475,196,2022/4/15 20:10,29,100,-71,
21476,196,2022/4/15 20:20,28,127,-99,
21477,196,2022/4/15 20:30,27,104,-77,
21478,196,2022/4/15 20:40,25,107,-82,
21479,196,2022/4/15 20:50,30,106,-76,
21480,196,2022/4/15 21:00,24,104,-80,
21481,196,2022/4/15 21:10,23,114,-91,
21482,196,2022/4/15 21:20,22,123,-101,
21483,196,2022/4/15 21:30,24,108,-84,
21484,196,2022/4/15 21:40,18,99,-81,
21485,196,2022/4/15 21:50,14,124,-110,
21486,196,2022/4/15 22:00,12,103,-91,
21487,196,2022/4/15 22:10,7,96,-89,
21488,196,2022/4/15 22:20,2,108,-106,
21489,196,2022/4/15 22:30,1,63,-62,
21490,196,2022/4/15 22:40,0,102,-102,
21491,196,2022/4/15 22:50,0,3,-3,
21492,199,2022/4/15 5:00,0,1,-1,
21493,199,2022/4/15 5:10,0,1,-1,
21494,199,2022/4/15 5:20,0,1,-1,
21495,199,2022/4/15 5:30,0,1,-1,
21496,199,2022/4/15 5:40,0,1,-1,
21497,199,2022/4/15 5:50,32,1,31,
21498,199,2022/4/15 6:00,55,1,54,
21499,199,2022/4/15 6:10,83,6,77,
21500,199,2022/4/15 6:20,78,25,53,
21501,199,2022/4/15 6:30,106,21,85,
21502,199,2022/4/15 6:40,187,52,135,
21503,199,2022/4/15 6:50,226,49,177,
21504,199,2022/4/15 7:00,267,81,186,
21505,199,2022/4/15 7:10,358,102,256,
21506,199,2022/4/15 7:20,328,106,222,
21507,199,2022/4/15 7:30,567,102,465,
21508,199,2022/4/15 7:40,447,70,377,
21509,199,2022/4/15 7:50,324,68,256,
21510,199,2022/4/15 8:00,317,57,260,
21511,199,2022/4/15 8:10,280,69,211,
21512,199,2022/4/15 8:20,246,63,183,
21513,199,2022/4/15 8:30,207,72,135,
21514,199,2022/4/15 8:40,146,66,80,
21515,199,2022/4/15 8:50,83,68,15,
21516,199,2022/4/15 9:00,61,59,2,
21517,199,2022/4/15 9:10,48,57,-9,
21518,199,2022/4/15 9:20,43,52,-9,
21519,199,2022/4/15 9:30,33,65,-32,
21520,199,2022/4/15 9:40,30,57,-27,
21521,199,2022/4/15 9:50,32,60,-28,
21522,199,2022/4/15 10:00,30,62,-32,
21523,199,2022/4/15 10:10,27,50,-23,
21524,199,2022/4/15 10:20,28,62,-34,
21525,199,2022/4/15 10:30,27,64,-37,
21526,199,2022/4/15 10:40,28,54,-26,
21527,199,2022/4/15 10:50,26,52,-26,
21528,199,2022/4/15 11:00,28,66,-38,
21529,199,2022/4/15 11:10,29,58,-29,
21530,199,2022/4/15 11:20,28,51,-23,
21531,199,2022/4/15 11:30,26,65,-39,
21532,199,2022/4/15 11:40,28,51,-23,
21533,199,2022/4/15 11:50,29,53,-24,
21534,199,2022/4/15 12:00,31,62,-31,
21535,199,2022/4/15 12:10,31,53,-22,
21536,199,2022/4/15 12:20,33,45,-12,
21537,199,2022/4/15 12:30,31,65,-34,
21538,199,2022/4/15 12:40,26,50,-24,
21539,199,2022/4/15 12:50,25,60,-35,
21540,199,2022/4/15 13:00,26,63,-37,
21541,199,2022/4/15 13:10,29,50,-21,
21542,199,2022/4/15 13:20,29,61,-32,
21543,199,2022/4/15 13:30,27,66,-39,
21544,199,2022/4/15 13:40,27,59,-32,
21545,199,2022/4/15 13:50,24,64,-40,
21546,199,2022/4/15 14:00,22,63,-41,
21547,199,2022/4/15 14:10,27,61,-34,
21548,199,2022/4/15 14:20,22,64,-42,
21549,199,2022/4/15 14:30,25,72,-47,
21550,199,2022/4/15 14:40,22,53,-31,
21551,199,2022/4/15 14:50,27,66,-39,
21552,199,2022/4/15 15:00,28,75,-47,
21553,199,2022/4/15 15:10,28,64,-36,
21554,199,2022/4/15 15:20,29,65,-36,
21555,199,2022/4/15 15:30,24,74,-50,
21556,199,2022/4/15 15:40,24,78,-54,
21557,199,2022/4/15 15:50,25,76,-51,
21558,199,2022/4/15 16:00,29,87,-58,
21559,199,2022/4/15 16:10,28,83,-55,
21560,199,2022/4/15 16:20,26,80,-54,
21561,199,2022/4/15 16:30,41,99,-58,
21562,199,2022/4/15 16:40,163,112,51,
21563,199,2022/4/15 16:50,41,100,-59,
21564,199,2022/4/15 17:00,43,108,-65,
21565,199,2022/4/15 17:10,41,127,-86,
21566,199,2022/4/15 17:20,37,110,-73,
21567,199,2022/4/15 17:30,30,118,-88,
21568,199,2022/4/15 17:40,31,118,-87,
21569,199,2022/4/15 17:50,29,132,-103,
21570,199,2022/4/15 18:00,24,107,-83,
21571,199,2022/4/15 18:10,24,149,-125,
21572,199,2022/4/15 18:20,26,128,-102,
21573,199,2022/4/15 18:30,24,119,-95,
21574,199,2022/4/15 18:40,22,146,-124,
21575,199,2022/4/15 18:50,21,112,-91,
21576,199,2022/4/15 19:00,19,109,-90,
21577,199,2022/4/15 19:10,23,109,-86,
21578,199,2022/4/15 19:20,19,121,-102,
21579,199,2022/4/15 19:30,22,120,-98,
21580,199,2022/4/15 19:40,21,114,-93,
21581,199,2022/4/15 19:50,19,113,-94,
21582,199,2022/4/15 20:00,21,90,-69,
21583,199,2022/4/15 20:10,20,91,-71,
21584,199,2022/4/15 20:20,20,82,-62,
21585,199,2022/4/15 20:30,26,77,-51,
21586,199,2022/4/15 20:40,20,78,-58,
21587,199,2022/4/15 20:50,19,73,-54,
21588,199,2022/4/15 21:00,20,69,-49,
21589,199,2022/4/15 21:10,18,91,-73,
21590,199,2022/4/15 21:20,18,73,-55,
21591,199,2022/4/15 21:30,16,69,-53,
21592,199,2022/4/15 21:40,12,77,-65,
21593,199,2022/4/15 21:50,9,77,-68,
21594,199,2022/4/15 22:00,7,63,-56,
21595,199,2022/4/15 22:10,2,78,-76,
21596,199,2022/4/15 22:20,1,55,-54,
21597,199,2022/4/15 22:30,2,71,-69,
21598,199,2022/4/15 22:40,0,67,-67,
21599,199,2022/4/15 22:50,0,17,-17,
21600,197,2022/4/15 5:00,0,1,-1,
21601,197,2022/4/15 5:10,0,1,-1,
21602,197,2022/4/15 5:20,0,1,-1,
21603,197,2022/4/15 5:30,0,1,-1,
21604,197,2022/4/15 5:40,5,1,4,
21605,197,2022/4/15 5:50,29,1,28,
21606,197,2022/4/15 6:00,58,1,57,
21607,197,2022/4/15 6:10,45,1,44,
21608,197,2022/4/15 6:20,75,19,56,
21609,197,2022/4/15 6:30,81,21,60,
21610,197,2022/4/15 6:40,168,21,147,
21611,197,2022/4/15 6:50,185,48,137,
21612,197,2022/4/15 7:00,218,64,154,
21613,197,2022/4/15 7:10,274,99,175,
21614,197,2022/4/15 7:20,305,106,199,
21615,197,2022/4/15 7:30,281,109,172,
21616,197,2022/4/15 7:40,276,198,78,
21617,197,2022/4/15 7:50,273,138,135,
21618,197,2022/4/15 8:00,226,122,104,
21619,197,2022/4/15 8:10,212,93,119,
21620,197,2022/4/15 8:20,149,76,73,
21621,197,2022/4/15 8:30,78,60,18,
21622,197,2022/4/15 8:40,57,65,-8,
21623,197,2022/4/15 8:50,54,56,-2,
21624,197,2022/4/15 9:00,32,49,-17,
21625,197,2022/4/15 9:10,28,47,-19,
21626,197,2022/4/15 9:20,27,51,-24,
21627,197,2022/4/15 9:30,28,49,-21,
21628,197,2022/4/15 9:40,24,50,-26,
21629,197,2022/4/15 9:50,26,51,-25,
21630,197,2022/4/15 10:00,25,38,-13,
21631,197,2022/4/15 10:10,21,40,-19,
21632,197,2022/4/15 10:20,18,50,-32,
21633,197,2022/4/15 10:30,22,31,-9,
21634,197,2022/4/15 10:40,15,40,-25,
21635,197,2022/4/15 10:50,20,46,-26,
21636,197,2022/4/15 11:00,19,32,-13,
21637,197,2022/4/15 11:10,17,48,-31,
21638,197,2022/4/15 11:20,28,48,-20,
21639,197,2022/4/15 11:30,23,38,-15,
21640,197,2022/4/15 11:40,27,50,-23,
21641,197,2022/4/15 11:50,25,48,-23,
21642,197,2022/4/15 12:00,25,29,-4,
21643,197,2022/4/15 12:10,23,45,-22,
21644,197,2022/4/15 12:20,25,42,-17,
21645,197,2022/4/15 12:30,23,35,-12,
21646,197,2022/4/15 12:40,24,45,-21,
21647,197,2022/4/15 12:50,21,49,-28,
21648,197,2022/4/15 13:00,24,38,-14,
21649,197,2022/4/15 13:10,20,41,-21,
21650,197,2022/4/15 13:20,21,46,-25,
21651,197,2022/4/15 13:30,22,37,-15,
21652,197,2022/4/15 13:40,19,50,-31,
21653,197,2022/4/15 13:50,22,49,-27,
21654,197,2022/4/15 14:00,21,38,-17,
21655,197,2022/4/15 14:10,20,45,-25,
21656,197,2022/4/15 14:20,23,45,-22,
21657,197,2022/4/15 14:30,22,37,-15,
21658,197,2022/4/15 14:40,24,54,-30,
21659,197,2022/4/15 14:50,22,54,-32,
21660,197,2022/4/15 15:00,23,45,-22,
21661,197,2022/4/15 15:10,24,65,-41,
21662,197,2022/4/15 15:20,26,65,-39,
21663,197,2022/4/15 15:30,25,48,-23,
21664,197,2022/4/15 15:40,25,62,-37,
21665,197,2022/4/15 15:50,62,62,0,
21666,197,2022/4/15 16:00,76,57,19,
21667,197,2022/4/15 16:10,33,65,-32,
21668,197,2022/4/15 16:20,28,84,-56,
21669,197,2022/4/15 16:30,53,62,-9,
21670,197,2022/4/15 16:40,149,63,86,
21671,197,2022/4/15 16:50,75,77,-2,
21672,197,2022/4/15 17:00,46,80,-34,
21673,197,2022/4/15 17:10,44,93,-49,
21674,197,2022/4/15 17:20,41,100,-59,
21675,197,2022/4/15 17:30,44,102,-58,
21676,197,2022/4/15 17:40,40,108,-68,
21677,197,2022/4/15 17:50,27,112,-85,
21678,197,2022/4/15 18:00,30,90,-60,
21679,197,2022/4/15 18:10,34,101,-67,
21680,197,2022/4/15 18:20,24,108,-84,
21681,197,2022/4/15 18:30,26,123,-97,
21682,197,2022/4/15 18:40,23,122,-99,
21683,197,2022/4/15 18:50,20,128,-108,
21684,197,2022/4/15 19:00,22,124,-102,
21685,197,2022/4/15 19:10,16,89,-73,
21686,197,2022/4/15 19:20,16,124,-108,
21687,197,2022/4/15 19:30,14,105,-91,
21688,197,2022/4/15 19:40,16,103,-87,
21689,197,2022/4/15 19:50,14,97,-83,
21690,197,2022/4/15 20:00,16,88,-72,
21691,197,2022/4/15 20:10,16,77,-61,
21692,197,2022/4/15 20:20,11,79,-68,
21693,197,2022/4/15 20:30,16,71,-55,
21694,197,2022/4/15 20:40,10,66,-56,
21695,197,2022/4/15 20:50,9,70,-61,
21696,197,2022/4/15 21:00,8,71,-63,
21697,197,2022/4/15 21:10,7,50,-43,
21698,197,2022/4/15 21:20,9,76,-67,
21699,197,2022/4/15 21:30,5,69,-64,
21700,197,2022/4/15 21:40,7,68,-61,
21701,197,2022/4/15 21:50,4,63,-59,
21702,197,2022/4/15 22:00,1,72,-71,
21703,197,2022/4/15 22:10,0,49,-49,
21704,197,2022/4/15 22:20,0,68,-68,
21705,197,2022/4/15 22:30,0,64,-64,
21706,197,2022/4/15 22:40,0,49,-49,
21707,197,2022/4/15 22:50,0,25,-25,
21708,201,2022/4/15 5:00,0,1,-1,
21709,201,2022/4/15 5:10,0,1,-1,
21710,201,2022/4/15 5:20,0,1,-1,
21711,201,2022/4/15 5:30,0,1,-1,
21712,201,2022/4/15 5:40,1,1,0,
21713,201,2022/4/15 5:50,8,1,7,
21714,201,2022/4/15 6:00,5,1,4,
21715,201,2022/4/15 6:10,7,1,6,
21716,201,2022/4/15 6:20,8,23,-15,
21717,201,2022/4/15 6:30,14,35,-21,
21718,201,2022/4/15 6:40,17,21,-4,
21719,201,2022/4/15 6:50,14,38,-24,
21720,201,2022/4/15 7:00,20,41,-21,
21721,201,2022/4/15 7:10,27,76,-49,
21722,201,2022/4/15 7:20,29,76,-47,
21723,201,2022/4/15 7:30,30,111,-81,
21724,201,2022/4/15 7:40,26,115,-89,
21725,201,2022/4/15 7:50,26,108,-82,
21726,201,2022/4/15 8:00,24,120,-96,
21727,201,2022/4/15 8:10,17,150,-133,
21728,201,2022/4/15 8:20,15,109,-94,
21729,201,2022/4/15 8:30,13,106,-93,
21730,201,2022/4/15 8:40,17,104,-87,
21731,201,2022/4/15 8:50,10,103,-93,
21732,201,2022/4/15 9:00,6,93,-87,
21733,201,2022/4/15 9:10,5,74,-69,
21734,201,2022/4/15 9:20,5,70,-65,
21735,201,2022/4/15 9:30,5,77,-72,
21736,201,2022/4/15 9:40,6,51,-45,
21737,201,2022/4/15 9:50,9,42,-33,
21738,201,2022/4/15 10:00,7,45,-38,
21739,201,2022/4/15 10:10,9,38,-29,
21740,201,2022/4/15 10:20,8,23,-15,
21741,201,2022/4/15 10:30,9,37,-28,
21742,201,2022/4/15 10:40,10,31,-21,
21743,201,2022/4/15 10:50,10,19,-9,
21744,201,2022/4/15 11:00,9,25,-16,
21745,201,2022/4/15 11:10,13,31,-18,
21746,201,2022/4/15 11:20,9,23,-14,
21747,201,2022/4/15 11:30,11,23,-12,
21748,201,2022/4/15 11:40,13,23,-10,
21749,201,2022/4/15 11:50,16,21,-5,
21750,201,2022/4/15 12:00,14,24,-10,
21751,201,2022/4/15 12:10,14,32,-18,
21752,201,2022/4/15 12:20,15,21,-6,
21753,201,2022/4/15 12:30,15,25,-10,
21754,201,2022/4/15 12:40,15,29,-14,
21755,201,2022/4/15 12:50,11,21,-10,
21756,201,2022/4/15 13:00,13,32,-19,
21757,201,2022/4/15 13:10,11,28,-17,
21758,201,2022/4/15 13:20,10,21,-11,
21759,201,2022/4/15 13:30,13,23,-10,
21760,201,2022/4/15 13:40,13,33,-20,
21761,201,2022/4/15 13:50,11,23,-12,
21762,201,2022/4/15 14:00,13,23,-10,
21763,201,2022/4/15 14:10,13,30,-17,
21764,201,2022/4/15 14:20,10,13,-3,
21765,201,2022/4/15 14:30,13,23,-10,
21766,201,2022/4/15 14:40,15,23,-8,
21767,201,2022/4/15 14:50,12,19,-7,
21768,201,2022/4/15 15:00,14,23,-9,
21769,201,2022/4/15 15:10,17,21,-4,
21770,201,2022/4/15 15:20,14,15,-1,
21771,201,2022/4/15 15:30,16,21,-5,
21772,201,2022/4/15 15:40,14,23,-9,
21773,201,2022/4/15 15:50,19,14,5,
21774,201,2022/4/15 16:00,26,23,3,
21775,201,2022/4/15 16:10,33,21,12,
21776,201,2022/4/15 16:20,22,14,8,
21777,201,2022/4/15 16:30,45,21,24,
21778,201,2022/4/15 16:40,46,23,23,
21779,201,2022/4/15 16:50,49,23,26,
21780,201,2022/4/15 17:00,141,19,122,
21781,201,2022/4/15 17:10,174,23,151,
21782,201,2022/4/15 17:20,198,23,175,
21783,201,2022/4/15 17:30,69,29,40,
21784,201,2022/4/15 17:40,43,23,20,
21785,201,2022/4/15 17:50,31,33,-2,
21786,201,2022/4/15 18:00,26,27,-1,
21787,201,2022/4/15 18:10,22,38,-16,
21788,201,2022/4/15 18:20,20,36,-16,
21789,201,2022/4/15 18:30,20,33,-13,
21790,201,2022/4/15 18:40,18,32,-14,
21791,201,2022/4/15 18:50,14,31,-17,
21792,201,2022/4/15 19:00,15,33,-18,
21793,201,2022/4/15 19:10,15,45,-30,
21794,201,2022/4/15 19:20,14,33,-19,
21795,201,2022/4/15 19:30,12,33,-21,
21796,201,2022/4/15 19:40,12,33,-21,
21797,201,2022/4/15 19:50,11,31,-20,
21798,201,2022/4/15 20:00,18,32,-14,
21799,201,2022/4/15 20:10,25,22,3,
21800,201,2022/4/15 20:20,10,21,-11,
21801,201,2022/4/15 20:30,7,23,-16,
21802,201,2022/4/15 20:40,6,21,-15,
21803,201,2022/4/15 20:50,7,23,-16,
21804,201,2022/4/15 21:00,11,10,1,
21805,201,2022/4/15 21:10,6,23,-17,
21806,201,2022/4/15 21:20,3,22,-19,
21807,201,2022/4/15 21:30,2,15,-13,
21808,201,2022/4/15 21:40,1,23,-22,
21809,201,2022/4/15 21:50,1,23,-22,
21810,201,2022/4/15 22:00,1,13,-12,
21811,201,2022/4/15 22:10,0,19,-19,
21812,201,2022/4/15 22:20,0,25,-25,
21813,201,2022/4/15 22:30,0,18,-18,
21814,201,2022/4/15 22:40,0,23,-23,
21815,201,2022/4/15 22:50,0,7,-7,
21816,200,2022/4/15 5:00,0,1,-1,
21817,200,2022/4/15 5:10,0,1,-1,
21818,200,2022/4/15 5:20,0,1,-1,
21819,200,2022/4/15 5:30,0,1,-1,
21820,200,2022/4/15 5:40,19,1,18,
21821,200,2022/4/15 5:50,37,1,36,
21822,200,2022/4/15 6:00,26,1,25,
21823,200,2022/4/15 6:10,32,1,31,
21824,200,2022/4/15 6:20,34,21,13,
21825,200,2022/4/15 6:30,38,23,15,
21826,200,2022/4/15 6:40,47,49,-2,
21827,200,2022/4/15 6:50,59,61,-2,
21828,200,2022/4/15 7:00,79,108,-29,
21829,200,2022/4/15 7:10,145,69,76,
21830,200,2022/4/15 7:20,149,93,56,
21831,200,2022/4/15 7:30,128,121,7,
21832,200,2022/4/15 7:40,128,96,32,
21833,200,2022/4/15 7:50,83,105,-22,
21834,200,2022/4/15 8:00,86,124,-38,
21835,200,2022/4/15 8:10,60,105,-45,
21836,200,2022/4/15 8:20,55,110,-55,
21837,200,2022/4/15 8:30,44,108,-64,
21838,200,2022/4/15 8:40,31,120,-89,
21839,200,2022/4/15 8:50,25,97,-72,
21840,200,2022/4/15 9:00,27,87,-60,
21841,200,2022/4/15 9:10,24,83,-59,
21842,200,2022/4/15 9:20,26,70,-44,
21843,200,2022/4/15 9:30,23,78,-55,
21844,200,2022/4/15 9:40,23,69,-46,
21845,200,2022/4/15 9:50,20,67,-47,
21846,200,2022/4/15 10:00,20,67,-47,
21847,200,2022/4/15 10:10,22,55,-33,
21848,200,2022/4/15 10:20,25,65,-40,
21849,200,2022/4/15 10:30,17,54,-37,
21850,200,2022/4/15 10:40,23,42,-19,
21851,200,2022/4/15 10:50,22,54,-32,
21852,200,2022/4/15 11:00,22,49,-27,
21853,200,2022/4/15 11:10,20,33,-13,
21854,200,2022/4/15 11:20,21,46,-25,
21855,200,2022/4/15 11:30,22,41,-19,
21856,200,2022/4/15 11:40,21,32,-11,
21857,200,2022/4/15 11:50,23,47,-24,
21858,200,2022/4/15 12:00,21,47,-26,
21859,200,2022/4/15 12:10,24,25,-1,
21860,200,2022/4/15 12:20,24,45,-21,
21861,200,2022/4/15 12:30,20,42,-22,
21862,200,2022/4/15 12:40,25,31,-6,
21863,200,2022/4/15 12:50,21,45,-24,
21864,200,2022/4/15 13:00,22,41,-19,
21865,200,2022/4/15 13:10,20,28,-8,
21866,200,2022/4/15 13:20,20,41,-21,
21867,200,2022/4/15 13:30,15,44,-29,
21868,200,2022/4/15 13:40,17,29,-12,
21869,200,2022/4/15 13:50,16,41,-25,
21870,200,2022/4/15 14:00,15,38,-23,
21871,200,2022/4/15 14:10,16,31,-15,
21872,200,2022/4/15 14:20,18,42,-24,
21873,200,2022/4/15 14:30,15,40,-25,
21874,200,2022/4/15 14:40,14,23,-9,
21875,200,2022/4/15 14:50,18,47,-29,
21876,200,2022/4/15 15:00,16,46,-30,
21877,200,2022/4/15 15:10,17,35,-18,
21878,200,2022/4/15 15:20,20,44,-24,
21879,200,2022/4/15 15:30,23,44,-21,
21880,200,2022/4/15 15:40,21,31,-10,
21881,200,2022/4/15 15:50,25,51,-26,
21882,200,2022/4/15 16:00,68,61,7,
21883,200,2022/4/15 16:10,32,47,-15,
21884,200,2022/4/15 16:20,35,62,-27,
21885,200,2022/4/15 16:30,35,42,-7,
21886,200,2022/4/15 16:40,46,74,-28,
21887,200,2022/4/15 16:50,64,62,2,
21888,200,2022/4/15 17:00,45,68,-23,
21889,200,2022/4/15 17:10,47,73,-26,
21890,200,2022/4/15 17:20,37,73,-36,
21891,200,2022/4/15 17:30,53,76,-23,
21892,200,2022/4/15 17:40,42,80,-38,
21893,200,2022/4/15 17:50,26,81,-55,
21894,200,2022/4/15 18:00,29,92,-63,
21895,200,2022/4/15 18:10,29,95,-66,
21896,200,2022/4/15 18:20,24,95,-71,
21897,200,2022/4/15 18:30,20,80,-60,
21898,200,2022/4/15 18:40,17,91,-74,
21899,200,2022/4/15 18:50,13,93,-80,
21900,200,2022/4/15 19:00,17,78,-61,
21901,200,2022/4/15 19:10,13,99,-86,
21902,200,2022/4/15 19:20,13,81,-68,
21903,200,2022/4/15 19:30,12,76,-64,
21904,200,2022/4/15 19:40,8,77,-69,
21905,200,2022/4/15 19:50,9,75,-66,
21906,200,2022/4/15 20:00,9,73,-64,
21907,200,2022/4/15 20:10,11,67,-56,
21908,200,2022/4/15 20:20,8,67,-59,
21909,200,2022/4/15 20:30,13,55,-42,
21910,200,2022/4/15 20:40,7,59,-52,
21911,200,2022/4/15 20:50,4,64,-60,
21912,200,2022/4/15 21:00,12,64,-52,
21913,200,2022/4/15 21:10,7,63,-56,
21914,200,2022/4/15 21:20,5,50,-45,
21915,200,2022/4/15 21:30,4,62,-58,
21916,200,2022/4/15 21:40,4,64,-60,
21917,200,2022/4/15 21:50,2,39,-37,
21918,200,2022/4/15 22:00,0,51,-51,
21919,200,2022/4/15 22:10,0,63,-63,
21920,200,2022/4/15 22:20,0,47,-47,
21921,200,2022/4/15 22:30,0,52,-52,
21922,200,2022/4/15 22:40,0,39,-39,
21923,200,2022/4/15 22:50,0,49,-49,
21924,210,2022/4/15 5:00,0,1,-1,-1
21925,210,2022/4/15 5:10,7,1,6,6
21926,210,2022/4/15 5:20,16,1,15,15
21927,210,2022/4/15 5:30,16,1,15,15
21928,210,2022/4/15 5:40,17,1,16,16
21929,210,2022/4/15 5:50,24,1,23,23
21930,210,2022/4/15 6:00,30,1,29,29
21931,210,2022/4/15 6:10,34,1,33,33
21932,210,2022/4/15 6:20,40,1,39,39
21933,210,2022/4/15 6:30,47,13,34,34
21934,210,2022/4/15 6:40,56,13,43,43
21935,210,2022/4/15 6:50,55,19,36,36
21936,210,2022/4/15 7:00,76,23,53,53
21937,210,2022/4/15 7:10,93,21,72,72
21938,210,2022/4/15 7:20,180,29,151,151
21939,210,2022/4/15 7:30,224,23,201,201
21940,210,2022/4/15 7:40,222,51,171,171
21941,210,2022/4/15 7:50,216,35,181,181
21942,210,2022/4/15 8:00,180,49,131,131
21943,210,2022/4/15 8:10,83,68,15,15
21944,210,2022/4/15 8:20,58,48,10,10
21945,210,2022/4/15 8:30,45,67,-22,-22
21946,210,2022/4/15 8:40,32,49,-17,-17
21947,210,2022/4/15 8:50,30,38,-8,-8
21948,210,2022/4/15 9:00,26,49,-23,-23
21949,210,2022/4/15 9:10,24,47,-23,-23
21950,210,2022/4/15 9:20,20,38,-18,-18
21951,210,2022/4/15 9:30,19,46,-27,-27
21952,210,2022/4/15 9:40,16,38,-22,-22
21953,210,2022/4/15 9:50,16,46,-30,-30
21954,210,2022/4/15 10:00,18,30,-12,-12
21955,210,2022/4/15 10:10,12,35,-23,-23
21956,210,2022/4/15 10:20,18,33,-15,-15
21957,210,2022/4/15 10:30,15,35,-20,-20
21958,210,2022/4/15 10:40,16,41,-25,-25
21959,210,2022/4/15 10:50,16,38,-22,-22
21960,210,2022/4/15 11:00,17,30,-13,-13
21961,210,2022/4/15 11:10,16,34,-18,-18
21962,210,2022/4/15 11:20,16,32,-16,-16
21963,210,2022/4/15 11:30,17,25,-8,-8
21964,210,2022/4/15 11:40,16,23,-7,-7
21965,210,2022/4/15 11:50,16,30,-14,-14
21966,210,2022/4/15 12:00,14,32,-18,-18
21967,210,2022/4/15 12:10,16,48,-32,-32
21968,210,2022/4/15 12:20,16,38,-22,-22
21969,210,2022/4/15 12:30,15,32,-17,-17
21970,210,2022/4/15 12:40,16,34,-18,-18
21971,210,2022/4/15 12:50,13,37,-24,-24
21972,210,2022/4/15 13:00,12,32,-20,-20
21973,210,2022/4/15 13:10,14,34,-20,-20
21974,210,2022/4/15 13:20,14,35,-21,-21
21975,210,2022/4/15 13:30,14,39,-25,-25
21976,210,2022/4/15 13:40,15,44,-29,-29
21977,210,2022/4/15 13:50,12,38,-26,-26
21978,210,2022/4/15 14:00,14,33,-19,-19
21979,210,2022/4/15 14:10,14,38,-24,-24
21980,210,2022/4/15 14:20,13,38,-25,-25
21981,210,2022/4/15 14:30,13,32,-19,-19
21982,210,2022/4/15 14:40,15,38,-23,-23
21983,210,2022/4/15 14:50,11,31,-20,-20
21984,210,2022/4/15 15:00,15,38,-23,-23
21985,210,2022/4/15 15:10,16,64,-48,-48
21986,210,2022/4/15 15:20,13,48,-35,-35
21987,210,2022/4/15 15:30,12,45,-33,-33
21988,210,2022/4/15 15:40,19,38,-19,-19
21989,210,2022/4/15 15:50,15,38,-23,-23
21990,210,2022/4/15 16:00,17,40,-23,-23
21991,210,2022/4/15 16:10,19,47,-28,-28
21992,210,2022/4/15 16:20,20,47,-27,-27
21993,210,2022/4/15 16:30,19,58,-39,-39
21994,210,2022/4/15 16:40,19,82,-63,-63
21995,210,2022/4/15 16:50,20,55,-35,-35
21996,210,2022/4/15 17:00,17,56,-39,-39
21997,210,2022/4/15 17:10,29,58,-29,-29
21998,210,2022/4/15 17:20,20,70,-50,-50
21999,210,2022/4/15 17:30,16,76,-60,-60
22000,210,2022/4/15 17:40,24,93,-69,-69
22001,210,2022/4/15 17:50,20,77,-57,-57
22002,210,2022/4/15 18:00,13,95,-82,-82
22003,210,2022/4/15 18:10,12,77,-65,-65
22004,210,2022/4/15 18:20,11,78,-67,-67
22005,210,2022/4/15 18:30,10,78,-68,-68
22006,210,2022/4/15 18:40,11,99,-88,-88
22007,210,2022/4/15 18:50,10,101,-91,-91
22008,210,2022/4/15 19:00,9,94,-85,-85
22009,210,2022/4/15 19:10,7,124,-117,-117
22010,210,2022/4/15 19:20,7,89,-82,-82
22011,210,2022/4/15 19:30,6,78,-72,-72
22012,210,2022/4/15 19:40,7,81,-74,-74
22013,210,2022/4/15 19:50,4,78,-74,-74
22014,210,2022/4/15 20:00,7,71,-64,-64
22015,210,2022/4/15 20:10,4,69,-65,-65
22016,210,2022/4/15 20:20,4,64,-60,-60
22017,210,2022/4/15 20:30,5,72,-67,-67
22018,210,2022/4/15 20:40,5,62,-57,-57
22019,210,2022/4/15 20:50,4,53,-49,-49
22020,210,2022/4/15 21:00,5,49,-44,-44
22021,210,2022/4/15 21:10,4,49,-45,-45
22022,210,2022/4/15 21:20,4,56,-52,-52
22023,210,2022/4/15 21:30,4,51,-47,-47
22024,210,2022/4/15 21:40,2,66,-64,-64
22025,210,2022/4/15 21:50,2,47,-45,-45
22026,210,2022/4/15 22:00,1,56,-55,-55
22027,210,2022/4/15 22:10,1,34,-33,-33
22028,210,2022/4/15 22:20,2,52,-50,-50
22029,210,2022/4/15 22:30,0,49,-49,-49
22030,210,2022/4/15 22:40,0,33,-33,-33
22031,210,2022/4/15 22:50,0,46,-46,-46
22032,224,2022/4/15 5:00,0,1,-1,
22033,224,2022/4/15 5:10,3,1,2,
22034,224,2022/4/15 5:20,14,1,13,
22035,224,2022/4/15 5:30,16,2,14,
22036,224,2022/4/15 5:40,18,1,17,
22037,224,2022/4/15 5:50,20,1,19,
22038,224,2022/4/15 6:00,25,1,24,
22039,224,2022/4/15 6:10,33,1,32,
22040,224,2022/4/15 6:20,35,1,34,
22041,224,2022/4/15 6:30,38,45,-7,
22042,224,2022/4/15 6:40,45,72,-27,
22043,224,2022/4/15 6:50,49,97,-48,
22044,224,2022/4/15 7:00,69,112,-43,
22045,224,2022/4/15 7:10,85,76,9,
22046,224,2022/4/15 7:20,104,71,33,
22047,224,2022/4/15 7:30,155,63,92,
22048,224,2022/4/15 7:40,162,71,91,
22049,224,2022/4/15 7:50,152,68,84,
22050,224,2022/4/15 8:00,90,95,-5,
22051,224,2022/4/15 8:10,59,105,-46,
22052,224,2022/4/15 8:20,52,115,-63,
22053,224,2022/4/15 8:30,50,126,-76,
22054,224,2022/4/15 8:40,36,104,-68,
22055,224,2022/4/15 8:50,29,119,-90,
22056,224,2022/4/15 9:00,23,109,-86,
22057,224,2022/4/15 9:10,21,112,-91,
22058,224,2022/4/15 9:20,23,88,-65,
22059,224,2022/4/15 9:30,23,75,-52,
22060,224,2022/4/15 9:40,20,68,-48,
22061,224,2022/4/15 9:50,21,57,-36,
22062,224,2022/4/15 10:00,19,60,-41,
22063,224,2022/4/15 10:10,21,69,-48,
22064,224,2022/4/15 10:20,17,51,-34,
22065,224,2022/4/15 10:30,18,54,-36,
22066,224,2022/4/15 10:40,21,45,-24,
22067,224,2022/4/15 10:50,19,38,-19,
22068,224,2022/4/15 11:00,20,40,-20,
22069,224,2022/4/15 11:10,23,46,-23,
22070,224,2022/4/15 11:20,20,40,-20,
22071,224,2022/4/15 11:30,22,47,-25,
22072,224,2022/4/15 11:40,21,51,-30,
22073,224,2022/4/15 11:50,20,38,-18,
22074,224,2022/4/15 12:00,25,39,-14,
22075,224,2022/4/15 12:10,25,42,-17,
22076,224,2022/4/15 12:20,21,38,-17,
22077,224,2022/4/15 12:30,21,45,-24,
22078,224,2022/4/15 12:40,20,41,-21,
22079,224,2022/4/15 12:50,16,46,-30,
22080,224,2022/4/15 13:00,17,50,-33,
22081,224,2022/4/15 13:10,23,73,-50,
22082,224,2022/4/15 13:20,20,52,-32,
22083,224,2022/4/15 13:30,23,49,-26,
22084,224,2022/4/15 13:40,20,50,-30,
22085,224,2022/4/15 13:50,23,48,-25,
22086,224,2022/4/15 14:00,21,51,-30,
22087,224,2022/4/15 14:10,24,47,-23,
22088,224,2022/4/15 14:20,23,50,-27,
22089,224,2022/4/15 14:30,25,59,-34,
22090,224,2022/4/15 14:40,22,59,-37,
22091,224,2022/4/15 14:50,25,51,-26,
22092,224,2022/4/15 15:00,27,47,-20,
22093,224,2022/4/15 15:10,28,41,-13,
22094,224,2022/4/15 15:20,25,48,-23,
22095,224,2022/4/15 15:30,28,51,-23,
22096,224,2022/4/15 15:40,22,49,-27,
22097,224,2022/4/15 15:50,26,41,-15,
22098,224,2022/4/15 16:00,28,65,-37,
22099,224,2022/4/15 16:10,35,59,-24,
22100,224,2022/4/15 16:20,46,42,4,
22101,224,2022/4/15 16:30,55,61,-6,
22102,224,2022/4/15 16:40,64,54,10,
22103,224,2022/4/15 16:50,76,57,19,
22104,224,2022/4/15 17:00,84,65,19,
22105,224,2022/4/15 17:10,87,61,26,
22106,224,2022/4/15 17:20,64,97,-33,
22107,224,2022/4/15 17:30,79,70,9,
22108,224,2022/4/15 17:40,113,79,34,
22109,224,2022/4/15 17:50,71,77,-6,
22110,224,2022/4/15 18:00,39,75,-36,
22111,224,2022/4/15 18:10,37,78,-41,
22112,224,2022/4/15 18:20,30,108,-78,
22113,224,2022/4/15 18:30,27,107,-80,
22114,224,2022/4/15 18:40,24,92,-68,
22115,224,2022/4/15 18:50,21,76,-55,
22116,224,2022/4/15 19:00,20,95,-75,
22117,224,2022/4/15 19:10,18,78,-60,
22118,224,2022/4/15 19:20,16,77,-61,
22119,224,2022/4/15 19:30,14,77,-63,
22120,224,2022/4/15 19:40,14,67,-53,
22121,224,2022/4/15 19:50,12,73,-61,
22122,224,2022/4/15 20:00,10,71,-61,
22123,224,2022/4/15 20:10,10,63,-53,
22124,224,2022/4/15 20:20,12,54,-42,
22125,224,2022/4/15 20:30,12,48,-36,
22126,224,2022/4/15 20:40,10,50,-40,
22127,224,2022/4/15 20:50,10,49,-39,
22128,224,2022/4/15 21:00,8,48,-40,
22129,224,2022/4/15 21:10,9,40,-31,
22130,224,2022/4/15 21:20,6,62,-56,
22131,224,2022/4/15 21:30,7,55,-48,
22132,224,2022/4/15 21:40,4,49,-45,
22133,224,2022/4/15 21:50,2,41,-39,
22134,224,2022/4/15 22:00,3,51,-48,
22135,224,2022/4/15 22:10,3,47,-44,
22136,224,2022/4/15 22:20,2,40,-38,
22137,224,2022/4/15 22:30,0,51,-51,
22138,224,2022/4/15 22:40,0,41,-41,
22139,224,2022/4/15 22:50,0,26,-26,
22140,213,2022/4/15 5:00,0,1,-1,
22141,213,2022/4/15 5:10,6,1,5,
22142,213,2022/4/15 5:20,18,1,17,
22143,213,2022/4/15 5:30,16,1,15,
22144,213,2022/4/15 5:40,19,1,18,
22145,213,2022/4/15 5:50,32,1,31,
22146,213,2022/4/15 6:00,33,1,32,
22147,213,2022/4/15 6:10,43,1,42,
22148,213,2022/4/15 6:20,54,1,53,
22149,213,2022/4/15 6:30,58,32,26,
22150,213,2022/4/15 6:40,61,31,30,
22151,213,2022/4/15 6:50,72,54,18,
22152,213,2022/4/15 7:00,92,51,41,
22153,213,2022/4/15 7:10,151,76,75,
22154,213,2022/4/15 7:20,177,72,105,
22155,213,2022/4/15 7:30,230,67,163,
22156,213,2022/4/15 7:40,224,98,126,
22157,213,2022/4/15 7:50,200,109,91,
22158,213,2022/4/15 8:00,144,110,34,
22159,213,2022/4/15 8:10,84,118,-34,
22160,213,2022/4/15 8:20,60,120,-60,
22161,213,2022/4/15 8:30,54,183,-129,
22162,213,2022/4/15 8:40,42,312,-270,
22163,213,2022/4/15 8:50,31,132,-101,
22164,213,2022/4/15 9:00,29,104,-75,
22165,213,2022/4/15 9:10,27,106,-79,
22166,213,2022/4/15 9:20,26,90,-64,
22167,213,2022/4/15 9:30,27,92,-65,
22168,213,2022/4/15 9:40,27,75,-48,
22169,213,2022/4/15 9:50,24,70,-46,
22170,213,2022/4/15 10:00,23,71,-48,
22171,213,2022/4/15 10:10,25,61,-36,
22172,213,2022/4/15 10:20,24,60,-36,
22173,213,2022/4/15 10:30,25,60,-35,
22174,213,2022/4/15 10:40,22,62,-40,
22175,213,2022/4/15 10:50,25,53,-28,
22176,213,2022/4/15 11:00,25,72,-47,
22177,213,2022/4/15 11:10,26,63,-37,
22178,213,2022/4/15 11:20,27,47,-20,
22179,213,2022/4/15 11:30,26,50,-24,
22180,213,2022/4/15 11:40,28,59,-31,
22181,213,2022/4/15 11:50,25,48,-23,
22182,213,2022/4/15 12:00,24,54,-30,
22183,213,2022/4/15 12:10,29,52,-23,
22184,213,2022/4/15 12:20,31,53,-22,
22185,213,2022/4/15 12:30,27,68,-41,
22186,213,2022/4/15 12:40,25,70,-45,
22187,213,2022/4/15 12:50,20,60,-40,
22188,213,2022/4/15 13:00,25,61,-36,
22189,213,2022/4/15 13:10,28,57,-29,
22190,213,2022/4/15 13:20,28,60,-32,
22191,213,2022/4/15 13:30,25,60,-35,
22192,213,2022/4/15 13:40,25,59,-34,
22193,213,2022/4/15 13:50,27,58,-31,
22194,213,2022/4/15 14:00,25,70,-45,
22195,213,2022/4/15 14:10,26,69,-43,
22196,213,2022/4/15 14:20,23,59,-36,
22197,213,2022/4/15 14:30,23,54,-31,
22198,213,2022/4/15 14:40,23,58,-35,
22199,213,2022/4/15 14:50,25,57,-32,
22200,213,2022/4/15 15:00,26,61,-35,
22201,213,2022/4/15 15:10,22,63,-41,
22202,213,2022/4/15 15:20,24,61,-37,
22203,213,2022/4/15 15:30,25,71,-46,
22204,213,2022/4/15 15:40,30,72,-42,
22205,213,2022/4/15 15:50,34,69,-35,
22206,213,2022/4/15 16:00,35,65,-30,
22207,213,2022/4/15 16:10,39,70,-31,
22208,213,2022/4/15 16:20,44,72,-28,
22209,213,2022/4/15 16:30,46,71,-25,
22210,213,2022/4/15 16:40,45,70,-25,
22211,213,2022/4/15 16:50,47,95,-48,
22212,213,2022/4/15 17:00,85,86,-1,
22213,213,2022/4/15 17:10,112,87,25,
22214,213,2022/4/15 17:20,70,74,-4,
22215,213,2022/4/15 17:30,90,94,-4,
22216,213,2022/4/15 17:40,217,93,124,
22217,213,2022/4/15 17:50,70,97,-27,
22218,213,2022/4/15 18:00,48,106,-58,
22219,213,2022/4/15 18:10,45,108,-63,
22220,213,2022/4/15 18:20,30,111,-81,
22221,213,2022/4/15 18:30,25,125,-100,
22222,213,2022/4/15 18:40,28,109,-81,
22223,213,2022/4/15 18:50,25,108,-83,
22224,213,2022/4/15 19:00,20,110,-90,
22225,213,2022/4/15 19:10,19,88,-69,
22226,213,2022/4/15 19:20,18,107,-89,
22227,213,2022/4/15 19:30,17,110,-93,
22228,213,2022/4/15 19:40,14,98,-84,
22229,213,2022/4/15 19:50,16,87,-71,
22230,213,2022/4/15 20:00,15,79,-64,
22231,213,2022/4/15 20:10,14,83,-69,
22232,213,2022/4/15 20:20,14,72,-58,
22233,213,2022/4/15 20:30,12,75,-63,
22234,213,2022/4/15 20:40,11,63,-52,
22235,213,2022/4/15 20:50,11,72,-61,
22236,213,2022/4/15 21:00,12,78,-66,
22237,213,2022/4/15 21:10,14,60,-46,
22238,213,2022/4/15 21:20,12,71,-59,
22239,213,2022/4/15 21:30,12,62,-50,
22240,213,2022/4/15 21:40,4,60,-56,
22241,213,2022/4/15 21:50,6,63,-57,
22242,213,2022/4/15 22:00,4,56,-52,
22243,213,2022/4/15 22:10,5,47,-42,
22244,213,2022/4/15 22:20,2,64,-62,
22245,213,2022/4/15 22:30,0,43,-43,
22246,213,2022/4/15 22:40,0,48,-48,
22247,213,2022/4/15 22:50,0,53,-53,
22248,225,2022/4/15 5:00,0,1,-1,
22249,225,2022/4/15 5:10,0,1,-1,
22250,225,2022/4/15 5:20,5,1,4,
22251,225,2022/4/15 5:30,10,1,9,
22252,225,2022/4/15 5:40,11,1,10,
22253,225,2022/4/15 5:50,12,1,11,
22254,225,2022/4/15 6:00,16,1,15,
22255,225,2022/4/15 6:10,20,1,19,
22256,225,2022/4/15 6:20,32,14,18,
22257,225,2022/4/15 6:30,31,16,15,
22258,225,2022/4/15 6:40,35,32,3,
22259,225,2022/4/15 6:50,45,21,24,
22260,225,2022/4/15 7:00,54,35,19,
22261,225,2022/4/15 7:10,67,62,5,
22262,225,2022/4/15 7:20,77,50,27,
22263,225,2022/4/15 7:30,101,90,11,
22264,225,2022/4/15 7:40,147,104,43,
22265,225,2022/4/15 7:50,124,120,4,
22266,225,2022/4/15 8:00,113,181,-68,
22267,225,2022/4/15 8:10,67,190,-123,
22268,225,2022/4/15 8:20,45,296,-251,
22269,225,2022/4/15 8:30,42,329,-287,
22270,225,2022/4/15 8:40,32,327,-295,
22271,225,2022/4/15 8:50,29,190,-161,
22272,225,2022/4/15 9:00,26,108,-82,
22273,225,2022/4/15 9:10,21,106,-85,
22274,225,2022/4/15 9:20,19,102,-83,
22275,225,2022/4/15 9:30,16,91,-75,
22276,225,2022/4/15 9:40,20,78,-58,
22277,225,2022/4/15 9:50,19,80,-61,
22278,225,2022/4/15 10:00,15,70,-55,
22279,225,2022/4/15 10:10,22,61,-39,
22280,225,2022/4/15 10:20,19,63,-44,
22281,225,2022/4/15 10:30,18,80,-62,
22282,225,2022/4/15 10:40,21,69,-48,
22283,225,2022/4/15 10:50,25,49,-24,
22284,225,2022/4/15 11:00,24,50,-26,
22285,225,2022/4/15 11:10,26,46,-20,
22286,225,2022/4/15 11:20,23,47,-24,
22287,225,2022/4/15 11:30,26,44,-18,
22288,225,2022/4/15 11:40,28,48,-20,
22289,225,2022/4/15 11:50,25,42,-17,
22290,225,2022/4/15 12:00,27,57,-30,
22291,225,2022/4/15 12:10,28,61,-33,
22292,225,2022/4/15 12:20,26,50,-24,
22293,225,2022/4/15 12:30,26,48,-22,
22294,225,2022/4/15 12:40,26,50,-24,
22295,225,2022/4/15 12:50,26,50,-24,
22296,225,2022/4/15 13:00,22,51,-29,
22297,225,2022/4/15 13:10,23,55,-32,
22298,225,2022/4/15 13:20,23,59,-36,
22299,225,2022/4/15 13:30,22,72,-50,
22300,225,2022/4/15 13:40,24,60,-36,
22301,225,2022/4/15 13:50,22,50,-28,
22302,225,2022/4/15 14:00,22,47,-25,
22303,225,2022/4/15 14:10,25,45,-20,
22304,225,2022/4/15 14:20,25,47,-22,
22305,225,2022/4/15 14:30,26,47,-21,
22306,225,2022/4/15 14:40,23,40,-17,
22307,225,2022/4/15 14:50,24,49,-25,
22308,225,2022/4/15 15:00,27,65,-38,
22309,225,2022/4/15 15:10,24,52,-28,
22310,225,2022/4/15 15:20,30,47,-17,
22311,225,2022/4/15 15:30,28,46,-18,
22312,225,2022/4/15 15:40,26,45,-19,
22313,225,2022/4/15 15:50,27,40,-13,
22314,225,2022/4/15 16:00,26,40,-14,
22315,225,2022/4/15 16:10,38,47,-9,
22316,225,2022/4/15 16:20,29,44,-15,
22317,225,2022/4/15 16:30,34,63,-29,
22318,225,2022/4/15 16:40,46,49,-3,
22319,225,2022/4/15 16:50,47,52,-5,
22320,225,2022/4/15 17:00,77,45,32,
22321,225,2022/4/15 17:10,160,50,110,
22322,225,2022/4/15 17:20,77,50,27,
22323,225,2022/4/15 17:30,235,69,166,
22324,225,2022/4/15 17:40,261,78,183,
22325,225,2022/4/15 17:50,139,64,75,
22326,225,2022/4/15 18:00,55,75,-20,
22327,225,2022/4/15 18:10,60,72,-12,
22328,225,2022/4/15 18:20,45,75,-30,
22329,225,2022/4/15 18:30,30,78,-48,
22330,225,2022/4/15 18:40,22,83,-61,
22331,225,2022/4/15 18:50,26,93,-67,
22332,225,2022/4/15 19:00,27,104,-77,
22333,225,2022/4/15 19:10,33,107,-74,
22334,225,2022/4/15 19:20,35,79,-44,
22335,225,2022/4/15 19:30,35,71,-36,
22336,225,2022/4/15 19:40,30,82,-52,
22337,225,2022/4/15 19:50,29,74,-45,
22338,225,2022/4/15 20:00,24,74,-50,
22339,225,2022/4/15 20:10,28,71,-43,
22340,225,2022/4/15 20:20,20,75,-55,
22341,225,2022/4/15 20:30,20,81,-61,
22342,225,2022/4/15 20:40,18,63,-45,
22343,225,2022/4/15 20:50,16,68,-52,
22344,225,2022/4/15 21:00,16,55,-39,
22345,225,2022/4/15 21:10,15,62,-47,
22346,225,2022/4/15 21:20,11,62,-51,
22347,225,2022/4/15 21:30,10,69,-59,
22348,225,2022/4/15 21:40,12,46,-34,
22349,225,2022/4/15 21:50,6,63,-57,
22350,225,2022/4/15 22:00,6,52,-46,
22351,225,2022/4/15 22:10,7,51,-44,
22352,225,2022/4/15 22:20,4,40,-36,
22353,225,2022/4/15 22:30,2,49,-47,
22354,225,2022/4/15 22:40,0,40,-40,
22355,225,2022/4/15 22:50,0,33,-33,
22356,230,2022/4/15 5:00,0,1,-1,
22357,230,2022/4/15 5:10,0,1,-1,
22358,230,2022/4/15 5:20,3,1,2,
22359,230,2022/4/15 5:30,12,1,11,
22360,230,2022/4/15 5:40,6,1,5,
22361,230,2022/4/15 5:50,13,1,12,
22362,230,2022/4/15 6:00,15,1,14,
22363,230,2022/4/15 6:10,22,1,21,
22364,230,2022/4/15 6:20,24,8,16,
22365,230,2022/4/15 6:30,29,8,21,
22366,230,2022/4/15 6:40,51,25,26,
22367,230,2022/4/15 6:50,47,33,14,
22368,230,2022/4/15 7:00,57,38,19,
22369,230,2022/4/15 7:10,67,38,29,
22370,230,2022/4/15 7:20,55,56,-1,
22371,230,2022/4/15 7:30,86,61,25,
22372,230,2022/4/15 7:40,196,63,133,
22373,230,2022/4/15 7:50,187,54,133,
22374,230,2022/4/15 8:00,123,83,40,
22375,230,2022/4/15 8:10,74,64,10,
22376,230,2022/4/15 8:20,55,61,-6,
22377,230,2022/4/15 8:30,52,60,-8,
22378,230,2022/4/15 8:40,40,65,-25,
22379,230,2022/4/15 8:50,30,65,-35,
22380,230,2022/4/15 9:00,26,48,-22,
22381,230,2022/4/15 9:10,25,49,-24,
22382,230,2022/4/15 9:20,21,51,-30,
22383,230,2022/4/15 9:30,16,50,-34,
22384,230,2022/4/15 9:40,18,48,-30,
22385,230,2022/4/15 9:50,12,41,-29,
22386,230,2022/4/15 10:00,17,39,-22,
22387,230,2022/4/15 10:10,11,37,-26,
22388,230,2022/4/15 10:20,17,34,-17,
22389,230,2022/4/15 10:30,13,34,-21,
22390,230,2022/4/15 10:40,16,37,-21,
22391,230,2022/4/15 10:50,13,30,-17,
22392,230,2022/4/15 11:00,17,33,-16,
22393,230,2022/4/15 11:10,13,33,-20,
22394,230,2022/4/15 11:20,17,34,-17,
22395,230,2022/4/15 11:30,13,48,-35,
22396,230,2022/4/15 11:40,17,38,-21,
22397,230,2022/4/15 11:50,12,37,-25,
22398,230,2022/4/15 12:00,14,33,-19,
22399,230,2022/4/15 12:10,16,33,-17,
22400,230,2022/4/15 12:20,19,33,-14,
22401,230,2022/4/15 12:30,14,32,-18,
22402,230,2022/4/15 12:40,15,37,-22,
22403,230,2022/4/15 12:50,14,38,-24,
22404,230,2022/4/15 13:00,13,63,-50,
22405,230,2022/4/15 13:10,13,44,-31,
22406,230,2022/4/15 13:20,13,38,-25,
22407,230,2022/4/15 13:30,12,40,-28,
22408,230,2022/4/15 13:40,18,37,-19,
22409,230,2022/4/15 13:50,16,36,-20,
22410,230,2022/4/15 14:00,15,38,-23,
22411,230,2022/4/15 14:10,13,37,-24,
22412,230,2022/4/15 14:20,13,36,-23,
22413,230,2022/4/15 14:30,15,55,-40,
22414,230,2022/4/15 14:40,18,46,-28,
22415,230,2022/4/15 14:50,13,51,-38,
22416,230,2022/4/15 15:00,17,45,-28,
22417,230,2022/4/15 15:10,16,42,-26,
22418,230,2022/4/15 15:20,23,51,-28,
22419,230,2022/4/15 15:30,17,47,-30,
22420,230,2022/4/15 15:40,17,45,-28,
22421,230,2022/4/15 15:50,17,51,-34,
22422,230,2022/4/15 16:00,17,65,-48,
22423,230,2022/4/15 16:10,16,51,-35,
22424,230,2022/4/15 16:20,23,57,-34,
22425,230,2022/4/15 16:30,24,56,-32,
22426,230,2022/4/15 16:40,32,60,-28,
22427,230,2022/4/15 16:50,24,68,-44,
22428,230,2022/4/15 17:00,35,64,-29,
22429,230,2022/4/15 17:10,30,87,-57,
22430,230,2022/4/15 17:20,23,67,-44,
22431,230,2022/4/15 17:30,28,78,-50,
22432,230,2022/4/15 17:40,23,82,-59,
22433,230,2022/4/15 17:50,19,93,-74,
22434,230,2022/4/15 18:00,19,89,-70,
22435,230,2022/4/15 18:10,26,91,-65,
22436,230,2022/4/15 18:20,22,104,-82,
22437,230,2022/4/15 18:30,22,98,-76,
22438,230,2022/4/15 18:40,16,104,-88,
22439,230,2022/4/15 18:50,15,96,-81,
22440,230,2022/4/15 19:00,13,76,-63,
22441,230,2022/4/15 19:10,14,75,-61,
22442,230,2022/4/15 19:20,10,64,-54,
22443,230,2022/4/15 19:30,13,65,-52,
22444,230,2022/4/15 19:40,13,61,-48,
22445,230,2022/4/15 19:50,12,65,-53,
22446,230,2022/4/15 20:00,16,72,-56,
22447,230,2022/4/15 20:10,12,52,-40,
22448,230,2022/4/15 20:20,13,44,-31,
22449,230,2022/4/15 20:30,13,39,-26,
22450,230,2022/4/15 20:40,8,42,-34,
22451,230,2022/4/15 20:50,12,41,-29,
22452,230,2022/4/15 21:00,10,41,-31,
22453,230,2022/4/15 21:10,12,49,-37,
22454,230,2022/4/15 21:20,11,54,-43,
22455,230,2022/4/15 21:30,10,49,-39,
22456,230,2022/4/15 21:40,8,41,-33,
22457,230,2022/4/15 21:50,7,40,-33,
22458,230,2022/4/15 22:00,10,40,-30,
22459,230,2022/4/15 22:10,7,25,-18,
22460,230,2022/4/15 22:20,3,40,-37,
22461,230,2022/4/15 22:30,2,23,-21,
22462,230,2022/4/15 22:40,1,41,-40,
22463,230,2022/4/15 22:50,0,34,-34,
22464,227,2022/4/15 5:00,0,1,-1,
22465,227,2022/4/15 5:10,0,1,-1,
22466,227,2022/4/15 5:20,3,1,2,
22467,227,2022/4/15 5:30,7,1,6,
22468,227,2022/4/15 5:40,8,13,-5,
22469,227,2022/4/15 5:50,10,1,9,
22470,227,2022/4/15 6:00,15,2,13,
22471,227,2022/4/15 6:10,18,5,13,
22472,227,2022/4/15 6:20,24,59,-35,
22473,227,2022/4/15 6:30,28,49,-21,
22474,227,2022/4/15 6:40,25,52,-27,
22475,227,2022/4/15 6:50,29,60,-31,
22476,227,2022/4/15 7:00,55,50,5,
22477,227,2022/4/15 7:10,43,52,-9,
22478,227,2022/4/15 7:20,67,57,10,
22479,227,2022/4/15 7:30,86,56,30,
22480,227,2022/4/15 7:40,69,70,-1,
22481,227,2022/4/15 7:50,55,70,-15,
22482,227,2022/4/15 8:00,51,62,-11,
22483,227,2022/4/15 8:10,55,51,4,
22484,227,2022/4/15 8:20,51,65,-14,
22485,227,2022/4/15 8:30,43,66,-23,
22486,227,2022/4/15 8:40,34,48,-14,
22487,227,2022/4/15 8:50,26,67,-41,
22488,227,2022/4/15 9:00,27,60,-33,
22489,227,2022/4/15 9:10,23,54,-31,
22490,227,2022/4/15 9:20,23,52,-29,
22491,227,2022/4/15 9:30,17,54,-37,
22492,227,2022/4/15 9:40,24,44,-20,
22493,227,2022/4/15 9:50,20,45,-25,
22494,227,2022/4/15 10:00,16,46,-30,
22495,227,2022/4/15 10:10,12,40,-28,
22496,227,2022/4/15 10:20,23,42,-19,
22497,227,2022/4/15 10:30,9,40,-31,
22498,227,2022/4/15 10:40,11,36,-25,
22499,227,2022/4/15 10:50,21,38,-17,
22500,227,2022/4/15 11:00,17,46,-29,
22501,227,2022/4/15 11:10,9,40,-31,
22502,227,2022/4/15 11:20,27,44,-17,
22503,227,2022/4/15 11:30,8,45,-37,
22504,227,2022/4/15 11:40,13,34,-21,
22505,227,2022/4/15 11:50,19,37,-18,
22506,227,2022/4/15 12:00,9,35,-26,
22507,227,2022/4/15 12:10,24,40,-16,
22508,227,2022/4/15 12:20,10,40,-30,
22509,227,2022/4/15 12:30,12,46,-34,
22510,227,2022/4/15 12:40,23,56,-33,
22511,227,2022/4/15 12:50,11,43,-32,
22512,227,2022/4/15 13:00,11,50,-39,
22513,227,2022/4/15 13:10,24,45,-21,
22514,227,2022/4/15 13:20,16,38,-22,
22515,227,2022/4/15 13:30,12,43,-31,
22516,227,2022/4/15 13:40,19,44,-25,
22517,227,2022/4/15 13:50,20,42,-22,
22518,227,2022/4/15 14:00,23,52,-29,
22519,227,2022/4/15 14:10,11,63,-52,
22520,227,2022/4/15 14:20,22,45,-23,
22521,227,2022/4/15 14:30,18,53,-35,
22522,227,2022/4/15 14:40,19,53,-34,
22523,227,2022/4/15 14:50,25,57,-32,
22524,227,2022/4/15 15:00,14,51,-37,
22525,227,2022/4/15 15:10,19,60,-41,
22526,227,2022/4/15 15:20,27,52,-25,
22527,227,2022/4/15 15:30,22,61,-39,
22528,227,2022/4/15 15:40,21,57,-36,
22529,227,2022/4/15 15:50,20,56,-36,
22530,227,2022/4/15 16:00,19,61,-42,
22531,227,2022/4/15 16:10,25,56,-31,
22532,227,2022/4/15 16:20,20,60,-40,
22533,227,2022/4/15 16:30,25,61,-36,
22534,227,2022/4/15 16:40,23,63,-40,
22535,227,2022/4/15 16:50,23,66,-43,
22536,227,2022/4/15 17:00,28,66,-38,
22537,227,2022/4/15 17:10,23,70,-47,
22538,227,2022/4/15 17:20,28,59,-31,
22539,227,2022/4/15 17:30,26,82,-56,
22540,227,2022/4/15 17:40,24,71,-47,
22541,227,2022/4/15 17:50,23,73,-50,
22542,227,2022/4/15 18:00,22,89,-67,
22543,227,2022/4/15 18:10,25,101,-76,
22544,227,2022/4/15 18:20,12,76,-64,
22545,227,2022/4/15 18:30,24,80,-56,
22546,227,2022/4/15 18:40,21,74,-53,
22547,227,2022/4/15 18:50,19,61,-42,
22548,227,2022/4/15 19:00,13,66,-53,
22549,227,2022/4/15 19:10,16,57,-41,
22550,227,2022/4/15 19:20,7,58,-51,
22551,227,2022/4/15 19:30,24,66,-42,
22552,227,2022/4/15 19:40,8,67,-59,
22553,227,2022/4/15 19:50,9,48,-39,
22554,227,2022/4/15 20:00,13,45,-32,
22555,227,2022/4/15 20:10,4,38,-34,
22556,227,2022/4/15 20:20,10,39,-29,
22557,227,2022/4/15 20:30,6,38,-32,
22558,227,2022/4/15 20:40,6,33,-27,
22559,227,2022/4/15 20:50,8,27,-19,
22560,227,2022/4/15 21:00,3,40,-37,
22561,227,2022/4/15 21:10,5,34,-29,
22562,227,2022/4/15 21:20,5,25,-20,
22563,227,2022/4/15 21:30,4,22,-18,
22564,227,2022/4/15 21:40,2,25,-23,
22565,227,2022/4/15 21:50,2,21,-19,
22566,227,2022/4/15 22:00,1,25,-24,
22567,227,2022/4/15 22:10,2,23,-21,
22568,227,2022/4/15 22:20,2,21,-19,
22569,227,2022/4/15 22:30,0,21,-21,
22570,227,2022/4/15 22:40,0,18,-18,
22571,227,2022/4/15 22:50,0,10,-10,
22572,208,2022/4/15 5:00,0,1,-1,
22573,208,2022/4/15 5:10,0,1,-1,
22574,208,2022/4/15 5:20,1,1,0,
22575,208,2022/4/15 5:30,15,1,14,
22576,208,2022/4/15 5:40,20,1,19,
22577,208,2022/4/15 5:50,23,1,22,
22578,208,2022/4/15 6:00,26,1,25,
22579,208,2022/4/15 6:10,33,1,32,
22580,208,2022/4/15 6:20,37,14,23,
22581,208,2022/4/15 6:30,57,23,34,
22582,208,2022/4/15 6:40,66,23,43,
22583,208,2022/4/15 6:50,78,38,40,
22584,208,2022/4/15 7:00,93,50,43,
22585,208,2022/4/15 7:10,187,64,123,
22586,208,2022/4/15 7:20,226,63,163,
22587,208,2022/4/15 7:30,280,63,217,
22588,208,2022/4/15 7:40,375,50,325,
22589,208,2022/4/15 7:50,573,51,522,
22590,208,2022/4/15 8:00,599,47,552,
22591,208,2022/4/15 8:10,375,63,312,
22592,208,2022/4/15 8:20,279,51,228,
22593,208,2022/4/15 8:30,223,50,173,
22594,208,2022/4/15 8:40,152,52,100,
22595,208,2022/4/15 8:50,87,51,36,
22596,208,2022/4/15 9:00,52,52,0,
22597,208,2022/4/15 9:10,36,38,-2,
22598,208,2022/4/15 9:20,30,33,-3,
22599,208,2022/4/15 9:30,31,35,-4,
22600,208,2022/4/15 9:40,26,32,-6,
22601,208,2022/4/15 9:50,28,34,-6,
22602,208,2022/4/15 10:00,23,35,-12,
22603,208,2022/4/15 10:10,24,38,-14,
22604,208,2022/4/15 10:20,22,34,-12,
22605,208,2022/4/15 10:30,22,37,-15,
22606,208,2022/4/15 10:40,20,46,-26,
22607,208,2022/4/15 10:50,22,37,-15,
22608,208,2022/4/15 11:00,19,36,-17,
22609,208,2022/4/15 11:10,21,32,-11,
22610,208,2022/4/15 11:20,19,36,-17,
22611,208,2022/4/15 11:30,24,39,-15,
22612,208,2022/4/15 11:40,22,38,-16,
22613,208,2022/4/15 11:50,19,35,-16,
22614,208,2022/4/15 12:00,21,42,-21,
22615,208,2022/4/15 12:10,26,47,-21,
22616,208,2022/4/15 12:20,25,36,-11,
22617,208,2022/4/15 12:30,21,40,-19,
22618,208,2022/4/15 12:40,25,38,-13,
22619,208,2022/4/15 12:50,23,37,-14,
22620,208,2022/4/15 13:00,22,38,-16,
22621,208,2022/4/15 13:10,20,38,-18,
22622,208,2022/4/15 13:20,22,40,-18,
22623,208,2022/4/15 13:30,20,46,-26,
22624,208,2022/4/15 13:40,23,44,-21,
22625,208,2022/4/15 13:50,22,47,-25,
22626,208,2022/4/15 14:00,20,38,-18,
22627,208,2022/4/15 14:10,21,42,-21,
22628,208,2022/4/15 14:20,16,41,-25,
22629,208,2022/4/15 14:30,14,42,-28,
22630,208,2022/4/15 14:40,19,40,-21,
22631,208,2022/4/15 14:50,17,47,-30,
22632,208,2022/4/15 15:00,16,51,-35,
22633,208,2022/4/15 15:10,17,66,-49,
22634,208,2022/4/15 15:20,20,53,-33,
22635,208,2022/4/15 15:30,16,50,-34,
22636,208,2022/4/15 15:40,16,54,-38,
22637,208,2022/4/15 15:50,14,67,-53,
22638,208,2022/4/15 16:00,17,63,-46,
22639,208,2022/4/15 16:10,19,66,-47,
22640,208,2022/4/15 16:20,18,68,-50,
22641,208,2022/4/15 16:30,26,77,-51,
22642,208,2022/4/15 16:40,27,75,-48,
22643,208,2022/4/15 16:50,27,82,-55,
22644,208,2022/4/15 17:00,28,74,-46,
22645,208,2022/4/15 17:10,23,75,-52,
22646,208,2022/4/15 17:20,27,93,-66,
22647,208,2022/4/15 17:30,26,107,-81,
22648,208,2022/4/15 17:40,21,108,-87,
22649,208,2022/4/15 17:50,18,110,-92,
22650,208,2022/4/15 18:00,21,117,-96,
22651,208,2022/4/15 18:10,22,114,-92,
22652,208,2022/4/15 18:20,19,110,-91,
22653,208,2022/4/15 18:30,15,128,-113,
22654,208,2022/4/15 18:40,16,104,-88,
22655,208,2022/4/15 18:50,15,119,-104,
22656,208,2022/4/15 19:00,12,109,-97,
22657,208,2022/4/15 19:10,12,161,-149,
22658,208,2022/4/15 19:20,14,150,-136,
22659,208,2022/4/15 19:30,10,123,-113,
22660,208,2022/4/15 19:40,11,106,-95,
22661,208,2022/4/15 19:50,10,107,-97,
22662,208,2022/4/15 20:00,12,106,-94,
22663,208,2022/4/15 20:10,12,89,-77,
22664,208,2022/4/15 20:20,9,94,-85,
22665,208,2022/4/15 20:30,8,98,-90,
22666,208,2022/4/15 20:40,6,99,-93,
22667,208,2022/4/15 20:50,6,95,-89,
22668,208,2022/4/15 21:00,8,84,-76,
22669,208,2022/4/15 21:10,7,89,-82,
22670,208,2022/4/15 21:20,7,78,-71,
22671,208,2022/4/15 21:30,6,77,-71,
22672,208,2022/4/15 21:40,5,78,-73,
22673,208,2022/4/15 21:50,2,88,-86,
22674,208,2022/4/15 22:00,1,72,-71,
22675,208,2022/4/15 22:10,2,89,-87,
22676,208,2022/4/15 22:20,2,78,-76,
22677,208,2022/4/15 22:30,2,62,-60,
22678,208,2022/4/15 22:40,0,78,-78,
22679,208,2022/4/15 22:50,0,65,-65,
22680,216,2022/4/15 5:00,0,1,-1,
22681,216,2022/4/15 5:10,0,1,-1,
22682,216,2022/4/15 5:20,0,1,-1,
22683,216,2022/4/15 5:30,17,1,16,
22684,216,2022/4/15 5:40,29,1,28,
22685,216,2022/4/15 5:50,20,1,19,
22686,216,2022/4/15 6:00,34,1,33,
22687,216,2022/4/15 6:10,37,21,16,
22688,216,2022/4/15 6:20,43,31,12,
22689,216,2022/4/15 6:30,69,23,46,
22690,216,2022/4/15 6:40,75,23,52,
22691,216,2022/4/15 6:50,88,38,50,
22692,216,2022/4/15 7:00,152,47,105,
22693,216,2022/4/15 7:10,227,47,180,
22694,216,2022/4/15 7:20,244,57,187,
22695,216,2022/4/15 7:30,303,59,244,
22696,216,2022/4/15 7:40,339,68,271,
22697,216,2022/4/15 7:50,324,72,252,
22698,216,2022/4/15 8:00,337,77,260,
22699,216,2022/4/15 8:10,356,72,284,
22700,216,2022/4/15 8:20,277,85,192,
22701,216,2022/4/15 8:30,233,72,161,
22702,216,2022/4/15 8:40,189,61,128,
22703,216,2022/4/15 8:50,109,52,57,
22704,216,2022/4/15 9:00,66,52,14,
22705,216,2022/4/15 9:10,52,50,2,
22706,216,2022/4/15 9:20,40,47,-7,
22707,216,2022/4/15 9:30,28,47,-19,
22708,216,2022/4/15 9:40,32,41,-9,
22709,216,2022/4/15 9:50,31,39,-8,
22710,216,2022/4/15 10:00,27,37,-10,
22711,216,2022/4/15 10:10,25,42,-17,
22712,216,2022/4/15 10:20,24,45,-21,
22713,216,2022/4/15 10:30,23,32,-9,
22714,216,2022/4/15 10:40,23,41,-18,
22715,216,2022/4/15 10:50,20,44,-24,
22716,216,2022/4/15 11:00,22,49,-27,
22717,216,2022/4/15 11:10,24,46,-22,
22718,216,2022/4/15 11:20,21,45,-24,
22719,216,2022/4/15 11:30,20,45,-25,
22720,216,2022/4/15 11:40,21,47,-26,
22721,216,2022/4/15 11:50,27,47,-20,
22722,216,2022/4/15 12:00,23,41,-18,
22723,216,2022/4/15 12:10,25,45,-20,
22724,216,2022/4/15 12:20,26,48,-22,
22725,216,2022/4/15 12:30,26,54,-28,
22726,216,2022/4/15 12:40,25,48,-23,
22727,216,2022/4/15 12:50,26,45,-19,
22728,216,2022/4/15 13:00,21,47,-26,
22729,216,2022/4/15 13:10,23,50,-27,
22730,216,2022/4/15 13:20,23,45,-22,
22731,216,2022/4/15 13:30,20,44,-24,
22732,216,2022/4/15 13:40,22,45,-23,
22733,216,2022/4/15 13:50,18,47,-29,
22734,216,2022/4/15 14:00,20,51,-31,
22735,216,2022/4/15 14:10,20,49,-29,
22736,216,2022/4/15 14:20,21,44,-23,
22737,216,2022/4/15 14:30,20,51,-31,
22738,216,2022/4/15 14:40,20,65,-45,
22739,216,2022/4/15 14:50,17,60,-43,
22740,216,2022/4/15 15:00,19,57,-38,
22741,216,2022/4/15 15:10,18,65,-47,
22742,216,2022/4/15 15:20,18,57,-39,
22743,216,2022/4/15 15:30,22,78,-56,
22744,216,2022/4/15 15:40,21,70,-49,
22745,216,2022/4/15 15:50,22,71,-49,
22746,216,2022/4/15 16:00,24,83,-59,
22747,216,2022/4/15 16:10,23,75,-52,
22748,216,2022/4/15 16:20,27,75,-48,
22749,216,2022/4/15 16:30,27,77,-50,
22750,216,2022/4/15 16:40,28,77,-49,
22751,216,2022/4/15 16:50,35,98,-63,
22752,216,2022/4/15 17:00,38,113,-75,
22753,216,2022/4/15 17:10,39,98,-59,
22754,216,2022/4/15 17:20,42,119,-77,
22755,216,2022/4/15 17:30,38,122,-84,
22756,216,2022/4/15 17:40,33,115,-82,
22757,216,2022/4/15 17:50,57,122,-65,
22758,216,2022/4/15 18:00,67,104,-37,
22759,216,2022/4/15 18:10,28,152,-124,
22760,216,2022/4/15 18:20,24,116,-92,
22761,216,2022/4/15 18:30,26,107,-81,
22762,216,2022/4/15 18:40,22,121,-99,
22763,216,2022/4/15 18:50,22,116,-94,
22764,216,2022/4/15 19:00,21,128,-107,
22765,216,2022/4/15 19:10,20,110,-90,
22766,216,2022/4/15 19:20,18,119,-101,
22767,216,2022/4/15 19:30,16,105,-89,
22768,216,2022/4/15 19:40,14,102,-88,
22769,216,2022/4/15 19:50,16,92,-76,
22770,216,2022/4/15 20:00,19,81,-62,
22771,216,2022/4/15 20:10,15,94,-79,
22772,216,2022/4/15 20:20,14,89,-75,
22773,216,2022/4/15 20:30,16,75,-59,
22774,216,2022/4/15 20:40,15,85,-70,
22775,216,2022/4/15 20:50,15,85,-70,
22776,216,2022/4/15 21:00,15,71,-56,
22777,216,2022/4/15 21:10,17,77,-60,
22778,216,2022/4/15 21:20,12,77,-65,
22779,216,2022/4/15 21:30,12,68,-56,
22780,216,2022/4/15 21:40,11,80,-69,
22781,216,2022/4/15 21:50,10,63,-53,
22782,216,2022/4/15 22:00,9,78,-69,
22783,216,2022/4/15 22:10,9,73,-64,
22784,216,2022/4/15 22:20,5,70,-65,
22785,216,2022/4/15 22:30,5,73,-68,
22786,216,2022/4/15 22:40,2,69,-67,
22787,216,2022/4/15 22:50,0,78,-78,
22788,226,2022/4/15 5:00,0,1,-1,
22789,226,2022/4/15 5:10,0,1,-1,
22790,226,2022/4/15 5:20,0,1,-1,
22791,226,2022/4/15 5:30,13,1,12,
22792,226,2022/4/15 5:40,28,1,27,
22793,226,2022/4/15 5:50,27,2,25,
22794,226,2022/4/15 6:00,37,5,32,
22795,226,2022/4/15 6:10,47,21,26,
22796,226,2022/4/15 6:20,57,19,38,
22797,226,2022/4/15 6:30,88,35,53,
22798,226,2022/4/15 6:40,174,42,132,
22799,226,2022/4/15 6:50,183,54,129,
22800,226,2022/4/15 7:00,228,55,173,
22801,226,2022/4/15 7:10,278,69,209,
22802,226,2022/4/15 7:20,351,71,280,
22803,226,2022/4/15 7:30,598,73,525,
22804,226,2022/4/15 7:40,630,60,570,
22805,226,2022/4/15 7:50,724,69,655,
22806,226,2022/4/15 8:00,635,59,576,
22807,226,2022/4/15 8:10,629,72,557,
22808,226,2022/4/15 8:20,446,62,384,
22809,226,2022/4/15 8:30,276,60,216,
22810,226,2022/4/15 8:40,236,70,166,
22811,226,2022/4/15 8:50,186,70,116,
22812,226,2022/4/15 9:00,99,64,35,
22813,226,2022/4/15 9:10,72,75,-3,
22814,226,2022/4/15 9:20,51,72,-21,
22815,226,2022/4/15 9:30,47,61,-14,
22816,226,2022/4/15 9:40,35,61,-26,
22817,226,2022/4/15 9:50,26,66,-40,
22818,226,2022/4/15 10:00,30,71,-41,
22819,226,2022/4/15 10:10,32,67,-35,
22820,226,2022/4/15 10:20,29,65,-36,
22821,226,2022/4/15 10:30,28,71,-43,
22822,226,2022/4/15 10:40,28,74,-46,
22823,226,2022/4/15 10:50,27,68,-41,
22824,226,2022/4/15 11:00,27,63,-36,
22825,226,2022/4/15 11:10,29,63,-34,
22826,226,2022/4/15 11:20,29,71,-42,
22827,226,2022/4/15 11:30,29,69,-40,
22828,226,2022/4/15 11:40,29,68,-39,
22829,226,2022/4/15 11:50,27,74,-47,
22830,226,2022/4/15 12:00,36,68,-32,
22831,226,2022/4/15 12:10,32,72,-40,
22832,226,2022/4/15 12:20,35,65,-30,
22833,226,2022/4/15 12:30,29,70,-41,
22834,226,2022/4/15 12:40,33,70,-37,
22835,226,2022/4/15 12:50,30,85,-55,
22836,226,2022/4/15 13:00,27,76,-49,
22837,226,2022/4/15 13:10,26,56,-30,
22838,226,2022/4/15 13:20,33,73,-40,
22839,226,2022/4/15 13:30,28,77,-49,
22840,226,2022/4/15 13:40,26,62,-36,
22841,226,2022/4/15 13:50,25,70,-45,
22842,226,2022/4/15 14:00,26,69,-43,
22843,226,2022/4/15 14:10,27,77,-50,
22844,226,2022/4/15 14:20,25,93,-68,
22845,226,2022/4/15 14:30,28,77,-49,
22846,226,2022/4/15 14:40,26,73,-47,
22847,226,2022/4/15 14:50,30,80,-50,
22848,226,2022/4/15 15:00,20,91,-71,
22849,226,2022/4/15 15:10,27,93,-66,
22850,226,2022/4/15 15:20,22,87,-65,
22851,226,2022/4/15 15:30,26,97,-71,
22852,226,2022/4/15 15:40,26,105,-79,
22853,226,2022/4/15 15:50,30,104,-74,
22854,226,2022/4/15 16:00,26,102,-76,
22855,226,2022/4/15 16:10,33,102,-69,
22856,226,2022/4/15 16:20,24,103,-79,
22857,226,2022/4/15 16:30,31,119,-88,
22858,226,2022/4/15 16:40,36,104,-68,
22859,226,2022/4/15 16:50,42,120,-78,
22860,226,2022/4/15 17:00,37,123,-86,
22861,226,2022/4/15 17:10,34,111,-77,
22862,226,2022/4/15 17:20,37,152,-115,
22863,226,2022/4/15 17:30,42,158,-116,
22864,226,2022/4/15 17:40,37,207,-170,
22865,226,2022/4/15 17:50,37,298,-261,
22866,226,2022/4/15 18:00,32,301,-269,
22867,226,2022/4/15 18:10,36,299,-263,
22868,226,2022/4/15 18:20,27,336,-309,
22869,226,2022/4/15 18:30,31,286,-255,
22870,226,2022/4/15 18:40,29,321,-292,
22871,226,2022/4/15 18:50,26,335,-309,
22872,226,2022/4/15 19:00,28,208,-180,
22873,226,2022/4/15 19:10,26,224,-198,
22874,226,2022/4/15 19:20,25,159,-134,
22875,226,2022/4/15 19:30,26,104,-78,
22876,226,2022/4/15 19:40,25,111,-86,
22877,226,2022/4/15 19:50,25,126,-101,
22878,226,2022/4/15 20:00,26,103,-77,
22879,226,2022/4/15 20:10,24,113,-89,
22880,226,2022/4/15 20:20,28,104,-76,
22881,226,2022/4/15 20:30,27,101,-74,
22882,226,2022/4/15 20:40,22,105,-83,
22883,226,2022/4/15 20:50,24,105,-81,
22884,226,2022/4/15 21:00,26,94,-68,
22885,226,2022/4/15 21:10,26,102,-76,
22886,226,2022/4/15 21:20,24,92,-68,
22887,226,2022/4/15 21:30,22,89,-67,
22888,226,2022/4/15 21:40,17,89,-72,
22889,226,2022/4/15 21:50,16,95,-79,
22890,226,2022/4/15 22:00,34,76,-42,
22891,226,2022/4/15 22:10,15,92,-77,
22892,226,2022/4/15 22:20,7,70,-63,
22893,226,2022/4/15 22:30,4,78,-74,
22894,226,2022/4/15 22:40,3,79,-76,
22895,226,2022/4/15 22:50,1,66,-65,
22896,205,2022/4/15 5:00,0,1,-1,
22897,205,2022/4/15 5:10,0,1,-1,
22898,205,2022/4/15 5:20,1,1,0,
22899,205,2022/4/15 5:30,11,1,10,
22900,205,2022/4/15 5:40,31,1,30,
22901,205,2022/4/15 5:50,32,1,31,
22902,205,2022/4/15 6:00,54,2,52,
22903,205,2022/4/15 6:10,59,14,45,
22904,205,2022/4/15 6:20,89,19,70,
22905,205,2022/4/15 6:30,189,40,149,
22906,205,2022/4/15 6:40,243,50,193,
22907,205,2022/4/15 6:50,266,62,204,
22908,205,2022/4/15 7:00,301,72,229,
22909,205,2022/4/15 7:10,436,69,367,
22910,205,2022/4/15 7:20,655,79,576,
22911,205,2022/4/15 7:30,867,93,774,
22912,205,2022/4/15 7:40,1170,83,1087,
22913,205,2022/4/15 7:50,1216,75,1141,
22914,205,2022/4/15 8:00,1227,99,1128,
22915,205,2022/4/15 8:10,1051,73,978,
22916,205,2022/4/15 8:20,702,93,609,
22917,205,2022/4/15 8:30,596,98,498,
22918,205,2022/4/15 8:40,374,77,297,
22919,205,2022/4/15 8:50,280,81,199,
22920,205,2022/4/15 9:00,231,62,169,
22921,205,2022/4/15 9:10,182,66,116,
22922,205,2022/4/15 9:20,90,69,21,
22923,205,2022/4/15 9:30,71,66,5,
22924,205,2022/4/15 9:40,51,60,-9,
22925,205,2022/4/15 9:50,46,47,-1,
22926,205,2022/4/15 10:00,36,66,-30,
22927,205,2022/4/15 10:10,33,54,-21,
22928,205,2022/4/15 10:20,31,54,-23,
22929,205,2022/4/15 10:30,32,54,-22,
22930,205,2022/4/15 10:40,31,52,-21,
22931,205,2022/4/15 10:50,30,64,-34,
22932,205,2022/4/15 11:00,26,57,-31,
22933,205,2022/4/15 11:10,32,54,-22,
22934,205,2022/4/15 11:20,27,57,-30,
22935,205,2022/4/15 11:30,28,66,-38,
22936,205,2022/4/15 11:40,28,71,-43,
22937,205,2022/4/15 11:50,29,65,-36,
22938,205,2022/4/15 12:00,31,59,-28,
22939,205,2022/4/15 12:10,30,62,-32,
22940,205,2022/4/15 12:20,31,71,-40,
22941,205,2022/4/15 12:30,29,70,-41,
22942,205,2022/4/15 12:40,30,62,-32,
22943,205,2022/4/15 12:50,28,66,-38,
22944,205,2022/4/15 13:00,33,67,-34,
22945,205,2022/4/15 13:10,29,63,-34,
22946,205,2022/4/15 13:20,26,71,-45,
22947,205,2022/4/15 13:30,26,58,-32,
22948,205,2022/4/15 13:40,29,69,-40,
22949,205,2022/4/15 13:50,25,65,-40,
22950,205,2022/4/15 14:00,29,70,-41,
22951,205,2022/4/15 14:10,25,70,-45,
22952,205,2022/4/15 14:20,28,71,-43,
22953,205,2022/4/15 14:30,27,77,-50,
22954,205,2022/4/15 14:40,24,76,-52,
22955,205,2022/4/15 14:50,21,76,-55,
22956,205,2022/4/15 15:00,27,74,-47,
22957,205,2022/4/15 15:10,25,78,-53,
22958,205,2022/4/15 15:20,23,93,-70,
22959,205,2022/4/15 15:30,24,97,-73,
22960,205,2022/4/15 15:40,27,92,-65,
22961,205,2022/4/15 15:50,24,90,-66,
22962,205,2022/4/15 16:00,29,102,-73,
22963,205,2022/4/15 16:10,33,112,-79,
22964,205,2022/4/15 16:20,29,104,-75,
22965,205,2022/4/15 16:30,37,112,-75,
22966,205,2022/4/15 16:40,33,122,-89,
22967,205,2022/4/15 16:50,28,110,-82,
22968,205,2022/4/15 17:00,43,116,-73,
22969,205,2022/4/15 17:10,42,127,-85,
22970,205,2022/4/15 17:20,43,212,-169,
22971,205,2022/4/15 17:30,42,196,-154,
22972,205,2022/4/15 17:40,46,268,-222,
22973,205,2022/4/15 17:50,51,333,-282,
22974,205,2022/4/15 18:00,45,381,-336,
22975,205,2022/4/15 18:10,43,385,-342,
22976,205,2022/4/15 18:20,39,510,-471,
22977,205,2022/4/15 18:30,30,382,-352,
22978,205,2022/4/15 18:40,29,373,-344,
22979,205,2022/4/15 18:50,32,535,-503,
22980,205,2022/4/15 19:00,24,350,-326,
22981,205,2022/4/15 19:10,26,269,-243,
22982,205,2022/4/15 19:20,25,234,-209,
22983,205,2022/4/15 19:30,21,145,-124,
22984,205,2022/4/15 19:40,23,117,-94,
22985,205,2022/4/15 19:50,20,104,-84,
22986,205,2022/4/15 20:00,25,125,-100,
22987,205,2022/4/15 20:10,20,123,-103,
22988,205,2022/4/15 20:20,18,110,-92,
22989,205,2022/4/15 20:30,20,89,-69,
22990,205,2022/4/15 20:40,20,105,-85,
22991,205,2022/4/15 20:50,18,103,-85,
22992,205,2022/4/15 21:00,22,107,-85,
22993,205,2022/4/15 21:10,17,107,-90,
22994,205,2022/4/15 21:20,18,112,-94,
22995,205,2022/4/15 21:30,12,107,-95,
22996,205,2022/4/15 21:40,11,110,-99,
22997,205,2022/4/15 21:50,12,112,-100,
22998,205,2022/4/15 22:00,8,113,-105,
22999,205,2022/4/15 22:10,9,93,-84,
23000,205,2022/4/15 22:20,5,104,-99,
23001,205,2022/4/15 22:30,3,98,-95,
23002,205,2022/4/15 22:40,4,76,-72,
23003,205,2022/4/15 22:50,0,85,-85,
23004,215,2022/4/15 5:00,0,1,-1,
23005,215,2022/4/15 5:10,0,1,-1,
23006,215,2022/4/15 5:20,0,1,-1,
23007,215,2022/4/15 5:30,11,1,10,
23008,215,2022/4/15 5:40,22,1,21,
23009,215,2022/4/15 5:50,27,5,22,
23010,215,2022/4/15 6:00,38,6,32,
23011,215,2022/4/15 6:10,39,38,1,
23012,215,2022/4/15 6:20,54,29,25,
23013,215,2022/4/15 6:30,69,63,6,
23014,215,2022/4/15 6:40,87,77,10,
23015,215,2022/4/15 6:50,99,93,6,
23016,215,2022/4/15 7:00,194,90,104,
23017,215,2022/4/15 7:10,236,105,131,
23018,215,2022/4/15 7:20,278,123,155,
23019,215,2022/4/15 7:30,393,110,283,
23020,215,2022/4/15 7:40,596,120,476,
23021,215,2022/4/15 7:50,662,144,518,
23022,215,2022/4/15 8:00,654,193,461,
23023,215,2022/4/15 8:10,664,233,431,
23024,215,2022/4/15 8:20,389,223,166,
23025,215,2022/4/15 8:30,276,233,43,
23026,215,2022/4/15 8:40,283,234,49,
23027,215,2022/4/15 8:50,216,180,36,
23028,215,2022/4/15 9:00,177,112,65,
23029,215,2022/4/15 9:10,140,133,7,
23030,215,2022/4/15 9:20,71,125,-54,
23031,215,2022/4/15 9:30,58,126,-68,
23032,215,2022/4/15 9:40,49,112,-63,
23033,215,2022/4/15 9:50,45,105,-60,
23034,215,2022/4/15 10:00,41,94,-53,
23035,215,2022/4/15 10:10,36,90,-54,
23036,215,2022/4/15 10:20,33,93,-60,
23037,215,2022/4/15 10:30,39,91,-52,
23038,215,2022/4/15 10:40,38,98,-60,
23039,215,2022/4/15 10:50,37,87,-50,
23040,215,2022/4/15 11:00,34,76,-42,
23041,215,2022/4/15 11:10,37,87,-50,
23042,215,2022/4/15 11:20,38,100,-62,
23043,215,2022/4/15 11:30,35,93,-58,
23044,215,2022/4/15 11:40,36,77,-41,
23045,215,2022/4/15 11:50,38,75,-37,
23046,215,2022/4/15 12:00,44,93,-49,
23047,215,2022/4/15 12:10,40,97,-57,
23048,215,2022/4/15 12:20,43,99,-56,
23049,215,2022/4/15 12:30,44,90,-46,
23050,215,2022/4/15 12:40,45,99,-54,
23051,215,2022/4/15 12:50,43,108,-65,
23052,215,2022/4/15 13:00,43,101,-58,
23053,215,2022/4/15 13:10,45,93,-48,
23054,215,2022/4/15 13:20,35,91,-56,
23055,215,2022/4/15 13:30,41,93,-52,
23056,215,2022/4/15 13:40,41,109,-68,
23057,215,2022/4/15 13:50,37,97,-60,
23058,215,2022/4/15 14:00,37,90,-53,
23059,215,2022/4/15 14:10,41,101,-60,
23060,215,2022/4/15 14:20,42,101,-59,
23061,215,2022/4/15 14:30,38,93,-55,
23062,215,2022/4/15 14:40,32,97,-65,
23063,215,2022/4/15 14:50,41,93,-52,
23064,215,2022/4/15 15:00,42,101,-59,
23065,215,2022/4/15 15:10,47,111,-64,
23066,215,2022/4/15 15:20,42,102,-60,
23067,215,2022/4/15 15:30,43,96,-53,
23068,215,2022/4/15 15:40,59,103,-44,
23069,215,2022/4/15 15:50,46,108,-62,
23070,215,2022/4/15 16:00,63,102,-39,
23071,215,2022/4/15 16:10,41,101,-60,
23072,215,2022/4/15 16:20,54,101,-47,
23073,215,2022/4/15 16:30,69,123,-54,
23074,215,2022/4/15 16:40,70,125,-55,
23075,215,2022/4/15 16:50,77,113,-36,
23076,215,2022/4/15 17:00,140,124,16,
23077,215,2022/4/15 17:10,174,107,67,
23078,215,2022/4/15 17:20,137,108,29,
23079,215,2022/4/15 17:30,143,177,-34,
23080,215,2022/4/15 17:40,175,212,-37,
23081,215,2022/4/15 17:50,160,207,-47,
23082,215,2022/4/15 18:00,150,268,-118,
23083,215,2022/4/15 18:10,176,327,-151,
23084,215,2022/4/15 18:20,175,326,-151,
23085,215,2022/4/15 18:30,109,335,-226,
23086,215,2022/4/15 18:40,128,320,-192,
23087,215,2022/4/15 18:50,64,269,-205,
23088,215,2022/4/15 19:00,57,270,-213,
23089,215,2022/4/15 19:10,54,234,-180,
23090,215,2022/4/15 19:20,45,192,-147,
23091,215,2022/4/15 19:30,39,170,-131,
23092,215,2022/4/15 19:40,39,108,-69,
23093,215,2022/4/15 19:50,41,124,-83,
23094,215,2022/4/15 20:00,45,123,-78,
23095,215,2022/4/15 20:10,44,124,-80,
23096,215,2022/4/15 20:20,39,116,-77,
23097,215,2022/4/15 20:30,40,109,-69,
23098,215,2022/4/15 20:40,39,115,-76,
23099,215,2022/4/15 20:50,43,107,-64,
23100,215,2022/4/15 21:00,44,106,-62,
23101,215,2022/4/15 21:10,43,112,-69,
23102,215,2022/4/15 21:20,31,105,-74,
23103,215,2022/4/15 21:30,32,107,-75,
23104,215,2022/4/15 21:40,29,107,-78,
23105,215,2022/4/15 21:50,25,82,-57,
23106,215,2022/4/15 22:00,29,106,-77,
23107,215,2022/4/15 22:10,25,103,-78,
23108,215,2022/4/15 22:20,14,76,-62,
23109,215,2022/4/15 22:30,11,104,-93,
23110,215,2022/4/15 22:40,5,76,-71,
23111,215,2022/4/15 22:50,2,70,-68,
23112,229,2022/4/15 5:00,0,1,-1,
23113,229,2022/4/15 5:10,0,1,-1,
23114,229,2022/4/15 5:20,0,1,-1,
23115,229,2022/4/15 5:30,4,1,3,
23116,229,2022/4/15 5:40,18,1,17,
23117,229,2022/4/15 5:50,32,2,30,
23118,229,2022/4/15 6:00,42,19,23,
23119,229,2022/4/15 6:10,36,11,25,
23120,229,2022/4/15 6:20,58,25,33,
23121,229,2022/4/15 6:30,84,31,53,
23122,229,2022/4/15 6:40,116,41,75,
23123,229,2022/4/15 6:50,169,48,121,
23124,229,2022/4/15 7:00,186,60,126,
23125,229,2022/4/15 7:10,265,64,201,
23126,229,2022/4/15 7:20,318,78,240,
23127,229,2022/4/15 7:30,597,92,505,
23128,229,2022/4/15 7:40,722,105,617,
23129,229,2022/4/15 7:50,723,113,610,
23130,229,2022/4/15 8:00,688,109,579,
23131,229,2022/4/15 8:10,629,105,524,
23132,229,2022/4/15 8:20,390,86,304,
23133,229,2022/4/15 8:30,319,126,193,
23134,229,2022/4/15 8:40,272,120,152,
23135,229,2022/4/15 8:50,226,105,121,
23136,229,2022/4/15 9:00,173,97,76,
23137,229,2022/4/15 9:10,143,90,53,
23138,229,2022/4/15 9:20,76,76,0,
23139,229,2022/4/15 9:30,50,64,-14,
23140,229,2022/4/15 9:40,46,78,-32,
23141,229,2022/4/15 9:50,37,67,-30,
23142,229,2022/4/15 10:00,37,65,-28,
23143,229,2022/4/15 10:10,36,70,-34,
23144,229,2022/4/15 10:20,29,61,-32,
23145,229,2022/4/15 10:30,31,63,-32,
23146,229,2022/4/15 10:40,29,61,-32,
23147,229,2022/4/15 10:50,25,66,-41,
23148,229,2022/4/15 11:00,32,68,-36,
23149,229,2022/4/15 11:10,30,61,-31,
23150,229,2022/4/15 11:20,28,61,-33,
23151,229,2022/4/15 11:30,30,66,-36,
23152,229,2022/4/15 11:40,29,72,-43,
23153,229,2022/4/15 11:50,30,69,-39,
23154,229,2022/4/15 12:00,28,61,-33,
23155,229,2022/4/15 12:10,34,59,-25,
23156,229,2022/4/15 12:20,29,70,-41,
23157,229,2022/4/15 12:30,34,64,-30,
23158,229,2022/4/15 12:40,34,74,-40,
23159,229,2022/4/15 12:50,37,62,-25,
23160,229,2022/4/15 13:00,30,76,-46,
23161,229,2022/4/15 13:10,31,83,-52,
23162,229,2022/4/15 13:20,30,69,-39,
23163,229,2022/4/15 13:30,25,67,-42,
23164,229,2022/4/15 13:40,27,66,-39,
23165,229,2022/4/15 13:50,27,77,-50,
23166,229,2022/4/15 14:00,30,69,-39,
23167,229,2022/4/15 14:10,29,64,-35,
23168,229,2022/4/15 14:20,30,72,-42,
23169,229,2022/4/15 14:30,25,70,-45,
23170,229,2022/4/15 14:40,26,75,-49,
23171,229,2022/4/15 14:50,30,78,-48,
23172,229,2022/4/15 15:00,31,81,-50,
23173,229,2022/4/15 15:10,32,85,-53,
23174,229,2022/4/15 15:20,22,91,-69,
23175,229,2022/4/15 15:30,28,84,-56,
23176,229,2022/4/15 15:40,27,87,-60,
23177,229,2022/4/15 15:50,31,97,-66,
23178,229,2022/4/15 16:00,34,90,-56,
23179,229,2022/4/15 16:10,38,103,-65,
23180,229,2022/4/15 16:20,34,93,-59,
23181,229,2022/4/15 16:30,46,93,-47,
23182,229,2022/4/15 16:40,38,100,-62,
23183,229,2022/4/15 16:50,44,126,-82,
23184,229,2022/4/15 17:00,42,107,-65,
23185,229,2022/4/15 17:10,71,127,-56,
23186,229,2022/4/15 17:20,64,115,-51,
23187,229,2022/4/15 17:30,46,177,-131,
23188,229,2022/4/15 17:40,65,196,-131,
23189,229,2022/4/15 17:50,65,221,-156,
23190,229,2022/4/15 18:00,42,218,-176,
23191,229,2022/4/15 18:10,45,300,-255,
23192,229,2022/4/15 18:20,44,257,-213,
23193,229,2022/4/15 18:30,44,233,-189,
23194,229,2022/4/15 18:40,44,257,-213,
23195,229,2022/4/15 18:50,33,255,-222,
23196,229,2022/4/15 19:00,30,222,-192,
23197,229,2022/4/15 19:10,30,234,-204,
23198,229,2022/4/15 19:20,26,116,-90,
23199,229,2022/4/15 19:30,26,113,-87,
23200,229,2022/4/15 19:40,24,121,-97,
23201,229,2022/4/15 19:50,22,110,-88,
23202,229,2022/4/15 20:00,26,107,-81,
23203,229,2022/4/15 20:10,28,104,-76,
23204,229,2022/4/15 20:20,24,111,-87,
23205,229,2022/4/15 20:30,27,110,-83,
23206,229,2022/4/15 20:40,23,107,-84,
23207,229,2022/4/15 20:50,26,92,-66,
23208,229,2022/4/15 21:00,22,95,-73,
23209,229,2022/4/15 21:10,27,108,-81,
23210,229,2022/4/15 21:20,22,78,-56,
23211,229,2022/4/15 21:30,17,114,-97,
23212,229,2022/4/15 21:40,18,93,-75,
23213,229,2022/4/15 21:50,14,110,-96,
23214,229,2022/4/15 22:00,13,74,-61,
23215,229,2022/4/15 22:10,10,107,-97,
23216,229,2022/4/15 22:20,6,80,-74,
23217,229,2022/4/15 22:30,6,86,-80,
23218,229,2022/4/15 22:40,3,77,-74,
23219,229,2022/4/15 22:50,1,78,-77,
23220,206,2022/4/15 5:00,0,1,-1,
23221,206,2022/4/15 5:10,0,1,-1,
23222,206,2022/4/15 5:20,0,1,-1,
23223,206,2022/4/15 5:30,2,1,1,
23224,206,2022/4/15 5:40,16,1,15,
23225,206,2022/4/15 5:50,28,6,22,
23226,206,2022/4/15 6:00,33,13,20,
23227,206,2022/4/15 6:10,45,19,26,
23228,206,2022/4/15 6:20,45,23,22,
23229,206,2022/4/15 6:30,82,46,36,
23230,206,2022/4/15 6:40,115,74,41,
23231,206,2022/4/15 6:50,156,75,81,
23232,206,2022/4/15 7:00,192,93,99,
23233,206,2022/4/15 7:10,245,113,132,
23234,206,2022/4/15 7:20,281,96,185,
23235,206,2022/4/15 7:30,384,106,278,
23236,206,2022/4/15 7:40,721,90,631,
23237,206,2022/4/15 7:50,630,100,530,
23238,206,2022/4/15 8:00,589,111,478,
23239,206,2022/4/15 8:10,442,96,346,
23240,206,2022/4/15 8:20,361,102,259,
23241,206,2022/4/15 8:30,275,107,168,
23242,206,2022/4/15 8:40,266,104,162,
23243,206,2022/4/15 8:50,227,133,94,
23244,206,2022/4/15 9:00,193,109,84,
23245,206,2022/4/15 9:10,149,103,46,
23246,206,2022/4/15 9:20,93,93,0,
23247,206,2022/4/15 9:30,65,76,-11,
23248,206,2022/4/15 9:40,54,88,-34,
23249,206,2022/4/15 9:50,45,92,-47,
23250,206,2022/4/15 10:00,46,73,-27,
23251,206,2022/4/15 10:10,40,70,-30,
23252,206,2022/4/15 10:20,37,72,-35,
23253,206,2022/4/15 10:30,41,74,-33,
23254,206,2022/4/15 10:40,35,72,-37,
23255,206,2022/4/15 10:50,37,60,-23,
23256,206,2022/4/15 11:00,37,62,-25,
23257,206,2022/4/15 11:10,39,69,-30,
23258,206,2022/4/15 11:20,38,66,-28,
23259,206,2022/4/15 11:30,37,66,-29,
23260,206,2022/4/15 11:40,33,66,-33,
23261,206,2022/4/15 11:50,34,68,-34,
23262,206,2022/4/15 12:00,37,66,-29,
23263,206,2022/4/15 12:10,35,65,-30,
23264,206,2022/4/15 12:20,33,76,-43,
23265,206,2022/4/15 12:30,36,69,-33,
23266,206,2022/4/15 12:40,32,87,-55,
23267,206,2022/4/15 12:50,32,95,-63,
23268,206,2022/4/15 13:00,33,90,-57,
23269,206,2022/4/15 13:10,27,73,-46,
23270,206,2022/4/15 13:20,30,78,-48,
23271,206,2022/4/15 13:30,35,75,-40,
23272,206,2022/4/15 13:40,37,76,-39,
23273,206,2022/4/15 13:50,31,74,-43,
23274,206,2022/4/15 14:00,36,76,-40,
23275,206,2022/4/15 14:10,35,77,-42,
23276,206,2022/4/15 14:20,37,83,-46,
23277,206,2022/4/15 14:30,37,80,-43,
23278,206,2022/4/15 14:40,35,77,-42,
23279,206,2022/4/15 14:50,33,76,-43,
23280,206,2022/4/15 15:00,40,76,-36,
23281,206,2022/4/15 15:10,31,83,-52,
23282,206,2022/4/15 15:20,40,74,-34,
23283,206,2022/4/15 15:30,43,75,-32,
23284,206,2022/4/15 15:40,44,97,-53,
23285,206,2022/4/15 15:50,48,109,-61,
23286,206,2022/4/15 16:00,45,104,-59,
23287,206,2022/4/15 16:10,45,93,-48,
23288,206,2022/4/15 16:20,44,102,-58,
23289,206,2022/4/15 16:30,47,116,-69,
23290,206,2022/4/15 16:40,77,104,-27,
23291,206,2022/4/15 16:50,72,123,-51,
23292,206,2022/4/15 17:00,92,116,-24,
23293,206,2022/4/15 17:10,70,132,-62,
23294,206,2022/4/15 17:20,67,168,-101,
23295,206,2022/4/15 17:30,52,192,-140,
23296,206,2022/4/15 17:40,45,179,-134,
23297,206,2022/4/15 17:50,42,255,-213,
23298,206,2022/4/15 18:00,77,218,-141,
23299,206,2022/4/15 18:10,76,217,-141,
23300,206,2022/4/15 18:20,45,300,-255,
23301,206,2022/4/15 18:30,43,218,-175,
23302,206,2022/4/15 18:40,36,235,-199,
23303,206,2022/4/15 18:50,31,256,-225,
23304,206,2022/4/15 19:00,24,224,-200,
23305,206,2022/4/15 19:10,24,184,-160,
23306,206,2022/4/15 19:20,24,144,-120,
23307,206,2022/4/15 19:30,25,116,-91,
23308,206,2022/4/15 19:40,25,109,-84,
23309,206,2022/4/15 19:50,23,108,-85,
23310,206,2022/4/15 20:00,28,109,-81,
23311,206,2022/4/15 20:10,24,113,-89,
23312,206,2022/4/15 20:20,22,106,-84,
23313,206,2022/4/15 20:30,22,107,-85,
23314,206,2022/4/15 20:40,22,105,-83,
23315,206,2022/4/15 20:50,22,109,-87,
23316,206,2022/4/15 21:00,21,100,-79,
23317,206,2022/4/15 21:10,23,107,-84,
23318,206,2022/4/15 21:20,19,106,-87,
23319,206,2022/4/15 21:30,14,105,-91,
23320,206,2022/4/15 21:40,16,97,-81,
23321,206,2022/4/15 21:50,11,92,-81,
23322,206,2022/4/15 22:00,12,106,-94,
23323,206,2022/4/15 22:10,8,78,-70,
23324,206,2022/4/15 22:20,6,98,-92,
23325,206,2022/4/15 22:30,6,91,-85,
23326,206,2022/4/15 22:40,4,66,-62,
23327,206,2022/4/15 22:50,2,71,-69,
23328,204,2022/4/15 5:00,0,1,-1,
23329,204,2022/4/15 5:10,0,1,-1,
23330,204,2022/4/15 5:20,0,1,-1,
23331,204,2022/4/15 5:30,0,1,-1,
23332,204,2022/4/15 5:40,7,1,6,
23333,204,2022/4/15 5:50,16,1,15,
23334,204,2022/4/15 6:00,19,16,3,
23335,204,2022/4/15 6:10,24,19,5,
23336,204,2022/4/15 6:20,29,25,4,
23337,204,2022/4/15 6:30,38,46,-8,
23338,204,2022/4/15 6:40,45,74,-29,
23339,204,2022/4/15 6:50,55,76,-21,
23340,204,2022/4/15 7:00,57,93,-36,
23341,204,2022/4/15 7:10,62,99,-37,
23342,204,2022/4/15 7:20,83,83,0,
23343,204,2022/4/15 7:30,180,112,68,
23344,204,2022/4/15 7:40,224,105,119,
23345,204,2022/4/15 7:50,226,90,136,
23346,204,2022/4/15 8:00,205,93,112,
23347,204,2022/4/15 8:10,188,97,91,
23348,204,2022/4/15 8:20,150,104,46,
23349,204,2022/4/15 8:30,90,92,-2,
23350,204,2022/4/15 8:40,78,113,-35,
23351,204,2022/4/15 8:50,66,93,-27,
23352,204,2022/4/15 9:00,50,77,-27,
23353,204,2022/4/15 9:10,48,77,-29,
23354,204,2022/4/15 9:20,38,61,-23,
23355,204,2022/4/15 9:30,39,69,-30,
23356,204,2022/4/15 9:40,28,65,-37,
23357,204,2022/4/15 9:50,31,69,-38,
23358,204,2022/4/15 10:00,25,68,-43,
23359,204,2022/4/15 10:10,30,65,-35,
23360,204,2022/4/15 10:20,32,58,-26,
23361,204,2022/4/15 10:30,26,67,-41,
23362,204,2022/4/15 10:40,25,64,-39,
23363,204,2022/4/15 10:50,27,60,-33,
23364,204,2022/4/15 11:00,25,52,-27,
23365,204,2022/4/15 11:10,28,57,-29,
23366,204,2022/4/15 11:20,28,51,-23,
23367,204,2022/4/15 11:30,26,64,-38,
23368,204,2022/4/15 11:40,25,48,-23,
23369,204,2022/4/15 11:50,25,48,-23,
23370,204,2022/4/15 12:00,24,47,-23,
23371,204,2022/4/15 12:10,28,54,-26,
23372,204,2022/4/15 12:20,27,62,-35,
23373,204,2022/4/15 12:30,29,57,-28,
23374,204,2022/4/15 12:40,24,62,-38,
23375,204,2022/4/15 12:50,27,62,-35,
23376,204,2022/4/15 13:00,28,66,-38,
23377,204,2022/4/15 13:10,29,61,-32,
23378,204,2022/4/15 13:20,27,63,-36,
23379,204,2022/4/15 13:30,27,60,-33,
23380,204,2022/4/15 13:40,26,73,-47,
23381,204,2022/4/15 13:50,26,72,-46,
23382,204,2022/4/15 14:00,27,64,-37,
23383,204,2022/4/15 14:10,26,57,-31,
23384,204,2022/4/15 14:20,27,57,-30,
23385,204,2022/4/15 14:30,26,71,-45,
23386,204,2022/4/15 14:40,24,69,-45,
23387,204,2022/4/15 14:50,28,74,-46,
23388,204,2022/4/15 15:00,23,59,-36,
23389,204,2022/4/15 15:10,30,74,-44,
23390,204,2022/4/15 15:20,32,72,-40,
23391,204,2022/4/15 15:30,26,72,-46,
23392,204,2022/4/15 15:40,33,73,-40,
23393,204,2022/4/15 15:50,26,69,-43,
23394,204,2022/4/15 16:00,31,77,-46,
23395,204,2022/4/15 16:10,28,64,-36,
23396,204,2022/4/15 16:20,29,72,-43,
23397,204,2022/4/15 16:30,38,82,-44,
23398,204,2022/4/15 16:40,77,80,-3,
23399,204,2022/4/15 16:50,65,93,-28,
23400,204,2022/4/15 17:00,108,92,16,
23401,204,2022/4/15 17:10,63,100,-37,
23402,204,2022/4/15 17:20,49,121,-72,
23403,204,2022/4/15 17:30,43,123,-80,
23404,204,2022/4/15 17:40,41,114,-73,
23405,204,2022/4/15 17:50,31,119,-88,
23406,204,2022/4/15 18:00,33,106,-73,
23407,204,2022/4/15 18:10,30,115,-85,
23408,204,2022/4/15 18:20,31,111,-80,
23409,204,2022/4/15 18:30,24,110,-86,
23410,204,2022/4/15 18:40,26,123,-97,
23411,204,2022/4/15 18:50,24,124,-100,
23412,204,2022/4/15 19:00,21,125,-104,
23413,204,2022/4/15 19:10,21,106,-85,
23414,204,2022/4/15 19:20,20,113,-93,
23415,204,2022/4/15 19:30,22,92,-70,
23416,204,2022/4/15 19:40,18,80,-62,
23417,204,2022/4/15 19:50,15,79,-64,
23418,204,2022/4/15 20:00,18,63,-45,
23419,204,2022/4/15 20:10,23,72,-49,
23420,204,2022/4/15 20:20,19,73,-54,
23421,204,2022/4/15 20:30,15,69,-54,
23422,204,2022/4/15 20:40,19,71,-52,
23423,204,2022/4/15 20:50,14,76,-62,
23424,204,2022/4/15 21:00,16,72,-56,
23425,204,2022/4/15 21:10,18,70,-52,
23426,204,2022/4/15 21:20,12,67,-55,
23427,204,2022/4/15 21:30,11,73,-62,
23428,204,2022/4/15 21:40,12,66,-54,
23429,204,2022/4/15 21:50,10,70,-60,
23430,204,2022/4/15 22:00,9,60,-51,
23431,204,2022/4/15 22:10,8,68,-60,
23432,204,2022/4/15 22:20,5,51,-46,
23433,204,2022/4/15 22:30,3,59,-56,
23434,204,2022/4/15 22:40,2,51,-49,
23435,204,2022/4/15 22:50,2,38,-36,
23436,220,2022/4/15 5:00,0,1,-1,
23437,220,2022/4/15 5:10,0,1,-1,
23438,220,2022/4/15 5:20,0,1,-1,
23439,220,2022/4/15 5:30,0,1,-1,
23440,220,2022/4/15 5:40,6,1,5,
23441,220,2022/4/15 5:50,15,1,14,
23442,220,2022/4/15 6:00,21,11,10,
23443,220,2022/4/15 6:10,31,10,21,
23444,220,2022/4/15 6:20,32,21,11,
23445,220,2022/4/15 6:30,41,47,-6,
23446,220,2022/4/15 6:40,41,63,-22,
23447,220,2022/4/15 6:50,57,93,-36,
23448,220,2022/4/15 7:00,58,115,-57,
23449,220,2022/4/15 7:10,69,158,-89,
23450,220,2022/4/15 7:20,76,197,-121,
23451,220,2022/4/15 7:30,147,109,38,
23452,220,2022/4/15 7:40,206,110,96,
23453,220,2022/4/15 7:50,223,111,112,
23454,220,2022/4/15 8:00,206,114,92,
23455,220,2022/4/15 8:10,186,198,-12,
23456,220,2022/4/15 8:20,151,192,-41,
23457,220,2022/4/15 8:30,149,109,40,
23458,220,2022/4/15 8:40,91,128,-37,
23459,220,2022/4/15 8:50,70,119,-49,
23460,220,2022/4/15 9:00,61,126,-65,
23461,220,2022/4/15 9:10,49,108,-59,
23462,220,2022/4/15 9:20,44,93,-49,
23463,220,2022/4/15 9:30,39,80,-41,
23464,220,2022/4/15 9:40,33,77,-44,
23465,220,2022/4/15 9:50,31,62,-31,
23466,220,2022/4/15 10:00,29,66,-37,
23467,220,2022/4/15 10:10,35,66,-31,
23468,220,2022/4/15 10:20,27,65,-38,
23469,220,2022/4/15 10:30,29,60,-31,
23470,220,2022/4/15 10:40,29,63,-34,
23471,220,2022/4/15 10:50,27,62,-35,
23472,220,2022/4/15 11:00,28,55,-27,
23473,220,2022/4/15 11:10,29,64,-35,
23474,220,2022/4/15 11:20,28,55,-27,
23475,220,2022/4/15 11:30,29,52,-23,
23476,220,2022/4/15 11:40,27,55,-28,
23477,220,2022/4/15 11:50,27,66,-39,
23478,220,2022/4/15 12:00,26,59,-33,
23479,220,2022/4/15 12:10,28,68,-40,
23480,220,2022/4/15 12:20,27,61,-34,
23481,220,2022/4/15 12:30,25,69,-44,
23482,220,2022/4/15 12:40,23,67,-44,
23483,220,2022/4/15 12:50,21,68,-47,
23484,220,2022/4/15 13:00,25,73,-48,
23485,220,2022/4/15 13:10,31,68,-37,
23486,220,2022/4/15 13:20,24,61,-37,
23487,220,2022/4/15 13:30,29,72,-43,
23488,220,2022/4/15 13:40,26,67,-41,
23489,220,2022/4/15 13:50,22,69,-47,
23490,220,2022/4/15 14:00,22,66,-44,
23491,220,2022/4/15 14:10,21,71,-50,
23492,220,2022/4/15 14:20,25,72,-47,
23493,220,2022/4/15 14:30,25,67,-42,
23494,220,2022/4/15 14:40,57,64,-7,
23495,220,2022/4/15 14:50,45,71,-26,
23496,220,2022/4/15 15:00,35,68,-33,
23497,220,2022/4/15 15:10,41,72,-31,
23498,220,2022/4/15 15:20,31,71,-40,
23499,220,2022/4/15 15:30,36,68,-32,
23500,220,2022/4/15 15:40,45,75,-30,
23501,220,2022/4/15 15:50,69,76,-7,
23502,220,2022/4/15 16:00,63,76,-13,
23503,220,2022/4/15 16:10,76,76,0,
23504,220,2022/4/15 16:20,45,97,-52,
23505,220,2022/4/15 16:30,43,97,-54,
23506,220,2022/4/15 16:40,72,76,-4,
23507,220,2022/4/15 16:50,56,93,-37,
23508,220,2022/4/15 17:00,210,102,108,
23509,220,2022/4/15 17:10,221,104,117,
23510,220,2022/4/15 17:20,162,109,53,
23511,220,2022/4/15 17:30,148,122,26,
23512,220,2022/4/15 17:40,176,110,66,
23513,220,2022/4/15 17:50,70,120,-50,
23514,220,2022/4/15 18:00,74,110,-36,
23515,220,2022/4/15 18:10,71,121,-50,
23516,220,2022/4/15 18:20,44,113,-69,
23517,220,2022/4/15 18:30,38,116,-78,
23518,220,2022/4/15 18:40,30,104,-74,
23519,220,2022/4/15 18:50,31,113,-82,
23520,220,2022/4/15 19:00,34,110,-76,
23521,220,2022/4/15 19:10,27,122,-95,
23522,220,2022/4/15 19:20,28,103,-75,
23523,220,2022/4/15 19:30,28,106,-78,
23524,220,2022/4/15 19:40,28,95,-67,
23525,220,2022/4/15 19:50,25,78,-53,
23526,220,2022/4/15 20:00,26,83,-57,
23527,220,2022/4/15 20:10,25,79,-54,
23528,220,2022/4/15 20:20,23,78,-55,
23529,220,2022/4/15 20:30,27,79,-52,
23530,220,2022/4/15 20:40,26,64,-38,
23531,220,2022/4/15 20:50,25,84,-59,
23532,220,2022/4/15 21:00,27,76,-49,
23533,220,2022/4/15 21:10,26,75,-49,
23534,220,2022/4/15 21:20,20,79,-59,
23535,220,2022/4/15 21:30,22,83,-61,
23536,220,2022/4/15 21:40,15,62,-47,
23537,220,2022/4/15 21:50,15,83,-68,
23538,220,2022/4/15 22:00,14,65,-51,
23539,220,2022/4/15 22:10,10,83,-73,
23540,220,2022/4/15 22:20,10,63,-53,
23541,220,2022/4/15 22:30,6,49,-43,
23542,220,2022/4/15 22:40,4,55,-51,
23543,220,2022/4/15 22:50,1,46,-45,
23544,228,2022/4/15 5:00,0,1,-1,
23545,228,2022/4/15 5:10,0,1,-1,
23546,228,2022/4/15 5:20,0,1,-1,
23547,228,2022/4/15 5:30,1,1,0,
23548,228,2022/4/15 5:40,2,1,1,
23549,228,2022/4/15 5:50,6,6,0,
23550,228,2022/4/15 6:00,9,11,-2,
23551,228,2022/4/15 6:10,13,16,-3,
23552,228,2022/4/15 6:20,20,37,-17,
23553,228,2022/4/15 6:30,27,55,-28,
23554,228,2022/4/15 6:40,29,106,-77,
23555,228,2022/4/15 6:50,30,110,-80,
23556,228,2022/4/15 7:00,35,324,-289,
23557,228,2022/4/15 7:10,33,324,-291,
23558,228,2022/4/15 7:20,37,297,-260,
23559,228,2022/4/15 7:30,43,319,-276,
23560,228,2022/4/15 7:40,52,196,-144,
23561,228,2022/4/15 7:50,58,196,-138,
23562,228,2022/4/15 8:00,58,253,-195,
23563,228,2022/4/15 8:10,56,194,-138,
23564,228,2022/4/15 8:20,51,332,-281,
23565,228,2022/4/15 8:30,45,324,-279,
23566,228,2022/4/15 8:40,44,381,-337,
23567,228,2022/4/15 8:50,43,297,-254,
23568,228,2022/4/15 9:00,39,154,-115,
23569,228,2022/4/15 9:10,32,125,-93,
23570,228,2022/4/15 9:20,31,121,-90,
23571,228,2022/4/15 9:30,28,105,-77,
23572,228,2022/4/15 9:40,31,105,-74,
23573,228,2022/4/15 9:50,31,114,-83,
23574,228,2022/4/15 10:00,29,90,-61,
23575,228,2022/4/15 10:10,26,75,-49,
23576,228,2022/4/15 10:20,26,75,-49,
23577,228,2022/4/15 10:30,23,69,-46,
23578,228,2022/4/15 10:40,28,69,-41,
23579,228,2022/4/15 10:50,27,66,-39,
23580,228,2022/4/15 11:00,24,63,-39,
23581,228,2022/4/15 11:10,25,62,-37,
23582,228,2022/4/15 11:20,23,60,-37,
23583,228,2022/4/15 11:30,29,60,-31,
23584,228,2022/4/15 11:40,24,73,-49,
23585,228,2022/4/15 11:50,22,70,-48,
23586,228,2022/4/15 12:00,35,70,-35,
23587,228,2022/4/15 12:10,36,65,-29,
23588,228,2022/4/15 12:20,32,65,-33,
23589,228,2022/4/15 12:30,33,71,-38,
23590,228,2022/4/15 12:40,30,70,-40,
23591,228,2022/4/15 12:50,25,64,-39,
23592,228,2022/4/15 13:00,26,73,-47,
23593,228,2022/4/15 13:10,27,76,-49,
23594,228,2022/4/15 13:20,27,84,-57,
23595,228,2022/4/15 13:30,27,68,-41,
23596,228,2022/4/15 13:40,24,67,-43,
23597,228,2022/4/15 13:50,23,75,-52,
23598,228,2022/4/15 14:00,30,68,-38,
23599,228,2022/4/15 14:10,35,65,-30,
23600,228,2022/4/15 14:20,38,70,-32,
23601,228,2022/4/15 14:30,32,66,-34,
23602,228,2022/4/15 14:40,114,80,34,
23603,228,2022/4/15 14:50,124,70,54,
23604,228,2022/4/15 15:00,57,68,-11,
23605,228,2022/4/15 15:10,65,71,-6,
23606,228,2022/4/15 15:20,119,68,51,
23607,228,2022/4/15 15:30,132,69,63,
23608,228,2022/4/15 15:40,164,81,83,
23609,228,2022/4/15 15:50,172,70,102,
23610,228,2022/4/15 16:00,164,75,89,
23611,228,2022/4/15 16:10,190,77,113,
23612,228,2022/4/15 16:20,154,76,78,
23613,228,2022/4/15 16:30,174,70,104,
23614,228,2022/4/15 16:40,191,76,115,
23615,228,2022/4/15 16:50,174,74,100,
23616,228,2022/4/15 17:00,187,93,94,
23617,228,2022/4/15 17:10,243,91,152,
23618,228,2022/4/15 17:20,204,111,93,
23619,228,2022/4/15 17:30,244,105,139,
23620,228,2022/4/15 17:40,335,86,249,
23621,228,2022/4/15 17:50,264,103,161,
23622,228,2022/4/15 18:00,273,110,163,
23623,228,2022/4/15 18:10,294,109,185,
23624,228,2022/4/15 18:20,198,109,89,
23625,228,2022/4/15 18:30,149,105,44,
23626,228,2022/4/15 18:40,85,108,-23,
23627,228,2022/4/15 18:50,51,110,-59,
23628,228,2022/4/15 19:00,47,113,-66,
23629,228,2022/4/15 19:10,47,107,-60,
23630,228,2022/4/15 19:20,44,81,-37,
23631,228,2022/4/15 19:30,39,77,-38,
23632,228,2022/4/15 19:40,39,79,-40,
23633,228,2022/4/15 19:50,39,72,-33,
23634,228,2022/4/15 20:00,36,64,-28,
23635,228,2022/4/15 20:10,39,70,-31,
23636,228,2022/4/15 20:20,33,59,-26,
23637,228,2022/4/15 20:30,35,65,-30,
23638,228,2022/4/15 20:40,38,68,-30,
23639,228,2022/4/15 20:50,35,63,-28,
23640,228,2022/4/15 21:00,34,66,-32,
23641,228,2022/4/15 21:10,32,54,-22,
23642,228,2022/4/15 21:20,32,66,-34,
23643,228,2022/4/15 21:30,25,62,-37,
23644,228,2022/4/15 21:40,28,59,-31,
23645,228,2022/4/15 21:50,26,55,-29,
23646,228,2022/4/15 22:00,29,62,-33,
23647,228,2022/4/15 22:10,21,40,-19,
23648,228,2022/4/15 22:20,13,63,-50,
23649,228,2022/4/15 22:30,9,50,-41,
23650,228,2022/4/15 22:40,9,49,-40,
23651,228,2022/4/15 22:50,2,32,-30,
23652,221,2022/4/15 5:00,0,1,-1,
23653,221,2022/4/15 5:10,0,1,-1,
23654,221,2022/4/15 5:20,0,1,-1,
23655,221,2022/4/15 5:30,1,1,0,
23656,221,2022/4/15 5:40,8,1,7,
23657,221,2022/4/15 5:50,10,14,-4,
23658,221,2022/4/15 6:00,19,6,13,
23659,221,2022/4/15 6:10,20,23,-3,
23660,221,2022/4/15 6:20,25,47,-22,
23661,221,2022/4/15 6:30,32,40,-8,
23662,221,2022/4/15 6:40,43,55,-12,
23663,221,2022/4/15 6:50,46,63,-17,
23664,221,2022/4/15 7:00,46,77,-31,
23665,221,2022/4/15 7:10,54,92,-38,
23666,221,2022/4/15 7:20,58,101,-43,
23667,221,2022/4/15 7:30,86,125,-39,
23668,221,2022/4/15 7:40,128,145,-17,
23669,221,2022/4/15 7:50,185,284,-99,
23670,221,2022/4/15 8:00,188,497,-309,
23671,221,2022/4/15 8:10,188,581,-393,
23672,221,2022/4/15 8:20,224,1510,-1286,
23673,221,2022/4/15 8:30,193,2839,-2646,
23674,221,2022/4/15 8:40,126,3008,-2882,
23675,221,2022/4/15 8:50,85,3300,-3215,
23676,221,2022/4/15 9:00,70,638,-568,
23677,221,2022/4/15 9:10,51,422,-371,
23678,221,2022/4/15 9:20,47,326,-279,
23679,221,2022/4/15 9:30,40,282,-242,
23680,221,2022/4/15 9:40,29,231,-202,
23681,221,2022/4/15 9:50,33,132,-99,
23682,221,2022/4/15 10:00,31,102,-71,
23683,221,2022/4/15 10:10,29,99,-70,
23684,221,2022/4/15 10:20,33,80,-47,
23685,221,2022/4/15 10:30,30,93,-63,
23686,221,2022/4/15 10:40,33,83,-50,
23687,221,2022/4/15 10:50,28,83,-55,
23688,221,2022/4/15 11:00,32,67,-35,
23689,221,2022/4/15 11:10,30,80,-50,
23690,221,2022/4/15 11:20,27,61,-34,
23691,221,2022/4/15 11:30,31,83,-52,
23692,221,2022/4/15 11:40,37,64,-27,
23693,221,2022/4/15 11:50,37,67,-30,
23694,221,2022/4/15 12:00,39,75,-36,
23695,221,2022/4/15 12:10,35,70,-35,
23696,221,2022/4/15 12:20,35,73,-38,
23697,221,2022/4/15 12:30,39,83,-44,
23698,221,2022/4/15 12:40,37,90,-53,
23699,221,2022/4/15 12:50,37,81,-44,
23700,221,2022/4/15 13:00,37,75,-38,
23701,221,2022/4/15 13:10,37,83,-46,
23702,221,2022/4/15 13:20,32,76,-44,
23703,221,2022/4/15 13:30,31,93,-62,
23704,221,2022/4/15 13:40,35,75,-40,
23705,221,2022/4/15 13:50,31,77,-46,
23706,221,2022/4/15 14:00,32,71,-39,
23707,221,2022/4/15 14:10,33,76,-43,
23708,221,2022/4/15 14:20,31,83,-52,
23709,221,2022/4/15 14:30,37,81,-44,
23710,221,2022/4/15 14:40,38,71,-33,
23711,221,2022/4/15 14:50,31,66,-35,
23712,221,2022/4/15 15:00,36,74,-38,
23713,221,2022/4/15 15:10,43,68,-25,
23714,221,2022/4/15 15:20,42,71,-29,
23715,221,2022/4/15 15:30,47,68,-21,
23716,221,2022/4/15 15:40,35,77,-42,
23717,221,2022/4/15 15:50,37,74,-37,
23718,221,2022/4/15 16:00,42,82,-40,
23719,221,2022/4/15 16:10,54,65,-11,
23720,221,2022/4/15 16:20,41,78,-37,
23721,221,2022/4/15 16:30,56,93,-37,
23722,221,2022/4/15 16:40,90,73,17,
23723,221,2022/4/15 16:50,76,76,0,
23724,221,2022/4/15 17:00,269,96,173,
23725,221,2022/4/15 17:10,379,108,271,
23726,221,2022/4/15 17:20,314,104,210,
23727,221,2022/4/15 17:30,544,101,443,
23728,221,2022/4/15 17:40,845,126,719,
23729,221,2022/4/15 17:50,616,105,511,
23730,221,2022/4/15 18:00,713,127,586,
23731,221,2022/4/15 18:10,1568,125,1443,
23732,221,2022/4/15 18:20,1031,110,921,
23733,221,2022/4/15 18:30,697,121,576,
23734,221,2022/4/15 18:40,581,125,456,
23735,221,2022/4/15 18:50,353,108,245,
23736,221,2022/4/15 19:00,309,110,199,
23737,221,2022/4/15 19:10,272,104,168,
23738,221,2022/4/15 19:20,235,113,122,
23739,221,2022/4/15 19:30,186,80,106,
23740,221,2022/4/15 19:40,170,79,91,
23741,221,2022/4/15 19:50,116,77,39,
23742,221,2022/4/15 20:00,85,69,16,
23743,221,2022/4/15 20:10,151,63,88,
23744,221,2022/4/15 20:20,79,70,9,
23745,221,2022/4/15 20:30,84,69,15,
23746,221,2022/4/15 20:40,86,62,24,
23747,221,2022/4/15 20:50,68,75,-7,
23748,221,2022/4/15 21:00,69,69,0,
23749,221,2022/4/15 21:10,87,68,19,
23750,221,2022/4/15 21:20,60,74,-14,
23751,221,2022/4/15 21:30,44,67,-23,
23752,221,2022/4/15 21:40,35,63,-28,
23753,221,2022/4/15 21:50,29,67,-38,
23754,221,2022/4/15 22:00,44,68,-24,
23755,221,2022/4/15 22:10,33,62,-29,
23756,221,2022/4/15 22:20,25,69,-44,
23757,221,2022/4/15 22:30,18,45,-27,
23758,221,2022/4/15 22:40,16,55,-39,
23759,221,2022/4/15 22:50,7,25,-18,
23760,217,2022/4/15 5:00,0,1,-1,
23761,217,2022/4/15 5:10,0,1,-1,
23762,217,2022/4/15 5:20,0,1,-1,
23763,217,2022/4/15 5:30,4,1,3,
23764,217,2022/4/15 5:40,8,1,7,
23765,217,2022/4/15 5:50,13,2,11,
23766,217,2022/4/15 6:00,20,1,19,
23767,217,2022/4/15 6:10,26,19,7,
23768,217,2022/4/15 6:20,32,19,13,
23769,217,2022/4/15 6:30,31,31,0,
23770,217,2022/4/15 6:40,41,50,-9,
23771,217,2022/4/15 6:50,57,72,-15,
23772,217,2022/4/15 7:00,60,93,-33,
23773,217,2022/4/15 7:10,58,75,-17,
23774,217,2022/4/15 7:20,78,71,7,
23775,217,2022/4/15 7:30,108,70,38,
23776,217,2022/4/15 7:40,186,75,111,
23777,217,2022/4/15 7:50,226,75,151,
23778,217,2022/4/15 8:00,244,80,164,
23779,217,2022/4/15 8:10,269,98,171,
23780,217,2022/4/15 8:20,254,99,155,
23781,217,2022/4/15 8:30,244,112,132,
23782,217,2022/4/15 8:40,170,108,62,
23783,217,2022/4/15 8:50,108,104,4,
23784,217,2022/4/15 9:00,66,92,-26,
23785,217,2022/4/15 9:10,50,83,-33,
23786,217,2022/4/15 9:20,50,68,-18,
23787,217,2022/4/15 9:30,41,64,-23,
23788,217,2022/4/15 9:40,29,58,-29,
23789,217,2022/4/15 9:50,28,50,-22,
23790,217,2022/4/15 10:00,26,45,-19,
23791,217,2022/4/15 10:10,26,52,-26,
23792,217,2022/4/15 10:20,23,42,-19,
23793,217,2022/4/15 10:30,23,45,-22,
23794,217,2022/4/15 10:40,20,49,-29,
23795,217,2022/4/15 10:50,19,46,-27,
23796,217,2022/4/15 11:00,18,38,-20,
23797,217,2022/4/15 11:10,20,40,-20,
23798,217,2022/4/15 11:20,22,45,-23,
23799,217,2022/4/15 11:30,22,51,-29,
23800,217,2022/4/15 11:40,23,55,-32,
23801,217,2022/4/15 11:50,25,50,-25,
23802,217,2022/4/15 12:00,27,50,-23,
23803,217,2022/4/15 12:10,29,50,-21,
23804,217,2022/4/15 12:20,29,54,-25,
23805,217,2022/4/15 12:30,28,66,-38,
23806,217,2022/4/15 12:40,25,64,-39,
23807,217,2022/4/15 12:50,28,67,-39,
23808,217,2022/4/15 13:00,29,51,-22,
23809,217,2022/4/15 13:10,28,61,-33,
23810,217,2022/4/15 13:20,25,51,-26,
23811,217,2022/4/15 13:30,26,42,-16,
23812,217,2022/4/15 13:40,25,48,-23,
23813,217,2022/4/15 13:50,23,59,-36,
23814,217,2022/4/15 14:00,22,50,-28,
23815,217,2022/4/15 14:10,23,51,-28,
23816,217,2022/4/15 14:20,20,52,-32,
23817,217,2022/4/15 14:30,20,50,-30,
23818,217,2022/4/15 14:40,22,51,-29,
23819,217,2022/4/15 14:50,21,54,-33,
23820,217,2022/4/15 15:00,26,57,-31,
23821,217,2022/4/15 15:10,24,52,-28,
23822,217,2022/4/15 15:20,24,57,-33,
23823,217,2022/4/15 15:30,25,60,-35,
23824,217,2022/4/15 15:40,25,72,-47,
23825,217,2022/4/15 15:50,24,60,-36,
23826,217,2022/4/15 16:00,27,72,-45,
23827,217,2022/4/15 16:10,25,70,-45,
23828,217,2022/4/15 16:20,27,71,-44,
23829,217,2022/4/15 16:30,28,65,-37,
23830,217,2022/4/15 16:40,25,69,-44,
23831,217,2022/4/15 16:50,25,81,-56,
23832,217,2022/4/15 17:00,29,93,-64,
23833,217,2022/4/15 17:10,43,112,-69,
23834,217,2022/4/15 17:20,44,104,-60,
23835,217,2022/4/15 17:30,40,104,-64,
23836,217,2022/4/15 17:40,34,107,-73,
23837,217,2022/4/15 17:50,31,115,-84,
23838,217,2022/4/15 18:00,29,111,-82,
23839,217,2022/4/15 18:10,38,133,-95,
23840,217,2022/4/15 18:20,37,111,-74,
23841,217,2022/4/15 18:30,30,110,-80,
23842,217,2022/4/15 18:40,31,124,-93,
23843,217,2022/4/15 18:50,31,125,-94,
23844,217,2022/4/15 19:00,26,129,-103,
23845,217,2022/4/15 19:10,27,110,-83,
23846,217,2022/4/15 19:20,26,108,-82,
23847,217,2022/4/15 19:30,26,95,-69,
23848,217,2022/4/15 19:40,25,82,-57,
23849,217,2022/4/15 19:50,28,77,-49,
23850,217,2022/4/15 20:00,29,73,-44,
23851,217,2022/4/15 20:10,27,79,-52,
23852,217,2022/4/15 20:20,26,75,-49,
23853,217,2022/4/15 20:30,20,65,-45,
23854,217,2022/4/15 20:40,21,85,-64,
23855,217,2022/4/15 20:50,23,72,-49,
23856,217,2022/4/15 21:00,26,75,-49,
23857,217,2022/4/15 21:10,24,79,-55,
23858,217,2022/4/15 21:20,18,79,-61,
23859,217,2022/4/15 21:30,22,74,-52,
23860,217,2022/4/15 21:40,21,87,-66,
23861,217,2022/4/15 21:50,13,74,-61,
23862,217,2022/4/15 22:00,14,68,-54,
23863,217,2022/4/15 22:10,11,64,-53,
23864,217,2022/4/15 22:20,9,55,-46,
23865,217,2022/4/15 22:30,4,68,-64,
23866,217,2022/4/15 22:40,5,41,-36,
23867,217,2022/4/15 22:50,4,41,-37,
23868,222,2022/4/15 5:00,0,1,-1,
23869,222,2022/4/15 5:10,0,1,-1,
23870,222,2022/4/15 5:20,0,1,-1,
23871,222,2022/4/15 5:30,2,1,1,
23872,222,2022/4/15 5:40,6,5,1,
23873,222,2022/4/15 5:50,7,8,-1,
23874,222,2022/4/15 6:00,10,6,4,
23875,222,2022/4/15 6:10,15,46,-31,
23876,222,2022/4/15 6:20,25,29,-4,
23877,222,2022/4/15 6:30,32,50,-18,
23878,222,2022/4/15 6:40,38,48,-10,
23879,222,2022/4/15 6:50,37,75,-38,
23880,222,2022/4/15 7:00,57,93,-36,
23881,222,2022/4/15 7:10,58,101,-43,
23882,222,2022/4/15 7:20,84,109,-25,
23883,222,2022/4/15 7:30,87,121,-34,
23884,222,2022/4/15 7:40,180,104,76,
23885,222,2022/4/15 7:50,198,133,65,
23886,222,2022/4/15 8:00,189,111,78,
23887,222,2022/4/15 8:10,224,110,114,
23888,222,2022/4/15 8:20,186,124,62,
23889,222,2022/4/15 8:30,183,108,75,
23890,222,2022/4/15 8:40,156,108,48,
23891,222,2022/4/15 8:50,114,120,-6,
23892,222,2022/4/15 9:00,74,106,-32,
23893,222,2022/4/15 9:10,58,112,-54,
23894,222,2022/4/15 9:20,48,105,-57,
23895,222,2022/4/15 9:30,42,82,-40,
23896,222,2022/4/15 9:40,38,92,-54,
23897,222,2022/4/15 9:50,33,92,-59,
23898,222,2022/4/15 10:00,30,73,-43,
23899,222,2022/4/15 10:10,29,65,-36,
23900,222,2022/4/15 10:20,28,66,-38,
23901,222,2022/4/15 10:30,32,76,-44,
23902,222,2022/4/15 10:40,33,67,-34,
23903,222,2022/4/15 10:50,29,65,-36,
23904,222,2022/4/15 11:00,29,66,-37,
23905,222,2022/4/15 11:10,29,64,-35,
23906,222,2022/4/15 11:20,27,63,-36,
23907,222,2022/4/15 11:30,27,64,-37,
23908,222,2022/4/15 11:40,27,62,-35,
23909,222,2022/4/15 11:50,28,52,-24,
23910,222,2022/4/15 12:00,31,59,-28,
23911,222,2022/4/15 12:10,27,67,-40,
23912,222,2022/4/15 12:20,27,62,-35,
23913,222,2022/4/15 12:30,29,67,-38,
23914,222,2022/4/15 12:40,25,72,-47,
23915,222,2022/4/15 12:50,24,78,-54,
23916,222,2022/4/15 13:00,28,80,-52,
23917,222,2022/4/15 13:10,28,69,-41,
23918,222,2022/4/15 13:20,30,73,-43,
23919,222,2022/4/15 13:30,28,62,-34,
23920,222,2022/4/15 13:40,27,71,-44,
23921,222,2022/4/15 13:50,26,69,-43,
23922,222,2022/4/15 14:00,27,62,-35,
23923,222,2022/4/15 14:10,27,67,-40,
23924,222,2022/4/15 14:20,27,71,-44,
23925,222,2022/4/15 14:30,30,64,-34,
23926,222,2022/4/15 14:40,30,61,-31,
23927,222,2022/4/15 14:50,28,63,-35,
23928,222,2022/4/15 15:00,29,82,-53,
23929,222,2022/4/15 15:10,27,72,-45,
23930,222,2022/4/15 15:20,27,70,-43,
23931,222,2022/4/15 15:30,36,67,-31,
23932,222,2022/4/15 15:40,34,72,-38,
23933,222,2022/4/15 15:50,29,83,-54,
23934,222,2022/4/15 16:00,37,70,-33,
23935,222,2022/4/15 16:10,38,66,-28,
23936,222,2022/4/15 16:20,43,82,-39,
23937,222,2022/4/15 16:30,46,77,-31,
23938,222,2022/4/15 16:40,48,64,-16,
23939,222,2022/4/15 16:50,46,96,-50,
23940,222,2022/4/15 17:00,58,93,-35,
23941,222,2022/4/15 17:10,74,106,-32,
23942,222,2022/4/15 17:20,50,106,-56,
23943,222,2022/4/15 17:30,46,119,-73,
23944,222,2022/4/15 17:40,62,113,-51,
23945,222,2022/4/15 17:50,45,124,-79,
23946,222,2022/4/15 18:00,37,125,-88,
23947,222,2022/4/15 18:10,54,107,-53,
23948,222,2022/4/15 18:20,43,107,-64,
23949,222,2022/4/15 18:30,36,123,-87,
23950,222,2022/4/15 18:40,27,99,-72,
23951,222,2022/4/15 18:50,28,103,-75,
23952,222,2022/4/15 19:00,27,110,-83,
23953,222,2022/4/15 19:10,29,100,-71,
23954,222,2022/4/15 19:20,24,90,-66,
23955,222,2022/4/15 19:30,25,90,-65,
23956,222,2022/4/15 19:40,21,85,-64,
23957,222,2022/4/15 19:50,20,71,-51,
23958,222,2022/4/15 20:00,22,64,-42,
23959,222,2022/4/15 20:10,26,69,-43,
23960,222,2022/4/15 20:20,22,64,-42,
23961,222,2022/4/15 20:30,21,74,-53,
23962,222,2022/4/15 20:40,23,64,-41,
23963,222,2022/4/15 20:50,21,57,-36,
23964,222,2022/4/15 21:00,19,72,-53,
23965,222,2022/4/15 21:10,16,64,-48,
23966,222,2022/4/15 21:20,15,67,-52,
23967,222,2022/4/15 21:30,14,67,-53,
23968,222,2022/4/15 21:40,13,60,-47,
23969,222,2022/4/15 21:50,11,55,-44,
23970,222,2022/4/15 22:00,9,62,-53,
23971,222,2022/4/15 22:10,8,42,-34,
23972,222,2022/4/15 22:20,6,52,-46,
23973,222,2022/4/15 22:30,4,46,-42,
23974,222,2022/4/15 22:40,2,40,-38,
23975,222,2022/4/15 22:50,2,25,-23,
23976,218,2022/4/15 5:00,0,1,-1,
23977,218,2022/4/15 5:10,0,1,-1,
23978,218,2022/4/15 5:20,0,1,-1,
23979,218,2022/4/15 5:30,12,1,11,
23980,218,2022/4/15 5:40,13,6,7,
23981,218,2022/4/15 5:50,18,6,12,
23982,218,2022/4/15 6:00,22,8,14,
23983,218,2022/4/15 6:10,30,21,9,
23984,218,2022/4/15 6:20,38,22,16,
23985,218,2022/4/15 6:30,38,31,7,
23986,218,2022/4/15 6:40,61,60,1,
23987,218,2022/4/15 6:50,66,67,-1,
23988,218,2022/4/15 7:00,68,99,-31,
23989,218,2022/4/15 7:10,89,90,-1,
23990,218,2022/4/15 7:20,149,101,48,
23991,218,2022/4/15 7:30,199,125,74,
23992,218,2022/4/15 7:40,246,138,108,
23993,218,2022/4/15 7:50,282,192,90,
23994,218,2022/4/15 8:00,285,119,166,
23995,218,2022/4/15 8:10,317,137,180,
23996,218,2022/4/15 8:20,277,232,45,
23997,218,2022/4/15 8:30,280,297,-17,
23998,218,2022/4/15 8:40,238,383,-145,
23999,218,2022/4/15 8:50,181,317,-136,
24000,218,2022/4/15 9:00,86,180,-94,
24001,218,2022/4/15 9:10,52,144,-92,
24002,218,2022/4/15 9:20,51,126,-75,
24003,218,2022/4/15 9:30,37,112,-75,
24004,218,2022/4/15 9:40,25,87,-62,
24005,218,2022/4/15 9:50,33,71,-38,
24006,218,2022/4/15 10:00,28,72,-44,
24007,218,2022/4/15 10:10,28,71,-43,
24008,218,2022/4/15 10:20,27,59,-32,
24009,218,2022/4/15 10:30,26,59,-33,
24010,218,2022/4/15 10:40,24,59,-35,
24011,218,2022/4/15 10:50,26,64,-38,
24012,218,2022/4/15 11:00,25,67,-42,
24013,218,2022/4/15 11:10,27,48,-21,
24014,218,2022/4/15 11:20,26,63,-37,
24015,218,2022/4/15 11:30,25,51,-26,
24016,218,2022/4/15 11:40,29,62,-33,
24017,218,2022/4/15 11:50,28,62,-34,
24018,218,2022/4/15 12:00,29,55,-26,
24019,218,2022/4/15 12:10,27,58,-31,
24020,218,2022/4/15 12:20,28,63,-35,
24021,218,2022/4/15 12:30,29,62,-33,
24022,218,2022/4/15 12:40,26,69,-43,
24023,218,2022/4/15 12:50,26,75,-49,
24024,218,2022/4/15 13:00,25,73,-48,
24025,218,2022/4/15 13:10,22,71,-49,
24026,218,2022/4/15 13:20,26,72,-46,
24027,218,2022/4/15 13:30,27,69,-42,
24028,218,2022/4/15 13:40,28,65,-37,
24029,218,2022/4/15 13:50,25,62,-37,
24030,218,2022/4/15 14:00,27,67,-40,
24031,218,2022/4/15 14:10,29,61,-32,
24032,218,2022/4/15 14:20,24,61,-37,
24033,218,2022/4/15 14:30,27,64,-37,
24034,218,2022/4/15 14:40,26,72,-46,
24035,218,2022/4/15 14:50,26,71,-45,
24036,218,2022/4/15 15:00,28,66,-38,
24037,218,2022/4/15 15:10,27,64,-37,
24038,218,2022/4/15 15:20,28,65,-37,
24039,218,2022/4/15 15:30,30,77,-47,
24040,218,2022/4/15 15:40,26,73,-47,
24041,218,2022/4/15 15:50,27,62,-35,
24042,218,2022/4/15 16:00,27,71,-44,
24043,218,2022/4/15 16:10,30,77,-47,
24044,218,2022/4/15 16:20,28,70,-42,
24045,218,2022/4/15 16:30,30,96,-66,
24046,218,2022/4/15 16:40,37,77,-40,
24047,218,2022/4/15 16:50,29,104,-75,
24048,218,2022/4/15 17:00,220,109,111,
24049,218,2022/4/15 17:10,268,109,159,
24050,218,2022/4/15 17:20,137,102,35,
24051,218,2022/4/15 17:30,274,117,157,
24052,218,2022/4/15 17:40,265,116,149,
24053,218,2022/4/15 17:50,143,123,20,
24054,218,2022/4/15 18:00,168,109,59,
24055,218,2022/4/15 18:10,206,137,69,
24056,218,2022/4/15 18:20,137,145,-8,
24057,218,2022/4/15 18:30,85,152,-67,
24058,218,2022/4/15 18:40,72,121,-49,
24059,218,2022/4/15 18:50,39,118,-79,
24060,218,2022/4/15 19:00,38,111,-73,
24061,218,2022/4/15 19:10,39,122,-83,
24062,218,2022/4/15 19:20,34,89,-55,
24063,218,2022/4/15 19:30,28,102,-74,
24064,218,2022/4/15 19:40,30,92,-62,
24065,218,2022/4/15 19:50,26,92,-66,
24066,218,2022/4/15 20:00,28,77,-49,
24067,218,2022/4/15 20:10,27,78,-51,
24068,218,2022/4/15 20:20,29,69,-40,
24069,218,2022/4/15 20:30,29,77,-48,
24070,218,2022/4/15 20:40,37,76,-39,
24071,218,2022/4/15 20:50,31,79,-48,
24072,218,2022/4/15 21:00,25,72,-47,
24073,218,2022/4/15 21:10,35,79,-44,
24074,218,2022/4/15 21:20,33,83,-50,
24075,218,2022/4/15 21:30,38,72,-34,
24076,218,2022/4/15 21:40,28,77,-49,
24077,218,2022/4/15 21:50,22,77,-55,
24078,218,2022/4/15 22:00,21,74,-53,
24079,218,2022/4/15 22:10,18,71,-53,
24080,218,2022/4/15 22:20,12,75,-63,
24081,218,2022/4/15 22:30,7,59,-52,
24082,218,2022/4/15 22:40,2,68,-66,
24083,218,2022/4/15 22:50,2,29,-27,
24084,211,2022/4/15 5:00,0,1,-1,
24085,211,2022/4/15 5:10,0,1,-1,
24086,211,2022/4/15 5:20,6,1,5,
24087,211,2022/4/15 5:30,15,1,14,
24088,211,2022/4/15 5:40,10,2,8,
24089,211,2022/4/15 5:50,16,1,15,
24090,211,2022/4/15 6:00,24,2,22,
24091,211,2022/4/15 6:10,35,2,33,
24092,211,2022/4/15 6:20,47,32,15,
24093,211,2022/4/15 6:30,57,24,33,
24094,211,2022/4/15 6:40,70,49,21,
24095,211,2022/4/15 6:50,88,74,14,
24096,211,2022/4/15 7:00,163,104,59,
24097,211,2022/4/15 7:10,177,122,55,
24098,211,2022/4/15 7:20,213,126,87,
24099,211,2022/4/15 7:30,282,119,163,
24100,211,2022/4/15 7:40,348,91,257,
24101,211,2022/4/15 7:50,444,98,346,
24102,211,2022/4/15 8:00,468,105,363,
24103,211,2022/4/15 8:10,572,104,468,
24104,211,2022/4/15 8:20,390,151,239,
24105,211,2022/4/15 8:30,318,326,-8,
24106,211,2022/4/15 8:40,282,321,-39,
24107,211,2022/4/15 8:50,231,324,-93,
24108,211,2022/4/15 9:00,148,213,-65,
24109,211,2022/4/15 9:10,86,128,-42,
24110,211,2022/4/15 9:20,67,106,-39,
24111,211,2022/4/15 9:30,49,109,-60,
24112,211,2022/4/15 9:40,37,97,-60,
24113,211,2022/4/15 9:50,31,83,-52,
24114,211,2022/4/15 10:00,32,70,-38,
24115,211,2022/4/15 10:10,28,65,-37,
24116,211,2022/4/15 10:20,29,60,-31,
24117,211,2022/4/15 10:30,29,54,-25,
24118,211,2022/4/15 10:40,27,55,-28,
24119,211,2022/4/15 10:50,26,50,-24,
24120,211,2022/4/15 11:00,27,55,-28,
24121,211,2022/4/15 11:10,24,54,-30,
24122,211,2022/4/15 11:20,29,51,-22,
24123,211,2022/4/15 11:30,28,51,-23,
24124,211,2022/4/15 11:40,29,54,-25,
24125,211,2022/4/15 11:50,28,54,-26,
24126,211,2022/4/15 12:00,29,61,-32,
24127,211,2022/4/15 12:10,27,60,-33,
24128,211,2022/4/15 12:20,29,60,-31,
24129,211,2022/4/15 12:30,29,60,-31,
24130,211,2022/4/15 12:40,23,70,-47,
24131,211,2022/4/15 12:50,25,68,-43,
24132,211,2022/4/15 13:00,28,64,-36,
24133,211,2022/4/15 13:10,25,68,-43,
24134,211,2022/4/15 13:20,28,69,-41,
24135,211,2022/4/15 13:30,29,61,-32,
24136,211,2022/4/15 13:40,26,61,-35,
24137,211,2022/4/15 13:50,28,67,-39,
24138,211,2022/4/15 14:00,28,61,-33,
24139,211,2022/4/15 14:10,23,65,-42,
24140,211,2022/4/15 14:20,28,59,-31,
24141,211,2022/4/15 14:30,28,62,-34,
24142,211,2022/4/15 14:40,28,71,-43,
24143,211,2022/4/15 14:50,27,67,-40,
24144,211,2022/4/15 15:00,27,70,-43,
24145,211,2022/4/15 15:10,29,68,-39,
24146,211,2022/4/15 15:20,29,68,-39,
24147,211,2022/4/15 15:30,25,76,-51,
24148,211,2022/4/15 15:40,26,74,-48,
24149,211,2022/4/15 15:50,28,78,-50,
24150,211,2022/4/15 16:00,32,77,-45,
24151,211,2022/4/15 16:10,32,77,-45,
24152,211,2022/4/15 16:20,39,93,-54,
24153,211,2022/4/15 16:30,61,92,-31,
24154,211,2022/4/15 16:40,85,96,-11,
24155,211,2022/4/15 16:50,177,105,72,
24156,211,2022/4/15 17:00,207,109,98,
24157,211,2022/4/15 17:10,198,115,83,
24158,211,2022/4/15 17:20,106,110,-4,
24159,211,2022/4/15 17:30,77,118,-41,
24160,211,2022/4/15 17:40,213,127,86,
24161,211,2022/4/15 17:50,77,177,-100,
24162,211,2022/4/15 18:00,98,152,-54,
24163,211,2022/4/15 18:10,275,226,49,
24164,211,2022/4/15 18:20,174,158,16,
24165,211,2022/4/15 18:30,77,224,-147,
24166,211,2022/4/15 18:40,136,224,-88,
24167,211,2022/4/15 18:50,72,171,-99,
24168,211,2022/4/15 19:00,44,119,-75,
24169,211,2022/4/15 19:10,37,122,-85,
24170,211,2022/4/15 19:20,35,88,-53,
24171,211,2022/4/15 19:30,29,110,-81,
24172,211,2022/4/15 19:40,24,110,-86,
24173,211,2022/4/15 19:50,23,92,-69,
24174,211,2022/4/15 20:00,29,78,-49,
24175,211,2022/4/15 20:10,35,95,-60,
24176,211,2022/4/15 20:20,25,82,-57,
24177,211,2022/4/15 20:30,28,82,-54,
24178,211,2022/4/15 20:40,28,90,-62,
24179,211,2022/4/15 20:50,25,88,-63,
24180,211,2022/4/15 21:00,26,76,-50,
24181,211,2022/4/15 21:10,32,94,-62,
24182,211,2022/4/15 21:20,29,79,-50,
24183,211,2022/4/15 21:30,28,83,-55,
24184,211,2022/4/15 21:40,28,78,-50,
24185,211,2022/4/15 21:50,28,76,-48,
24186,211,2022/4/15 22:00,17,68,-51,
24187,211,2022/4/15 22:10,21,83,-62,
24188,211,2022/4/15 22:20,13,75,-62,
24189,211,2022/4/15 22:30,11,67,-56,
24190,211,2022/4/15 22:40,4,62,-58,
24191,211,2022/4/15 22:50,2,59,-57,
24192,209,2022/4/15 5:00,0,1,-1,
24193,209,2022/4/15 5:10,0,1,-1,
24194,209,2022/4/15 5:20,5,1,4,
24195,209,2022/4/15 5:30,13,1,12,
24196,209,2022/4/15 5:40,14,1,13,
24197,209,2022/4/15 5:50,20,1,19,
24198,209,2022/4/15 6:00,26,1,25,
24199,209,2022/4/15 6:10,32,1,31,
24200,209,2022/4/15 6:20,39,19,20,
24201,209,2022/4/15 6:30,59,33,26,
24202,209,2022/4/15 6:40,81,31,50,
24203,209,2022/4/15 6:50,81,41,40,
24204,209,2022/4/15 7:00,150,48,102,
24205,209,2022/4/15 7:10,187,55,132,
24206,209,2022/4/15 7:20,231,50,181,
24207,209,2022/4/15 7:30,275,60,215,
24208,209,2022/4/15 7:40,336,63,273,
24209,209,2022/4/15 7:50,360,79,281,
24210,209,2022/4/15 8:00,375,77,298,
24211,209,2022/4/15 8:10,474,76,398,
24212,209,2022/4/15 8:20,392,90,302,
24213,209,2022/4/15 8:30,326,113,213,
24214,209,2022/4/15 8:40,243,103,140,
24215,209,2022/4/15 8:50,195,105,90,
24216,209,2022/4/15 9:00,139,75,64,
24217,209,2022/4/15 9:10,86,72,14,
24218,209,2022/4/15 9:20,64,50,14,
24219,209,2022/4/15 9:30,44,69,-25,
24220,209,2022/4/15 9:40,38,60,-22,
24221,209,2022/4/15 9:50,29,52,-23,
24222,209,2022/4/15 10:00,31,49,-18,
24223,209,2022/4/15 10:10,27,52,-25,
24224,209,2022/4/15 10:20,28,65,-37,
24225,209,2022/4/15 10:30,29,48,-19,
24226,209,2022/4/15 10:40,28,48,-20,
24227,209,2022/4/15 10:50,24,51,-27,
24228,209,2022/4/15 11:00,25,57,-32,
24229,209,2022/4/15 11:10,24,50,-26,
24230,209,2022/4/15 11:20,25,45,-20,
24231,209,2022/4/15 11:30,23,47,-24,
24232,209,2022/4/15 11:40,24,52,-28,
24233,209,2022/4/15 11:50,27,53,-26,
24234,209,2022/4/15 12:00,26,51,-25,
24235,209,2022/4/15 12:10,28,50,-22,
24236,209,2022/4/15 12:20,31,50,-19,
24237,209,2022/4/15 12:30,28,55,-27,
24238,209,2022/4/15 12:40,25,60,-35,
24239,209,2022/4/15 12:50,27,51,-24,
24240,209,2022/4/15 13:00,26,51,-25,
24241,209,2022/4/15 13:10,27,57,-30,
24242,209,2022/4/15 13:20,29,60,-31,
24243,209,2022/4/15 13:30,27,50,-23,
24244,209,2022/4/15 13:40,22,49,-27,
24245,209,2022/4/15 13:50,22,57,-35,
24246,209,2022/4/15 14:00,24,67,-43,
24247,209,2022/4/15 14:10,27,60,-33,
24248,209,2022/4/15 14:20,22,57,-35,
24249,209,2022/4/15 14:30,22,61,-39,
24250,209,2022/4/15 14:40,23,62,-39,
24251,209,2022/4/15 14:50,22,69,-47,
24252,209,2022/4/15 15:00,22,58,-36,
24253,209,2022/4/15 15:10,28,64,-36,
24254,209,2022/4/15 15:20,25,67,-42,
24255,209,2022/4/15 15:30,25,75,-50,
24256,209,2022/4/15 15:40,27,78,-51,
24257,209,2022/4/15 15:50,25,76,-51,
24258,209,2022/4/15 16:00,28,72,-44,
24259,209,2022/4/15 16:10,26,79,-53,
24260,209,2022/4/15 16:20,29,75,-46,
24261,209,2022/4/15 16:30,28,76,-48,
24262,209,2022/4/15 16:40,28,98,-70,
24263,209,2022/4/15 16:50,30,96,-66,
24264,209,2022/4/15 17:00,43,106,-63,
24265,209,2022/4/15 17:10,48,100,-52,
24266,209,2022/4/15 17:20,31,106,-75,
24267,209,2022/4/15 17:30,31,110,-79,
24268,209,2022/4/15 17:40,36,118,-82,
24269,209,2022/4/15 17:50,32,151,-119,
24270,209,2022/4/15 18:00,25,144,-119,
24271,209,2022/4/15 18:10,32,181,-149,
24272,209,2022/4/15 18:20,27,227,-200,
24273,209,2022/4/15 18:30,26,153,-127,
24274,209,2022/4/15 18:40,23,180,-157,
24275,209,2022/4/15 18:50,22,184,-162,
24276,209,2022/4/15 19:00,20,107,-87,
24277,209,2022/4/15 19:10,17,104,-87,
24278,209,2022/4/15 19:20,15,109,-94,
24279,209,2022/4/15 19:30,15,114,-99,
24280,209,2022/4/15 19:40,17,106,-89,
24281,209,2022/4/15 19:50,16,94,-78,
24282,209,2022/4/15 20:00,14,89,-75,
24283,209,2022/4/15 20:10,14,93,-79,
24284,209,2022/4/15 20:20,15,86,-71,
24285,209,2022/4/15 20:30,14,84,-70,
24286,209,2022/4/15 20:40,16,92,-76,
24287,209,2022/4/15 20:50,14,79,-65,
24288,209,2022/4/15 21:00,14,77,-63,
24289,209,2022/4/15 21:10,15,89,-74,
24290,209,2022/4/15 21:20,10,80,-70,
24291,209,2022/4/15 21:30,11,79,-68,
24292,209,2022/4/15 21:40,12,79,-67,
24293,209,2022/4/15 21:50,9,76,-67,
24294,209,2022/4/15 22:00,10,72,-62,
24295,209,2022/4/15 22:10,7,74,-67,
24296,209,2022/4/15 22:20,4,70,-66,
24297,209,2022/4/15 22:30,2,64,-62,
24298,209,2022/4/15 22:40,0,71,-71,
24299,209,2022/4/15 22:50,0,51,-51,
24300,212,2022/4/15 5:00,0,1,-1,
24301,212,2022/4/15 5:10,0,1,-1,
24302,212,2022/4/15 5:20,4,1,3,
24303,212,2022/4/15 5:30,14,1,13,
24304,212,2022/4/15 5:40,16,1,15,
24305,212,2022/4/15 5:50,18,1,17,
24306,212,2022/4/15 6:00,23,1,22,
24307,212,2022/4/15 6:10,31,1,30,
24308,212,2022/4/15 6:20,41,21,20,
24309,212,2022/4/15 6:30,58,16,42,
24310,212,2022/4/15 6:40,78,23,55,
24311,212,2022/4/15 6:50,124,23,101,
24312,212,2022/4/15 7:00,163,23,140,
24313,212,2022/4/15 7:10,222,38,184,
24314,212,2022/4/15 7:20,267,48,219,
24315,212,2022/4/15 7:30,346,55,291,
24316,212,2022/4/15 7:40,598,66,532,
24317,212,2022/4/15 7:50,590,69,521,
24318,212,2022/4/15 8:00,716,69,647,
24319,212,2022/4/15 8:10,688,82,606,
24320,212,2022/4/15 8:20,721,79,642,
24321,212,2022/4/15 8:30,474,90,384,
24322,212,2022/4/15 8:40,347,96,251,
24323,212,2022/4/15 8:50,245,86,159,
24324,212,2022/4/15 9:00,191,76,115,
24325,212,2022/4/15 9:10,116,83,33,
24326,212,2022/4/15 9:20,60,65,-5,
24327,212,2022/4/15 9:30,43,66,-23,
24328,212,2022/4/15 9:40,37,62,-25,
24329,212,2022/4/15 9:50,27,66,-39,
24330,212,2022/4/15 10:00,33,67,-34,
24331,212,2022/4/15 10:10,27,54,-27,
24332,212,2022/4/15 10:20,29,51,-22,
24333,212,2022/4/15 10:30,25,54,-29,
24334,212,2022/4/15 10:40,28,50,-22,
24335,212,2022/4/15 10:50,25,58,-33,
24336,212,2022/4/15 11:00,21,52,-31,
24337,212,2022/4/15 11:10,28,54,-26,
24338,212,2022/4/15 11:20,27,52,-25,
24339,212,2022/4/15 11:30,23,51,-28,
24340,212,2022/4/15 11:40,24,55,-31,
24341,212,2022/4/15 11:50,27,48,-21,
24342,212,2022/4/15 12:00,28,50,-22,
24343,212,2022/4/15 12:10,27,49,-22,
24344,212,2022/4/15 12:20,27,53,-26,
24345,212,2022/4/15 12:30,28,57,-29,
24346,212,2022/4/15 12:40,27,65,-38,
24347,212,2022/4/15 12:50,28,48,-20,
24348,212,2022/4/15 13:00,27,61,-34,
24349,212,2022/4/15 13:10,26,61,-35,
24350,212,2022/4/15 13:20,27,52,-25,
24351,212,2022/4/15 13:30,22,52,-30,
24352,212,2022/4/15 13:40,26,54,-28,
24353,212,2022/4/15 13:50,23,64,-41,
24354,212,2022/4/15 14:00,21,54,-33,
24355,212,2022/4/15 14:10,26,67,-41,
24356,212,2022/4/15 14:20,23,62,-39,
24357,212,2022/4/15 14:30,22,63,-41,
24358,212,2022/4/15 14:40,21,69,-48,
24359,212,2022/4/15 14:50,22,61,-39,
24360,212,2022/4/15 15:00,21,65,-44,
24361,212,2022/4/15 15:10,24,67,-43,
24362,212,2022/4/15 15:20,23,71,-48,
24363,212,2022/4/15 15:30,22,65,-43,
24364,212,2022/4/15 15:40,22,77,-55,
24365,212,2022/4/15 15:50,23,77,-54,
24366,212,2022/4/15 16:00,24,91,-67,
24367,212,2022/4/15 16:10,24,76,-52,
24368,212,2022/4/15 16:20,27,69,-42,
24369,212,2022/4/15 16:30,24,74,-50,
24370,212,2022/4/15 16:40,27,114,-87,
24371,212,2022/4/15 16:50,30,92,-62,
24372,212,2022/4/15 17:00,34,120,-86,
24373,212,2022/4/15 17:10,37,101,-64,
24374,212,2022/4/15 17:20,31,107,-76,
24375,212,2022/4/15 17:30,34,110,-76,
24376,212,2022/4/15 17:40,45,149,-104,
24377,212,2022/4/15 17:50,31,152,-121,
24378,212,2022/4/15 18:00,29,226,-197,
24379,212,2022/4/15 18:10,33,232,-199,
24380,212,2022/4/15 18:20,31,218,-187,
24381,212,2022/4/15 18:30,28,232,-204,
24382,212,2022/4/15 18:40,28,285,-257,
24383,212,2022/4/15 18:50,23,233,-210,
24384,212,2022/4/15 19:00,22,191,-169,
24385,212,2022/4/15 19:10,20,145,-125,
24386,212,2022/4/15 19:20,20,109,-89,
24387,212,2022/4/15 19:30,18,123,-105,
24388,212,2022/4/15 19:40,17,125,-108,
24389,212,2022/4/15 19:50,17,114,-97,
24390,212,2022/4/15 20:00,18,106,-88,
24391,212,2022/4/15 20:10,17,104,-87,
24392,212,2022/4/15 20:20,14,93,-79,
24393,212,2022/4/15 20:30,17,78,-61,
24394,212,2022/4/15 20:40,18,104,-86,
24395,212,2022/4/15 20:50,16,95,-79,
24396,212,2022/4/15 21:00,11,83,-72,
24397,212,2022/4/15 21:10,15,108,-93,
24398,212,2022/4/15 21:20,15,93,-78,
24399,212,2022/4/15 21:30,10,89,-79,
24400,212,2022/4/15 21:40,10,97,-87,
24401,212,2022/4/15 21:50,8,78,-70,
24402,212,2022/4/15 22:00,10,78,-68,
24403,212,2022/4/15 22:10,8,78,-70,
24404,212,2022/4/15 22:20,6,67,-61,
24405,212,2022/4/15 22:30,4,86,-82,
24406,212,2022/4/15 22:40,1,64,-63,
24407,212,2022/4/15 22:50,0,53,-53,
24408,214,2022/4/15 5:00,0,1,-1,
24409,214,2022/4/15 5:10,1,1,0,
24410,214,2022/4/15 5:20,5,1,4,
24411,214,2022/4/15 5:30,10,1,9,
24412,214,2022/4/15 5:40,7,1,6,
24413,214,2022/4/15 5:50,13,1,12,
24414,214,2022/4/15 6:00,18,1,17,
24415,214,2022/4/15 6:10,24,1,23,
24416,214,2022/4/15 6:20,37,19,18,
24417,214,2022/4/15 6:30,48,23,25,
24418,214,2022/4/15 6:40,68,29,39,
24419,214,2022/4/15 6:50,58,49,9,
24420,214,2022/4/15 7:00,81,51,30,
24421,214,2022/4/15 7:10,152,73,79,
24422,214,2022/4/15 7:20,162,81,81,
24423,214,2022/4/15 7:30,206,106,100,
24424,214,2022/4/15 7:40,188,105,83,
24425,214,2022/4/15 7:50,279,105,174,
24426,214,2022/4/15 8:00,345,71,274,
24427,214,2022/4/15 8:10,271,76,195,
24428,214,2022/4/15 8:20,241,72,169,
24429,214,2022/4/15 8:30,267,73,194,
24430,214,2022/4/15 8:40,186,69,117,
24431,214,2022/4/15 8:50,93,72,21,
24432,214,2022/4/15 9:00,62,56,6,
24433,214,2022/4/15 9:10,48,71,-23,
24434,214,2022/4/15 9:20,44,51,-7,
24435,214,2022/4/15 9:30,31,60,-29,
24436,214,2022/4/15 9:40,33,45,-12,
24437,214,2022/4/15 9:50,27,47,-20,
24438,214,2022/4/15 10:00,28,44,-16,
24439,214,2022/4/15 10:10,25,44,-19,
24440,214,2022/4/15 10:20,23,42,-19,
24441,214,2022/4/15 10:30,24,41,-17,
24442,214,2022/4/15 10:40,20,50,-30,
24443,214,2022/4/15 10:50,23,45,-22,
24444,214,2022/4/15 11:00,24,42,-18,
24445,214,2022/4/15 11:10,22,32,-10,
24446,214,2022/4/15 11:20,20,33,-13,
24447,214,2022/4/15 11:30,20,37,-17,
24448,214,2022/4/15 11:40,22,37,-15,
24449,214,2022/4/15 11:50,20,46,-26,
24450,214,2022/4/15 12:00,20,41,-21,
24451,214,2022/4/15 12:10,22,54,-32,
24452,214,2022/4/15 12:20,23,45,-22,
24453,214,2022/4/15 12:30,24,44,-20,
24454,214,2022/4/15 12:40,20,47,-27,
24455,214,2022/4/15 12:50,22,51,-29,
24456,214,2022/4/15 13:00,19,48,-29,
24457,214,2022/4/15 13:10,22,46,-24,
24458,214,2022/4/15 13:20,18,45,-27,
24459,214,2022/4/15 13:30,24,56,-32,
24460,214,2022/4/15 13:40,16,65,-49,
24461,214,2022/4/15 13:50,20,53,-33,
24462,214,2022/4/15 14:00,17,49,-32,
24463,214,2022/4/15 14:10,21,48,-27,
24464,214,2022/4/15 14:20,18,51,-33,
24465,214,2022/4/15 14:30,21,47,-26,
24466,214,2022/4/15 14:40,20,52,-32,
24467,214,2022/4/15 14:50,25,50,-25,
24468,214,2022/4/15 15:00,25,59,-34,
24469,214,2022/4/15 15:10,26,63,-37,
24470,214,2022/4/15 15:20,19,57,-38,
24471,214,2022/4/15 15:30,26,62,-36,
24472,214,2022/4/15 15:40,20,60,-40,
24473,214,2022/4/15 15:50,21,64,-43,
24474,214,2022/4/15 16:00,29,60,-31,
24475,214,2022/4/15 16:10,30,69,-39,
24476,214,2022/4/15 16:20,28,93,-65,
24477,214,2022/4/15 16:30,30,85,-55,
24478,214,2022/4/15 16:40,28,75,-47,
24479,214,2022/4/15 16:50,25,84,-59,
24480,214,2022/4/15 17:00,32,75,-43,
24481,214,2022/4/15 17:10,27,105,-78,
24482,214,2022/4/15 17:20,26,103,-77,
24483,214,2022/4/15 17:30,28,105,-77,
24484,214,2022/4/15 17:40,29,122,-93,
24485,214,2022/4/15 17:50,24,123,-99,
24486,214,2022/4/15 18:00,25,124,-99,
24487,214,2022/4/15 18:10,25,142,-117,
24488,214,2022/4/15 18:20,24,192,-168,
24489,214,2022/4/15 18:30,18,107,-89,
24490,214,2022/4/15 18:40,15,122,-107,
24491,214,2022/4/15 18:50,15,114,-99,
24492,214,2022/4/15 19:00,14,110,-96,
24493,214,2022/4/15 19:10,12,111,-99,
24494,214,2022/4/15 19:20,13,92,-79,
24495,214,2022/4/15 19:30,12,102,-90,
24496,214,2022/4/15 19:40,12,94,-82,
24497,214,2022/4/15 19:50,8,66,-58,
24498,214,2022/4/15 20:00,12,69,-57,
24499,214,2022/4/15 20:10,11,59,-48,
24500,214,2022/4/15 20:20,10,53,-43,
24501,214,2022/4/15 20:30,9,63,-54,
24502,214,2022/4/15 20:40,11,61,-50,
24503,214,2022/4/15 20:50,10,75,-65,
24504,214,2022/4/15 21:00,9,62,-53,
24505,214,2022/4/15 21:10,9,63,-54,
24506,214,2022/4/15 21:20,5,56,-51,
24507,214,2022/4/15 21:30,5,53,-48,
24508,214,2022/4/15 21:40,4,53,-49,
24509,214,2022/4/15 21:50,4,55,-51,
24510,214,2022/4/15 22:00,4,49,-45,
24511,214,2022/4/15 22:10,2,41,-39,
24512,214,2022/4/15 22:20,2,53,-51,
24513,214,2022/4/15 22:30,1,40,-39,
24514,214,2022/4/15 22:40,0,46,-46,
24515,214,2022/4/15 22:50,0,40,-40,
24516,223,2022/4/15 5:00,0,1,-1,
24517,223,2022/4/15 5:10,2,1,1,
24518,223,2022/4/15 5:20,11,1,10,
24519,223,2022/4/15 5:30,12,1,11,
24520,223,2022/4/15 5:40,13,1,12,
24521,223,2022/4/15 5:50,19,1,18,
24522,223,2022/4/15 6:00,24,1,23,
24523,223,2022/4/15 6:10,32,2,30,
24524,223,2022/4/15 6:20,53,6,47,
24525,223,2022/4/15 6:30,63,38,25,
24526,223,2022/4/15 6:40,77,45,32,
24527,223,2022/4/15 6:50,85,41,44,
24528,223,2022/4/15 7:00,170,49,121,
24529,223,2022/4/15 7:10,174,67,107,
24530,223,2022/4/15 7:20,185,65,120,
24531,223,2022/4/15 7:30,256,71,185,
24532,223,2022/4/15 7:40,278,91,187,
24533,223,2022/4/15 7:50,349,73,276,
24534,223,2022/4/15 8:00,345,69,276,
24535,223,2022/4/15 8:10,475,87,388,
24536,223,2022/4/15 8:20,357,75,282,
24537,223,2022/4/15 8:30,280,65,215,
24538,223,2022/4/15 8:40,215,83,132,
24539,223,2022/4/15 8:50,152,67,85,
24540,223,2022/4/15 9:00,75,50,25,
24541,223,2022/4/15 9:10,57,65,-8,
24542,223,2022/4/15 9:20,45,45,0,
24543,223,2022/4/15 9:30,34,49,-15,
24544,223,2022/4/15 9:40,31,46,-15,
24545,223,2022/4/15 9:50,30,45,-15,
24546,223,2022/4/15 10:00,30,46,-16,
24547,223,2022/4/15 10:10,29,47,-18,
24548,223,2022/4/15 10:20,25,49,-24,
24549,223,2022/4/15 10:30,25,46,-21,
24550,223,2022/4/15 10:40,22,48,-26,
24551,223,2022/4/15 10:50,22,57,-35,
24552,223,2022/4/15 11:00,23,45,-22,
24553,223,2022/4/15 11:10,23,45,-22,
24554,223,2022/4/15 11:20,22,47,-25,
24555,223,2022/4/15 11:30,19,38,-19,
24556,223,2022/4/15 11:40,24,45,-21,
24557,223,2022/4/15 11:50,25,51,-26,
24558,223,2022/4/15 12:00,29,47,-18,
24559,223,2022/4/15 12:10,29,51,-22,
24560,223,2022/4/15 12:20,28,62,-34,
24561,223,2022/4/15 12:30,29,48,-19,
24562,223,2022/4/15 12:40,28,46,-18,
24563,223,2022/4/15 12:50,26,48,-22,
24564,223,2022/4/15 13:00,24,42,-18,
24565,223,2022/4/15 13:10,24,48,-24,
24566,223,2022/4/15 13:20,23,49,-26,
24567,223,2022/4/15 13:30,24,47,-23,
24568,223,2022/4/15 13:40,23,45,-22,
24569,223,2022/4/15 13:50,22,56,-34,
24570,223,2022/4/15 14:00,20,52,-32,
24571,223,2022/4/15 14:10,20,50,-30,
24572,223,2022/4/15 14:20,20,47,-27,
24573,223,2022/4/15 14:30,23,48,-25,
24574,223,2022/4/15 14:40,19,54,-35,
24575,223,2022/4/15 14:50,23,51,-28,
24576,223,2022/4/15 15:00,23,59,-36,
24577,223,2022/4/15 15:10,21,64,-43,
24578,223,2022/4/15 15:20,22,66,-44,
24579,223,2022/4/15 15:30,23,69,-46,
24580,223,2022/4/15 15:40,22,60,-38,
24581,223,2022/4/15 15:50,21,72,-51,
24582,223,2022/4/15 16:00,23,68,-45,
24583,223,2022/4/15 16:10,27,67,-40,
24584,223,2022/4/15 16:20,26,93,-67,
24585,223,2022/4/15 16:30,29,60,-31,
24586,223,2022/4/15 16:40,28,91,-63,
24587,223,2022/4/15 16:50,28,92,-64,
24588,223,2022/4/15 17:00,36,76,-40,
24589,223,2022/4/15 17:10,44,105,-61,
24590,223,2022/4/15 17:20,45,113,-68,
24591,223,2022/4/15 17:30,43,107,-64,
24592,223,2022/4/15 17:40,57,110,-53,
24593,223,2022/4/15 17:50,45,117,-72,
24594,223,2022/4/15 18:00,46,109,-63,
24595,223,2022/4/15 18:10,48,110,-62,
24596,223,2022/4/15 18:20,40,150,-110,
24597,223,2022/4/15 18:30,29,150,-121,
24598,223,2022/4/15 18:40,31,154,-123,
24599,223,2022/4/15 18:50,28,133,-105,
24600,223,2022/4/15 19:00,19,109,-90,
24601,223,2022/4/15 19:10,19,118,-99,
24602,223,2022/4/15 19:20,14,116,-102,
24603,223,2022/4/15 19:30,15,113,-98,
24604,223,2022/4/15 19:40,16,77,-61,
24605,223,2022/4/15 19:50,16,107,-91,
24606,223,2022/4/15 20:00,15,77,-62,
24607,223,2022/4/15 20:10,15,68,-53,
24608,223,2022/4/15 20:20,15,72,-57,
24609,223,2022/4/15 20:30,15,73,-58,
24610,223,2022/4/15 20:40,15,85,-70,
24611,223,2022/4/15 20:50,13,82,-69,
24612,223,2022/4/15 21:00,13,77,-64,
24613,223,2022/4/15 21:10,13,75,-62,
24614,223,2022/4/15 21:20,12,72,-60,
24615,223,2022/4/15 21:30,11,78,-67,
24616,223,2022/4/15 21:40,9,69,-60,
24617,223,2022/4/15 21:50,5,66,-61,
24618,223,2022/4/15 22:00,8,74,-66,
24619,223,2022/4/15 22:10,7,71,-64,
24620,223,2022/4/15 22:20,3,62,-59,
24621,223,2022/4/15 22:30,1,62,-61,
24622,223,2022/4/15 22:40,1,64,-63,
24623,223,2022/4/15 22:50,0,36,-36,
24624,219,2022/4/15 5:00,0,1,-1,
24625,219,2022/4/15 5:10,1,1,0,
24626,219,2022/4/15 5:20,7,1,6,
24627,219,2022/4/15 5:30,13,1,12,
24628,219,2022/4/15 5:40,10,1,9,
24629,219,2022/4/15 5:50,16,1,15,
24630,219,2022/4/15 6:00,25,1,24,
24631,219,2022/4/15 6:10,35,1,34,
24632,219,2022/4/15 6:20,57,11,46,
24633,219,2022/4/15 6:30,68,45,23,
24634,219,2022/4/15 6:40,85,93,-8,
24635,219,2022/4/15 6:50,128,111,17,
24636,219,2022/4/15 7:00,174,110,64,
24637,219,2022/4/15 7:10,188,85,103,
24638,219,2022/4/15 7:20,244,45,199,
24639,219,2022/4/15 7:30,278,38,240,
24640,219,2022/4/15 7:40,327,63,264,
24641,219,2022/4/15 7:50,386,50,336,
24642,219,2022/4/15 8:00,597,41,556,
24643,219,2022/4/15 8:10,597,63,534,
24644,219,2022/4/15 8:20,339,55,284,
24645,219,2022/4/15 8:30,279,63,216,
24646,219,2022/4/15 8:40,241,74,167,
24647,219,2022/4/15 8:50,179,72,107,
24648,219,2022/4/15 9:00,76,66,10,
24649,219,2022/4/15 9:10,66,62,4,
24650,219,2022/4/15 9:20,50,57,-7,
24651,219,2022/4/15 9:30,41,45,-4,
24652,219,2022/4/15 9:40,36,58,-22,
24653,219,2022/4/15 9:50,25,56,-31,
24654,219,2022/4/15 10:00,29,54,-25,
24655,219,2022/4/15 10:10,26,45,-19,
24656,219,2022/4/15 10:20,23,47,-24,
24657,219,2022/4/15 10:30,24,42,-18,
24658,219,2022/4/15 10:40,23,48,-25,
24659,219,2022/4/15 10:50,19,41,-22,
24660,219,2022/4/15 11:00,21,50,-29,
24661,219,2022/4/15 11:10,23,46,-23,
24662,219,2022/4/15 11:20,20,50,-30,
24663,219,2022/4/15 11:30,17,51,-34,
24664,219,2022/4/15 11:40,21,41,-20,
24665,219,2022/4/15 11:50,23,47,-24,
24666,219,2022/4/15 12:00,23,38,-15,
24667,219,2022/4/15 12:10,27,47,-20,
24668,219,2022/4/15 12:20,25,38,-13,
24669,219,2022/4/15 12:30,28,50,-22,
24670,219,2022/4/15 12:40,23,51,-28,
24671,219,2022/4/15 12:50,25,62,-37,
24672,219,2022/4/15 13:00,25,60,-35,
24673,219,2022/4/15 13:10,24,45,-21,
24674,219,2022/4/15 13:20,22,45,-23,
24675,219,2022/4/15 13:30,18,42,-24,
24676,219,2022/4/15 13:40,22,48,-26,
24677,219,2022/4/15 13:50,21,48,-27,
24678,219,2022/4/15 14:00,23,46,-23,
24679,219,2022/4/15 14:10,20,51,-31,
24680,219,2022/4/15 14:20,14,69,-55,
24681,219,2022/4/15 14:30,16,59,-43,
24682,219,2022/4/15 14:40,19,63,-44,
24683,219,2022/4/15 14:50,22,56,-34,
24684,219,2022/4/15 15:00,20,61,-41,
24685,219,2022/4/15 15:10,21,65,-44,
24686,219,2022/4/15 15:20,23,70,-47,
24687,219,2022/4/15 15:30,21,73,-52,
24688,219,2022/4/15 15:40,23,70,-47,
24689,219,2022/4/15 15:50,23,79,-56,
24690,219,2022/4/15 16:00,23,80,-57,
24691,219,2022/4/15 16:10,22,68,-46,
24692,219,2022/4/15 16:20,24,82,-58,
24693,219,2022/4/15 16:30,37,79,-42,
24694,219,2022/4/15 16:40,68,90,-22,
24695,219,2022/4/15 16:50,67,106,-39,
24696,219,2022/4/15 17:00,40,93,-53,
24697,219,2022/4/15 17:10,33,105,-72,
24698,219,2022/4/15 17:20,30,109,-79,
24699,219,2022/4/15 17:30,26,125,-99,
24700,219,2022/4/15 17:40,48,103,-55,
24701,219,2022/4/15 17:50,29,118,-89,
24702,219,2022/4/15 18:00,28,150,-122,
24703,219,2022/4/15 18:10,28,146,-118,
24704,219,2022/4/15 18:20,21,159,-138,
24705,219,2022/4/15 18:30,21,150,-129,
24706,219,2022/4/15 18:40,16,180,-164,
24707,219,2022/4/15 18:50,15,329,-314,
24708,219,2022/4/15 19:00,14,180,-166,
24709,219,2022/4/15 19:10,14,110,-96,
24710,219,2022/4/15 19:20,12,117,-105,
24711,219,2022/4/15 19:30,14,112,-98,
24712,219,2022/4/15 19:40,16,95,-79,
24713,219,2022/4/15 19:50,11,95,-84,
24714,219,2022/4/15 20:00,11,81,-70,
24715,219,2022/4/15 20:10,13,95,-82,
24716,219,2022/4/15 20:20,13,112,-99,
24717,219,2022/4/15 20:30,13,80,-67,
24718,219,2022/4/15 20:40,12,75,-63,
24719,219,2022/4/15 20:50,13,85,-72,
24720,219,2022/4/15 21:00,13,79,-66,
24721,219,2022/4/15 21:10,13,91,-78,
24722,219,2022/4/15 21:20,8,77,-69,
24723,219,2022/4/15 21:30,8,69,-61,
24724,219,2022/4/15 21:40,10,77,-67,
24725,219,2022/4/15 21:50,8,79,-71,
24726,219,2022/4/15 22:00,6,67,-61,
24727,219,2022/4/15 22:10,6,71,-65,
24728,219,2022/4/15 22:20,4,66,-62,
24729,219,2022/4/15 22:30,2,64,-62,
24730,219,2022/4/15 22:40,0,40,-40,
24731,219,2022/4/15 22:50,0,47,-47,
24732,207,2022/4/15 5:00,0,1,-1,
24733,207,2022/4/15 5:10,1,1,0,
24734,207,2022/4/15 5:20,3,1,2,
24735,207,2022/4/15 5:30,5,1,4,
24736,207,2022/4/15 5:40,10,1,9,
24737,207,2022/4/15 5:50,12,1,11,
24738,207,2022/4/15 6:00,16,1,15,
24739,207,2022/4/15 6:10,18,2,16,
24740,207,2022/4/15 6:20,23,11,12,
24741,207,2022/4/15 6:30,33,14,19,
24742,207,2022/4/15 6:40,31,33,-2,
24743,207,2022/4/15 6:50,37,49,-12,
24744,207,2022/4/15 7:00,44,62,-18,
24745,207,2022/4/15 7:10,53,60,-7,
24746,207,2022/4/15 7:20,66,65,1,
24747,207,2022/4/15 7:30,78,68,10,
24748,207,2022/4/15 7:40,91,77,14,
24749,207,2022/4/15 7:50,122,97,25,
24750,207,2022/4/15 8:00,158,116,42,
24751,207,2022/4/15 8:10,144,109,35,
24752,207,2022/4/15 8:20,144,124,20,
24753,207,2022/4/15 8:30,71,102,-31,
24754,207,2022/4/15 8:40,53,76,-23,
24755,207,2022/4/15 8:50,50,67,-17,
24756,207,2022/4/15 9:00,31,49,-18,
24757,207,2022/4/15 9:10,33,46,-13,
24758,207,2022/4/15 9:20,27,44,-17,
24759,207,2022/4/15 9:30,21,32,-11,
24760,207,2022/4/15 9:40,20,35,-15,
24761,207,2022/4/15 9:50,14,32,-18,
24762,207,2022/4/15 10:00,12,30,-18,
24763,207,2022/4/15 10:10,13,29,-16,
24764,207,2022/4/15 10:20,12,23,-11,
24765,207,2022/4/15 10:30,11,23,-12,
24766,207,2022/4/15 10:40,13,31,-18,
24767,207,2022/4/15 10:50,11,23,-12,
24768,207,2022/4/15 11:00,14,21,-7,
24769,207,2022/4/15 11:10,12,23,-11,
24770,207,2022/4/15 11:20,11,25,-14,
24771,207,2022/4/15 11:30,11,23,-12,
24772,207,2022/4/15 11:40,9,23,-14,
24773,207,2022/4/15 11:50,13,24,-11,
24774,207,2022/4/15 12:00,12,30,-18,
24775,207,2022/4/15 12:10,11,32,-21,
24776,207,2022/4/15 12:20,13,31,-18,
24777,207,2022/4/15 12:30,14,23,-9,
24778,207,2022/4/15 12:40,10,38,-28,
24779,207,2022/4/15 12:50,13,32,-19,
24780,207,2022/4/15 13:00,11,37,-26,
24781,207,2022/4/15 13:10,9,36,-27,
24782,207,2022/4/15 13:20,9,38,-29,
24783,207,2022/4/15 13:30,11,33,-22,
24784,207,2022/4/15 13:40,11,37,-26,
24785,207,2022/4/15 13:50,10,38,-28,
24786,207,2022/4/15 14:00,11,33,-22,
24787,207,2022/4/15 14:10,10,32,-22,
24788,207,2022/4/15 14:20,12,36,-24,
24789,207,2022/4/15 14:30,10,37,-27,
24790,207,2022/4/15 14:40,12,38,-26,
24791,207,2022/4/15 14:50,12,30,-18,
24792,207,2022/4/15 15:00,17,38,-21,
24793,207,2022/4/15 15:10,16,36,-20,
24794,207,2022/4/15 15:20,14,45,-31,
24795,207,2022/4/15 15:30,14,36,-22,
24796,207,2022/4/15 15:40,21,46,-25,
24797,207,2022/4/15 15:50,15,45,-30,
24798,207,2022/4/15 16:00,18,62,-44,
24799,207,2022/4/15 16:10,17,65,-48,
24800,207,2022/4/15 16:20,25,52,-27,
24801,207,2022/4/15 16:30,21,57,-36,
24802,207,2022/4/15 16:40,33,61,-28,
24803,207,2022/4/15 16:50,24,52,-28,
24804,207,2022/4/15 17:00,37,59,-22,
24805,207,2022/4/15 17:10,53,60,-7,
24806,207,2022/4/15 17:20,27,72,-45,
24807,207,2022/4/15 17:30,24,84,-60,
24808,207,2022/4/15 17:40,50,81,-31,
24809,207,2022/4/15 17:50,40,92,-52,
24810,207,2022/4/15 18:00,27,110,-83,
24811,207,2022/4/15 18:10,45,106,-61,
24812,207,2022/4/15 18:20,43,115,-72,
24813,207,2022/4/15 18:30,32,102,-70,
24814,207,2022/4/15 18:40,47,107,-60,
24815,207,2022/4/15 18:50,28,95,-67,
24816,207,2022/4/15 19:00,19,92,-73,
24817,207,2022/4/15 19:10,24,78,-54,
24818,207,2022/4/15 19:20,15,73,-58,
24819,207,2022/4/15 19:30,14,66,-52,
24820,207,2022/4/15 19:40,17,66,-49,
24821,207,2022/4/15 19:50,12,52,-40,
24822,207,2022/4/15 20:00,10,49,-39,
24823,207,2022/4/15 20:10,18,40,-22,
24824,207,2022/4/15 20:20,15,47,-32,
24825,207,2022/4/15 20:30,15,40,-25,
24826,207,2022/4/15 20:40,24,47,-23,
24827,207,2022/4/15 20:50,16,42,-26,
24828,207,2022/4/15 21:00,16,47,-31,
24829,207,2022/4/15 21:10,11,37,-26,
24830,207,2022/4/15 21:20,13,34,-21,
24831,207,2022/4/15 21:30,6,40,-34,
24832,207,2022/4/15 21:40,6,37,-31,
24833,207,2022/4/15 21:50,4,39,-35,
24834,207,2022/4/15 22:00,4,41,-37,
24835,207,2022/4/15 22:10,5,40,-35,
24836,207,2022/4/15 22:20,2,40,-38,
24837,207,2022/4/15 22:30,1,41,-40,
24838,207,2022/4/15 22:40,0,52,-52,
24839,207,2022/4/15 22:50,0,44,-44,
24840,240,2022/4/15 5:00,0,1,-1,-1
24841,240,2022/4/15 5:10,2,1,1,1
24842,240,2022/4/15 5:20,2,1,1,1
24843,240,2022/4/15 5:30,3,1,2,2
24844,240,2022/4/15 5:40,3,1,2,2
24845,240,2022/4/15 5:50,2,1,1,1
24846,240,2022/4/15 6:00,2,1,1,1
24847,240,2022/4/15 6:10,4,1,3,3
24848,240,2022/4/15 6:20,6,1,5,5
24849,240,2022/4/15 6:30,10,71,-61,-61
24850,240,2022/4/15 6:40,10,47,-37,-37
24851,240,2022/4/15 6:50,10,51,-41,-41
24852,240,2022/4/15 7:00,21,66,-45,-45
24853,240,2022/4/15 7:10,27,72,-45,-45
24854,240,2022/4/15 7:20,25,95,-70,-70
24855,240,2022/4/15 7:30,27,103,-76,-76
24856,240,2022/4/15 7:40,32,112,-80,-80
24857,240,2022/4/15 7:50,32,128,-96,-96
24858,240,2022/4/15 8:00,30,211,-181,-181
24859,240,2022/4/15 8:10,29,295,-266,-266
24860,240,2022/4/15 8:20,30,424,-394,-394
24861,240,2022/4/15 8:30,26,401,-375,-375
24862,240,2022/4/15 8:40,24,589,-565,-565
24863,240,2022/4/15 8:50,21,689,-668,-668
24864,240,2022/4/15 9:00,21,482,-461,-461
24865,240,2022/4/15 9:10,20,412,-392,-392
24866,240,2022/4/15 9:20,20,405,-385,-385
24867,240,2022/4/15 9:30,18,429,-411,-411
24868,240,2022/4/15 9:40,16,231,-215,-215
24869,240,2022/4/15 9:50,16,301,-285,-285
24870,240,2022/4/15 10:00,19,221,-202,-202
24871,240,2022/4/15 10:10,22,150,-128,-128
24872,240,2022/4/15 10:20,21,108,-87,-87
24873,240,2022/4/15 10:30,23,119,-96,-96
24874,240,2022/4/15 10:40,25,108,-83,-83
24875,240,2022/4/15 10:50,26,118,-92,-92
24876,240,2022/4/15 11:00,25,103,-78,-78
24877,240,2022/4/15 11:10,27,96,-69,-69
24878,240,2022/4/15 11:20,26,85,-59,-59
24879,240,2022/4/15 11:30,27,99,-72,-72
24880,240,2022/4/15 11:40,34,106,-72,-72
24881,240,2022/4/15 11:50,31,94,-63,-63
24882,240,2022/4/15 12:00,36,76,-40,-40
24883,240,2022/4/15 12:10,40,84,-44,-44
24884,240,2022/4/15 12:20,35,86,-51,-51
24885,240,2022/4/15 12:30,29,104,-75,-75
24886,240,2022/4/15 12:40,36,107,-71,-71
24887,240,2022/4/15 12:50,38,102,-64,-64
24888,240,2022/4/15 13:00,39,96,-57,-57
24889,240,2022/4/15 13:10,44,89,-45,-45
24890,240,2022/4/15 13:20,42,96,-54,-54
24891,240,2022/4/15 13:30,45,98,-53,-53
24892,240,2022/4/15 13:40,45,96,-51,-51
24893,240,2022/4/15 13:50,45,96,-51,-51
24894,240,2022/4/15 14:00,46,81,-35,-35
24895,240,2022/4/15 14:10,48,95,-47,-47
24896,240,2022/4/15 14:20,49,90,-41,-41
24897,240,2022/4/15 14:30,53,94,-41,-41
24898,240,2022/4/15 14:40,55,84,-29,-29
24899,240,2022/4/15 14:50,56,82,-26,-26
24900,240,2022/4/15 15:00,60,62,-2,-2
24901,240,2022/4/15 15:10,70,72,-2,-2
24902,240,2022/4/15 15:20,88,78,10,10
24903,240,2022/4/15 15:30,80,65,15,15
24904,240,2022/4/15 15:40,114,84,30,30
24905,240,2022/4/15 15:50,72,63,9,9
24906,240,2022/4/15 16:00,99,70,29,29
24907,240,2022/4/15 16:10,119,71,48,48
24908,240,2022/4/15 16:20,115,61,54,54
24909,240,2022/4/15 16:30,138,68,70,70
24910,240,2022/4/15 16:40,171,62,109,109
24911,240,2022/4/15 16:50,142,71,71,71
24912,240,2022/4/15 17:00,273,69,204,204
24913,240,2022/4/15 17:10,355,77,278,278
24914,240,2022/4/15 17:20,329,71,258,258
24915,240,2022/4/15 17:30,629,74,555,555
24916,240,2022/4/15 17:40,594,76,518,518
24917,240,2022/4/15 17:50,346,91,255,255
24918,240,2022/4/15 18:00,590,91,499,499
24919,240,2022/4/15 18:10,630,92,538,538
24920,240,2022/4/15 18:20,374,95,279,279
24921,240,2022/4/15 18:30,289,92,197,197
24922,240,2022/4/15 18:40,268,90,178,178
24923,240,2022/4/15 18:50,218,87,131,131
24924,240,2022/4/15 19:00,175,77,98,98
24925,240,2022/4/15 19:10,141,72,69,69
24926,240,2022/4/15 19:20,89,82,7,7
24927,240,2022/4/15 19:30,76,74,2,2
24928,240,2022/4/15 19:40,71,61,10,10
24929,240,2022/4/15 19:50,55,50,5,5
24930,240,2022/4/15 20:00,71,40,31,31
24931,240,2022/4/15 20:10,77,47,30,30
24932,240,2022/4/15 20:20,56,39,17,17
24933,240,2022/4/15 20:30,55,27,28,28
24934,240,2022/4/15 20:40,46,33,13,13
24935,240,2022/4/15 20:50,44,36,8,8
24936,240,2022/4/15 21:00,60,25,35,35
24937,240,2022/4/15 21:10,58,27,31,31
24938,240,2022/4/15 21:20,44,32,12,12
24939,240,2022/4/15 21:30,51,33,18,18
24940,240,2022/4/15 21:40,42,32,10,10
24941,240,2022/4/15 21:50,41,25,16,16
24942,240,2022/4/15 22:00,138,25,113,113
24943,240,2022/4/15 22:10,50,25,25,25
24944,240,2022/4/15 22:20,27,23,4,4
24945,240,2022/4/15 22:30,0,21,-21,-21
24946,240,2022/4/15 22:40,0,25,-25,-25
24947,240,2022/4/15 22:50,0,18,-18,-18
24948,246,2022/4/15 5:00,0,1,-1,
24949,246,2022/4/15 5:10,3,1,2,
24950,246,2022/4/15 5:20,12,1,11,
24951,246,2022/4/15 5:30,14,1,13,
24952,246,2022/4/15 5:40,15,1,14,
24953,246,2022/4/15 5:50,17,1,16,
24954,246,2022/4/15 6:00,22,1,21,
24955,246,2022/4/15 6:10,21,1,20,
24956,246,2022/4/15 6:20,26,8,18,
24957,246,2022/4/15 6:30,36,64,-28,
24958,246,2022/4/15 6:40,29,73,-44,
24959,246,2022/4/15 6:50,50,82,-32,
24960,246,2022/4/15 7:00,47,104,-57,
24961,246,2022/4/15 7:10,56,87,-31,
24962,246,2022/4/15 7:20,78,111,-33,
24963,246,2022/4/15 7:30,70,133,-63,
24964,246,2022/4/15 7:40,149,152,-3,
24965,246,2022/4/15 7:50,171,112,59,
24966,246,2022/4/15 8:00,184,110,74,
24967,246,2022/4/15 8:10,147,121,26,
24968,246,2022/4/15 8:20,151,107,44,
24969,246,2022/4/15 8:30,121,110,11,
24970,246,2022/4/15 8:40,71,185,-114,
24971,246,2022/4/15 8:50,69,144,-75,
24972,246,2022/4/15 9:00,38,123,-85,
24973,246,2022/4/15 9:10,36,106,-70,
24974,246,2022/4/15 9:20,31,104,-73,
24975,246,2022/4/15 9:30,35,82,-47,
24976,246,2022/4/15 9:40,24,76,-52,
24977,246,2022/4/15 9:50,25,76,-51,
24978,246,2022/4/15 10:00,27,63,-36,
24979,246,2022/4/15 10:10,24,69,-45,
24980,246,2022/4/15 10:20,26,65,-39,
24981,246,2022/4/15 10:30,21,51,-30,
24982,246,2022/4/15 10:40,18,64,-46,
24983,246,2022/4/15 10:50,26,45,-19,
24984,246,2022/4/15 11:00,25,62,-37,
24985,246,2022/4/15 11:10,24,54,-30,
24986,246,2022/4/15 11:20,24,57,-33,
24987,246,2022/4/15 11:30,25,41,-16,
24988,246,2022/4/15 11:40,25,58,-33,
24989,246,2022/4/15 11:50,29,64,-35,
24990,246,2022/4/15 12:00,28,60,-32,
24991,246,2022/4/15 12:10,26,65,-39,
24992,246,2022/4/15 12:20,26,54,-28,
24993,246,2022/4/15 12:30,23,51,-28,
24994,246,2022/4/15 12:40,35,48,-13,
24995,246,2022/4/15 12:50,27,62,-35,
24996,246,2022/4/15 13:00,25,66,-41,
24997,246,2022/4/15 13:10,26,55,-29,
24998,246,2022/4/15 13:20,27,57,-30,
24999,246,2022/4/15 13:30,27,50,-23,
25000,246,2022/4/15 13:40,28,52,-24,
25001,246,2022/4/15 13:50,26,62,-36,
25002,246,2022/4/15 14:00,28,64,-36,
25003,246,2022/4/15 14:10,26,65,-39,
25004,246,2022/4/15 14:20,26,63,-37,
25005,246,2022/4/15 14:30,25,50,-25,
25006,246,2022/4/15 14:40,28,63,-35,
25007,246,2022/4/15 14:50,28,65,-37,
25008,246,2022/4/15 15:00,27,63,-36,
25009,246,2022/4/15 15:10,31,57,-26,
25010,246,2022/4/15 15:20,27,51,-24,
25011,246,2022/4/15 15:30,25,50,-25,
25012,246,2022/4/15 15:40,32,59,-27,
25013,246,2022/4/15 15:50,26,65,-39,
25014,246,2022/4/15 16:00,30,64,-34,
25015,246,2022/4/15 16:10,37,66,-29,
25016,246,2022/4/15 16:20,43,53,-10,
25017,246,2022/4/15 16:30,60,69,-9,
25018,246,2022/4/15 16:40,135,71,64,
25019,246,2022/4/15 16:50,101,66,35,
25020,246,2022/4/15 17:00,177,70,107,
25021,246,2022/4/15 17:10,270,72,198,
25022,246,2022/4/15 17:20,234,77,157,
25023,246,2022/4/15 17:30,227,76,151,
25024,246,2022/4/15 17:40,336,92,244,
25025,246,2022/4/15 17:50,316,81,235,
25026,246,2022/4/15 18:00,270,99,171,
25027,246,2022/4/15 18:10,584,77,507,
25028,246,2022/4/15 18:20,266,106,160,
25029,246,2022/4/15 18:30,167,95,72,
25030,246,2022/4/15 18:40,191,106,85,
25031,246,2022/4/15 18:50,75,102,-27,
25032,246,2022/4/15 19:00,41,78,-37,
25033,246,2022/4/15 19:10,42,81,-39,
25034,246,2022/4/15 19:20,34,67,-33,
25035,246,2022/4/15 19:30,29,63,-34,
25036,246,2022/4/15 19:40,30,70,-40,
25037,246,2022/4/15 19:50,28,53,-25,
25038,246,2022/4/15 20:00,33,50,-17,
25039,246,2022/4/15 20:10,32,46,-14,
25040,246,2022/4/15 20:20,29,43,-14,
25041,246,2022/4/15 20:30,44,40,4,
25042,246,2022/4/15 20:40,27,47,-20,
25043,246,2022/4/15 20:50,32,40,-8,
25044,246,2022/4/15 21:00,35,36,-1,
25045,246,2022/4/15 21:10,27,27,0,
25046,246,2022/4/15 21:20,28,41,-13,
25047,246,2022/4/15 21:30,29,33,-4,
25048,246,2022/4/15 21:40,21,31,-10,
25049,246,2022/4/15 21:50,17,38,-21,
25050,246,2022/4/15 22:00,15,34,-19,
25051,246,2022/4/15 22:10,13,34,-21,
25052,246,2022/4/15 22:20,6,34,-28,
25053,246,2022/4/15 22:30,5,34,-29,
25054,246,2022/4/15 22:40,1,25,-24,
25055,246,2022/4/15 22:50,1,25,-24,
25056,237,2022/4/15 5:00,2,1,1,
25057,237,2022/4/15 5:10,7,1,6,
25058,237,2022/4/15 5:20,19,1,18,
25059,237,2022/4/15 5:30,25,1,24,
25060,237,2022/4/15 5:40,29,2,27,
25061,237,2022/4/15 5:50,32,2,30,
25062,237,2022/4/15 6:00,45,5,40,
25063,237,2022/4/15 6:10,54,5,49,
25064,237,2022/4/15 6:20,91,51,40,
25065,237,2022/4/15 6:30,168,55,113,
25066,237,2022/4/15 6:40,228,64,164,
25067,237,2022/4/15 6:50,251,77,174,
25068,237,2022/4/15 7:00,356,107,249,
25069,237,2022/4/15 7:10,366,104,262,
25070,237,2022/4/15 7:20,642,99,543,
25071,237,2022/4/15 7:30,687,110,577,
25072,237,2022/4/15 7:40,1049,139,910,
25073,237,2022/4/15 7:50,1215,128,1087,
25074,237,2022/4/15 8:00,1209,144,1065,
25075,237,2022/4/15 8:10,1360,128,1232,
25076,237,2022/4/15 8:20,1169,104,1065,
25077,237,2022/4/15 8:30,1036,109,927,
25078,237,2022/4/15 8:40,831,125,706,
25079,237,2022/4/15 8:50,720,110,610,
25080,237,2022/4/15 9:00,584,112,472,
25081,237,2022/4/15 9:10,435,106,329,
25082,237,2022/4/15 9:20,319,112,207,
25083,237,2022/4/15 9:30,236,97,139,
25084,237,2022/4/15 9:40,197,89,108,
25085,237,2022/4/15 9:50,117,96,21,
25086,237,2022/4/15 10:00,82,105,-23,
25087,237,2022/4/15 10:10,72,69,3,
25088,237,2022/4/15 10:20,59,92,-33,
25089,237,2022/4/15 10:30,66,93,-27,
25090,237,2022/4/15 10:40,56,93,-37,
25091,237,2022/4/15 10:50,66,77,-11,
25092,237,2022/4/15 11:00,45,77,-32,
25093,237,2022/4/15 11:10,55,77,-22,
25094,237,2022/4/15 11:20,50,64,-14,
25095,237,2022/4/15 11:30,46,87,-41,
25096,237,2022/4/15 11:40,50,77,-27,
25097,237,2022/4/15 11:50,55,76,-21,
25098,237,2022/4/15 12:00,54,74,-20,
25099,237,2022/4/15 12:10,52,82,-30,
25100,237,2022/4/15 12:20,51,92,-41,
25101,237,2022/4/15 12:30,57,90,-33,
25102,237,2022/4/15 12:40,46,90,-44,
25103,237,2022/4/15 12:50,45,108,-63,
25104,237,2022/4/15 13:00,46,109,-63,
25105,237,2022/4/15 13:10,45,76,-31,
25106,237,2022/4/15 13:20,42,111,-69,
25107,237,2022/4/15 13:30,47,93,-46,
25108,237,2022/4/15 13:40,45,92,-47,
25109,237,2022/4/15 13:50,41,104,-63,
25110,237,2022/4/15 14:00,41,92,-51,
25111,237,2022/4/15 14:10,44,93,-49,
25112,237,2022/4/15 14:20,44,105,-61,
25113,237,2022/4/15 14:30,38,99,-61,
25114,237,2022/4/15 14:40,39,105,-66,
25115,237,2022/4/15 14:50,43,104,-61,
25116,237,2022/4/15 15:00,39,76,-37,
25117,237,2022/4/15 15:10,43,104,-61,
25118,237,2022/4/15 15:20,40,109,-69,
25119,237,2022/4/15 15:30,46,104,-58,
25120,237,2022/4/15 15:40,44,106,-62,
25121,237,2022/4/15 15:50,47,111,-64,
25122,237,2022/4/15 16:00,52,100,-48,
25123,237,2022/4/15 16:10,46,101,-55,
25124,237,2022/4/15 16:20,48,121,-73,
25125,237,2022/4/15 16:30,68,106,-38,
25126,237,2022/4/15 16:40,61,108,-47,
25127,237,2022/4/15 16:50,66,139,-73,
25128,237,2022/4/15 17:00,103,119,-16,
25129,237,2022/4/15 17:10,140,127,13,
25130,237,2022/4/15 17:20,160,157,3,
25131,237,2022/4/15 17:30,89,196,-107,
25132,237,2022/4/15 17:40,136,376,-240,
25133,237,2022/4/15 17:50,115,332,-217,
25134,237,2022/4/15 18:00,75,282,-207,
25135,237,2022/4/15 18:10,48,508,-460,
25136,237,2022/4/15 18:20,44,534,-490,
25137,237,2022/4/15 18:30,42,502,-460,
25138,237,2022/4/15 18:40,35,432,-397,
25139,237,2022/4/15 18:50,38,502,-464,
25140,237,2022/4/15 19:00,25,533,-508,
25141,237,2022/4/15 19:10,34,381,-347,
25142,237,2022/4/15 19:20,31,301,-270,
25143,237,2022/4/15 19:30,26,176,-150,
25144,237,2022/4/15 19:40,24,190,-166,
25145,237,2022/4/15 19:50,27,177,-150,
25146,237,2022/4/15 20:00,27,152,-125,
25147,237,2022/4/15 20:10,28,121,-93,
25148,237,2022/4/15 20:20,23,121,-98,
25149,237,2022/4/15 20:30,27,117,-90,
25150,237,2022/4/15 20:40,28,125,-97,
25151,237,2022/4/15 20:50,22,116,-94,
25152,237,2022/4/15 21:00,27,110,-83,
25153,237,2022/4/15 21:10,26,144,-118,
25154,237,2022/4/15 21:20,26,120,-94,
25155,237,2022/4/15 21:30,25,104,-79,
25156,237,2022/4/15 21:40,22,119,-97,
25157,237,2022/4/15 21:50,16,110,-94,
25158,237,2022/4/15 22:00,17,122,-105,
25159,237,2022/4/15 22:10,13,125,-112,
25160,237,2022/4/15 22:20,9,110,-101,
25161,237,2022/4/15 22:30,4,105,-101,
25162,237,2022/4/15 22:40,1,95,-94,
25163,237,2022/4/15 22:50,1,112,-111,
25164,241,2022/4/15 5:00,0,1,-1,
25165,241,2022/4/15 5:10,0,1,-1,
25166,241,2022/4/15 5:20,13,1,12,
25167,241,2022/4/15 5:30,21,1,20,
25168,241,2022/4/15 5:40,16,1,15,
25169,241,2022/4/15 5:50,30,1,29,
25170,241,2022/4/15 6:00,33,2,31,
25171,241,2022/4/15 6:10,46,2,44,
25172,241,2022/4/15 6:20,65,33,32,
25173,241,2022/4/15 6:30,94,36,58,
25174,241,2022/4/15 6:40,170,54,116,
25175,241,2022/4/15 6:50,213,67,146,
25176,241,2022/4/15 7:00,277,70,207,
25177,241,2022/4/15 7:10,347,74,273,
25178,241,2022/4/15 7:20,568,90,478,
25179,241,2022/4/15 7:30,693,97,596,
25180,241,2022/4/15 7:40,1052,95,957,
25181,241,2022/4/15 7:50,1221,98,1123,
25182,241,2022/4/15 8:00,1385,115,1270,
25183,241,2022/4/15 8:10,1578,122,1456,
25184,241,2022/4/15 8:20,1172,104,1068,
25185,241,2022/4/15 8:30,1040,110,930,
25186,241,2022/4/15 8:40,735,108,627,
25187,241,2022/4/15 8:50,664,95,569,
25188,241,2022/4/15 9:00,436,93,343,
25189,241,2022/4/15 9:10,273,92,181,
25190,241,2022/4/15 9:20,240,83,157,
25191,241,2022/4/15 9:30,183,75,108,
25192,241,2022/4/15 9:40,76,73,3,
25193,241,2022/4/15 9:50,72,74,-2,
25194,241,2022/4/15 10:00,48,70,-22,
25195,241,2022/4/15 10:10,46,67,-21,
25196,241,2022/4/15 10:20,41,65,-24,
25197,241,2022/4/15 10:30,37,68,-31,
25198,241,2022/4/15 10:40,36,62,-26,
25199,241,2022/4/15 10:50,29,66,-37,
25200,241,2022/4/15 11:00,35,73,-38,
25201,241,2022/4/15 11:10,31,69,-38,
25202,241,2022/4/15 11:20,33,67,-34,
25203,241,2022/4/15 11:30,36,73,-37,
25204,241,2022/4/15 11:40,26,70,-44,
25205,241,2022/4/15 11:50,36,70,-34,
25206,241,2022/4/15 12:00,36,74,-38,
25207,241,2022/4/15 12:10,44,82,-38,
25208,241,2022/4/15 12:20,38,73,-35,
25209,241,2022/4/15 12:30,39,74,-35,
25210,241,2022/4/15 12:40,37,69,-32,
25211,241,2022/4/15 12:50,37,84,-47,
25212,241,2022/4/15 13:00,36,80,-44,
25213,241,2022/4/15 13:10,36,70,-34,
25214,241,2022/4/15 13:20,39,82,-43,
25215,241,2022/4/15 13:30,31,73,-42,
25216,241,2022/4/15 13:40,31,73,-42,
25217,241,2022/4/15 13:50,32,83,-51,
25218,241,2022/4/15 14:00,28,84,-56,
25219,241,2022/4/15 14:10,22,84,-62,
25220,241,2022/4/15 14:20,26,77,-51,
25221,241,2022/4/15 14:30,27,73,-46,
25222,241,2022/4/15 14:40,28,76,-48,
25223,241,2022/4/15 14:50,30,81,-51,
25224,241,2022/4/15 15:00,30,92,-62,
25225,241,2022/4/15 15:10,36,75,-39,
25226,241,2022/4/15 15:20,33,89,-56,
25227,241,2022/4/15 15:30,31,93,-62,
25228,241,2022/4/15 15:40,30,102,-72,
25229,241,2022/4/15 15:50,39,105,-66,
25230,241,2022/4/15 16:00,37,101,-64,
25231,241,2022/4/15 16:10,57,104,-47,
25232,241,2022/4/15 16:20,42,96,-54,
25233,241,2022/4/15 16:30,43,118,-75,
25234,241,2022/4/15 16:40,49,108,-59,
25235,241,2022/4/15 16:50,46,122,-76,
25236,241,2022/4/15 17:00,64,124,-60,
25237,241,2022/4/15 17:10,78,158,-80,
25238,241,2022/4/15 17:20,72,153,-81,
25239,241,2022/4/15 17:30,57,225,-168,
25240,241,2022/4/15 17:40,74,212,-138,
25241,241,2022/4/15 17:50,73,333,-260,
25242,241,2022/4/15 18:00,55,334,-279,
25243,241,2022/4/15 18:10,49,510,-461,
25244,241,2022/4/15 18:20,56,433,-377,
25245,241,2022/4/15 18:30,43,438,-395,
25246,241,2022/4/15 18:40,37,432,-395,
25247,241,2022/4/15 18:50,30,440,-410,
25248,241,2022/4/15 19:00,31,382,-351,
25249,241,2022/4/15 19:10,29,321,-292,
25250,241,2022/4/15 19:20,32,232,-200,
25251,241,2022/4/15 19:30,27,271,-244,
25252,241,2022/4/15 19:40,29,126,-97,
25253,241,2022/4/15 19:50,29,118,-89,
25254,241,2022/4/15 20:00,32,110,-78,
25255,241,2022/4/15 20:10,30,113,-83,
25256,241,2022/4/15 20:20,29,110,-81,
25257,241,2022/4/15 20:30,28,124,-96,
25258,241,2022/4/15 20:40,24,115,-91,
25259,241,2022/4/15 20:50,26,122,-96,
25260,241,2022/4/15 21:00,22,122,-100,
25261,241,2022/4/15 21:10,26,119,-93,
25262,241,2022/4/15 21:20,26,127,-101,
25263,241,2022/4/15 21:30,21,124,-103,
25264,241,2022/4/15 21:40,18,123,-105,
25265,241,2022/4/15 21:50,14,123,-109,
25266,241,2022/4/15 22:00,14,114,-100,
25267,241,2022/4/15 22:10,16,110,-94,
25268,241,2022/4/15 22:20,12,103,-91,
25269,241,2022/4/15 22:30,6,107,-101,
25270,241,2022/4/15 22:40,1,102,-101,
25271,241,2022/4/15 22:50,1,70,-69,
25272,256,2022/4/15 5:00,0,1,-1,
25273,256,2022/4/15 5:10,0,1,-1,
25274,256,2022/4/15 5:20,8,1,7,
25275,256,2022/4/15 5:30,18,1,17,
25276,256,2022/4/15 5:40,19,1,18,
25277,256,2022/4/15 5:50,23,1,22,
25278,256,2022/4/15 6:00,31,1,30,
25279,256,2022/4/15 6:10,43,5,38,
25280,256,2022/4/15 6:20,59,45,14,
25281,256,2022/4/15 6:30,74,45,29,
25282,256,2022/4/15 6:40,146,74,72,
25283,256,2022/4/15 6:50,205,93,112,
25284,256,2022/4/15 7:00,249,121,128,
25285,256,2022/4/15 7:10,352,112,240,
25286,256,2022/4/15 7:20,593,91,502,
25287,256,2022/4/15 7:30,693,93,600,
25288,256,2022/4/15 7:40,1060,105,955,
25289,256,2022/4/15 7:50,1061,113,948,
25290,256,2022/4/15 8:00,1210,122,1088,
25291,256,2022/4/15 8:10,1385,119,1266,
25292,256,2022/4/15 8:20,1215,101,1114,
25293,256,2022/4/15 8:30,858,109,749,
25294,256,2022/4/15 8:40,689,119,570,
25295,256,2022/4/15 8:50,630,104,526,
25296,256,2022/4/15 9:00,384,115,269,
25297,256,2022/4/15 9:10,298,111,187,
25298,256,2022/4/15 9:20,238,92,146,
25299,256,2022/4/15 9:30,178,72,106,
25300,256,2022/4/15 9:40,93,75,18,
25301,256,2022/4/15 9:50,61,83,-22,
25302,256,2022/4/15 10:00,47,85,-38,
25303,256,2022/4/15 10:10,46,47,-1,
25304,256,2022/4/15 10:20,41,71,-30,
25305,256,2022/4/15 10:30,38,66,-28,
25306,256,2022/4/15 10:40,36,69,-33,
25307,256,2022/4/15 10:50,34,73,-39,
25308,256,2022/4/15 11:00,34,67,-33,
25309,256,2022/4/15 11:10,28,51,-23,
25310,256,2022/4/15 11:20,30,69,-39,
25311,256,2022/4/15 11:30,28,65,-37,
25312,256,2022/4/15 11:40,32,75,-43,
25313,256,2022/4/15 11:50,33,70,-37,
25314,256,2022/4/15 12:00,38,63,-25,
25315,256,2022/4/15 12:10,37,70,-33,
25316,256,2022/4/15 12:20,35,72,-37,
25317,256,2022/4/15 12:30,39,77,-38,
25318,256,2022/4/15 12:40,39,75,-36,
25319,256,2022/4/15 12:50,36,75,-39,
25320,256,2022/4/15 13:00,37,75,-38,
25321,256,2022/4/15 13:10,33,63,-30,
25322,256,2022/4/15 13:20,29,76,-47,
25323,256,2022/4/15 13:30,31,84,-53,
25324,256,2022/4/15 13:40,28,78,-50,
25325,256,2022/4/15 13:50,23,62,-39,
25326,256,2022/4/15 14:00,30,69,-39,
25327,256,2022/4/15 14:10,32,78,-46,
25328,256,2022/4/15 14:20,31,76,-45,
25329,256,2022/4/15 14:30,28,77,-49,
25330,256,2022/4/15 14:40,27,76,-49,
25331,256,2022/4/15 14:50,36,77,-41,
25332,256,2022/4/15 15:00,29,85,-56,
25333,256,2022/4/15 15:10,19,98,-79,
25334,256,2022/4/15 15:20,38,91,-53,
25335,256,2022/4/15 15:30,39,99,-60,
25336,256,2022/4/15 15:40,30,106,-76,
25337,256,2022/4/15 15:50,29,80,-51,
25338,256,2022/4/15 16:00,33,111,-78,
25339,256,2022/4/15 16:10,35,105,-70,
25340,256,2022/4/15 16:20,36,101,-65,
25341,256,2022/4/15 16:30,47,101,-54,
25342,256,2022/4/15 16:40,103,119,-16,
25343,256,2022/4/15 16:50,170,121,49,
25344,256,2022/4/15 17:00,99,127,-28,
25345,256,2022/4/15 17:10,131,118,13,
25346,256,2022/4/15 17:20,83,138,-55,
25347,256,2022/4/15 17:30,81,283,-202,
25348,256,2022/4/15 17:40,174,322,-148,
25349,256,2022/4/15 17:50,73,268,-195,
25350,256,2022/4/15 18:00,65,317,-252,
25351,256,2022/4/15 18:10,62,501,-439,
25352,256,2022/4/15 18:20,64,504,-440,
25353,256,2022/4/15 18:30,47,496,-449,
25354,256,2022/4/15 18:40,41,431,-390,
25355,256,2022/4/15 18:50,37,421,-384,
25356,256,2022/4/15 19:00,30,380,-350,
25357,256,2022/4/15 19:10,33,512,-479,
25358,256,2022/4/15 19:20,26,217,-191,
25359,256,2022/4/15 19:30,26,183,-157,
25360,256,2022/4/15 19:40,28,157,-129,
25361,256,2022/4/15 19:50,27,191,-164,
25362,256,2022/4/15 20:00,25,139,-114,
25363,256,2022/4/15 20:10,28,114,-86,
25364,256,2022/4/15 20:20,27,111,-84,
25365,256,2022/4/15 20:30,26,100,-74,
25366,256,2022/4/15 20:40,24,182,-158,
25367,256,2022/4/15 20:50,22,109,-87,
25368,256,2022/4/15 21:00,25,109,-84,
25369,256,2022/4/15 21:10,22,110,-88,
25370,256,2022/4/15 21:20,22,114,-92,
25371,256,2022/4/15 21:30,20,111,-91,
25372,256,2022/4/15 21:40,18,128,-110,
25373,256,2022/4/15 21:50,14,124,-110,
25374,256,2022/4/15 22:00,13,105,-92,
25375,256,2022/4/15 22:10,12,111,-99,
25376,256,2022/4/15 22:20,9,95,-86,
25377,256,2022/4/15 22:30,6,112,-106,
25378,256,2022/4/15 22:40,1,106,-105,
25379,256,2022/4/15 22:50,1,72,-71,
25380,257,2022/4/15 5:00,0,1,-1,
25381,257,2022/4/15 5:10,0,1,-1,
25382,257,2022/4/15 5:20,1,1,0,
25383,257,2022/4/15 5:30,7,1,6,
25384,257,2022/4/15 5:40,10,1,9,
25385,257,2022/4/15 5:50,15,6,9,
25386,257,2022/4/15 6:00,20,2,18,
25387,257,2022/4/15 6:10,35,13,22,
25388,257,2022/4/15 6:20,42,23,19,
25389,257,2022/4/15 6:30,58,31,27,
25390,257,2022/4/15 6:40,79,29,50,
25391,257,2022/4/15 6:50,84,42,42,
25392,257,2022/4/15 7:00,89,51,38,
25393,257,2022/4/15 7:10,155,64,91,
25394,257,2022/4/15 7:20,200,74,126,
25395,257,2022/4/15 7:30,246,86,160,
25396,257,2022/4/15 7:40,351,87,264,
25397,257,2022/4/15 7:50,326,77,249,
25398,257,2022/4/15 8:00,325,90,235,
25399,257,2022/4/15 8:10,395,98,297,
25400,257,2022/4/15 8:20,326,113,213,
25401,257,2022/4/15 8:30,346,117,229,
25402,257,2022/4/15 8:40,277,119,158,
25403,257,2022/4/15 8:50,253,123,130,
25404,257,2022/4/15 9:00,199,96,103,
25405,257,2022/4/15 9:10,178,90,88,
25406,257,2022/4/15 9:20,116,77,39,
25407,257,2022/4/15 9:30,64,74,-10,
25408,257,2022/4/15 9:40,48,75,-27,
25409,257,2022/4/15 9:50,43,76,-33,
25410,257,2022/4/15 10:00,38,61,-23,
25411,257,2022/4/15 10:10,39,68,-29,
25412,257,2022/4/15 10:20,31,63,-32,
25413,257,2022/4/15 10:30,32,69,-37,
25414,257,2022/4/15 10:40,32,65,-33,
25415,257,2022/4/15 10:50,28,65,-37,
25416,257,2022/4/15 11:00,33,57,-24,
25417,257,2022/4/15 11:10,29,49,-20,
25418,257,2022/4/15 11:20,27,65,-38,
25419,257,2022/4/15 11:30,27,52,-25,
25420,257,2022/4/15 11:40,27,67,-40,
25421,257,2022/4/15 11:50,28,62,-34,
25422,257,2022/4/15 12:00,30,45,-15,
25423,257,2022/4/15 12:10,25,69,-44,
25424,257,2022/4/15 12:20,32,62,-30,
25425,257,2022/4/15 12:30,27,73,-46,
25426,257,2022/4/15 12:40,30,68,-38,
25427,257,2022/4/15 12:50,29,61,-32,
25428,257,2022/4/15 13:00,29,61,-32,
25429,257,2022/4/15 13:10,30,66,-36,
25430,257,2022/4/15 13:20,29,85,-56,
25431,257,2022/4/15 13:30,33,72,-39,
25432,257,2022/4/15 13:40,31,85,-54,
25433,257,2022/4/15 13:50,24,64,-40,
25434,257,2022/4/15 14:00,32,65,-33,
25435,257,2022/4/15 14:10,32,76,-44,
25436,257,2022/4/15 14:20,31,77,-46,
25437,257,2022/4/15 14:30,29,71,-42,
25438,257,2022/4/15 14:40,34,68,-34,
25439,257,2022/4/15 14:50,28,69,-41,
25440,257,2022/4/15 15:00,30,81,-51,
25441,257,2022/4/15 15:10,35,74,-39,
25442,257,2022/4/15 15:20,23,77,-54,
25443,257,2022/4/15 15:30,30,80,-50,
25444,257,2022/4/15 15:40,27,75,-48,
25445,257,2022/4/15 15:50,29,74,-45,
25446,257,2022/4/15 16:00,29,93,-64,
25447,257,2022/4/15 16:10,39,90,-51,
25448,257,2022/4/15 16:20,42,88,-46,
25449,257,2022/4/15 16:30,56,94,-38,
25450,257,2022/4/15 16:40,47,99,-52,
25451,257,2022/4/15 16:50,38,114,-76,
25452,257,2022/4/15 17:00,49,108,-59,
25453,257,2022/4/15 17:10,49,107,-58,
25454,257,2022/4/15 17:20,40,106,-66,
25455,257,2022/4/15 17:30,87,144,-57,
25456,257,2022/4/15 17:40,83,127,-44,
25457,257,2022/4/15 17:50,45,151,-106,
25458,257,2022/4/15 18:00,35,182,-147,
25459,257,2022/4/15 18:10,33,184,-151,
25460,257,2022/4/15 18:20,32,198,-166,
25461,257,2022/4/15 18:30,29,184,-155,
25462,257,2022/4/15 18:40,28,191,-163,
25463,257,2022/4/15 18:50,26,155,-129,
25464,257,2022/4/15 19:00,27,107,-80,
25465,257,2022/4/15 19:10,25,124,-99,
25466,257,2022/4/15 19:20,22,108,-86,
25467,257,2022/4/15 19:30,17,110,-93,
25468,257,2022/4/15 19:40,16,106,-90,
25469,257,2022/4/15 19:50,17,115,-98,
25470,257,2022/4/15 20:00,18,91,-73,
25471,257,2022/4/15 20:10,18,77,-59,
25472,257,2022/4/15 20:20,19,83,-64,
25473,257,2022/4/15 20:30,19,86,-67,
25474,257,2022/4/15 20:40,23,93,-70,
25475,257,2022/4/15 20:50,16,79,-63,
25476,257,2022/4/15 21:00,22,92,-70,
25477,257,2022/4/15 21:10,23,77,-54,
25478,257,2022/4/15 21:20,16,78,-62,
25479,257,2022/4/15 21:30,17,99,-82,
25480,257,2022/4/15 21:40,15,78,-63,
25481,257,2022/4/15 21:50,12,85,-73,
25482,257,2022/4/15 22:00,11,83,-72,
25483,257,2022/4/15 22:10,12,73,-61,
25484,257,2022/4/15 22:20,8,68,-60,
25485,257,2022/4/15 22:30,7,65,-58,
25486,257,2022/4/15 22:40,1,68,-67,
25487,257,2022/4/15 22:50,0,45,-45,
25488,258,2022/4/15 5:00,0,1,-1,
25489,258,2022/4/15 5:10,0,1,-1,
25490,258,2022/4/15 5:20,1,1,0,
25491,258,2022/4/15 5:30,10,1,9,
25492,258,2022/4/15 5:40,24,1,23,
25493,258,2022/4/15 5:50,22,1,21,
25494,258,2022/4/15 6:00,32,6,26,
25495,258,2022/4/15 6:10,40,23,17,
25496,258,2022/4/15 6:20,55,22,33,
25497,258,2022/4/15 6:30,86,41,45,
25498,258,2022/4/15 6:40,174,51,123,
25499,258,2022/4/15 6:50,227,71,156,
25500,258,2022/4/15 7:00,233,77,156,
25501,258,2022/4/15 7:10,281,93,188,
25502,258,2022/4/15 7:20,352,105,247,
25503,258,2022/4/15 7:30,477,98,379,
25504,258,2022/4/15 7:40,691,102,589,
25505,258,2022/4/15 7:50,693,109,584,
25506,258,2022/4/15 8:00,733,111,622,
25507,258,2022/4/15 8:10,869,111,758,
25508,258,2022/4/15 8:20,827,106,721,
25509,258,2022/4/15 8:30,695,113,582,
25510,258,2022/4/15 8:40,631,121,510,
25511,258,2022/4/15 8:50,478,108,370,
25512,258,2022/4/15 9:00,330,94,236,
25513,258,2022/4/15 9:10,273,92,181,
25514,258,2022/4/15 9:20,228,62,166,
25515,258,2022/4/15 9:30,178,76,102,
25516,258,2022/4/15 9:40,137,82,55,
25517,258,2022/4/15 9:50,69,62,7,
25518,258,2022/4/15 10:00,45,71,-26,
25519,258,2022/4/15 10:10,44,72,-28,
25520,258,2022/4/15 10:20,41,68,-27,
25521,258,2022/4/15 10:30,39,59,-20,
25522,258,2022/4/15 10:40,31,68,-37,
25523,258,2022/4/15 10:50,27,63,-36,
25524,258,2022/4/15 11:00,30,67,-37,
25525,258,2022/4/15 11:10,31,65,-34,
25526,258,2022/4/15 11:20,28,62,-34,
25527,258,2022/4/15 11:30,37,72,-35,
25528,258,2022/4/15 11:40,33,61,-28,
25529,258,2022/4/15 11:50,27,66,-39,
25530,258,2022/4/15 12:00,31,72,-41,
25531,258,2022/4/15 12:10,38,65,-27,
25532,258,2022/4/15 12:20,37,72,-35,
25533,258,2022/4/15 12:30,39,70,-31,
25534,258,2022/4/15 12:40,35,74,-39,
25535,258,2022/4/15 12:50,39,67,-28,
25536,258,2022/4/15 13:00,28,66,-38,
25537,258,2022/4/15 13:10,29,69,-40,
25538,258,2022/4/15 13:20,31,70,-39,
25539,258,2022/4/15 13:30,36,67,-31,
25540,258,2022/4/15 13:40,25,71,-46,
25541,258,2022/4/15 13:50,28,63,-35,
25542,258,2022/4/15 14:00,32,70,-38,
25543,258,2022/4/15 14:10,27,73,-46,
25544,258,2022/4/15 14:20,29,74,-45,
25545,258,2022/4/15 14:30,28,71,-43,
25546,258,2022/4/15 14:40,26,85,-59,
25547,258,2022/4/15 14:50,29,83,-54,
25548,258,2022/4/15 15:00,30,78,-48,
25549,258,2022/4/15 15:10,31,76,-45,
25550,258,2022/4/15 15:20,32,90,-58,
25551,258,2022/4/15 15:30,33,75,-42,
25552,258,2022/4/15 15:40,30,103,-73,
25553,258,2022/4/15 15:50,35,106,-71,
25554,258,2022/4/15 16:00,38,93,-55,
25555,258,2022/4/15 16:10,40,105,-65,
25556,258,2022/4/15 16:20,32,108,-76,
25557,258,2022/4/15 16:30,45,104,-59,
25558,258,2022/4/15 16:40,46,124,-78,
25559,258,2022/4/15 16:50,46,109,-63,
25560,258,2022/4/15 17:00,66,107,-41,
25561,258,2022/4/15 17:10,77,108,-31,
25562,258,2022/4/15 17:20,47,191,-144,
25563,258,2022/4/15 17:30,45,217,-172,
25564,258,2022/4/15 17:40,47,326,-279,
25565,258,2022/4/15 17:50,45,255,-210,
25566,258,2022/4/15 18:00,47,335,-288,
25567,258,2022/4/15 18:10,57,325,-268,
25568,258,2022/4/15 18:20,35,326,-291,
25569,258,2022/4/15 18:30,30,348,-318,
25570,258,2022/4/15 18:40,35,347,-312,
25571,258,2022/4/15 18:50,23,328,-305,
25572,258,2022/4/15 19:00,30,197,-167,
25573,258,2022/4/15 19:10,26,219,-193,
25574,258,2022/4/15 19:20,23,170,-147,
25575,258,2022/4/15 19:30,25,119,-94,
25576,258,2022/4/15 19:40,27,103,-76,
25577,258,2022/4/15 19:50,21,103,-82,
25578,258,2022/4/15 20:00,22,119,-97,
25579,258,2022/4/15 20:10,22,106,-84,
25580,258,2022/4/15 20:20,24,104,-80,
25581,258,2022/4/15 20:30,22,124,-102,
25582,258,2022/4/15 20:40,27,109,-82,
25583,258,2022/4/15 20:50,22,123,-101,
25584,258,2022/4/15 21:00,21,110,-89,
25585,258,2022/4/15 21:10,23,117,-94,
25586,258,2022/4/15 21:20,23,115,-92,
25587,258,2022/4/15 21:30,17,127,-110,
25588,258,2022/4/15 21:40,15,103,-88,
25589,258,2022/4/15 21:50,14,102,-88,
25590,258,2022/4/15 22:00,13,106,-93,
25591,258,2022/4/15 22:10,12,94,-82,
25592,258,2022/4/15 22:20,9,95,-86,
25593,258,2022/4/15 22:30,7,103,-96,
25594,258,2022/4/15 22:40,3,82,-79,
25595,258,2022/4/15 22:50,2,50,-48,
25596,239,2022/4/15 5:00,0,1,-1,
25597,239,2022/4/15 5:10,0,1,-1,
25598,239,2022/4/15 5:20,0,1,-1,
25599,239,2022/4/15 5:30,0,1,-1,
25600,239,2022/4/15 5:40,1,1,0,
25601,239,2022/4/15 5:50,1,5,-4,
25602,239,2022/4/15 6:00,3,1,2,
25603,239,2022/4/15 6:10,3,8,-5,
25604,239,2022/4/15 6:20,5,6,-1,
25605,239,2022/4/15 6:30,12,14,-2,
25606,239,2022/4/15 6:40,8,19,-11,
25607,239,2022/4/15 6:50,12,21,-9,
25608,239,2022/4/15 7:00,19,21,-2,
25609,239,2022/4/15 7:10,17,23,-6,
25610,239,2022/4/15 7:20,18,33,-15,
25611,239,2022/4/15 7:30,21,39,-18,
25612,239,2022/4/15 7:40,25,46,-21,
25613,239,2022/4/15 7:50,32,62,-30,
25614,239,2022/4/15 8:00,31,75,-44,
25615,239,2022/4/15 8:10,31,98,-67,
25616,239,2022/4/15 8:20,29,105,-76,
25617,239,2022/4/15 8:30,30,107,-77,
25618,239,2022/4/15 8:40,28,122,-94,
25619,239,2022/4/15 8:50,25,116,-91,
25620,239,2022/4/15 9:00,23,86,-63,
25621,239,2022/4/15 9:10,18,68,-50,
25622,239,2022/4/15 9:20,15,61,-46,
25623,239,2022/4/15 9:30,10,62,-52,
25624,239,2022/4/15 9:40,8,73,-65,
25625,239,2022/4/15 9:50,6,61,-55,
25626,239,2022/4/15 10:00,9,41,-32,
25627,239,2022/4/15 10:10,9,34,-25,
25628,239,2022/4/15 10:20,7,32,-25,
25629,239,2022/4/15 10:30,8,23,-15,
25630,239,2022/4/15 10:40,9,23,-14,
25631,239,2022/4/15 10:50,8,23,-15,
25632,239,2022/4/15 11:00,7,23,-16,
25633,239,2022/4/15 11:10,5,16,-11,
25634,239,2022/4/15 11:20,7,23,-16,
25635,239,2022/4/15 11:30,9,23,-14,
25636,239,2022/4/15 11:40,8,19,-11,
25637,239,2022/4/15 11:50,7,21,-14,
25638,239,2022/4/15 12:00,7,19,-12,
25639,239,2022/4/15 12:10,9,19,-10,
25640,239,2022/4/15 12:20,8,19,-11,
25641,239,2022/4/15 12:30,11,21,-10,
25642,239,2022/4/15 12:40,9,19,-10,
25643,239,2022/4/15 12:50,7,23,-16,
25644,239,2022/4/15 13:00,8,29,-21,
25645,239,2022/4/15 13:10,9,14,-5,
25646,239,2022/4/15 13:20,7,23,-16,
25647,239,2022/4/15 13:30,8,29,-21,
25648,239,2022/4/15 13:40,6,23,-17,
25649,239,2022/4/15 13:50,9,23,-14,
25650,239,2022/4/15 14:00,8,22,-14,
25651,239,2022/4/15 14:10,9,22,-13,
25652,239,2022/4/15 14:20,6,25,-19,
25653,239,2022/4/15 14:30,8,23,-15,
25654,239,2022/4/15 14:40,8,23,-15,
25655,239,2022/4/15 14:50,8,19,-11,
25656,239,2022/4/15 15:00,10,12,-2,
25657,239,2022/4/15 15:10,11,25,-14,
25658,239,2022/4/15 15:20,8,23,-15,
25659,239,2022/4/15 15:30,8,23,-15,
25660,239,2022/4/15 15:40,10,19,-9,
25661,239,2022/4/15 15:50,11,21,-10,
25662,239,2022/4/15 16:00,13,23,-10,
25663,239,2022/4/15 16:10,10,23,-13,
25664,239,2022/4/15 16:20,13,23,-10,
25665,239,2022/4/15 16:30,11,31,-20,
25666,239,2022/4/15 16:40,13,21,-8,
25667,239,2022/4/15 16:50,17,23,-6,
25668,239,2022/4/15 17:00,21,25,-4,
25669,239,2022/4/15 17:10,28,38,-10,
25670,239,2022/4/15 17:20,29,52,-23,
25671,239,2022/4/15 17:30,38,45,-7,
25672,239,2022/4/15 17:40,43,45,-2,
25673,239,2022/4/15 17:50,27,51,-24,
25674,239,2022/4/15 18:00,29,50,-21,
25675,239,2022/4/15 18:10,33,53,-20,
25676,239,2022/4/15 18:20,37,49,-12,
25677,239,2022/4/15 18:30,36,49,-13,
25678,239,2022/4/15 18:40,37,52,-15,
25679,239,2022/4/15 18:50,29,50,-21,
25680,239,2022/4/15 19:00,23,41,-18,
25681,239,2022/4/15 19:10,12,25,-13,
25682,239,2022/4/15 19:20,18,25,-7,
25683,239,2022/4/15 19:30,18,25,-7,
25684,239,2022/4/15 19:40,10,25,-15,
25685,239,2022/4/15 19:50,12,23,-11,
25686,239,2022/4/15 20:00,10,21,-11,
25687,239,2022/4/15 20:10,14,22,-8,
25688,239,2022/4/15 20:20,11,21,-10,
25689,239,2022/4/15 20:30,12,21,-9,
25690,239,2022/4/15 20:40,7,21,-14,
25691,239,2022/4/15 20:50,7,15,-8,
25692,239,2022/4/15 21:00,7,18,-11,
25693,239,2022/4/15 21:10,6,18,-12,
25694,239,2022/4/15 21:20,6,19,-13,
25695,239,2022/4/15 21:30,5,15,-10,
25696,239,2022/4/15 21:40,2,15,-13,
25697,239,2022/4/15 21:50,2,18,-16,
25698,239,2022/4/15 22:00,2,15,-13,
25699,239,2022/4/15 22:10,2,7,-5,
25700,239,2022/4/15 22:20,2,18,-16,
25701,239,2022/4/15 22:30,1,8,-7,
25702,239,2022/4/15 22:40,2,13,-11,
25703,239,2022/4/15 22:50,1,8,-7,
25704,245,2022/4/15 5:00,0,1,-1,
25705,245,2022/4/15 5:10,0,1,-1,
25706,245,2022/4/15 5:20,0,1,-1,
25707,245,2022/4/15 5:30,1,1,0,
25708,245,2022/4/15 5:40,6,1,5,
25709,245,2022/4/15 5:50,13,5,8,
25710,245,2022/4/15 6:00,16,23,-7,
25711,245,2022/4/15 6:10,18,23,-5,
25712,245,2022/4/15 6:20,21,34,-13,
25713,245,2022/4/15 6:30,24,52,-28,
25714,245,2022/4/15 6:40,36,62,-26,
25715,245,2022/4/15 6:50,38,51,-13,
25716,245,2022/4/15 7:00,38,79,-41,
25717,245,2022/4/15 7:10,48,80,-32,
25718,245,2022/4/15 7:20,59,93,-34,
25719,245,2022/4/15 7:30,83,110,-27,
25720,245,2022/4/15 7:40,78,109,-31,
25721,245,2022/4/15 7:50,113,123,-10,
25722,245,2022/4/15 8:00,181,230,-49,
25723,245,2022/4/15 8:10,163,267,-104,
25724,245,2022/4/15 8:20,127,206,-79,
25725,245,2022/4/15 8:30,102,322,-220,
25726,245,2022/4/15 8:40,86,493,-407,
25727,245,2022/4/15 8:50,82,378,-296,
25728,245,2022/4/15 9:00,60,284,-224,
25729,245,2022/4/15 9:10,52,184,-132,
25730,245,2022/4/15 9:20,46,284,-238,
25731,245,2022/4/15 9:30,40,140,-100,
25732,245,2022/4/15 9:40,28,109,-81,
25733,245,2022/4/15 9:50,34,105,-71,
25734,245,2022/4/15 10:00,31,106,-75,
25735,245,2022/4/15 10:10,30,96,-66,
25736,245,2022/4/15 10:20,27,82,-55,
25737,245,2022/4/15 10:30,26,77,-51,
25738,245,2022/4/15 10:40,28,78,-50,
25739,245,2022/4/15 10:50,25,82,-57,
25740,245,2022/4/15 11:00,27,65,-38,
25741,245,2022/4/15 11:10,29,64,-35,
25742,245,2022/4/15 11:20,26,65,-39,
25743,245,2022/4/15 11:30,30,67,-37,
25744,245,2022/4/15 11:40,26,69,-43,
25745,245,2022/4/15 11:50,32,66,-34,
25746,245,2022/4/15 12:00,31,70,-39,
25747,245,2022/4/15 12:10,31,74,-43,
25748,245,2022/4/15 12:20,31,76,-45,
25749,245,2022/4/15 12:30,32,82,-50,
25750,245,2022/4/15 12:40,30,77,-47,
25751,245,2022/4/15 12:50,25,67,-42,
25752,245,2022/4/15 13:00,32,73,-41,
25753,245,2022/4/15 13:10,32,82,-50,
25754,245,2022/4/15 13:20,28,76,-48,
25755,245,2022/4/15 13:30,31,82,-51,
25756,245,2022/4/15 13:40,32,78,-46,
25757,245,2022/4/15 13:50,32,65,-33,
25758,245,2022/4/15 14:00,32,85,-53,
25759,245,2022/4/15 14:10,32,73,-41,
25760,245,2022/4/15 14:20,30,84,-54,
25761,245,2022/4/15 14:30,26,82,-56,
25762,245,2022/4/15 14:40,33,61,-28,
25763,245,2022/4/15 14:50,37,62,-25,
25764,245,2022/4/15 15:00,36,69,-33,
25765,245,2022/4/15 15:10,40,76,-36,
25766,245,2022/4/15 15:20,37,68,-31,
25767,245,2022/4/15 15:30,39,69,-30,
25768,245,2022/4/15 15:40,42,71,-29,
25769,245,2022/4/15 15:50,38,73,-35,
25770,245,2022/4/15 16:00,45,76,-31,
25771,245,2022/4/15 16:10,45,70,-25,
25772,245,2022/4/15 16:20,45,84,-39,
25773,245,2022/4/15 16:30,45,75,-30,
25774,245,2022/4/15 16:40,60,90,-30,
25775,245,2022/4/15 16:50,66,90,-24,
25776,245,2022/4/15 17:00,213,90,123,
25777,245,2022/4/15 17:10,346,92,254,
25778,245,2022/4/15 17:20,208,105,103,
25779,245,2022/4/15 17:30,214,123,91,
25780,245,2022/4/15 17:40,267,119,148,
25781,245,2022/4/15 17:50,176,123,53,
25782,245,2022/4/15 18:00,214,116,98,
25783,245,2022/4/15 18:10,378,104,274,
25784,245,2022/4/15 18:20,232,124,108,
25785,245,2022/4/15 18:30,169,104,65,
25786,245,2022/4/15 18:40,175,123,52,
25787,245,2022/4/15 18:50,118,111,7,
25788,245,2022/4/15 19:00,76,125,-49,
25789,245,2022/4/15 19:10,61,92,-31,
25790,245,2022/4/15 19:20,44,80,-36,
25791,245,2022/4/15 19:30,44,85,-41,
25792,245,2022/4/15 19:40,37,76,-39,
25793,245,2022/4/15 19:50,38,75,-37,
25794,245,2022/4/15 20:00,35,68,-33,
25795,245,2022/4/15 20:10,41,57,-16,
25796,245,2022/4/15 20:20,32,68,-36,
25797,245,2022/4/15 20:30,32,64,-32,
25798,245,2022/4/15 20:40,30,66,-36,
25799,245,2022/4/15 20:50,30,74,-44,
25800,245,2022/4/15 21:00,32,62,-30,
25801,245,2022/4/15 21:10,34,60,-26,
25802,245,2022/4/15 21:20,34,67,-33,
25803,245,2022/4/15 21:30,25,70,-45,
25804,245,2022/4/15 21:40,33,62,-29,
25805,245,2022/4/15 21:50,37,65,-28,
25806,245,2022/4/15 22:00,34,55,-21,
25807,245,2022/4/15 22:10,28,52,-24,
25808,245,2022/4/15 22:20,16,49,-33,
25809,245,2022/4/15 22:30,13,50,-37,
25810,245,2022/4/15 22:40,7,51,-44,
25811,245,2022/4/15 22:50,3,27,-24,
25812,236,2022/4/15 5:00,0,1,-1,
25813,236,2022/4/15 5:10,0,1,-1,
25814,236,2022/4/15 5:20,1,1,0,
25815,236,2022/4/15 5:30,2,1,1,
25816,236,2022/4/15 5:40,3,1,2,
25817,236,2022/4/15 5:50,4,21,-17,
25818,236,2022/4/15 6:00,6,38,-32,
25819,236,2022/4/15 6:10,8,31,-23,
25820,236,2022/4/15 6:20,14,60,-46,
25821,236,2022/4/15 6:30,18,72,-54,
25822,236,2022/4/15 6:40,18,99,-81,
25823,236,2022/4/15 6:50,20,110,-90,
25824,236,2022/4/15 7:00,28,126,-98,
25825,236,2022/4/15 7:10,31,111,-80,
25826,236,2022/4/15 7:20,33,110,-77,
25827,236,2022/4/15 7:30,37,119,-82,
25828,236,2022/4/15 7:40,44,182,-138,
25829,236,2022/4/15 7:50,46,148,-102,
25830,236,2022/4/15 8:00,52,144,-92,
25831,236,2022/4/15 8:10,53,169,-116,
25832,236,2022/4/15 8:20,57,104,-47,
25833,236,2022/4/15 8:30,60,109,-49,
25834,236,2022/4/15 8:40,53,109,-56,
25835,236,2022/4/15 8:50,68,108,-40,
25836,236,2022/4/15 9:00,57,110,-53,
25837,236,2022/4/15 9:10,59,102,-43,
25838,236,2022/4/15 9:20,49,125,-76,
25839,236,2022/4/15 9:30,60,104,-44,
25840,236,2022/4/15 9:40,54,85,-31,
25841,236,2022/4/15 9:50,56,104,-48,
25842,236,2022/4/15 10:00,44,101,-57,
25843,236,2022/4/15 10:10,53,106,-53,
25844,236,2022/4/15 10:20,54,87,-33,
25845,236,2022/4/15 10:30,48,91,-43,
25846,236,2022/4/15 10:40,51,87,-36,
25847,236,2022/4/15 10:50,43,77,-34,
25848,236,2022/4/15 11:00,54,63,-9,
25849,236,2022/4/15 11:10,44,67,-23,
25850,236,2022/4/15 11:20,50,64,-14,
25851,236,2022/4/15 11:30,43,73,-30,
25852,236,2022/4/15 11:40,46,69,-23,
25853,236,2022/4/15 11:50,43,76,-33,
25854,236,2022/4/15 12:00,41,73,-32,
25855,236,2022/4/15 12:10,40,73,-33,
25856,236,2022/4/15 12:20,37,74,-37,
25857,236,2022/4/15 12:30,37,91,-54,
25858,236,2022/4/15 12:40,33,92,-59,
25859,236,2022/4/15 12:50,29,96,-67,
25860,236,2022/4/15 13:00,37,93,-56,
25861,236,2022/4/15 13:10,29,90,-61,
25862,236,2022/4/15 13:20,37,104,-67,
25863,236,2022/4/15 13:30,35,90,-55,
25864,236,2022/4/15 13:40,39,90,-51,
25865,236,2022/4/15 13:50,43,87,-44,
25866,236,2022/4/15 14:00,44,85,-41,
25867,236,2022/4/15 14:10,47,84,-37,
25868,236,2022/4/15 14:20,47,85,-38,
25869,236,2022/4/15 14:30,46,92,-46,
25870,236,2022/4/15 14:40,54,77,-23,
25871,236,2022/4/15 14:50,47,70,-23,
25872,236,2022/4/15 15:00,63,64,-1,
25873,236,2022/4/15 15:10,53,74,-21,
25874,236,2022/4/15 15:20,62,69,-7,
25875,236,2022/4/15 15:30,59,75,-16,
25876,236,2022/4/15 15:40,61,63,-2,
25877,236,2022/4/15 15:50,59,60,-1,
25878,236,2022/4/15 16:00,73,74,-1,
25879,236,2022/4/15 16:10,62,62,0,
25880,236,2022/4/15 16:20,68,70,-2,
25881,236,2022/4/15 16:30,70,64,6,
25882,236,2022/4/15 16:40,74,64,10,
25883,236,2022/4/15 16:50,73,64,9,
25884,236,2022/4/15 17:00,133,67,66,
25885,236,2022/4/15 17:10,156,62,94,
25886,236,2022/4/15 17:20,76,77,-1,
25887,236,2022/4/15 17:30,67,76,-9,
25888,236,2022/4/15 17:40,65,88,-23,
25889,236,2022/4/15 17:50,48,77,-29,
25890,236,2022/4/15 18:00,43,95,-52,
25891,236,2022/4/15 18:10,38,106,-68,
25892,236,2022/4/15 18:20,36,89,-53,
25893,236,2022/4/15 18:30,31,93,-62,
25894,236,2022/4/15 18:40,35,91,-56,
25895,236,2022/4/15 18:50,31,90,-59,
25896,236,2022/4/15 19:00,28,77,-49,
25897,236,2022/4/15 19:10,28,70,-42,
25898,236,2022/4/15 19:20,29,66,-37,
25899,236,2022/4/15 19:30,28,67,-39,
25900,236,2022/4/15 19:40,29,55,-26,
25901,236,2022/4/15 19:50,26,63,-37,
25902,236,2022/4/15 20:00,29,59,-30,
25903,236,2022/4/15 20:10,30,53,-23,
25904,236,2022/4/15 20:20,29,54,-25,
25905,236,2022/4/15 20:30,30,54,-24,
25906,236,2022/4/15 20:40,28,50,-22,
25907,236,2022/4/15 20:50,25,63,-38,
25908,236,2022/4/15 21:00,22,55,-33,
25909,236,2022/4/15 21:10,22,46,-24,
25910,236,2022/4/15 21:20,22,56,-34,
25911,236,2022/4/15 21:30,15,57,-42,
25912,236,2022/4/15 21:40,16,52,-36,
25913,236,2022/4/15 21:50,13,52,-39,
25914,236,2022/4/15 22:00,16,43,-27,
25915,236,2022/4/15 22:10,13,48,-35,
25916,236,2022/4/15 22:20,10,40,-30,
25917,236,2022/4/15 22:30,6,43,-37,
25918,236,2022/4/15 22:40,4,25,-21,
25919,236,2022/4/15 22:50,2,23,-21,
25920,260,2022/4/15 5:00,0,1,-1,
25921,260,2022/4/15 5:10,0,1,-1,
25922,260,2022/4/15 5:20,1,1,0,
25923,260,2022/4/15 5:30,3,1,2,
25924,260,2022/4/15 5:40,9,1,8,
25925,260,2022/4/15 5:50,17,19,-2,
25926,260,2022/4/15 6:00,19,50,-31,
25927,260,2022/4/15 6:10,21,62,-41,
25928,260,2022/4/15 6:20,27,93,-66,
25929,260,2022/4/15 6:30,36,112,-76,
25930,260,2022/4/15 6:40,40,152,-112,
25931,260,2022/4/15 6:50,49,153,-104,
25932,260,2022/4/15 7:00,63,230,-167,
25933,260,2022/4/15 7:10,75,297,-222,
25934,260,2022/4/15 7:20,84,321,-237,
25935,260,2022/4/15 7:30,148,502,-354,
25936,260,2022/4/15 7:40,184,497,-313,
25937,260,2022/4/15 7:50,234,586,-352,
25938,260,2022/4/15 8:00,244,1104,-860,
25939,260,2022/4/15 8:10,265,1618,-1353,
25940,260,2022/4/15 8:20,282,1555,-1273,
25941,260,2022/4/15 8:30,283,1832,-1549,
25942,260,2022/4/15 8:40,239,2834,-2595,
25943,260,2022/4/15 8:50,234,2622,-2388,
25944,260,2022/4/15 9:00,240,1663,-1423,
25945,260,2022/4/15 9:10,220,615,-395,
25946,260,2022/4/15 9:20,219,563,-344,
25947,260,2022/4/15 9:30,211,503,-292,
25948,260,2022/4/15 9:40,192,326,-134,
25949,260,2022/4/15 9:50,180,385,-205,
25950,260,2022/4/15 10:00,174,256,-82,
25951,260,2022/4/15 10:10,173,222,-49,
25952,260,2022/4/15 10:20,169,192,-23,
25953,260,2022/4/15 10:30,150,119,31,
25954,260,2022/4/15 10:40,161,117,44,
25955,260,2022/4/15 10:50,174,121,53,
25956,260,2022/4/15 11:00,173,108,65,
25957,260,2022/4/15 11:10,173,122,51,
25958,260,2022/4/15 11:20,180,105,75,
25959,260,2022/4/15 11:30,187,117,70,
25960,260,2022/4/15 11:40,184,122,62,
25961,260,2022/4/15 11:50,174,123,51,
25962,260,2022/4/15 12:00,170,109,61,
25963,260,2022/4/15 12:10,159,88,71,
25964,260,2022/4/15 12:20,141,128,13,
25965,260,2022/4/15 12:30,129,108,21,
25966,260,2022/4/15 12:40,112,152,-40,
25967,260,2022/4/15 12:50,103,178,-75,
25968,260,2022/4/15 13:00,138,193,-55,
25969,260,2022/4/15 13:10,143,144,-1,
25970,260,2022/4/15 13:20,147,153,-6,
25971,260,2022/4/15 13:30,154,180,-26,
25972,260,2022/4/15 13:40,176,179,-3,
25973,260,2022/4/15 13:50,169,140,29,
25974,260,2022/4/15 14:00,175,108,67,
25975,260,2022/4/15 14:10,185,109,76,
25976,260,2022/4/15 14:20,199,108,91,
25977,260,2022/4/15 14:30,207,119,88,
25978,260,2022/4/15 14:40,207,125,82,
25979,260,2022/4/15 14:50,207,109,98,
25980,260,2022/4/15 15:00,223,113,110,
25981,260,2022/4/15 15:10,262,127,135,
25982,260,2022/4/15 15:20,267,118,149,
25983,260,2022/4/15 15:30,265,122,143,
25984,260,2022/4/15 15:40,258,105,153,
25985,260,2022/4/15 15:50,273,109,164,
25986,260,2022/4/15 16:00,274,125,149,
25987,260,2022/4/15 16:10,271,124,147,
25988,260,2022/4/15 16:20,336,124,212,
25989,260,2022/4/15 16:30,355,122,233,
25990,260,2022/4/15 16:40,378,123,255,
25991,260,2022/4/15 16:50,312,121,191,
25992,260,2022/4/15 17:00,805,125,680,
25993,260,2022/4/15 17:10,1350,123,1227,
25994,260,2022/4/15 17:20,1028,118,910,
25995,260,2022/4/15 17:30,1031,149,882,
25996,260,2022/4/15 17:40,1356,178,1178,
25997,260,2022/4/15 17:50,831,158,673,
25998,260,2022/4/15 18:00,800,179,621,
25999,260,2022/4/15 18:10,1206,226,980,
26000,260,2022/4/15 18:20,711,170,541,
26001,260,2022/4/15 18:30,578,178,400,
26002,260,2022/4/15 18:40,352,153,199,
26003,260,2022/4/15 18:50,294,117,177,
26004,260,2022/4/15 19:00,225,114,111,
26005,260,2022/4/15 19:10,231,104,127,
26006,260,2022/4/15 19:20,192,106,86,
26007,260,2022/4/15 19:30,176,114,62,
26008,260,2022/4/15 19:40,159,99,60,
26009,260,2022/4/15 19:50,172,99,73,
26010,260,2022/4/15 20:00,157,91,66,
26011,260,2022/4/15 20:10,166,77,89,
26012,260,2022/4/15 20:20,164,79,85,
26013,260,2022/4/15 20:30,133,88,45,
26014,260,2022/4/15 20:40,113,77,36,
26015,260,2022/4/15 20:50,74,86,-12,
26016,260,2022/4/15 21:00,103,79,24,
26017,260,2022/4/15 21:10,85,85,0,
26018,260,2022/4/15 21:20,77,86,-9,
26019,260,2022/4/15 21:30,70,77,-7,
26020,260,2022/4/15 21:40,66,75,-9,
26021,260,2022/4/15 21:50,44,82,-38,
26022,260,2022/4/15 22:00,44,72,-28,
26023,260,2022/4/15 22:10,38,71,-33,
26024,260,2022/4/15 22:20,30,76,-46,
26025,260,2022/4/15 22:30,31,64,-33,
26026,260,2022/4/15 22:40,28,51,-23,
26027,260,2022/4/15 22:50,8,64,-56,
26028,232,2022/4/15 5:00,0,1,-1,
26029,232,2022/4/15 5:10,0,1,-1,
26030,232,2022/4/15 5:20,0,1,-1,
26031,232,2022/4/15 5:30,3,1,2,
26032,232,2022/4/15 5:40,3,2,1,
26033,232,2022/4/15 5:50,12,6,6,
26034,232,2022/4/15 6:00,12,61,-49,
26035,232,2022/4/15 6:10,15,62,-47,
26036,232,2022/4/15 6:20,22,70,-48,
26037,232,2022/4/15 6:30,23,76,-53,
26038,232,2022/4/15 6:40,30,110,-80,
26039,232,2022/4/15 6:50,34,123,-89,
26040,232,2022/4/15 7:00,46,150,-104,
26041,232,2022/4/15 7:10,44,211,-167,
26042,232,2022/4/15 7:20,45,297,-252,
26043,232,2022/4/15 7:30,45,327,-282,
26044,232,2022/4/15 7:40,57,441,-384,
26045,232,2022/4/15 7:50,79,507,-428,
26046,232,2022/4/15 8:00,84,414,-330,
26047,232,2022/4/15 8:10,82,591,-509,
26048,232,2022/4/15 8:20,128,478,-350,
26049,232,2022/4/15 8:30,93,591,-498,
26050,232,2022/4/15 8:40,112,1725,-1613,
26051,232,2022/4/15 8:50,93,1677,-1584,
26052,232,2022/4/15 9:00,82,1186,-1104,
26053,232,2022/4/15 9:10,79,486,-407,
26054,232,2022/4/15 9:20,79,424,-345,
26055,232,2022/4/15 9:30,73,425,-352,
26056,232,2022/4/15 9:40,71,428,-357,
26057,232,2022/4/15 9:50,68,345,-277,
26058,232,2022/4/15 10:00,73,318,-245,
26059,232,2022/4/15 10:10,75,223,-148,
26060,232,2022/4/15 10:20,69,171,-102,
26061,232,2022/4/15 10:30,82,179,-97,
26062,232,2022/4/15 10:40,75,139,-64,
26063,232,2022/4/15 10:50,66,122,-56,
26064,232,2022/4/15 11:00,70,111,-41,
26065,232,2022/4/15 11:10,67,105,-38,
26066,232,2022/4/15 11:20,66,114,-48,
26067,232,2022/4/15 11:30,75,105,-30,
26068,232,2022/4/15 11:40,73,111,-38,
26069,232,2022/4/15 11:50,73,87,-14,
26070,232,2022/4/15 12:00,71,105,-34,
26071,232,2022/4/15 12:10,74,105,-31,
26072,232,2022/4/15 12:20,68,105,-37,
26073,232,2022/4/15 12:30,67,118,-51,
26074,232,2022/4/15 12:40,55,101,-46,
26075,232,2022/4/15 12:50,44,117,-73,
26076,232,2022/4/15 13:00,46,121,-75,
26077,232,2022/4/15 13:10,46,108,-62,
26078,232,2022/4/15 13:20,47,110,-63,
26079,232,2022/4/15 13:30,55,104,-49,
26080,232,2022/4/15 13:40,62,109,-47,
26081,232,2022/4/15 13:50,70,122,-52,
26082,232,2022/4/15 14:00,71,109,-38,
26083,232,2022/4/15 14:10,94,123,-29,
26084,232,2022/4/15 14:20,131,103,28,
26085,232,2022/4/15 14:30,116,105,11,
26086,232,2022/4/15 14:40,139,111,28,
26087,232,2022/4/15 14:50,135,112,23,
26088,232,2022/4/15 15:00,136,103,33,
26089,232,2022/4/15 15:10,176,102,74,
26090,232,2022/4/15 15:20,190,112,78,
26091,232,2022/4/15 15:30,163,110,53,
26092,232,2022/4/15 15:40,184,99,85,
26093,232,2022/4/15 15:50,188,105,83,
26094,232,2022/4/15 16:00,223,101,122,
26095,232,2022/4/15 16:10,227,90,137,
26096,232,2022/4/15 16:20,244,101,143,
26097,232,2022/4/15 16:30,255,93,162,
26098,232,2022/4/15 16:40,336,93,243,
26099,232,2022/4/15 16:50,378,93,285,
26100,232,2022/4/15 17:00,568,100,468,
26101,232,2022/4/15 17:10,658,106,552,
26102,232,2022/4/15 17:20,571,105,466,
26103,232,2022/4/15 17:30,696,105,591,
26104,232,2022/4/15 17:40,1038,125,913,
26105,232,2022/4/15 17:50,608,121,487,
26106,232,2022/4/15 18:00,639,111,528,
26107,232,2022/4/15 18:10,1034,117,917,
26108,232,2022/4/15 18:20,714,104,610,
26109,232,2022/4/15 18:30,615,105,510,
26110,232,2022/4/15 18:40,551,110,441,
26111,232,2022/4/15 18:50,350,105,245,
26112,232,2022/4/15 19:00,273,120,153,
26113,232,2022/4/15 19:10,262,111,151,
26114,232,2022/4/15 19:20,212,95,117,
26115,232,2022/4/15 19:30,176,98,78,
26116,232,2022/4/15 19:40,138,79,59,
26117,232,2022/4/15 19:50,111,87,24,
26118,232,2022/4/15 20:00,88,72,16,
26119,232,2022/4/15 20:10,142,73,69,
26120,232,2022/4/15 20:20,86,74,12,
26121,232,2022/4/15 20:30,79,74,5,
26122,232,2022/4/15 20:40,73,70,3,
26123,232,2022/4/15 20:50,70,68,2,
26124,232,2022/4/15 21:00,70,67,3,
26125,232,2022/4/15 21:10,80,70,10,
26126,232,2022/4/15 21:20,62,70,-8,
26127,232,2022/4/15 21:30,68,61,7,
26128,232,2022/4/15 21:40,64,67,-3,
26129,232,2022/4/15 21:50,47,59,-12,
26130,232,2022/4/15 22:00,44,53,-9,
26131,232,2022/4/15 22:10,53,66,-13,
26132,232,2022/4/15 22:20,39,58,-19,
26133,232,2022/4/15 22:30,23,47,-24,
26134,232,2022/4/15 22:40,35,49,-14,
26135,232,2022/4/15 22:50,19,35,-16,
26136,242,2022/4/15 5:00,0,1,-1,
26137,242,2022/4/15 5:10,0,1,-1,
26138,242,2022/4/15 5:20,0,1,-1,
26139,242,2022/4/15 5:30,6,1,5,
26140,242,2022/4/15 5:40,8,1,7,
26141,242,2022/4/15 5:50,16,2,14,
26142,242,2022/4/15 6:00,15,47,-32,
26143,242,2022/4/15 6:10,15,65,-50,
26144,242,2022/4/15 6:20,16,68,-52,
26145,242,2022/4/15 6:30,20,82,-62,
26146,242,2022/4/15 6:40,25,106,-81,
26147,242,2022/4/15 6:50,27,116,-89,
26148,242,2022/4/15 7:00,32,115,-83,
26149,242,2022/4/15 7:10,42,267,-225,
26150,242,2022/4/15 7:20,37,253,-216,
26151,242,2022/4/15 7:30,35,298,-263,
26152,242,2022/4/15 7:40,43,334,-291,
26153,242,2022/4/15 7:50,45,534,-489,
26154,242,2022/4/15 8:00,54,682,-628,
26155,242,2022/4/15 8:10,61,1803,-1742,
26156,242,2022/4/15 8:20,66,3188,-3122,
26157,242,2022/4/15 8:30,57,3046,-2989,
26158,242,2022/4/15 8:40,52,8117,-8065,
26159,242,2022/4/15 8:50,50,6447,-6397,
26160,242,2022/4/15 9:00,45,2963,-2918,
26161,242,2022/4/15 9:10,46,3536,-3490,
26162,242,2022/4/15 9:20,43,3313,-3270,
26163,242,2022/4/15 9:30,38,2224,-2186,
26164,242,2022/4/15 9:40,38,811,-773,
26165,242,2022/4/15 9:50,37,576,-539,
26166,242,2022/4/15 10:00,36,385,-349,
26167,242,2022/4/15 10:10,43,297,-254,
26168,242,2022/4/15 10:20,40,297,-257,
26169,242,2022/4/15 10:30,43,179,-136,
26170,242,2022/4/15 10:40,45,143,-98,
26171,242,2022/4/15 10:50,43,183,-140,
26172,242,2022/4/15 11:00,45,182,-137,
26173,242,2022/4/15 11:10,47,118,-71,
26174,242,2022/4/15 11:20,43,111,-68,
26175,242,2022/4/15 11:30,54,109,-55,
26176,242,2022/4/15 11:40,57,143,-86,
26177,242,2022/4/15 11:50,61,110,-49,
26178,242,2022/4/15 12:00,65,112,-47,
26179,242,2022/4/15 12:10,73,105,-32,
26180,242,2022/4/15 12:20,74,122,-48,
26181,242,2022/4/15 12:30,64,120,-56,
26182,242,2022/4/15 12:40,70,152,-82,
26183,242,2022/4/15 12:50,69,181,-112,
26184,242,2022/4/15 13:00,74,139,-65,
26185,242,2022/4/15 13:10,103,121,-18,
26186,242,2022/4/15 13:20,79,110,-31,
26187,242,2022/4/15 13:30,79,128,-49,
26188,242,2022/4/15 13:40,82,144,-62,
26189,242,2022/4/15 13:50,85,117,-32,
26190,242,2022/4/15 14:00,110,110,0,
26191,242,2022/4/15 14:10,132,119,13,
26192,242,2022/4/15 14:20,135,107,28,
26193,242,2022/4/15 14:30,128,120,8,
26194,242,2022/4/15 14:40,94,114,-20,
26195,242,2022/4/15 14:50,129,122,7,
26196,242,2022/4/15 15:00,149,109,40,
26197,242,2022/4/15 15:10,157,101,56,
26198,242,2022/4/15 15:20,172,123,49,
26199,242,2022/4/15 15:30,183,102,81,
26200,242,2022/4/15 15:40,200,119,81,
26201,242,2022/4/15 15:50,202,126,76,
26202,242,2022/4/15 16:00,224,108,116,
26203,242,2022/4/15 16:10,262,103,159,
26204,242,2022/4/15 16:20,263,103,160,
26205,242,2022/4/15 16:30,263,98,165,
26206,242,2022/4/15 16:40,336,118,218,
26207,242,2022/4/15 16:50,335,107,228,
26208,242,2022/4/15 17:00,610,119,491,
26209,242,2022/4/15 17:10,1035,121,914,
26210,242,2022/4/15 17:20,719,122,597,
26211,242,2022/4/15 17:30,828,107,721,
26212,242,2022/4/15 17:40,1568,127,1441,
26213,242,2022/4/15 17:50,1352,191,1161,
26214,242,2022/4/15 18:00,1559,158,1401,
26215,242,2022/4/15 18:10,2500,159,2341,
26216,242,2022/4/15 18:20,1986,146,1840,
26217,242,2022/4/15 18:30,1360,199,1161,
26218,242,2022/4/15 18:40,1348,181,1167,
26219,242,2022/4/15 18:50,1163,115,1048,
26220,242,2022/4/15 19:00,806,124,682,
26221,242,2022/4/15 19:10,655,117,538,
26222,242,2022/4/15 19:20,578,105,473,
26223,242,2022/4/15 19:30,458,112,346,
26224,242,2022/4/15 19:40,355,95,260,
26225,242,2022/4/15 19:50,350,82,268,
26226,242,2022/4/15 20:00,337,80,257,
26227,242,2022/4/15 20:10,325,81,244,
26228,242,2022/4/15 20:20,307,79,228,
26229,242,2022/4/15 20:30,273,73,200,
26230,242,2022/4/15 20:40,266,68,198,
26231,242,2022/4/15 20:50,272,64,208,
26232,242,2022/4/15 21:00,269,67,202,
26233,242,2022/4/15 21:10,336,66,270,
26234,242,2022/4/15 21:20,289,69,220,
26235,242,2022/4/15 21:30,269,63,206,
26236,242,2022/4/15 21:40,273,62,211,
26237,242,2022/4/15 21:50,244,60,184,
26238,242,2022/4/15 22:00,390,57,333,
26239,242,2022/4/15 22:10,617,50,567,
26240,242,2022/4/15 22:20,222,50,172,
26241,242,2022/4/15 22:30,66,49,17,
26242,242,2022/4/15 22:40,37,42,-5,
26243,242,2022/4/15 22:50,25,25,0,
26244,231,2022/4/15 5:00,0,1,-1,
26245,231,2022/4/15 5:10,0,1,-1,
26246,231,2022/4/15 5:20,0,1,-1,
26247,231,2022/4/15 5:30,3,1,2,
26248,231,2022/4/15 5:40,15,1,14,
26249,231,2022/4/15 5:50,24,12,12,
26250,231,2022/4/15 6:00,26,35,-9,
26251,231,2022/4/15 6:10,33,53,-20,
26252,231,2022/4/15 6:20,40,59,-19,
26253,231,2022/4/15 6:30,52,74,-22,
26254,231,2022/4/15 6:40,61,91,-30,
26255,231,2022/4/15 6:50,80,109,-29,
26256,231,2022/4/15 7:00,112,181,-69,
26257,231,2022/4/15 7:10,152,267,-115,
26258,231,2022/4/15 7:20,216,253,-37,
26259,231,2022/4/15 7:30,215,268,-53,
26260,231,2022/4/15 7:40,245,345,-100,
26261,231,2022/4/15 7:50,266,434,-168,
26262,231,2022/4/15 8:00,347,582,-235,
26263,231,2022/4/15 8:10,366,1126,-760,
26264,231,2022/4/15 8:20,347,1134,-787,
26265,231,2022/4/15 8:30,278,1122,-844,
26266,231,2022/4/15 8:40,282,1643,-1361,
26267,231,2022/4/15 8:50,246,1549,-1303,
26268,231,2022/4/15 9:00,208,489,-281,
26269,231,2022/4/15 9:10,178,631,-453,
26270,231,2022/4/15 9:20,148,423,-275,
26271,231,2022/4/15 9:30,115,431,-316,
26272,231,2022/4/15 9:40,85,382,-297,
26273,231,2022/4/15 9:50,70,282,-212,
26274,231,2022/4/15 10:00,68,233,-165,
26275,231,2022/4/15 10:10,64,119,-55,
26276,231,2022/4/15 10:20,59,123,-64,
26277,231,2022/4/15 10:30,53,117,-64,
26278,231,2022/4/15 10:40,45,115,-70,
26279,231,2022/4/15 10:50,50,120,-70,
26280,231,2022/4/15 11:00,52,99,-47,
26281,231,2022/4/15 11:10,55,110,-55,
26282,231,2022/4/15 11:20,55,104,-49,
26283,231,2022/4/15 11:30,59,113,-54,
26284,231,2022/4/15 11:40,69,102,-33,
26285,231,2022/4/15 11:50,58,108,-50,
26286,231,2022/4/15 12:00,70,97,-27,
26287,231,2022/4/15 12:10,72,122,-50,
26288,231,2022/4/15 12:20,59,107,-48,
26289,231,2022/4/15 12:30,61,119,-58,
26290,231,2022/4/15 12:40,63,102,-39,
26291,231,2022/4/15 12:50,66,105,-39,
26292,231,2022/4/15 13:00,68,117,-49,
26293,231,2022/4/15 13:10,60,124,-64,
26294,231,2022/4/15 13:20,62,117,-55,
26295,231,2022/4/15 13:30,58,116,-58,
26296,231,2022/4/15 13:40,67,123,-56,
26297,231,2022/4/15 13:50,67,105,-38,
26298,231,2022/4/15 14:00,62,118,-56,
26299,231,2022/4/15 14:10,65,122,-57,
26300,231,2022/4/15 14:20,62,121,-59,
26301,231,2022/4/15 14:30,76,101,-25,
26302,231,2022/4/15 14:40,69,98,-29,
26303,231,2022/4/15 14:50,102,88,14,
26304,231,2022/4/15 15:00,131,105,26,
26305,231,2022/4/15 15:10,158,107,51,
26306,231,2022/4/15 15:20,172,125,47,
26307,231,2022/4/15 15:30,174,114,60,
26308,231,2022/4/15 15:40,149,108,41,
26309,231,2022/4/15 15:50,137,102,35,
26310,231,2022/4/15 16:00,181,108,73,
26311,231,2022/4/15 16:10,218,118,100,
26312,231,2022/4/15 16:20,227,121,106,
26313,231,2022/4/15 16:30,293,123,170,
26314,231,2022/4/15 16:40,332,107,225,
26315,231,2022/4/15 16:50,333,124,209,
26316,231,2022/4/15 17:00,697,111,586,
26317,231,2022/4/15 17:10,830,118,712,
26318,231,2022/4/15 17:20,675,196,479,
26319,231,2022/4/15 17:30,698,212,486,
26320,231,2022/4/15 17:40,796,177,619,
26321,231,2022/4/15 17:50,630,178,452,
26322,231,2022/4/15 18:00,631,218,413,
26323,231,2022/4/15 18:10,1202,301,901,
26324,231,2022/4/15 18:20,801,284,517,
26325,231,2022/4/15 18:30,572,284,288,
26326,231,2022/4/15 18:40,463,190,273,
26327,231,2022/4/15 18:50,333,178,155,
26328,231,2022/4/15 19:00,274,145,129,
26329,231,2022/4/15 19:10,230,128,102,
26330,231,2022/4/15 19:20,191,109,82,
26331,231,2022/4/15 19:30,175,103,72,
26332,231,2022/4/15 19:40,144,110,34,
26333,231,2022/4/15 19:50,87,111,-24,
26334,231,2022/4/15 20:00,89,95,-6,
26335,231,2022/4/15 20:10,82,92,-10,
26336,231,2022/4/15 20:20,83,100,-17,
26337,231,2022/4/15 20:30,67,114,-47,
26338,231,2022/4/15 20:40,85,95,-10,
26339,231,2022/4/15 20:50,83,95,-12,
26340,231,2022/4/15 21:00,106,106,0,
26341,231,2022/4/15 21:10,84,108,-24,
26342,231,2022/4/15 21:20,62,91,-29,
26343,231,2022/4/15 21:30,67,106,-39,
26344,231,2022/4/15 21:40,49,92,-43,
26345,231,2022/4/15 21:50,40,97,-57,
26346,231,2022/4/15 22:00,34,92,-58,
26347,231,2022/4/15 22:10,37,82,-45,
26348,231,2022/4/15 22:20,31,85,-54,
26349,231,2022/4/15 22:30,24,78,-54,
26350,231,2022/4/15 22:40,20,73,-53,
26351,231,2022/4/15 22:50,9,64,-55,
26352,259,2022/4/15 5:00,0,1,-1,
26353,259,2022/4/15 5:10,0,1,-1,
26354,259,2022/4/15 5:20,1,1,0,
26355,259,2022/4/15 5:30,8,1,7,
26356,259,2022/4/15 5:40,17,1,16,
26357,259,2022/4/15 5:50,26,8,18,
26358,259,2022/4/15 6:00,31,29,2,
26359,259,2022/4/15 6:10,37,45,-8,
26360,259,2022/4/15 6:20,45,72,-27,
26361,259,2022/4/15 6:30,57,75,-18,
26362,259,2022/4/15 6:40,77,106,-29,
26363,259,2022/4/15 6:50,99,137,-38,
26364,259,2022/4/15 7:00,193,195,-2,
26365,259,2022/4/15 7:10,223,196,27,
26366,259,2022/4/15 7:20,227,118,109,
26367,259,2022/4/15 7:30,255,224,31,
26368,259,2022/4/15 7:40,319,333,-14,
26369,259,2022/4/15 7:50,327,534,-207,
26370,259,2022/4/15 8:00,599,615,-16,
26371,259,2022/4/15 8:10,595,1933,-1338,
26372,259,2022/4/15 8:20,599,1890,-1291,
26373,259,2022/4/15 8:30,478,4581,-4103,
26374,259,2022/4/15 8:40,351,5187,-4836,
26375,259,2022/4/15 8:50,331,1968,-1637,
26376,259,2022/4/15 9:00,277,2804,-2527,
26377,259,2022/4/15 9:10,229,1961,-1732,
26378,259,2022/4/15 9:20,217,1576,-1359,
26379,259,2022/4/15 9:30,216,460,-244,
26380,259,2022/4/15 9:40,200,469,-269,
26381,259,2022/4/15 9:50,183,399,-216,
26382,259,2022/4/15 10:00,162,344,-182,
26383,259,2022/4/15 10:10,154,231,-77,
26384,259,2022/4/15 10:20,140,268,-128,
26385,259,2022/4/15 10:30,141,212,-71,
26386,259,2022/4/15 10:40,136,151,-15,
26387,259,2022/4/15 10:50,127,177,-50,
26388,259,2022/4/15 11:00,136,180,-44,
26389,259,2022/4/15 11:10,113,110,3,
26390,259,2022/4/15 11:20,147,117,30,
26391,259,2022/4/15 11:30,135,125,10,
26392,259,2022/4/15 11:40,162,152,10,
26393,259,2022/4/15 11:50,161,152,9,
26394,259,2022/4/15 12:00,177,151,26,
26395,259,2022/4/15 12:10,173,144,29,
26396,259,2022/4/15 12:20,174,110,64,
26397,259,2022/4/15 12:30,179,128,51,
26398,259,2022/4/15 12:40,175,193,-18,
26399,259,2022/4/15 12:50,191,185,6,
26400,259,2022/4/15 13:00,183,180,3,
26401,259,2022/4/15 13:10,204,117,87,
26402,259,2022/4/15 13:20,205,127,78,
26403,259,2022/4/15 13:30,213,180,33,
26404,259,2022/4/15 13:40,205,180,25,
26405,259,2022/4/15 13:50,196,159,37,
26406,259,2022/4/15 14:00,196,151,45,
26407,259,2022/4/15 14:10,185,110,75,
26408,259,2022/4/15 14:20,200,171,29,
26409,259,2022/4/15 14:30,203,183,20,
26410,259,2022/4/15 14:40,212,170,42,
26411,259,2022/4/15 14:50,238,139,99,
26412,259,2022/4/15 15:00,231,121,110,
26413,259,2022/4/15 15:10,243,110,133,
26414,259,2022/4/15 15:20,238,112,126,
26415,259,2022/4/15 15:30,263,146,117,
26416,259,2022/4/15 15:40,262,159,103,
26417,259,2022/4/15 15:50,270,139,131,
26418,259,2022/4/15 16:00,269,145,124,
26419,259,2022/4/15 16:10,294,121,173,
26420,259,2022/4/15 16:20,269,181,88,
26421,259,2022/4/15 16:30,327,146,181,
26422,259,2022/4/15 16:40,457,214,243,
26423,259,2022/4/15 16:50,430,197,233,
26424,259,2022/4/15 17:00,800,195,605,
26425,259,2022/4/15 17:10,1197,229,968,
26426,259,2022/4/15 17:20,1025,296,729,
26427,259,2022/4/15 17:30,1207,315,892,
26428,259,2022/4/15 17:40,1981,337,1644,
26429,259,2022/4/15 17:50,1347,527,820,
26430,259,2022/4/15 18:00,1196,506,690,
26431,259,2022/4/15 18:10,1974,508,1466,
26432,259,2022/4/15 18:20,1615,501,1114,
26433,259,2022/4/15 18:30,1148,421,727,
26434,259,2022/4/15 18:40,1163,508,655,
26435,259,2022/4/15 18:50,660,324,336,
26436,259,2022/4/15 19:00,643,326,317,
26437,259,2022/4/15 19:10,570,300,270,
26438,259,2022/4/15 19:20,432,180,252,
26439,259,2022/4/15 19:30,340,159,181,
26440,259,2022/4/15 19:40,334,111,223,
26441,259,2022/4/15 19:50,267,110,157,
26442,259,2022/4/15 20:00,306,133,173,
26443,259,2022/4/15 20:10,339,114,225,
26444,259,2022/4/15 20:20,306,120,186,
26445,259,2022/4/15 20:30,314,106,208,
26446,259,2022/4/15 20:40,313,110,203,
26447,259,2022/4/15 20:50,274,106,168,
26448,259,2022/4/15 21:00,336,123,213,
26449,259,2022/4/15 21:10,269,114,155,
26450,259,2022/4/15 21:20,256,126,130,
26451,259,2022/4/15 21:30,209,99,110,
26452,259,2022/4/15 21:40,223,120,103,
26453,259,2022/4/15 21:50,167,107,60,
26454,259,2022/4/15 22:00,221,105,116,
26455,259,2022/4/15 22:10,134,109,25,
26456,259,2022/4/15 22:20,44,106,-62,
26457,259,2022/4/15 22:30,32,111,-79,
26458,259,2022/4/15 22:40,24,99,-75,
26459,259,2022/4/15 22:50,15,65,-50,
26460,261,2022/4/15 5:00,0,1,-1,
26461,261,2022/4/15 5:10,0,1,-1,
26462,261,2022/4/15 5:20,0,1,-1,
26463,261,2022/4/15 5:30,4,1,3,
26464,261,2022/4/15 5:40,13,1,12,
26465,261,2022/4/15 5:50,16,5,11,
26466,261,2022/4/15 6:00,21,19,2,
26467,261,2022/4/15 6:10,22,33,-11,
26468,261,2022/4/15 6:20,32,25,7,
26469,261,2022/4/15 6:30,36,51,-15,
26470,261,2022/4/15 6:40,47,60,-13,
26471,261,2022/4/15 6:50,69,66,3,
26472,261,2022/4/15 7:00,85,93,-8,
26473,261,2022/4/15 7:10,87,84,3,
26474,261,2022/4/15 7:20,152,69,83,
26475,261,2022/4/15 7:30,185,100,85,
26476,261,2022/4/15 7:40,234,98,136,
26477,261,2022/4/15 7:50,277,108,169,
26478,261,2022/4/15 8:00,317,109,208,
26479,261,2022/4/15 8:10,350,208,142,
26480,261,2022/4/15 8:20,345,208,137,
26481,261,2022/4/15 8:30,282,233,49,
26482,261,2022/4/15 8:40,269,298,-29,
26483,261,2022/4/15 8:50,224,148,76,
26484,261,2022/4/15 9:00,156,103,53,
26485,261,2022/4/15 9:10,96,108,-12,
26486,261,2022/4/15 9:20,79,107,-28,
26487,261,2022/4/15 9:30,76,104,-28,
26488,261,2022/4/15 9:40,50,127,-77,
26489,261,2022/4/15 9:50,45,108,-63,
26490,261,2022/4/15 10:00,39,83,-44,
26491,261,2022/4/15 10:10,39,82,-43,
26492,261,2022/4/15 10:20,33,71,-38,
26493,261,2022/4/15 10:30,33,62,-29,
26494,261,2022/4/15 10:40,34,85,-51,
26495,261,2022/4/15 10:50,29,73,-44,
26496,261,2022/4/15 11:00,30,72,-42,
26497,261,2022/4/15 11:10,29,65,-36,
26498,261,2022/4/15 11:20,30,70,-40,
26499,261,2022/4/15 11:30,35,73,-38,
26500,261,2022/4/15 11:40,30,67,-37,
26501,261,2022/4/15 11:50,32,74,-42,
26502,261,2022/4/15 12:00,28,62,-34,
26503,261,2022/4/15 12:10,27,67,-40,
26504,261,2022/4/15 12:20,30,69,-39,
26505,261,2022/4/15 12:30,32,82,-50,
26506,261,2022/4/15 12:40,31,79,-48,
26507,261,2022/4/15 12:50,29,64,-35,
26508,261,2022/4/15 13:00,28,61,-33,
26509,261,2022/4/15 13:10,33,77,-44,
26510,261,2022/4/15 13:20,28,84,-56,
26511,261,2022/4/15 13:30,28,76,-48,
26512,261,2022/4/15 13:40,29,78,-49,
26513,261,2022/4/15 13:50,32,64,-32,
26514,261,2022/4/15 14:00,29,70,-41,
26515,261,2022/4/15 14:10,30,77,-47,
26516,261,2022/4/15 14:20,25,85,-60,
26517,261,2022/4/15 14:30,25,84,-59,
26518,261,2022/4/15 14:40,25,69,-44,
26519,261,2022/4/15 14:50,30,73,-43,
26520,261,2022/4/15 15:00,39,76,-37,
26521,261,2022/4/15 15:10,36,77,-41,
26522,261,2022/4/15 15:20,30,97,-67,
26523,261,2022/4/15 15:30,29,76,-47,
26524,261,2022/4/15 15:40,36,90,-54,
26525,261,2022/4/15 15:50,37,83,-46,
26526,261,2022/4/15 16:00,42,76,-34,
26527,261,2022/4/15 16:10,44,90,-46,
26528,261,2022/4/15 16:20,40,96,-56,
26529,261,2022/4/15 16:30,44,100,-56,
26530,261,2022/4/15 16:40,52,104,-52,
26531,261,2022/4/15 16:50,46,101,-55,
26532,261,2022/4/15 17:00,129,104,25,
26533,261,2022/4/15 17:10,176,118,58,
26534,261,2022/4/15 17:20,138,125,13,
26535,261,2022/4/15 17:30,161,115,46,
26536,261,2022/4/15 17:40,259,118,141,
26537,261,2022/4/15 17:50,175,127,48,
26538,261,2022/4/15 18:00,102,152,-50,
26539,261,2022/4/15 18:10,199,179,20,
26540,261,2022/4/15 18:20,137,158,-21,
26541,261,2022/4/15 18:30,77,184,-107,
26542,261,2022/4/15 18:40,62,192,-130,
26543,261,2022/4/15 18:50,48,124,-76,
26544,261,2022/4/15 19:00,43,109,-66,
26545,261,2022/4/15 19:10,48,111,-63,
26546,261,2022/4/15 19:20,45,112,-67,
26547,261,2022/4/15 19:30,39,110,-71,
26548,261,2022/4/15 19:40,36,113,-77,
26549,261,2022/4/15 19:50,31,99,-68,
26550,261,2022/4/15 20:00,30,92,-62,
26551,261,2022/4/15 20:10,29,79,-50,
26552,261,2022/4/15 20:20,25,83,-58,
26553,261,2022/4/15 20:30,29,95,-66,
26554,261,2022/4/15 20:40,25,94,-69,
26555,261,2022/4/15 20:50,28,83,-55,
26556,261,2022/4/15 21:00,22,82,-60,
26557,261,2022/4/15 21:10,28,81,-53,
26558,261,2022/4/15 21:20,22,93,-71,
26559,261,2022/4/15 21:30,23,78,-55,
26560,261,2022/4/15 21:40,20,74,-54,
26561,261,2022/4/15 21:50,19,74,-55,
26562,261,2022/4/15 22:00,16,78,-62,
26563,261,2022/4/15 22:10,16,77,-61,
26564,261,2022/4/15 22:20,15,69,-54,
26565,261,2022/4/15 22:30,14,86,-72,
26566,261,2022/4/15 22:40,9,72,-63,
26567,261,2022/4/15 22:50,5,61,-56,
26568,243,2022/4/15 5:00,0,1,-1,
26569,243,2022/4/15 5:10,0,1,-1,
26570,243,2022/4/15 5:20,1,1,0,
26571,243,2022/4/15 5:30,9,1,8,
26572,243,2022/4/15 5:40,23,5,18,
26573,243,2022/4/15 5:50,27,6,21,
26574,243,2022/4/15 6:00,30,16,14,
26575,243,2022/4/15 6:10,35,39,-4,
26576,243,2022/4/15 6:20,44,38,6,
26577,243,2022/4/15 6:30,59,47,12,
26578,243,2022/4/15 6:40,88,66,22,
26579,243,2022/4/15 6:50,164,72,92,
26580,243,2022/4/15 7:00,187,66,121,
26581,243,2022/4/15 7:10,227,73,154,
26582,243,2022/4/15 7:20,225,93,132,
26583,243,2022/4/15 7:30,223,88,135,
26584,243,2022/4/15 7:40,244,103,141,
26585,243,2022/4/15 7:50,317,120,197,
26586,243,2022/4/15 8:00,301,119,182,
26587,243,2022/4/15 8:10,282,192,90,
26588,243,2022/4/15 8:20,277,184,93,
26589,243,2022/4/15 8:30,279,234,45,
26590,243,2022/4/15 8:40,277,298,-21,
26591,243,2022/4/15 8:50,228,318,-90,
26592,243,2022/4/15 9:00,167,320,-153,
26593,243,2022/4/15 9:10,150,226,-76,
26594,243,2022/4/15 9:20,122,155,-33,
26595,243,2022/4/15 9:30,77,117,-40,
26596,243,2022/4/15 9:40,65,105,-40,
26597,243,2022/4/15 9:50,53,124,-71,
26598,243,2022/4/15 10:00,45,108,-63,
26599,243,2022/4/15 10:10,44,111,-67,
26600,243,2022/4/15 10:20,39,87,-48,
26601,243,2022/4/15 10:30,37,96,-59,
26602,243,2022/4/15 10:40,37,87,-50,
26603,243,2022/4/15 10:50,35,72,-37,
26604,243,2022/4/15 11:00,35,82,-47,
26605,243,2022/4/15 11:10,35,77,-42,
26606,243,2022/4/15 11:20,35,85,-50,
26607,243,2022/4/15 11:30,35,71,-36,
26608,243,2022/4/15 11:40,39,70,-31,
26609,243,2022/4/15 11:50,38,77,-39,
26610,243,2022/4/15 12:00,42,77,-35,
26611,243,2022/4/15 12:10,43,77,-34,
26612,243,2022/4/15 12:20,43,77,-34,
26613,243,2022/4/15 12:30,43,62,-19,
26614,243,2022/4/15 12:40,43,77,-34,
26615,243,2022/4/15 12:50,42,82,-40,
26616,243,2022/4/15 13:00,37,87,-50,
26617,243,2022/4/15 13:10,39,91,-52,
26618,243,2022/4/15 13:20,40,76,-36,
26619,243,2022/4/15 13:30,37,69,-32,
26620,243,2022/4/15 13:40,37,91,-54,
26621,243,2022/4/15 13:50,35,91,-56,
26622,243,2022/4/15 14:00,33,96,-63,
26623,243,2022/4/15 14:10,39,98,-59,
26624,243,2022/4/15 14:20,37,70,-33,
26625,243,2022/4/15 14:30,29,93,-64,
26626,243,2022/4/15 14:40,33,97,-64,
26627,243,2022/4/15 14:50,29,92,-63,
26628,243,2022/4/15 15:00,31,95,-64,
26629,243,2022/4/15 15:10,38,77,-39,
26630,243,2022/4/15 15:20,37,77,-40,
26631,243,2022/4/15 15:30,33,98,-65,
26632,243,2022/4/15 15:40,35,109,-74,
26633,243,2022/4/15 15:50,38,113,-75,
26634,243,2022/4/15 16:00,44,106,-62,
26635,243,2022/4/15 16:10,46,112,-66,
26636,243,2022/4/15 16:20,46,85,-39,
26637,243,2022/4/15 16:30,68,105,-37,
26638,243,2022/4/15 16:40,52,120,-68,
26639,243,2022/4/15 16:50,60,123,-63,
26640,243,2022/4/15 17:00,215,124,91,
26641,243,2022/4/15 17:10,206,112,94,
26642,243,2022/4/15 17:20,131,127,4,
26643,243,2022/4/15 17:30,264,110,154,
26644,243,2022/4/15 17:40,207,151,56,
26645,243,2022/4/15 17:50,177,212,-35,
26646,243,2022/4/15 18:00,247,224,23,
26647,243,2022/4/15 18:10,270,184,86,
26648,243,2022/4/15 18:20,191,235,-44,
26649,243,2022/4/15 18:30,223,183,40,
26650,243,2022/4/15 18:40,205,271,-66,
26651,243,2022/4/15 18:50,88,181,-93,
26652,243,2022/4/15 19:00,70,170,-100,
26653,243,2022/4/15 19:10,67,152,-85,
26654,243,2022/4/15 19:20,57,110,-53,
26655,243,2022/4/15 19:30,46,122,-76,
26656,243,2022/4/15 19:40,40,119,-79,
26657,243,2022/4/15 19:50,37,112,-75,
26658,243,2022/4/15 20:00,37,109,-72,
26659,243,2022/4/15 20:10,41,125,-84,
26660,243,2022/4/15 20:20,38,115,-77,
26661,243,2022/4/15 20:30,34,107,-73,
26662,243,2022/4/15 20:40,34,101,-67,
26663,243,2022/4/15 20:50,33,111,-78,
26664,243,2022/4/15 21:00,36,113,-77,
26665,243,2022/4/15 21:10,28,112,-84,
26666,243,2022/4/15 21:20,32,105,-73,
26667,243,2022/4/15 21:30,25,106,-81,
26668,243,2022/4/15 21:40,29,107,-78,
26669,243,2022/4/15 21:50,25,108,-83,
26670,243,2022/4/15 22:00,24,98,-74,
26671,243,2022/4/15 22:10,21,92,-71,
26672,243,2022/4/15 22:20,16,99,-83,
26673,243,2022/4/15 22:30,15,107,-92,
26674,243,2022/4/15 22:40,10,81,-71,
26675,243,2022/4/15 22:50,2,73,-71,
26676,254,2022/4/15 5:00,0,1,-1,
26677,254,2022/4/15 5:10,0,1,-1,
26678,254,2022/4/15 5:20,0,1,-1,
26679,254,2022/4/15 5:30,18,1,17,
26680,254,2022/4/15 5:40,27,2,25,
26681,254,2022/4/15 5:50,30,1,29,
26682,254,2022/4/15 6:00,44,22,22,
26683,254,2022/4/15 6:10,57,45,12,
26684,254,2022/4/15 6:20,76,45,31,
26685,254,2022/4/15 6:30,182,50,132,
26686,254,2022/4/15 6:40,237,59,178,
26687,254,2022/4/15 6:50,350,73,277,
26688,254,2022/4/15 7:00,327,86,241,
26689,254,2022/4/15 7:10,593,76,517,
26690,254,2022/4/15 7:20,666,110,556,
26691,254,2022/4/15 7:30,667,126,541,
26692,254,2022/4/15 7:40,735,109,626,
26693,254,2022/4/15 7:50,1175,104,1071,
26694,254,2022/4/15 8:00,1180,120,1060,
26695,254,2022/4/15 8:10,1059,121,938,
26696,254,2022/4/15 8:20,826,111,715,
26697,254,2022/4/15 8:30,731,153,578,
26698,254,2022/4/15 8:40,688,180,508,
26699,254,2022/4/15 8:50,477,160,317,
26700,254,2022/4/15 9:00,337,109,228,
26701,254,2022/4/15 9:10,295,125,170,
26702,254,2022/4/15 9:20,268,117,151,
26703,254,2022/4/15 9:30,227,116,111,
26704,254,2022/4/15 9:40,180,109,71,
26705,254,2022/4/15 9:50,138,107,31,
26706,254,2022/4/15 10:00,95,108,-13,
26707,254,2022/4/15 10:10,73,105,-32,
26708,254,2022/4/15 10:20,73,90,-17,
26709,254,2022/4/15 10:30,59,74,-15,
26710,254,2022/4/15 10:40,46,101,-55,
26711,254,2022/4/15 10:50,45,99,-54,
26712,254,2022/4/15 11:00,48,99,-51,
26713,254,2022/4/15 11:10,46,91,-45,
26714,254,2022/4/15 11:20,44,76,-32,
26715,254,2022/4/15 11:30,47,101,-54,
26716,254,2022/4/15 11:40,48,99,-51,
26717,254,2022/4/15 11:50,45,103,-58,
26718,254,2022/4/15 12:00,46,101,-55,
26719,254,2022/4/15 12:10,53,81,-28,
26720,254,2022/4/15 12:20,57,102,-45,
26721,254,2022/4/15 12:30,48,104,-56,
26722,254,2022/4/15 12:40,47,100,-53,
26723,254,2022/4/15 12:50,45,105,-60,
26724,254,2022/4/15 13:00,49,105,-56,
26725,254,2022/4/15 13:10,57,88,-31,
26726,254,2022/4/15 13:20,46,106,-60,
26727,254,2022/4/15 13:30,48,104,-56,
26728,254,2022/4/15 13:40,45,105,-60,
26729,254,2022/4/15 13:50,46,109,-63,
26730,254,2022/4/15 14:00,40,97,-57,
26731,254,2022/4/15 14:10,49,102,-53,
26732,254,2022/4/15 14:20,47,107,-60,
26733,254,2022/4/15 14:30,41,103,-62,
26734,254,2022/4/15 14:40,38,86,-48,
26735,254,2022/4/15 14:50,38,111,-73,
26736,254,2022/4/15 15:00,40,105,-65,
26737,254,2022/4/15 15:10,45,105,-60,
26738,254,2022/4/15 15:20,45,122,-77,
26739,254,2022/4/15 15:30,46,125,-79,
26740,254,2022/4/15 15:40,44,109,-65,
26741,254,2022/4/15 15:50,41,120,-79,
26742,254,2022/4/15 16:00,44,114,-70,
26743,254,2022/4/15 16:10,54,107,-53,
26744,254,2022/4/15 16:20,54,120,-66,
26745,254,2022/4/15 16:30,65,133,-68,
26746,254,2022/4/15 16:40,69,171,-102,
26747,254,2022/4/15 16:50,73,159,-86,
26748,254,2022/4/15 17:00,137,106,31,
26749,254,2022/4/15 17:10,175,210,-35,
26750,254,2022/4/15 17:20,170,317,-147,
26751,254,2022/4/15 17:30,115,437,-322,
26752,254,2022/4/15 17:40,174,383,-209,
26753,254,2022/4/15 17:50,134,531,-397,
26754,254,2022/4/15 18:00,115,432,-317,
26755,254,2022/4/15 18:10,179,432,-253,
26756,254,2022/4/15 18:20,87,478,-391,
26757,254,2022/4/15 18:30,65,432,-367,
26758,254,2022/4/15 18:40,69,427,-358,
26759,254,2022/4/15 18:50,60,335,-275,
26760,254,2022/4/15 19:00,48,387,-339,
26761,254,2022/4/15 19:10,39,326,-287,
26762,254,2022/4/15 19:20,41,335,-294,
26763,254,2022/4/15 19:30,34,255,-221,
26764,254,2022/4/15 19:40,32,169,-137,
26765,254,2022/4/15 19:50,35,180,-145,
26766,254,2022/4/15 20:00,30,106,-76,
26767,254,2022/4/15 20:10,28,128,-100,
26768,254,2022/4/15 20:20,30,129,-99,
26769,254,2022/4/15 20:30,37,132,-95,
26770,254,2022/4/15 20:40,27,109,-82,
26771,254,2022/4/15 20:50,33,124,-91,
26772,254,2022/4/15 21:00,29,124,-95,
26773,254,2022/4/15 21:10,31,107,-76,
26774,254,2022/4/15 21:20,29,112,-83,
26775,254,2022/4/15 21:30,29,110,-81,
26776,254,2022/4/15 21:40,28,111,-83,
26777,254,2022/4/15 21:50,25,104,-79,
26778,254,2022/4/15 22:00,22,104,-82,
26779,254,2022/4/15 22:10,21,122,-101,
26780,254,2022/4/15 22:20,20,102,-82,
26781,254,2022/4/15 22:30,12,107,-95,
26782,254,2022/4/15 22:40,7,109,-102,
26783,254,2022/4/15 22:50,2,78,-76,
26784,235,2022/4/15 5:00,0,1,-1,
26785,235,2022/4/15 5:10,1,1,0,
26786,235,2022/4/15 5:20,10,1,9,
26787,235,2022/4/15 5:30,22,1,21,
26788,235,2022/4/15 5:40,35,1,34,
26789,235,2022/4/15 5:50,31,1,30,
26790,235,2022/4/15 6:00,51,16,35,
26791,235,2022/4/15 6:10,83,23,60,
26792,235,2022/4/15 6:20,125,28,97,
26793,235,2022/4/15 6:30,228,34,194,
26794,235,2022/4/15 6:40,302,50,252,
26795,235,2022/4/15 6:50,330,65,265,
26796,235,2022/4/15 7:00,593,73,520,
26797,235,2022/4/15 7:10,722,84,638,
26798,235,2022/4/15 7:20,729,76,653,
26799,235,2022/4/15 7:30,859,99,760,
26800,235,2022/4/15 7:40,1213,100,1113,
26801,235,2022/4/15 7:50,1586,112,1474,
26802,235,2022/4/15 8:00,1588,120,1468,
26803,235,2022/4/15 8:10,1573,109,1464,
26804,235,2022/4/15 8:20,1364,87,1277,
26805,235,2022/4/15 8:30,1212,122,1090,
26806,235,2022/4/15 8:40,1054,123,931,
26807,235,2022/4/15 8:50,723,110,613,
26808,235,2022/4/15 9:00,586,101,485,
26809,235,2022/4/15 9:10,374,104,270,
26810,235,2022/4/15 9:20,277,109,168,
26811,235,2022/4/15 9:30,231,90,141,
26812,235,2022/4/15 9:40,224,91,133,
26813,235,2022/4/15 9:50,182,104,78,
26814,235,2022/4/15 10:00,130,93,37,
26815,235,2022/4/15 10:10,95,76,19,
26816,235,2022/4/15 10:20,73,76,-3,
26817,235,2022/4/15 10:30,62,68,-6,
26818,235,2022/4/15 10:40,48,98,-50,
26819,235,2022/4/15 10:50,45,92,-47,
26820,235,2022/4/15 11:00,42,73,-31,
26821,235,2022/4/15 11:10,44,83,-39,
26822,235,2022/4/15 11:20,47,93,-46,
26823,235,2022/4/15 11:30,44,93,-49,
26824,235,2022/4/15 11:40,47,94,-47,
26825,235,2022/4/15 11:50,44,77,-33,
26826,235,2022/4/15 12:00,47,100,-53,
26827,235,2022/4/15 12:10,58,104,-46,
26828,235,2022/4/15 12:20,59,114,-55,
26829,235,2022/4/15 12:30,58,111,-53,
26830,235,2022/4/15 12:40,56,96,-40,
26831,235,2022/4/15 12:50,59,77,-18,
26832,235,2022/4/15 13:00,56,109,-53,
26833,235,2022/4/15 13:10,48,91,-43,
26834,235,2022/4/15 13:20,49,105,-56,
26835,235,2022/4/15 13:30,54,103,-49,
26836,235,2022/4/15 13:40,45,74,-29,
26837,235,2022/4/15 13:50,41,105,-64,
26838,235,2022/4/15 14:00,44,103,-59,
26839,235,2022/4/15 14:10,41,104,-63,
26840,235,2022/4/15 14:20,40,102,-62,
26841,235,2022/4/15 14:30,36,100,-64,
26842,235,2022/4/15 14:40,39,100,-61,
26843,235,2022/4/15 14:50,38,121,-83,
26844,235,2022/4/15 15:00,37,122,-85,
26845,235,2022/4/15 15:10,42,124,-82,
26846,235,2022/4/15 15:20,44,125,-81,
26847,235,2022/4/15 15:30,44,94,-50,
26848,235,2022/4/15 15:40,39,117,-78,
26849,235,2022/4/15 15:50,37,129,-92,
26850,235,2022/4/15 16:00,40,117,-77,
26851,235,2022/4/15 16:10,42,182,-140,
26852,235,2022/4/15 16:20,41,183,-142,
26853,235,2022/4/15 16:30,48,151,-103,
26854,235,2022/4/15 16:40,49,121,-72,
26855,235,2022/4/15 16:50,49,235,-186,
26856,235,2022/4/15 17:00,63,230,-167,
26857,235,2022/4/15 17:10,69,295,-226,
26858,235,2022/4/15 17:20,82,372,-290,
26859,235,2022/4/15 17:30,65,529,-464,
26860,235,2022/4/15 17:40,67,498,-431,
26861,235,2022/4/15 17:50,66,477,-411,
26862,235,2022/4/15 18:00,50,572,-522,
26863,235,2022/4/15 18:10,55,431,-376,
26864,235,2022/4/15 18:20,48,1214,-1166,
26865,235,2022/4/15 18:30,43,429,-386,
26866,235,2022/4/15 18:40,43,645,-602,
26867,235,2022/4/15 18:50,39,576,-537,
26868,235,2022/4/15 19:00,38,432,-394,
26869,235,2022/4/15 19:10,32,503,-471,
26870,235,2022/4/15 19:20,33,379,-346,
26871,235,2022/4/15 19:30,28,218,-190,
26872,235,2022/4/15 19:40,32,217,-185,
26873,235,2022/4/15 19:50,27,196,-169,
26874,235,2022/4/15 20:00,29,159,-130,
26875,235,2022/4/15 20:10,36,180,-144,
26876,235,2022/4/15 20:20,32,132,-100,
26877,235,2022/4/15 20:30,35,117,-82,
26878,235,2022/4/15 20:40,28,104,-76,
26879,235,2022/4/15 20:50,28,128,-100,
26880,235,2022/4/15 21:00,26,192,-166,
26881,235,2022/4/15 21:10,29,114,-85,
26882,235,2022/4/15 21:20,31,111,-80,
26883,235,2022/4/15 21:30,29,109,-80,
26884,235,2022/4/15 21:40,26,119,-93,
26885,235,2022/4/15 21:50,26,110,-84,
26886,235,2022/4/15 22:00,22,109,-87,
26887,235,2022/4/15 22:10,18,120,-102,
26888,235,2022/4/15 22:20,18,123,-105,
26889,235,2022/4/15 22:30,13,123,-110,
26890,235,2022/4/15 22:40,5,122,-117,
26891,235,2022/4/15 22:50,2,95,-93,
26892,255,2022/4/15 5:00,0,1,-1,
26893,255,2022/4/15 5:10,1,1,0,
26894,255,2022/4/15 5:20,10,1,9,
26895,255,2022/4/15 5:30,24,1,23,
26896,255,2022/4/15 5:40,25,1,24,
26897,255,2022/4/15 5:50,25,1,24,
26898,255,2022/4/15 6:00,40,8,32,
26899,255,2022/4/15 6:10,55,19,36,
26900,255,2022/4/15 6:20,71,67,4,
26901,255,2022/4/15 6:30,155,65,90,
26902,255,2022/4/15 6:40,225,108,117,
26903,255,2022/4/15 6:50,281,126,155,
26904,255,2022/4/15 7:00,361,118,243,
26905,255,2022/4/15 7:10,598,127,471,
26906,255,2022/4/15 7:20,724,104,620,
26907,255,2022/4/15 7:30,825,108,717,
26908,255,2022/4/15 7:40,1229,106,1123,
26909,255,2022/4/15 7:50,1558,120,1438,
26910,255,2022/4/15 8:00,1561,113,1448,
26911,255,2022/4/15 8:10,1366,119,1247,
26912,255,2022/4/15 8:20,1179,133,1046,
26913,255,2022/4/15 8:30,859,128,731,
26914,255,2022/4/15 8:40,684,109,575,
26915,255,2022/4/15 8:50,476,126,350,
26916,255,2022/4/15 9:00,354,103,251,
26917,255,2022/4/15 9:10,278,106,172,
26918,255,2022/4/15 9:20,232,111,121,
26919,255,2022/4/15 9:30,183,75,108,
26920,255,2022/4/15 9:40,144,98,46,
26921,255,2022/4/15 9:50,97,83,14,
26922,255,2022/4/15 10:00,64,75,-11,
26923,255,2022/4/15 10:10,63,84,-21,
26924,255,2022/4/15 10:20,42,69,-27,
26925,255,2022/4/15 10:30,44,82,-38,
26926,255,2022/4/15 10:40,37,66,-29,
26927,255,2022/4/15 10:50,41,85,-44,
26928,255,2022/4/15 11:00,38,77,-39,
26929,255,2022/4/15 11:10,37,84,-47,
26930,255,2022/4/15 11:20,37,78,-41,
26931,255,2022/4/15 11:30,42,69,-27,
26932,255,2022/4/15 11:40,43,81,-38,
26933,255,2022/4/15 11:50,40,76,-36,
26934,255,2022/4/15 12:00,44,83,-39,
26935,255,2022/4/15 12:10,45,78,-33,
26936,255,2022/4/15 12:20,44,64,-20,
26937,255,2022/4/15 12:30,48,80,-32,
26938,255,2022/4/15 12:40,44,84,-40,
26939,255,2022/4/15 12:50,40,80,-40,
26940,255,2022/4/15 13:00,44,76,-32,
26941,255,2022/4/15 13:10,42,75,-33,
26942,255,2022/4/15 13:20,41,69,-28,
26943,255,2022/4/15 13:30,43,77,-34,
26944,255,2022/4/15 13:40,40,83,-43,
26945,255,2022/4/15 13:50,36,99,-63,
26946,255,2022/4/15 14:00,39,90,-51,
26947,255,2022/4/15 14:10,26,77,-51,
26948,255,2022/4/15 14:20,36,96,-60,
26949,255,2022/4/15 14:30,30,101,-71,
26950,255,2022/4/15 14:40,33,96,-63,
26951,255,2022/4/15 14:50,39,108,-69,
26952,255,2022/4/15 15:00,33,84,-51,
26953,255,2022/4/15 15:10,35,93,-58,
26954,255,2022/4/15 15:20,40,103,-63,
26955,255,2022/4/15 15:30,35,109,-74,
26956,255,2022/4/15 15:40,35,105,-70,
26957,255,2022/4/15 15:50,38,104,-66,
26958,255,2022/4/15 16:00,42,125,-83,
26959,255,2022/4/15 16:10,41,109,-68,
26960,255,2022/4/15 16:20,45,121,-76,
26961,255,2022/4/15 16:30,71,106,-35,
26962,255,2022/4/15 16:40,61,111,-50,
26963,255,2022/4/15 16:50,70,152,-82,
26964,255,2022/4/15 17:00,138,142,-4,
26965,255,2022/4/15 17:10,190,109,81,
26966,255,2022/4/15 17:20,233,264,-31,
26967,255,2022/4/15 17:30,175,333,-158,
26968,255,2022/4/15 17:40,233,330,-97,
26969,255,2022/4/15 17:50,241,345,-104,
26970,255,2022/4/15 18:00,126,328,-202,
26971,255,2022/4/15 18:10,188,502,-314,
26972,255,2022/4/15 18:20,175,425,-250,
26973,255,2022/4/15 18:30,92,432,-340,
26974,255,2022/4/15 18:40,57,432,-375,
26975,255,2022/4/15 18:50,50,430,-380,
26976,255,2022/4/15 19:00,36,327,-291,
26977,255,2022/4/15 19:10,35,322,-287,
26978,255,2022/4/15 19:20,30,300,-270,
26979,255,2022/4/15 19:30,28,336,-308,
26980,255,2022/4/15 19:40,28,158,-130,
26981,255,2022/4/15 19:50,30,110,-80,
26982,255,2022/4/15 20:00,27,106,-79,
26983,255,2022/4/15 20:10,28,104,-76,
26984,255,2022/4/15 20:20,27,121,-94,
26985,255,2022/4/15 20:30,30,110,-80,
26986,255,2022/4/15 20:40,26,111,-85,
26987,255,2022/4/15 20:50,28,124,-96,
26988,255,2022/4/15 21:00,27,107,-80,
26989,255,2022/4/15 21:10,26,120,-94,
26990,255,2022/4/15 21:20,27,113,-86,
26991,255,2022/4/15 21:30,27,111,-84,
26992,255,2022/4/15 21:40,21,123,-102,
26993,255,2022/4/15 21:50,19,125,-106,
26994,255,2022/4/15 22:00,18,124,-106,
26995,255,2022/4/15 22:10,16,107,-91,
26996,255,2022/4/15 22:20,13,112,-99,
26997,255,2022/4/15 22:30,10,104,-94,
26998,255,2022/4/15 22:40,4,108,-104,
26999,255,2022/4/15 22:50,2,80,-78,
27000,234,2022/4/15 5:00,0,1,-1,
27001,234,2022/4/15 5:10,0,1,-1,
27002,234,2022/4/15 5:20,3,1,2,
27003,234,2022/4/15 5:30,9,1,8,
27004,234,2022/4/15 5:40,10,1,9,
27005,234,2022/4/15 5:50,12,1,11,
27006,234,2022/4/15 6:00,21,1,20,
27007,234,2022/4/15 6:10,20,1,19,
27008,234,2022/4/15 6:20,25,23,2,
27009,234,2022/4/15 6:30,26,14,12,
27010,234,2022/4/15 6:40,32,16,16,
27011,234,2022/4/15 6:50,34,23,11,
27012,234,2022/4/15 7:00,40,23,17,
27013,234,2022/4/15 7:10,57,33,24,
27014,234,2022/4/15 7:20,59,66,-7,
27015,234,2022/4/15 7:30,85,46,39,
27016,234,2022/4/15 7:40,176,62,114,
27017,234,2022/4/15 7:50,221,62,159,
27018,234,2022/4/15 8:00,224,76,148,
27019,234,2022/4/15 8:10,216,107,109,
27020,234,2022/4/15 8:20,179,99,80,
27021,234,2022/4/15 8:30,106,97,9,
27022,234,2022/4/15 8:40,70,75,-5,
27023,234,2022/4/15 8:50,51,76,-25,
27024,234,2022/4/15 9:00,44,70,-26,
27025,234,2022/4/15 9:10,36,67,-31,
27026,234,2022/4/15 9:20,28,60,-32,
27027,234,2022/4/15 9:30,26,63,-37,
27028,234,2022/4/15 9:40,28,51,-23,
27029,234,2022/4/15 9:50,22,51,-29,
27030,234,2022/4/15 10:00,20,47,-27,
27031,234,2022/4/15 10:10,21,42,-21,
27032,234,2022/4/15 10:20,16,38,-22,
27033,234,2022/4/15 10:30,15,43,-28,
27034,234,2022/4/15 10:40,16,35,-19,
27035,234,2022/4/15 10:50,13,38,-25,
27036,234,2022/4/15 11:00,15,32,-17,
27037,234,2022/4/15 11:10,16,33,-17,
27038,234,2022/4/15 11:20,16,38,-22,
27039,234,2022/4/15 11:30,17,35,-18,
27040,234,2022/4/15 11:40,15,38,-23,
27041,234,2022/4/15 11:50,16,38,-22,
27042,234,2022/4/15 12:00,18,31,-13,
27043,234,2022/4/15 12:10,18,38,-20,
27044,234,2022/4/15 12:20,15,47,-32,
27045,234,2022/4/15 12:30,17,38,-21,
27046,234,2022/4/15 12:40,16,45,-29,
27047,234,2022/4/15 12:50,16,40,-24,
27048,234,2022/4/15 13:00,15,35,-20,
27049,234,2022/4/15 13:10,19,47,-28,
27050,234,2022/4/15 13:20,16,43,-27,
27051,234,2022/4/15 13:30,15,45,-30,
27052,234,2022/4/15 13:40,14,47,-33,
27053,234,2022/4/15 13:50,16,25,-9,
27054,234,2022/4/15 14:00,17,41,-24,
27055,234,2022/4/15 14:10,16,47,-31,
27056,234,2022/4/15 14:20,15,47,-32,
27057,234,2022/4/15 14:30,16,41,-25,
27058,234,2022/4/15 14:40,15,31,-16,
27059,234,2022/4/15 14:50,17,38,-21,
27060,234,2022/4/15 15:00,16,43,-27,
27061,234,2022/4/15 15:10,19,45,-26,
27062,234,2022/4/15 15:20,17,45,-28,
27063,234,2022/4/15 15:30,15,46,-31,
27064,234,2022/4/15 15:40,16,37,-21,
27065,234,2022/4/15 15:50,17,46,-29,
27066,234,2022/4/15 16:00,18,50,-32,
27067,234,2022/4/15 16:10,18,51,-33,
27068,234,2022/4/15 16:20,21,50,-29,
27069,234,2022/4/15 16:30,24,55,-31,
27070,234,2022/4/15 16:40,29,61,-32,
27071,234,2022/4/15 16:50,25,48,-23,
27072,234,2022/4/15 17:00,37,64,-27,
27073,234,2022/4/15 17:10,60,71,-11,
27074,234,2022/4/15 17:20,32,72,-40,
27075,234,2022/4/15 17:30,39,70,-31,
27076,234,2022/4/15 17:40,46,79,-33,
27077,234,2022/4/15 17:50,35,114,-79,
27078,234,2022/4/15 18:00,30,95,-65,
27079,234,2022/4/15 18:10,31,83,-52,
27080,234,2022/4/15 18:20,29,93,-64,
27081,234,2022/4/15 18:30,28,110,-82,
27082,234,2022/4/15 18:40,23,125,-102,
27083,234,2022/4/15 18:50,20,89,-69,
27084,234,2022/4/15 19:00,19,97,-78,
27085,234,2022/4/15 19:10,15,106,-91,
27086,234,2022/4/15 19:20,15,95,-80,
27087,234,2022/4/15 19:30,15,94,-79,
27088,234,2022/4/15 19:40,14,79,-65,
27089,234,2022/4/15 19:50,15,77,-62,
27090,234,2022/4/15 20:00,15,73,-58,
27091,234,2022/4/15 20:10,13,74,-61,
27092,234,2022/4/15 20:20,10,59,-49,
27093,234,2022/4/15 20:30,10,62,-52,
27094,234,2022/4/15 20:40,8,62,-54,
27095,234,2022/4/15 20:50,10,72,-62,
27096,234,2022/4/15 21:00,10,64,-54,
27097,234,2022/4/15 21:10,13,42,-29,
27098,234,2022/4/15 21:20,10,67,-57,
27099,234,2022/4/15 21:30,11,59,-48,
27100,234,2022/4/15 21:40,7,63,-56,
27101,234,2022/4/15 21:50,9,68,-59,
27102,234,2022/4/15 22:00,5,57,-52,
27103,234,2022/4/15 22:10,5,67,-62,
27104,234,2022/4/15 22:20,10,52,-42,
27105,234,2022/4/15 22:30,2,58,-56,
27106,234,2022/4/15 22:40,2,54,-52,
27107,234,2022/4/15 22:50,1,40,-39,
27108,233,2022/4/15 5:00,0,1,-1,
27109,233,2022/4/15 5:10,0,1,-1,
27110,233,2022/4/15 5:20,15,1,14,
27111,233,2022/4/15 5:30,27,1,26,
27112,233,2022/4/15 5:40,32,1,31,
27113,233,2022/4/15 5:50,36,8,28,
27114,233,2022/4/15 6:00,54,5,49,
27115,233,2022/4/15 6:10,59,11,48,
27116,233,2022/4/15 6:20,87,38,49,
27117,233,2022/4/15 6:30,123,38,85,
27118,233,2022/4/15 6:40,222,49,173,
27119,233,2022/4/15 6:50,224,61,163,
27120,233,2022/4/15 7:00,278,71,207,
27121,233,2022/4/15 7:10,282,76,206,
27122,233,2022/4/15 7:20,352,76,276,
27123,233,2022/4/15 7:30,597,81,516,
27124,233,2022/4/15 7:40,681,108,573,
27125,233,2022/4/15 7:50,744,100,644,
27126,233,2022/4/15 8:00,739,88,651,
27127,233,2022/4/15 8:10,693,100,593,
27128,233,2022/4/15 8:20,670,93,577,
27129,233,2022/4/15 8:30,598,93,505,
27130,233,2022/4/15 8:40,347,112,235,
27131,233,2022/4/15 8:50,278,90,188,
27132,233,2022/4/15 9:00,205,94,111,
27133,233,2022/4/15 9:10,187,93,94,
27134,233,2022/4/15 9:20,177,97,80,
27135,233,2022/4/15 9:30,82,74,8,
27136,233,2022/4/15 9:40,70,87,-17,
27137,233,2022/4/15 9:50,59,75,-16,
27138,233,2022/4/15 10:00,46,79,-33,
27139,233,2022/4/15 10:10,44,83,-39,
27140,233,2022/4/15 10:20,41,66,-25,
27141,233,2022/4/15 10:30,36,64,-28,
27142,233,2022/4/15 10:40,33,68,-35,
27143,233,2022/4/15 10:50,30,60,-30,
27144,233,2022/4/15 11:00,30,74,-44,
27145,233,2022/4/15 11:10,32,67,-35,
27146,233,2022/4/15 11:20,29,67,-38,
27147,233,2022/4/15 11:30,31,56,-25,
27148,233,2022/4/15 11:40,31,66,-35,
27149,233,2022/4/15 11:50,35,70,-35,
27150,233,2022/4/15 12:00,38,67,-29,
27151,233,2022/4/15 12:10,39,72,-33,
27152,233,2022/4/15 12:20,39,67,-28,
27153,233,2022/4/15 12:30,38,52,-14,
27154,233,2022/4/15 12:40,39,76,-37,
27155,233,2022/4/15 12:50,32,82,-50,
27156,233,2022/4/15 13:00,35,68,-33,
27157,233,2022/4/15 13:10,31,78,-47,
27158,233,2022/4/15 13:20,32,66,-34,
27159,233,2022/4/15 13:30,32,66,-34,
27160,233,2022/4/15 13:40,30,71,-41,
27161,233,2022/4/15 13:50,28,82,-54,
27162,233,2022/4/15 14:00,33,84,-51,
27163,233,2022/4/15 14:10,26,73,-47,
27164,233,2022/4/15 14:20,28,65,-37,
27165,233,2022/4/15 14:30,28,77,-49,
27166,233,2022/4/15 14:40,27,75,-48,
27167,233,2022/4/15 14:50,27,93,-66,
27168,233,2022/4/15 15:00,29,97,-68,
27169,233,2022/4/15 15:10,24,74,-50,
27170,233,2022/4/15 15:20,28,93,-65,
27171,233,2022/4/15 15:30,25,106,-81,
27172,233,2022/4/15 15:40,25,93,-68,
27173,233,2022/4/15 15:50,26,112,-86,
27174,233,2022/4/15 16:00,28,102,-74,
27175,233,2022/4/15 16:10,34,105,-71,
27176,233,2022/4/15 16:20,29,90,-61,
27177,233,2022/4/15 16:30,33,107,-74,
27178,233,2022/4/15 16:40,40,124,-84,
27179,233,2022/4/15 16:50,37,111,-74,
27180,233,2022/4/15 17:00,46,107,-61,
27181,233,2022/4/15 17:10,45,108,-63,
27182,233,2022/4/15 17:20,45,120,-75,
27183,233,2022/4/15 17:30,46,196,-150,
27184,233,2022/4/15 17:40,43,222,-179,
27185,233,2022/4/15 17:50,37,178,-141,
27186,233,2022/4/15 18:00,43,224,-181,
27187,233,2022/4/15 18:10,44,232,-188,
27188,233,2022/4/15 18:20,38,325,-287,
27189,233,2022/4/15 18:30,38,378,-340,
27190,233,2022/4/15 18:40,34,285,-251,
27191,233,2022/4/15 18:50,35,348,-313,
27192,233,2022/4/15 19:00,33,256,-223,
27193,233,2022/4/15 19:10,30,224,-194,
27194,233,2022/4/15 19:20,27,180,-153,
27195,233,2022/4/15 19:30,29,184,-155,
27196,233,2022/4/15 19:40,25,107,-82,
27197,233,2022/4/15 19:50,27,128,-101,
27198,233,2022/4/15 20:00,22,126,-104,
27199,233,2022/4/15 20:10,28,113,-85,
27200,233,2022/4/15 20:20,22,106,-84,
27201,233,2022/4/15 20:30,23,112,-89,
27202,233,2022/4/15 20:40,23,120,-97,
27203,233,2022/4/15 20:50,23,112,-89,
27204,233,2022/4/15 21:00,23,111,-88,
27205,233,2022/4/15 21:10,21,110,-89,
27206,233,2022/4/15 21:20,20,106,-86,
27207,233,2022/4/15 21:30,16,88,-72,
27208,233,2022/4/15 21:40,18,98,-80,
27209,233,2022/4/15 21:50,13,112,-99,
27210,233,2022/4/15 22:00,15,107,-92,
27211,233,2022/4/15 22:10,11,103,-92,
27212,233,2022/4/15 22:20,10,103,-93,
27213,233,2022/4/15 22:30,5,104,-99,
27214,233,2022/4/15 22:40,5,106,-101,
27215,233,2022/4/15 22:50,2,94,-92,
27216,252,2022/4/15 5:00,0,1,-1,
27217,252,2022/4/15 5:10,2,1,1,
27218,252,2022/4/15 5:20,13,1,12,
27219,252,2022/4/15 5:30,16,1,15,
27220,252,2022/4/15 5:40,20,1,19,
27221,252,2022/4/15 5:50,28,1,27,
27222,252,2022/4/15 6:00,24,2,22,
27223,252,2022/4/15 6:10,33,1,32,
27224,252,2022/4/15 6:20,47,19,28,
27225,252,2022/4/15 6:30,60,8,52,
27226,252,2022/4/15 6:40,68,38,30,
27227,252,2022/4/15 6:50,87,34,53,
27228,252,2022/4/15 7:00,109,40,69,
27229,252,2022/4/15 7:10,168,58,110,
27230,252,2022/4/15 7:20,170,47,123,
27231,252,2022/4/15 7:30,214,60,154,
27232,252,2022/4/15 7:40,268,75,193,
27233,252,2022/4/15 7:50,284,79,205,
27234,252,2022/4/15 8:00,282,92,190,
27235,252,2022/4/15 8:10,236,118,118,
27236,252,2022/4/15 8:20,210,107,103,
27237,252,2022/4/15 8:30,184,87,97,
27238,252,2022/4/15 8:40,101,103,-2,
27239,252,2022/4/15 8:50,76,93,-17,
27240,252,2022/4/15 9:00,60,85,-25,
27241,252,2022/4/15 9:10,47,74,-27,
27242,252,2022/4/15 9:20,38,61,-23,
27243,252,2022/4/15 9:30,34,73,-39,
27244,252,2022/4/15 9:40,31,62,-31,
27245,252,2022/4/15 9:50,29,47,-18,
27246,252,2022/4/15 10:00,28,63,-35,
27247,252,2022/4/15 10:10,27,51,-24,
27248,252,2022/4/15 10:20,24,50,-26,
27249,252,2022/4/15 10:30,23,48,-25,
27250,252,2022/4/15 10:40,22,32,-10,
27251,252,2022/4/15 10:50,27,51,-24,
27252,252,2022/4/15 11:00,21,49,-28,
27253,252,2022/4/15 11:10,26,38,-12,
27254,252,2022/4/15 11:20,25,49,-24,
27255,252,2022/4/15 11:30,20,51,-31,
27256,252,2022/4/15 11:40,23,48,-25,
27257,252,2022/4/15 11:50,22,45,-23,
27258,252,2022/4/15 12:00,25,38,-13,
27259,252,2022/4/15 12:10,23,50,-27,
27260,252,2022/4/15 12:20,26,55,-29,
27261,252,2022/4/15 12:30,26,55,-29,
27262,252,2022/4/15 12:40,21,55,-34,
27263,252,2022/4/15 12:50,23,55,-32,
27264,252,2022/4/15 13:00,23,40,-17,
27265,252,2022/4/15 13:10,22,61,-39,
27266,252,2022/4/15 13:20,21,55,-34,
27267,252,2022/4/15 13:30,20,56,-36,
27268,252,2022/4/15 13:40,18,51,-33,
27269,252,2022/4/15 13:50,22,40,-18,
27270,252,2022/4/15 14:00,22,51,-29,
27271,252,2022/4/15 14:10,21,51,-30,
27272,252,2022/4/15 14:20,20,59,-39,
27273,252,2022/4/15 14:30,19,53,-34,
27274,252,2022/4/15 14:40,21,51,-30,
27275,252,2022/4/15 14:50,18,42,-24,
27276,252,2022/4/15 15:00,23,54,-31,
27277,252,2022/4/15 15:10,20,58,-38,
27278,252,2022/4/15 15:20,22,61,-39,
27279,252,2022/4/15 15:30,21,64,-43,
27280,252,2022/4/15 15:40,23,51,-28,
27281,252,2022/4/15 15:50,22,69,-47,
27282,252,2022/4/15 16:00,22,68,-46,
27283,252,2022/4/15 16:10,23,70,-47,
27284,252,2022/4/15 16:20,24,70,-46,
27285,252,2022/4/15 16:30,25,85,-60,
27286,252,2022/4/15 16:40,25,75,-50,
27287,252,2022/4/15 16:50,36,64,-28,
27288,252,2022/4/15 17:00,37,77,-40,
27289,252,2022/4/15 17:10,43,93,-50,
27290,252,2022/4/15 17:20,30,96,-66,
27291,252,2022/4/15 17:30,33,114,-81,
27292,252,2022/4/15 17:40,42,113,-71,
27293,252,2022/4/15 17:50,43,113,-70,
27294,252,2022/4/15 18:00,47,105,-58,
27295,252,2022/4/15 18:10,36,108,-72,
27296,252,2022/4/15 18:20,33,110,-77,
27297,252,2022/4/15 18:30,29,133,-104,
27298,252,2022/4/15 18:40,26,122,-96,
27299,252,2022/4/15 18:50,25,122,-97,
27300,252,2022/4/15 19:00,22,127,-105,
27301,252,2022/4/15 19:10,20,106,-86,
27302,252,2022/4/15 19:20,20,107,-87,
27303,252,2022/4/15 19:30,13,102,-89,
27304,252,2022/4/15 19:40,13,83,-70,
27305,252,2022/4/15 19:50,13,81,-68,
27306,252,2022/4/15 20:00,14,80,-66,
27307,252,2022/4/15 20:10,12,79,-67,
27308,252,2022/4/15 20:20,12,81,-69,
27309,252,2022/4/15 20:30,13,69,-56,
27310,252,2022/4/15 20:40,16,64,-48,
27311,252,2022/4/15 20:50,13,71,-58,
27312,252,2022/4/15 21:00,12,75,-63,
27313,252,2022/4/15 21:10,12,71,-59,
27314,252,2022/4/15 21:20,9,76,-67,
27315,252,2022/4/15 21:30,10,58,-48,
27316,252,2022/4/15 21:40,6,73,-67,
27317,252,2022/4/15 21:50,7,74,-67,
27318,252,2022/4/15 22:00,5,68,-63,
27319,252,2022/4/15 22:10,4,62,-58,
27320,252,2022/4/15 22:20,2,68,-66,
27321,252,2022/4/15 22:30,2,63,-61,
27322,252,2022/4/15 22:40,0,64,-64,
27323,252,2022/4/15 22:50,0,59,-59,
27324,249,2022/4/15 5:00,0,1,-1,
27325,249,2022/4/15 5:10,1,1,0,
27326,249,2022/4/15 5:20,6,1,5,
27327,249,2022/4/15 5:30,5,1,4,
27328,249,2022/4/15 5:40,17,1,16,
27329,249,2022/4/15 5:50,14,1,13,
27330,249,2022/4/15 6:00,25,1,24,
27331,249,2022/4/15 6:10,31,1,30,
27332,249,2022/4/15 6:20,34,14,20,
27333,249,2022/4/15 6:30,34,8,26,
27334,249,2022/4/15 6:40,45,16,29,
27335,249,2022/4/15 6:50,53,22,31,
27336,249,2022/4/15 7:00,53,23,30,
27337,249,2022/4/15 7:10,71,49,22,
27338,249,2022/4/15 7:20,149,62,87,
27339,249,2022/4/15 7:30,179,72,107,
27340,249,2022/4/15 7:40,238,71,167,
27341,249,2022/4/15 7:50,282,83,199,
27342,249,2022/4/15 8:00,232,83,149,
27343,249,2022/4/15 8:10,235,77,158,
27344,249,2022/4/15 8:20,212,77,135,
27345,249,2022/4/15 8:30,155,71,84,
27346,249,2022/4/15 8:40,73,48,25,
27347,249,2022/4/15 8:50,54,53,1,
27348,249,2022/4/15 9:00,45,50,-5,
27349,249,2022/4/15 9:10,35,42,-7,
27350,249,2022/4/15 9:20,36,57,-21,
27351,249,2022/4/15 9:30,28,50,-22,
27352,249,2022/4/15 9:40,27,58,-31,
27353,249,2022/4/15 9:50,26,54,-28,
27354,249,2022/4/15 10:00,22,47,-25,
27355,249,2022/4/15 10:10,22,35,-13,
27356,249,2022/4/15 10:20,21,38,-17,
27357,249,2022/4/15 10:30,21,24,-3,
27358,249,2022/4/15 10:40,19,32,-13,
27359,249,2022/4/15 10:50,20,31,-11,
27360,249,2022/4/15 11:00,21,40,-19,
27361,249,2022/4/15 11:10,22,39,-17,
27362,249,2022/4/15 11:20,21,35,-14,
27363,249,2022/4/15 11:30,22,37,-15,
27364,249,2022/4/15 11:40,20,34,-14,
27365,249,2022/4/15 11:50,22,38,-16,
27366,249,2022/4/15 12:00,21,36,-15,
27367,249,2022/4/15 12:10,22,38,-16,
27368,249,2022/4/15 12:20,25,42,-17,
27369,249,2022/4/15 12:30,25,38,-13,
27370,249,2022/4/15 12:40,23,46,-23,
27371,249,2022/4/15 12:50,21,47,-26,
27372,249,2022/4/15 13:00,21,53,-32,
27373,249,2022/4/15 13:10,22,51,-29,
27374,249,2022/4/15 13:20,23,39,-16,
27375,249,2022/4/15 13:30,22,23,-1,
27376,249,2022/4/15 13:40,21,40,-19,
27377,249,2022/4/15 13:50,20,41,-21,
27378,249,2022/4/15 14:00,20,38,-18,
27379,249,2022/4/15 14:10,22,38,-16,
27380,249,2022/4/15 14:20,20,32,-12,
27381,249,2022/4/15 14:30,17,38,-21,
27382,249,2022/4/15 14:40,21,41,-20,
27383,249,2022/4/15 14:50,23,41,-18,
27384,249,2022/4/15 15:00,25,49,-24,
27385,249,2022/4/15 15:10,22,38,-16,
27386,249,2022/4/15 15:20,20,38,-18,
27387,249,2022/4/15 15:30,18,52,-34,
27388,249,2022/4/15 15:40,22,48,-26,
27389,249,2022/4/15 15:50,23,50,-27,
27390,249,2022/4/15 16:00,24,54,-30,
27391,249,2022/4/15 16:10,25,53,-28,
27392,249,2022/4/15 16:20,26,52,-26,
27393,249,2022/4/15 16:30,31,45,-14,
27394,249,2022/4/15 16:40,30,62,-32,
27395,249,2022/4/15 16:50,27,71,-44,
27396,249,2022/4/15 17:00,23,72,-49,
27397,249,2022/4/15 17:10,23,69,-46,
27398,249,2022/4/15 17:20,16,77,-61,
27399,249,2022/4/15 17:30,24,98,-74,
27400,249,2022/4/15 17:40,20,99,-79,
27401,249,2022/4/15 17:50,18,98,-80,
27402,249,2022/4/15 18:00,17,107,-90,
27403,249,2022/4/15 18:10,17,126,-109,
27404,249,2022/4/15 18:20,15,125,-110,
27405,249,2022/4/15 18:30,18,84,-66,
27406,249,2022/4/15 18:40,15,122,-107,
27407,249,2022/4/15 18:50,12,125,-113,
27408,249,2022/4/15 19:00,12,127,-115,
27409,249,2022/4/15 19:10,11,106,-95,
27410,249,2022/4/15 19:20,11,107,-96,
27411,249,2022/4/15 19:30,9,106,-97,
27412,249,2022/4/15 19:40,9,88,-79,
27413,249,2022/4/15 19:50,10,75,-65,
27414,249,2022/4/15 20:00,12,85,-73,
27415,249,2022/4/15 20:10,13,79,-66,
27416,249,2022/4/15 20:20,11,62,-51,
27417,249,2022/4/15 20:30,9,82,-73,
27418,249,2022/4/15 20:40,12,74,-62,
27419,249,2022/4/15 20:50,11,70,-59,
27420,249,2022/4/15 21:00,9,66,-57,
27421,249,2022/4/15 21:10,6,70,-64,
27422,249,2022/4/15 21:20,5,75,-70,
27423,249,2022/4/15 21:30,4,71,-67,
27424,249,2022/4/15 21:40,5,69,-64,
27425,249,2022/4/15 21:50,5,60,-55,
27426,249,2022/4/15 22:00,1,63,-62,
27427,249,2022/4/15 22:10,1,68,-67,
27428,249,2022/4/15 22:20,2,61,-59,
27429,249,2022/4/15 22:30,1,52,-51,
27430,249,2022/4/15 22:40,0,59,-59,
27431,249,2022/4/15 22:50,0,53,-53,
27432,251,2022/4/15 5:00,0,1,-1,
27433,251,2022/4/15 5:10,1,1,0,
27434,251,2022/4/15 5:20,3,1,2,
27435,251,2022/4/15 5:30,5,1,4,
27436,251,2022/4/15 5:40,6,1,5,
27437,251,2022/4/15 5:50,7,1,6,
27438,251,2022/4/15 6:00,9,1,8,
27439,251,2022/4/15 6:10,18,1,17,
27440,251,2022/4/15 6:20,19,6,13,
27441,251,2022/4/15 6:30,26,12,14,
27442,251,2022/4/15 6:40,32,11,21,
27443,251,2022/4/15 6:50,32,11,21,
27444,251,2022/4/15 7:00,29,13,16,
27445,251,2022/4/15 7:10,54,21,33,
27446,251,2022/4/15 7:20,43,11,32,
27447,251,2022/4/15 7:30,68,8,60,
27448,251,2022/4/15 7:40,79,23,56,
27449,251,2022/4/15 7:50,59,23,36,
27450,251,2022/4/15 8:00,68,30,38,
27451,251,2022/4/15 8:10,64,33,31,
27452,251,2022/4/15 8:20,52,30,22,
27453,251,2022/4/15 8:30,38,23,15,
27454,251,2022/4/15 8:40,33,21,12,
27455,251,2022/4/15 8:50,28,23,5,
27456,251,2022/4/15 9:00,24,21,3,
27457,251,2022/4/15 9:10,17,23,-6,
27458,251,2022/4/15 9:20,15,22,-7,
27459,251,2022/4/15 9:30,13,22,-9,
27460,251,2022/4/15 9:40,10,16,-6,
27461,251,2022/4/15 9:50,10,20,-10,
27462,251,2022/4/15 10:00,8,24,-16,
27463,251,2022/4/15 10:10,10,22,-12,
27464,251,2022/4/15 10:20,8,19,-11,
27465,251,2022/4/15 10:30,7,16,-9,
27466,251,2022/4/15 10:40,5,23,-18,
27467,251,2022/4/15 10:50,7,19,-12,
27468,251,2022/4/15 11:00,8,18,-10,
27469,251,2022/4/15 11:10,8,19,-11,
27470,251,2022/4/15 11:20,9,21,-12,
27471,251,2022/4/15 11:30,9,12,-3,
27472,251,2022/4/15 11:40,9,14,-5,
27473,251,2022/4/15 11:50,8,18,-10,
27474,251,2022/4/15 12:00,7,19,-12,
27475,251,2022/4/15 12:10,8,17,-9,
27476,251,2022/4/15 12:20,8,15,-7,
27477,251,2022/4/15 12:30,9,17,-8,
27478,251,2022/4/15 12:40,9,14,-5,
27479,251,2022/4/15 12:50,10,19,-9,
27480,251,2022/4/15 13:00,8,19,-11,
27481,251,2022/4/15 13:10,5,12,-7,
27482,251,2022/4/15 13:20,6,17,-11,
27483,251,2022/4/15 13:30,5,21,-16,
27484,251,2022/4/15 13:40,8,14,-6,
27485,251,2022/4/15 13:50,5,21,-16,
27486,251,2022/4/15 14:00,7,21,-14,
27487,251,2022/4/15 14:10,4,19,-15,
27488,251,2022/4/15 14:20,5,21,-16,
27489,251,2022/4/15 14:30,6,13,-7,
27490,251,2022/4/15 14:40,6,23,-17,
27491,251,2022/4/15 14:50,6,19,-13,
27492,251,2022/4/15 15:00,8,23,-15,
27493,251,2022/4/15 15:10,5,23,-18,
27494,251,2022/4/15 15:20,6,23,-17,
27495,251,2022/4/15 15:30,7,21,-14,
27496,251,2022/4/15 15:40,7,23,-16,
27497,251,2022/4/15 15:50,9,25,-16,
27498,251,2022/4/15 16:00,7,21,-14,
27499,251,2022/4/15 16:10,9,23,-14,
27500,251,2022/4/15 16:20,6,25,-19,
27501,251,2022/4/15 16:30,8,32,-24,
27502,251,2022/4/15 16:40,8,23,-15,
27503,251,2022/4/15 16:50,8,39,-31,
27504,251,2022/4/15 17:00,11,37,-26,
27505,251,2022/4/15 17:10,7,38,-31,
27506,251,2022/4/15 17:20,7,45,-38,
27507,251,2022/4/15 17:30,5,46,-41,
27508,251,2022/4/15 17:40,7,50,-43,
27509,251,2022/4/15 17:50,8,50,-42,
27510,251,2022/4/15 18:00,6,63,-57,
27511,251,2022/4/15 18:10,6,65,-59,
27512,251,2022/4/15 18:20,6,63,-57,
27513,251,2022/4/15 18:30,4,70,-66,
27514,251,2022/4/15 18:40,6,75,-69,
27515,251,2022/4/15 18:50,4,59,-55,
27516,251,2022/4/15 19:00,3,80,-77,
27517,251,2022/4/15 19:10,4,74,-70,
27518,251,2022/4/15 19:20,3,62,-59,
27519,251,2022/4/15 19:30,2,53,-51,
27520,251,2022/4/15 19:40,3,54,-51,
27521,251,2022/4/15 19:50,2,40,-38,
27522,251,2022/4/15 20:00,2,40,-38,
27523,251,2022/4/15 20:10,2,34,-32,
27524,251,2022/4/15 20:20,1,35,-34,
27525,251,2022/4/15 20:30,1,40,-39,
27526,251,2022/4/15 20:40,1,37,-36,
27527,251,2022/4/15 20:50,2,35,-33,
27528,251,2022/4/15 21:00,1,31,-30,
27529,251,2022/4/15 21:10,3,27,-24,
27530,251,2022/4/15 21:20,2,25,-23,
27531,251,2022/4/15 21:30,1,35,-34,
27532,251,2022/4/15 21:40,1,33,-32,
27533,251,2022/4/15 21:50,1,32,-31,
27534,251,2022/4/15 22:00,1,39,-38,
27535,251,2022/4/15 22:10,0,33,-33,
27536,251,2022/4/15 22:20,0,26,-26,
27537,251,2022/4/15 22:30,0,35,-35,
27538,251,2022/4/15 22:40,0,35,-35,
27539,251,2022/4/15 22:50,0,34,-34,
27540,238,2022/4/15 5:00,0,1,-1,
27541,238,2022/4/15 5:10,2,1,1,
27542,238,2022/4/15 5:20,16,1,15,
27543,238,2022/4/15 5:30,31,1,30,
27544,238,2022/4/15 5:40,32,5,27,
27545,238,2022/4/15 5:50,38,5,33,
27546,238,2022/4/15 6:00,83,1,82,
27547,238,2022/4/15 6:10,71,5,66,
27548,238,2022/4/15 6:20,181,5,176,
27549,238,2022/4/15 6:30,237,67,170,
27550,238,2022/4/15 6:40,302,37,265,
27551,238,2022/4/15 6:50,275,72,203,
27552,238,2022/4/15 7:00,601,66,535,
27553,238,2022/4/15 7:10,700,79,621,
27554,238,2022/4/15 7:20,850,93,757,
27555,238,2022/4/15 7:30,1226,105,1121,
27556,238,2022/4/15 7:40,1371,109,1262,
27557,238,2022/4/15 7:50,1364,123,1241,
27558,238,2022/4/15 8:00,1363,91,1272,
27559,238,2022/4/15 8:10,1169,108,1061,
27560,238,2022/4/15 8:20,842,123,719,
27561,238,2022/4/15 8:30,719,159,560,
27562,238,2022/4/15 8:40,469,110,359,
27563,238,2022/4/15 8:50,361,103,258,
27564,238,2022/4/15 9:00,274,120,154,
27565,238,2022/4/15 9:10,217,118,99,
27566,238,2022/4/15 9:20,182,110,72,
27567,238,2022/4/15 9:30,116,174,-58,
27568,238,2022/4/15 9:40,85,154,-69,
27569,238,2022/4/15 9:50,75,113,-38,
27570,238,2022/4/15 10:00,62,179,-117,
27571,238,2022/4/15 10:10,67,128,-61,
27572,238,2022/4/15 10:20,62,128,-66,
27573,238,2022/4/15 10:30,59,144,-85,
27574,238,2022/4/15 10:40,38,116,-78,
27575,238,2022/4/15 10:50,58,125,-67,
27576,238,2022/4/15 11:00,43,119,-76,
27577,238,2022/4/15 11:10,47,85,-38,
27578,238,2022/4/15 11:20,44,121,-77,
27579,238,2022/4/15 11:30,61,109,-48,
27580,238,2022/4/15 11:40,69,108,-39,
27581,238,2022/4/15 11:50,74,109,-35,
27582,238,2022/4/15 12:00,64,121,-57,
27583,238,2022/4/15 12:10,84,112,-28,
27584,238,2022/4/15 12:20,69,120,-51,
27585,238,2022/4/15 12:30,70,114,-44,
27586,238,2022/4/15 12:40,56,97,-41,
27587,238,2022/4/15 12:50,115,88,27,
27588,238,2022/4/15 13:00,61,108,-47,
27589,238,2022/4/15 13:10,107,109,-2,
27590,238,2022/4/15 13:20,116,107,9,
27591,238,2022/4/15 13:30,107,105,2,
27592,238,2022/4/15 13:40,119,109,10,
27593,238,2022/4/15 13:50,104,109,-5,
27594,238,2022/4/15 14:00,104,108,-4,
27595,238,2022/4/15 14:10,112,112,0,
27596,238,2022/4/15 14:20,102,114,-12,
27597,238,2022/4/15 14:30,101,110,-9,
27598,238,2022/4/15 14:40,119,77,42,
27599,238,2022/4/15 14:50,102,117,-15,
27600,238,2022/4/15 15:00,108,124,-16,
27601,238,2022/4/15 15:10,119,150,-31,
27602,238,2022/4/15 15:20,132,75,57,
27603,238,2022/4/15 15:30,121,128,-7,
27604,238,2022/4/15 15:40,132,60,72,
27605,238,2022/4/15 15:50,130,117,13,
27606,238,2022/4/15 16:00,130,144,-14,
27607,238,2022/4/15 16:10,130,122,8,
27608,238,2022/4/15 16:20,125,120,5,
27609,238,2022/4/15 16:30,130,96,34,
27610,238,2022/4/15 16:40,176,197,-21,
27611,238,2022/4/15 16:50,169,112,57,
27612,238,2022/4/15 17:00,136,110,26,
27613,238,2022/4/15 17:10,185,145,40,
27614,238,2022/4/15 17:20,99,179,-80,
27615,238,2022/4/15 17:30,73,218,-145,
27616,238,2022/4/15 17:40,74,298,-224,
27617,238,2022/4/15 17:50,48,299,-251,
27618,238,2022/4/15 18:00,52,335,-283,
27619,238,2022/4/15 18:10,58,207,-149,
27620,238,2022/4/15 18:20,38,579,-541,
27621,238,2022/4/15 18:30,42,441,-399,
27622,238,2022/4/15 18:40,34,510,-476,
27623,238,2022/4/15 18:50,35,430,-395,
27624,238,2022/4/15 19:00,26,534,-508,
27625,238,2022/4/15 19:10,33,655,-622,
27626,238,2022/4/15 19:20,30,378,-348,
27627,238,2022/4/15 19:30,26,387,-361,
27628,238,2022/4/15 19:40,27,336,-309,
27629,238,2022/4/15 19:50,27,207,-180,
27630,238,2022/4/15 20:00,27,213,-186,
27631,238,2022/4/15 20:10,29,100,-71,
27632,238,2022/4/15 20:20,27,171,-144,
27633,238,2022/4/15 20:30,25,301,-276,
27634,238,2022/4/15 20:40,26,112,-86,
27635,238,2022/4/15 20:50,20,119,-99,
27636,238,2022/4/15 21:00,26,111,-85,
27637,238,2022/4/15 21:10,25,110,-85,
27638,238,2022/4/15 21:20,21,150,-129,
27639,238,2022/4/15 21:30,18,107,-89,
27640,238,2022/4/15 21:40,17,109,-92,
27641,238,2022/4/15 21:50,15,106,-91,
27642,238,2022/4/15 22:00,18,111,-93,
27643,238,2022/4/15 22:10,15,111,-96,
27644,238,2022/4/15 22:20,6,117,-111,
27645,238,2022/4/15 22:30,2,123,-121,
27646,238,2022/4/15 22:40,2,125,-123,
27647,238,2022/4/15 22:50,1,125,-124,
27648,244,2022/4/15 5:00,0,1,-1,
27649,244,2022/4/15 5:10,0,1,-1,
27650,244,2022/4/15 5:20,17,1,16,
27651,244,2022/4/15 5:30,30,1,29,
27652,244,2022/4/15 5:40,31,1,30,
27653,244,2022/4/15 5:50,49,1,48,
27654,244,2022/4/15 6:00,70,1,69,
27655,244,2022/4/15 6:10,59,1,58,
27656,244,2022/4/15 6:20,75,5,70,
27657,244,2022/4/15 6:30,70,12,58,
27658,244,2022/4/15 6:40,73,65,8,
27659,244,2022/4/15 6:50,108,38,70,
27660,244,2022/4/15 7:00,207,55,152,
27661,244,2022/4/15 7:10,254,50,204,
27662,244,2022/4/15 7:20,349,54,295,
27663,244,2022/4/15 7:30,394,67,327,
27664,244,2022/4/15 7:40,600,63,537,
27665,244,2022/4/15 7:50,442,60,382,
27666,244,2022/4/15 8:00,326,63,263,
27667,244,2022/4/15 8:10,360,62,298,
27668,244,2022/4/15 8:20,273,73,200,
27669,244,2022/4/15 8:30,188,57,131,
27670,244,2022/4/15 8:40,122,37,85,
27671,244,2022/4/15 8:50,81,48,33,
27672,244,2022/4/15 9:00,63,52,11,
27673,244,2022/4/15 9:10,50,54,-4,
27674,244,2022/4/15 9:20,39,50,-11,
27675,244,2022/4/15 9:30,39,49,-10,
27676,244,2022/4/15 9:40,35,64,-29,
27677,244,2022/4/15 9:50,30,45,-15,
27678,244,2022/4/15 10:00,30,37,-7,
27679,244,2022/4/15 10:10,34,50,-16,
27680,244,2022/4/15 10:20,28,50,-22,
27681,244,2022/4/15 10:30,28,44,-16,
27682,244,2022/4/15 10:40,24,50,-26,
27683,244,2022/4/15 10:50,29,42,-13,
27684,244,2022/4/15 11:00,29,38,-9,
27685,244,2022/4/15 11:10,30,28,2,
27686,244,2022/4/15 11:20,25,45,-20,
27687,244,2022/4/15 11:30,28,51,-23,
27688,244,2022/4/15 11:40,27,51,-24,
27689,244,2022/4/15 11:50,33,48,-15,
27690,244,2022/4/15 12:00,29,50,-21,
27691,244,2022/4/15 12:10,36,51,-15,
27692,244,2022/4/15 12:20,29,18,11,
27693,244,2022/4/15 12:30,29,49,-20,
27694,244,2022/4/15 12:40,25,65,-40,
27695,244,2022/4/15 12:50,26,67,-41,
27696,244,2022/4/15 13:00,22,61,-39,
27697,244,2022/4/15 13:10,27,55,-28,
27698,244,2022/4/15 13:20,25,50,-25,
27699,244,2022/4/15 13:30,25,50,-25,
27700,244,2022/4/15 13:40,25,54,-29,
27701,244,2022/4/15 13:50,25,54,-29,
27702,244,2022/4/15 14:00,25,50,-25,
27703,244,2022/4/15 14:10,24,18,6,
27704,244,2022/4/15 14:20,20,47,-27,
27705,244,2022/4/15 14:30,21,65,-44,
27706,244,2022/4/15 14:40,26,55,-29,
27707,244,2022/4/15 14:50,21,63,-42,
27708,244,2022/4/15 15:00,17,61,-44,
27709,244,2022/4/15 15:10,20,59,-39,
27710,244,2022/4/15 15:20,24,66,-42,
27711,244,2022/4/15 15:30,21,73,-52,
27712,244,2022/4/15 15:40,23,51,-28,
27713,244,2022/4/15 15:50,23,69,-46,
27714,244,2022/4/15 16:00,21,83,-62,
27715,244,2022/4/15 16:10,26,59,-33,
27716,244,2022/4/15 16:20,26,106,-80,
27717,244,2022/4/15 16:30,27,60,-33,
27718,244,2022/4/15 16:40,29,90,-61,
27719,244,2022/4/15 16:50,29,98,-69,
27720,244,2022/4/15 17:00,23,108,-85,
27721,244,2022/4/15 17:10,27,108,-81,
27722,244,2022/4/15 17:20,24,65,-41,
27723,244,2022/4/15 17:30,24,99,-75,
27724,244,2022/4/15 17:40,25,151,-126,
27725,244,2022/4/15 17:50,22,109,-87,
27726,244,2022/4/15 18:00,22,160,-138,
27727,244,2022/4/15 18:10,19,112,-93,
27728,244,2022/4/15 18:20,17,124,-107,
27729,244,2022/4/15 18:30,17,197,-180,
27730,244,2022/4/15 18:40,18,119,-101,
27731,244,2022/4/15 18:50,13,285,-272,
27732,244,2022/4/15 19:00,17,109,-92,
27733,244,2022/4/15 19:10,17,112,-95,
27734,244,2022/4/15 19:20,12,178,-166,
27735,244,2022/4/15 19:30,12,119,-107,
27736,244,2022/4/15 19:40,12,111,-99,
27737,244,2022/4/15 19:50,12,107,-95,
27738,244,2022/4/15 20:00,12,120,-108,
27739,244,2022/4/15 20:10,16,95,-79,
27740,244,2022/4/15 20:20,12,110,-98,
27741,244,2022/4/15 20:30,12,110,-98,
27742,244,2022/4/15 20:40,8,63,-55,
27743,244,2022/4/15 20:50,6,95,-89,
27744,244,2022/4/15 21:00,11,103,-92,
27745,244,2022/4/15 21:10,13,108,-95,
27746,244,2022/4/15 21:20,7,89,-82,
27747,244,2022/4/15 21:30,7,110,-103,
27748,244,2022/4/15 21:40,8,95,-87,
27749,244,2022/4/15 21:50,7,68,-61,
27750,244,2022/4/15 22:00,15,99,-84,
27751,244,2022/4/15 22:10,5,99,-94,
27752,244,2022/4/15 22:20,1,99,-98,
27753,244,2022/4/15 22:30,0,78,-78,
27754,244,2022/4/15 22:40,0,78,-78,
27755,244,2022/4/15 22:50,0,83,-83,
27756,250,2022/4/15 5:00,0,1,-1,
27757,250,2022/4/15 5:10,2,1,1,
27758,250,2022/4/15 5:20,10,1,9,
27759,250,2022/4/15 5:30,14,1,13,
27760,250,2022/4/15 5:40,14,1,13,
27761,250,2022/4/15 5:50,26,1,25,
27762,250,2022/4/15 6:00,27,1,26,
27763,250,2022/4/15 6:10,36,1,35,
27764,250,2022/4/15 6:20,38,1,37,
27765,250,2022/4/15 6:30,57,1,56,
27766,250,2022/4/15 6:40,34,27,7,
27767,250,2022/4/15 6:50,56,22,34,
27768,250,2022/4/15 7:00,54,16,38,
27769,250,2022/4/15 7:10,88,14,74,
27770,250,2022/4/15 7:20,108,19,89,
27771,250,2022/4/15 7:30,121,21,100,
27772,250,2022/4/15 7:40,185,24,161,
27773,250,2022/4/15 7:50,147,35,112,
27774,250,2022/4/15 8:00,79,29,50,
27775,250,2022/4/15 8:10,64,29,35,
27776,250,2022/4/15 8:20,53,28,25,
27777,250,2022/4/15 8:30,33,25,8,
27778,250,2022/4/15 8:40,29,19,10,
27779,250,2022/4/15 8:50,31,23,8,
27780,250,2022/4/15 9:00,26,23,3,
27781,250,2022/4/15 9:10,23,31,-8,
27782,250,2022/4/15 9:20,21,23,-2,
27783,250,2022/4/15 9:30,14,23,-9,
27784,250,2022/4/15 9:40,16,23,-7,
27785,250,2022/4/15 9:50,15,33,-18,
27786,250,2022/4/15 10:00,14,23,-9,
27787,250,2022/4/15 10:10,17,21,-4,
27788,250,2022/4/15 10:20,14,25,-11,
27789,250,2022/4/15 10:30,13,23,-10,
27790,250,2022/4/15 10:40,14,19,-5,
27791,250,2022/4/15 10:50,13,19,-6,
27792,250,2022/4/15 11:00,12,23,-11,
27793,250,2022/4/15 11:10,12,19,-7,
27794,250,2022/4/15 11:20,15,23,-8,
27795,250,2022/4/15 11:30,13,23,-10,
27796,250,2022/4/15 11:40,12,23,-11,
27797,250,2022/4/15 11:50,15,23,-8,
27798,250,2022/4/15 12:00,13,8,5,
27799,250,2022/4/15 12:10,13,23,-10,
27800,250,2022/4/15 12:20,12,23,-11,
27801,250,2022/4/15 12:30,10,23,-13,
27802,250,2022/4/15 12:40,11,22,-11,
27803,250,2022/4/15 12:50,10,23,-13,
27804,250,2022/4/15 13:00,14,29,-15,
27805,250,2022/4/15 13:10,10,25,-15,
27806,250,2022/4/15 13:20,12,32,-20,
27807,250,2022/4/15 13:30,11,23,-12,
27808,250,2022/4/15 13:40,8,23,-15,
27809,250,2022/4/15 13:50,9,8,1,
27810,250,2022/4/15 14:00,7,23,-16,
27811,250,2022/4/15 14:10,6,23,-17,
27812,250,2022/4/15 14:20,9,29,-20,
27813,250,2022/4/15 14:30,7,24,-17,
27814,250,2022/4/15 14:40,10,31,-21,
27815,250,2022/4/15 14:50,7,31,-24,
27816,250,2022/4/15 15:00,5,32,-27,
27817,250,2022/4/15 15:10,8,31,-23,
27818,250,2022/4/15 15:20,10,32,-22,
27819,250,2022/4/15 15:30,5,30,-25,
27820,250,2022/4/15 15:40,7,23,-16,
27821,250,2022/4/15 15:50,10,38,-28,
27822,250,2022/4/15 16:00,9,41,-32,
27823,250,2022/4/15 16:10,8,25,-17,
27824,250,2022/4/15 16:20,12,38,-26,
27825,250,2022/4/15 16:30,5,49,-44,
27826,250,2022/4/15 16:40,10,49,-39,
27827,250,2022/4/15 16:50,8,49,-41,
27828,250,2022/4/15 17:00,7,15,-8,
27829,250,2022/4/15 17:10,8,68,-60,
27830,250,2022/4/15 17:20,8,39,-31,
27831,250,2022/4/15 17:30,9,60,-51,
27832,250,2022/4/15 17:40,10,76,-66,
27833,250,2022/4/15 17:50,8,38,-30,
27834,250,2022/4/15 18:00,7,75,-68,
27835,250,2022/4/15 18:10,7,84,-77,
27836,250,2022/4/15 18:20,5,81,-76,
27837,250,2022/4/15 18:30,8,95,-87,
27838,250,2022/4/15 18:40,6,52,-46,
27839,250,2022/4/15 18:50,7,110,-103,
27840,250,2022/4/15 19:00,5,91,-86,
27841,250,2022/4/15 19:10,2,64,-62,
27842,250,2022/4/15 19:20,4,99,-95,
27843,250,2022/4/15 19:30,3,75,-72,
27844,250,2022/4/15 19:40,2,74,-72,
27845,250,2022/4/15 19:50,4,39,-35,
27846,250,2022/4/15 20:00,3,71,-68,
27847,250,2022/4/15 20:10,3,53,-50,
27848,250,2022/4/15 20:20,2,46,-44,
27849,250,2022/4/15 20:30,3,48,-45,
27850,250,2022/4/15 20:40,1,33,-32,
27851,250,2022/4/15 20:50,2,41,-39,
27852,250,2022/4/15 21:00,1,40,-39,
27853,250,2022/4/15 21:10,2,46,-44,
27854,250,2022/4/15 21:20,2,49,-47,
27855,250,2022/4/15 21:30,2,40,-38,
27856,250,2022/4/15 21:40,2,27,-25,
27857,250,2022/4/15 21:50,1,54,-53,
27858,250,2022/4/15 22:00,1,48,-47,
27859,250,2022/4/15 22:10,2,48,-46,
27860,250,2022/4/15 22:20,0,47,-47,
27861,250,2022/4/15 22:30,0,41,-41,
27862,250,2022/4/15 22:40,0,40,-40,
27863,250,2022/4/15 22:50,0,49,-49,
27864,247,2022/4/15 5:00,0,1,-1,
27865,247,2022/4/15 5:10,3,1,2,
27866,247,2022/4/15 5:20,15,1,14,
27867,247,2022/4/15 5:30,19,1,18,
27868,247,2022/4/15 5:40,19,1,18,
27869,247,2022/4/15 5:50,31,1,30,
27870,247,2022/4/15 6:00,33,1,32,
27871,247,2022/4/15 6:10,35,1,34,
27872,247,2022/4/15 6:20,44,1,43,
27873,247,2022/4/15 6:30,45,1,44,
27874,247,2022/4/15 6:40,51,23,28,
27875,247,2022/4/15 6:50,71,21,50,
27876,247,2022/4/15 7:00,86,32,54,
27877,247,2022/4/15 7:10,153,42,111,
27878,247,2022/4/15 7:20,222,41,181,
27879,247,2022/4/15 7:30,199,71,128,
27880,247,2022/4/15 7:40,213,72,141,
27881,247,2022/4/15 7:50,184,68,116,
27882,247,2022/4/15 8:00,181,74,107,
27883,247,2022/4/15 8:10,105,48,57,
27884,247,2022/4/15 8:20,76,53,23,
27885,247,2022/4/15 8:30,56,62,-6,
27886,247,2022/4/15 8:40,43,76,-33,
27887,247,2022/4/15 8:50,33,66,-33,
27888,247,2022/4/15 9:00,29,58,-29,
27889,247,2022/4/15 9:10,30,46,-16,
27890,247,2022/4/15 9:20,26,54,-28,
27891,247,2022/4/15 9:30,23,52,-29,
27892,247,2022/4/15 9:40,22,44,-22,
27893,247,2022/4/15 9:50,22,53,-31,
27894,247,2022/4/15 10:00,22,38,-16,
27895,247,2022/4/15 10:10,17,57,-40,
27896,247,2022/4/15 10:20,20,41,-21,
27897,247,2022/4/15 10:30,20,54,-34,
27898,247,2022/4/15 10:40,16,41,-25,
27899,247,2022/4/15 10:50,18,29,-11,
27900,247,2022/4/15 11:00,18,45,-27,
27901,247,2022/4/15 11:10,19,51,-32,
27902,247,2022/4/15 11:20,19,6,13,
27903,247,2022/4/15 11:30,20,47,-27,
27904,247,2022/4/15 11:40,19,41,-22,
27905,247,2022/4/15 11:50,21,46,-25,
27906,247,2022/4/15 12:00,18,45,-27,
27907,247,2022/4/15 12:10,20,38,-18,
27908,247,2022/4/15 12:20,19,38,-19,
27909,247,2022/4/15 12:30,19,45,-26,
27910,247,2022/4/15 12:40,21,40,-19,
27911,247,2022/4/15 12:50,17,41,-24,
27912,247,2022/4/15 13:00,17,31,-14,
27913,247,2022/4/15 13:10,17,19,-2,
27914,247,2022/4/15 13:20,17,47,-30,
27915,247,2022/4/15 13:30,20,50,-30,
27916,247,2022/4/15 13:40,20,51,-31,
27917,247,2022/4/15 13:50,19,49,-30,
27918,247,2022/4/15 14:00,16,51,-35,
27919,247,2022/4/15 14:10,18,52,-34,
27920,247,2022/4/15 14:20,18,50,-32,
27921,247,2022/4/15 14:30,17,50,-33,
27922,247,2022/4/15 14:40,16,45,-29,
27923,247,2022/4/15 14:50,19,45,-26,
27924,247,2022/4/15 15:00,14,21,-7,
27925,247,2022/4/15 15:10,17,68,-51,
27926,247,2022/4/15 15:20,15,70,-55,
27927,247,2022/4/15 15:30,23,41,-18,
27928,247,2022/4/15 15:40,19,67,-48,
27929,247,2022/4/15 15:50,16,28,-12,
27930,247,2022/4/15 16:00,17,56,-39,
27931,247,2022/4/15 16:10,21,73,-52,
27932,247,2022/4/15 16:20,18,62,-44,
27933,247,2022/4/15 16:30,28,61,-33,
27934,247,2022/4/15 16:40,17,41,-24,
27935,247,2022/4/15 16:50,29,93,-64,
27936,247,2022/4/15 17:00,24,59,-35,
27937,247,2022/4/15 17:10,28,80,-52,
27938,247,2022/4/15 17:20,18,63,-45,
27939,247,2022/4/15 17:30,24,77,-53,
27940,247,2022/4/15 17:40,27,98,-71,
27941,247,2022/4/15 17:50,26,93,-67,
27942,247,2022/4/15 18:00,21,106,-85,
27943,247,2022/4/15 18:10,13,123,-110,
27944,247,2022/4/15 18:20,15,107,-92,
27945,247,2022/4/15 18:30,14,105,-91,
27946,247,2022/4/15 18:40,12,108,-96,
27947,247,2022/4/15 18:50,10,112,-102,
27948,247,2022/4/15 19:00,8,116,-108,
27949,247,2022/4/15 19:10,10,112,-102,
27950,247,2022/4/15 19:20,9,110,-101,
27951,247,2022/4/15 19:30,8,106,-98,
27952,247,2022/4/15 19:40,9,101,-92,
27953,247,2022/4/15 19:50,8,99,-91,
27954,247,2022/4/15 20:00,6,77,-71,
27955,247,2022/4/15 20:10,6,88,-82,
27956,247,2022/4/15 20:20,7,52,-45,
27957,247,2022/4/15 20:30,6,94,-88,
27958,247,2022/4/15 20:40,4,71,-67,
27959,247,2022/4/15 20:50,5,61,-56,
27960,247,2022/4/15 21:00,6,70,-64,
27961,247,2022/4/15 21:10,3,64,-61,
27962,247,2022/4/15 21:20,3,64,-61,
27963,247,2022/4/15 21:30,2,71,-69,
27964,247,2022/4/15 21:40,3,48,-45,
27965,247,2022/4/15 21:50,2,68,-66,
27966,247,2022/4/15 22:00,2,34,-32,
27967,247,2022/4/15 22:10,1,65,-64,
27968,247,2022/4/15 22:20,0,67,-67,
27969,247,2022/4/15 22:30,0,53,-53,
27970,247,2022/4/15 22:40,0,52,-52,
27971,247,2022/4/15 22:50,0,49,-49,
27972,248,2022/4/15 5:00,3,1,2,
27973,248,2022/4/15 5:10,8,1,7,
27974,248,2022/4/15 5:20,20,1,19,
27975,248,2022/4/15 5:30,15,1,14,
27976,248,2022/4/15 5:40,25,1,24,
27977,248,2022/4/15 5:50,42,1,41,
27978,248,2022/4/15 6:00,45,1,44,
27979,248,2022/4/15 6:10,55,1,54,
27980,248,2022/4/15 6:20,60,1,59,
27981,248,2022/4/15 6:30,83,1,82,
27982,248,2022/4/15 6:40,163,51,112,
27983,248,2022/4/15 6:50,228,68,160,
27984,248,2022/4/15 7:00,231,50,181,
27985,248,2022/4/15 7:10,327,99,228,
27986,248,2022/4/15 7:20,349,76,273,
27987,248,2022/4/15 7:30,396,110,286,
27988,248,2022/4/15 7:40,365,105,260,
27989,248,2022/4/15 7:50,348,89,259,
27990,248,2022/4/15 8:00,278,99,179,
27991,248,2022/4/15 8:10,282,122,160,
27992,248,2022/4/15 8:20,207,103,104,
27993,248,2022/4/15 8:30,144,126,18,
27994,248,2022/4/15 8:40,100,96,4,
27995,248,2022/4/15 8:50,94,83,11,
27996,248,2022/4/15 9:00,48,93,-45,
27997,248,2022/4/15 9:10,50,101,-51,
27998,248,2022/4/15 9:20,44,90,-46,
27999,248,2022/4/15 9:30,38,87,-49,
28000,248,2022/4/15 9:40,37,101,-64,
28001,248,2022/4/15 9:50,35,106,-71,
28002,248,2022/4/15 10:00,35,87,-52,
28003,248,2022/4/15 10:10,34,90,-56,
28004,248,2022/4/15 10:20,37,87,-50,
28005,248,2022/4/15 10:30,33,73,-40,
28006,248,2022/4/15 10:40,38,77,-39,
28007,248,2022/4/15 10:50,30,92,-62,
28008,248,2022/4/15 11:00,38,68,-30,
28009,248,2022/4/15 11:10,39,64,-25,
28010,248,2022/4/15 11:20,38,51,-13,
28011,248,2022/4/15 11:30,40,70,-30,
28012,248,2022/4/15 11:40,48,74,-26,
28013,248,2022/4/15 11:50,51,65,-14,
28014,248,2022/4/15 12:00,43,78,-35,
28015,248,2022/4/15 12:10,46,70,-24,
28016,248,2022/4/15 12:20,41,74,-33,
28017,248,2022/4/15 12:30,43,47,-4,
28018,248,2022/4/15 12:40,44,47,-3,
28019,248,2022/4/15 12:50,39,71,-32,
28020,248,2022/4/15 13:00,29,75,-46,
28021,248,2022/4/15 13:10,40,73,-33,
28022,248,2022/4/15 13:20,39,70,-31,
28023,248,2022/4/15 13:30,33,76,-43,
28024,248,2022/4/15 13:40,31,76,-45,
28025,248,2022/4/15 13:50,34,73,-39,
28026,248,2022/4/15 14:00,28,68,-40,
28027,248,2022/4/15 14:10,25,85,-60,
28028,248,2022/4/15 14:20,37,44,-7,
28029,248,2022/4/15 14:30,29,65,-36,
28030,248,2022/4/15 14:40,36,81,-45,
28031,248,2022/4/15 14:50,27,77,-50,
28032,248,2022/4/15 15:00,29,77,-48,
28033,248,2022/4/15 15:10,30,87,-57,
28034,248,2022/4/15 15:20,41,81,-40,
28035,248,2022/4/15 15:30,29,77,-48,
28036,248,2022/4/15 15:40,34,90,-56,
28037,248,2022/4/15 15:50,42,62,-20,
28038,248,2022/4/15 16:00,44,87,-43,
28039,248,2022/4/15 16:10,34,101,-67,
28040,248,2022/4/15 16:20,42,75,-33,
28041,248,2022/4/15 16:30,38,106,-68,
28042,248,2022/4/15 16:40,43,70,-27,
28043,248,2022/4/15 16:50,44,110,-66,
28044,248,2022/4/15 17:00,42,107,-65,
28045,248,2022/4/15 17:10,53,110,-57,
28046,248,2022/4/15 17:20,73,126,-53,
28047,248,2022/4/15 17:30,43,104,-61,
28048,248,2022/4/15 17:40,40,93,-53,
28049,248,2022/4/15 17:50,37,106,-69,
28050,248,2022/4/15 18:00,29,108,-79,
28051,248,2022/4/15 18:10,31,128,-97,
28052,248,2022/4/15 18:20,29,101,-72,
28053,248,2022/4/15 18:30,28,119,-91,
28054,248,2022/4/15 18:40,26,235,-209,
28055,248,2022/4/15 18:50,23,119,-96,
28056,248,2022/4/15 19:00,23,154,-131,
28057,248,2022/4/15 19:10,23,111,-88,
28058,248,2022/4/15 19:20,17,181,-164,
28059,248,2022/4/15 19:30,19,128,-109,
28060,248,2022/4/15 19:40,20,117,-97,
28061,248,2022/4/15 19:50,18,87,-69,
28062,248,2022/4/15 20:00,15,105,-90,
28063,248,2022/4/15 20:10,13,110,-97,
28064,248,2022/4/15 20:20,17,79,-62,
28065,248,2022/4/15 20:30,14,95,-81,
28066,248,2022/4/15 20:40,14,104,-90,
28067,248,2022/4/15 20:50,12,95,-83,
28068,248,2022/4/15 21:00,10,95,-85,
28069,248,2022/4/15 21:10,13,77,-64,
28070,248,2022/4/15 21:20,10,76,-66,
28071,248,2022/4/15 21:30,7,87,-80,
28072,248,2022/4/15 21:40,6,76,-70,
28073,248,2022/4/15 21:50,5,87,-82,
28074,248,2022/4/15 22:00,5,54,-49,
28075,248,2022/4/15 22:10,1,83,-82,
28076,248,2022/4/15 22:20,0,87,-87,
28077,248,2022/4/15 22:30,0,79,-79,
28078,248,2022/4/15 22:40,0,74,-74,
28079,248,2022/4/15 22:50,0,73,-73,
28080,253,2022/4/15 5:00,0,1,-1,
28081,253,2022/4/15 5:10,5,1,4,
28082,253,2022/4/15 5:20,23,1,22,
28083,253,2022/4/15 5:30,18,1,17,
28084,253,2022/4/15 5:40,25,8,17,
28085,253,2022/4/15 5:50,31,5,26,
28086,253,2022/4/15 6:00,32,2,30,
28087,253,2022/4/15 6:10,71,19,52,
28088,253,2022/4/15 6:20,85,16,69,
28089,253,2022/4/15 6:30,180,47,133,
28090,253,2022/4/15 6:40,244,38,206,
28091,253,2022/4/15 6:50,277,63,214,
28092,253,2022/4/15 7:00,276,76,200,
28093,253,2022/4/15 7:10,340,103,237,
28094,253,2022/4/15 7:20,595,100,495,
28095,253,2022/4/15 7:30,668,146,522,
28096,253,2022/4/15 7:40,836,150,686,
28097,253,2022/4/15 7:50,1054,146,908,
28098,253,2022/4/15 8:00,872,126,746,
28099,253,2022/4/15 8:10,820,89,731,
28100,253,2022/4/15 8:20,686,118,568,
28101,253,2022/4/15 8:30,600,124,476,
28102,253,2022/4/15 8:40,351,108,243,
28103,253,2022/4/15 8:50,283,105,178,
28104,253,2022/4/15 9:00,236,109,127,
28105,253,2022/4/15 9:10,224,93,131,
28106,253,2022/4/15 9:20,145,93,52,
28107,253,2022/4/15 9:30,115,106,9,
28108,253,2022/4/15 9:40,76,99,-23,
28109,253,2022/4/15 9:50,68,97,-29,
28110,253,2022/4/15 10:00,61,76,-15,
28111,253,2022/4/15 10:10,41,91,-50,
28112,253,2022/4/15 10:20,43,90,-47,
28113,253,2022/4/15 10:30,35,84,-49,
28114,253,2022/4/15 10:40,40,77,-37,
28115,253,2022/4/15 10:50,32,67,-35,
28116,253,2022/4/15 11:00,36,93,-57,
28117,253,2022/4/15 11:10,41,79,-38,
28118,253,2022/4/15 11:20,39,84,-45,
28119,253,2022/4/15 11:30,41,101,-60,
28120,253,2022/4/15 11:40,57,97,-40,
28121,253,2022/4/15 11:50,53,87,-34,
28122,253,2022/4/15 12:00,60,101,-41,
28123,253,2022/4/15 12:10,56,83,-27,
28124,253,2022/4/15 12:20,58,88,-30,
28125,253,2022/4/15 12:30,61,99,-38,
28126,253,2022/4/15 12:40,64,93,-29,
28127,253,2022/4/15 12:50,47,104,-57,
28128,253,2022/4/15 13:00,52,90,-38,
28129,253,2022/4/15 13:10,52,64,-12,
28130,253,2022/4/15 13:20,47,97,-50,
28131,253,2022/4/15 13:30,42,96,-54,
28132,253,2022/4/15 13:40,42,91,-49,
28133,253,2022/4/15 13:50,38,98,-60,
28134,253,2022/4/15 14:00,51,70,-19,
28135,253,2022/4/15 14:10,42,93,-51,
28136,253,2022/4/15 14:20,44,100,-56,
28137,253,2022/4/15 14:30,32,100,-68,
28138,253,2022/4/15 14:40,62,105,-43,
28139,253,2022/4/15 14:50,53,94,-41,
28140,253,2022/4/15 15:00,46,87,-41,
28141,253,2022/4/15 15:10,47,110,-63,
28142,253,2022/4/15 15:20,39,106,-67,
28143,253,2022/4/15 15:30,52,103,-51,
28144,253,2022/4/15 15:40,43,110,-67,
28145,253,2022/4/15 15:50,45,96,-51,
28146,253,2022/4/15 16:00,57,126,-69,
28147,253,2022/4/15 16:10,63,124,-61,
28148,253,2022/4/15 16:20,52,105,-53,
28149,253,2022/4/15 16:30,70,108,-38,
28150,253,2022/4/15 16:40,66,128,-62,
28151,253,2022/4/15 16:50,138,106,32,
28152,253,2022/4/15 17:00,94,120,-26,
28153,253,2022/4/15 17:10,137,109,28,
28154,253,2022/4/15 17:20,156,183,-27,
28155,253,2022/4/15 17:30,82,212,-130,
28156,253,2022/4/15 17:40,84,211,-127,
28157,253,2022/4/15 17:50,79,378,-299,
28158,253,2022/4/15 18:00,137,326,-189,
28159,253,2022/4/15 18:10,64,334,-270,
28160,253,2022/4/15 18:20,45,326,-281,
28161,253,2022/4/15 18:30,41,434,-393,
28162,253,2022/4/15 18:40,39,434,-395,
28163,253,2022/4/15 18:50,41,432,-391,
28164,253,2022/4/15 19:00,31,507,-476,
28165,253,2022/4/15 19:10,31,300,-269,
28166,253,2022/4/15 19:20,25,333,-308,
28167,253,2022/4/15 19:30,30,321,-291,
28168,253,2022/4/15 19:40,25,232,-207,
28169,253,2022/4/15 19:50,25,150,-125,
28170,253,2022/4/15 20:00,28,151,-123,
28171,253,2022/4/15 20:10,28,119,-91,
28172,253,2022/4/15 20:20,25,144,-119,
28173,253,2022/4/15 20:30,26,119,-93,
28174,253,2022/4/15 20:40,33,107,-74,
28175,253,2022/4/15 20:50,28,103,-75,
28176,253,2022/4/15 21:00,26,128,-102,
28177,253,2022/4/15 21:10,27,101,-74,
28178,253,2022/4/15 21:20,27,115,-88,
28179,253,2022/4/15 21:30,25,111,-86,
28180,253,2022/4/15 21:40,26,108,-82,
28181,253,2022/4/15 21:50,22,121,-99,
28182,253,2022/4/15 22:00,16,118,-102,
28183,253,2022/4/15 22:10,14,122,-108,
28184,253,2022/4/15 22:20,10,106,-96,
28185,253,2022/4/15 22:30,6,101,-95,
28186,253,2022/4/15 22:40,2,107,-105,
28187,253,2022/4/15 22:50,2,108,-106,
28188,280,2022/4/15 5:00,0,1,-1,-1
28189,280,2022/4/15 5:10,30,1,29,29
28190,280,2022/4/15 5:20,53,1,52,52
28191,280,2022/4/15 5:30,41,1,40,40
28192,280,2022/4/15 5:40,52,1,51,51
28193,280,2022/4/15 5:50,204,1,203,203
28194,280,2022/4/15 6:00,187,2,185,185
28195,280,2022/4/15 6:10,360,1,359,359
28196,280,2022/4/15 6:20,601,1,600,600
28197,280,2022/4/15 6:30,479,89,390,390
28198,280,2022/4/15 6:40,723,69,654,654
28199,280,2022/4/15 6:50,822,102,720,720
28200,280,2022/4/15 7:00,1160,109,1051,1051
28201,280,2022/4/15 7:10,1378,180,1198,1198
28202,280,2022/4/15 7:20,1964,105,1859,1859
28203,280,2022/4/15 7:30,1999,256,1743,1743
28204,280,2022/4/15 7:40,1968,147,1821,1821
28205,280,2022/4/15 7:50,1971,233,1738,1738
28206,280,2022/4/15 8:00,1996,111,1885,1885
28207,280,2022/4/15 8:10,1968,256,1712,1712
28208,280,2022/4/15 8:20,1405,256,1149,1149
28209,280,2022/4/15 8:30,849,192,657,657
28210,280,2022/4/15 8:40,836,154,682,682
28211,280,2022/4/15 8:50,617,126,491,491
28212,280,2022/4/15 9:00,580,124,456,456
28213,280,2022/4/15 9:10,273,109,164,164
28214,280,2022/4/15 9:20,271,179,92,92
28215,280,2022/4/15 9:30,220,108,112,112
28216,280,2022/4/15 9:40,178,144,34,34
28217,280,2022/4/15 9:50,210,178,32,32
28218,280,2022/4/15 10:00,135,126,9,9
28219,280,2022/4/15 10:10,138,117,21,21
28220,280,2022/4/15 10:20,176,108,68,68
28221,280,2022/4/15 10:30,136,183,-47,-47
28222,280,2022/4/15 10:40,54,109,-55,-55
28223,280,2022/4/15 10:50,204,97,107,107
28224,280,2022/4/15 11:00,47,108,-61,-61
28225,280,2022/4/15 11:10,174,139,35,35
28226,280,2022/4/15 11:20,80,122,-42,-42
28227,280,2022/4/15 11:30,135,110,25,25
28228,280,2022/4/15 11:40,131,106,25,25
28229,280,2022/4/15 11:50,140,120,20,20
28230,280,2022/4/15 12:00,131,102,29,29
28231,280,2022/4/15 12:10,191,109,82,82
28232,280,2022/4/15 12:20,149,106,43,43
28233,280,2022/4/15 12:30,191,121,70,70
28234,280,2022/4/15 12:40,171,100,71,71
28235,280,2022/4/15 12:50,157,104,53,53
28236,280,2022/4/15 13:00,149,103,46,46
28237,280,2022/4/15 13:10,205,144,61,61
28238,280,2022/4/15 13:20,182,102,80,80
28239,280,2022/4/15 13:30,174,99,75,75
28240,280,2022/4/15 13:40,113,106,7,7
28241,280,2022/4/15 13:50,167,142,25,25
28242,280,2022/4/15 14:00,136,117,19,19
28243,280,2022/4/15 14:10,163,108,55,55
28244,280,2022/4/15 14:20,132,105,27,27
28245,280,2022/4/15 14:30,150,154,-4,-4
28246,280,2022/4/15 14:40,85,119,-34,-34
28247,280,2022/4/15 14:50,175,104,71,71
28248,280,2022/4/15 15:00,150,103,47,47
28249,280,2022/4/15 15:10,105,146,-41,-41
28250,280,2022/4/15 15:20,126,122,4,4
28251,280,2022/4/15 15:30,139,124,15,15
28252,280,2022/4/15 15:40,77,110,-33,-33
28253,280,2022/4/15 15:50,147,197,-50,-50
28254,280,2022/4/15 16:00,171,169,2,2
28255,280,2022/4/15 16:10,149,108,41,41
28256,280,2022/4/15 16:20,171,110,61,61
28257,280,2022/4/15 16:30,227,328,-101,-101
28258,280,2022/4/15 16:40,270,223,47,47
28259,280,2022/4/15 16:50,220,184,36,36
28260,280,2022/4/15 17:00,265,156,109,109
28261,280,2022/4/15 17:10,229,430,-201,-201
28262,280,2022/4/15 17:20,258,323,-65,-65
28263,280,2022/4/15 17:30,264,296,-32,-32
28264,280,2022/4/15 17:40,210,427,-217,-217
28265,280,2022/4/15 17:50,196,326,-130,-130
28266,280,2022/4/15 18:00,177,570,-393,-393
28267,280,2022/4/15 18:10,126,383,-257,-257
28268,280,2022/4/15 18:20,145,573,-428,-428
28269,280,2022/4/15 18:30,71,425,-354,-354
28270,280,2022/4/15 18:40,51,1223,-1172,-1172
28271,280,2022/4/15 18:50,58,497,-439,-439
28272,280,2022/4/15 19:00,35,555,-520,-520
28273,280,2022/4/15 19:10,44,398,-354,-354
28274,280,2022/4/15 19:20,36,638,-602,-602
28275,280,2022/4/15 19:30,28,419,-391,-391
28276,280,2022/4/15 19:40,30,503,-473,-473
28277,280,2022/4/15 19:50,28,219,-191,-191
28278,280,2022/4/15 20:00,28,320,-292,-292
28279,280,2022/4/15 20:10,31,208,-177,-177
28280,280,2022/4/15 20:20,30,179,-149,-149
28281,280,2022/4/15 20:30,28,169,-141,-141
28282,280,2022/4/15 20:40,24,209,-185,-185
28283,280,2022/4/15 20:50,24,159,-135,-135
28284,280,2022/4/15 21:00,26,121,-95,-95
28285,280,2022/4/15 21:10,25,215,-190,-190
28286,280,2022/4/15 21:20,22,141,-119,-119
28287,280,2022/4/15 21:30,19,119,-100,-100
28288,280,2022/4/15 21:40,18,150,-132,-132
28289,280,2022/4/15 21:50,15,219,-204,-204
28290,280,2022/4/15 22:00,12,230,-218,-218
28291,280,2022/4/15 22:10,10,108,-98,-98
28292,280,2022/4/15 22:20,6,125,-119,-119
28293,280,2022/4/15 22:30,0,125,-125,-125
28294,280,2022/4/15 22:40,0,114,-114,-114
28295,280,2022/4/15 22:50,0,154,-154,-154
28296,271,2022/4/15 5:00,0,1,-1,
28297,271,2022/4/15 5:10,5,1,4,
28298,271,2022/4/15 5:20,21,1,20,
28299,271,2022/4/15 5:30,29,1,28,
28300,271,2022/4/15 5:40,28,1,27,
28301,271,2022/4/15 5:50,32,1,31,
28302,271,2022/4/15 6:00,36,1,35,
28303,271,2022/4/15 6:10,34,1,33,
28304,271,2022/4/15 6:20,43,1,42,
28305,271,2022/4/15 6:30,53,25,28,
28306,271,2022/4/15 6:40,61,25,36,
28307,271,2022/4/15 6:50,71,35,36,
28308,271,2022/4/15 7:00,89,36,53,
28309,271,2022/4/15 7:10,214,51,163,
28310,271,2022/4/15 7:20,239,67,172,
28311,271,2022/4/15 7:30,303,114,189,
28312,271,2022/4/15 7:40,449,108,341,
28313,271,2022/4/15 7:50,575,105,470,
28314,271,2022/4/15 8:00,599,124,475,
28315,271,2022/4/15 8:10,351,122,229,
28316,271,2022/4/15 8:20,277,110,167,
28317,271,2022/4/15 8:30,227,144,83,
28318,271,2022/4/15 8:40,191,226,-35,
28319,271,2022/4/15 8:50,113,117,-4,
28320,271,2022/4/15 9:00,64,115,-51,
28321,271,2022/4/15 9:10,49,106,-57,
28322,271,2022/4/15 9:20,42,93,-51,
28323,271,2022/4/15 9:30,29,76,-47,
28324,271,2022/4/15 9:40,31,64,-33,
28325,271,2022/4/15 9:50,28,74,-46,
28326,271,2022/4/15 10:00,27,69,-42,
28327,271,2022/4/15 10:10,28,45,-17,
28328,271,2022/4/15 10:20,25,62,-37,
28329,271,2022/4/15 10:30,21,45,-24,
28330,271,2022/4/15 10:40,24,44,-20,
28331,271,2022/4/15 10:50,23,45,-22,
28332,271,2022/4/15 11:00,22,59,-37,
28333,271,2022/4/15 11:10,23,38,-15,
28334,271,2022/4/15 11:20,25,38,-13,
28335,271,2022/4/15 11:30,24,45,-21,
28336,271,2022/4/15 11:40,22,58,-36,
28337,271,2022/4/15 11:50,28,38,-10,
28338,271,2022/4/15 12:00,29,40,-11,
28339,271,2022/4/15 12:10,27,41,-14,
28340,271,2022/4/15 12:20,29,62,-33,
28341,271,2022/4/15 12:30,29,46,-17,
28342,271,2022/4/15 12:40,25,47,-22,
28343,271,2022/4/15 12:50,25,50,-25,
28344,271,2022/4/15 13:00,27,68,-41,
28345,271,2022/4/15 13:10,27,51,-24,
28346,271,2022/4/15 13:20,25,51,-26,
28347,271,2022/4/15 13:30,19,48,-29,
28348,271,2022/4/15 13:40,25,69,-44,
28349,271,2022/4/15 13:50,20,49,-29,
28350,271,2022/4/15 14:00,23,47,-24,
28351,271,2022/4/15 14:10,20,56,-36,
28352,271,2022/4/15 14:20,23,67,-44,
28353,271,2022/4/15 14:30,21,50,-29,
28354,271,2022/4/15 14:40,20,54,-34,
28355,271,2022/4/15 14:50,23,53,-30,
28356,271,2022/4/15 15:00,21,70,-49,
28357,271,2022/4/15 15:10,20,51,-31,
28358,271,2022/4/15 15:20,26,48,-22,
28359,271,2022/4/15 15:30,23,54,-31,
28360,271,2022/4/15 15:40,25,83,-58,
28361,271,2022/4/15 15:50,23,64,-41,
28362,271,2022/4/15 16:00,27,66,-39,
28363,271,2022/4/15 16:10,25,73,-48,
28364,271,2022/4/15 16:20,31,90,-59,
28365,271,2022/4/15 16:30,39,69,-30,
28366,271,2022/4/15 16:40,204,70,134,
28367,271,2022/4/15 16:50,31,68,-37,
28368,271,2022/4/15 17:00,35,106,-71,
28369,271,2022/4/15 17:10,73,85,-12,
28370,271,2022/4/15 17:20,51,79,-28,
28371,271,2022/4/15 17:30,85,125,-40,
28372,271,2022/4/15 17:40,161,80,81,
28373,271,2022/4/15 17:50,43,132,-89,
28374,271,2022/4/15 18:00,46,110,-64,
28375,271,2022/4/15 18:10,65,151,-86,
28376,271,2022/4/15 18:20,43,126,-83,
28377,271,2022/4/15 18:30,37,197,-160,
28378,271,2022/4/15 18:40,25,104,-79,
28379,271,2022/4/15 18:50,30,182,-152,
28380,271,2022/4/15 19:00,24,109,-85,
28381,271,2022/4/15 19:10,27,234,-207,
28382,271,2022/4/15 19:20,21,117,-96,
28383,271,2022/4/15 19:30,16,192,-176,
28384,271,2022/4/15 19:40,19,107,-88,
28385,271,2022/4/15 19:50,15,113,-98,
28386,271,2022/4/15 20:00,18,80,-62,
28387,271,2022/4/15 20:10,15,104,-89,
28388,271,2022/4/15 20:20,13,84,-71,
28389,271,2022/4/15 20:30,13,106,-93,
28390,271,2022/4/15 20:40,17,96,-79,
28391,271,2022/4/15 20:50,13,73,-60,
28392,271,2022/4/15 21:00,12,104,-92,
28393,271,2022/4/15 21:10,11,92,-81,
28394,271,2022/4/15 21:20,10,78,-68,
28395,271,2022/4/15 21:30,7,101,-94,
28396,271,2022/4/15 21:40,8,77,-69,
28397,271,2022/4/15 21:50,6,76,-70,
28398,271,2022/4/15 22:00,7,85,-78,
28399,271,2022/4/15 22:10,3,75,-72,
28400,271,2022/4/15 22:20,1,73,-72,
28401,271,2022/4/15 22:30,1,74,-73,
28402,271,2022/4/15 22:40,0,71,-71,
28403,271,2022/4/15 22:50,0,94,-94,
28404,269,2022/4/15 5:00,0,1,-1,
28405,269,2022/4/15 5:10,3,1,2,
28406,269,2022/4/15 5:20,26,1,25,
28407,269,2022/4/15 5:30,21,1,20,
28408,269,2022/4/15 5:40,23,1,22,
28409,269,2022/4/15 5:50,34,1,33,
28410,269,2022/4/15 6:00,44,1,43,
28411,269,2022/4/15 6:10,47,1,46,
28412,269,2022/4/15 6:20,59,1,58,
28413,269,2022/4/15 6:30,61,64,-3,
28414,269,2022/4/15 6:40,86,48,38,
28415,269,2022/4/15 6:50,174,67,107,
28416,269,2022/4/15 7:00,163,97,66,
28417,269,2022/4/15 7:10,299,98,201,
28418,269,2022/4/15 7:20,301,114,187,
28419,269,2022/4/15 7:30,368,133,235,
28420,269,2022/4/15 7:40,601,213,388,
28421,269,2022/4/15 7:50,603,181,422,
28422,269,2022/4/15 8:00,593,436,157,
28423,269,2022/4/15 8:10,391,224,167,
28424,269,2022/4/15 8:20,360,195,165,
28425,269,2022/4/15 8:30,256,211,45,
28426,269,2022/4/15 8:40,228,254,-26,
28427,269,2022/4/15 8:50,208,115,93,
28428,269,2022/4/15 9:00,144,114,30,
28429,269,2022/4/15 9:10,64,106,-42,
28430,269,2022/4/15 9:20,71,106,-35,
28431,269,2022/4/15 9:30,56,109,-53,
28432,269,2022/4/15 9:40,40,100,-60,
28433,269,2022/4/15 9:50,41,96,-55,
28434,269,2022/4/15 10:00,38,76,-38,
28435,269,2022/4/15 10:10,34,91,-57,
28436,269,2022/4/15 10:20,34,62,-28,
28437,269,2022/4/15 10:30,33,72,-39,
28438,269,2022/4/15 10:40,30,87,-57,
28439,269,2022/4/15 10:50,31,81,-50,
28440,269,2022/4/15 11:00,33,65,-32,
28441,269,2022/4/15 11:10,27,65,-38,
28442,269,2022/4/15 11:20,32,81,-49,
28443,269,2022/4/15 11:30,29,77,-48,
28444,269,2022/4/15 11:40,35,68,-33,
28445,269,2022/4/15 11:50,34,74,-40,
28446,269,2022/4/15 12:00,34,76,-42,
28447,269,2022/4/15 12:10,25,87,-62,
28448,269,2022/4/15 12:20,45,67,-22,
28449,269,2022/4/15 12:30,36,73,-37,
28450,269,2022/4/15 12:40,36,91,-55,
28451,269,2022/4/15 12:50,36,90,-54,
28452,269,2022/4/15 13:00,33,70,-37,
28453,269,2022/4/15 13:10,27,64,-37,
28454,269,2022/4/15 13:20,37,96,-59,
28455,269,2022/4/15 13:30,24,93,-69,
28456,269,2022/4/15 13:40,36,71,-35,
28457,269,2022/4/15 13:50,31,61,-30,
28458,269,2022/4/15 14:00,27,92,-65,
28459,269,2022/4/15 14:10,33,87,-54,
28460,269,2022/4/15 14:20,33,82,-49,
28461,269,2022/4/15 14:30,28,75,-47,
28462,269,2022/4/15 14:40,34,90,-56,
28463,269,2022/4/15 14:50,26,100,-74,
28464,269,2022/4/15 15:00,28,77,-49,
28465,269,2022/4/15 15:10,29,73,-44,
28466,269,2022/4/15 15:20,37,100,-63,
28467,269,2022/4/15 15:30,27,104,-77,
28468,269,2022/4/15 15:40,37,97,-60,
28469,269,2022/4/15 15:50,41,87,-46,
28470,269,2022/4/15 16:00,32,101,-69,
28471,269,2022/4/15 16:10,38,125,-87,
28472,269,2022/4/15 16:20,45,96,-51,
28473,269,2022/4/15 16:30,268,101,167,
28474,269,2022/4/15 16:40,115,119,-4,
28475,269,2022/4/15 16:50,62,119,-57,
28476,269,2022/4/15 17:00,244,112,132,
28477,269,2022/4/15 17:10,213,109,104,
28478,269,2022/4/15 17:20,175,190,-15,
28479,269,2022/4/15 17:30,143,119,24,
28480,269,2022/4/15 17:40,205,206,-1,
28481,269,2022/4/15 17:50,171,125,46,
28482,269,2022/4/15 18:00,71,283,-212,
28483,269,2022/4/15 18:10,54,149,-95,
28484,269,2022/4/15 18:20,49,327,-278,
28485,269,2022/4/15 18:30,44,179,-135,
28486,269,2022/4/15 18:40,28,283,-255,
28487,269,2022/4/15 18:50,31,190,-159,
28488,269,2022/4/15 19:00,32,327,-295,
28489,269,2022/4/15 19:10,26,217,-191,
28490,269,2022/4/15 19:20,23,312,-289,
28491,269,2022/4/15 19:30,28,132,-104,
28492,269,2022/4/15 19:40,22,184,-162,
28493,269,2022/4/15 19:50,24,106,-82,
28494,269,2022/4/15 20:00,25,110,-85,
28495,269,2022/4/15 20:10,23,95,-72,
28496,269,2022/4/15 20:20,22,126,-104,
28497,269,2022/4/15 20:30,28,110,-82,
28498,269,2022/4/15 20:40,18,104,-86,
28499,269,2022/4/15 20:50,22,106,-84,
28500,269,2022/4/15 21:00,14,97,-83,
28501,269,2022/4/15 21:10,15,103,-88,
28502,269,2022/4/15 21:20,20,92,-72,
28503,269,2022/4/15 21:30,13,95,-82,
28504,269,2022/4/15 21:40,13,93,-80,
28505,269,2022/4/15 21:50,14,89,-75,
28506,269,2022/4/15 22:00,6,95,-89,
28507,269,2022/4/15 22:10,6,85,-79,
28508,269,2022/4/15 22:20,7,76,-69,
28509,269,2022/4/15 22:30,2,103,-101,
28510,269,2022/4/15 22:40,0,94,-94,
28511,269,2022/4/15 22:50,1,75,-74,
28512,276,2022/4/15 5:00,0,1,-1,
28513,276,2022/4/15 5:10,3,1,2,
28514,276,2022/4/15 5:20,9,1,8,
28515,276,2022/4/15 5:30,15,1,14,
28516,276,2022/4/15 5:40,20,2,18,
28517,276,2022/4/15 5:50,19,1,18,
28518,276,2022/4/15 6:00,31,1,30,
28519,276,2022/4/15 6:10,36,2,34,
28520,276,2022/4/15 6:20,48,23,25,
28521,276,2022/4/15 6:30,62,24,38,
28522,276,2022/4/15 6:40,150,38,112,
28523,276,2022/4/15 6:50,80,40,40,
28524,276,2022/4/15 7:00,170,47,123,
28525,276,2022/4/15 7:10,225,60,165,
28526,276,2022/4/15 7:20,276,92,184,
28527,276,2022/4/15 7:30,279,87,192,
28528,276,2022/4/15 7:40,386,106,280,
28529,276,2022/4/15 7:50,445,96,349,
28530,276,2022/4/15 8:00,395,120,275,
28531,276,2022/4/15 8:10,328,120,208,
28532,276,2022/4/15 8:20,265,110,155,
28533,276,2022/4/15 8:30,215,178,37,
28534,276,2022/4/15 8:40,191,218,-27,
28535,276,2022/4/15 8:50,107,209,-102,
28536,276,2022/4/15 9:00,71,182,-111,
28537,276,2022/4/15 9:10,70,182,-112,
28538,276,2022/4/15 9:20,42,112,-70,
28539,276,2022/4/15 9:30,31,112,-81,
28540,276,2022/4/15 9:40,31,99,-68,
28541,276,2022/4/15 9:50,31,101,-70,
28542,276,2022/4/15 10:00,31,93,-62,
28543,276,2022/4/15 10:10,33,67,-34,
28544,276,2022/4/15 10:20,28,72,-44,
28545,276,2022/4/15 10:30,28,93,-65,
28546,276,2022/4/15 10:40,27,69,-42,
28547,276,2022/4/15 10:50,26,64,-38,
28548,276,2022/4/15 11:00,28,65,-37,
28549,276,2022/4/15 11:10,32,73,-41,
28550,276,2022/4/15 11:20,27,60,-33,
28551,276,2022/4/15 11:30,27,62,-35,
28552,276,2022/4/15 11:40,28,65,-37,
28553,276,2022/4/15 11:50,29,85,-56,
28554,276,2022/4/15 12:00,29,64,-35,
28555,276,2022/4/15 12:10,35,65,-30,
28556,276,2022/4/15 12:20,30,61,-31,
28557,276,2022/4/15 12:30,27,77,-50,
28558,276,2022/4/15 12:40,35,63,-28,
28559,276,2022/4/15 12:50,30,70,-40,
28560,276,2022/4/15 13:00,30,69,-39,
28561,276,2022/4/15 13:10,28,91,-63,
28562,276,2022/4/15 13:20,26,60,-34,
28563,276,2022/4/15 13:30,26,68,-42,
28564,276,2022/4/15 13:40,27,67,-40,
28565,276,2022/4/15 13:50,31,79,-48,
28566,276,2022/4/15 14:00,28,65,-37,
28567,276,2022/4/15 14:10,30,61,-31,
28568,276,2022/4/15 14:20,27,61,-34,
28569,276,2022/4/15 14:30,29,76,-47,
28570,276,2022/4/15 14:40,29,68,-39,
28571,276,2022/4/15 14:50,28,62,-34,
28572,276,2022/4/15 15:00,29,70,-41,
28573,276,2022/4/15 15:10,29,90,-61,
28574,276,2022/4/15 15:20,26,59,-33,
28575,276,2022/4/15 15:30,27,70,-43,
28576,276,2022/4/15 15:40,25,72,-47,
28577,276,2022/4/15 15:50,30,103,-73,
28578,276,2022/4/15 16:00,28,73,-45,
28579,276,2022/4/15 16:10,33,82,-49,
28580,276,2022/4/15 16:20,35,81,-46,
28581,276,2022/4/15 16:30,43,109,-66,
28582,276,2022/4/15 16:40,46,91,-45,
28583,276,2022/4/15 16:50,42,77,-35,
28584,276,2022/4/15 17:00,59,93,-34,
28585,276,2022/4/15 17:10,99,109,-10,
28586,276,2022/4/15 17:20,133,112,21,
28587,276,2022/4/15 17:30,74,123,-49,
28588,276,2022/4/15 17:40,103,123,-20,
28589,276,2022/4/15 17:50,67,144,-77,
28590,276,2022/4/15 18:00,164,111,53,
28591,276,2022/4/15 18:10,227,121,106,
28592,276,2022/4/15 18:20,77,149,-72,
28593,276,2022/4/15 18:30,85,180,-95,
28594,276,2022/4/15 18:40,76,180,-104,
28595,276,2022/4/15 18:50,60,119,-59,
28596,276,2022/4/15 19:00,47,181,-134,
28597,276,2022/4/15 19:10,43,146,-103,
28598,276,2022/4/15 19:20,36,126,-90,
28599,276,2022/4/15 19:30,30,107,-77,
28600,276,2022/4/15 19:40,39,102,-63,
28601,276,2022/4/15 19:50,28,105,-77,
28602,276,2022/4/15 20:00,25,105,-80,
28603,276,2022/4/15 20:10,28,97,-69,
28604,276,2022/4/15 20:20,24,85,-61,
28605,276,2022/4/15 20:30,29,93,-64,
28606,276,2022/4/15 20:40,36,98,-62,
28607,276,2022/4/15 20:50,33,70,-37,
28608,276,2022/4/15 21:00,34,64,-30,
28609,276,2022/4/15 21:10,27,79,-52,
28610,276,2022/4/15 21:20,29,70,-41,
28611,276,2022/4/15 21:30,26,70,-44,
28612,276,2022/4/15 21:40,24,71,-47,
28613,276,2022/4/15 21:50,22,71,-49,
28614,276,2022/4/15 22:00,24,71,-47,
28615,276,2022/4/15 22:10,15,92,-77,
28616,276,2022/4/15 22:20,8,65,-57,
28617,276,2022/4/15 22:30,5,66,-61,
28618,276,2022/4/15 22:40,3,56,-53,
28619,276,2022/4/15 22:50,2,72,-70,
28620,273,2022/4/15 5:00,0,1,-1,
28621,273,2022/4/15 5:10,2,1,1,
28622,273,2022/4/15 5:20,25,1,24,
28623,273,2022/4/15 5:30,59,1,58,
28624,273,2022/4/15 5:40,45,1,44,
28625,273,2022/4/15 5:50,59,1,58,
28626,273,2022/4/15 6:00,83,1,82,
28627,273,2022/4/15 6:10,109,1,108,
28628,273,2022/4/15 6:20,175,36,139,
28629,273,2022/4/15 6:30,255,23,232,
28630,273,2022/4/15 6:40,280,45,235,
28631,273,2022/4/15 6:50,349,64,285,
28632,273,2022/4/15 7:00,568,66,502,
28633,273,2022/4/15 7:10,592,45,547,
28634,273,2022/4/15 7:20,684,76,608,
28635,273,2022/4/15 7:30,868,69,799,
28636,273,2022/4/15 7:40,1051,93,958,
28637,273,2022/4/15 7:50,1214,93,1121,
28638,273,2022/4/15 8:00,1366,99,1267,
28639,273,2022/4/15 8:10,1169,105,1064,
28640,273,2022/4/15 8:20,819,117,702,
28641,273,2022/4/15 8:30,630,126,504,
28642,273,2022/4/15 8:40,599,87,512,
28643,273,2022/4/15 8:50,326,105,221,
28644,273,2022/4/15 9:00,271,101,170,
28645,273,2022/4/15 9:10,247,83,164,
28646,273,2022/4/15 9:20,182,82,100,
28647,273,2022/4/15 9:30,76,73,3,
28648,273,2022/4/15 9:40,72,94,-22,
28649,273,2022/4/15 9:50,61,71,-10,
28650,273,2022/4/15 10:00,47,66,-19,
28651,273,2022/4/15 10:10,46,91,-45,
28652,273,2022/4/15 10:20,45,71,-26,
28653,273,2022/4/15 10:30,43,70,-27,
28654,273,2022/4/15 10:40,45,65,-20,
28655,273,2022/4/15 10:50,36,76,-40,
28656,273,2022/4/15 11:00,39,66,-27,
28657,273,2022/4/15 11:10,38,63,-25,
28658,273,2022/4/15 11:20,43,60,-17,
28659,273,2022/4/15 11:30,38,77,-39,
28660,273,2022/4/15 11:40,37,66,-29,
28661,273,2022/4/15 11:50,37,62,-25,
28662,273,2022/4/15 12:00,45,70,-25,
28663,273,2022/4/15 12:10,42,91,-49,
28664,273,2022/4/15 12:20,45,62,-17,
28665,273,2022/4/15 12:30,41,68,-27,
28666,273,2022/4/15 12:40,43,63,-20,
28667,273,2022/4/15 12:50,44,88,-44,
28668,273,2022/4/15 13:00,36,75,-39,
28669,273,2022/4/15 13:10,43,62,-19,
28670,273,2022/4/15 13:20,39,67,-28,
28671,273,2022/4/15 13:30,36,105,-69,
28672,273,2022/4/15 13:40,32,77,-45,
28673,273,2022/4/15 13:50,35,70,-35,
28674,273,2022/4/15 14:00,31,82,-51,
28675,273,2022/4/15 14:10,31,110,-79,
28676,273,2022/4/15 14:20,32,80,-48,
28677,273,2022/4/15 14:30,35,63,-28,
28678,273,2022/4/15 14:40,31,72,-41,
28679,273,2022/4/15 14:50,27,112,-85,
28680,273,2022/4/15 15:00,29,87,-58,
28681,273,2022/4/15 15:10,29,76,-47,
28682,273,2022/4/15 15:20,31,76,-45,
28683,273,2022/4/15 15:30,29,122,-93,
28684,273,2022/4/15 15:40,31,99,-68,
28685,273,2022/4/15 15:50,32,98,-66,
28686,273,2022/4/15 16:00,33,112,-79,
28687,273,2022/4/15 16:10,39,130,-91,
28688,273,2022/4/15 16:20,36,96,-60,
28689,273,2022/4/15 16:30,45,106,-61,
28690,273,2022/4/15 16:40,46,118,-72,
28691,273,2022/4/15 16:50,41,180,-139,
28692,273,2022/4/15 17:00,68,106,-38,
28693,273,2022/4/15 17:10,74,117,-43,
28694,273,2022/4/15 17:20,62,267,-205,
28695,273,2022/4/15 17:30,47,178,-131,
28696,273,2022/4/15 17:40,64,266,-202,
28697,273,2022/4/15 17:50,68,328,-260,
28698,273,2022/4/15 18:00,43,333,-290,
28699,273,2022/4/15 18:10,45,318,-273,
28700,273,2022/4/15 18:20,45,301,-256,
28701,273,2022/4/15 18:30,44,323,-279,
28702,273,2022/4/15 18:40,41,327,-286,
28703,273,2022/4/15 18:50,33,303,-270,
28704,273,2022/4/15 19:00,35,366,-331,
28705,273,2022/4/15 19:10,30,378,-348,
28706,273,2022/4/15 19:20,32,348,-316,
28707,273,2022/4/15 19:30,25,191,-166,
28708,273,2022/4/15 19:40,29,221,-192,
28709,273,2022/4/15 19:50,29,113,-84,
28710,273,2022/4/15 20:00,28,185,-157,
28711,273,2022/4/15 20:10,24,106,-82,
28712,273,2022/4/15 20:20,21,119,-98,
28713,273,2022/4/15 20:30,29,107,-78,
28714,273,2022/4/15 20:40,20,109,-89,
28715,273,2022/4/15 20:50,21,108,-87,
28716,273,2022/4/15 21:00,20,192,-172,
28717,273,2022/4/15 21:10,17,90,-73,
28718,273,2022/4/15 21:20,14,111,-97,
28719,273,2022/4/15 21:30,16,108,-92,
28720,273,2022/4/15 21:40,17,160,-143,
28721,273,2022/4/15 21:50,12,122,-110,
28722,273,2022/4/15 22:00,12,98,-86,
28723,273,2022/4/15 22:10,9,102,-93,
28724,273,2022/4/15 22:20,7,104,-97,
28725,273,2022/4/15 22:30,6,106,-100,
28726,273,2022/4/15 22:40,1,116,-115,
28727,273,2022/4/15 22:50,1,105,-104,
28728,272,2022/4/15 5:00,0,1,-1,
28729,272,2022/4/15 5:10,0,1,-1,
28730,272,2022/4/15 5:20,7,1,6,
28731,272,2022/4/15 5:30,25,1,24,
28732,272,2022/4/15 5:40,34,8,26,
28733,272,2022/4/15 5:50,41,2,39,
28734,272,2022/4/15 6:00,59,5,54,
28735,272,2022/4/15 6:10,69,8,61,
28736,272,2022/4/15 6:20,109,45,64,
28737,272,2022/4/15 6:30,163,47,116,
28738,272,2022/4/15 6:40,207,58,149,
28739,272,2022/4/15 6:50,217,59,158,
28740,272,2022/4/15 7:00,217,77,140,
28741,272,2022/4/15 7:10,279,71,208,
28742,272,2022/4/15 7:20,334,79,255,
28743,272,2022/4/15 7:30,478,83,395,
28744,272,2022/4/15 7:40,600,77,523,
28745,272,2022/4/15 7:50,705,90,615,
28746,272,2022/4/15 8:00,742,83,659,
28747,272,2022/4/15 8:10,720,111,609,
28748,272,2022/4/15 8:20,577,93,484,
28749,272,2022/4/15 8:30,393,105,288,
28750,272,2022/4/15 8:40,319,88,231,
28751,272,2022/4/15 8:50,281,76,205,
28752,272,2022/4/15 9:00,207,59,148,
28753,272,2022/4/15 9:10,179,64,115,
28754,272,2022/4/15 9:20,139,62,77,
28755,272,2022/4/15 9:30,66,61,5,
28756,272,2022/4/15 9:40,51,66,-15,
28757,272,2022/4/15 9:50,48,60,-12,
28758,272,2022/4/15 10:00,44,60,-16,
28759,272,2022/4/15 10:10,37,48,-11,
28760,272,2022/4/15 10:20,31,47,-16,
28761,272,2022/4/15 10:30,27,66,-39,
28762,272,2022/4/15 10:40,29,50,-21,
28763,272,2022/4/15 10:50,35,47,-12,
28764,272,2022/4/15 11:00,31,51,-20,
28765,272,2022/4/15 11:10,32,68,-36,
28766,272,2022/4/15 11:20,29,51,-22,
28767,272,2022/4/15 11:30,26,47,-21,
28768,272,2022/4/15 11:40,27,54,-27,
28769,272,2022/4/15 11:50,30,67,-37,
28770,272,2022/4/15 12:00,32,61,-29,
28771,272,2022/4/15 12:10,36,62,-26,
28772,272,2022/4/15 12:20,35,49,-14,
28773,272,2022/4/15 12:30,33,76,-43,
28774,272,2022/4/15 12:40,30,52,-22,
28775,272,2022/4/15 12:50,28,52,-24,
28776,272,2022/4/15 13:00,31,59,-28,
28777,272,2022/4/15 13:10,27,70,-43,
28778,272,2022/4/15 13:20,29,56,-27,
28779,272,2022/4/15 13:30,30,49,-19,
28780,272,2022/4/15 13:40,28,61,-33,
28781,272,2022/4/15 13:50,25,69,-44,
28782,272,2022/4/15 14:00,27,62,-35,
28783,272,2022/4/15 14:10,25,66,-41,
28784,272,2022/4/15 14:20,27,65,-38,
28785,272,2022/4/15 14:30,29,81,-52,
28786,272,2022/4/15 14:40,23,67,-44,
28787,272,2022/4/15 14:50,25,70,-45,
28788,272,2022/4/15 15:00,26,72,-46,
28789,272,2022/4/15 15:10,26,90,-64,
28790,272,2022/4/15 15:20,24,71,-47,
28791,272,2022/4/15 15:30,27,62,-35,
28792,272,2022/4/15 15:40,25,70,-45,
28793,272,2022/4/15 15:50,27,96,-69,
28794,272,2022/4/15 16:00,27,104,-77,
28795,272,2022/4/15 16:10,33,74,-41,
28796,272,2022/4/15 16:20,30,80,-50,
28797,272,2022/4/15 16:30,35,105,-70,
28798,272,2022/4/15 16:40,29,106,-77,
28799,272,2022/4/15 16:50,33,106,-73,
28800,272,2022/4/15 17:00,45,98,-53,
28801,272,2022/4/15 17:10,46,108,-62,
28802,272,2022/4/15 17:20,45,97,-52,
28803,272,2022/4/15 17:30,37,184,-147,
28804,272,2022/4/15 17:40,36,110,-74,
28805,272,2022/4/15 17:50,41,206,-165,
28806,272,2022/4/15 18:00,43,108,-65,
28807,272,2022/4/15 18:10,39,180,-141,
28808,272,2022/4/15 18:20,33,180,-147,
28809,272,2022/4/15 18:30,38,216,-178,
28810,272,2022/4/15 18:40,30,199,-169,
28811,272,2022/4/15 18:50,29,235,-206,
28812,272,2022/4/15 19:00,26,235,-209,
28813,272,2022/4/15 19:10,25,258,-233,
28814,272,2022/4/15 19:20,23,150,-127,
28815,272,2022/4/15 19:30,25,160,-135,
28816,272,2022/4/15 19:40,19,98,-79,
28817,272,2022/4/15 19:50,19,133,-114,
28818,272,2022/4/15 20:00,17,105,-88,
28819,272,2022/4/15 20:10,19,120,-101,
28820,272,2022/4/15 20:20,17,124,-107,
28821,272,2022/4/15 20:30,17,115,-98,
28822,272,2022/4/15 20:40,20,88,-68,
28823,272,2022/4/15 20:50,14,128,-114,
28824,272,2022/4/15 21:00,17,105,-88,
28825,272,2022/4/15 21:10,15,113,-98,
28826,272,2022/4/15 21:20,13,113,-100,
28827,272,2022/4/15 21:30,13,89,-76,
28828,272,2022/4/15 21:40,13,104,-91,
28829,272,2022/4/15 21:50,11,108,-97,
28830,272,2022/4/15 22:00,10,104,-94,
28831,272,2022/4/15 22:10,9,110,-101,
28832,272,2022/4/15 22:20,8,105,-97,
28833,272,2022/4/15 22:30,5,153,-148,
28834,272,2022/4/15 22:40,2,105,-103,
28835,272,2022/4/15 22:50,1,85,-84,
28836,287,2022/4/15 5:00,0,1,-1,
28837,287,2022/4/15 5:10,0,1,-1,
28838,287,2022/4/15 5:20,3,1,2,
28839,287,2022/4/15 5:30,15,1,14,
28840,287,2022/4/15 5:40,30,2,28,
28841,287,2022/4/15 5:50,34,5,29,
28842,287,2022/4/15 6:00,38,2,36,
28843,287,2022/4/15 6:10,58,23,35,
28844,287,2022/4/15 6:20,68,21,47,
28845,287,2022/4/15 6:30,149,38,111,
28846,287,2022/4/15 6:40,226,62,164,
28847,287,2022/4/15 6:50,243,50,193,
28848,287,2022/4/15 7:00,265,71,194,
28849,287,2022/4/15 7:10,339,69,270,
28850,287,2022/4/15 7:20,588,68,520,
28851,287,2022/4/15 7:30,703,89,614,
28852,287,2022/4/15 7:40,1049,83,966,
28853,287,2022/4/15 7:50,1368,97,1271,
28854,287,2022/4/15 8:00,1573,108,1465,
28855,287,2022/4/15 8:10,1571,108,1463,
28856,287,2022/4/15 8:20,1359,111,1248,
28857,287,2022/4/15 8:30,1173,121,1052,
28858,287,2022/4/15 8:40,831,128,703,
28859,287,2022/4/15 8:50,722,107,615,
28860,287,2022/4/15 9:00,578,105,473,
28861,287,2022/4/15 9:10,342,109,233,
28862,287,2022/4/15 9:20,276,80,196,
28863,287,2022/4/15 9:30,225,76,149,
28864,287,2022/4/15 9:40,167,76,91,
28865,287,2022/4/15 9:50,90,72,18,
28866,287,2022/4/15 10:00,76,77,-1,
28867,287,2022/4/15 10:10,69,68,1,
28868,287,2022/4/15 10:20,60,75,-15,
28869,287,2022/4/15 10:30,44,70,-26,
28870,287,2022/4/15 10:40,46,84,-38,
28871,287,2022/4/15 10:50,43,64,-21,
28872,287,2022/4/15 11:00,37,80,-43,
28873,287,2022/4/15 11:10,40,72,-32,
28874,287,2022/4/15 11:20,38,76,-38,
28875,287,2022/4/15 11:30,35,69,-34,
28876,287,2022/4/15 11:40,38,87,-49,
28877,287,2022/4/15 11:50,39,74,-35,
28878,287,2022/4/15 12:00,42,93,-51,
28879,287,2022/4/15 12:10,47,70,-23,
28880,287,2022/4/15 12:20,48,98,-50,
28881,287,2022/4/15 12:30,46,82,-36,
28882,287,2022/4/15 12:40,44,75,-31,
28883,287,2022/4/15 12:50,43,84,-41,
28884,287,2022/4/15 13:00,43,93,-50,
28885,287,2022/4/15 13:10,45,81,-36,
28886,287,2022/4/15 13:20,39,93,-54,
28887,287,2022/4/15 13:30,38,81,-43,
28888,287,2022/4/15 13:40,39,96,-57,
28889,287,2022/4/15 13:50,35,76,-41,
28890,287,2022/4/15 14:00,37,90,-53,
28891,287,2022/4/15 14:10,28,75,-47,
28892,287,2022/4/15 14:20,32,99,-67,
28893,287,2022/4/15 14:30,34,87,-53,
28894,287,2022/4/15 14:40,32,108,-76,
28895,287,2022/4/15 14:50,30,93,-63,
28896,287,2022/4/15 15:00,29,112,-83,
28897,287,2022/4/15 15:10,36,96,-60,
28898,287,2022/4/15 15:20,31,105,-74,
28899,287,2022/4/15 15:30,36,103,-67,
28900,287,2022/4/15 15:40,31,101,-70,
28901,287,2022/4/15 15:50,29,112,-83,
28902,287,2022/4/15 16:00,33,106,-73,
28903,287,2022/4/15 16:10,36,97,-61,
28904,287,2022/4/15 16:20,36,128,-92,
28905,287,2022/4/15 16:30,41,124,-83,
28906,287,2022/4/15 16:40,37,152,-115,
28907,287,2022/4/15 16:50,38,105,-67,
28908,287,2022/4/15 17:00,46,177,-131,
28909,287,2022/4/15 17:10,77,177,-100,
28910,287,2022/4/15 17:20,57,230,-173,
28911,287,2022/4/15 17:30,57,324,-267,
28912,287,2022/4/15 17:40,96,424,-328,
28913,287,2022/4/15 17:50,70,330,-260,
28914,287,2022/4/15 18:00,57,429,-372,
28915,287,2022/4/15 18:10,76,428,-352,
28916,287,2022/4/15 18:20,47,420,-373,
28917,287,2022/4/15 18:30,41,402,-361,
28918,287,2022/4/15 18:40,39,413,-374,
28919,287,2022/4/15 18:50,33,419,-386,
28920,287,2022/4/15 19:00,35,440,-405,
28921,287,2022/4/15 19:10,29,375,-346,
28922,287,2022/4/15 19:20,31,330,-299,
28923,287,2022/4/15 19:30,28,224,-196,
28924,287,2022/4/15 19:40,26,207,-181,
28925,287,2022/4/15 19:50,28,167,-139,
28926,287,2022/4/15 20:00,27,155,-128,
28927,287,2022/4/15 20:10,29,119,-90,
28928,287,2022/4/15 20:20,29,107,-78,
28929,287,2022/4/15 20:30,28,128,-100,
28930,287,2022/4/15 20:40,23,128,-105,
28931,287,2022/4/15 20:50,27,116,-89,
28932,287,2022/4/15 21:00,28,109,-81,
28933,287,2022/4/15 21:10,26,110,-84,
28934,287,2022/4/15 21:20,26,117,-91,
28935,287,2022/4/15 21:30,27,154,-127,
28936,287,2022/4/15 21:40,21,124,-103,
28937,287,2022/4/15 21:50,21,110,-89,
28938,287,2022/4/15 22:00,23,121,-98,
28939,287,2022/4/15 22:10,19,143,-124,
28940,287,2022/4/15 22:20,15,116,-101,
28941,287,2022/4/15 22:30,12,110,-98,
28942,287,2022/4/15 22:40,6,115,-109,
28943,287,2022/4/15 22:50,2,105,-103,
28944,263,2022/4/15 5:00,0,1,-1,
28945,263,2022/4/15 5:10,0,1,-1,
28946,263,2022/4/15 5:20,2,1,1,
28947,263,2022/4/15 5:30,15,1,14,
28948,263,2022/4/15 5:40,38,1,37,
28949,263,2022/4/15 5:50,36,23,13,
28950,263,2022/4/15 6:00,55,16,39,
28951,263,2022/4/15 6:10,76,48,28,
28952,263,2022/4/15 6:20,197,65,132,
28953,263,2022/4/15 6:30,274,60,214,
28954,263,2022/4/15 6:40,280,73,207,
28955,263,2022/4/15 6:50,339,115,224,
28956,263,2022/4/15 7:00,438,108,330,
28957,263,2022/4/15 7:10,611,109,502,
28958,263,2022/4/15 7:20,723,126,597,
28959,263,2022/4/15 7:30,824,111,713,
28960,263,2022/4/15 7:40,1172,104,1068,
28961,263,2022/4/15 7:50,1367,144,1223,
28962,263,2022/4/15 8:00,1573,122,1451,
28963,263,2022/4/15 8:10,1597,121,1476,
28964,263,2022/4/15 8:20,1360,102,1258,
28965,263,2022/4/15 8:30,1212,111,1101,
28966,263,2022/4/15 8:40,1047,115,932,
28967,263,2022/4/15 8:50,742,120,622,
28968,263,2022/4/15 9:00,650,105,545,
28969,263,2022/4/15 9:10,468,99,369,
28970,263,2022/4/15 9:20,329,96,233,
28971,263,2022/4/15 9:30,278,94,184,
28972,263,2022/4/15 9:40,226,93,133,
28973,263,2022/4/15 9:50,173,98,75,
28974,263,2022/4/15 10:00,141,77,64,
28975,263,2022/4/15 10:10,92,93,-1,
28976,263,2022/4/15 10:20,72,76,-4,
28977,263,2022/4/15 10:30,69,108,-39,
28978,263,2022/4/15 10:40,65,85,-20,
28979,263,2022/4/15 10:50,49,101,-52,
28980,263,2022/4/15 11:00,48,85,-37,
28981,263,2022/4/15 11:10,45,103,-58,
28982,263,2022/4/15 11:20,45,74,-29,
28983,263,2022/4/15 11:30,50,93,-43,
28984,263,2022/4/15 11:40,46,82,-36,
28985,263,2022/4/15 11:50,54,106,-52,
28986,263,2022/4/15 12:00,65,90,-25,
28987,263,2022/4/15 12:10,70,100,-30,
28988,263,2022/4/15 12:20,70,83,-13,
28989,263,2022/4/15 12:30,73,109,-36,
28990,263,2022/4/15 12:40,64,90,-26,
28991,263,2022/4/15 12:50,69,105,-36,
28992,263,2022/4/15 13:00,62,93,-31,
28993,263,2022/4/15 13:10,58,104,-46,
28994,263,2022/4/15 13:20,63,77,-14,
28995,263,2022/4/15 13:30,61,112,-51,
28996,263,2022/4/15 13:40,54,90,-36,
28997,263,2022/4/15 13:50,41,109,-68,
28998,263,2022/4/15 14:00,43,91,-48,
28999,263,2022/4/15 14:10,42,105,-63,
29000,263,2022/4/15 14:20,43,89,-46,
29001,263,2022/4/15 14:30,43,121,-78,
29002,263,2022/4/15 14:40,50,110,-60,
29003,263,2022/4/15 14:50,45,118,-73,
29004,263,2022/4/15 15:00,43,101,-58,
29005,263,2022/4/15 15:10,43,124,-81,
29006,263,2022/4/15 15:20,76,106,-30,
29007,263,2022/4/15 15:30,58,133,-75,
29008,263,2022/4/15 15:40,51,101,-50,
29009,263,2022/4/15 15:50,47,150,-103,
29010,263,2022/4/15 16:00,55,119,-64,
29011,263,2022/4/15 16:10,59,150,-91,
29012,263,2022/4/15 16:20,68,110,-42,
29013,263,2022/4/15 16:30,81,226,-145,
29014,263,2022/4/15 16:40,74,117,-43,
29015,263,2022/4/15 16:50,85,197,-112,
29016,263,2022/4/15 17:00,134,251,-117,
29017,263,2022/4/15 17:10,157,252,-95,
29018,263,2022/4/15 17:20,138,375,-237,
29019,263,2022/4/15 17:30,179,318,-139,
29020,263,2022/4/15 17:40,182,499,-317,
29021,263,2022/4/15 17:50,77,523,-446,
29022,263,2022/4/15 18:00,68,417,-349,
29023,263,2022/4/15 18:10,102,420,-318,
29024,263,2022/4/15 18:20,57,431,-374,
29025,263,2022/4/15 18:30,51,419,-368,
29026,263,2022/4/15 18:40,46,490,-444,
29027,263,2022/4/15 18:50,41,431,-390,
29028,263,2022/4/15 19:00,37,503,-466,
29029,263,2022/4/15 19:10,37,321,-284,
29030,263,2022/4/15 19:20,32,299,-267,
29031,263,2022/4/15 19:30,28,221,-193,
29032,263,2022/4/15 19:40,28,177,-149,
29033,263,2022/4/15 19:50,28,169,-141,
29034,263,2022/4/15 20:00,30,111,-81,
29035,263,2022/4/15 20:10,35,109,-74,
29036,263,2022/4/15 20:20,27,111,-84,
29037,263,2022/4/15 20:30,29,110,-81,
29038,263,2022/4/15 20:40,27,138,-111,
29039,263,2022/4/15 20:50,27,127,-100,
29040,263,2022/4/15 21:00,29,191,-162,
29041,263,2022/4/15 21:10,35,116,-81,
29042,263,2022/4/15 21:20,28,107,-79,
29043,263,2022/4/15 21:30,27,111,-84,
29044,263,2022/4/15 21:40,24,150,-126,
29045,263,2022/4/15 21:50,23,128,-105,
29046,263,2022/4/15 22:00,21,119,-98,
29047,263,2022/4/15 22:10,17,118,-101,
29048,263,2022/4/15 22:20,15,112,-97,
29049,263,2022/4/15 22:30,13,109,-96,
29050,263,2022/4/15 22:40,11,105,-94,
29051,263,2022/4/15 22:50,3,77,-74,
29052,288,2022/4/15 5:00,0,1,-1,
29053,288,2022/4/15 5:10,0,1,-1,
29054,288,2022/4/15 5:20,2,1,1,
29055,288,2022/4/15 5:30,11,1,10,
29056,288,2022/4/15 5:40,26,2,24,
29057,288,2022/4/15 5:50,32,24,8,
29058,288,2022/4/15 6:00,39,16,23,
29059,288,2022/4/15 6:10,54,52,2,
29060,288,2022/4/15 6:20,64,51,13,
29061,288,2022/4/15 6:30,88,60,28,
29062,288,2022/4/15 6:40,152,75,77,
29063,288,2022/4/15 6:50,200,95,105,
29064,288,2022/4/15 7:00,228,124,104,
29065,288,2022/4/15 7:10,257,128,129,
29066,288,2022/4/15 7:20,301,112,189,
29067,288,2022/4/15 7:30,397,128,269,
29068,288,2022/4/15 7:40,656,103,553,
29069,288,2022/4/15 7:50,821,123,698,
29070,288,2022/4/15 8:00,859,138,721,
29071,288,2022/4/15 8:10,870,146,724,
29072,288,2022/4/15 8:20,1056,232,824,
29073,288,2022/4/15 8:30,824,218,606,
29074,288,2022/4/15 8:40,689,234,455,
29075,288,2022/4/15 8:50,599,192,407,
29076,288,2022/4/15 9:00,380,117,263,
29077,288,2022/4/15 9:10,314,109,205,
29078,288,2022/4/15 9:20,275,105,170,
29079,288,2022/4/15 9:30,214,123,91,
29080,288,2022/4/15 9:40,141,119,22,
29081,288,2022/4/15 9:50,79,118,-39,
29082,288,2022/4/15 10:00,68,97,-29,
29083,288,2022/4/15 10:10,63,105,-42,
29084,288,2022/4/15 10:20,48,103,-55,
29085,288,2022/4/15 10:30,46,97,-51,
29086,288,2022/4/15 10:40,45,103,-58,
29087,288,2022/4/15 10:50,41,112,-71,
29088,288,2022/4/15 11:00,42,108,-66,
29089,288,2022/4/15 11:10,44,90,-46,
29090,288,2022/4/15 11:20,40,112,-72,
29091,288,2022/4/15 11:30,41,104,-63,
29092,288,2022/4/15 11:40,43,112,-69,
29093,288,2022/4/15 11:50,43,105,-62,
29094,288,2022/4/15 12:00,44,106,-62,
29095,288,2022/4/15 12:10,48,101,-53,
29096,288,2022/4/15 12:20,52,103,-51,
29097,288,2022/4/15 12:30,58,105,-47,
29098,288,2022/4/15 12:40,51,87,-36,
29099,288,2022/4/15 12:50,63,103,-40,
29100,288,2022/4/15 13:00,51,119,-68,
29101,288,2022/4/15 13:10,63,103,-40,
29102,288,2022/4/15 13:20,51,108,-57,
29103,288,2022/4/15 13:30,47,104,-57,
29104,288,2022/4/15 13:40,52,125,-73,
29105,288,2022/4/15 13:50,48,108,-60,
29106,288,2022/4/15 14:00,42,102,-60,
29107,288,2022/4/15 14:10,53,110,-57,
29108,288,2022/4/15 14:20,45,114,-69,
29109,288,2022/4/15 14:30,51,118,-67,
29110,288,2022/4/15 14:40,57,125,-68,
29111,288,2022/4/15 14:50,60,122,-62,
29112,288,2022/4/15 15:00,54,123,-69,
29113,288,2022/4/15 15:10,71,113,-42,
29114,288,2022/4/15 15:20,56,110,-54,
29115,288,2022/4/15 15:30,67,114,-47,
29116,288,2022/4/15 15:40,71,117,-46,
29117,288,2022/4/15 15:50,73,108,-35,
29118,288,2022/4/15 16:00,65,119,-54,
29119,288,2022/4/15 16:10,110,110,0,
29120,288,2022/4/15 16:20,72,144,-72,
29121,288,2022/4/15 16:30,149,152,-3,
29122,288,2022/4/15 16:40,195,191,4,
29123,288,2022/4/15 16:50,151,192,-41,
29124,288,2022/4/15 17:00,181,204,-23,
29125,288,2022/4/15 17:10,203,265,-62,
29126,288,2022/4/15 17:20,205,330,-125,
29127,288,2022/4/15 17:30,212,523,-311,
29128,288,2022/4/15 17:40,200,533,-333,
29129,288,2022/4/15 17:50,228,417,-189,
29130,288,2022/4/15 18:00,177,434,-257,
29131,288,2022/4/15 18:10,148,430,-282,
29132,288,2022/4/15 18:20,80,425,-345,
29133,288,2022/4/15 18:30,75,475,-400,
29134,288,2022/4/15 18:40,63,491,-428,
29135,288,2022/4/15 18:50,55,431,-376,
29136,288,2022/4/15 19:00,50,421,-371,
29137,288,2022/4/15 19:10,52,341,-289,
29138,288,2022/4/15 19:20,46,300,-254,
29139,288,2022/4/15 19:30,44,217,-173,
29140,288,2022/4/15 19:40,45,221,-176,
29141,288,2022/4/15 19:50,39,169,-130,
29142,288,2022/4/15 20:00,46,142,-96,
29143,288,2022/4/15 20:10,60,144,-84,
29144,288,2022/4/15 20:20,47,128,-81,
29145,288,2022/4/15 20:30,54,121,-67,
29146,288,2022/4/15 20:40,51,123,-72,
29147,288,2022/4/15 20:50,46,133,-87,
29148,288,2022/4/15 21:00,51,106,-55,
29149,288,2022/4/15 21:10,55,109,-54,
29150,288,2022/4/15 21:20,46,116,-70,
29151,288,2022/4/15 21:30,44,110,-66,
29152,288,2022/4/15 21:40,43,123,-80,
29153,288,2022/4/15 21:50,39,119,-80,
29154,288,2022/4/15 22:00,139,102,37,
29155,288,2022/4/15 22:10,50,128,-78,
29156,288,2022/4/15 22:20,23,122,-99,
29157,288,2022/4/15 22:30,18,108,-90,
29158,288,2022/4/15 22:40,13,109,-96,
29159,288,2022/4/15 22:50,6,78,-72,
29160,289,2022/4/15 5:00,0,1,-1,
29161,289,2022/4/15 5:10,0,1,-1,
29162,289,2022/4/15 5:20,0,1,-1,
29163,289,2022/4/15 5:30,0,1,-1,
29164,289,2022/4/15 5:40,0,1,-1,
29165,289,2022/4/15 5:50,0,1,-1,
29166,289,2022/4/15 6:00,3,1,2,
29167,289,2022/4/15 6:10,9,11,-2,
29168,289,2022/4/15 6:20,3,19,-16,
29169,289,2022/4/15 6:30,4,13,-9,
29170,289,2022/4/15 6:40,5,15,-10,
29171,289,2022/4/15 6:50,4,29,-25,
29172,289,2022/4/15 7:00,4,38,-34,
29173,289,2022/4/15 7:10,5,38,-33,
29174,289,2022/4/15 7:20,10,47,-37,
29175,289,2022/4/15 7:30,12,70,-58,
29176,289,2022/4/15 7:40,14,70,-56,
29177,289,2022/4/15 7:50,17,85,-68,
29178,289,2022/4/15 8:00,18,83,-65,
29179,289,2022/4/15 8:10,16,73,-57,
29180,289,2022/4/15 8:20,17,75,-58,
29181,289,2022/4/15 8:30,15,90,-75,
29182,289,2022/4/15 8:40,8,104,-96,
29183,289,2022/4/15 8:50,11,110,-99,
29184,289,2022/4/15 9:00,10,102,-92,
29185,289,2022/4/15 9:10,5,126,-121,
29186,289,2022/4/15 9:20,7,109,-102,
29187,289,2022/4/15 9:30,6,105,-99,
29188,289,2022/4/15 9:40,5,96,-91,
29189,289,2022/4/15 9:50,6,90,-84,
29190,289,2022/4/15 10:00,7,77,-70,
29191,289,2022/4/15 10:10,5,76,-71,
29192,289,2022/4/15 10:20,8,74,-66,
29193,289,2022/4/15 10:30,11,81,-70,
29194,289,2022/4/15 10:40,10,69,-59,
29195,289,2022/4/15 10:50,11,69,-58,
29196,289,2022/4/15 11:00,12,64,-52,
29197,289,2022/4/15 11:10,15,63,-48,
29198,289,2022/4/15 11:20,16,60,-44,
29199,289,2022/4/15 11:30,14,69,-55,
29200,289,2022/4/15 11:40,16,64,-48,
29201,289,2022/4/15 11:50,17,62,-45,
29202,289,2022/4/15 12:00,16,56,-40,
29203,289,2022/4/15 12:10,16,68,-52,
29204,289,2022/4/15 12:20,20,64,-44,
29205,289,2022/4/15 12:30,17,56,-39,
29206,289,2022/4/15 12:40,17,63,-46,
29207,289,2022/4/15 12:50,21,68,-47,
29208,289,2022/4/15 13:00,22,57,-35,
29209,289,2022/4/15 13:10,21,61,-40,
29210,289,2022/4/15 13:20,20,61,-41,
29211,289,2022/4/15 13:30,25,70,-45,
29212,289,2022/4/15 13:40,23,56,-33,
29213,289,2022/4/15 13:50,27,68,-41,
29214,289,2022/4/15 14:00,25,56,-31,
29215,289,2022/4/15 14:10,22,67,-45,
29216,289,2022/4/15 14:20,23,59,-36,
29217,289,2022/4/15 14:30,25,64,-39,
29218,289,2022/4/15 14:40,23,57,-34,
29219,289,2022/4/15 14:50,24,70,-46,
29220,289,2022/4/15 15:00,23,55,-32,
29221,289,2022/4/15 15:10,23,57,-34,
29222,289,2022/4/15 15:20,24,57,-33,
29223,289,2022/4/15 15:30,27,69,-42,
29224,289,2022/4/15 15:40,26,51,-25,
29225,289,2022/4/15 15:50,25,60,-35,
29226,289,2022/4/15 16:00,29,57,-28,
29227,289,2022/4/15 16:10,28,61,-33,
29228,289,2022/4/15 16:20,24,64,-40,
29229,289,2022/4/15 16:30,34,68,-34,
29230,289,2022/4/15 16:40,28,63,-35,
29231,289,2022/4/15 16:50,36,72,-36,
29232,289,2022/4/15 17:00,43,69,-26,
29233,289,2022/4/15 17:10,51,70,-19,
29234,289,2022/4/15 17:20,41,81,-40,
29235,289,2022/4/15 17:30,34,87,-53,
29236,289,2022/4/15 17:40,44,90,-46,
29237,289,2022/4/15 17:50,30,96,-66,
29238,289,2022/4/15 18:00,31,102,-71,
29239,289,2022/4/15 18:10,28,96,-68,
29240,289,2022/4/15 18:20,28,102,-74,
29241,289,2022/4/15 18:30,29,101,-72,
29242,289,2022/4/15 18:40,26,102,-76,
29243,289,2022/4/15 18:50,20,94,-74,
29244,289,2022/4/15 19:00,21,88,-67,
29245,289,2022/4/15 19:10,26,98,-72,
29246,289,2022/4/15 19:20,25,73,-48,
29247,289,2022/4/15 19:30,23,71,-48,
29248,289,2022/4/15 19:40,24,62,-38,
29249,289,2022/4/15 19:50,25,48,-23,
29250,289,2022/4/15 20:00,29,38,-9,
29251,289,2022/4/15 20:10,32,39,-7,
29252,289,2022/4/15 20:20,28,33,-5,
29253,289,2022/4/15 20:30,31,32,-1,
29254,289,2022/4/15 20:40,27,30,-3,
29255,289,2022/4/15 20:50,27,23,4,
29256,289,2022/4/15 21:00,36,25,11,
29257,289,2022/4/15 21:10,39,25,14,
29258,289,2022/4/15 21:20,35,21,14,
29259,289,2022/4/15 21:30,45,21,24,
29260,289,2022/4/15 21:40,36,21,15,
29261,289,2022/4/15 21:50,35,18,17,
29262,289,2022/4/15 22:00,109,13,96,
29263,289,2022/4/15 22:10,66,13,53,
29264,289,2022/4/15 22:20,20,15,5,
29265,289,2022/4/15 22:30,14,15,-1,
29266,289,2022/4/15 22:40,10,3,7,
29267,289,2022/4/15 22:50,7,4,3,
29268,284,2022/4/15 5:00,0,1,-1,
29269,284,2022/4/15 5:10,0,1,-1,
29270,284,2022/4/15 5:20,3,1,2,
29271,284,2022/4/15 5:30,9,1,8,
29272,284,2022/4/15 5:40,12,8,4,
29273,284,2022/4/15 5:50,24,38,-14,
29274,284,2022/4/15 6:00,34,62,-28,
29275,284,2022/4/15 6:10,47,77,-30,
29276,284,2022/4/15 6:20,60,106,-46,
29277,284,2022/4/15 6:30,88,123,-35,
29278,284,2022/4/15 6:40,153,197,-44,
29279,284,2022/4/15 6:50,187,383,-196,
29280,284,2022/4/15 7:00,234,381,-147,
29281,284,2022/4/15 7:10,283,506,-223,
29282,284,2022/4/15 7:20,287,508,-221,
29283,284,2022/4/15 7:30,302,425,-123,
29284,284,2022/4/15 7:40,445,1212,-767,
29285,284,2022/4/15 7:50,632,491,141,
29286,284,2022/4/15 8:00,689,432,257,
29287,284,2022/4/15 8:10,724,428,296,
29288,284,2022/4/15 8:20,686,430,256,
29289,284,2022/4/15 8:30,665,427,238,
29290,284,2022/4/15 8:40,603,1189,-586,
29291,284,2022/4/15 8:50,439,575,-136,
29292,284,2022/4/15 9:00,319,488,-169,
29293,284,2022/4/15 9:10,322,428,-106,
29294,284,2022/4/15 9:20,275,427,-152,
29295,284,2022/4/15 9:30,277,344,-67,
29296,284,2022/4/15 9:40,231,254,-23,
29297,284,2022/4/15 9:50,237,281,-44,
29298,284,2022/4/15 10:00,213,159,54,
29299,284,2022/4/15 10:10,213,179,34,
29300,284,2022/4/15 10:20,205,133,72,
29301,284,2022/4/15 10:30,190,154,36,
29302,284,2022/4/15 10:40,185,110,75,
29303,284,2022/4/15 10:50,182,110,72,
29304,284,2022/4/15 11:00,184,125,59,
29305,284,2022/4/15 11:10,174,125,49,
29306,284,2022/4/15 11:20,178,122,56,
29307,284,2022/4/15 11:30,185,124,61,
29308,284,2022/4/15 11:40,174,115,59,
29309,284,2022/4/15 11:50,176,110,66,
29310,284,2022/4/15 12:00,163,107,56,
29311,284,2022/4/15 12:10,163,120,43,
29312,284,2022/4/15 12:20,138,121,17,
29313,284,2022/4/15 12:30,137,146,-9,
29314,284,2022/4/15 12:40,114,117,-3,
29315,284,2022/4/15 12:50,136,197,-61,
29316,284,2022/4/15 13:00,93,192,-99,
29317,284,2022/4/15 13:10,89,198,-109,
29318,284,2022/4/15 13:20,98,180,-82,
29319,284,2022/4/15 13:30,102,192,-90,
29320,284,2022/4/15 13:40,136,140,-4,
29321,284,2022/4/15 13:50,168,159,9,
29322,284,2022/4/15 14:00,186,120,66,
29323,284,2022/4/15 14:10,206,143,63,
29324,284,2022/4/15 14:20,216,105,111,
29325,284,2022/4/15 14:30,211,181,30,
29326,284,2022/4/15 14:40,223,121,102,
29327,284,2022/4/15 14:50,237,110,127,
29328,284,2022/4/15 15:00,257,123,134,
29329,284,2022/4/15 15:10,265,120,145,
29330,284,2022/4/15 15:20,274,110,164,
29331,284,2022/4/15 15:30,271,109,162,
29332,284,2022/4/15 15:40,335,105,230,
29333,284,2022/4/15 15:50,336,119,217,
29334,284,2022/4/15 16:00,352,109,243,
29335,284,2022/4/15 16:10,310,109,201,
29336,284,2022/4/15 16:20,359,119,240,
29337,284,2022/4/15 16:30,632,152,480,
29338,284,2022/4/15 16:40,714,111,603,
29339,284,2022/4/15 16:50,637,152,485,
29340,284,2022/4/15 17:00,800,140,660,
29341,284,2022/4/15 17:10,1024,176,848,
29342,284,2022/4/15 17:20,652,221,431,
29343,284,2022/4/15 17:30,639,324,315,
29344,284,2022/4/15 17:40,791,266,525,
29345,284,2022/4/15 17:50,610,332,278,
29346,284,2022/4/15 18:00,579,335,244,
29347,284,2022/4/15 18:10,724,320,404,
29348,284,2022/4/15 18:20,609,300,309,
29349,284,2022/4/15 18:30,370,328,42,
29350,284,2022/4/15 18:40,326,271,55,
29351,284,2022/4/15 18:50,274,233,41,
29352,284,2022/4/15 19:00,224,179,45,
29353,284,2022/4/15 19:10,191,150,41,
29354,284,2022/4/15 19:20,183,133,50,
29355,284,2022/4/15 19:30,138,109,29,
29356,284,2022/4/15 19:40,132,99,33,
29357,284,2022/4/15 19:50,72,122,-50,
29358,284,2022/4/15 20:00,70,106,-36,
29359,284,2022/4/15 20:10,83,109,-26,
29360,284,2022/4/15 20:20,70,101,-31,
29361,284,2022/4/15 20:30,51,105,-54,
29362,284,2022/4/15 20:40,65,99,-34,
29363,284,2022/4/15 20:50,54,111,-57,
29364,284,2022/4/15 21:00,55,113,-58,
29365,284,2022/4/15 21:10,62,108,-46,
29366,284,2022/4/15 21:20,44,121,-77,
29367,284,2022/4/15 21:30,45,120,-75,
29368,284,2022/4/15 21:40,46,106,-60,
29369,284,2022/4/15 21:50,37,106,-69,
29370,284,2022/4/15 22:00,26,105,-79,
29371,284,2022/4/15 22:10,30,102,-72,
29372,284,2022/4/15 22:20,26,103,-77,
29373,284,2022/4/15 22:30,18,92,-74,
29374,284,2022/4/15 22:40,14,77,-63,
29375,284,2022/4/15 22:50,9,64,-55,
29376,274,2022/4/15 5:00,0,1,-1,
29377,274,2022/4/15 5:10,0,1,-1,
29378,274,2022/4/15 5:20,2,1,1,
29379,274,2022/4/15 5:30,9,1,8,
29380,274,2022/4/15 5:40,12,8,4,
29381,274,2022/4/15 5:50,29,2,27,
29382,274,2022/4/15 6:00,35,61,-26,
29383,274,2022/4/15 6:10,37,63,-26,
29384,274,2022/4/15 6:20,47,83,-36,
29385,274,2022/4/15 6:30,76,75,1,
29386,274,2022/4/15 6:40,108,110,-2,
29387,274,2022/4/15 6:50,163,197,-34,
29388,274,2022/4/15 7:00,192,439,-247,
29389,274,2022/4/15 7:10,255,419,-164,
29390,274,2022/4/15 7:20,260,425,-165,
29391,274,2022/4/15 7:30,278,426,-148,
29392,274,2022/4/15 7:40,371,500,-129,
29393,274,2022/4/15 7:50,631,506,125,
29394,274,2022/4/15 8:00,690,425,265,
29395,274,2022/4/15 8:10,687,600,87,
29396,274,2022/4/15 8:20,725,560,165,
29397,274,2022/4/15 8:30,655,601,54,
29398,274,2022/4/15 8:40,595,1591,-996,
29399,274,2022/4/15 8:50,337,1168,-831,
29400,274,2022/4/15 9:00,340,426,-86,
29401,274,2022/4/15 9:10,312,426,-114,
29402,274,2022/4/15 9:20,278,376,-98,
29403,274,2022/4/15 9:30,270,324,-54,
29404,274,2022/4/15 9:40,230,325,-95,
29405,274,2022/4/15 9:50,219,178,41,
29406,274,2022/4/15 10:00,207,186,21,
29407,274,2022/4/15 10:10,189,147,42,
29408,274,2022/4/15 10:20,194,152,42,
29409,274,2022/4/15 10:30,174,105,69,
29410,274,2022/4/15 10:40,176,112,64,
29411,274,2022/4/15 10:50,163,125,38,
29412,274,2022/4/15 11:00,163,108,55,
29413,274,2022/4/15 11:10,175,126,49,
29414,274,2022/4/15 11:20,156,110,46,
29415,274,2022/4/15 11:30,192,119,73,
29416,274,2022/4/15 11:40,185,110,75,
29417,274,2022/4/15 11:50,272,114,158,
29418,274,2022/4/15 12:00,203,119,84,
29419,274,2022/4/15 12:10,213,109,104,
29420,274,2022/4/15 12:20,175,112,63,
29421,274,2022/4/15 12:30,197,110,87,
29422,274,2022/4/15 12:40,192,170,22,
29423,274,2022/4/15 12:50,177,128,49,
29424,274,2022/4/15 13:00,179,192,-13,
29425,274,2022/4/15 13:10,211,128,83,
29426,274,2022/4/15 13:20,184,185,-1,
29427,274,2022/4/15 13:30,174,120,54,
29428,274,2022/4/15 13:40,185,181,4,
29429,274,2022/4/15 13:50,185,105,80,
29430,274,2022/4/15 14:00,192,169,23,
29431,274,2022/4/15 14:10,207,111,96,
29432,274,2022/4/15 14:20,202,119,83,
29433,274,2022/4/15 14:30,231,111,120,
29434,274,2022/4/15 14:40,351,119,232,
29435,274,2022/4/15 14:50,332,109,223,
29436,274,2022/4/15 15:00,269,144,125,
29437,274,2022/4/15 15:10,319,109,210,
29438,274,2022/4/15 15:20,264,120,144,
29439,274,2022/4/15 15:30,303,133,170,
29440,274,2022/4/15 15:40,333,170,163,
29441,274,2022/4/15 15:50,316,133,183,
29442,274,2022/4/15 16:00,349,110,239,
29443,274,2022/4/15 16:10,328,110,218,
29444,274,2022/4/15 16:20,311,185,126,
29445,274,2022/4/15 16:30,314,121,193,
29446,274,2022/4/15 16:40,361,192,169,
29447,274,2022/4/15 16:50,380,183,197,
29448,274,2022/4/15 17:00,707,189,518,
29449,274,2022/4/15 17:10,833,205,628,
29450,274,2022/4/15 17:20,634,296,338,
29451,274,2022/4/15 17:30,680,341,339,
29452,274,2022/4/15 17:40,789,331,458,
29453,274,2022/4/15 17:50,574,381,193,
29454,274,2022/4/15 18:00,642,433,209,
29455,274,2022/4/15 18:10,715,378,337,
29456,274,2022/4/15 18:20,571,326,245,
29457,274,2022/4/15 18:30,317,382,-65,
29458,274,2022/4/15 18:40,276,327,-51,
29459,274,2022/4/15 18:50,216,299,-83,
29460,274,2022/4/15 19:00,186,198,-12,
29461,274,2022/4/15 19:10,175,184,-9,
29462,274,2022/4/15 19:20,142,182,-40,
29463,274,2022/4/15 19:30,115,120,-5,
29464,274,2022/4/15 19:40,88,113,-25,
29465,274,2022/4/15 19:50,85,124,-39,
29466,274,2022/4/15 20:00,76,121,-45,
29467,274,2022/4/15 20:10,137,121,16,
29468,274,2022/4/15 20:20,83,108,-25,
29469,274,2022/4/15 20:30,80,111,-31,
29470,274,2022/4/15 20:40,89,127,-38,
29471,274,2022/4/15 20:50,84,106,-22,
29472,274,2022/4/15 21:00,96,120,-24,
29473,274,2022/4/15 21:10,88,125,-37,
29474,274,2022/4/15 21:20,54,121,-67,
29475,274,2022/4/15 21:30,40,114,-74,
29476,274,2022/4/15 21:40,44,101,-57,
29477,274,2022/4/15 21:50,40,122,-82,
29478,274,2022/4/15 22:00,43,109,-66,
29479,274,2022/4/15 22:10,37,107,-70,
29480,274,2022/4/15 22:20,25,123,-98,
29481,274,2022/4/15 22:30,21,105,-84,
29482,274,2022/4/15 22:40,13,85,-72,
29483,274,2022/4/15 22:50,11,67,-56,
29484,270,2022/4/15 5:00,0,1,-1,
29485,270,2022/4/15 5:10,1,1,0,
29486,270,2022/4/15 5:20,1,1,0,
29487,270,2022/4/15 5:30,8,1,7,
29488,270,2022/4/15 5:40,19,1,18,
29489,270,2022/4/15 5:50,36,11,25,
29490,270,2022/4/15 6:00,35,42,-7,
29491,270,2022/4/15 6:10,47,51,-4,
29492,270,2022/4/15 6:20,53,65,-12,
29493,270,2022/4/15 6:30,72,76,-4,
29494,270,2022/4/15 6:40,70,93,-23,
29495,270,2022/4/15 6:50,150,104,46,
29496,270,2022/4/15 7:00,165,119,46,
29497,270,2022/4/15 7:10,190,109,81,
29498,270,2022/4/15 7:20,200,110,90,
29499,270,2022/4/15 7:30,216,147,69,
29500,270,2022/4/15 7:40,258,235,23,
29501,270,2022/4/15 7:50,338,270,68,
29502,270,2022/4/15 8:00,369,333,36,
29503,270,2022/4/15 8:10,575,501,74,
29504,270,2022/4/15 8:20,446,443,3,
29505,270,2022/4/15 8:30,481,420,61,
29506,270,2022/4/15 8:40,351,630,-279,
29507,270,2022/4/15 8:50,278,580,-302,
29508,270,2022/4/15 9:00,269,508,-239,
29509,270,2022/4/15 9:10,238,324,-86,
29510,270,2022/4/15 9:20,219,331,-112,
29511,270,2022/4/15 9:30,177,254,-77,
29512,270,2022/4/15 9:40,145,217,-72,
29513,270,2022/4/15 9:50,108,220,-112,
29514,270,2022/4/15 10:00,100,144,-44,
29515,270,2022/4/15 10:10,91,139,-48,
29516,270,2022/4/15 10:20,76,124,-48,
29517,270,2022/4/15 10:30,76,110,-34,
29518,270,2022/4/15 10:40,73,124,-51,
29519,270,2022/4/15 10:50,67,123,-56,
29520,270,2022/4/15 11:00,65,122,-57,
29521,270,2022/4/15 11:10,70,101,-31,
29522,270,2022/4/15 11:20,76,109,-33,
29523,270,2022/4/15 11:30,86,101,-15,
29524,270,2022/4/15 11:40,76,119,-43,
29525,270,2022/4/15 11:50,108,122,-14,
29526,270,2022/4/15 12:00,101,125,-24,
29527,270,2022/4/15 12:10,92,110,-18,
29528,270,2022/4/15 12:20,102,107,-5,
29529,270,2022/4/15 12:30,88,108,-20,
29530,270,2022/4/15 12:40,110,115,-5,
29531,270,2022/4/15 12:50,82,106,-24,
29532,270,2022/4/15 13:00,132,121,11,
29533,270,2022/4/15 13:10,92,106,-14,
29534,270,2022/4/15 13:20,104,122,-18,
29535,270,2022/4/15 13:30,96,109,-13,
29536,270,2022/4/15 13:40,114,121,-7,
29537,270,2022/4/15 13:50,89,109,-20,
29538,270,2022/4/15 14:00,130,122,8,
29539,270,2022/4/15 14:10,96,121,-25,
29540,270,2022/4/15 14:20,128,104,24,
29541,270,2022/4/15 14:30,102,114,-12,
29542,270,2022/4/15 14:40,132,117,15,
29543,270,2022/4/15 14:50,131,108,23,
29544,270,2022/4/15 15:00,128,124,4,
29545,270,2022/4/15 15:10,174,109,65,
29546,270,2022/4/15 15:20,175,121,54,
29547,270,2022/4/15 15:30,164,105,59,
29548,270,2022/4/15 15:40,174,121,53,
29549,270,2022/4/15 15:50,174,125,49,
29550,270,2022/4/15 16:00,210,116,94,
29551,270,2022/4/15 16:10,218,125,93,
29552,270,2022/4/15 16:20,205,109,96,
29553,270,2022/4/15 16:30,265,125,140,
29554,270,2022/4/15 16:40,269,106,163,
29555,270,2022/4/15 16:50,265,112,153,
29556,270,2022/4/15 17:00,546,110,436,
29557,270,2022/4/15 17:10,580,191,389,
29558,270,2022/4/15 17:20,352,212,140,
29559,270,2022/4/15 17:30,609,207,402,
29560,270,2022/4/15 17:40,699,233,466,
29561,270,2022/4/15 17:50,364,283,81,
29562,270,2022/4/15 18:00,581,269,312,
29563,270,2022/4/15 18:10,641,269,372,
29564,270,2022/4/15 18:20,355,322,33,
29565,270,2022/4/15 18:30,292,284,8,
29566,270,2022/4/15 18:40,273,197,76,
29567,270,2022/4/15 18:50,237,196,41,
29568,270,2022/4/15 19:00,227,150,77,
29569,270,2022/4/15 19:10,185,117,68,
29570,270,2022/4/15 19:20,134,110,24,
29571,270,2022/4/15 19:30,114,105,9,
29572,270,2022/4/15 19:40,86,122,-36,
29573,270,2022/4/15 19:50,77,107,-30,
29574,270,2022/4/15 20:00,76,107,-31,
29575,270,2022/4/15 20:10,75,113,-38,
29576,270,2022/4/15 20:20,70,114,-44,
29577,270,2022/4/15 20:30,70,107,-37,
29578,270,2022/4/15 20:40,68,113,-45,
29579,270,2022/4/15 20:50,61,110,-49,
29580,270,2022/4/15 21:00,77,113,-36,
29581,270,2022/4/15 21:10,67,104,-37,
29582,270,2022/4/15 21:20,45,126,-81,
29583,270,2022/4/15 21:30,43,102,-59,
29584,270,2022/4/15 21:40,41,110,-69,
29585,270,2022/4/15 21:50,35,107,-72,
29586,270,2022/4/15 22:00,41,113,-72,
29587,270,2022/4/15 22:10,29,110,-81,
29588,270,2022/4/15 22:20,28,124,-96,
29589,270,2022/4/15 22:30,19,105,-86,
29590,270,2022/4/15 22:40,13,73,-60,
29591,270,2022/4/15 22:50,8,71,-63,
29592,264,2022/4/15 5:00,0,1,-1,
29593,264,2022/4/15 5:10,0,1,-1,
29594,264,2022/4/15 5:20,1,1,0,
29595,264,2022/4/15 5:30,7,1,6,
29596,264,2022/4/15 5:40,15,1,14,
29597,264,2022/4/15 5:50,26,1,25,
29598,264,2022/4/15 6:00,24,62,-38,
29599,264,2022/4/15 6:10,20,56,-36,
29600,264,2022/4/15 6:20,29,68,-39,
29601,264,2022/4/15 6:30,27,93,-66,
29602,264,2022/4/15 6:40,31,125,-94,
29603,264,2022/4/15 6:50,34,109,-75,
29604,264,2022/4/15 7:00,45,195,-150,
29605,264,2022/4/15 7:10,40,157,-117,
29606,264,2022/4/15 7:20,51,115,-64,
29607,264,2022/4/15 7:30,45,196,-151,
29608,264,2022/4/15 7:40,54,326,-272,
29609,264,2022/4/15 7:50,58,534,-476,
29610,264,2022/4/15 8:00,73,675,-602,
29611,264,2022/4/15 8:10,73,2121,-2048,
29612,264,2022/4/15 8:20,69,2164,-2095,
29613,264,2022/4/15 8:30,74,3042,-2968,
29614,264,2022/4/15 8:40,75,7859,-7784,
29615,264,2022/4/15 8:50,60,5741,-5681,
29616,264,2022/4/15 9:00,53,2109,-2056,
29617,264,2022/4/15 9:10,50,2106,-2056,
29618,264,2022/4/15 9:20,51,1126,-1075,
29619,264,2022/4/15 9:30,48,477,-429,
29620,264,2022/4/15 9:40,47,428,-381,
29621,264,2022/4/15 9:50,46,434,-388,
29622,264,2022/4/15 10:00,48,324,-276,
29623,264,2022/4/15 10:10,47,159,-112,
29624,264,2022/4/15 10:20,46,213,-167,
29625,264,2022/4/15 10:30,53,144,-91,
29626,264,2022/4/15 10:40,45,186,-141,
29627,264,2022/4/15 10:50,55,105,-50,
29628,264,2022/4/15 11:00,51,120,-69,
29629,264,2022/4/15 11:10,47,111,-64,
29630,264,2022/4/15 11:20,53,121,-68,
29631,264,2022/4/15 11:30,62,108,-46,
29632,264,2022/4/15 11:40,71,112,-41,
29633,264,2022/4/15 11:50,68,124,-56,
29634,264,2022/4/15 12:00,66,120,-54,
29635,264,2022/4/15 12:10,72,127,-55,
29636,264,2022/4/15 12:20,74,129,-55,
29637,264,2022/4/15 12:30,76,109,-33,
29638,264,2022/4/15 12:40,73,171,-98,
29639,264,2022/4/15 12:50,82,109,-27,
29640,264,2022/4/15 13:00,102,128,-26,
29641,264,2022/4/15 13:10,93,105,-12,
29642,264,2022/4/15 13:20,128,111,17,
29643,264,2022/4/15 13:30,136,110,26,
29644,264,2022/4/15 13:40,142,144,-2,
29645,264,2022/4/15 13:50,135,127,8,
29646,264,2022/4/15 14:00,137,109,28,
29647,264,2022/4/15 14:10,142,123,19,
29648,264,2022/4/15 14:20,133,111,22,
29649,264,2022/4/15 14:30,131,88,43,
29650,264,2022/4/15 14:40,137,110,27,
29651,264,2022/4/15 14:50,133,105,28,
29652,264,2022/4/15 15:00,166,121,45,
29653,264,2022/4/15 15:10,186,106,80,
29654,264,2022/4/15 15:20,164,122,42,
29655,264,2022/4/15 15:30,157,96,61,
29656,264,2022/4/15 15:40,183,119,64,
29657,264,2022/4/15 15:50,162,102,60,
29658,264,2022/4/15 16:00,178,117,61,
29659,264,2022/4/15 16:10,216,106,110,
29660,264,2022/4/15 16:20,219,104,115,
29661,264,2022/4/15 16:30,272,114,158,
29662,264,2022/4/15 16:40,313,111,202,
29663,264,2022/4/15 16:50,348,111,237,
29664,264,2022/4/15 17:00,695,123,572,
29665,264,2022/4/15 17:10,806,149,657,
29666,264,2022/4/15 17:20,656,190,466,
29667,264,2022/4/15 17:30,1154,211,943,
29668,264,2022/4/15 17:40,1609,217,1392,
29669,264,2022/4/15 17:50,1149,254,895,
29670,264,2022/4/15 18:00,1189,321,868,
29671,264,2022/4/15 18:10,2511,284,2227,
29672,264,2022/4/15 18:20,1583,314,1269,
29673,264,2022/4/15 18:30,822,300,522,
29674,264,2022/4/15 18:40,806,294,512,
29675,264,2022/4/15 18:50,608,226,382,
29676,264,2022/4/15 19:00,558,146,412,
29677,264,2022/4/15 19:10,431,109,322,
29678,264,2022/4/15 19:20,347,122,225,
29679,264,2022/4/15 19:30,265,116,149,
29680,264,2022/4/15 19:40,269,106,163,
29681,264,2022/4/15 19:50,271,103,168,
29682,264,2022/4/15 20:00,269,90,179,
29683,264,2022/4/15 20:10,265,86,179,
29684,264,2022/4/15 20:20,265,77,188,
29685,264,2022/4/15 20:30,273,95,178,
29686,264,2022/4/15 20:40,273,76,197,
29687,264,2022/4/15 20:50,242,81,161,
29688,264,2022/4/15 21:00,274,80,194,
29689,264,2022/4/15 21:10,302,81,221,
29690,264,2022/4/15 21:20,273,87,186,
29691,264,2022/4/15 21:30,228,75,153,
29692,264,2022/4/15 21:40,189,77,112,
29693,264,2022/4/15 21:50,192,69,123,
29694,264,2022/4/15 22:00,168,71,97,
29695,264,2022/4/15 22:10,147,73,74,
29696,264,2022/4/15 22:20,63,78,-15,
29697,264,2022/4/15 22:30,44,85,-41,
29698,264,2022/4/15 22:40,33,66,-33,
29699,264,2022/4/15 22:50,25,58,-33,
29700,279,2022/4/15 5:00,3,1,2,
29701,279,2022/4/15 5:10,4,6,-2,
29702,279,2022/4/15 5:20,9,5,4,
29703,279,2022/4/15 5:30,13,8,5,
29704,279,2022/4/15 5:40,12,13,-1,
29705,279,2022/4/15 5:50,16,23,-7,
29706,279,2022/4/15 6:00,23,115,-92,
29707,279,2022/4/15 6:10,22,117,-95,
29708,279,2022/4/15 6:20,32,107,-75,
29709,279,2022/4/15 6:30,32,126,-94,
29710,279,2022/4/15 6:40,41,222,-181,
29711,279,2022/4/15 6:50,38,218,-180,
29712,279,2022/4/15 7:00,57,327,-270,
29713,279,2022/4/15 7:10,57,373,-316,
29714,279,2022/4/15 7:20,56,403,-347,
29715,279,2022/4/15 7:30,57,471,-414,
29716,279,2022/4/15 7:40,74,1164,-1090,
29717,279,2022/4/15 7:50,88,1924,-1836,
29718,279,2022/4/15 8:00,112,4571,-4459,
29719,279,2022/4/15 8:10,154,5231,-5077,
29720,279,2022/4/15 8:20,151,6152,-6001,
29721,279,2022/4/15 8:30,164,7061,-6897,
29722,279,2022/4/15 8:40,156,8263,-8107,
29723,279,2022/4/15 8:50,155,5793,-5638,
29724,279,2022/4/15 9:00,167,8649,-8482,
29725,279,2022/4/15 9:10,181,6146,-5965,
29726,279,2022/4/15 9:20,140,4386,-4246,
29727,279,2022/4/15 9:30,150,2949,-2799,
29728,279,2022/4/15 9:40,179,2322,-2143,
29729,279,2022/4/15 9:50,178,2038,-1860,
29730,279,2022/4/15 10:00,175,1188,-1013,
29731,279,2022/4/15 10:10,187,566,-379,
29732,279,2022/4/15 10:20,209,470,-261,
29733,279,2022/4/15 10:30,210,620,-410,
29734,279,2022/4/15 10:40,215,482,-267,
29735,279,2022/4/15 10:50,217,412,-195,
29736,279,2022/4/15 11:00,234,420,-186,
29737,279,2022/4/15 11:10,224,423,-199,
29738,279,2022/4/15 11:20,237,428,-191,
29739,279,2022/4/15 11:30,267,415,-148,
29740,279,2022/4/15 11:40,267,429,-162,
29741,279,2022/4/15 11:50,300,429,-129,
29742,279,2022/4/15 12:00,344,412,-68,
29743,279,2022/4/15 12:10,336,411,-75,
29744,279,2022/4/15 12:20,327,428,-101,
29745,279,2022/4/15 12:30,351,414,-63,
29746,279,2022/4/15 12:40,424,421,3,
29747,279,2022/4/15 12:50,424,422,2,
29748,279,2022/4/15 13:00,553,427,126,
29749,279,2022/4/15 13:10,557,422,135,
29750,279,2022/4/15 13:20,579,422,157,
29751,279,2022/4/15 13:30,567,426,141,
29752,279,2022/4/15 13:40,573,485,88,
29753,279,2022/4/15 13:50,575,428,147,
29754,279,2022/4/15 14:00,620,427,193,
29755,279,2022/4/15 14:10,592,418,174,
29756,279,2022/4/15 14:20,607,418,189,
29757,279,2022/4/15 14:30,622,427,195,
29758,279,2022/4/15 14:40,628,424,204,
29759,279,2022/4/15 14:50,693,484,209,
29760,279,2022/4/15 15:00,679,527,152,
29761,279,2022/4/15 15:10,731,492,239,
29762,279,2022/4/15 15:20,672,485,187,
29763,279,2022/4/15 15:30,661,491,170,
29764,279,2022/4/15 15:40,716,491,225,
29765,279,2022/4/15 15:50,713,487,226,
29766,279,2022/4/15 16:00,830,491,339,
29767,279,2022/4/15 16:10,1022,413,609,
29768,279,2022/4/15 16:20,823,479,344,
29769,279,2022/4/15 16:30,1018,487,531,
29770,279,2022/4/15 16:40,1196,484,712,
29771,279,2022/4/15 16:50,1195,422,773,
29772,279,2022/4/15 17:00,1987,389,1598,
29773,279,2022/4/15 17:10,2517,397,2120,
29774,279,2022/4/15 17:20,2030,463,1567,
29775,279,2022/4/15 17:30,2535,593,1942,
29776,279,2022/4/15 17:40,3506,1126,2380,
29777,279,2022/4/15 17:50,3356,1121,2235,
29778,279,2022/4/15 18:00,3257,1538,1719,
29779,279,2022/4/15 18:10,3452,1561,1891,
29780,279,2022/4/15 18:20,3368,1542,1826,
29781,279,2022/4/15 18:30,3278,1529,1749,
29782,279,2022/4/15 18:40,2525,1514,1011,
29783,279,2022/4/15 18:50,1985,554,1431,
29784,279,2022/4/15 19:00,1974,484,1490,
29785,279,2022/4/15 19:10,1576,470,1106,
29786,279,2022/4/15 19:20,1352,361,991,
29787,279,2022/4/15 19:30,1199,322,877,
29788,279,2022/4/15 19:40,1196,234,962,
29789,279,2022/4/15 19:50,1017,226,791,
29790,279,2022/4/15 20:00,1135,193,942,
29791,279,2022/4/15 20:10,1185,116,1069,
29792,279,2022/4/15 20:20,1194,116,1078,
29793,279,2022/4/15 20:30,1237,111,1126,
29794,279,2022/4/15 20:40,1196,115,1081,
29795,279,2022/4/15 20:50,1242,114,1128,
29796,279,2022/4/15 21:00,1589,124,1465,
29797,279,2022/4/15 21:10,1633,121,1512,
29798,279,2022/4/15 21:20,1432,105,1327,
29799,279,2022/4/15 21:30,1278,101,1177,
29800,279,2022/4/15 21:40,1195,111,1084,
29801,279,2022/4/15 21:50,1292,112,1180,
29802,279,2022/4/15 22:00,1992,98,1894,
29803,279,2022/4/15 22:10,1403,92,1311,
29804,279,2022/4/15 22:20,313,95,218,
29805,279,2022/4/15 22:30,218,78,140,
29806,279,2022/4/15 22:40,123,71,52,
29807,279,2022/4/15 22:50,54,71,-17,
29808,277,2022/4/15 5:00,0,1,-1,
29809,277,2022/4/15 5:10,0,1,-1,
29810,277,2022/4/15 5:20,1,1,0,
29811,277,2022/4/15 5:30,3,1,2,
29812,277,2022/4/15 5:40,15,1,14,
29813,277,2022/4/15 5:50,17,6,11,
29814,277,2022/4/15 6:00,19,23,-4,
29815,277,2022/4/15 6:10,30,21,9,
29816,277,2022/4/15 6:20,31,44,-13,
29817,277,2022/4/15 6:30,39,52,-13,
29818,277,2022/4/15 6:40,45,69,-24,
29819,277,2022/4/15 6:50,60,98,-38,
29820,277,2022/4/15 7:00,64,102,-38,
29821,277,2022/4/15 7:10,66,102,-36,
29822,277,2022/4/15 7:20,58,105,-47,
29823,277,2022/4/15 7:30,87,107,-20,
29824,277,2022/4/15 7:40,88,109,-21,
29825,277,2022/4/15 7:50,163,171,-8,
29826,277,2022/4/15 8:00,187,223,-36,
29827,277,2022/4/15 8:10,186,323,-137,
29828,277,2022/4/15 8:20,147,339,-192,
29829,277,2022/4/15 8:30,103,501,-398,
29830,277,2022/4/15 8:40,91,437,-346,
29831,277,2022/4/15 8:50,78,431,-353,
29832,277,2022/4/15 9:00,79,346,-267,
29833,277,2022/4/15 9:10,69,299,-230,
29834,277,2022/4/15 9:20,50,233,-183,
29835,277,2022/4/15 9:30,43,152,-109,
29836,277,2022/4/15 9:40,45,129,-84,
29837,277,2022/4/15 9:50,37,108,-71,
29838,277,2022/4/15 10:00,29,102,-73,
29839,277,2022/4/15 10:10,36,108,-72,
29840,277,2022/4/15 10:20,38,102,-64,
29841,277,2022/4/15 10:30,36,114,-78,
29842,277,2022/4/15 10:40,31,93,-62,
29843,277,2022/4/15 10:50,31,108,-77,
29844,277,2022/4/15 11:00,36,93,-57,
29845,277,2022/4/15 11:10,38,96,-58,
29846,277,2022/4/15 11:20,33,90,-57,
29847,277,2022/4/15 11:30,37,100,-63,
29848,277,2022/4/15 11:40,34,105,-71,
29849,277,2022/4/15 11:50,39,99,-60,
29850,277,2022/4/15 12:00,41,93,-52,
29851,277,2022/4/15 12:10,36,99,-63,
29852,277,2022/4/15 12:20,46,77,-31,
29853,277,2022/4/15 12:30,44,104,-60,
29854,277,2022/4/15 12:40,45,93,-48,
29855,277,2022/4/15 12:50,46,98,-52,
29856,277,2022/4/15 13:00,44,101,-57,
29857,277,2022/4/15 13:10,43,100,-57,
29858,277,2022/4/15 13:20,46,93,-47,
29859,277,2022/4/15 13:30,45,110,-65,
29860,277,2022/4/15 13:40,45,113,-68,
29861,277,2022/4/15 13:50,44,98,-54,
29862,277,2022/4/15 14:00,45,90,-45,
29863,277,2022/4/15 14:10,44,113,-69,
29864,277,2022/4/15 14:20,43,93,-50,
29865,277,2022/4/15 14:30,43,106,-63,
29866,277,2022/4/15 14:40,42,88,-46,
29867,277,2022/4/15 14:50,43,101,-58,
29868,277,2022/4/15 15:00,45,93,-48,
29869,277,2022/4/15 15:10,46,96,-50,
29870,277,2022/4/15 15:20,46,99,-53,
29871,277,2022/4/15 15:30,49,105,-56,
29872,277,2022/4/15 15:40,52,105,-53,
29873,277,2022/4/15 15:50,69,105,-36,
29874,277,2022/4/15 16:00,72,98,-26,
29875,277,2022/4/15 16:10,81,105,-24,
29876,277,2022/4/15 16:20,77,108,-31,
29877,277,2022/4/15 16:30,100,97,3,
29878,277,2022/4/15 16:40,136,108,28,
29879,277,2022/4/15 16:50,144,123,21,
29880,277,2022/4/15 17:00,272,126,146,
29881,277,2022/4/15 17:10,308,110,198,
29882,277,2022/4/15 17:20,216,120,96,
29883,277,2022/4/15 17:30,307,127,180,
29884,277,2022/4/15 17:40,555,127,428,
29885,277,2022/4/15 17:50,288,144,144,
29886,277,2022/4/15 18:00,271,192,79,
29887,277,2022/4/15 18:10,331,159,172,
29888,277,2022/4/15 18:20,269,178,91,
29889,277,2022/4/15 18:30,259,192,67,
29890,277,2022/4/15 18:40,207,192,15,
29891,277,2022/4/15 18:50,180,109,71,
29892,277,2022/4/15 19:00,154,130,24,
29893,277,2022/4/15 19:10,133,123,10,
29894,277,2022/4/15 19:20,82,107,-25,
29895,277,2022/4/15 19:30,73,105,-32,
29896,277,2022/4/15 19:40,77,105,-28,
29897,277,2022/4/15 19:50,65,95,-30,
29898,277,2022/4/15 20:00,73,94,-21,
29899,277,2022/4/15 20:10,77,78,-1,
29900,277,2022/4/15 20:20,68,92,-24,
29901,277,2022/4/15 20:30,66,89,-23,
29902,277,2022/4/15 20:40,67,92,-25,
29903,277,2022/4/15 20:50,72,79,-7,
29904,277,2022/4/15 21:00,84,74,10,
29905,277,2022/4/15 21:10,71,75,-4,
29906,277,2022/4/15 21:20,71,95,-24,
29907,277,2022/4/15 21:30,60,77,-17,
29908,277,2022/4/15 21:40,64,84,-20,
29909,277,2022/4/15 21:50,50,70,-20,
29910,277,2022/4/15 22:00,76,85,-9,
29911,277,2022/4/15 22:10,37,79,-42,
29912,277,2022/4/15 22:20,23,78,-55,
29913,277,2022/4/15 22:30,22,78,-56,
29914,277,2022/4/15 22:40,13,56,-43,
29915,277,2022/4/15 22:50,9,48,-39,
29916,290,2022/4/15 5:00,0,1,-1,
29917,290,2022/4/15 5:10,0,1,-1,
29918,290,2022/4/15 5:20,1,1,0,
29919,290,2022/4/15 5:30,6,1,5,
29920,290,2022/4/15 5:40,24,1,23,
29921,290,2022/4/15 5:50,25,13,12,
29922,290,2022/4/15 6:00,32,8,24,
29923,290,2022/4/15 6:10,42,46,-4,
29924,290,2022/4/15 6:20,51,33,18,
29925,290,2022/4/15 6:30,58,50,8,
29926,290,2022/4/15 6:40,88,66,22,
29927,290,2022/4/15 6:50,151,77,74,
29928,290,2022/4/15 7:00,182,105,77,
29929,290,2022/4/15 7:10,216,117,99,
29930,290,2022/4/15 7:20,228,121,107,
29931,290,2022/4/15 7:30,254,112,142,
29932,290,2022/4/15 7:40,322,183,139,
29933,290,2022/4/15 7:50,378,159,219,
29934,290,2022/4/15 8:00,438,192,246,
29935,290,2022/4/15 8:10,446,226,220,
29936,290,2022/4/15 8:20,338,146,192,
29937,290,2022/4/15 8:30,360,144,216,
29938,290,2022/4/15 8:40,278,197,81,
29939,290,2022/4/15 8:50,263,154,109,
29940,290,2022/4/15 9:00,227,125,102,
29941,290,2022/4/15 9:10,192,110,82,
29942,290,2022/4/15 9:20,168,118,50,
29943,290,2022/4/15 9:30,115,116,-1,
29944,290,2022/4/15 9:40,76,104,-28,
29945,290,2022/4/15 9:50,58,98,-40,
29946,290,2022/4/15 10:00,50,81,-31,
29947,290,2022/4/15 10:10,46,83,-37,
29948,290,2022/4/15 10:20,45,81,-36,
29949,290,2022/4/15 10:30,45,75,-30,
29950,290,2022/4/15 10:40,37,77,-40,
29951,290,2022/4/15 10:50,39,83,-44,
29952,290,2022/4/15 11:00,35,77,-42,
29953,290,2022/4/15 11:10,43,62,-19,
29954,290,2022/4/15 11:20,39,85,-46,
29955,290,2022/4/15 11:30,35,70,-35,
29956,290,2022/4/15 11:40,35,77,-42,
29957,290,2022/4/15 11:50,37,77,-40,
29958,290,2022/4/15 12:00,40,76,-36,
29959,290,2022/4/15 12:10,39,68,-29,
29960,290,2022/4/15 12:20,38,75,-37,
29961,290,2022/4/15 12:30,43,76,-33,
29962,290,2022/4/15 12:40,43,93,-50,
29963,290,2022/4/15 12:50,45,76,-31,
29964,290,2022/4/15 13:00,40,99,-59,
29965,290,2022/4/15 13:10,41,76,-35,
29966,290,2022/4/15 13:20,40,98,-58,
29967,290,2022/4/15 13:30,40,76,-36,
29968,290,2022/4/15 13:40,38,93,-55,
29969,290,2022/4/15 13:50,37,77,-40,
29970,290,2022/4/15 14:00,35,92,-57,
29971,290,2022/4/15 14:10,38,75,-37,
29972,290,2022/4/15 14:20,39,97,-58,
29973,290,2022/4/15 14:30,38,88,-50,
29974,290,2022/4/15 14:40,37,93,-56,
29975,290,2022/4/15 14:50,37,76,-39,
29976,290,2022/4/15 15:00,43,106,-63,
29977,290,2022/4/15 15:10,44,80,-36,
29978,290,2022/4/15 15:20,37,110,-73,
29979,290,2022/4/15 15:30,40,90,-50,
29980,290,2022/4/15 15:40,45,107,-62,
29981,290,2022/4/15 15:50,42,96,-54,
29982,290,2022/4/15 16:00,44,108,-64,
29983,290,2022/4/15 16:10,53,110,-57,
29984,290,2022/4/15 16:20,45,110,-65,
29985,290,2022/4/15 16:30,85,110,-25,
29986,290,2022/4/15 16:40,177,119,58,
29987,290,2022/4/15 16:50,133,101,32,
29988,290,2022/4/15 17:00,235,109,126,
29989,290,2022/4/15 17:10,265,116,149,
29990,290,2022/4/15 17:20,208,151,57,
29991,290,2022/4/15 17:30,206,178,28,
29992,290,2022/4/15 17:40,238,224,14,
29993,290,2022/4/15 17:50,175,196,-21,
29994,290,2022/4/15 18:00,177,219,-42,
29995,290,2022/4/15 18:10,205,198,7,
29996,290,2022/4/15 18:20,136,198,-62,
29997,290,2022/4/15 18:30,68,198,-130,
29998,290,2022/4/15 18:40,66,209,-143,
29999,290,2022/4/15 18:50,46,180,-134,
30000,290,2022/4/15 19:00,47,152,-105,
30001,290,2022/4/15 19:10,49,109,-60,
30002,290,2022/4/15 19:20,40,106,-66,
30003,290,2022/4/15 19:30,37,128,-91,
30004,290,2022/4/15 19:40,39,118,-79,
30005,290,2022/4/15 19:50,33,110,-77,
30006,290,2022/4/15 20:00,34,107,-73,
30007,290,2022/4/15 20:10,39,110,-71,
30008,290,2022/4/15 20:20,32,113,-81,
30009,290,2022/4/15 20:30,25,113,-88,
30010,290,2022/4/15 20:40,28,111,-83,
30011,290,2022/4/15 20:50,29,105,-76,
30012,290,2022/4/15 21:00,28,103,-75,
30013,290,2022/4/15 21:10,27,112,-85,
30014,290,2022/4/15 21:20,29,103,-74,
30015,290,2022/4/15 21:30,30,103,-73,
30016,290,2022/4/15 21:40,28,118,-90,
30017,290,2022/4/15 21:50,23,111,-88,
30018,290,2022/4/15 22:00,23,105,-82,
30019,290,2022/4/15 22:10,24,107,-83,
30020,290,2022/4/15 22:20,13,106,-93,
30021,290,2022/4/15 22:30,14,108,-94,
30022,290,2022/4/15 22:40,8,85,-77,
30023,290,2022/4/15 22:50,4,62,-58,
30024,283,2022/4/15 5:00,0,1,-1,
30025,283,2022/4/15 5:10,0,1,-1,
30026,283,2022/4/15 5:20,3,1,2,
30027,283,2022/4/15 5:30,7,1,6,
30028,283,2022/4/15 5:40,24,1,23,
30029,283,2022/4/15 5:50,26,21,5,
30030,283,2022/4/15 6:00,35,13,22,
30031,283,2022/4/15 6:10,45,47,-2,
30032,283,2022/4/15 6:20,57,38,19,
30033,283,2022/4/15 6:30,77,42,35,
30034,283,2022/4/15 6:40,163,68,95,
30035,283,2022/4/15 6:50,195,93,102,
30036,283,2022/4/15 7:00,273,103,170,
30037,283,2022/4/15 7:10,277,108,169,
30038,283,2022/4/15 7:20,342,102,240,
30039,283,2022/4/15 7:30,576,110,466,
30040,283,2022/4/15 7:40,633,125,508,
30041,283,2022/4/15 7:50,733,147,586,
30042,283,2022/4/15 8:00,827,220,607,
30043,283,2022/4/15 8:10,864,332,532,
30044,283,2022/4/15 8:20,730,253,477,
30045,283,2022/4/15 8:30,655,324,331,
30046,283,2022/4/15 8:40,592,324,268,
30047,283,2022/4/15 8:50,393,318,75,
30048,283,2022/4/15 9:00,341,227,114,
30049,283,2022/4/15 9:10,262,180,82,
30050,283,2022/4/15 9:20,227,179,48,
30051,283,2022/4/15 9:30,189,120,69,
30052,283,2022/4/15 9:40,157,110,47,
30053,283,2022/4/15 9:50,147,110,37,
30054,283,2022/4/15 10:00,114,86,28,
30055,283,2022/4/15 10:10,76,108,-32,
30056,283,2022/4/15 10:20,75,93,-18,
30057,283,2022/4/15 10:30,66,112,-46,
30058,283,2022/4/15 10:40,62,79,-17,
30059,283,2022/4/15 10:50,59,111,-52,
30060,283,2022/4/15 11:00,57,77,-20,
30061,283,2022/4/15 11:10,61,106,-45,
30062,283,2022/4/15 11:20,54,76,-22,
30063,283,2022/4/15 11:30,63,104,-41,
30064,283,2022/4/15 11:40,54,75,-21,
30065,283,2022/4/15 11:50,52,106,-54,
30066,283,2022/4/15 12:00,55,77,-22,
30067,283,2022/4/15 12:10,58,108,-50,
30068,283,2022/4/15 12:20,63,92,-29,
30069,283,2022/4/15 12:30,69,106,-37,
30070,283,2022/4/15 12:40,62,97,-35,
30071,283,2022/4/15 12:50,64,119,-55,
30072,283,2022/4/15 13:00,75,100,-25,
30073,283,2022/4/15 13:10,76,118,-42,
30074,283,2022/4/15 13:20,62,105,-43,
30075,283,2022/4/15 13:30,77,127,-50,
30076,283,2022/4/15 13:40,69,93,-24,
30077,283,2022/4/15 13:50,65,107,-42,
30078,283,2022/4/15 14:00,57,105,-48,
30079,283,2022/4/15 14:10,52,104,-52,
30080,283,2022/4/15 14:20,62,109,-47,
30081,283,2022/4/15 14:30,69,123,-54,
30082,283,2022/4/15 14:40,51,109,-58,
30083,283,2022/4/15 14:50,59,124,-65,
30084,283,2022/4/15 15:00,70,102,-32,
30085,283,2022/4/15 15:10,74,121,-47,
30086,283,2022/4/15 15:20,73,112,-39,
30087,283,2022/4/15 15:30,79,120,-41,
30088,283,2022/4/15 15:40,75,110,-35,
30089,283,2022/4/15 15:50,63,121,-58,
30090,283,2022/4/15 16:00,74,102,-28,
30091,283,2022/4/15 16:10,76,114,-38,
30092,283,2022/4/15 16:20,80,105,-25,
30093,283,2022/4/15 16:30,209,108,101,
30094,283,2022/4/15 16:40,190,120,70,
30095,283,2022/4/15 16:50,177,117,60,
30096,283,2022/4/15 17:00,269,131,138,
30097,283,2022/4/15 17:10,272,177,95,
30098,283,2022/4/15 17:20,234,231,3,
30099,283,2022/4/15 17:30,270,232,38,
30100,283,2022/4/15 17:40,339,298,41,
30101,283,2022/4/15 17:50,243,322,-79,
30102,283,2022/4/15 18:00,216,326,-110,
30103,283,2022/4/15 18:10,262,348,-86,
30104,283,2022/4/15 18:20,208,335,-127,
30105,283,2022/4/15 18:30,157,336,-179,
30106,283,2022/4/15 18:40,149,326,-177,
30107,283,2022/4/15 18:50,84,327,-243,
30108,283,2022/4/15 19:00,85,285,-200,
30109,283,2022/4/15 19:10,65,180,-115,
30110,283,2022/4/15 19:20,54,152,-98,
30111,283,2022/4/15 19:30,48,119,-71,
30112,283,2022/4/15 19:40,42,107,-65,
30113,283,2022/4/15 19:50,35,124,-89,
30114,283,2022/4/15 20:00,35,129,-94,
30115,283,2022/4/15 20:10,32,117,-85,
30116,283,2022/4/15 20:20,28,122,-94,
30117,283,2022/4/15 20:30,29,119,-90,
30118,283,2022/4/15 20:40,35,124,-89,
30119,283,2022/4/15 20:50,27,128,-101,
30120,283,2022/4/15 21:00,33,101,-68,
30121,283,2022/4/15 21:10,30,110,-80,
30122,283,2022/4/15 21:20,29,115,-86,
30123,283,2022/4/15 21:30,28,121,-93,
30124,283,2022/4/15 21:40,27,99,-72,
30125,283,2022/4/15 21:50,28,105,-77,
30126,283,2022/4/15 22:00,28,99,-71,
30127,283,2022/4/15 22:10,25,112,-87,
30128,283,2022/4/15 22:20,22,108,-86,
30129,283,2022/4/15 22:30,14,107,-93,
30130,283,2022/4/15 22:40,14,83,-69,
30131,283,2022/4/15 22:50,4,70,-66,
30132,265,2022/4/15 5:00,0,1,-1,
30133,265,2022/4/15 5:10,0,1,-1,
30134,265,2022/4/15 5:20,3,1,2,
30135,265,2022/4/15 5:30,8,1,7,
30136,265,2022/4/15 5:40,22,1,21,
30137,265,2022/4/15 5:50,24,11,13,
30138,265,2022/4/15 6:00,35,8,27,
30139,265,2022/4/15 6:10,36,45,-9,
30140,265,2022/4/15 6:20,47,47,0,
30141,265,2022/4/15 6:30,66,62,4,
30142,265,2022/4/15 6:40,146,69,77,
30143,265,2022/4/15 6:50,164,75,89,
30144,265,2022/4/15 7:00,218,88,130,
30145,265,2022/4/15 7:10,246,111,135,
30146,265,2022/4/15 7:20,280,107,173,
30147,265,2022/4/15 7:30,439,107,332,
30148,265,2022/4/15 7:40,599,128,471,
30149,265,2022/4/15 7:50,691,154,537,
30150,265,2022/4/15 8:00,741,281,460,
30151,265,2022/4/15 8:10,828,535,293,
30152,265,2022/4/15 8:20,694,507,187,
30153,265,2022/4/15 8:30,724,426,298,
30154,265,2022/4/15 8:40,574,1186,-612,
30155,265,2022/4/15 8:50,383,479,-96,
30156,265,2022/4/15 9:00,313,508,-195,
30157,265,2022/4/15 9:10,276,377,-101,
30158,265,2022/4/15 9:20,225,332,-107,
30159,265,2022/4/15 9:30,201,211,-10,
30160,265,2022/4/15 9:40,144,224,-80,
30161,265,2022/4/15 9:50,90,144,-54,
30162,265,2022/4/15 10:00,94,179,-85,
30163,265,2022/4/15 10:10,74,119,-45,
30164,265,2022/4/15 10:20,72,111,-39,
30165,265,2022/4/15 10:30,71,122,-51,
30166,265,2022/4/15 10:40,69,128,-59,
30167,265,2022/4/15 10:50,70,105,-35,
30168,265,2022/4/15 11:00,71,111,-40,
30169,265,2022/4/15 11:10,70,111,-41,
30170,265,2022/4/15 11:20,65,153,-88,
30171,265,2022/4/15 11:30,76,125,-49,
30172,265,2022/4/15 11:40,76,159,-83,
30173,265,2022/4/15 11:50,70,120,-50,
30174,265,2022/4/15 12:00,127,181,-54,
30175,265,2022/4/15 12:10,157,128,29,
30176,265,2022/4/15 12:20,169,152,17,
30177,265,2022/4/15 12:30,198,121,77,
30178,265,2022/4/15 12:40,185,180,5,
30179,265,2022/4/15 12:50,186,128,58,
30180,265,2022/4/15 13:00,206,145,61,
30181,265,2022/4/15 13:10,207,121,86,
30182,265,2022/4/15 13:20,214,145,69,
30183,265,2022/4/15 13:30,205,109,96,
30184,265,2022/4/15 13:40,175,146,29,
30185,265,2022/4/15 13:50,174,119,55,
30186,265,2022/4/15 14:00,176,128,48,
30187,265,2022/4/15 14:10,178,108,70,
30188,265,2022/4/15 14:20,175,150,25,
30189,265,2022/4/15 14:30,176,108,68,
30190,265,2022/4/15 14:40,177,117,60,
30191,265,2022/4/15 14:50,175,133,42,
30192,265,2022/4/15 15:00,180,185,-5,
30193,265,2022/4/15 15:10,180,132,48,
30194,265,2022/4/15 15:20,202,198,4,
30195,265,2022/4/15 15:30,195,169,26,
30196,265,2022/4/15 15:40,201,213,-12,
30197,265,2022/4/15 15:50,193,154,39,
30198,265,2022/4/15 16:00,221,195,26,
30199,265,2022/4/15 16:10,236,192,44,
30200,265,2022/4/15 16:20,256,267,-11,
30201,265,2022/4/15 16:30,271,197,74,
30202,265,2022/4/15 16:40,285,269,16,
30203,265,2022/4/15 16:50,271,319,-48,
30204,265,2022/4/15 17:00,548,375,173,
30205,265,2022/4/15 17:10,699,429,270,
30206,265,2022/4/15 17:20,579,412,167,
30207,265,2022/4/15 17:30,650,422,228,
30208,265,2022/4/15 17:40,792,474,318,
30209,265,2022/4/15 17:50,610,571,39,
30210,265,2022/4/15 18:00,677,614,63,
30211,265,2022/4/15 18:10,831,608,223,
30212,265,2022/4/15 18:20,641,610,31,
30213,265,2022/4/15 18:30,573,609,-36,
30214,265,2022/4/15 18:40,546,611,-65,
30215,265,2022/4/15 18:50,312,566,-254,
30216,265,2022/4/15 19:00,328,416,-88,
30217,265,2022/4/15 19:10,347,504,-157,
30218,265,2022/4/15 19:20,315,335,-20,
30219,265,2022/4/15 19:30,290,321,-31,
30220,265,2022/4/15 19:40,266,218,48,
30221,265,2022/4/15 19:50,284,179,105,
30222,265,2022/4/15 20:00,316,169,147,
30223,265,2022/4/15 20:10,349,109,240,
30224,265,2022/4/15 20:20,308,129,179,
30225,265,2022/4/15 20:30,334,121,213,
30226,265,2022/4/15 20:40,349,110,239,
30227,265,2022/4/15 20:50,335,110,225,
30228,265,2022/4/15 21:00,350,119,231,
30229,265,2022/4/15 21:10,358,120,238,
30230,265,2022/4/15 21:20,289,121,168,
30231,265,2022/4/15 21:30,264,124,140,
30232,265,2022/4/15 21:40,268,109,159,
30233,265,2022/4/15 21:50,192,106,86,
30234,265,2022/4/15 22:00,86,103,-17,
30235,265,2022/4/15 22:10,58,111,-53,
30236,265,2022/4/15 22:20,32,111,-79,
30237,265,2022/4/15 22:30,22,106,-84,
30238,265,2022/4/15 22:40,18,98,-80,
30239,265,2022/4/15 22:50,8,75,-67,
30240,278,2022/4/15 5:00,0,1,-1,
30241,278,2022/4/15 5:10,0,1,-1,
30242,278,2022/4/15 5:20,3,1,2,
30243,278,2022/4/15 5:30,16,1,15,
30244,278,2022/4/15 5:40,26,1,25,
30245,278,2022/4/15 5:50,25,2,23,
30246,278,2022/4/15 6:00,31,6,25,
30247,278,2022/4/15 6:10,39,23,16,
30248,278,2022/4/15 6:20,57,25,32,
30249,278,2022/4/15 6:30,77,41,36,
30250,278,2022/4/15 6:40,194,63,131,
30251,278,2022/4/15 6:50,199,82,117,
30252,278,2022/4/15 7:00,255,100,155,
30253,278,2022/4/15 7:10,283,127,156,
30254,278,2022/4/15 7:20,369,107,262,
30255,278,2022/4/15 7:30,599,118,481,
30256,278,2022/4/15 7:40,702,107,595,
30257,278,2022/4/15 7:50,872,113,759,
30258,278,2022/4/15 8:00,1177,119,1058,
30259,278,2022/4/15 8:10,1177,139,1038,
30260,278,2022/4/15 8:20,1047,121,926,
30261,278,2022/4/15 8:30,815,121,694,
30262,278,2022/4/15 8:40,683,109,574,
30263,278,2022/4/15 8:50,591,109,482,
30264,278,2022/4/15 9:00,369,104,265,
30265,278,2022/4/15 9:10,324,112,212,
30266,278,2022/4/15 9:20,217,105,112,
30267,278,2022/4/15 9:30,180,91,89,
30268,278,2022/4/15 9:40,141,96,45,
30269,278,2022/4/15 9:50,78,78,0,
30270,278,2022/4/15 10:00,63,76,-13,
30271,278,2022/4/15 10:10,59,66,-7,
30272,278,2022/4/15 10:20,44,82,-38,
30273,278,2022/4/15 10:30,41,85,-44,
30274,278,2022/4/15 10:40,43,72,-29,
30275,278,2022/4/15 10:50,36,76,-40,
30276,278,2022/4/15 11:00,39,68,-29,
30277,278,2022/4/15 11:10,39,67,-28,
30278,278,2022/4/15 11:20,37,73,-36,
30279,278,2022/4/15 11:30,37,82,-45,
30280,278,2022/4/15 11:40,44,86,-42,
30281,278,2022/4/15 11:50,37,75,-38,
30282,278,2022/4/15 12:00,41,69,-28,
30283,278,2022/4/15 12:10,48,76,-28,
30284,278,2022/4/15 12:20,42,77,-35,
30285,278,2022/4/15 12:30,47,83,-36,
30286,278,2022/4/15 12:40,44,90,-46,
30287,278,2022/4/15 12:50,44,93,-49,
30288,278,2022/4/15 13:00,41,79,-38,
30289,278,2022/4/15 13:10,48,97,-49,
30290,278,2022/4/15 13:20,43,97,-54,
30291,278,2022/4/15 13:30,43,90,-47,
30292,278,2022/4/15 13:40,37,93,-56,
30293,278,2022/4/15 13:50,37,93,-56,
30294,278,2022/4/15 14:00,41,93,-52,
30295,278,2022/4/15 14:10,35,90,-55,
30296,278,2022/4/15 14:20,37,93,-56,
30297,278,2022/4/15 14:30,40,88,-48,
30298,278,2022/4/15 14:40,40,97,-57,
30299,278,2022/4/15 14:50,38,99,-61,
30300,278,2022/4/15 15:00,40,96,-56,
30301,278,2022/4/15 15:10,58,104,-46,
30302,278,2022/4/15 15:20,43,105,-62,
30303,278,2022/4/15 15:30,43,105,-62,
30304,278,2022/4/15 15:40,47,103,-56,
30305,278,2022/4/15 15:50,44,100,-56,
30306,278,2022/4/15 16:00,73,105,-32,
30307,278,2022/4/15 16:10,76,126,-50,
30308,278,2022/4/15 16:20,70,119,-49,
30309,278,2022/4/15 16:30,92,117,-25,
30310,278,2022/4/15 16:40,114,114,0,
30311,278,2022/4/15 16:50,89,133,-44,
30312,278,2022/4/15 17:00,158,115,43,
30313,278,2022/4/15 17:10,218,177,41,
30314,278,2022/4/15 17:20,195,215,-20,
30315,278,2022/4/15 17:30,157,297,-140,
30316,278,2022/4/15 17:40,198,332,-134,
30317,278,2022/4/15 17:50,176,345,-169,
30318,278,2022/4/15 18:00,98,380,-282,
30319,278,2022/4/15 18:10,130,379,-249,
30320,278,2022/4/15 18:20,72,386,-314,
30321,278,2022/4/15 18:30,56,527,-471,
30322,278,2022/4/15 18:40,56,382,-326,
30323,278,2022/4/15 18:50,41,519,-478,
30324,278,2022/4/15 19:00,40,336,-296,
30325,278,2022/4/15 19:10,43,301,-258,
30326,278,2022/4/15 19:20,34,214,-180,
30327,278,2022/4/15 19:30,31,153,-122,
30328,278,2022/4/15 19:40,31,128,-97,
30329,278,2022/4/15 19:50,34,116,-82,
30330,278,2022/4/15 20:00,28,111,-83,
30331,278,2022/4/15 20:10,32,110,-78,
30332,278,2022/4/15 20:20,27,104,-77,
30333,278,2022/4/15 20:30,29,109,-80,
30334,278,2022/4/15 20:40,26,120,-94,
30335,278,2022/4/15 20:50,27,125,-98,
30336,278,2022/4/15 21:00,31,119,-88,
30337,278,2022/4/15 21:10,29,117,-88,
30338,278,2022/4/15 21:20,23,122,-99,
30339,278,2022/4/15 21:30,24,116,-92,
30340,278,2022/4/15 21:40,24,122,-98,
30341,278,2022/4/15 21:50,20,88,-68,
30342,278,2022/4/15 22:00,16,99,-83,
30343,278,2022/4/15 22:10,16,112,-96,
30344,278,2022/4/15 22:20,13,107,-94,
30345,278,2022/4/15 22:30,12,102,-90,
30346,278,2022/4/15 22:40,6,95,-89,
30347,278,2022/4/15 22:50,2,71,-69,
30348,282,2022/4/15 5:00,0,1,-1,
30349,282,2022/4/15 5:10,2,1,1,
30350,282,2022/4/15 5:20,5,1,4,
30351,282,2022/4/15 5:30,16,1,15,
30352,282,2022/4/15 5:40,19,1,18,
30353,282,2022/4/15 5:50,21,6,15,
30354,282,2022/4/15 6:00,30,5,25,
30355,282,2022/4/15 6:10,35,16,19,
30356,282,2022/4/15 6:20,38,35,3,
30357,282,2022/4/15 6:30,49,51,-2,
30358,282,2022/4/15 6:40,76,68,8,
30359,282,2022/4/15 6:50,94,108,-14,
30360,282,2022/4/15 7:00,156,193,-37,
30361,282,2022/4/15 7:10,197,119,78,
30362,282,2022/4/15 7:20,235,104,131,
30363,282,2022/4/15 7:30,278,121,157,
30364,282,2022/4/15 7:40,325,122,203,
30365,282,2022/4/15 7:50,575,124,451,
30366,282,2022/4/15 8:00,632,181,451,
30367,282,2022/4/15 8:10,723,215,508,
30368,282,2022/4/15 8:20,655,296,359,
30369,282,2022/4/15 8:30,601,332,269,
30370,282,2022/4/15 8:40,369,421,-52,
30371,282,2022/4/15 8:50,280,509,-229,
30372,282,2022/4/15 9:00,227,299,-72,
30373,282,2022/4/15 9:10,209,197,12,
30374,282,2022/4/15 9:20,167,185,-18,
30375,282,2022/4/15 9:30,107,109,-2,
30376,282,2022/4/15 9:40,67,123,-56,
30377,282,2022/4/15 9:50,56,106,-50,
30378,282,2022/4/15 10:00,46,105,-59,
30379,282,2022/4/15 10:10,45,96,-51,
30380,282,2022/4/15 10:20,45,97,-52,
30381,282,2022/4/15 10:30,43,93,-50,
30382,282,2022/4/15 10:40,41,81,-40,
30383,282,2022/4/15 10:50,38,80,-42,
30384,282,2022/4/15 11:00,33,77,-44,
30385,282,2022/4/15 11:10,35,76,-41,
30386,282,2022/4/15 11:20,36,75,-39,
30387,282,2022/4/15 11:30,39,77,-38,
30388,282,2022/4/15 11:40,41,72,-31,
30389,282,2022/4/15 11:50,45,91,-46,
30390,282,2022/4/15 12:00,43,76,-33,
30391,282,2022/4/15 12:10,54,81,-27,
30392,282,2022/4/15 12:20,45,84,-39,
30393,282,2022/4/15 12:30,44,93,-49,
30394,282,2022/4/15 12:40,42,104,-62,
30395,282,2022/4/15 12:50,47,113,-66,
30396,282,2022/4/15 13:00,48,105,-57,
30397,282,2022/4/15 13:10,46,101,-55,
30398,282,2022/4/15 13:20,44,105,-61,
30399,282,2022/4/15 13:30,45,98,-53,
30400,282,2022/4/15 13:40,44,93,-49,
30401,282,2022/4/15 13:50,44,96,-52,
30402,282,2022/4/15 14:00,42,94,-52,
30403,282,2022/4/15 14:10,41,97,-56,
30404,282,2022/4/15 14:20,36,81,-45,
30405,282,2022/4/15 14:30,44,93,-49,
30406,282,2022/4/15 14:40,39,90,-51,
30407,282,2022/4/15 14:50,41,92,-51,
30408,282,2022/4/15 15:00,50,93,-43,
30409,282,2022/4/15 15:10,118,100,18,
30410,282,2022/4/15 15:20,66,100,-34,
30411,282,2022/4/15 15:30,59,99,-40,
30412,282,2022/4/15 15:40,66,104,-38,
30413,282,2022/4/15 15:50,81,109,-28,
30414,282,2022/4/15 16:00,170,100,70,
30415,282,2022/4/15 16:10,140,104,36,
30416,282,2022/4/15 16:20,78,108,-30,
30417,282,2022/4/15 16:30,136,87,49,
30418,282,2022/4/15 16:40,191,97,94,
30419,282,2022/4/15 16:50,228,118,110,
30420,282,2022/4/15 17:00,333,121,212,
30421,282,2022/4/15 17:10,336,108,228,
30422,282,2022/4/15 17:20,223,149,74,
30423,282,2022/4/15 17:30,270,191,79,
30424,282,2022/4/15 17:40,579,179,400,
30425,282,2022/4/15 17:50,292,255,37,
30426,282,2022/4/15 18:00,308,283,25,
30427,282,2022/4/15 18:10,377,284,93,
30428,282,2022/4/15 18:20,265,300,-35,
30429,282,2022/4/15 18:30,189,270,-81,
30430,282,2022/4/15 18:40,177,284,-107,
30431,282,2022/4/15 18:50,134,234,-100,
30432,282,2022/4/15 19:00,68,178,-110,
30433,282,2022/4/15 19:10,60,170,-110,
30434,282,2022/4/15 19:20,48,121,-73,
30435,282,2022/4/15 19:30,44,109,-65,
30436,282,2022/4/15 19:40,42,118,-76,
30437,282,2022/4/15 19:50,43,106,-63,
30438,282,2022/4/15 20:00,39,110,-71,
30439,282,2022/4/15 20:10,41,102,-61,
30440,282,2022/4/15 20:20,36,104,-68,
30441,282,2022/4/15 20:30,41,100,-59,
30442,282,2022/4/15 20:40,46,104,-58,
30443,282,2022/4/15 20:50,46,97,-51,
30444,282,2022/4/15 21:00,38,108,-70,
30445,282,2022/4/15 21:10,41,104,-63,
30446,282,2022/4/15 21:20,39,112,-73,
30447,282,2022/4/15 21:30,35,103,-68,
30448,282,2022/4/15 21:40,30,93,-63,
30449,282,2022/4/15 21:50,28,102,-74,
30450,282,2022/4/15 22:00,24,85,-61,
30451,282,2022/4/15 22:10,22,96,-74,
30452,282,2022/4/15 22:20,19,92,-73,
30453,282,2022/4/15 22:30,13,78,-65,
30454,282,2022/4/15 22:40,6,66,-60,
30455,282,2022/4/15 22:50,3,72,-69,
30456,262,2022/4/15 5:00,0,1,-1,
30457,262,2022/4/15 5:10,0,1,-1,
30458,262,2022/4/15 5:20,8,1,7,
30459,262,2022/4/15 5:30,21,1,20,
30460,262,2022/4/15 5:40,22,2,20,
30461,262,2022/4/15 5:50,20,6,14,
30462,262,2022/4/15 6:00,27,6,21,
30463,262,2022/4/15 6:10,41,6,35,
30464,262,2022/4/15 6:20,54,40,14,
30465,262,2022/4/15 6:30,75,23,52,
30466,262,2022/4/15 6:40,91,32,59,
30467,262,2022/4/15 6:50,108,68,40,
30468,262,2022/4/15 7:00,187,67,120,
30469,262,2022/4/15 7:10,187,112,75,
30470,262,2022/4/15 7:20,241,90,151,
30471,262,2022/4/15 7:30,302,79,223,
30472,262,2022/4/15 7:40,349,104,245,
30473,262,2022/4/15 7:50,368,112,256,
30474,262,2022/4/15 8:00,575,98,477,
30475,262,2022/4/15 8:10,445,109,336,
30476,262,2022/4/15 8:20,327,110,217,
30477,262,2022/4/15 8:30,344,109,235,
30478,262,2022/4/15 8:40,282,151,131,
30479,262,2022/4/15 8:50,232,108,124,
30480,262,2022/4/15 9:00,177,107,70,
30481,262,2022/4/15 9:10,138,102,36,
30482,262,2022/4/15 9:20,79,108,-29,
30483,262,2022/4/15 9:30,63,91,-28,
30484,262,2022/4/15 9:40,50,88,-38,
30485,262,2022/4/15 9:50,45,85,-40,
30486,262,2022/4/15 10:00,36,69,-33,
30487,262,2022/4/15 10:10,36,78,-42,
30488,262,2022/4/15 10:20,34,72,-38,
30489,262,2022/4/15 10:30,32,62,-30,
30490,262,2022/4/15 10:40,33,67,-34,
30491,262,2022/4/15 10:50,31,66,-35,
30492,262,2022/4/15 11:00,33,73,-40,
30493,262,2022/4/15 11:10,35,72,-37,
30494,262,2022/4/15 11:20,28,69,-41,
30495,262,2022/4/15 11:30,31,70,-39,
30496,262,2022/4/15 11:40,29,68,-39,
30497,262,2022/4/15 11:50,32,68,-36,
30498,262,2022/4/15 12:00,31,65,-34,
30499,262,2022/4/15 12:10,31,65,-34,
30500,262,2022/4/15 12:20,39,70,-31,
30501,262,2022/4/15 12:30,32,81,-49,
30502,262,2022/4/15 12:40,35,72,-37,
30503,262,2022/4/15 12:50,36,81,-45,
30504,262,2022/4/15 13:00,37,84,-47,
30505,262,2022/4/15 13:10,36,83,-47,
30506,262,2022/4/15 13:20,31,75,-44,
30507,262,2022/4/15 13:30,35,74,-39,
30508,262,2022/4/15 13:40,32,79,-47,
30509,262,2022/4/15 13:50,29,75,-46,
30510,262,2022/4/15 14:00,32,80,-48,
30511,262,2022/4/15 14:10,27,77,-50,
30512,262,2022/4/15 14:20,29,73,-44,
30513,262,2022/4/15 14:30,31,72,-41,
30514,262,2022/4/15 14:40,31,83,-52,
30515,262,2022/4/15 14:50,25,78,-53,
30516,262,2022/4/15 15:00,33,91,-58,
30517,262,2022/4/15 15:10,34,90,-56,
30518,262,2022/4/15 15:20,28,96,-68,
30519,262,2022/4/15 15:30,28,102,-74,
30520,262,2022/4/15 15:40,30,108,-78,
30521,262,2022/4/15 15:50,29,104,-75,
30522,262,2022/4/15 16:00,32,103,-71,
30523,262,2022/4/15 16:10,35,111,-76,
30524,262,2022/4/15 16:20,40,96,-56,
30525,262,2022/4/15 16:30,44,107,-63,
30526,262,2022/4/15 16:40,58,119,-61,
30527,262,2022/4/15 16:50,60,115,-55,
30528,262,2022/4/15 17:00,130,116,14,
30529,262,2022/4/15 17:10,156,118,38,
30530,262,2022/4/15 17:20,77,181,-104,
30531,262,2022/4/15 17:30,86,180,-94,
30532,262,2022/4/15 17:40,142,179,-37,
30533,262,2022/4/15 17:50,93,217,-124,
30534,262,2022/4/15 18:00,71,198,-127,
30535,262,2022/4/15 18:10,102,198,-96,
30536,262,2022/4/15 18:20,77,222,-145,
30537,262,2022/4/15 18:30,53,235,-182,
30538,262,2022/4/15 18:40,46,224,-178,
30539,262,2022/4/15 18:50,37,209,-172,
30540,262,2022/4/15 19:00,34,192,-158,
30541,262,2022/4/15 19:10,35,109,-74,
30542,262,2022/4/15 19:20,33,109,-76,
30543,262,2022/4/15 19:30,26,105,-79,
30544,262,2022/4/15 19:40,33,106,-73,
30545,262,2022/4/15 19:50,29,108,-79,
30546,262,2022/4/15 20:00,35,105,-70,
30547,262,2022/4/15 20:10,24,104,-80,
30548,262,2022/4/15 20:20,28,92,-64,
30549,262,2022/4/15 20:30,29,106,-77,
30550,262,2022/4/15 20:40,24,111,-87,
30551,262,2022/4/15 20:50,23,115,-92,
30552,262,2022/4/15 21:00,31,102,-71,
30553,262,2022/4/15 21:10,25,105,-80,
30554,262,2022/4/15 21:20,25,116,-91,
30555,262,2022/4/15 21:30,34,106,-72,
30556,262,2022/4/15 21:40,24,105,-81,
30557,262,2022/4/15 21:50,16,95,-79,
30558,262,2022/4/15 22:00,16,101,-85,
30559,262,2022/4/15 22:10,17,110,-93,
30560,262,2022/4/15 22:20,12,83,-71,
30561,262,2022/4/15 22:30,8,93,-85,
30562,262,2022/4/15 22:40,5,71,-66,
30563,262,2022/4/15 22:50,1,63,-62,
30564,268,2022/4/15 5:00,0,1,-1,
30565,268,2022/4/15 5:10,1,1,0,
30566,268,2022/4/15 5:20,8,1,7,
30567,268,2022/4/15 5:30,28,1,27,
30568,268,2022/4/15 5:40,22,21,1,
30569,268,2022/4/15 5:50,30,13,17,
30570,268,2022/4/15 6:00,39,13,26,
30571,268,2022/4/15 6:10,45,21,24,
30572,268,2022/4/15 6:20,56,60,-4,
30573,268,2022/4/15 6:30,74,68,6,
30574,268,2022/4/15 6:40,83,105,-22,
30575,268,2022/4/15 6:50,113,106,7,
30576,268,2022/4/15 7:00,158,125,33,
30577,268,2022/4/15 7:10,195,153,42,
30578,268,2022/4/15 7:20,239,146,93,
30579,268,2022/4/15 7:30,280,328,-48,
30580,268,2022/4/15 7:40,302,327,-25,
30581,268,2022/4/15 7:50,368,320,48,
30582,268,2022/4/15 8:00,477,179,298,
30583,268,2022/4/15 8:10,568,225,343,
30584,268,2022/4/15 8:20,387,225,162,
30585,268,2022/4/15 8:30,337,255,82,
30586,268,2022/4/15 8:40,277,333,-56,
30587,268,2022/4/15 8:50,260,217,43,
30588,268,2022/4/15 9:00,225,180,45,
30589,268,2022/4/15 9:10,177,139,38,
30590,268,2022/4/15 9:20,162,108,54,
30591,268,2022/4/15 9:30,139,117,22,
30592,268,2022/4/15 9:40,116,115,1,
30593,268,2022/4/15 9:50,90,118,-28,
30594,268,2022/4/15 10:00,73,120,-47,
30595,268,2022/4/15 10:10,82,125,-43,
30596,268,2022/4/15 10:20,70,110,-40,
30597,268,2022/4/15 10:30,75,104,-29,
30598,268,2022/4/15 10:40,72,99,-27,
30599,268,2022/4/15 10:50,67,106,-39,
30600,268,2022/4/15 11:00,67,92,-25,
30601,268,2022/4/15 11:10,66,93,-27,
30602,268,2022/4/15 11:20,69,77,-8,
30603,268,2022/4/15 11:30,65,102,-37,
30604,268,2022/4/15 11:40,69,81,-12,
30605,268,2022/4/15 11:50,65,90,-25,
30606,268,2022/4/15 12:00,61,83,-22,
30607,268,2022/4/15 12:10,69,95,-26,
30608,268,2022/4/15 12:20,56,87,-31,
30609,268,2022/4/15 12:30,54,102,-48,
30610,268,2022/4/15 12:40,45,99,-54,
30611,268,2022/4/15 12:50,47,115,-68,
30612,268,2022/4/15 13:00,44,102,-58,
30613,268,2022/4/15 13:10,47,122,-75,
30614,268,2022/4/15 13:20,47,106,-59,
30615,268,2022/4/15 13:30,48,112,-64,
30616,268,2022/4/15 13:40,60,110,-50,
30617,268,2022/4/15 13:50,62,107,-45,
30618,268,2022/4/15 14:00,69,100,-31,
30619,268,2022/4/15 14:10,74,87,-13,
30620,268,2022/4/15 14:20,80,107,-27,
30621,268,2022/4/15 14:30,70,106,-36,
30622,268,2022/4/15 14:40,70,109,-39,
30623,268,2022/4/15 14:50,83,86,-3,
30624,268,2022/4/15 15:00,77,108,-31,
30625,268,2022/4/15 15:10,73,109,-36,
30626,268,2022/4/15 15:20,74,102,-28,
30627,268,2022/4/15 15:30,75,114,-39,
30628,268,2022/4/15 15:40,77,109,-32,
30629,268,2022/4/15 15:50,93,100,-7,
30630,268,2022/4/15 16:00,133,105,28,
30631,268,2022/4/15 16:10,139,115,24,
30632,268,2022/4/15 16:20,164,108,56,
30633,268,2022/4/15 16:30,257,114,143,
30634,268,2022/4/15 16:40,213,108,105,
30635,268,2022/4/15 16:50,191,121,70,
30636,268,2022/4/15 17:00,222,118,104,
30637,268,2022/4/15 17:10,247,103,144,
30638,268,2022/4/15 17:20,206,116,90,
30639,268,2022/4/15 17:30,227,108,119,
30640,268,2022/4/15 17:40,238,153,85,
30641,268,2022/4/15 17:50,164,159,5,
30642,268,2022/4/15 18:00,177,213,-36,
30643,268,2022/4/15 18:10,199,180,19,
30644,268,2022/4/15 18:20,141,178,-37,
30645,268,2022/4/15 18:30,70,191,-121,
30646,268,2022/4/15 18:40,57,159,-102,
30647,268,2022/4/15 18:50,44,192,-148,
30648,268,2022/4/15 19:00,45,139,-94,
30649,268,2022/4/15 19:10,42,107,-65,
30650,268,2022/4/15 19:20,39,113,-74,
30651,268,2022/4/15 19:30,40,108,-68,
30652,268,2022/4/15 19:40,36,104,-68,
30653,268,2022/4/15 19:50,30,110,-80,
30654,268,2022/4/15 20:00,32,102,-70,
30655,268,2022/4/15 20:10,35,101,-66,
30656,268,2022/4/15 20:20,35,100,-65,
30657,268,2022/4/15 20:30,30,92,-62,
30658,268,2022/4/15 20:40,28,95,-67,
30659,268,2022/4/15 20:50,28,91,-63,
30660,268,2022/4/15 21:00,35,113,-78,
30661,268,2022/4/15 21:10,36,99,-63,
30662,268,2022/4/15 21:20,27,97,-70,
30663,268,2022/4/15 21:30,24,92,-68,
30664,268,2022/4/15 21:40,24,104,-80,
30665,268,2022/4/15 21:50,20,91,-71,
30666,268,2022/4/15 22:00,21,78,-57,
30667,268,2022/4/15 22:10,17,77,-60,
30668,268,2022/4/15 22:20,12,75,-63,
30669,268,2022/4/15 22:30,10,94,-84,
30670,268,2022/4/15 22:40,4,78,-74,
30671,268,2022/4/15 22:50,1,73,-72,
30672,267,2022/4/15 5:00,0,1,-1,
30673,267,2022/4/15 5:10,1,1,0,
30674,267,2022/4/15 5:20,16,1,15,
30675,267,2022/4/15 5:30,32,1,31,
30676,267,2022/4/15 5:40,31,2,29,
30677,267,2022/4/15 5:50,35,5,30,
30678,267,2022/4/15 6:00,47,13,34,
30679,267,2022/4/15 6:10,57,11,46,
30680,267,2022/4/15 6:20,76,48,28,
30681,267,2022/4/15 6:30,174,59,115,
30682,267,2022/4/15 6:40,189,66,123,
30683,267,2022/4/15 6:50,239,96,143,
30684,267,2022/4/15 7:00,283,118,165,
30685,267,2022/4/15 7:10,279,110,169,
30686,267,2022/4/15 7:20,482,118,364,
30687,267,2022/4/15 7:30,666,105,561,
30688,267,2022/4/15 7:40,828,133,695,
30689,267,2022/4/15 7:50,861,106,755,
30690,267,2022/4/15 8:00,1049,109,940,
30691,267,2022/4/15 8:10,741,119,622,
30692,267,2022/4/15 8:20,740,117,623,
30693,267,2022/4/15 8:30,679,123,556,
30694,267,2022/4/15 8:40,602,126,476,
30695,267,2022/4/15 8:50,316,106,210,
30696,267,2022/4/15 9:00,278,101,177,
30697,267,2022/4/15 9:10,219,109,110,
30698,267,2022/4/15 9:20,179,93,86,
30699,267,2022/4/15 9:30,103,96,7,
30700,267,2022/4/15 9:40,74,93,-19,
30701,267,2022/4/15 9:50,76,77,-1,
30702,267,2022/4/15 10:00,57,76,-19,
30703,267,2022/4/15 10:10,47,81,-34,
30704,267,2022/4/15 10:20,46,75,-29,
30705,267,2022/4/15 10:30,42,74,-32,
30706,267,2022/4/15 10:40,38,76,-38,
30707,267,2022/4/15 10:50,39,76,-37,
30708,267,2022/4/15 11:00,41,75,-34,
30709,267,2022/4/15 11:10,43,73,-30,
30710,267,2022/4/15 11:20,40,77,-37,
30711,267,2022/4/15 11:30,37,77,-40,
30712,267,2022/4/15 11:40,41,80,-39,
30713,267,2022/4/15 11:50,42,78,-36,
30714,267,2022/4/15 12:00,46,85,-39,
30715,267,2022/4/15 12:10,54,88,-34,
30716,267,2022/4/15 12:20,45,85,-40,
30717,267,2022/4/15 12:30,47,76,-29,
30718,267,2022/4/15 12:40,46,96,-50,
30719,267,2022/4/15 12:50,43,93,-50,
30720,267,2022/4/15 13:00,45,95,-50,
30721,267,2022/4/15 13:10,47,96,-49,
30722,267,2022/4/15 13:20,41,100,-59,
30723,267,2022/4/15 13:30,43,90,-47,
30724,267,2022/4/15 13:40,44,104,-60,
30725,267,2022/4/15 13:50,41,99,-58,
30726,267,2022/4/15 14:00,36,102,-66,
30727,267,2022/4/15 14:10,40,87,-47,
30728,267,2022/4/15 14:20,35,99,-64,
30729,267,2022/4/15 14:30,35,105,-70,
30730,267,2022/4/15 14:40,39,105,-66,
30731,267,2022/4/15 14:50,38,108,-70,
30732,267,2022/4/15 15:00,37,102,-65,
30733,267,2022/4/15 15:10,49,113,-64,
30734,267,2022/4/15 15:20,58,96,-38,
30735,267,2022/4/15 15:30,62,104,-42,
30736,267,2022/4/15 15:40,55,107,-52,
30737,267,2022/4/15 15:50,43,125,-82,
30738,267,2022/4/15 16:00,53,109,-56,
30739,267,2022/4/15 16:10,58,107,-49,
30740,267,2022/4/15 16:20,88,109,-21,
30741,267,2022/4/15 16:30,129,123,6,
30742,267,2022/4/15 16:40,92,108,-16,
30743,267,2022/4/15 16:50,142,133,9,
30744,267,2022/4/15 17:00,205,143,62,
30745,267,2022/4/15 17:10,230,158,72,
30746,267,2022/4/15 17:20,176,178,-2,
30747,267,2022/4/15 17:30,177,221,-44,
30748,267,2022/4/15 17:40,170,298,-128,
30749,267,2022/4/15 17:50,115,333,-218,
30750,267,2022/4/15 18:00,101,336,-235,
30751,267,2022/4/15 18:10,87,326,-239,
30752,267,2022/4/15 18:20,61,324,-263,
30753,267,2022/4/15 18:30,49,347,-298,
30754,267,2022/4/15 18:40,46,347,-301,
30755,267,2022/4/15 18:50,32,337,-305,
30756,267,2022/4/15 19:00,37,337,-300,
30757,267,2022/4/15 19:10,35,284,-249,
30758,267,2022/4/15 19:20,24,222,-198,
30759,267,2022/4/15 19:30,28,160,-132,
30760,267,2022/4/15 19:40,28,111,-83,
30761,267,2022/4/15 19:50,29,119,-90,
30762,267,2022/4/15 20:00,27,111,-84,
30763,267,2022/4/15 20:10,30,125,-95,
30764,267,2022/4/15 20:20,27,123,-96,
30765,267,2022/4/15 20:30,33,123,-90,
30766,267,2022/4/15 20:40,29,116,-87,
30767,267,2022/4/15 20:50,24,112,-88,
30768,267,2022/4/15 21:00,30,89,-59,
30769,267,2022/4/15 21:10,25,107,-82,
30770,267,2022/4/15 21:20,25,103,-78,
30771,267,2022/4/15 21:30,25,105,-80,
30772,267,2022/4/15 21:40,24,101,-77,
30773,267,2022/4/15 21:50,23,99,-76,
30774,267,2022/4/15 22:00,26,112,-86,
30775,267,2022/4/15 22:10,21,108,-87,
30776,267,2022/4/15 22:20,19,110,-91,
30777,267,2022/4/15 22:30,13,111,-98,
30778,267,2022/4/15 22:40,2,113,-111,
30779,267,2022/4/15 22:50,2,89,-87,
30780,286,2022/4/15 5:00,1,1,0,
30781,286,2022/4/15 5:10,7,1,6,
30782,286,2022/4/15 5:20,22,1,21,
30783,286,2022/4/15 5:30,31,1,30,
30784,286,2022/4/15 5:40,31,1,30,
30785,286,2022/4/15 5:50,40,1,39,
30786,286,2022/4/15 6:00,46,1,45,
30787,286,2022/4/15 6:10,57,5,52,
30788,286,2022/4/15 6:20,84,32,52,
30789,286,2022/4/15 6:30,184,38,146,
30790,286,2022/4/15 6:40,244,50,194,
30791,286,2022/4/15 6:50,278,70,208,
30792,286,2022/4/15 7:00,359,78,281,
30793,286,2022/4/15 7:10,470,104,366,
30794,286,2022/4/15 7:20,665,105,560,
30795,286,2022/4/15 7:30,740,102,638,
30796,286,2022/4/15 7:40,864,113,751,
30797,286,2022/4/15 7:50,1177,121,1056,
30798,286,2022/4/15 8:00,1170,127,1043,
30799,286,2022/4/15 8:10,1169,110,1059,
30800,286,2022/4/15 8:20,827,94,733,
30801,286,2022/4/15 8:30,724,122,602,
30802,286,2022/4/15 8:40,594,119,475,
30803,286,2022/4/15 8:50,331,109,222,
30804,286,2022/4/15 9:00,267,87,180,
30805,286,2022/4/15 9:10,216,83,133,
30806,286,2022/4/15 9:20,160,77,83,
30807,286,2022/4/15 9:30,116,77,39,
30808,286,2022/4/15 9:40,77,85,-8,
30809,286,2022/4/15 9:50,60,81,-21,
30810,286,2022/4/15 10:00,46,78,-32,
30811,286,2022/4/15 10:10,45,64,-19,
30812,286,2022/4/15 10:20,43,66,-23,
30813,286,2022/4/15 10:30,38,75,-37,
30814,286,2022/4/15 10:40,36,64,-28,
30815,286,2022/4/15 10:50,35,82,-47,
30816,286,2022/4/15 11:00,33,65,-32,
30817,286,2022/4/15 11:10,37,83,-46,
30818,286,2022/4/15 11:20,40,70,-30,
30819,286,2022/4/15 11:30,35,81,-46,
30820,286,2022/4/15 11:40,36,74,-38,
30821,286,2022/4/15 11:50,40,82,-42,
30822,286,2022/4/15 12:00,41,76,-35,
30823,286,2022/4/15 12:10,44,81,-37,
30824,286,2022/4/15 12:20,43,74,-31,
30825,286,2022/4/15 12:30,44,87,-43,
30826,286,2022/4/15 12:40,41,76,-35,
30827,286,2022/4/15 12:50,41,97,-56,
30828,286,2022/4/15 13:00,41,72,-31,
30829,286,2022/4/15 13:10,44,91,-47,
30830,286,2022/4/15 13:20,39,69,-30,
30831,286,2022/4/15 13:30,38,90,-52,
30832,286,2022/4/15 13:40,37,64,-27,
30833,286,2022/4/15 13:50,37,94,-57,
30834,286,2022/4/15 14:00,40,74,-34,
30835,286,2022/4/15 14:10,33,93,-60,
30836,286,2022/4/15 14:20,30,72,-42,
30837,286,2022/4/15 14:30,32,105,-73,
30838,286,2022/4/15 14:40,36,76,-40,
30839,286,2022/4/15 14:50,37,105,-68,
30840,286,2022/4/15 15:00,36,97,-61,
30841,286,2022/4/15 15:10,44,102,-58,
30842,286,2022/4/15 15:20,34,99,-65,
30843,286,2022/4/15 15:30,40,121,-81,
30844,286,2022/4/15 15:40,39,103,-64,
30845,286,2022/4/15 15:50,37,125,-88,
30846,286,2022/4/15 16:00,42,100,-58,
30847,286,2022/4/15 16:10,42,121,-79,
30848,286,2022/4/15 16:20,47,123,-76,
30849,286,2022/4/15 16:30,54,109,-55,
30850,286,2022/4/15 16:40,48,125,-77,
30851,286,2022/4/15 16:50,45,152,-107,
30852,286,2022/4/15 17:00,77,111,-34,
30853,286,2022/4/15 17:10,103,220,-117,
30854,286,2022/4/15 17:20,65,189,-124,
30855,286,2022/4/15 17:30,61,281,-220,
30856,286,2022/4/15 17:40,69,295,-226,
30857,286,2022/4/15 17:50,44,315,-271,
30858,286,2022/4/15 18:00,44,317,-273,
30859,286,2022/4/15 18:10,53,321,-268,
30860,286,2022/4/15 18:20,46,426,-380,
30861,286,2022/4/15 18:30,36,383,-347,
30862,286,2022/4/15 18:40,39,508,-469,
30863,286,2022/4/15 18:50,31,323,-292,
30864,286,2022/4/15 19:00,30,435,-405,
30865,286,2022/4/15 19:10,31,299,-268,
30866,286,2022/4/15 19:20,34,233,-199,
30867,286,2022/4/15 19:30,30,191,-161,
30868,286,2022/4/15 19:40,29,137,-108,
30869,286,2022/4/15 19:50,27,120,-93,
30870,286,2022/4/15 20:00,28,110,-82,
30871,286,2022/4/15 20:10,23,111,-88,
30872,286,2022/4/15 20:20,25,121,-96,
30873,286,2022/4/15 20:30,23,127,-104,
30874,286,2022/4/15 20:40,26,126,-100,
30875,286,2022/4/15 20:50,27,109,-82,
30876,286,2022/4/15 21:00,25,122,-97,
30877,286,2022/4/15 21:10,29,126,-97,
30878,286,2022/4/15 21:20,22,114,-92,
30879,286,2022/4/15 21:30,21,123,-102,
30880,286,2022/4/15 21:40,21,112,-91,
30881,286,2022/4/15 21:50,17,103,-86,
30882,286,2022/4/15 22:00,16,118,-102,
30883,286,2022/4/15 22:10,15,105,-90,
30884,286,2022/4/15 22:20,8,123,-115,
30885,286,2022/4/15 22:30,7,110,-103,
30886,286,2022/4/15 22:40,2,103,-101,
30887,286,2022/4/15 22:50,2,99,-97,
30888,266,2022/4/15 5:00,0,1,-1,
30889,266,2022/4/15 5:10,3,1,2,
30890,266,2022/4/15 5:20,12,1,11,
30891,266,2022/4/15 5:30,11,1,10,
30892,266,2022/4/15 5:40,14,1,13,
30893,266,2022/4/15 5:50,18,1,17,
30894,266,2022/4/15 6:00,22,1,21,
30895,266,2022/4/15 6:10,32,1,31,
30896,266,2022/4/15 6:20,42,5,37,
30897,266,2022/4/15 6:30,43,22,21,
30898,266,2022/4/15 6:40,54,19,35,
30899,266,2022/4/15 6:50,77,23,54,
30900,266,2022/4/15 7:00,75,39,36,
30901,266,2022/4/15 7:10,152,40,112,
30902,266,2022/4/15 7:20,199,50,149,
30903,266,2022/4/15 7:30,265,66,199,
30904,266,2022/4/15 7:40,278,54,224,
30905,266,2022/4/15 7:50,283,83,200,
30906,266,2022/4/15 8:00,277,86,191,
30907,266,2022/4/15 8:10,270,108,162,
30908,266,2022/4/15 8:20,206,96,110,
30909,266,2022/4/15 8:30,182,114,68,
30910,266,2022/4/15 8:40,107,120,-13,
30911,266,2022/4/15 8:50,65,118,-53,
30912,266,2022/4/15 9:00,48,75,-27,
30913,266,2022/4/15 9:10,46,81,-35,
30914,266,2022/4/15 9:20,29,72,-43,
30915,266,2022/4/15 9:30,34,76,-42,
30916,266,2022/4/15 9:40,29,65,-36,
30917,266,2022/4/15 9:50,26,70,-44,
30918,266,2022/4/15 10:00,27,64,-37,
30919,266,2022/4/15 10:10,29,61,-32,
30920,266,2022/4/15 10:20,27,62,-35,
30921,266,2022/4/15 10:30,24,47,-23,
30922,266,2022/4/15 10:40,27,71,-44,
30923,266,2022/4/15 10:50,26,55,-29,
30924,266,2022/4/15 11:00,25,49,-24,
30925,266,2022/4/15 11:10,28,50,-22,
30926,266,2022/4/15 11:20,27,74,-47,
30927,266,2022/4/15 11:30,24,53,-29,
30928,266,2022/4/15 11:40,25,48,-23,
30929,266,2022/4/15 11:50,26,51,-25,
30930,266,2022/4/15 12:00,27,65,-38,
30931,266,2022/4/15 12:10,27,51,-24,
30932,266,2022/4/15 12:20,27,48,-21,
30933,266,2022/4/15 12:30,26,51,-25,
30934,266,2022/4/15 12:40,27,72,-45,
30935,266,2022/4/15 12:50,27,53,-26,
30936,266,2022/4/15 13:00,28,51,-23,
30937,266,2022/4/15 13:10,28,53,-25,
30938,266,2022/4/15 13:20,25,69,-44,
30939,266,2022/4/15 13:30,21,53,-32,
30940,266,2022/4/15 13:40,25,49,-24,
30941,266,2022/4/15 13:50,25,49,-24,
30942,266,2022/4/15 14:00,28,69,-41,
30943,266,2022/4/15 14:10,24,52,-28,
30944,266,2022/4/15 14:20,27,54,-27,
30945,266,2022/4/15 14:30,26,51,-25,
30946,266,2022/4/15 14:40,24,83,-59,
30947,266,2022/4/15 14:50,27,62,-35,
30948,266,2022/4/15 15:00,28,53,-25,
30949,266,2022/4/15 15:10,28,62,-34,
30950,266,2022/4/15 15:20,27,76,-49,
30951,266,2022/4/15 15:30,25,59,-34,
30952,266,2022/4/15 15:40,30,62,-32,
30953,266,2022/4/15 15:50,26,64,-38,
30954,266,2022/4/15 16:00,27,95,-68,
30955,266,2022/4/15 16:10,29,68,-39,
30956,266,2022/4/15 16:20,30,66,-36,
30957,266,2022/4/15 16:30,30,69,-39,
30958,266,2022/4/15 16:40,34,102,-68,
30959,266,2022/4/15 16:50,31,75,-44,
30960,266,2022/4/15 17:00,41,87,-46,
30961,266,2022/4/15 17:10,41,97,-56,
30962,266,2022/4/15 17:20,32,123,-91,
30963,266,2022/4/15 17:30,49,106,-57,
30964,266,2022/4/15 17:40,45,118,-73,
30965,266,2022/4/15 17:50,41,105,-64,
30966,266,2022/4/15 18:00,37,109,-72,
30967,266,2022/4/15 18:10,49,117,-68,
30968,266,2022/4/15 18:20,41,171,-130,
30969,266,2022/4/15 18:30,38,88,-50,
30970,266,2022/4/15 18:40,28,116,-88,
30971,266,2022/4/15 18:50,28,121,-93,
30972,266,2022/4/15 19:00,26,128,-102,
30973,266,2022/4/15 19:10,24,107,-83,
30974,266,2022/4/15 19:20,24,126,-102,
30975,266,2022/4/15 19:30,21,77,-56,
30976,266,2022/4/15 19:40,23,105,-82,
30977,266,2022/4/15 19:50,19,79,-60,
30978,266,2022/4/15 20:00,17,77,-60,
30979,266,2022/4/15 20:10,16,64,-48,
30980,266,2022/4/15 20:20,18,77,-59,
30981,266,2022/4/15 20:30,12,69,-57,
30982,266,2022/4/15 20:40,17,63,-46,
30983,266,2022/4/15 20:50,16,75,-59,
30984,266,2022/4/15 21:00,15,67,-52,
30985,266,2022/4/15 21:10,21,74,-53,
30986,266,2022/4/15 21:20,14,77,-63,
30987,266,2022/4/15 21:30,13,69,-56,
30988,266,2022/4/15 21:40,16,68,-52,
30989,266,2022/4/15 21:50,16,61,-45,
30990,266,2022/4/15 22:00,12,65,-53,
30991,266,2022/4/15 22:10,10,60,-50,
30992,266,2022/4/15 22:20,9,56,-47,
30993,266,2022/4/15 22:30,5,66,-61,
30994,266,2022/4/15 22:40,2,59,-57,
30995,266,2022/4/15 22:50,1,49,-48,
30996,285,2022/4/15 5:00,0,1,-1,
30997,285,2022/4/15 5:10,3,1,2,
30998,285,2022/4/15 5:20,11,1,10,
30999,285,2022/4/15 5:30,16,1,15,
31000,285,2022/4/15 5:40,17,1,16,
31001,285,2022/4/15 5:50,18,1,17,
31002,285,2022/4/15 6:00,27,5,22,
31003,285,2022/4/15 6:10,36,1,35,
31004,285,2022/4/15 6:20,53,8,45,
31005,285,2022/4/15 6:30,48,63,-15,
31006,285,2022/4/15 6:40,62,63,-1,
31007,285,2022/4/15 6:50,97,72,25,
31008,285,2022/4/15 7:00,107,75,32,
31009,285,2022/4/15 7:10,196,83,113,
31010,285,2022/4/15 7:20,241,121,120,
31011,285,2022/4/15 7:30,278,97,181,
31012,285,2022/4/15 7:40,277,106,171,
31013,285,2022/4/15 7:50,300,104,196,
31014,285,2022/4/15 8:00,302,124,178,
31015,285,2022/4/15 8:10,280,111,169,
31016,285,2022/4/15 8:20,255,102,153,
31017,285,2022/4/15 8:30,215,126,89,
31018,285,2022/4/15 8:40,157,110,47,
31019,285,2022/4/15 8:50,102,105,-3,
31020,285,2022/4/15 9:00,74,108,-34,
31021,285,2022/4/15 9:10,53,96,-43,
31022,285,2022/4/15 9:20,50,105,-55,
31023,285,2022/4/15 9:30,39,108,-69,
31024,285,2022/4/15 9:40,40,101,-61,
31025,285,2022/4/15 9:50,39,82,-43,
31026,285,2022/4/15 10:00,35,93,-58,
31027,285,2022/4/15 10:10,38,96,-58,
31028,285,2022/4/15 10:20,39,67,-28,
31029,285,2022/4/15 10:30,35,82,-47,
31030,285,2022/4/15 10:40,33,70,-37,
31031,285,2022/4/15 10:50,29,92,-63,
31032,285,2022/4/15 11:00,30,66,-36,
31033,285,2022/4/15 11:10,33,65,-32,
31034,285,2022/4/15 11:20,35,62,-27,
31035,285,2022/4/15 11:30,28,74,-46,
31036,285,2022/4/15 11:40,34,71,-37,
31037,285,2022/4/15 11:50,27,66,-39,
31038,285,2022/4/15 12:00,35,63,-28,
31039,285,2022/4/15 12:10,33,79,-46,
31040,285,2022/4/15 12:20,36,67,-31,
31041,285,2022/4/15 12:30,33,69,-36,
31042,285,2022/4/15 12:40,29,68,-39,
31043,285,2022/4/15 12:50,28,82,-54,
31044,285,2022/4/15 13:00,37,74,-37,
31045,285,2022/4/15 13:10,29,72,-43,
31046,285,2022/4/15 13:20,31,71,-40,
31047,285,2022/4/15 13:30,31,93,-62,
31048,285,2022/4/15 13:40,32,64,-32,
31049,285,2022/4/15 13:50,25,73,-48,
31050,285,2022/4/15 14:00,31,72,-41,
31051,285,2022/4/15 14:10,30,93,-63,
31052,285,2022/4/15 14:20,33,80,-47,
31053,285,2022/4/15 14:30,35,74,-39,
31054,285,2022/4/15 14:40,31,77,-46,
31055,285,2022/4/15 14:50,26,90,-64,
31056,285,2022/4/15 15:00,33,74,-41,
31057,285,2022/4/15 15:10,30,72,-42,
31058,285,2022/4/15 15:20,34,75,-41,
31059,285,2022/4/15 15:30,35,102,-67,
31060,285,2022/4/15 15:40,35,75,-40,
31061,285,2022/4/15 15:50,37,84,-47,
31062,285,2022/4/15 16:00,33,76,-43,
31063,285,2022/4/15 16:10,39,108,-69,
31064,285,2022/4/15 16:20,40,76,-36,
31065,285,2022/4/15 16:30,39,84,-45,
31066,285,2022/4/15 16:40,45,98,-53,
31067,285,2022/4/15 16:50,44,118,-74,
31068,285,2022/4/15 17:00,47,103,-56,
31069,285,2022/4/15 17:10,67,105,-38,
31070,285,2022/4/15 17:20,50,106,-56,
31071,285,2022/4/15 17:30,62,152,-90,
31072,285,2022/4/15 17:40,74,109,-35,
31073,285,2022/4/15 17:50,70,168,-98,
31074,285,2022/4/15 18:00,54,121,-67,
31075,285,2022/4/15 18:10,76,180,-104,
31076,285,2022/4/15 18:20,40,111,-71,
31077,285,2022/4/15 18:30,35,198,-163,
31078,285,2022/4/15 18:40,36,125,-89,
31079,285,2022/4/15 18:50,33,171,-138,
31080,285,2022/4/15 19:00,31,120,-89,
31081,285,2022/4/15 19:10,28,116,-88,
31082,285,2022/4/15 19:20,29,113,-84,
31083,285,2022/4/15 19:30,25,116,-91,
31084,285,2022/4/15 19:40,25,88,-63,
31085,285,2022/4/15 19:50,23,113,-90,
31086,285,2022/4/15 20:00,24,80,-56,
31087,285,2022/4/15 20:10,25,99,-74,
31088,285,2022/4/15 20:20,27,77,-50,
31089,285,2022/4/15 20:30,23,69,-46,
31090,285,2022/4/15 20:40,21,71,-50,
31091,285,2022/4/15 20:50,22,82,-60,
31092,285,2022/4/15 21:00,22,74,-52,
31093,285,2022/4/15 21:10,21,83,-62,
31094,285,2022/4/15 21:20,22,85,-63,
31095,285,2022/4/15 21:30,17,99,-82,
31096,285,2022/4/15 21:40,15,84,-69,
31097,285,2022/4/15 21:50,15,86,-71,
31098,285,2022/4/15 22:00,15,71,-56,
31099,285,2022/4/15 22:10,13,71,-58,
31100,285,2022/4/15 22:20,10,73,-63,
31101,285,2022/4/15 22:30,2,84,-82,
31102,285,2022/4/15 22:40,0,66,-66,
31103,285,2022/4/15 22:50,0,50,-50,
31104,275,2022/4/15 5:00,1,1,0,
31105,275,2022/4/15 5:10,13,1,12,
31106,275,2022/4/15 5:20,28,1,27,
31107,275,2022/4/15 5:30,30,1,29,
31108,275,2022/4/15 5:40,30,1,29,
31109,275,2022/4/15 5:50,36,1,35,
31110,275,2022/4/15 6:00,33,1,32,
31111,275,2022/4/15 6:10,59,1,58,
31112,275,2022/4/15 6:20,79,1,78,
31113,275,2022/4/15 6:30,88,49,39,
31114,275,2022/4/15 6:40,206,70,136,
31115,275,2022/4/15 6:50,190,67,123,
31116,275,2022/4/15 7:00,277,70,207,
31117,275,2022/4/15 7:10,303,69,234,
31118,275,2022/4/15 7:20,378,77,301,
31119,275,2022/4/15 7:30,599,79,520,
31120,275,2022/4/15 7:40,602,118,484,
31121,275,2022/4/15 7:50,666,76,590,
31122,275,2022/4/15 8:00,657,72,585,
31123,275,2022/4/15 8:10,631,99,532,
31124,275,2022/4/15 8:20,369,75,294,
31125,275,2022/4/15 8:30,302,76,226,
31126,275,2022/4/15 8:40,278,83,195,
31127,275,2022/4/15 8:50,185,62,123,
31128,275,2022/4/15 9:00,145,67,78,
31129,275,2022/4/15 9:10,83,64,19,
31130,275,2022/4/15 9:20,70,74,-4,
31131,275,2022/4/15 9:30,59,57,2,
31132,275,2022/4/15 9:40,48,70,-22,
31133,275,2022/4/15 9:50,41,73,-32,
31134,275,2022/4/15 10:00,37,62,-25,
31135,275,2022/4/15 10:10,37,69,-32,
31136,275,2022/4/15 10:20,26,57,-31,
31137,275,2022/4/15 10:30,28,69,-41,
31138,275,2022/4/15 10:40,30,56,-26,
31139,275,2022/4/15 10:50,36,62,-26,
31140,275,2022/4/15 11:00,33,78,-45,
31141,275,2022/4/15 11:10,28,65,-37,
31142,275,2022/4/15 11:20,28,63,-35,
31143,275,2022/4/15 11:30,26,67,-41,
31144,275,2022/4/15 11:40,27,85,-58,
31145,275,2022/4/15 11:50,29,70,-41,
31146,275,2022/4/15 12:00,35,60,-25,
31147,275,2022/4/15 12:10,35,65,-30,
31148,275,2022/4/15 12:20,36,82,-46,
31149,275,2022/4/15 12:30,38,62,-24,
31150,275,2022/4/15 12:40,39,62,-23,
31151,275,2022/4/15 12:50,37,65,-28,
31152,275,2022/4/15 13:00,34,89,-55,
31153,275,2022/4/15 13:10,35,73,-38,
31154,275,2022/4/15 13:20,28,74,-46,
31155,275,2022/4/15 13:30,32,67,-35,
31156,275,2022/4/15 13:40,29,90,-61,
31157,275,2022/4/15 13:50,27,72,-45,
31158,275,2022/4/15 14:00,29,70,-41,
31159,275,2022/4/15 14:10,28,71,-43,
31160,275,2022/4/15 14:20,24,101,-77,
31161,275,2022/4/15 14:30,22,76,-54,
31162,275,2022/4/15 14:40,33,66,-33,
31163,275,2022/4/15 14:50,46,69,-23,
31164,275,2022/4/15 15:00,46,101,-55,
31165,275,2022/4/15 15:10,38,87,-49,
31166,275,2022/4/15 15:20,34,79,-45,
31167,275,2022/4/15 15:30,33,91,-58,
31168,275,2022/4/15 15:40,34,118,-84,
31169,275,2022/4/15 15:50,33,102,-69,
31170,275,2022/4/15 16:00,26,93,-67,
31171,275,2022/4/15 16:10,28,93,-65,
31172,275,2022/4/15 16:20,35,110,-75,
31173,275,2022/4/15 16:30,37,102,-65,
31174,275,2022/4/15 16:40,47,106,-59,
31175,275,2022/4/15 16:50,42,104,-62,
31176,275,2022/4/15 17:00,42,191,-149,
31177,275,2022/4/15 17:10,46,121,-75,
31178,275,2022/4/15 17:20,41,103,-62,
31179,275,2022/4/15 17:30,37,233,-196,
31180,275,2022/4/15 17:40,39,191,-152,
31181,275,2022/4/15 17:50,30,253,-223,
31182,275,2022/4/15 18:00,28,299,-271,
31183,275,2022/4/15 18:10,37,320,-283,
31184,275,2022/4/15 18:20,28,294,-266,
31185,275,2022/4/15 18:30,26,316,-290,
31186,275,2022/4/15 18:40,29,331,-302,
31187,275,2022/4/15 18:50,27,321,-294,
31188,275,2022/4/15 19:00,22,294,-272,
31189,275,2022/4/15 19:10,23,301,-278,
31190,275,2022/4/15 19:20,22,182,-160,
31191,275,2022/4/15 19:30,19,145,-126,
31192,275,2022/4/15 19:40,18,109,-91,
31193,275,2022/4/15 19:50,18,124,-106,
31194,275,2022/4/15 20:00,16,106,-90,
31195,275,2022/4/15 20:10,21,124,-103,
31196,275,2022/4/15 20:20,22,108,-86,
31197,275,2022/4/15 20:30,21,107,-86,
31198,275,2022/4/15 20:40,17,104,-87,
31199,275,2022/4/15 20:50,22,111,-89,
31200,275,2022/4/15 21:00,24,111,-87,
31201,275,2022/4/15 21:10,22,100,-78,
31202,275,2022/4/15 21:20,17,107,-90,
31203,275,2022/4/15 21:30,15,103,-88,
31204,275,2022/4/15 21:40,13,107,-94,
31205,275,2022/4/15 21:50,11,106,-95,
31206,275,2022/4/15 22:00,11,124,-113,
31207,275,2022/4/15 22:10,10,95,-85,
31208,275,2022/4/15 22:20,3,85,-82,
31209,275,2022/4/15 22:30,1,81,-80,
31210,275,2022/4/15 22:40,0,108,-108,
31211,275,2022/4/15 22:50,0,94,-94,
31212,281,2022/4/15 5:00,3,1,2,
31213,281,2022/4/15 5:10,22,1,21,
31214,281,2022/4/15 5:20,33,1,32,
31215,281,2022/4/15 5:30,34,1,33,
31216,281,2022/4/15 5:40,36,1,35,
31217,281,2022/4/15 5:50,44,1,43,
31218,281,2022/4/15 6:00,69,1,68,
31219,281,2022/4/15 6:10,110,1,109,
31220,281,2022/4/15 6:20,199,1,198,
31221,281,2022/4/15 6:30,249,45,204,
31222,281,2022/4/15 6:40,339,45,294,
31223,281,2022/4/15 6:50,369,72,297,
31224,281,2022/4/15 7:00,630,81,549,
31225,281,2022/4/15 7:10,735,85,650,
31226,281,2022/4/15 7:20,1166,82,1084,
31227,281,2022/4/15 7:30,1207,74,1133,
31228,281,2022/4/15 7:40,1214,90,1124,
31229,281,2022/4/15 7:50,1365,127,1238,
31230,281,2022/4/15 8:00,1366,93,1273,
31231,281,2022/4/15 8:10,1179,95,1084,
31232,281,2022/4/15 8:20,743,106,637,
31233,281,2022/4/15 8:30,598,108,490,
31234,281,2022/4/15 8:40,374,92,282,
31235,281,2022/4/15 8:50,318,74,244,
31236,281,2022/4/15 9:00,232,78,154,
31237,281,2022/4/15 9:10,175,65,110,
31238,281,2022/4/15 9:20,122,76,46,
31239,281,2022/4/15 9:30,73,62,11,
31240,281,2022/4/15 9:40,53,72,-19,
31241,281,2022/4/15 9:50,47,80,-33,
31242,281,2022/4/15 10:00,45,68,-23,
31243,281,2022/4/15 10:10,39,62,-23,
31244,281,2022/4/15 10:20,43,65,-22,
31245,281,2022/4/15 10:30,37,77,-40,
31246,281,2022/4/15 10:40,33,67,-34,
31247,281,2022/4/15 10:50,31,54,-23,
31248,281,2022/4/15 11:00,30,67,-37,
31249,281,2022/4/15 11:10,31,76,-45,
31250,281,2022/4/15 11:20,31,64,-33,
31251,281,2022/4/15 11:30,32,61,-29,
31252,281,2022/4/15 11:40,37,61,-24,
31253,281,2022/4/15 11:50,36,81,-45,
31254,281,2022/4/15 12:00,36,65,-29,
31255,281,2022/4/15 12:10,42,61,-19,
31256,281,2022/4/15 12:20,43,59,-16,
31257,281,2022/4/15 12:30,40,88,-48,
31258,281,2022/4/15 12:40,36,65,-29,
31259,281,2022/4/15 12:50,34,63,-29,
31260,281,2022/4/15 13:00,32,66,-34,
31261,281,2022/4/15 13:10,32,91,-59,
31262,281,2022/4/15 13:20,29,71,-42,
31263,281,2022/4/15 13:30,28,74,-46,
31264,281,2022/4/15 13:40,26,72,-46,
31265,281,2022/4/15 13:50,26,91,-65,
31266,281,2022/4/15 14:00,32,67,-35,
31267,281,2022/4/15 14:10,29,71,-42,
31268,281,2022/4/15 14:20,28,72,-44,
31269,281,2022/4/15 14:30,24,105,-81,
31270,281,2022/4/15 14:40,26,83,-57,
31271,281,2022/4/15 14:50,28,72,-44,
31272,281,2022/4/15 15:00,28,77,-49,
31273,281,2022/4/15 15:10,33,105,-72,
31274,281,2022/4/15 15:20,28,87,-59,
31275,281,2022/4/15 15:30,33,78,-45,
31276,281,2022/4/15 15:40,26,91,-65,
31277,281,2022/4/15 15:50,29,116,-87,
31278,281,2022/4/15 16:00,34,104,-70,
31279,281,2022/4/15 16:10,35,93,-58,
31280,281,2022/4/15 16:20,35,111,-76,
31281,281,2022/4/15 16:30,44,122,-78,
31282,281,2022/4/15 16:40,37,120,-83,
31283,281,2022/4/15 16:50,40,116,-76,
31284,281,2022/4/15 17:00,40,125,-85,
31285,281,2022/4/15 17:10,63,231,-168,
31286,281,2022/4/15 17:20,45,144,-99,
31287,281,2022/4/15 17:30,41,142,-101,
31288,281,2022/4/15 17:40,42,378,-336,
31289,281,2022/4/15 17:50,36,190,-154,
31290,281,2022/4/15 18:00,33,506,-473,
31291,281,2022/4/15 18:10,37,196,-159,
31292,281,2022/4/15 18:20,35,431,-396,
31293,281,2022/4/15 18:30,29,233,-204,
31294,281,2022/4/15 18:40,24,421,-397,
31295,281,2022/4/15 18:50,27,222,-195,
31296,281,2022/4/15 19:00,25,506,-481,
31297,281,2022/4/15 19:10,22,181,-159,
31298,281,2022/4/15 19:20,20,328,-308,
31299,281,2022/4/15 19:30,21,111,-90,
31300,281,2022/4/15 19:40,22,226,-204,
31301,281,2022/4/15 19:50,21,104,-83,
31302,281,2022/4/15 20:00,25,151,-126,
31303,281,2022/4/15 20:10,23,98,-75,
31304,281,2022/4/15 20:20,19,110,-91,
31305,281,2022/4/15 20:30,18,95,-77,
31306,281,2022/4/15 20:40,20,110,-90,
31307,281,2022/4/15 20:50,18,133,-115,
31308,281,2022/4/15 21:00,18,97,-79,
31309,281,2022/4/15 21:10,14,104,-90,
31310,281,2022/4/15 21:20,13,112,-99,
31311,281,2022/4/15 21:30,14,110,-96,
31312,281,2022/4/15 21:40,12,108,-96,
31313,281,2022/4/15 21:50,12,107,-95,
31314,281,2022/4/15 22:00,13,110,-97,
31315,281,2022/4/15 22:10,13,112,-99,
31316,281,2022/4/15 22:20,6,121,-115,
31317,281,2022/4/15 22:30,0,101,-101,
31318,281,2022/4/15 22:40,0,103,-103,
31319,281,2022/4/15 22:50,0,99,-99,
31320,310,2022/4/15 5:00,0,1,-1,-1
31321,310,2022/4/15 5:10,3,1,2,2
31322,310,2022/4/15 5:20,8,1,7,7
31323,310,2022/4/15 5:30,7,1,6,6
31324,310,2022/4/15 5:40,12,1,11,11
31325,310,2022/4/15 5:50,21,1,20,20
31326,310,2022/4/15 6:00,22,1,21,21
31327,310,2022/4/15 6:10,34,1,33,33
31328,310,2022/4/15 6:20,34,73,-39,-39
31329,310,2022/4/15 6:30,62,63,-1,-1
31330,310,2022/4/15 6:40,85,71,14,14
31331,310,2022/4/15 6:50,101,73,28,28
31332,310,2022/4/15 7:00,196,92,104,104
31333,310,2022/4/15 7:10,246,124,122,122
31334,310,2022/4/15 7:20,322,118,204,204
31335,310,2022/4/15 7:30,570,108,462,462
31336,310,2022/4/15 7:40,657,197,460,460
31337,310,2022/4/15 7:50,824,334,490,490
31338,310,2022/4/15 8:00,1044,430,614,614
31339,310,2022/4/15 8:10,1038,478,560,560
31340,310,2022/4/15 8:20,1045,576,469,469
31341,310,2022/4/15 8:30,824,1136,-312,-312
31342,310,2022/4/15 8:40,640,615,25,25
31343,310,2022/4/15 8:50,437,432,5,5
31344,310,2022/4/15 9:00,296,432,-136,-136
31345,310,2022/4/15 9:10,266,341,-75,-75
31346,310,2022/4/15 9:20,220,330,-110,-110
31347,310,2022/4/15 9:30,180,297,-117,-117
31348,310,2022/4/15 9:40,140,157,-17,-17
31349,310,2022/4/15 9:50,94,137,-43,-43
31350,310,2022/4/15 10:00,76,120,-44,-44
31351,310,2022/4/15 10:10,76,103,-27,-27
31352,310,2022/4/15 10:20,76,120,-44,-44
31353,310,2022/4/15 10:30,69,109,-40,-40
31354,310,2022/4/15 10:40,67,93,-26,-26
31355,310,2022/4/15 10:50,60,105,-45,-45
31356,310,2022/4/15 11:00,65,105,-40,-40
31357,310,2022/4/15 11:10,62,101,-39,-39
31358,310,2022/4/15 11:20,60,99,-39,-39
31359,310,2022/4/15 11:30,75,70,5,5
31360,310,2022/4/15 11:40,64,100,-36,-36
31361,310,2022/4/15 11:50,57,96,-39,-39
31362,310,2022/4/15 12:00,59,99,-40,-40
31363,310,2022/4/15 12:10,59,103,-44,-44
31364,310,2022/4/15 12:20,62,85,-23,-23
31365,310,2022/4/15 12:30,63,108,-45,-45
31366,310,2022/4/15 12:40,51,108,-57,-57
31367,310,2022/4/15 12:50,62,112,-50,-50
31368,310,2022/4/15 13:00,56,107,-51,-51
31369,310,2022/4/15 13:10,58,109,-51,-51
31370,310,2022/4/15 13:20,53,95,-42,-42
31371,310,2022/4/15 13:30,59,114,-55,-55
31372,310,2022/4/15 13:40,67,103,-36,-36
31373,310,2022/4/15 13:50,67,122,-55,-55
31374,310,2022/4/15 14:00,63,125,-62,-62
31375,310,2022/4/15 14:10,68,96,-28,-28
31376,310,2022/4/15 14:20,70,107,-37,-37
31377,310,2022/4/15 14:30,76,125,-49,-49
31378,310,2022/4/15 14:40,74,87,-13,-13
31379,310,2022/4/15 14:50,71,127,-56,-56
31380,310,2022/4/15 15:00,73,112,-39,-39
31381,310,2022/4/15 15:10,81,90,-9,-9
31382,310,2022/4/15 15:20,85,104,-19,-19
31383,310,2022/4/15 15:30,120,123,-3,-3
31384,310,2022/4/15 15:40,121,124,-3,-3
31385,310,2022/4/15 15:50,118,117,1,1
31386,310,2022/4/15 16:00,134,83,51,51
31387,310,2022/4/15 16:10,151,112,39,39
31388,310,2022/4/15 16:20,165,97,68,68
31389,310,2022/4/15 16:30,236,122,114,114
31390,310,2022/4/15 16:40,295,126,169,169
31391,310,2022/4/15 16:50,328,122,206,206
31392,310,2022/4/15 17:00,580,105,475,475
31393,310,2022/4/15 17:10,699,120,579,579
31394,310,2022/4/15 17:20,572,149,423,423
31395,310,2022/4/15 17:30,658,212,446,446
31396,310,2022/4/15 17:40,1205,144,1061,1061
31397,310,2022/4/15 17:50,681,298,383,383
31398,310,2022/4/15 18:00,650,336,314,314
31399,310,2022/4/15 18:10,709,216,493,493
31400,310,2022/4/15 18:20,459,326,133,133
31401,310,2022/4/15 18:30,335,327,8,8
31402,310,2022/4/15 18:40,271,300,-29,-29
31403,310,2022/4/15 18:50,225,196,29,29
31404,310,2022/4/15 19:00,163,198,-35,-35
31405,310,2022/4/15 19:10,113,192,-79,-79
31406,310,2022/4/15 19:20,78,132,-54,-54
31407,310,2022/4/15 19:30,75,116,-41,-41
31408,310,2022/4/15 19:40,63,118,-55,-55
31409,310,2022/4/15 19:50,46,112,-66,-66
31410,310,2022/4/15 20:00,43,113,-70,-70
31411,310,2022/4/15 20:10,46,106,-60,-60
31412,310,2022/4/15 20:20,62,106,-44,-44
31413,310,2022/4/15 20:30,46,106,-60,-60
31414,310,2022/4/15 20:40,47,92,-45,-45
31415,310,2022/4/15 20:50,42,106,-64,-64
31416,310,2022/4/15 21:00,38,104,-66,-66
31417,310,2022/4/15 21:10,44,113,-69,-69
31418,310,2022/4/15 21:20,36,95,-59,-59
31419,310,2022/4/15 21:30,31,101,-70,-70
31420,310,2022/4/15 21:40,35,100,-65,-65
31421,310,2022/4/15 21:50,28,84,-56,-56
31422,310,2022/4/15 22:00,27,94,-67,-67
31423,310,2022/4/15 22:10,32,88,-56,-56
31424,310,2022/4/15 22:20,26,67,-41,-41
31425,310,2022/4/15 22:30,0,73,-73,-73
31426,310,2022/4/15 22:40,0,79,-79,-79
31427,310,2022/4/15 22:50,0,49,-49,-49
31428,300,2022/4/15 5:00,0,1,-1,
31429,300,2022/4/15 5:10,3,1,2,
31430,300,2022/4/15 5:20,7,1,6,
31431,300,2022/4/15 5:30,9,1,8,
31432,300,2022/4/15 5:40,11,1,10,
31433,300,2022/4/15 5:50,17,6,11,
31434,300,2022/4/15 6:00,18,2,16,
31435,300,2022/4/15 6:10,23,38,-15,
31436,300,2022/4/15 6:20,23,42,-19,
31437,300,2022/4/15 6:30,31,55,-24,
31438,300,2022/4/15 6:40,39,69,-30,
31439,300,2022/4/15 6:50,42,83,-41,
31440,300,2022/4/15 7:00,54,105,-51,
31441,300,2022/4/15 7:10,55,101,-46,
31442,300,2022/4/15 7:20,73,121,-48,
31443,300,2022/4/15 7:30,80,178,-98,
31444,300,2022/4/15 7:40,154,233,-79,
31445,300,2022/4/15 7:50,184,382,-198,
31446,300,2022/4/15 8:00,234,1638,-1404,
31447,300,2022/4/15 8:10,231,2056,-1825,
31448,300,2022/4/15 8:20,243,2708,-2465,
31449,300,2022/4/15 8:30,223,4315,-4092,
31450,300,2022/4/15 8:40,216,6540,-6324,
31451,300,2022/4/15 8:50,180,4458,-4278,
31452,300,2022/4/15 9:00,122,2643,-2521,
31453,300,2022/4/15 9:10,82,1693,-1611,
31454,300,2022/4/15 9:20,74,597,-523,
31455,300,2022/4/15 9:30,61,561,-500,
31456,300,2022/4/15 9:40,56,427,-371,
31457,300,2022/4/15 9:50,50,319,-269,
31458,300,2022/4/15 10:00,48,223,-175,
31459,300,2022/4/15 10:10,49,222,-173,
31460,300,2022/4/15 10:20,50,183,-133,
31461,300,2022/4/15 10:30,46,103,-57,
31462,300,2022/4/15 10:40,53,144,-91,
31463,300,2022/4/15 10:50,57,144,-87,
31464,300,2022/4/15 11:00,52,111,-59,
31465,300,2022/4/15 11:10,46,119,-73,
31466,300,2022/4/15 11:20,58,126,-68,
31467,300,2022/4/15 11:30,63,108,-45,
31468,300,2022/4/15 11:40,67,110,-43,
31469,300,2022/4/15 11:50,64,109,-45,
31470,300,2022/4/15 12:00,72,119,-47,
31471,300,2022/4/15 12:10,90,102,-12,
31472,300,2022/4/15 12:20,82,108,-26,
31473,300,2022/4/15 12:30,88,122,-34,
31474,300,2022/4/15 12:40,97,121,-24,
31475,300,2022/4/15 12:50,96,139,-43,
31476,300,2022/4/15 13:00,133,120,13,
31477,300,2022/4/15 13:10,148,123,25,
31478,300,2022/4/15 13:20,142,113,29,
31479,300,2022/4/15 13:30,140,125,15,
31480,300,2022/4/15 13:40,151,152,-1,
31481,300,2022/4/15 13:50,136,117,19,
31482,300,2022/4/15 14:00,136,108,28,
31483,300,2022/4/15 14:10,138,123,15,
31484,300,2022/4/15 14:20,132,125,7,
31485,300,2022/4/15 14:30,135,119,16,
31486,300,2022/4/15 14:40,136,108,28,
31487,300,2022/4/15 14:50,140,122,18,
31488,300,2022/4/15 15:00,177,109,68,
31489,300,2022/4/15 15:10,177,123,54,
31490,300,2022/4/15 15:20,183,114,69,
31491,300,2022/4/15 15:30,185,108,77,
31492,300,2022/4/15 15:40,180,109,71,
31493,300,2022/4/15 15:50,183,105,78,
31494,300,2022/4/15 16:00,208,108,100,
31495,300,2022/4/15 16:10,218,123,95,
31496,300,2022/4/15 16:20,214,125,89,
31497,300,2022/4/15 16:30,261,105,156,
31498,300,2022/4/15 16:40,307,116,191,
31499,300,2022/4/15 16:50,288,119,169,
31500,300,2022/4/15 17:00,641,147,494,
31501,300,2022/4/15 17:10,653,156,497,
31502,300,2022/4/15 17:20,656,211,445,
31503,300,2022/4/15 17:30,1155,267,888,
31504,300,2022/4/15 17:40,1587,296,1291,
31505,300,2022/4/15 17:50,1200,321,879,
31506,300,2022/4/15 18:00,1347,299,1048,
31507,300,2022/4/15 18:10,1979,323,1656,
31508,300,2022/4/15 18:20,1558,318,1240,
31509,300,2022/4/15 18:30,1154,347,807,
31510,300,2022/4/15 18:40,827,320,507,
31511,300,2022/4/15 18:50,671,285,386,
31512,300,2022/4/15 19:00,577,195,382,
31513,300,2022/4/15 19:10,579,149,430,
31514,300,2022/4/15 19:20,371,103,268,
31515,300,2022/4/15 19:30,337,124,213,
31516,300,2022/4/15 19:40,318,105,213,
31517,300,2022/4/15 19:50,270,103,167,
31518,300,2022/4/15 20:00,306,112,194,
31519,300,2022/4/15 20:10,327,91,236,
31520,300,2022/4/15 20:20,314,92,222,
31521,300,2022/4/15 20:30,333,79,254,
31522,300,2022/4/15 20:40,348,93,255,
31523,300,2022/4/15 20:50,305,89,216,
31524,300,2022/4/15 21:00,321,78,243,
31525,300,2022/4/15 21:10,437,76,361,
31526,300,2022/4/15 21:20,317,77,240,
31527,300,2022/4/15 21:30,318,75,243,
31528,300,2022/4/15 21:40,268,77,191,
31529,300,2022/4/15 21:50,205,83,122,
31530,300,2022/4/15 22:00,267,71,196,
31531,300,2022/4/15 22:10,595,66,529,
31532,300,2022/4/15 22:20,58,72,-14,
31533,300,2022/4/15 22:30,24,65,-41,
31534,300,2022/4/15 22:40,14,62,-48,
31535,300,2022/4/15 22:50,6,37,-31,
31536,307,2022/4/15 5:00,0,1,-1,
31537,307,2022/4/15 5:10,0,1,-1,
31538,307,2022/4/15 5:20,4,1,3,
31539,307,2022/4/15 5:30,12,1,11,
31540,307,2022/4/15 5:40,11,2,9,
31541,307,2022/4/15 5:50,21,1,20,
31542,307,2022/4/15 6:00,32,2,30,
31543,307,2022/4/15 6:10,36,37,-1,
31544,307,2022/4/15 6:20,47,33,14,
31545,307,2022/4/15 6:30,65,64,1,
31546,307,2022/4/15 6:40,84,67,17,
31547,307,2022/4/15 6:50,103,88,15,
31548,307,2022/4/15 7:00,165,98,67,
31549,307,2022/4/15 7:10,160,105,55,
31550,307,2022/4/15 7:20,200,116,84,
31551,307,2022/4/15 7:30,235,104,131,
31552,307,2022/4/15 7:40,281,117,164,
31553,307,2022/4/15 7:50,349,233,116,
31554,307,2022/4/15 8:00,325,332,-7,
31555,307,2022/4/15 8:10,324,378,-54,
31556,307,2022/4/15 8:20,395,333,62,
31557,307,2022/4/15 8:30,335,379,-44,
31558,307,2022/4/15 8:40,282,379,-97,
31559,307,2022/4/15 8:50,234,318,-84,
31560,307,2022/4/15 9:00,216,218,-2,
31561,307,2022/4/15 9:10,179,180,-1,
31562,307,2022/4/15 9:20,117,119,-2,
31563,307,2022/4/15 9:30,76,121,-45,
31564,307,2022/4/15 9:40,66,122,-56,
31565,307,2022/4/15 9:50,49,109,-60,
31566,307,2022/4/15 10:00,47,105,-58,
31567,307,2022/4/15 10:10,46,96,-50,
31568,307,2022/4/15 10:20,43,104,-61,
31569,307,2022/4/15 10:30,44,77,-33,
31570,307,2022/4/15 10:40,44,93,-49,
31571,307,2022/4/15 10:50,41,91,-50,
31572,307,2022/4/15 11:00,40,98,-58,
31573,307,2022/4/15 11:10,38,79,-41,
31574,307,2022/4/15 11:20,41,85,-44,
31575,307,2022/4/15 11:30,39,91,-52,
31576,307,2022/4/15 11:40,41,76,-35,
31577,307,2022/4/15 11:50,40,93,-53,
31578,307,2022/4/15 12:00,43,90,-47,
31579,307,2022/4/15 12:10,44,70,-26,
31580,307,2022/4/15 12:20,46,93,-47,
31581,307,2022/4/15 12:30,45,91,-46,
31582,307,2022/4/15 12:40,43,109,-66,
31583,307,2022/4/15 12:50,43,111,-68,
31584,307,2022/4/15 13:00,46,100,-54,
31585,307,2022/4/15 13:10,46,90,-44,
31586,307,2022/4/15 13:20,43,96,-53,
31587,307,2022/4/15 13:30,41,102,-61,
31588,307,2022/4/15 13:40,44,111,-67,
31589,307,2022/4/15 13:50,37,97,-60,
31590,307,2022/4/15 14:00,38,92,-54,
31591,307,2022/4/15 14:10,42,99,-57,
31592,307,2022/4/15 14:20,42,98,-56,
31593,307,2022/4/15 14:30,42,101,-59,
31594,307,2022/4/15 14:40,44,111,-67,
31595,307,2022/4/15 14:50,41,93,-52,
31596,307,2022/4/15 15:00,43,76,-33,
31597,307,2022/4/15 15:10,60,109,-49,
31598,307,2022/4/15 15:20,47,105,-58,
31599,307,2022/4/15 15:30,59,112,-53,
31600,307,2022/4/15 15:40,44,105,-61,
31601,307,2022/4/15 15:50,41,76,-35,
31602,307,2022/4/15 16:00,65,86,-21,
31603,307,2022/4/15 16:10,74,105,-31,
31604,307,2022/4/15 16:20,60,119,-59,
31605,307,2022/4/15 16:30,110,114,-4,
31606,307,2022/4/15 16:40,148,87,61,
31607,307,2022/4/15 16:50,132,119,13,
31608,307,2022/4/15 17:00,209,104,105,
31609,307,2022/4/15 17:10,270,110,160,
31610,307,2022/4/15 17:20,291,103,188,
31611,307,2022/4/15 17:30,267,179,88,
31612,307,2022/4/15 17:40,312,183,129,
31613,307,2022/4/15 17:50,308,183,125,
31614,307,2022/4/15 18:00,235,233,2,
31615,307,2022/4/15 18:10,266,256,10,
31616,307,2022/4/15 18:20,255,178,77,
31617,307,2022/4/15 18:30,207,199,8,
31618,307,2022/4/15 18:40,173,226,-53,
31619,307,2022/4/15 18:50,133,192,-59,
31620,307,2022/4/15 19:00,77,117,-40,
31621,307,2022/4/15 19:10,65,123,-58,
31622,307,2022/4/15 19:20,50,111,-61,
31623,307,2022/4/15 19:30,44,129,-85,
31624,307,2022/4/15 19:40,45,110,-65,
31625,307,2022/4/15 19:50,39,109,-70,
31626,307,2022/4/15 20:00,38,107,-69,
31627,307,2022/4/15 20:10,36,107,-71,
31628,307,2022/4/15 20:20,31,102,-71,
31629,307,2022/4/15 20:30,35,112,-77,
31630,307,2022/4/15 20:40,26,108,-82,
31631,307,2022/4/15 20:50,26,111,-85,
31632,307,2022/4/15 21:00,29,102,-73,
31633,307,2022/4/15 21:10,29,111,-82,
31634,307,2022/4/15 21:20,33,105,-72,
31635,307,2022/4/15 21:30,27,110,-83,
31636,307,2022/4/15 21:40,26,109,-83,
31637,307,2022/4/15 21:50,26,112,-86,
31638,307,2022/4/15 22:00,25,99,-74,
31639,307,2022/4/15 22:10,20,100,-80,
31640,307,2022/4/15 22:20,15,92,-77,
31641,307,2022/4/15 22:30,13,121,-108,
31642,307,2022/4/15 22:40,3,62,-59,
31643,307,2022/4/15 22:50,1,40,-39,
31644,298,2022/4/15 5:00,0,1,-1,
31645,298,2022/4/15 5:10,0,1,-1,
31646,298,2022/4/15 5:20,3,1,2,
31647,298,2022/4/15 5:30,8,1,7,
31648,298,2022/4/15 5:40,9,2,7,
31649,298,2022/4/15 5:50,13,2,11,
31650,298,2022/4/15 6:00,27,11,16,
31651,298,2022/4/15 6:10,29,24,5,
31652,298,2022/4/15 6:20,32,29,3,
31653,298,2022/4/15 6:30,42,45,-3,
31654,298,2022/4/15 6:40,50,45,5,
31655,298,2022/4/15 6:50,57,69,-12,
31656,298,2022/4/15 7:00,80,84,-4,
31657,298,2022/4/15 7:10,92,91,1,
31658,298,2022/4/15 7:20,94,105,-11,
31659,298,2022/4/15 7:30,157,109,48,
31660,298,2022/4/15 7:40,207,119,88,
31661,298,2022/4/15 7:50,264,109,155,
31662,298,2022/4/15 8:00,277,190,87,
31663,298,2022/4/15 8:10,302,324,-22,
31664,298,2022/4/15 8:20,353,322,31,
31665,298,2022/4/15 8:30,281,382,-101,
31666,298,2022/4/15 8:40,269,436,-167,
31667,298,2022/4/15 8:50,215,431,-216,
31668,298,2022/4/15 9:00,184,535,-351,
31669,298,2022/4/15 9:10,167,505,-338,
31670,298,2022/4/15 9:20,78,317,-239,
31671,298,2022/4/15 9:30,57,232,-175,
31672,298,2022/4/15 9:40,57,231,-174,
31673,298,2022/4/15 9:50,51,103,-52,
31674,298,2022/4/15 10:00,45,119,-74,
31675,298,2022/4/15 10:10,47,125,-78,
31676,298,2022/4/15 10:20,46,105,-59,
31677,298,2022/4/15 10:30,43,109,-66,
31678,298,2022/4/15 10:40,43,106,-63,
31679,298,2022/4/15 10:50,38,106,-68,
31680,298,2022/4/15 11:00,38,96,-58,
31681,298,2022/4/15 11:10,39,88,-49,
31682,298,2022/4/15 11:20,39,89,-50,
31683,298,2022/4/15 11:30,38,91,-53,
31684,298,2022/4/15 11:40,38,92,-54,
31685,298,2022/4/15 11:50,39,99,-60,
31686,298,2022/4/15 12:00,43,89,-46,
31687,298,2022/4/15 12:10,43,90,-47,
31688,298,2022/4/15 12:20,40,98,-58,
31689,298,2022/4/15 12:30,39,93,-54,
31690,298,2022/4/15 12:40,42,106,-64,
31691,298,2022/4/15 12:50,39,106,-67,
31692,298,2022/4/15 13:00,42,99,-57,
31693,298,2022/4/15 13:10,38,108,-70,
31694,298,2022/4/15 13:20,44,113,-69,
31695,298,2022/4/15 13:30,44,103,-59,
31696,298,2022/4/15 13:40,45,104,-59,
31697,298,2022/4/15 13:50,46,102,-56,
31698,298,2022/4/15 14:00,49,104,-55,
31699,298,2022/4/15 14:10,45,103,-58,
31700,298,2022/4/15 14:20,44,99,-55,
31701,298,2022/4/15 14:30,49,108,-59,
31702,298,2022/4/15 14:40,44,96,-52,
31703,298,2022/4/15 14:50,46,93,-47,
31704,298,2022/4/15 15:00,52,92,-40,
31705,298,2022/4/15 15:10,54,108,-54,
31706,298,2022/4/15 15:20,52,111,-59,
31707,298,2022/4/15 15:30,62,104,-42,
31708,298,2022/4/15 15:40,62,105,-43,
31709,298,2022/4/15 15:50,52,93,-41,
31710,298,2022/4/15 16:00,61,112,-51,
31711,298,2022/4/15 16:10,77,97,-20,
31712,298,2022/4/15 16:20,70,103,-33,
31713,298,2022/4/15 16:30,96,105,-9,
31714,298,2022/4/15 16:40,175,100,75,
31715,298,2022/4/15 16:50,134,107,27,
31716,298,2022/4/15 17:00,179,107,72,
31717,298,2022/4/15 17:10,234,120,114,
31718,298,2022/4/15 17:20,179,118,61,
31719,298,2022/4/15 17:30,231,108,123,
31720,298,2022/4/15 17:40,275,150,125,
31721,298,2022/4/15 17:50,208,206,2,
31722,298,2022/4/15 18:00,268,198,70,
31723,298,2022/4/15 18:10,643,158,485,
31724,298,2022/4/15 18:20,314,224,90,
31725,298,2022/4/15 18:30,275,208,67,
31726,298,2022/4/15 18:40,350,184,166,
31727,298,2022/4/15 18:50,243,116,127,
31728,298,2022/4/15 19:00,214,111,103,
31729,298,2022/4/15 19:10,188,124,64,
31730,298,2022/4/15 19:20,148,107,41,
31731,298,2022/4/15 19:30,103,112,-9,
31732,298,2022/4/15 19:40,77,106,-29,
31733,298,2022/4/15 19:50,65,97,-32,
31734,298,2022/4/15 20:00,59,83,-24,
31735,298,2022/4/15 20:10,64,94,-30,
31736,298,2022/4/15 20:20,46,93,-47,
31737,298,2022/4/15 20:30,47,84,-37,
31738,298,2022/4/15 20:40,47,81,-34,
31739,298,2022/4/15 20:50,42,95,-53,
31740,298,2022/4/15 21:00,47,80,-33,
31741,298,2022/4/15 21:10,42,88,-46,
31742,298,2022/4/15 21:20,38,89,-51,
31743,298,2022/4/15 21:30,36,88,-52,
31744,298,2022/4/15 21:40,28,84,-56,
31745,298,2022/4/15 21:50,31,80,-49,
31746,298,2022/4/15 22:00,28,72,-44,
31747,298,2022/4/15 22:10,27,77,-50,
31748,298,2022/4/15 22:20,25,79,-54,
31749,298,2022/4/15 22:30,19,60,-41,
31750,298,2022/4/15 22:40,10,67,-57,
31751,298,2022/4/15 22:50,1,21,-20,
31752,292,2022/4/15 5:00,0,1,-1,
31753,292,2022/4/15 5:10,0,1,-1,
31754,292,2022/4/15 5:20,0,1,-1,
31755,292,2022/4/15 5:30,6,1,5,
31756,292,2022/4/15 5:40,10,5,5,
31757,292,2022/4/15 5:50,15,1,14,
31758,292,2022/4/15 6:00,21,23,-2,
31759,292,2022/4/15 6:10,23,54,-31,
31760,292,2022/4/15 6:20,28,52,-24,
31761,292,2022/4/15 6:30,32,85,-53,
31762,292,2022/4/15 6:40,35,102,-67,
31763,292,2022/4/15 6:50,43,144,-101,
31764,292,2022/4/15 7:00,52,230,-178,
31765,292,2022/4/15 7:10,58,325,-267,
31766,292,2022/4/15 7:20,78,344,-266,
31767,292,2022/4/15 7:30,102,534,-432,
31768,292,2022/4/15 7:40,176,432,-256,
31769,292,2022/4/15 7:50,215,431,-216,
31770,292,2022/4/15 8:00,234,572,-338,
31771,292,2022/4/15 8:10,259,1527,-1268,
31772,292,2022/4/15 8:20,286,1524,-1238,
31773,292,2022/4/15 8:30,278,2694,-2416,
31774,292,2022/4/15 8:40,226,3240,-3014,
31775,292,2022/4/15 8:50,222,2568,-2346,
31776,292,2022/4/15 9:00,222,1927,-1705,
31777,292,2022/4/15 9:10,216,1614,-1398,
31778,292,2022/4/15 9:20,202,619,-417,
31779,292,2022/4/15 9:30,183,599,-416,
31780,292,2022/4/15 9:40,167,460,-293,
31781,292,2022/4/15 9:50,160,527,-367,
31782,292,2022/4/15 10:00,138,434,-296,
31783,292,2022/4/15 10:10,173,297,-124,
31784,292,2022/4/15 10:20,178,330,-152,
31785,292,2022/4/15 10:30,178,318,-140,
31786,292,2022/4/15 10:40,174,216,-42,
31787,292,2022/4/15 10:50,177,296,-119,
31788,292,2022/4/15 11:00,174,232,-58,
31789,292,2022/4/15 11:10,197,177,20,
31790,292,2022/4/15 11:20,177,217,-40,
31791,292,2022/4/15 11:30,184,179,5,
31792,292,2022/4/15 11:40,212,254,-42,
31793,292,2022/4/15 11:50,217,298,-81,
31794,292,2022/4/15 12:00,222,231,-9,
31795,292,2022/4/15 12:10,233,221,12,
31796,292,2022/4/15 12:20,224,195,29,
31797,292,2022/4/15 12:30,237,206,31,
31798,292,2022/4/15 12:40,227,313,-86,
31799,292,2022/4/15 12:50,241,318,-77,
31800,292,2022/4/15 13:00,258,252,6,
31801,292,2022/4/15 13:10,268,281,-13,
31802,292,2022/4/15 13:20,271,195,76,
31803,292,2022/4/15 13:30,273,283,-10,
31804,292,2022/4/15 13:40,272,320,-48,
31805,292,2022/4/15 13:50,270,217,53,
31806,292,2022/4/15 14:00,271,226,45,
31807,292,2022/4/15 14:10,288,214,74,
31808,292,2022/4/15 14:20,290,178,112,
31809,292,2022/4/15 14:30,349,197,152,
31810,292,2022/4/15 14:40,315,208,107,
31811,292,2022/4/15 14:50,313,150,163,
31812,292,2022/4/15 15:00,334,226,108,
31813,292,2022/4/15 15:10,328,181,147,
31814,292,2022/4/15 15:20,322,129,193,
31815,292,2022/4/15 15:30,314,226,88,
31816,292,2022/4/15 15:40,329,178,151,
31817,292,2022/4/15 15:50,310,234,76,
31818,292,2022/4/15 16:00,430,145,285,
31819,292,2022/4/15 16:10,583,181,402,
31820,292,2022/4/15 16:20,612,197,415,
31821,292,2022/4/15 16:30,643,213,430,
31822,292,2022/4/15 16:40,644,178,466,
31823,292,2022/4/15 16:50,696,207,489,
31824,292,2022/4/15 17:00,1030,265,765,
31825,292,2022/4/15 17:10,1189,193,996,
31826,292,2022/4/15 17:20,1011,307,704,
31827,292,2022/4/15 17:30,1343,494,849,
31828,292,2022/4/15 17:40,1973,426,1547,
31829,292,2022/4/15 17:50,1204,514,690,
31830,292,2022/4/15 18:00,1209,415,794,
31831,292,2022/4/15 18:10,1538,431,1107,
31832,292,2022/4/15 18:20,1153,489,664,
31833,292,2022/4/15 18:30,715,415,300,
31834,292,2022/4/15 18:40,704,412,292,
31835,292,2022/4/15 18:50,698,423,275,
31836,292,2022/4/15 19:00,698,313,385,
31837,292,2022/4/15 19:10,579,294,285,
31838,292,2022/4/15 19:20,570,209,361,
31839,292,2022/4/15 19:30,465,145,320,
31840,292,2022/4/15 19:40,369,123,246,
31841,292,2022/4/15 19:50,354,125,229,
31842,292,2022/4/15 20:00,563,120,443,
31843,292,2022/4/15 20:10,553,107,446,
31844,292,2022/4/15 20:20,470,111,359,
31845,292,2022/4/15 20:30,577,94,483,
31846,292,2022/4/15 20:40,561,112,449,
31847,292,2022/4/15 20:50,430,92,338,
31848,292,2022/4/15 21:00,554,107,447,
31849,292,2022/4/15 21:10,585,110,475,
31850,292,2022/4/15 21:20,368,89,279,
31851,292,2022/4/15 21:30,328,92,236,
31852,292,2022/4/15 21:40,310,95,215,
31853,292,2022/4/15 21:50,285,92,193,
31854,292,2022/4/15 22:00,346,83,263,
31855,292,2022/4/15 22:10,182,83,99,
31856,292,2022/4/15 22:20,64,75,-11,
31857,292,2022/4/15 22:30,42,89,-47,
31858,292,2022/4/15 22:40,24,55,-31,
31859,292,2022/4/15 22:50,2,31,-29,
31860,296,2022/4/15 5:00,0,1,-1,
31861,296,2022/4/15 5:10,0,1,-1,
31862,296,2022/4/15 5:20,0,1,-1,
31863,296,2022/4/15 5:30,4,1,3,
31864,296,2022/4/15 5:40,7,1,6,
31865,296,2022/4/15 5:50,16,1,15,
31866,296,2022/4/15 6:00,24,6,18,
31867,296,2022/4/15 6:10,23,23,0,
31868,296,2022/4/15 6:20,33,31,2,
31869,296,2022/4/15 6:30,38,38,0,
31870,296,2022/4/15 6:40,41,63,-22,
31871,296,2022/4/15 6:50,59,70,-11,
31872,296,2022/4/15 7:00,76,85,-9,
31873,296,2022/4/15 7:10,88,89,-1,
31874,296,2022/4/15 7:20,146,98,48,
31875,296,2022/4/15 7:30,187,124,63,
31876,296,2022/4/15 7:40,214,111,103,
31877,296,2022/4/15 7:50,248,192,56,
31878,296,2022/4/15 8:00,277,321,-44,
31879,296,2022/4/15 8:10,282,492,-210,
31880,296,2022/4/15 8:20,276,432,-156,
31881,296,2022/4/15 8:30,256,478,-222,
31882,296,2022/4/15 8:40,217,608,-391,
31883,296,2022/4/15 8:50,187,584,-397,
31884,296,2022/4/15 9:00,149,428,-279,
31885,296,2022/4/15 9:10,120,379,-259,
31886,296,2022/4/15 9:20,75,344,-269,
31887,296,2022/4/15 9:30,67,299,-232,
31888,296,2022/4/15 9:40,59,182,-123,
31889,296,2022/4/15 9:50,50,211,-161,
31890,296,2022/4/15 10:00,43,121,-78,
31891,296,2022/4/15 10:10,42,152,-110,
31892,296,2022/4/15 10:20,45,118,-73,
31893,296,2022/4/15 10:30,44,110,-66,
31894,296,2022/4/15 10:40,42,124,-82,
31895,296,2022/4/15 10:50,43,88,-45,
31896,296,2022/4/15 11:00,43,96,-53,
31897,296,2022/4/15 11:10,44,111,-67,
31898,296,2022/4/15 11:20,42,112,-70,
31899,296,2022/4/15 11:30,47,112,-65,
31900,296,2022/4/15 11:40,49,111,-62,
31901,296,2022/4/15 11:50,43,87,-44,
31902,296,2022/4/15 12:00,45,90,-45,
31903,296,2022/4/15 12:10,44,111,-67,
31904,296,2022/4/15 12:20,44,112,-68,
31905,296,2022/4/15 12:30,45,104,-59,
31906,296,2022/4/15 12:40,45,104,-59,
31907,296,2022/4/15 12:50,43,106,-63,
31908,296,2022/4/15 13:00,45,105,-60,
31909,296,2022/4/15 13:10,48,105,-57,
31910,296,2022/4/15 13:20,43,122,-79,
31911,296,2022/4/15 13:30,51,87,-36,
31912,296,2022/4/15 13:40,49,105,-56,
31913,296,2022/4/15 13:50,42,105,-63,
31914,296,2022/4/15 14:00,55,108,-53,
31915,296,2022/4/15 14:10,62,103,-41,
31916,296,2022/4/15 14:20,47,108,-61,
31917,296,2022/4/15 14:30,51,102,-51,
31918,296,2022/4/15 14:40,49,101,-52,
31919,296,2022/4/15 14:50,60,107,-47,
31920,296,2022/4/15 15:00,62,112,-50,
31921,296,2022/4/15 15:10,69,98,-29,
31922,296,2022/4/15 15:20,71,112,-41,
31923,296,2022/4/15 15:30,85,106,-21,
31924,296,2022/4/15 15:40,79,101,-22,
31925,296,2022/4/15 15:50,69,102,-33,
31926,296,2022/4/15 16:00,79,103,-24,
31927,296,2022/4/15 16:10,110,112,-2,
31928,296,2022/4/15 16:20,129,104,25,
31929,296,2022/4/15 16:30,180,106,74,
31930,296,2022/4/15 16:40,198,122,76,
31931,296,2022/4/15 16:50,197,120,77,
31932,296,2022/4/15 17:00,347,106,241,
31933,296,2022/4/15 17:10,431,108,323,
31934,296,2022/4/15 17:20,330,142,188,
31935,296,2022/4/15 17:30,699,115,584,
31936,296,2022/4/15 17:40,660,144,516,
31937,296,2022/4/15 17:50,337,196,141,
31938,296,2022/4/15 18:00,465,222,243,
31939,296,2022/4/15 18:10,660,153,507,
31940,296,2022/4/15 18:20,354,223,131,
31941,296,2022/4/15 18:30,269,214,55,
31942,296,2022/4/15 18:40,275,191,84,
31943,296,2022/4/15 18:50,225,171,54,
31944,296,2022/4/15 19:00,177,128,49,
31945,296,2022/4/15 19:10,179,110,69,
31946,296,2022/4/15 19:20,130,107,23,
31947,296,2022/4/15 19:30,94,105,-11,
31948,296,2022/4/15 19:40,83,113,-30,
31949,296,2022/4/15 19:50,65,107,-42,
31950,296,2022/4/15 20:00,69,74,-5,
31951,296,2022/4/15 20:10,77,94,-17,
31952,296,2022/4/15 20:20,57,98,-41,
31953,296,2022/4/15 20:30,54,77,-23,
31954,296,2022/4/15 20:40,61,78,-17,
31955,296,2022/4/15 20:50,60,66,-6,
31956,296,2022/4/15 21:00,45,92,-47,
31957,296,2022/4/15 21:10,74,62,12,
31958,296,2022/4/15 21:20,46,81,-35,
31959,296,2022/4/15 21:30,44,82,-38,
31960,296,2022/4/15 21:40,47,77,-30,
31961,296,2022/4/15 21:50,41,72,-31,
31962,296,2022/4/15 22:00,31,77,-46,
31963,296,2022/4/15 22:10,41,65,-24,
31964,296,2022/4/15 22:20,30,81,-51,
31965,296,2022/4/15 22:30,26,67,-41,
31966,296,2022/4/15 22:40,14,47,-33,
31967,296,2022/4/15 22:50,0,25,-25,
31968,309,2022/4/15 5:00,0,1,-1,
31969,309,2022/4/15 5:10,0,1,-1,
31970,309,2022/4/15 5:20,1,1,0,
31971,309,2022/4/15 5:30,3,1,2,
31972,309,2022/4/15 5:40,7,1,6,
31973,309,2022/4/15 5:50,17,16,1,
31974,309,2022/4/15 6:00,16,37,-21,
31975,309,2022/4/15 6:10,22,32,-10,
31976,309,2022/4/15 6:20,27,65,-38,
31977,309,2022/4/15 6:30,32,96,-64,
31978,309,2022/4/15 6:40,35,104,-69,
31979,309,2022/4/15 6:50,43,125,-82,
31980,309,2022/4/15 7:00,52,190,-138,
31981,309,2022/4/15 7:10,73,318,-245,
31982,309,2022/4/15 7:20,78,253,-175,
31983,309,2022/4/15 7:30,115,298,-183,
31984,309,2022/4/15 7:40,154,324,-170,
31985,309,2022/4/15 7:50,195,436,-241,
31986,309,2022/4/15 8:00,236,401,-165,
31987,309,2022/4/15 8:10,226,1126,-900,
31988,309,2022/4/15 8:20,248,1597,-1349,
31989,309,2022/4/15 8:30,239,2009,-1770,
31990,309,2022/4/15 8:40,233,2604,-2371,
31991,309,2022/4/15 8:50,184,2706,-2522,
31992,309,2022/4/15 9:00,188,1865,-1677,
31993,309,2022/4/15 9:10,161,1676,-1515,
31994,309,2022/4/15 9:20,148,1199,-1051,
31995,309,2022/4/15 9:30,115,469,-354,
31996,309,2022/4/15 9:40,92,409,-317,
31997,309,2022/4/15 9:50,80,317,-237,
31998,309,2022/4/15 10:00,69,283,-214,
31999,309,2022/4/15 10:10,76,213,-137,
32000,309,2022/4/15 10:20,76,218,-142,
32001,309,2022/4/15 10:30,66,192,-126,
32002,309,2022/4/15 10:40,70,159,-89,
32003,309,2022/4/15 10:50,66,122,-56,
32004,309,2022/4/15 11:00,75,120,-45,
32005,309,2022/4/15 11:10,76,143,-67,
32006,309,2022/4/15 11:20,87,112,-25,
32007,309,2022/4/15 11:30,126,110,16,
32008,309,2022/4/15 11:40,74,120,-46,
32009,309,2022/4/15 11:50,78,108,-30,
32010,309,2022/4/15 12:00,93,108,-15,
32011,309,2022/4/15 12:10,129,109,20,
32012,309,2022/4/15 12:20,96,171,-75,
32013,309,2022/4/15 12:30,86,171,-85,
32014,309,2022/4/15 12:40,85,170,-85,
32015,309,2022/4/15 12:50,73,192,-119,
32016,309,2022/4/15 13:00,85,192,-107,
32017,309,2022/4/15 13:10,109,192,-83,
32018,309,2022/4/15 13:20,103,192,-89,
32019,309,2022/4/15 13:30,136,139,-3,
32020,309,2022/4/15 13:40,141,181,-40,
32021,309,2022/4/15 13:50,128,152,-24,
32022,309,2022/4/15 14:00,136,117,19,
32023,309,2022/4/15 14:10,150,117,33,
32024,309,2022/4/15 14:20,135,124,11,
32025,309,2022/4/15 14:30,128,127,1,
32026,309,2022/4/15 14:40,155,133,22,
32027,309,2022/4/15 14:50,170,129,41,
32028,309,2022/4/15 15:00,163,111,52,
32029,309,2022/4/15 15:10,183,121,62,
32030,309,2022/4/15 15:20,175,108,67,
32031,309,2022/4/15 15:30,195,109,86,
32032,309,2022/4/15 15:40,207,105,102,
32033,309,2022/4/15 15:50,192,109,83,
32034,309,2022/4/15 16:00,228,115,113,
32035,309,2022/4/15 16:10,271,109,162,
32036,309,2022/4/15 16:20,268,109,159,
32037,309,2022/4/15 16:30,335,110,225,
32038,309,2022/4/15 16:40,336,109,227,
32039,309,2022/4/15 16:50,305,115,190,
32040,309,2022/4/15 17:00,376,108,268,
32041,309,2022/4/15 17:10,642,183,459,
32042,309,2022/4/15 17:20,574,177,397,
32043,309,2022/4/15 17:30,654,254,400,
32044,309,2022/4/15 17:40,1352,254,1098,
32045,309,2022/4/15 17:50,830,298,532,
32046,309,2022/4/15 18:00,800,320,480,
32047,309,2022/4/15 18:10,1352,333,1019,
32048,309,2022/4/15 18:20,1038,318,720,
32049,309,2022/4/15 18:30,657,329,328,
32050,309,2022/4/15 18:40,643,321,322,
32051,309,2022/4/15 18:50,553,234,319,
32052,309,2022/4/15 19:00,377,181,196,
32053,309,2022/4/15 19:10,329,149,180,
32054,309,2022/4/15 19:20,269,121,148,
32055,309,2022/4/15 19:30,231,120,111,
32056,309,2022/4/15 19:40,228,112,116,
32057,309,2022/4/15 19:50,217,104,113,
32058,309,2022/4/15 20:00,262,103,159,
32059,309,2022/4/15 20:10,228,102,126,
32060,309,2022/4/15 20:20,211,95,116,
32061,309,2022/4/15 20:30,226,98,128,
32062,309,2022/4/15 20:40,238,90,148,
32063,309,2022/4/15 20:50,225,79,146,
32064,309,2022/4/15 21:00,267,77,190,
32065,309,2022/4/15 21:10,268,82,186,
32066,309,2022/4/15 21:20,210,87,123,
32067,309,2022/4/15 21:30,245,79,166,
32068,309,2022/4/15 21:40,210,77,133,
32069,309,2022/4/15 21:50,134,73,61,
32070,309,2022/4/15 22:00,599,75,524,
32071,309,2022/4/15 22:10,271,68,203,
32072,309,2022/4/15 22:20,71,70,1,
32073,309,2022/4/15 22:30,40,63,-23,
32074,309,2022/4/15 22:40,26,62,-36,
32075,309,2022/4/15 22:50,12,42,-30,
32076,311,2022/4/15 5:00,0,1,-1,
32077,311,2022/4/15 5:10,0,1,-1,
32078,311,2022/4/15 5:20,0,1,-1,
32079,311,2022/4/15 5:30,3,1,2,
32080,311,2022/4/15 5:40,6,1,5,
32081,311,2022/4/15 5:50,10,6,4,
32082,311,2022/4/15 6:00,12,6,6,
32083,311,2022/4/15 6:10,17,15,2,
32084,311,2022/4/15 6:20,20,28,-8,
32085,311,2022/4/15 6:30,26,62,-36,
32086,311,2022/4/15 6:40,30,75,-45,
32087,311,2022/4/15 6:50,37,71,-34,
32088,311,2022/4/15 7:00,43,78,-35,
32089,311,2022/4/15 7:10,58,109,-51,
32090,311,2022/4/15 7:20,69,98,-29,
32091,311,2022/4/15 7:30,85,109,-24,
32092,311,2022/4/15 7:40,96,152,-56,
32093,311,2022/4/15 7:50,151,233,-82,
32094,311,2022/4/15 8:00,194,517,-323,
32095,311,2022/4/15 8:10,199,551,-352,
32096,311,2022/4/15 8:20,206,586,-380,
32097,311,2022/4/15 8:30,212,1886,-1674,
32098,311,2022/4/15 8:40,162,2787,-2625,
32099,311,2022/4/15 8:50,128,2847,-2719,
32100,311,2022/4/15 9:00,100,1531,-1431,
32101,311,2022/4/15 9:10,74,569,-495,
32102,311,2022/4/15 9:20,72,472,-400,
32103,311,2022/4/15 9:30,65,498,-433,
32104,311,2022/4/15 9:40,58,333,-275,
32105,311,2022/4/15 9:50,52,296,-244,
32106,311,2022/4/15 10:00,57,154,-97,
32107,311,2022/4/15 10:10,47,110,-63,
32108,311,2022/4/15 10:20,47,126,-79,
32109,311,2022/4/15 10:30,42,108,-66,
32110,311,2022/4/15 10:40,45,114,-69,
32111,311,2022/4/15 10:50,42,100,-58,
32112,311,2022/4/15 11:00,45,121,-76,
32113,311,2022/4/15 11:10,48,104,-56,
32114,311,2022/4/15 11:20,44,108,-64,
32115,311,2022/4/15 11:30,58,120,-62,
32116,311,2022/4/15 11:40,65,125,-60,
32117,311,2022/4/15 11:50,69,104,-35,
32118,311,2022/4/15 12:00,67,126,-59,
32119,311,2022/4/15 12:10,76,86,-10,
32120,311,2022/4/15 12:20,80,114,-34,
32121,311,2022/4/15 12:30,82,112,-30,
32122,311,2022/4/15 12:40,86,110,-24,
32123,311,2022/4/15 12:50,85,124,-39,
32124,311,2022/4/15 13:00,114,120,-6,
32125,311,2022/4/15 13:10,114,127,-13,
32126,311,2022/4/15 13:20,133,121,12,
32127,311,2022/4/15 13:30,113,112,1,
32128,311,2022/4/15 13:40,128,122,6,
32129,311,2022/4/15 13:50,90,126,-36,
32130,311,2022/4/15 14:00,85,103,-18,
32131,311,2022/4/15 14:10,110,124,-14,
32132,311,2022/4/15 14:20,84,127,-43,
32133,311,2022/4/15 14:30,86,114,-28,
32134,311,2022/4/15 14:40,113,87,26,
32135,311,2022/4/15 14:50,97,112,-15,
32136,311,2022/4/15 15:00,111,106,5,
32137,311,2022/4/15 15:10,133,107,26,
32138,311,2022/4/15 15:20,135,107,28,
32139,311,2022/4/15 15:30,138,86,52,
32140,311,2022/4/15 15:40,137,108,29,
32141,311,2022/4/15 15:50,150,103,47,
32142,311,2022/4/15 16:00,164,100,64,
32143,311,2022/4/15 16:10,174,103,71,
32144,311,2022/4/15 16:20,176,102,74,
32145,311,2022/4/15 16:30,208,97,111,
32146,311,2022/4/15 16:40,214,117,97,
32147,311,2022/4/15 16:50,256,106,150,
32148,311,2022/4/15 17:00,325,124,201,
32149,311,2022/4/15 17:10,571,123,448,
32150,311,2022/4/15 17:20,425,132,293,
32151,311,2022/4/15 17:30,699,110,589,
32152,311,2022/4/15 17:40,1194,181,1013,
32153,311,2022/4/15 17:50,794,191,603,
32154,311,2022/4/15 18:00,790,181,609,
32155,311,2022/4/15 18:10,1366,208,1158,
32156,311,2022/4/15 18:20,1024,213,811,
32157,311,2022/4/15 18:30,662,199,463,
32158,311,2022/4/15 18:40,641,213,428,
32159,311,2022/4/15 18:50,460,199,261,
32160,311,2022/4/15 19:00,331,185,146,
32161,311,2022/4/15 19:10,317,128,189,
32162,311,2022/4/15 19:20,273,105,168,
32163,311,2022/4/15 19:30,240,104,136,
32164,311,2022/4/15 19:40,236,104,132,
32165,311,2022/4/15 19:50,214,110,104,
32166,311,2022/4/15 20:00,214,98,116,
32167,311,2022/4/15 20:10,204,91,113,
32168,311,2022/4/15 20:20,207,83,124,
32169,311,2022/4/15 20:30,223,77,146,
32170,311,2022/4/15 20:40,195,79,116,
32171,311,2022/4/15 20:50,197,77,120,
32172,311,2022/4/15 21:00,195,75,120,
32173,311,2022/4/15 21:10,194,73,121,
32174,311,2022/4/15 21:20,165,75,90,
32175,311,2022/4/15 21:30,164,71,93,
32176,311,2022/4/15 21:40,110,73,37,
32177,311,2022/4/15 21:50,105,70,35,
32178,311,2022/4/15 22:00,64,72,-8,
32179,311,2022/4/15 22:10,39,62,-23,
32180,311,2022/4/15 22:20,28,64,-36,
32181,311,2022/4/15 22:30,22,60,-38,
32182,311,2022/4/15 22:40,13,51,-38,
32183,311,2022/4/15 22:50,7,40,-33,
32184,294,2022/4/15 5:00,0,1,-1,
32185,294,2022/4/15 5:10,0,1,-1,
32186,294,2022/4/15 5:20,0,1,-1,
32187,294,2022/4/15 5:30,7,1,6,
32188,294,2022/4/15 5:40,16,1,15,
32189,294,2022/4/15 5:50,25,5,20,
32190,294,2022/4/15 6:00,30,25,5,
32191,294,2022/4/15 6:10,32,23,9,
32192,294,2022/4/15 6:20,50,48,2,
32193,294,2022/4/15 6:30,58,106,-48,
32194,294,2022/4/15 6:40,75,84,-9,
32195,294,2022/4/15 6:50,185,119,66,
32196,294,2022/4/15 7:00,235,153,82,
32197,294,2022/4/15 7:10,284,195,89,
32198,294,2022/4/15 7:20,331,331,0,
32199,294,2022/4/15 7:30,478,431,47,
32200,294,2022/4/15 7:40,632,418,214,
32201,294,2022/4/15 7:50,723,638,85,
32202,294,2022/4/15 8:00,694,1545,-851,
32203,294,2022/4/15 8:10,750,1701,-951,
32204,294,2022/4/15 8:20,678,2780,-2102,
32205,294,2022/4/15 8:30,723,4101,-3378,
32206,294,2022/4/15 8:40,600,4189,-3589,
32207,294,2022/4/15 8:50,387,2770,-2383,
32208,294,2022/4/15 9:00,340,1941,-1601,
32209,294,2022/4/15 9:10,277,1959,-1682,
32210,294,2022/4/15 9:20,250,569,-319,
32211,294,2022/4/15 9:30,202,514,-312,
32212,294,2022/4/15 9:40,167,420,-253,
32213,294,2022/4/15 9:50,120,331,-211,
32214,294,2022/4/15 10:00,109,208,-99,
32215,294,2022/4/15 10:10,79,151,-72,
32216,294,2022/4/15 10:20,72,125,-53,
32217,294,2022/4/15 10:30,69,133,-64,
32218,294,2022/4/15 10:40,69,105,-36,
32219,294,2022/4/15 10:50,71,104,-33,
32220,294,2022/4/15 11:00,66,103,-37,
32221,294,2022/4/15 11:10,74,123,-49,
32222,294,2022/4/15 11:20,79,118,-39,
32223,294,2022/4/15 11:30,73,117,-44,
32224,294,2022/4/15 11:40,73,101,-28,
32225,294,2022/4/15 11:50,81,105,-24,
32226,294,2022/4/15 12:00,96,121,-25,
32227,294,2022/4/15 12:10,96,109,-13,
32228,294,2022/4/15 12:20,132,111,21,
32229,294,2022/4/15 12:30,114,108,6,
32230,294,2022/4/15 12:40,109,116,-7,
32231,294,2022/4/15 12:50,92,117,-25,
32232,294,2022/4/15 13:00,109,104,5,
32233,294,2022/4/15 13:10,101,120,-19,
32234,294,2022/4/15 13:20,93,133,-40,
32235,294,2022/4/15 13:30,85,125,-40,
32236,294,2022/4/15 13:40,89,120,-31,
32237,294,2022/4/15 13:50,99,109,-10,
32238,294,2022/4/15 14:00,99,110,-11,
32239,294,2022/4/15 14:10,89,115,-26,
32240,294,2022/4/15 14:20,133,110,23,
32241,294,2022/4/15 14:30,88,104,-16,
32242,294,2022/4/15 14:40,129,120,9,
32243,294,2022/4/15 14:50,128,108,20,
32244,294,2022/4/15 15:00,129,123,6,
32245,294,2022/4/15 15:10,149,120,29,
32246,294,2022/4/15 15:20,175,100,75,
32247,294,2022/4/15 15:30,167,110,57,
32248,294,2022/4/15 15:40,173,110,63,
32249,294,2022/4/15 15:50,165,108,57,
32250,294,2022/4/15 16:00,203,104,99,
32251,294,2022/4/15 16:10,223,121,102,
32252,294,2022/4/15 16:20,227,121,106,
32253,294,2022/4/15 16:30,269,128,141,
32254,294,2022/4/15 16:40,319,144,175,
32255,294,2022/4/15 16:50,463,152,311,
32256,294,2022/4/15 17:00,654,149,505,
32257,294,2022/4/15 17:10,1032,182,850,
32258,294,2022/4/15 17:20,1150,195,955,
32259,294,2022/4/15 17:30,825,282,543,
32260,294,2022/4/15 17:40,1349,318,1031,
32261,294,2022/4/15 17:50,1606,323,1283,
32262,294,2022/4/15 18:00,1194,327,867,
32263,294,2022/4/15 18:10,1190,347,843,
32264,294,2022/4/15 18:20,1612,328,1284,
32265,294,2022/4/15 18:30,1198,534,664,
32266,294,2022/4/15 18:40,1035,434,601,
32267,294,2022/4/15 18:50,712,301,411,
32268,294,2022/4/15 19:00,641,348,293,
32269,294,2022/4/15 19:10,610,257,353,
32270,294,2022/4/15 19:20,432,215,217,
32271,294,2022/4/15 19:30,349,150,199,
32272,294,2022/4/15 19:40,270,143,127,
32273,294,2022/4/15 19:50,247,117,130,
32274,294,2022/4/15 20:00,256,110,146,
32275,294,2022/4/15 20:10,241,124,117,
32276,294,2022/4/15 20:20,259,126,133,
32277,294,2022/4/15 20:30,208,107,101,
32278,294,2022/4/15 20:40,214,125,89,
32279,294,2022/4/15 20:50,211,125,86,
32280,294,2022/4/15 21:00,219,109,110,
32281,294,2022/4/15 21:10,274,120,154,
32282,294,2022/4/15 21:20,219,110,109,
32283,294,2022/4/15 21:30,167,124,43,
32284,294,2022/4/15 21:40,116,125,-9,
32285,294,2022/4/15 21:50,74,120,-46,
32286,294,2022/4/15 22:00,66,110,-44,
32287,294,2022/4/15 22:10,59,110,-51,
32288,294,2022/4/15 22:20,42,107,-65,
32289,294,2022/4/15 22:30,28,111,-83,
32290,294,2022/4/15 22:40,16,93,-77,
32291,294,2022/4/15 22:50,12,51,-39,
32292,291,2022/4/15 5:00,0,1,-1,
32293,291,2022/4/15 5:10,0,1,-1,
32294,291,2022/4/15 5:20,0,1,-1,
32295,291,2022/4/15 5:30,5,1,4,
32296,291,2022/4/15 5:40,16,1,15,
32297,291,2022/4/15 5:50,18,21,-3,
32298,291,2022/4/15 6:00,23,30,-7,
32299,291,2022/4/15 6:10,32,44,-12,
32300,291,2022/4/15 6:20,31,60,-29,
32301,291,2022/4/15 6:30,41,72,-31,
32302,291,2022/4/15 6:40,67,106,-39,
32303,291,2022/4/15 6:50,97,105,-8,
32304,291,2022/4/15 7:00,165,87,78,
32305,291,2022/4/15 7:10,186,171,15,
32306,291,2022/4/15 7:20,228,481,-253,
32307,291,2022/4/15 7:30,269,561,-292,
32308,291,2022/4/15 7:40,285,1601,-1316,
32309,291,2022/4/15 7:50,344,4810,-4466,
32310,291,2022/4/15 8:00,351,4484,-4133,
32311,291,2022/4/15 8:10,339,8563,-8224,
32312,291,2022/4/15 8:20,351,11144,-10793,
32313,291,2022/4/15 8:30,315,10364,-10049,
32314,291,2022/4/15 8:40,257,11306,-11049,
32315,291,2022/4/15 8:50,213,9387,-9174,
32316,291,2022/4/15 9:00,193,9047,-8854,
32317,291,2022/4/15 9:10,166,7238,-7072,
32318,291,2022/4/15 9:20,138,5451,-5313,
32319,291,2022/4/15 9:30,107,2587,-2480,
32320,291,2022/4/15 9:40,94,2619,-2525,
32321,291,2022/4/15 9:50,77,1678,-1601,
32322,291,2022/4/15 10:00,72,428,-356,
32323,291,2022/4/15 10:10,72,375,-303,
32324,291,2022/4/15 10:20,73,196,-123,
32325,291,2022/4/15 10:30,76,176,-100,
32326,291,2022/4/15 10:40,103,146,-43,
32327,291,2022/4/15 10:50,81,142,-61,
32328,291,2022/4/15 11:00,91,120,-29,
32329,291,2022/4/15 11:10,144,114,30,
32330,291,2022/4/15 11:20,140,123,17,
32331,291,2022/4/15 11:30,163,122,41,
32332,291,2022/4/15 11:40,205,124,81,
32333,291,2022/4/15 11:50,188,122,66,
32334,291,2022/4/15 12:00,194,116,78,
32335,291,2022/4/15 12:10,212,120,92,
32336,291,2022/4/15 12:20,196,109,87,
32337,291,2022/4/15 12:30,183,159,24,
32338,291,2022/4/15 12:40,156,185,-29,
32339,291,2022/4/15 12:50,162,159,3,
32340,291,2022/4/15 13:00,137,152,-15,
32341,291,2022/4/15 13:10,174,116,58,
32342,291,2022/4/15 13:20,154,159,-5,
32343,291,2022/4/15 13:30,133,181,-48,
32344,291,2022/4/15 13:40,129,192,-63,
32345,291,2022/4/15 13:50,138,139,-1,
32346,291,2022/4/15 14:00,137,115,22,
32347,291,2022/4/15 14:10,156,133,23,
32348,291,2022/4/15 14:20,145,108,37,
32349,291,2022/4/15 14:30,163,108,55,
32350,291,2022/4/15 14:40,169,109,60,
32351,291,2022/4/15 14:50,175,102,73,
32352,291,2022/4/15 15:00,177,86,91,
32353,291,2022/4/15 15:10,213,114,99,
32354,291,2022/4/15 15:20,198,120,78,
32355,291,2022/4/15 15:30,202,102,100,
32356,291,2022/4/15 15:40,196,125,71,
32357,291,2022/4/15 15:50,198,106,92,
32358,291,2022/4/15 16:00,230,100,130,
32359,291,2022/4/15 16:10,268,118,150,
32360,291,2022/4/15 16:20,262,121,141,
32361,291,2022/4/15 16:30,548,106,442,
32362,291,2022/4/15 16:40,610,116,494,
32363,291,2022/4/15 16:50,664,120,544,
32364,291,2022/4/15 17:00,1212,120,1092,
32365,291,2022/4/15 17:10,3336,108,3228,
32366,291,2022/4/15 17:20,2474,108,2366,
32367,291,2022/4/15 17:30,3283,178,3105,
32368,291,2022/4/15 17:40,3565,136,3429,
32369,291,2022/4/15 17:50,3412,158,3254,
32370,291,2022/4/15 18:00,3314,180,3134,
32371,291,2022/4/15 18:10,3504,214,3290,
32372,291,2022/4/15 18:20,3423,179,3244,
32373,291,2022/4/15 18:30,3062,192,2870,
32374,291,2022/4/15 18:40,2522,208,2314,
32375,291,2022/4/15 18:50,1981,178,1803,
32376,291,2022/4/15 19:00,1564,168,1396,
32377,291,2022/4/15 19:10,1193,109,1084,
32378,291,2022/4/15 19:20,1156,117,1039,
32379,291,2022/4/15 19:30,718,124,594,
32380,291,2022/4/15 19:40,650,106,544,
32381,291,2022/4/15 19:50,573,101,472,
32382,291,2022/4/15 20:00,555,113,442,
32383,291,2022/4/15 20:10,673,107,566,
32384,291,2022/4/15 20:20,583,101,482,
32385,291,2022/4/15 20:30,431,107,324,
32386,291,2022/4/15 20:40,362,107,255,
32387,291,2022/4/15 20:50,269,95,174,
32388,291,2022/4/15 21:00,277,95,182,
32389,291,2022/4/15 21:10,343,105,238,
32390,291,2022/4/15 21:20,275,97,178,
32391,291,2022/4/15 21:30,214,89,125,
32392,291,2022/4/15 21:40,200,95,105,
32393,291,2022/4/15 21:50,102,95,7,
32394,291,2022/4/15 22:00,77,92,-15,
32395,291,2022/4/15 22:10,77,83,-6,
32396,291,2022/4/15 22:20,45,73,-28,
32397,291,2022/4/15 22:30,29,72,-43,
32398,291,2022/4/15 22:40,22,72,-50,
32399,291,2022/4/15 22:50,15,55,-40,
32400,295,2022/4/15 5:00,0,1,-1,
32401,295,2022/4/15 5:10,0,1,-1,
32402,295,2022/4/15 5:20,0,1,-1,
32403,295,2022/4/15 5:30,7,1,6,
32404,295,2022/4/15 5:40,19,1,18,
32405,295,2022/4/15 5:50,17,1,16,
32406,295,2022/4/15 6:00,26,13,13,
32407,295,2022/4/15 6:10,37,19,18,
32408,295,2022/4/15 6:20,36,38,-2,
32409,295,2022/4/15 6:30,58,51,7,
32410,295,2022/4/15 6:40,82,62,20,
32411,295,2022/4/15 6:50,179,72,107,
32412,295,2022/4/15 7:00,197,76,121,
32413,295,2022/4/15 7:10,247,104,143,
32414,295,2022/4/15 7:20,282,109,173,
32415,295,2022/4/15 7:30,354,125,229,
32416,295,2022/4/15 7:40,445,196,249,
32417,295,2022/4/15 7:50,601,428,173,
32418,295,2022/4/15 8:00,633,519,114,
32419,295,2022/4/15 8:10,592,1480,-888,
32420,295,2022/4/15 8:20,392,1709,-1317,
32421,295,2022/4/15 8:30,336,1656,-1320,
32422,295,2022/4/15 8:40,280,2995,-2715,
32423,295,2022/4/15 8:50,284,2342,-2058,
32424,295,2022/4/15 9:00,232,1530,-1298,
32425,295,2022/4/15 9:10,200,1140,-940,
32426,295,2022/4/15 9:20,162,408,-246,
32427,295,2022/4/15 9:30,85,318,-233,
32428,295,2022/4/15 9:40,73,282,-209,
32429,295,2022/4/15 9:50,58,182,-124,
32430,295,2022/4/15 10:00,50,110,-60,
32431,295,2022/4/15 10:10,47,124,-77,
32432,295,2022/4/15 10:20,47,103,-56,
32433,295,2022/4/15 10:30,47,111,-64,
32434,295,2022/4/15 10:40,45,109,-64,
32435,295,2022/4/15 10:50,40,75,-35,
32436,295,2022/4/15 11:00,42,98,-56,
32437,295,2022/4/15 11:10,41,99,-58,
32438,295,2022/4/15 11:20,45,108,-63,
32439,295,2022/4/15 11:30,44,104,-60,
32440,295,2022/4/15 11:40,45,92,-47,
32441,295,2022/4/15 11:50,46,75,-29,
32442,295,2022/4/15 12:00,48,105,-57,
32443,295,2022/4/15 12:10,45,108,-63,
32444,295,2022/4/15 12:20,45,105,-60,
32445,295,2022/4/15 12:30,51,105,-54,
32446,295,2022/4/15 12:40,49,90,-41,
32447,295,2022/4/15 12:50,47,110,-63,
32448,295,2022/4/15 13:00,45,103,-58,
32449,295,2022/4/15 13:10,50,109,-59,
32450,295,2022/4/15 13:20,56,103,-47,
32451,295,2022/4/15 13:30,48,111,-63,
32452,295,2022/4/15 13:40,46,91,-45,
32453,295,2022/4/15 13:50,45,107,-62,
32454,295,2022/4/15 14:00,42,112,-70,
32455,295,2022/4/15 14:10,43,103,-60,
32456,295,2022/4/15 14:20,45,102,-57,
32457,295,2022/4/15 14:30,45,97,-52,
32458,295,2022/4/15 14:40,46,114,-68,
32459,295,2022/4/15 14:50,44,101,-57,
32460,295,2022/4/15 15:00,48,112,-64,
32461,295,2022/4/15 15:10,50,110,-60,
32462,295,2022/4/15 15:20,52,93,-41,
32463,295,2022/4/15 15:30,53,119,-66,
32464,295,2022/4/15 15:40,49,119,-70,
32465,295,2022/4/15 15:50,47,112,-65,
32466,295,2022/4/15 16:00,52,107,-55,
32467,295,2022/4/15 16:10,70,104,-34,
32468,295,2022/4/15 16:20,75,105,-30,
32469,295,2022/4/15 16:30,132,122,10,
32470,295,2022/4/15 16:40,180,125,55,
32471,295,2022/4/15 16:50,142,125,17,
32472,295,2022/4/15 17:00,275,132,143,
32473,295,2022/4/15 17:10,710,154,556,
32474,295,2022/4/15 17:20,581,144,437,
32475,295,2022/4/15 17:30,702,224,478,
32476,295,2022/4/15 17:40,1976,217,1759,
32477,295,2022/4/15 17:50,1204,298,906,
32478,295,2022/4/15 18:00,1024,196,828,
32479,295,2022/4/15 18:10,1587,335,1252,
32480,295,2022/4/15 18:20,1202,335,867,
32481,295,2022/4/15 18:30,798,257,541,
32482,295,2022/4/15 18:40,610,335,275,
32483,295,2022/4/15 18:50,312,336,-24,
32484,295,2022/4/15 19:00,273,256,17,
32485,295,2022/4/15 19:10,271,181,90,
32486,295,2022/4/15 19:20,206,140,66,
32487,295,2022/4/15 19:30,158,109,49,
32488,295,2022/4/15 19:40,143,112,31,
32489,295,2022/4/15 19:50,98,122,-24,
32490,295,2022/4/15 20:00,90,106,-16,
32491,295,2022/4/15 20:10,129,91,38,
32492,295,2022/4/15 20:20,79,104,-25,
32493,295,2022/4/15 20:30,74,115,-41,
32494,295,2022/4/15 20:40,133,107,26,
32495,295,2022/4/15 20:50,77,110,-33,
32496,295,2022/4/15 21:00,67,106,-39,
32497,295,2022/4/15 21:10,78,103,-25,
32498,295,2022/4/15 21:20,64,107,-43,
32499,295,2022/4/15 21:30,41,112,-71,
32500,295,2022/4/15 21:40,42,104,-62,
32501,295,2022/4/15 21:50,35,103,-68,
32502,295,2022/4/15 22:00,25,103,-78,
32503,295,2022/4/15 22:10,26,98,-72,
32504,295,2022/4/15 22:20,23,90,-67,
32505,295,2022/4/15 22:30,13,90,-77,
32506,295,2022/4/15 22:40,11,77,-66,
32507,295,2022/4/15 22:50,7,66,-59,
32508,308,2022/4/15 5:00,0,1,-1,
32509,308,2022/4/15 5:10,0,1,-1,
32510,308,2022/4/15 5:20,1,1,0,
32511,308,2022/4/15 5:30,14,1,13,
32512,308,2022/4/15 5:40,19,1,18,
32513,308,2022/4/15 5:50,19,1,18,
32514,308,2022/4/15 6:00,28,8,20,
32515,308,2022/4/15 6:10,37,8,29,
32516,308,2022/4/15 6:20,41,38,3,
32517,308,2022/4/15 6:30,57,49,8,
32518,308,2022/4/15 6:40,65,48,17,
32519,308,2022/4/15 6:50,96,72,24,
32520,308,2022/4/15 7:00,157,77,80,
32521,308,2022/4/15 7:10,213,105,108,
32522,308,2022/4/15 7:20,267,115,152,
32523,308,2022/4/15 7:30,279,182,97,
32524,308,2022/4/15 7:40,327,170,157,
32525,308,2022/4/15 7:50,342,128,214,
32526,308,2022/4/15 8:00,359,117,242,
32527,308,2022/4/15 8:10,285,110,175,
32528,308,2022/4/15 8:20,253,125,128,
32529,308,2022/4/15 8:30,238,123,115,
32530,308,2022/4/15 8:40,192,114,78,
32531,308,2022/4/15 8:50,176,98,78,
32532,308,2022/4/15 9:00,140,104,36,
32533,308,2022/4/15 9:10,100,103,-3,
32534,308,2022/4/15 9:20,74,99,-25,
32535,308,2022/4/15 9:30,52,91,-39,
32536,308,2022/4/15 9:40,46,76,-30,
32537,308,2022/4/15 9:50,41,76,-35,
32538,308,2022/4/15 10:00,38,93,-55,
32539,308,2022/4/15 10:10,33,74,-41,
32540,308,2022/4/15 10:20,27,74,-47,
32541,308,2022/4/15 10:30,27,74,-47,
32542,308,2022/4/15 10:40,31,73,-42,
32543,308,2022/4/15 10:50,30,75,-45,
32544,308,2022/4/15 11:00,28,83,-55,
32545,308,2022/4/15 11:10,31,75,-44,
32546,308,2022/4/15 11:20,33,66,-33,
32547,308,2022/4/15 11:30,31,60,-29,
32548,308,2022/4/15 11:40,32,82,-50,
32549,308,2022/4/15 11:50,24,77,-53,
32550,308,2022/4/15 12:00,31,76,-45,
32551,308,2022/4/15 12:10,39,71,-32,
32552,308,2022/4/15 12:20,38,71,-33,
32553,308,2022/4/15 12:30,33,76,-43,
32554,308,2022/4/15 12:40,38,77,-39,
32555,308,2022/4/15 12:50,38,77,-39,
32556,308,2022/4/15 13:00,33,76,-43,
32557,308,2022/4/15 13:10,29,69,-40,
32558,308,2022/4/15 13:20,28,77,-49,
32559,308,2022/4/15 13:30,31,80,-49,
32560,308,2022/4/15 13:40,29,91,-62,
32561,308,2022/4/15 13:50,30,77,-47,
32562,308,2022/4/15 14:00,32,64,-32,
32563,308,2022/4/15 14:10,29,83,-54,
32564,308,2022/4/15 14:20,31,73,-42,
32565,308,2022/4/15 14:30,34,84,-50,
32566,308,2022/4/15 14:40,30,87,-57,
32567,308,2022/4/15 14:50,39,82,-43,
32568,308,2022/4/15 15:00,57,68,-11,
32569,308,2022/4/15 15:10,71,81,-10,
32570,308,2022/4/15 15:20,67,113,-46,
32571,308,2022/4/15 15:30,40,87,-47,
32572,308,2022/4/15 15:40,38,104,-66,
32573,308,2022/4/15 15:50,39,99,-60,
32574,308,2022/4/15 16:00,36,93,-57,
32575,308,2022/4/15 16:10,38,75,-37,
32576,308,2022/4/15 16:20,37,108,-71,
32577,308,2022/4/15 16:30,42,104,-62,
32578,308,2022/4/15 16:40,43,108,-65,
32579,308,2022/4/15 16:50,50,98,-48,
32580,308,2022/4/15 17:00,49,99,-50,
32581,308,2022/4/15 17:10,71,114,-43,
32582,308,2022/4/15 17:20,71,109,-38,
32583,308,2022/4/15 17:30,59,105,-46,
32584,308,2022/4/15 17:40,96,108,-12,
32585,308,2022/4/15 17:50,77,183,-106,
32586,308,2022/4/15 18:00,77,184,-107,
32587,308,2022/4/15 18:10,92,121,-29,
32588,308,2022/4/15 18:20,67,184,-117,
32589,308,2022/4/15 18:30,56,181,-125,
32590,308,2022/4/15 18:40,43,150,-107,
32591,308,2022/4/15 18:50,37,120,-83,
32592,308,2022/4/15 19:00,37,138,-101,
32593,308,2022/4/15 19:10,36,110,-74,
32594,308,2022/4/15 19:20,25,124,-99,
32595,308,2022/4/15 19:30,28,105,-77,
32596,308,2022/4/15 19:40,27,110,-83,
32597,308,2022/4/15 19:50,26,110,-84,
32598,308,2022/4/15 20:00,28,77,-49,
32599,308,2022/4/15 20:10,25,95,-70,
32600,308,2022/4/15 20:20,27,106,-79,
32601,308,2022/4/15 20:30,24,94,-70,
32602,308,2022/4/15 20:40,23,82,-59,
32603,308,2022/4/15 20:50,24,93,-69,
32604,308,2022/4/15 21:00,26,78,-52,
32605,308,2022/4/15 21:10,23,80,-57,
32606,308,2022/4/15 21:20,29,78,-49,
32607,308,2022/4/15 21:30,23,95,-72,
32608,308,2022/4/15 21:40,22,89,-67,
32609,308,2022/4/15 21:50,16,82,-66,
32610,308,2022/4/15 22:00,13,76,-63,
32611,308,2022/4/15 22:10,14,86,-72,
32612,308,2022/4/15 22:20,13,73,-60,
32613,308,2022/4/15 22:30,6,71,-65,
32614,308,2022/4/15 22:40,3,59,-56,
32615,308,2022/4/15 22:50,2,64,-62,
32616,299,2022/4/15 5:00,0,1,-1,
32617,299,2022/4/15 5:10,3,1,2,
32618,299,2022/4/15 5:20,17,1,16,
32619,299,2022/4/15 5:30,28,1,27,
32620,299,2022/4/15 5:40,33,1,32,
32621,299,2022/4/15 5:50,44,1,43,
32622,299,2022/4/15 6:00,87,1,86,
32623,299,2022/4/15 6:10,95,75,20,
32624,299,2022/4/15 6:20,186,71,115,
32625,299,2022/4/15 6:30,244,84,160,
32626,299,2022/4/15 6:40,345,105,240,
32627,299,2022/4/15 6:50,581,112,469,
32628,299,2022/4/15 7:00,664,146,518,
32629,299,2022/4/15 7:10,686,150,536,
32630,299,2022/4/15 7:20,1163,179,984,
32631,299,2022/4/15 7:30,1205,297,908,
32632,299,2022/4/15 7:40,1625,326,1299,
32633,299,2022/4/15 7:50,1971,530,1441,
32634,299,2022/4/15 8:00,1988,432,1556,
32635,299,2022/4/15 8:10,1626,533,1093,
32636,299,2022/4/15 8:20,1594,440,1154,
32637,299,2022/4/15 8:30,1383,431,952,
32638,299,2022/4/15 8:40,1198,521,677,
32639,299,2022/4/15 8:50,1164,433,731,
32640,299,2022/4/15 9:00,857,322,535,
32641,299,2022/4/15 9:10,724,283,441,
32642,299,2022/4/15 9:20,589,177,412,
32643,299,2022/4/15 9:30,365,177,188,
32644,299,2022/4/15 9:40,294,207,87,
32645,299,2022/4/15 9:50,278,169,109,
32646,299,2022/4/15 10:00,229,192,37,
32647,299,2022/4/15 10:10,212,146,66,
32648,299,2022/4/15 10:20,207,128,79,
32649,299,2022/4/15 10:30,175,159,16,
32650,299,2022/4/15 10:40,174,126,48,
32651,299,2022/4/15 10:50,153,183,-30,
32652,299,2022/4/15 11:00,131,139,-8,
32653,299,2022/4/15 11:10,160,192,-32,
32654,299,2022/4/15 11:20,147,185,-38,
32655,299,2022/4/15 11:30,148,171,-23,
32656,299,2022/4/15 11:40,169,117,52,
32657,299,2022/4/15 11:50,176,172,4,
32658,299,2022/4/15 12:00,206,152,54,
32659,299,2022/4/15 12:10,217,192,25,
32660,299,2022/4/15 12:20,226,181,45,
32661,299,2022/4/15 12:30,228,146,82,
32662,299,2022/4/15 12:40,218,128,90,
32663,299,2022/4/15 12:50,214,146,68,
32664,299,2022/4/15 13:00,222,192,30,
32665,299,2022/4/15 13:10,213,192,21,
32666,299,2022/4/15 13:20,208,146,62,
32667,299,2022/4/15 13:30,195,121,74,
32668,299,2022/4/15 13:40,205,192,13,
32669,299,2022/4/15 13:50,206,171,35,
32670,299,2022/4/15 14:00,185,180,5,
32671,299,2022/4/15 14:10,190,198,-8,
32672,299,2022/4/15 14:20,190,185,5,
32673,299,2022/4/15 14:30,179,116,63,
32674,299,2022/4/15 14:40,176,179,-3,
32675,299,2022/4/15 14:50,162,214,-52,
32676,299,2022/4/15 15:00,184,197,-13,
32677,299,2022/4/15 15:10,208,208,0,
32678,299,2022/4/15 15:20,196,146,50,
32679,299,2022/4/15 15:30,199,233,-34,
32680,299,2022/4/15 15:40,195,284,-89,
32681,299,2022/4/15 15:50,182,185,-3,
32682,299,2022/4/15 16:00,199,282,-83,
32683,299,2022/4/15 16:10,218,310,-92,
32684,299,2022/4/15 16:20,212,267,-55,
32685,299,2022/4/15 16:30,255,298,-43,
32686,299,2022/4/15 16:40,261,332,-71,
32687,299,2022/4/15 16:50,270,380,-110,
32688,299,2022/4/15 17:00,269,375,-106,
32689,299,2022/4/15 17:10,347,513,-166,
32690,299,2022/4/15 17:20,335,410,-75,
32691,299,2022/4/15 17:30,319,570,-251,
32692,299,2022/4/15 17:40,378,562,-184,
32693,299,2022/4/15 17:50,370,1557,-1187,
32694,299,2022/4/15 18:00,378,1565,-1187,
32695,299,2022/4/15 18:10,580,1113,-533,
32696,299,2022/4/15 18:20,555,1874,-1319,
32697,299,2022/4/15 18:30,457,1733,-1276,
32698,299,2022/4/15 18:40,351,1862,-1511,
32699,299,2022/4/15 18:50,332,1137,-805,
32700,299,2022/4/15 19:00,275,609,-334,
32701,299,2022/4/15 19:10,267,1171,-904,
32702,299,2022/4/15 19:20,226,429,-203,
32703,299,2022/4/15 19:30,196,492,-296,
32704,299,2022/4/15 19:40,205,380,-175,
32705,299,2022/4/15 19:50,178,321,-143,
32706,299,2022/4/15 20:00,176,335,-159,
32707,299,2022/4/15 20:10,204,206,-2,
32708,299,2022/4/15 20:20,204,268,-64,
32709,299,2022/4/15 20:30,171,285,-114,
32710,299,2022/4/15 20:40,168,196,-28,
32711,299,2022/4/15 20:50,182,190,-8,
32712,299,2022/4/15 21:00,179,233,-54,
32713,299,2022/4/15 21:10,163,234,-71,
32714,299,2022/4/15 21:20,138,179,-41,
32715,299,2022/4/15 21:30,89,215,-126,
32716,299,2022/4/15 21:40,84,178,-94,
32717,299,2022/4/15 21:50,70,179,-109,
32718,299,2022/4/15 22:00,60,149,-89,
32719,299,2022/4/15 22:10,56,145,-89,
32720,299,2022/4/15 22:20,30,187,-157,
32721,299,2022/4/15 22:30,23,122,-99,
32722,299,2022/4/15 22:40,23,122,-99,
32723,299,2022/4/15 22:50,15,132,-117,
32724,312,2022/4/15 5:00,0,1,-1,
32725,312,2022/4/15 5:10,2,1,1,
32726,312,2022/4/15 5:20,10,1,9,
32727,312,2022/4/15 5:30,13,1,12,
32728,312,2022/4/15 5:40,11,1,10,
32729,312,2022/4/15 5:50,20,1,19,
32730,312,2022/4/15 6:00,26,1,25,
32731,312,2022/4/15 6:10,26,17,9,
32732,312,2022/4/15 6:20,28,13,15,
32733,312,2022/4/15 6:30,33,22,11,
32734,312,2022/4/15 6:40,56,25,31,
32735,312,2022/4/15 6:50,81,40,41,
32736,312,2022/4/15 7:00,95,55,40,
32737,312,2022/4/15 7:10,109,73,36,
32738,312,2022/4/15 7:20,223,83,140,
32739,312,2022/4/15 7:30,190,88,102,
32740,312,2022/4/15 7:40,268,122,146,
32741,312,2022/4/15 7:50,351,109,242,
32742,312,2022/4/15 8:00,326,171,155,
32743,312,2022/4/15 8:10,337,146,191,
32744,312,2022/4/15 8:20,281,125,156,
32745,312,2022/4/15 8:30,266,119,147,
32746,312,2022/4/15 8:40,216,110,106,
32747,312,2022/4/15 8:50,181,100,81,
32748,312,2022/4/15 9:00,98,98,0,
32749,312,2022/4/15 9:10,64,81,-17,
32750,312,2022/4/15 9:20,49,73,-24,
32751,312,2022/4/15 9:30,38,70,-32,
32752,312,2022/4/15 9:40,37,62,-25,
32753,312,2022/4/15 9:50,28,50,-22,
32754,312,2022/4/15 10:00,30,60,-30,
32755,312,2022/4/15 10:10,30,50,-20,
32756,312,2022/4/15 10:20,29,51,-22,
32757,312,2022/4/15 10:30,25,39,-14,
32758,312,2022/4/15 10:40,26,49,-23,
32759,312,2022/4/15 10:50,27,45,-18,
32760,312,2022/4/15 11:00,25,41,-16,
32761,312,2022/4/15 11:10,24,38,-14,
32762,312,2022/4/15 11:20,22,38,-16,
32763,312,2022/4/15 11:30,17,45,-28,
32764,312,2022/4/15 11:40,23,45,-22,
32765,312,2022/4/15 11:50,23,46,-23,
32766,312,2022/4/15 12:00,27,41,-14,
32767,312,2022/4/15 12:10,26,39,-13,
32768,312,2022/4/15 12:20,26,41,-15,
32769,312,2022/4/15 12:30,29,51,-22,
32770,312,2022/4/15 12:40,24,51,-27,
32771,312,2022/4/15 12:50,28,51,-23,
32772,312,2022/4/15 13:00,26,46,-20,
32773,312,2022/4/15 13:10,22,45,-23,
32774,312,2022/4/15 13:20,25,55,-30,
32775,312,2022/4/15 13:30,24,58,-34,
32776,312,2022/4/15 13:40,27,51,-24,
32777,312,2022/4/15 13:50,26,51,-25,
32778,312,2022/4/15 14:00,24,40,-16,
32779,312,2022/4/15 14:10,24,54,-30,
32780,312,2022/4/15 14:20,23,51,-28,
32781,312,2022/4/15 14:30,24,54,-30,
32782,312,2022/4/15 14:40,25,57,-32,
32783,312,2022/4/15 14:50,23,48,-25,
32784,312,2022/4/15 15:00,23,51,-28,
32785,312,2022/4/15 15:10,25,64,-39,
32786,312,2022/4/15 15:20,24,61,-37,
32787,312,2022/4/15 15:30,27,50,-23,
32788,312,2022/4/15 15:40,27,54,-27,
32789,312,2022/4/15 15:50,27,67,-40,
32790,312,2022/4/15 16:00,26,62,-36,
32791,312,2022/4/15 16:10,26,62,-36,
32792,312,2022/4/15 16:20,28,63,-35,
32793,312,2022/4/15 16:30,34,65,-31,
32794,312,2022/4/15 16:40,38,65,-27,
32795,312,2022/4/15 16:50,47,68,-21,
32796,312,2022/4/15 17:00,47,71,-24,
32797,312,2022/4/15 17:10,92,67,25,
32798,312,2022/4/15 17:20,74,77,-3,
32799,312,2022/4/15 17:30,73,96,-23,
32800,312,2022/4/15 17:40,175,101,74,
32801,312,2022/4/15 17:50,180,104,76,
32802,312,2022/4/15 18:00,132,101,31,
32803,312,2022/4/15 18:10,143,122,21,
32804,312,2022/4/15 18:20,93,121,-28,
32805,312,2022/4/15 18:30,70,119,-49,
32806,312,2022/4/15 18:40,45,110,-65,
32807,312,2022/4/15 18:50,36,109,-73,
32808,312,2022/4/15 19:00,30,106,-76,
32809,312,2022/4/15 19:10,24,123,-99,
32810,312,2022/4/15 19:20,26,110,-84,
32811,312,2022/4/15 19:30,25,112,-87,
32812,312,2022/4/15 19:40,21,82,-61,
32813,312,2022/4/15 19:50,16,94,-78,
32814,312,2022/4/15 20:00,19,78,-59,
32815,312,2022/4/15 20:10,22,73,-51,
32816,312,2022/4/15 20:20,18,72,-54,
32817,312,2022/4/15 20:30,19,71,-52,
32818,312,2022/4/15 20:40,18,74,-56,
32819,312,2022/4/15 20:50,15,69,-54,
32820,312,2022/4/15 21:00,17,75,-58,
32821,312,2022/4/15 21:10,16,71,-55,
32822,312,2022/4/15 21:20,17,77,-60,
32823,312,2022/4/15 21:30,15,71,-56,
32824,312,2022/4/15 21:40,14,62,-48,
32825,312,2022/4/15 21:50,12,74,-62,
32826,312,2022/4/15 22:00,12,70,-58,
32827,312,2022/4/15 22:10,12,63,-51,
32828,312,2022/4/15 22:20,5,63,-58,
32829,312,2022/4/15 22:30,3,63,-60,
32830,312,2022/4/15 22:40,2,61,-59,
32831,312,2022/4/15 22:50,1,52,-51,
32832,297,2022/4/15 5:00,0,1,-1,
32833,297,2022/4/15 5:10,0,1,-1,
32834,297,2022/4/15 5:20,0,1,-1,
32835,297,2022/4/15 5:30,1,1,0,
32836,297,2022/4/15 5:40,8,1,7,
32837,297,2022/4/15 5:50,31,1,30,
32838,297,2022/4/15 6:00,88,2,86,
32839,297,2022/4/15 6:10,275,48,227,
32840,297,2022/4/15 6:20,248,38,210,
32841,297,2022/4/15 6:30,589,56,533,
32842,297,2022/4/15 6:40,645,67,578,
32843,297,2022/4/15 6:50,840,76,764,
32844,297,2022/4/15 7:00,1191,98,1093,
32845,297,2022/4/15 7:10,1599,119,1480,
32846,297,2022/4/15 7:20,1986,178,1808,
32847,297,2022/4/15 7:30,2534,233,2301,
32848,297,2022/4/15 7:40,3463,300,3163,
32849,297,2022/4/15 7:50,3407,328,3079,
32850,297,2022/4/15 8:00,3438,502,2936,
32851,297,2022/4/15 8:10,3442,378,3064,
32852,297,2022/4/15 8:20,3383,379,3004,
32853,297,2022/4/15 8:30,3087,536,2551,
32854,297,2022/4/15 8:40,1982,502,1480,
32855,297,2022/4/15 8:50,1626,321,1305,
32856,297,2022/4/15 9:00,1365,233,1132,
32857,297,2022/4/15 9:10,1019,169,850,
32858,297,2022/4/15 9:20,684,105,579,
32859,297,2022/4/15 9:30,580,128,452,
32860,297,2022/4/15 9:40,321,109,212,
32861,297,2022/4/15 9:50,327,109,218,
32862,297,2022/4/15 10:00,260,105,155,
32863,297,2022/4/15 10:10,225,113,112,
32864,297,2022/4/15 10:20,212,125,87,
32865,297,2022/4/15 10:30,157,99,58,
32866,297,2022/4/15 10:40,176,122,54,
32867,297,2022/4/15 10:50,174,124,50,
32868,297,2022/4/15 11:00,129,121,8,
32869,297,2022/4/15 11:10,149,98,51,
32870,297,2022/4/15 11:20,127,107,20,
32871,297,2022/4/15 11:30,132,106,26,
32872,297,2022/4/15 11:40,176,117,59,
32873,297,2022/4/15 11:50,174,106,68,
32874,297,2022/4/15 12:00,163,124,39,
32875,297,2022/4/15 12:10,195,122,73,
32876,297,2022/4/15 12:20,184,103,81,
32877,297,2022/4/15 12:30,192,102,90,
32878,297,2022/4/15 12:40,179,109,70,
32879,297,2022/4/15 12:50,175,108,67,
32880,297,2022/4/15 13:00,184,120,64,
32881,297,2022/4/15 13:10,170,104,66,
32882,297,2022/4/15 13:20,179,105,74,
32883,297,2022/4/15 13:30,139,111,28,
32884,297,2022/4/15 13:40,130,112,18,
32885,297,2022/4/15 13:50,136,109,27,
32886,297,2022/4/15 14:00,102,108,-6,
32887,297,2022/4/15 14:10,72,124,-52,
32888,297,2022/4/15 14:20,97,120,-23,
32889,297,2022/4/15 14:30,82,121,-39,
32890,297,2022/4/15 14:40,72,110,-38,
32891,297,2022/4/15 14:50,91,117,-26,
32892,297,2022/4/15 15:00,73,139,-66,
32893,297,2022/4/15 15:10,93,123,-30,
32894,297,2022/4/15 15:20,89,185,-96,
32895,297,2022/4/15 15:30,78,226,-148,
32896,297,2022/4/15 15:40,76,181,-105,
32897,297,2022/4/15 15:50,79,181,-102,
32898,297,2022/4/15 16:00,78,216,-138,
32899,297,2022/4/15 16:10,144,179,-35,
32900,297,2022/4/15 16:20,150,177,-27,
32901,297,2022/4/15 16:30,168,268,-100,
32902,297,2022/4/15 16:40,225,346,-121,
32903,297,2022/4/15 16:50,202,298,-96,
32904,297,2022/4/15 17:00,235,497,-262,
32905,297,2022/4/15 17:10,292,505,-213,
32906,297,2022/4/15 17:20,459,432,27,
32907,297,2022/4/15 17:30,330,568,-238,
32908,297,2022/4/15 17:40,328,616,-288,
32909,297,2022/4/15 17:50,374,620,-246,
32910,297,2022/4/15 18:00,545,1428,-883,
32911,297,2022/4/15 18:10,432,1671,-1239,
32912,297,2022/4/15 18:20,316,1714,-1398,
32913,297,2022/4/15 18:30,241,1783,-1542,
32914,297,2022/4/15 18:40,225,2447,-2222,
32915,297,2022/4/15 18:50,174,2485,-2311,
32916,297,2022/4/15 19:00,114,2790,-2676,
32917,297,2022/4/15 19:10,130,2029,-1899,
32918,297,2022/4/15 19:20,77,1703,-1626,
32919,297,2022/4/15 19:30,64,1129,-1065,
32920,297,2022/4/15 19:40,63,455,-392,
32921,297,2022/4/15 19:50,47,399,-352,
32922,297,2022/4/15 20:00,54,432,-378,
32923,297,2022/4/15 20:10,64,534,-470,
32924,297,2022/4/15 20:20,49,318,-269,
32925,297,2022/4/15 20:30,46,527,-481,
32926,297,2022/4/15 20:40,45,432,-387,
32927,297,2022/4/15 20:50,42,327,-285,
32928,297,2022/4/15 21:00,46,234,-188,
32929,297,2022/4/15 21:10,41,378,-337,
32930,297,2022/4/15 21:20,41,324,-283,
32931,297,2022/4/15 21:30,39,327,-288,
32932,297,2022/4/15 21:40,35,329,-294,
32933,297,2022/4/15 21:50,29,300,-271,
32934,297,2022/4/15 22:00,24,260,-236,
32935,297,2022/4/15 22:10,24,229,-205,
32936,297,2022/4/15 22:20,16,183,-167,
32937,297,2022/4/15 22:30,8,150,-142,
32938,297,2022/4/15 22:40,9,150,-141,
32939,297,2022/4/15 22:50,5,127,-122,
32940,302,2022/4/15 5:00,0,1,-1,
32941,302,2022/4/15 5:10,0,1,-1,
32942,302,2022/4/15 5:20,0,1,-1,
32943,302,2022/4/15 5:30,0,1,-1,
32944,302,2022/4/15 5:40,2,1,1,
32945,302,2022/4/15 5:50,55,1,54,
32946,302,2022/4/15 6:00,57,11,46,
32947,302,2022/4/15 6:10,77,5,72,
32948,302,2022/4/15 6:20,150,45,105,
32949,302,2022/4/15 6:30,236,51,185,
32950,302,2022/4/15 6:40,239,50,189,
32951,302,2022/4/15 6:50,281,47,234,
32952,302,2022/4/15 7:00,447,81,366,
32953,302,2022/4/15 7:10,622,85,537,
32954,302,2022/4/15 7:20,757,107,650,
32955,302,2022/4/15 7:30,1392,120,1272,
32956,302,2022/4/15 7:40,1366,104,1262,
32957,302,2022/4/15 7:50,1976,182,1794,
32958,302,2022/4/15 8:00,1990,119,1871,
32959,302,2022/4/15 8:10,1621,110,1511,
32960,302,2022/4/15 8:20,1209,116,1093,
32961,302,2022/4/15 8:30,1035,113,922,
32962,302,2022/4/15 8:40,684,109,575,
32963,302,2022/4/15 8:50,663,122,541,
32964,302,2022/4/15 9:00,440,105,335,
32965,302,2022/4/15 9:10,273,106,167,
32966,302,2022/4/15 9:20,212,104,108,
32967,302,2022/4/15 9:30,143,90,53,
32968,302,2022/4/15 9:40,78,96,-18,
32969,302,2022/4/15 9:50,97,90,7,
32970,302,2022/4/15 10:00,73,73,0,
32971,302,2022/4/15 10:10,49,106,-57,
32972,302,2022/4/15 10:20,52,76,-24,
32973,302,2022/4/15 10:30,46,87,-41,
32974,302,2022/4/15 10:40,46,96,-50,
32975,302,2022/4/15 10:50,44,93,-49,
32976,302,2022/4/15 11:00,48,81,-33,
32977,302,2022/4/15 11:10,40,62,-22,
32978,302,2022/4/15 11:20,43,93,-50,
32979,302,2022/4/15 11:30,43,92,-49,
32980,302,2022/4/15 11:40,45,93,-48,
32981,302,2022/4/15 11:50,56,93,-37,
32982,302,2022/4/15 12:00,45,83,-38,
32983,302,2022/4/15 12:10,53,89,-36,
32984,302,2022/4/15 12:20,77,93,-16,
32985,302,2022/4/15 12:30,48,90,-42,
32986,302,2022/4/15 12:40,47,103,-56,
32987,302,2022/4/15 12:50,46,91,-45,
32988,302,2022/4/15 13:00,44,92,-48,
32989,302,2022/4/15 13:10,44,98,-54,
32990,302,2022/4/15 13:20,47,101,-54,
32991,302,2022/4/15 13:30,42,100,-58,
32992,302,2022/4/15 13:40,43,98,-55,
32993,302,2022/4/15 13:50,37,90,-53,
32994,302,2022/4/15 14:00,36,97,-61,
32995,302,2022/4/15 14:10,43,104,-61,
32996,302,2022/4/15 14:20,41,99,-58,
32997,302,2022/4/15 14:30,31,107,-76,
32998,302,2022/4/15 14:40,35,101,-66,
32999,302,2022/4/15 14:50,33,90,-57,
33000,302,2022/4/15 15:00,42,109,-67,
33001,302,2022/4/15 15:10,41,107,-66,
33002,302,2022/4/15 15:20,40,125,-85,
33003,302,2022/4/15 15:30,41,104,-63,
33004,302,2022/4/15 15:40,39,105,-66,
33005,302,2022/4/15 15:50,37,121,-84,
33006,302,2022/4/15 16:00,44,122,-78,
33007,302,2022/4/15 16:10,50,119,-69,
33008,302,2022/4/15 16:20,44,126,-82,
33009,302,2022/4/15 16:30,110,116,-6,
33010,302,2022/4/15 16:40,74,111,-37,
33011,302,2022/4/15 16:50,63,152,-89,
33012,302,2022/4/15 17:00,180,181,-1,
33013,302,2022/4/15 17:10,88,222,-134,
33014,302,2022/4/15 17:20,79,150,-71,
33015,302,2022/4/15 17:30,132,266,-134,
33016,302,2022/4/15 17:40,137,320,-183,
33017,302,2022/4/15 17:50,198,415,-217,
33018,302,2022/4/15 18:00,82,519,-437,
33019,302,2022/4/15 18:10,67,572,-505,
33020,302,2022/4/15 18:20,68,574,-506,
33021,302,2022/4/15 18:30,45,412,-367,
33022,302,2022/4/15 18:40,39,625,-586,
33023,302,2022/4/15 18:50,38,576,-538,
33024,302,2022/4/15 19:00,36,479,-443,
33025,302,2022/4/15 19:10,27,405,-378,
33026,302,2022/4/15 19:20,28,422,-394,
33027,302,2022/4/15 19:30,28,502,-474,
33028,302,2022/4/15 19:40,24,328,-304,
33029,302,2022/4/15 19:50,31,271,-240,
33030,302,2022/4/15 20:00,31,197,-166,
33031,302,2022/4/15 20:10,31,197,-166,
33032,302,2022/4/15 20:20,29,184,-155,
33033,302,2022/4/15 20:30,26,192,-166,
33034,302,2022/4/15 20:40,28,198,-170,
33035,302,2022/4/15 20:50,26,178,-152,
33036,302,2022/4/15 21:00,25,111,-86,
33037,302,2022/4/15 21:10,25,159,-134,
33038,302,2022/4/15 21:20,25,159,-134,
33039,302,2022/4/15 21:30,21,181,-160,
33040,302,2022/4/15 21:40,20,104,-84,
33041,302,2022/4/15 21:50,18,111,-93,
33042,302,2022/4/15 22:00,20,110,-90,
33043,302,2022/4/15 22:10,6,112,-106,
33044,302,2022/4/15 22:20,3,121,-118,
33045,302,2022/4/15 22:30,2,107,-105,
33046,302,2022/4/15 22:40,1,102,-101,
33047,302,2022/4/15 22:50,1,113,-112,
33048,301,2022/4/15 5:00,0,1,-1,
33049,301,2022/4/15 5:10,0,1,-1,
33050,301,2022/4/15 5:20,0,1,-1,
33051,301,2022/4/15 5:30,0,1,-1,
33052,301,2022/4/15 5:40,30,1,29,
33053,301,2022/4/15 5:50,63,1,62,
33054,301,2022/4/15 6:00,60,5,55,
33055,301,2022/4/15 6:10,98,2,96,
33056,301,2022/4/15 6:20,97,38,59,
33057,301,2022/4/15 6:30,152,25,127,
33058,301,2022/4/15 6:40,225,38,187,
33059,301,2022/4/15 6:50,326,59,267,
33060,301,2022/4/15 7:00,480,68,412,
33061,301,2022/4/15 7:10,834,69,765,
33062,301,2022/4/15 7:20,1176,86,1090,
33063,301,2022/4/15 7:30,1388,110,1278,
33064,301,2022/4/15 7:40,1940,90,1850,
33065,301,2022/4/15 7:50,1598,124,1474,
33066,301,2022/4/15 8:00,1984,111,1873,
33067,301,2022/4/15 8:10,1596,96,1500,
33068,301,2022/4/15 8:20,1152,105,1047,
33069,301,2022/4/15 8:30,843,123,720,
33070,301,2022/4/15 8:40,664,121,543,
33071,301,2022/4/15 8:50,341,104,237,
33072,301,2022/4/15 9:00,276,109,167,
33073,301,2022/4/15 9:10,216,105,111,
33074,301,2022/4/15 9:20,172,104,68,
33075,301,2022/4/15 9:30,96,93,3,
33076,301,2022/4/15 9:40,79,103,-24,
33077,301,2022/4/15 9:50,65,99,-34,
33078,301,2022/4/15 10:00,60,92,-32,
33079,301,2022/4/15 10:10,45,108,-63,
33080,301,2022/4/15 10:20,51,104,-53,
33081,301,2022/4/15 10:30,52,87,-35,
33082,301,2022/4/15 10:40,44,112,-68,
33083,301,2022/4/15 10:50,55,93,-38,
33084,301,2022/4/15 11:00,37,93,-56,
33085,301,2022/4/15 11:10,31,87,-56,
33086,301,2022/4/15 11:20,42,113,-71,
33087,301,2022/4/15 11:30,42,93,-51,
33088,301,2022/4/15 11:40,41,96,-55,
33089,301,2022/4/15 11:50,52,87,-35,
33090,301,2022/4/15 12:00,53,76,-23,
33091,301,2022/4/15 12:10,56,92,-36,
33092,301,2022/4/15 12:20,64,87,-23,
33093,301,2022/4/15 12:30,50,99,-49,
33094,301,2022/4/15 12:40,56,91,-35,
33095,301,2022/4/15 12:50,53,90,-37,
33096,301,2022/4/15 13:00,40,73,-33,
33097,301,2022/4/15 13:10,54,97,-43,
33098,301,2022/4/15 13:20,40,91,-51,
33099,301,2022/4/15 13:30,45,108,-63,
33100,301,2022/4/15 13:40,41,90,-49,
33101,301,2022/4/15 13:50,44,90,-46,
33102,301,2022/4/15 14:00,40,77,-37,
33103,301,2022/4/15 14:10,38,92,-54,
33104,301,2022/4/15 14:20,38,96,-58,
33105,301,2022/4/15 14:30,37,101,-64,
33106,301,2022/4/15 14:40,32,96,-64,
33107,301,2022/4/15 14:50,45,73,-28,
33108,301,2022/4/15 15:00,42,92,-50,
33109,301,2022/4/15 15:10,40,105,-65,
33110,301,2022/4/15 15:20,40,106,-66,
33111,301,2022/4/15 15:30,47,102,-55,
33112,301,2022/4/15 15:40,43,87,-44,
33113,301,2022/4/15 15:50,44,86,-42,
33114,301,2022/4/15 16:00,39,98,-59,
33115,301,2022/4/15 16:10,40,93,-53,
33116,301,2022/4/15 16:20,52,114,-62,
33117,301,2022/4/15 16:30,71,106,-35,
33118,301,2022/4/15 16:40,73,125,-52,
33119,301,2022/4/15 16:50,164,120,44,
33120,301,2022/4/15 17:00,125,178,-53,
33121,301,2022/4/15 17:10,121,118,3,
33122,301,2022/4/15 17:20,173,150,23,
33123,301,2022/4/15 17:30,134,221,-87,
33124,301,2022/4/15 17:40,95,318,-223,
33125,301,2022/4/15 17:50,76,318,-242,
33126,301,2022/4/15 18:00,58,432,-374,
33127,301,2022/4/15 18:10,60,422,-362,
33128,301,2022/4/15 18:20,45,430,-385,
33129,301,2022/4/15 18:30,39,418,-379,
33130,301,2022/4/15 18:40,35,491,-456,
33131,301,2022/4/15 18:50,24,490,-466,
33132,301,2022/4/15 19:00,30,432,-402,
33133,301,2022/4/15 19:10,24,493,-469,
33134,301,2022/4/15 19:20,29,437,-408,
33135,301,2022/4/15 19:30,28,379,-351,
33136,301,2022/4/15 19:40,26,319,-293,
33137,301,2022/4/15 19:50,27,336,-309,
33138,301,2022/4/15 20:00,28,257,-229,
33139,301,2022/4/15 20:10,23,178,-155,
33140,301,2022/4/15 20:20,25,171,-146,
33141,301,2022/4/15 20:30,25,180,-155,
33142,301,2022/4/15 20:40,27,226,-199,
33143,301,2022/4/15 20:50,18,119,-101,
33144,301,2022/4/15 21:00,21,179,-158,
33145,301,2022/4/15 21:10,21,193,-172,
33146,301,2022/4/15 21:20,17,181,-164,
33147,301,2022/4/15 21:30,13,108,-95,
33148,301,2022/4/15 21:40,12,153,-141,
33149,301,2022/4/15 21:50,12,128,-116,
33150,301,2022/4/15 22:00,8,121,-113,
33151,301,2022/4/15 22:10,4,106,-102,
33152,301,2022/4/15 22:20,2,120,-118,
33153,301,2022/4/15 22:30,2,102,-100,
33154,301,2022/4/15 22:40,2,87,-85,
33155,301,2022/4/15 22:50,2,110,-108,
33156,293,2022/4/15 5:00,0,1,-1,
33157,293,2022/4/15 5:10,0,1,-1,
33158,293,2022/4/15 5:20,0,1,-1,
33159,293,2022/4/15 5:30,0,1,-1,
33160,293,2022/4/15 5:40,21,1,20,
33161,293,2022/4/15 5:50,25,2,23,
33162,293,2022/4/15 6:00,17,1,16,
33163,293,2022/4/15 6:10,29,11,18,
33164,293,2022/4/15 6:20,32,21,11,
33165,293,2022/4/15 6:30,36,55,-19,
33166,293,2022/4/15 6:40,51,47,4,
33167,293,2022/4/15 6:50,57,37,20,
33168,293,2022/4/15 7:00,56,60,-4,
33169,293,2022/4/15 7:10,114,51,63,
33170,293,2022/4/15 7:20,190,87,103,
33171,293,2022/4/15 7:30,189,92,97,
33172,293,2022/4/15 7:40,232,97,135,
33173,293,2022/4/15 7:50,222,100,122,
33174,293,2022/4/15 8:00,223,105,118,
33175,293,2022/4/15 8:10,147,97,50,
33176,293,2022/4/15 8:20,96,111,-15,
33177,293,2022/4/15 8:30,70,111,-41,
33178,293,2022/4/15 8:40,79,100,-21,
33179,293,2022/4/15 8:50,33,105,-72,
33180,293,2022/4/15 9:00,43,83,-40,
33181,293,2022/4/15 9:10,35,65,-30,
33182,293,2022/4/15 9:20,24,97,-73,
33183,293,2022/4/15 9:30,31,101,-70,
33184,293,2022/4/15 9:40,23,62,-39,
33185,293,2022/4/15 9:50,25,92,-67,
33186,293,2022/4/15 10:00,24,77,-53,
33187,293,2022/4/15 10:10,21,68,-47,
33188,293,2022/4/15 10:20,25,76,-51,
33189,293,2022/4/15 10:30,27,81,-54,
33190,293,2022/4/15 10:40,26,62,-36,
33191,293,2022/4/15 10:50,22,63,-41,
33192,293,2022/4/15 11:00,25,66,-41,
33193,293,2022/4/15 11:10,24,62,-38,
33194,293,2022/4/15 11:20,23,57,-34,
33195,293,2022/4/15 11:30,21,57,-36,
33196,293,2022/4/15 11:40,26,60,-34,
33197,293,2022/4/15 11:50,23,63,-40,
33198,293,2022/4/15 12:00,29,60,-31,
33199,293,2022/4/15 12:10,22,60,-38,
33200,293,2022/4/15 12:20,29,45,-16,
33201,293,2022/4/15 12:30,23,45,-22,
33202,293,2022/4/15 12:40,27,64,-37,
33203,293,2022/4/15 12:50,29,59,-30,
33204,293,2022/4/15 13:00,28,60,-32,
33205,293,2022/4/15 13:10,24,62,-38,
33206,293,2022/4/15 13:20,26,44,-18,
33207,293,2022/4/15 13:30,25,57,-32,
33208,293,2022/4/15 13:40,28,57,-29,
33209,293,2022/4/15 13:50,23,56,-33,
33210,293,2022/4/15 14:00,25,49,-24,
33211,293,2022/4/15 14:10,24,48,-24,
33212,293,2022/4/15 14:20,26,45,-19,
33213,293,2022/4/15 14:30,25,62,-37,
33214,293,2022/4/15 14:40,25,50,-25,
33215,293,2022/4/15 14:50,24,61,-37,
33216,293,2022/4/15 15:00,25,57,-32,
33217,293,2022/4/15 15:10,24,40,-16,
33218,293,2022/4/15 15:20,20,48,-28,
33219,293,2022/4/15 15:30,25,61,-36,
33220,293,2022/4/15 15:40,22,61,-39,
33221,293,2022/4/15 15:50,29,48,-19,
33222,293,2022/4/15 16:00,25,59,-34,
33223,293,2022/4/15 16:10,28,64,-36,
33224,293,2022/4/15 16:20,22,47,-25,
33225,293,2022/4/15 16:30,43,52,-9,
33226,293,2022/4/15 16:40,36,63,-27,
33227,293,2022/4/15 16:50,36,66,-30,
33228,293,2022/4/15 17:00,39,80,-41,
33229,293,2022/4/15 17:10,69,67,2,
33230,293,2022/4/15 17:20,42,57,-15,
33231,293,2022/4/15 17:30,58,92,-34,
33232,293,2022/4/15 17:40,46,68,-22,
33233,293,2022/4/15 17:50,44,76,-32,
33234,293,2022/4/15 18:00,40,114,-74,
33235,293,2022/4/15 18:10,27,95,-68,
33236,293,2022/4/15 18:20,26,124,-98,
33237,293,2022/4/15 18:30,24,104,-80,
33238,293,2022/4/15 18:40,28,95,-67,
33239,293,2022/4/15 18:50,21,114,-93,
33240,293,2022/4/15 19:00,15,101,-86,
33241,293,2022/4/15 19:10,15,99,-84,
33242,293,2022/4/15 19:20,14,126,-112,
33243,293,2022/4/15 19:30,12,85,-73,
33244,293,2022/4/15 19:40,16,95,-79,
33245,293,2022/4/15 19:50,16,94,-78,
33246,293,2022/4/15 20:00,14,63,-49,
33247,293,2022/4/15 20:10,12,77,-65,
33248,293,2022/4/15 20:20,9,71,-62,
33249,293,2022/4/15 20:30,9,64,-55,
33250,293,2022/4/15 20:40,10,85,-75,
33251,293,2022/4/15 20:50,7,60,-53,
33252,293,2022/4/15 21:00,7,59,-52,
33253,293,2022/4/15 21:10,8,79,-71,
33254,293,2022/4/15 21:20,7,66,-59,
33255,293,2022/4/15 21:30,4,56,-52,
33256,293,2022/4/15 21:40,3,62,-59,
33257,293,2022/4/15 21:50,4,71,-67,
33258,293,2022/4/15 22:00,5,63,-58,
33259,293,2022/4/15 22:10,0,54,-54,
33260,293,2022/4/15 22:20,0,51,-51,
33261,293,2022/4/15 22:30,0,44,-44,
33262,293,2022/4/15 22:40,0,47,-47,
33263,293,2022/4/15 22:50,1,39,-38,
33264,303,2022/4/15 5:00,0,1,-1,
33265,303,2022/4/15 5:10,0,1,-1,
33266,303,2022/4/15 5:20,0,1,-1,
33267,303,2022/4/15 5:30,14,1,13,
33268,303,2022/4/15 5:40,28,1,27,
33269,303,2022/4/15 5:50,33,6,27,
33270,303,2022/4/15 6:00,42,5,37,
33271,303,2022/4/15 6:10,73,8,65,
33272,303,2022/4/15 6:20,109,16,93,
33273,303,2022/4/15 6:30,190,79,111,
33274,303,2022/4/15 6:40,281,68,213,
33275,303,2022/4/15 6:50,370,72,298,
33276,303,2022/4/15 7:00,655,87,568,
33277,303,2022/4/15 7:10,740,118,622,
33278,303,2022/4/15 7:20,1169,104,1065,
33279,303,2022/4/15 7:30,1389,178,1211,
33280,303,2022/4/15 7:40,1371,255,1116,
33281,303,2022/4/15 7:50,1210,213,997,
33282,303,2022/4/15 8:00,1167,198,969,
33283,303,2022/4/15 8:10,1040,107,933,
33284,303,2022/4/15 8:20,732,224,508,
33285,303,2022/4/15 8:30,611,254,357,
33286,303,2022/4/15 8:40,369,180,189,
33287,303,2022/4/15 8:50,278,103,175,
33288,303,2022/4/15 9:00,236,150,86,
33289,303,2022/4/15 9:10,177,111,66,
33290,303,2022/4/15 9:20,162,142,20,
33291,303,2022/4/15 9:30,139,116,23,
33292,303,2022/4/15 9:40,130,101,29,
33293,303,2022/4/15 9:50,77,124,-47,
33294,303,2022/4/15 10:00,103,121,-18,
33295,303,2022/4/15 10:10,129,105,24,
33296,303,2022/4/15 10:20,108,101,7,
33297,303,2022/4/15 10:30,77,104,-27,
33298,303,2022/4/15 10:40,81,119,-38,
33299,303,2022/4/15 10:50,65,102,-37,
33300,303,2022/4/15 11:00,61,100,-39,
33301,303,2022/4/15 11:10,62,115,-53,
33302,303,2022/4/15 11:20,59,102,-43,
33303,303,2022/4/15 11:30,95,119,-24,
33304,303,2022/4/15 11:40,124,116,8,
33305,303,2022/4/15 11:50,165,121,44,
33306,303,2022/4/15 12:00,155,120,35,
33307,303,2022/4/15 12:10,186,105,81,
33308,303,2022/4/15 12:20,188,119,69,
33309,303,2022/4/15 12:30,231,99,132,
33310,303,2022/4/15 12:40,170,117,53,
33311,303,2022/4/15 12:50,141,121,20,
33312,303,2022/4/15 13:00,164,119,45,
33313,303,2022/4/15 13:10,167,124,43,
33314,303,2022/4/15 13:20,135,116,19,
33315,303,2022/4/15 13:30,109,108,1,
33316,303,2022/4/15 13:40,151,98,53,
33317,303,2022/4/15 13:50,82,107,-25,
33318,303,2022/4/15 14:00,127,105,22,
33319,303,2022/4/15 14:10,116,123,-7,
33320,303,2022/4/15 14:20,87,121,-34,
33321,303,2022/4/15 14:30,99,125,-26,
33322,303,2022/4/15 14:40,94,108,-14,
33323,303,2022/4/15 14:50,118,114,4,
33324,303,2022/4/15 15:00,163,121,42,
33325,303,2022/4/15 15:10,184,122,62,
33326,303,2022/4/15 15:20,131,120,11,
33327,303,2022/4/15 15:30,166,111,55,
33328,303,2022/4/15 15:40,178,97,81,
33329,303,2022/4/15 15:50,132,127,5,
33330,303,2022/4/15 16:00,158,114,44,
33331,303,2022/4/15 16:10,187,108,79,
33332,303,2022/4/15 16:20,171,150,21,
33333,303,2022/4/15 16:30,194,111,83,
33334,303,2022/4/15 16:40,259,106,153,
33335,303,2022/4/15 16:50,268,139,129,
33336,303,2022/4/15 17:00,213,181,32,
33337,303,2022/4/15 17:10,194,252,-58,
33338,303,2022/4/15 17:20,208,245,-37,
33339,303,2022/4/15 17:30,181,217,-36,
33340,303,2022/4/15 17:40,188,424,-236,
33341,303,2022/4/15 17:50,202,324,-122,
33342,303,2022/4/15 18:00,157,347,-190,
33343,303,2022/4/15 18:10,124,427,-303,
33344,303,2022/4/15 18:20,175,378,-203,
33345,303,2022/4/15 18:30,70,499,-429,
33346,303,2022/4/15 18:40,62,636,-574,
33347,303,2022/4/15 18:50,71,434,-363,
33348,303,2022/4/15 19:00,49,414,-365,
33349,303,2022/4/15 19:10,61,457,-396,
33350,303,2022/4/15 19:20,64,392,-328,
33351,303,2022/4/15 19:30,64,411,-347,
33352,303,2022/4/15 19:40,42,413,-371,
33353,303,2022/4/15 19:50,55,293,-238,
33354,303,2022/4/15 20:00,44,506,-462,
33355,303,2022/4/15 20:10,51,178,-127,
33356,303,2022/4/15 20:20,47,180,-133,
33357,303,2022/4/15 20:30,45,257,-212,
33358,303,2022/4/15 20:40,39,116,-77,
33359,303,2022/4/15 20:50,38,221,-183,
33360,303,2022/4/15 21:00,32,193,-161,
33361,303,2022/4/15 21:10,41,111,-70,
33362,303,2022/4/15 21:20,34,224,-190,
33363,303,2022/4/15 21:30,27,120,-93,
33364,303,2022/4/15 21:40,27,150,-123,
33365,303,2022/4/15 21:50,27,128,-101,
33366,303,2022/4/15 22:00,6,150,-144,
33367,303,2022/4/15 22:10,3,120,-117,
33368,303,2022/4/15 22:20,2,122,-120,
33369,303,2022/4/15 22:30,2,110,-108,
33370,303,2022/4/15 22:40,2,103,-101,
33371,303,2022/4/15 22:50,1,94,-93,
33372,306,2022/4/15 5:00,0,1,-1,
33373,306,2022/4/15 5:10,0,1,-1,
33374,306,2022/4/15 5:20,0,1,-1,
33375,306,2022/4/15 5:30,18,1,17,
33376,306,2022/4/15 5:40,30,1,29,
33377,306,2022/4/15 5:50,33,1,32,
33378,306,2022/4/15 6:00,37,1,36,
33379,306,2022/4/15 6:10,50,2,48,
33380,306,2022/4/15 6:20,80,2,78,
33381,306,2022/4/15 6:30,150,6,144,
33382,306,2022/4/15 6:40,185,65,120,
33383,306,2022/4/15 6:50,214,46,168,
33384,306,2022/4/15 7:00,233,113,120,
33385,306,2022/4/15 7:10,278,89,189,
33386,306,2022/4/15 7:20,355,102,253,
33387,306,2022/4/15 7:30,345,109,236,
33388,306,2022/4/15 7:40,331,120,211,
33389,306,2022/4/15 7:50,302,110,192,
33390,306,2022/4/15 8:00,285,115,170,
33391,306,2022/4/15 8:10,236,110,126,
33392,306,2022/4/15 8:20,189,111,78,
33393,306,2022/4/15 8:30,185,90,95,
33394,306,2022/4/15 8:40,82,105,-23,
33395,306,2022/4/15 8:50,73,110,-37,
33396,306,2022/4/15 9:00,54,64,-10,
33397,306,2022/4/15 9:10,49,93,-44,
33398,306,2022/4/15 9:20,45,104,-59,
33399,306,2022/4/15 9:30,47,75,-28,
33400,306,2022/4/15 9:40,38,82,-44,
33401,306,2022/4/15 9:50,38,76,-38,
33402,306,2022/4/15 10:00,39,80,-41,
33403,306,2022/4/15 10:10,38,65,-27,
33404,306,2022/4/15 10:20,38,74,-36,
33405,306,2022/4/15 10:30,38,65,-27,
33406,306,2022/4/15 10:40,32,81,-49,
33407,306,2022/4/15 10:50,29,76,-47,
33408,306,2022/4/15 11:00,33,60,-27,
33409,306,2022/4/15 11:10,33,82,-49,
33410,306,2022/4/15 11:20,40,82,-42,
33411,306,2022/4/15 11:30,37,86,-49,
33412,306,2022/4/15 11:40,38,81,-43,
33413,306,2022/4/15 11:50,34,76,-42,
33414,306,2022/4/15 12:00,41,62,-21,
33415,306,2022/4/15 12:10,36,75,-39,
33416,306,2022/4/15 12:20,39,77,-38,
33417,306,2022/4/15 12:30,34,73,-39,
33418,306,2022/4/15 12:40,32,79,-47,
33419,306,2022/4/15 12:50,30,76,-46,
33420,306,2022/4/15 13:00,34,72,-38,
33421,306,2022/4/15 13:10,32,87,-55,
33422,306,2022/4/15 13:20,28,87,-59,
33423,306,2022/4/15 13:30,29,81,-52,
33424,306,2022/4/15 13:40,30,78,-48,
33425,306,2022/4/15 13:50,29,59,-30,
33426,306,2022/4/15 14:00,35,76,-41,
33427,306,2022/4/15 14:10,30,76,-46,
33428,306,2022/4/15 14:20,27,75,-48,
33429,306,2022/4/15 14:30,25,78,-53,
33430,306,2022/4/15 14:40,32,83,-51,
33431,306,2022/4/15 14:50,32,64,-32,
33432,306,2022/4/15 15:00,34,74,-40,
33433,306,2022/4/15 15:10,33,81,-48,
33434,306,2022/4/15 15:20,33,78,-45,
33435,306,2022/4/15 15:30,36,87,-51,
33436,306,2022/4/15 15:40,34,69,-35,
33437,306,2022/4/15 15:50,36,95,-59,
33438,306,2022/4/15 16:00,41,101,-60,
33439,306,2022/4/15 16:10,38,61,-23,
33440,306,2022/4/15 16:20,63,92,-29,
33441,306,2022/4/15 16:30,67,63,4,
33442,306,2022/4/15 16:40,70,83,-13,
33443,306,2022/4/15 16:50,65,100,-35,
33444,306,2022/4/15 17:00,52,98,-46,
33445,306,2022/4/15 17:10,50,100,-50,
33446,306,2022/4/15 17:20,74,106,-32,
33447,306,2022/4/15 17:30,137,115,22,
33448,306,2022/4/15 17:40,74,105,-31,
33449,306,2022/4/15 17:50,67,116,-49,
33450,306,2022/4/15 18:00,61,182,-121,
33451,306,2022/4/15 18:10,47,103,-56,
33452,306,2022/4/15 18:20,37,224,-187,
33453,306,2022/4/15 18:30,37,110,-73,
33454,306,2022/4/15 18:40,26,111,-85,
33455,306,2022/4/15 18:50,28,209,-181,
33456,306,2022/4/15 19:00,28,114,-86,
33457,306,2022/4/15 19:10,23,123,-100,
33458,306,2022/4/15 19:20,25,180,-155,
33459,306,2022/4/15 19:30,26,100,-74,
33460,306,2022/4/15 19:40,24,124,-100,
33461,306,2022/4/15 19:50,26,106,-80,
33462,306,2022/4/15 20:00,26,93,-67,
33463,306,2022/4/15 20:10,27,116,-89,
33464,306,2022/4/15 20:20,24,80,-56,
33465,306,2022/4/15 20:30,26,79,-53,
33466,306,2022/4/15 20:40,23,105,-82,
33467,306,2022/4/15 20:50,16,71,-55,
33468,306,2022/4/15 21:00,21,72,-51,
33469,306,2022/4/15 21:10,19,106,-87,
33470,306,2022/4/15 21:20,20,72,-52,
33471,306,2022/4/15 21:30,17,77,-60,
33472,306,2022/4/15 21:40,11,67,-56,
33473,306,2022/4/15 21:50,8,95,-87,
33474,306,2022/4/15 22:00,2,65,-63,
33475,306,2022/4/15 22:10,1,82,-81,
33476,306,2022/4/15 22:20,1,74,-73,
33477,306,2022/4/15 22:30,0,68,-68,
33478,306,2022/4/15 22:40,0,59,-59,
33479,306,2022/4/15 22:50,0,64,-64,
33480,305,2022/4/15 5:00,0,1,-1,
33481,305,2022/4/15 5:10,0,1,-1,
33482,305,2022/4/15 5:20,0,1,-1,
33483,305,2022/4/15 5:30,29,1,28,
33484,305,2022/4/15 5:40,32,1,31,
33485,305,2022/4/15 5:50,50,1,49,
33486,305,2022/4/15 6:00,45,1,44,
33487,305,2022/4/15 6:10,68,1,67,
33488,305,2022/4/15 6:20,114,1,113,
33489,305,2022/4/15 6:30,154,1,153,
33490,305,2022/4/15 6:40,253,67,186,
33491,305,2022/4/15 6:50,283,50,233,
33492,305,2022/4/15 7:00,354,57,297,
33493,305,2022/4/15 7:10,601,105,496,
33494,305,2022/4/15 7:20,597,81,516,
33495,305,2022/4/15 7:30,601,102,499,
33496,305,2022/4/15 7:40,470,110,360,
33497,305,2022/4/15 7:50,393,100,293,
33498,305,2022/4/15 8:00,350,99,251,
33499,305,2022/4/15 8:10,281,102,179,
33500,305,2022/4/15 8:20,232,113,119,
33501,305,2022/4/15 8:30,185,97,88,
33502,305,2022/4/15 8:40,146,108,38,
33503,305,2022/4/15 8:50,74,68,6,
33504,305,2022/4/15 9:00,53,110,-57,
33505,305,2022/4/15 9:10,41,76,-35,
33506,305,2022/4/15 9:20,45,68,-23,
33507,305,2022/4/15 9:30,39,91,-52,
33508,305,2022/4/15 9:40,33,87,-54,
33509,305,2022/4/15 9:50,37,67,-30,
33510,305,2022/4/15 10:00,31,75,-44,
33511,305,2022/4/15 10:10,32,68,-36,
33512,305,2022/4/15 10:20,28,65,-37,
33513,305,2022/4/15 10:30,31,79,-48,
33514,305,2022/4/15 10:40,35,74,-39,
33515,305,2022/4/15 10:50,32,73,-41,
33516,305,2022/4/15 11:00,27,74,-47,
33517,305,2022/4/15 11:10,30,81,-51,
33518,305,2022/4/15 11:20,38,62,-24,
33519,305,2022/4/15 11:30,32,65,-33,
33520,305,2022/4/15 11:40,37,85,-48,
33521,305,2022/4/15 11:50,39,77,-38,
33522,305,2022/4/15 12:00,38,85,-47,
33523,305,2022/4/15 12:10,36,83,-47,
33524,305,2022/4/15 12:20,39,62,-23,
33525,305,2022/4/15 12:30,33,62,-29,
33526,305,2022/4/15 12:40,33,73,-40,
33527,305,2022/4/15 12:50,30,76,-46,
33528,305,2022/4/15 13:00,32,93,-61,
33529,305,2022/4/15 13:10,28,73,-45,
33530,305,2022/4/15 13:20,30,60,-30,
33531,305,2022/4/15 13:30,31,81,-50,
33532,305,2022/4/15 13:40,29,75,-46,
33533,305,2022/4/15 13:50,30,81,-51,
33534,305,2022/4/15 14:00,28,77,-49,
33535,305,2022/4/15 14:10,27,69,-42,
33536,305,2022/4/15 14:20,31,68,-37,
33537,305,2022/4/15 14:30,24,75,-51,
33538,305,2022/4/15 14:40,31,76,-45,
33539,305,2022/4/15 14:50,27,78,-51,
33540,305,2022/4/15 15:00,31,74,-43,
33541,305,2022/4/15 15:10,33,66,-33,
33542,305,2022/4/15 15:20,30,76,-46,
33543,305,2022/4/15 15:30,34,91,-57,
33544,305,2022/4/15 15:40,35,90,-55,
33545,305,2022/4/15 15:50,34,97,-63,
33546,305,2022/4/15 16:00,37,68,-31,
33547,305,2022/4/15 16:10,37,105,-68,
33548,305,2022/4/15 16:20,42,99,-57,
33549,305,2022/4/15 16:30,45,83,-38,
33550,305,2022/4/15 16:40,44,101,-57,
33551,305,2022/4/15 16:50,43,87,-44,
33552,305,2022/4/15 17:00,38,108,-70,
33553,305,2022/4/15 17:10,49,168,-119,
33554,305,2022/4/15 17:20,50,104,-54,
33555,305,2022/4/15 17:30,42,102,-60,
33556,305,2022/4/15 17:40,45,183,-138,
33557,305,2022/4/15 17:50,46,108,-62,
33558,305,2022/4/15 18:00,43,128,-85,
33559,305,2022/4/15 18:10,44,234,-190,
33560,305,2022/4/15 18:20,32,124,-92,
33561,305,2022/4/15 18:30,26,220,-194,
33562,305,2022/4/15 18:40,24,169,-145,
33563,305,2022/4/15 18:50,24,110,-86,
33564,305,2022/4/15 19:00,24,227,-203,
33565,305,2022/4/15 19:10,24,109,-85,
33566,305,2022/4/15 19:20,25,119,-94,
33567,305,2022/4/15 19:30,22,191,-169,
33568,305,2022/4/15 19:40,17,104,-87,
33569,305,2022/4/15 19:50,16,105,-89,
33570,305,2022/4/15 20:00,22,122,-100,
33571,305,2022/4/15 20:10,21,82,-61,
33572,305,2022/4/15 20:20,21,104,-83,
33573,305,2022/4/15 20:30,14,82,-68,
33574,305,2022/4/15 20:40,23,73,-50,
33575,305,2022/4/15 20:50,16,113,-97,
33576,305,2022/4/15 21:00,20,77,-57,
33577,305,2022/4/15 21:10,17,63,-46,
33578,305,2022/4/15 21:20,16,106,-90,
33579,305,2022/4/15 21:30,11,95,-84,
33580,305,2022/4/15 21:40,9,72,-63,
33581,305,2022/4/15 21:50,6,72,-66,
33582,305,2022/4/15 22:00,0,98,-98,
33583,305,2022/4/15 22:10,1,76,-75,
33584,305,2022/4/15 22:20,0,75,-75,
33585,305,2022/4/15 22:30,0,69,-69,
33586,305,2022/4/15 22:40,0,62,-62,
33587,305,2022/4/15 22:50,0,69,-69,
33588,313,2022/4/15 5:00,0,1,-1,
33589,313,2022/4/15 5:10,0,1,-1,
33590,313,2022/4/15 5:20,8,1,7,
33591,313,2022/4/15 5:30,14,1,13,
33592,313,2022/4/15 5:40,20,1,19,
33593,313,2022/4/15 5:50,27,1,26,
33594,313,2022/4/15 6:00,29,1,28,
33595,313,2022/4/15 6:10,30,1,29,
33596,313,2022/4/15 6:20,40,1,39,
33597,313,2022/4/15 6:30,54,1,53,
33598,313,2022/4/15 6:40,51,70,-19,
33599,313,2022/4/15 6:50,78,60,18,
33600,313,2022/4/15 7:00,102,38,64,
33601,313,2022/4/15 7:10,145,44,101,
33602,313,2022/4/15 7:20,214,70,144,
33603,313,2022/4/15 7:30,223,53,170,
33604,313,2022/4/15 7:40,190,70,120,
33605,313,2022/4/15 7:50,147,60,87,
33606,313,2022/4/15 8:00,83,60,23,
33607,313,2022/4/15 8:10,74,61,13,
33608,313,2022/4/15 8:20,55,53,2,
33609,313,2022/4/15 8:30,53,85,-32,
33610,313,2022/4/15 8:40,44,67,-23,
33611,313,2022/4/15 8:50,30,63,-33,
33612,313,2022/4/15 9:00,27,52,-25,
33613,313,2022/4/15 9:10,27,72,-45,
33614,313,2022/4/15 9:20,30,69,-39,
33615,313,2022/4/15 9:30,28,71,-43,
33616,313,2022/4/15 9:40,26,72,-46,
33617,313,2022/4/15 9:50,27,60,-33,
33618,313,2022/4/15 10:00,25,71,-46,
33619,313,2022/4/15 10:10,25,67,-42,
33620,313,2022/4/15 10:20,24,53,-29,
33621,313,2022/4/15 10:30,24,51,-27,
33622,313,2022/4/15 10:40,28,67,-39,
33623,313,2022/4/15 10:50,28,70,-42,
33624,313,2022/4/15 11:00,26,49,-23,
33625,313,2022/4/15 11:10,20,72,-52,
33626,313,2022/4/15 11:20,25,68,-43,
33627,313,2022/4/15 11:30,26,64,-38,
33628,313,2022/4/15 11:40,25,68,-43,
33629,313,2022/4/15 11:50,25,62,-37,
33630,313,2022/4/15 12:00,22,55,-33,
33631,313,2022/4/15 12:10,26,68,-42,
33632,313,2022/4/15 12:20,22,69,-47,
33633,313,2022/4/15 12:30,25,71,-46,
33634,313,2022/4/15 12:40,24,71,-47,
33635,313,2022/4/15 12:50,23,46,-23,
33636,313,2022/4/15 13:00,25,62,-37,
33637,313,2022/4/15 13:10,25,64,-39,
33638,313,2022/4/15 13:20,24,70,-46,
33639,313,2022/4/15 13:30,26,69,-43,
33640,313,2022/4/15 13:40,26,63,-37,
33641,313,2022/4/15 13:50,24,62,-38,
33642,313,2022/4/15 14:00,25,69,-44,
33643,313,2022/4/15 14:10,25,72,-47,
33644,313,2022/4/15 14:20,26,66,-40,
33645,313,2022/4/15 14:30,25,57,-32,
33646,313,2022/4/15 14:40,24,46,-22,
33647,313,2022/4/15 14:50,28,67,-39,
33648,313,2022/4/15 15:00,26,67,-41,
33649,313,2022/4/15 15:10,25,66,-41,
33650,313,2022/4/15 15:20,23,68,-45,
33651,313,2022/4/15 15:30,28,60,-32,
33652,313,2022/4/15 15:40,32,59,-27,
33653,313,2022/4/15 15:50,28,68,-40,
33654,313,2022/4/15 16:00,25,84,-59,
33655,313,2022/4/15 16:10,25,50,-25,
33656,313,2022/4/15 16:20,26,81,-55,
33657,313,2022/4/15 16:30,26,83,-57,
33658,313,2022/4/15 16:40,27,73,-46,
33659,313,2022/4/15 16:50,36,70,-34,
33660,313,2022/4/15 17:00,33,85,-52,
33661,313,2022/4/15 17:10,32,85,-53,
33662,313,2022/4/15 17:20,27,100,-73,
33663,313,2022/4/15 17:30,29,64,-35,
33664,313,2022/4/15 17:40,31,80,-49,
33665,313,2022/4/15 17:50,25,105,-80,
33666,313,2022/4/15 18:00,26,92,-66,
33667,313,2022/4/15 18:10,28,99,-71,
33668,313,2022/4/15 18:20,24,98,-74,
33669,313,2022/4/15 18:30,23,99,-76,
33670,313,2022/4/15 18:40,21,114,-93,
33671,313,2022/4/15 18:50,17,108,-91,
33672,313,2022/4/15 19:00,20,78,-58,
33673,313,2022/4/15 19:10,16,106,-90,
33674,313,2022/4/15 19:20,16,77,-61,
33675,313,2022/4/15 19:30,13,84,-71,
33676,313,2022/4/15 19:40,15,106,-91,
33677,313,2022/4/15 19:50,14,68,-54,
33678,313,2022/4/15 20:00,15,70,-55,
33679,313,2022/4/15 20:10,15,84,-69,
33680,313,2022/4/15 20:20,17,56,-39,
33681,313,2022/4/15 20:30,18,72,-54,
33682,313,2022/4/15 20:40,17,51,-34,
33683,313,2022/4/15 20:50,18,51,-33,
33684,313,2022/4/15 21:00,18,71,-53,
33685,313,2022/4/15 21:10,18,40,-22,
33686,313,2022/4/15 21:20,12,47,-35,
33687,313,2022/4/15 21:30,14,61,-47,
33688,313,2022/4/15 21:40,8,51,-43,
33689,313,2022/4/15 21:50,2,40,-38,
33690,313,2022/4/15 22:00,0,40,-40,
33691,313,2022/4/15 22:10,0,51,-51,
33692,313,2022/4/15 22:20,0,47,-47,
33693,313,2022/4/15 22:30,0,40,-40,
33694,313,2022/4/15 22:40,0,38,-38,
33695,313,2022/4/15 22:50,0,40,-40,
33696,304,2022/4/15 5:00,0,1,-1,
33697,304,2022/4/15 5:10,0,1,-1,
33698,304,2022/4/15 5:20,2,1,1,
33699,304,2022/4/15 5:30,4,1,3,
33700,304,2022/4/15 5:40,4,1,3,
33701,304,2022/4/15 5:50,7,1,6,
33702,304,2022/4/15 6:00,8,1,7,
33703,304,2022/4/15 6:10,9,1,8,
33704,304,2022/4/15 6:20,10,1,9,
33705,304,2022/4/15 6:30,12,1,11,
33706,304,2022/4/15 6:40,18,30,-12,
33707,304,2022/4/15 6:50,21,37,-16,
33708,304,2022/4/15 7:00,29,71,-42,
33709,304,2022/4/15 7:10,27,61,-34,
33710,304,2022/4/15 7:20,34,57,-23,
33711,304,2022/4/15 7:30,31,90,-59,
33712,304,2022/4/15 7:40,34,53,-19,
33713,304,2022/4/15 7:50,31,81,-50,
33714,304,2022/4/15 8:00,23,96,-73,
33715,304,2022/4/15 8:10,22,76,-54,
33716,304,2022/4/15 8:20,24,74,-50,
33717,304,2022/4/15 8:30,13,70,-57,
33718,304,2022/4/15 8:40,11,79,-68,
33719,304,2022/4/15 8:50,11,41,-30,
33720,304,2022/4/15 9:00,13,44,-31,
33721,304,2022/4/15 9:10,16,29,-13,
33722,304,2022/4/15 9:20,6,47,-41,
33723,304,2022/4/15 9:30,7,50,-43,
33724,304,2022/4/15 9:40,7,37,-30,
33725,304,2022/4/15 9:50,6,29,-23,
33726,304,2022/4/15 10:00,6,53,-47,
33727,304,2022/4/15 10:10,7,40,-33,
33728,304,2022/4/15 10:20,12,39,-27,
33729,304,2022/4/15 10:30,19,42,-23,
33730,304,2022/4/15 10:40,8,37,-29,
33731,304,2022/4/15 10:50,16,52,-36,
33732,304,2022/4/15 11:00,10,52,-42,
33733,304,2022/4/15 11:10,6,44,-38,
33734,304,2022/4/15 11:20,9,36,-27,
33735,304,2022/4/15 11:30,17,43,-26,
33736,304,2022/4/15 11:40,17,36,-19,
33737,304,2022/4/15 11:50,9,32,-23,
33738,304,2022/4/15 12:00,9,31,-22,
33739,304,2022/4/15 12:10,9,30,-21,
33740,304,2022/4/15 12:20,8,24,-16,
33741,304,2022/4/15 12:30,8,34,-26,
33742,304,2022/4/15 12:40,22,37,-15,
33743,304,2022/4/15 12:50,20,29,-9,
33744,304,2022/4/15 13:00,8,34,-26,
33745,304,2022/4/15 13:10,8,20,-12,
33746,304,2022/4/15 13:20,21,36,-15,
33747,304,2022/4/15 13:30,7,33,-26,
33748,304,2022/4/15 13:40,9,35,-26,
33749,304,2022/4/15 13:50,7,33,-26,
33750,304,2022/4/15 14:00,24,23,1,
33751,304,2022/4/15 14:10,21,21,0,
33752,304,2022/4/15 14:20,7,32,-25,
33753,304,2022/4/15 14:30,8,33,-25,
33754,304,2022/4/15 14:40,22,31,-9,
33755,304,2022/4/15 14:50,6,30,-24,
33756,304,2022/4/15 15:00,9,23,-14,
33757,304,2022/4/15 15:10,9,36,-27,
33758,304,2022/4/15 15:20,9,36,-27,
33759,304,2022/4/15 15:30,18,37,-19,
33760,304,2022/4/15 15:40,17,38,-21,
33761,304,2022/4/15 15:50,15,38,-23,
33762,304,2022/4/15 16:00,9,33,-24,
33763,304,2022/4/15 16:10,9,38,-29,
33764,304,2022/4/15 16:20,16,30,-14,
33765,304,2022/4/15 16:30,26,29,-3,
33766,304,2022/4/15 16:40,23,23,0,
33767,304,2022/4/15 16:50,20,59,-39,
33768,304,2022/4/15 17:00,20,50,-30,
33769,304,2022/4/15 17:10,36,50,-14,
33770,304,2022/4/15 17:20,26,43,-17,
33771,304,2022/4/15 17:30,26,57,-31,
33772,304,2022/4/15 17:40,39,35,4,
33773,304,2022/4/15 17:50,26,38,-12,
33774,304,2022/4/15 18:00,24,60,-36,
33775,304,2022/4/15 18:10,15,44,-29,
33776,304,2022/4/15 18:20,14,39,-25,
33777,304,2022/4/15 18:30,25,65,-40,
33778,304,2022/4/15 18:40,24,40,-16,
33779,304,2022/4/15 18:50,6,50,-44,
33780,304,2022/4/15 19:00,7,39,-32,
33781,304,2022/4/15 19:10,6,33,-27,
33782,304,2022/4/15 19:20,23,47,-24,
33783,304,2022/4/15 19:30,6,44,-38,
33784,304,2022/4/15 19:40,5,33,-28,
33785,304,2022/4/15 19:50,4,37,-33,
33786,304,2022/4/15 20:00,12,21,-9,
33787,304,2022/4/15 20:10,16,25,-9,
33788,304,2022/4/15 20:20,3,34,-31,
33789,304,2022/4/15 20:30,2,21,-19,
33790,304,2022/4/15 20:40,26,25,1,
33791,304,2022/4/15 20:50,4,21,-17,
33792,304,2022/4/15 21:00,3,21,-18,
33793,304,2022/4/15 21:10,2,27,-25,
33794,304,2022/4/15 21:20,25,18,7,
33795,304,2022/4/15 21:30,16,15,1,
33796,304,2022/4/15 21:40,6,21,-15,
33797,304,2022/4/15 21:50,0,22,-22,
33798,304,2022/4/15 22:00,0,15,-15,
33799,304,2022/4/15 22:10,0,21,-21,
33800,304,2022/4/15 22:20,0,10,-10,
33801,304,2022/4/15 22:30,0,18,-18,
33802,304,2022/4/15 22:40,0,8,-8,
33803,304,2022/4/15 22:50,0,13,-13,
