,Unnamed: 0,stationid,startTime,inNums,outNums,flow
0,0,1,2022/4/15 5:00:00,0,1,-1
1,1,1,2022/4/15 5:10:00,2,1,1
2,2,1,2022/4/15 5:20:00,9,1,8
3,3,1,2022/4/15 5:30:00,15,1,14
4,4,1,2022/4/15 5:40:00,20,1,19
5,5,1,2022/4/15 5:50:00,17,1,16
6,6,1,2022/4/15 6:00:00,25,1,24
7,7,1,2022/4/15 6:10:00,31,13,18
8,8,1,2022/4/15 6:20:00,45,17,28
9,9,1,2022/4/15 6:30:00,57,21,36
10,10,1,2022/4/15 6:40:00,69,32,37
11,11,1,2022/4/15 6:50:00,105,50,55
12,12,1,2022/4/15 7:00:00,181,67,114
13,13,1,2022/4/15 7:10:00,215,73,142
14,14,1,2022/4/15 7:20:00,252,75,177
15,15,1,2022/4/15 7:30:00,323,97,226
16,16,1,2022/4/15 7:40:00,590,106,484
17,17,1,2022/4/15 7:50:00,639,110,529
18,18,1,2022/4/15 8:00:00,723,123,600
19,19,1,2022/4/15 8:10:00,687,226,461
20,20,1,2022/4/15 8:20:00,653,171,482
21,21,1,2022/4/15 8:30:00,573,234,339
22,22,1,2022/4/15 8:40:00,358,222,136
23,23,1,2022/4/15 8:50:00,278,180,98
24,24,1,2022/4/15 9:00:00,232,152,80
25,25,1,2022/4/15 9:10:00,174,121,53
26,26,1,2022/4/15 9:20:00,106,123,-17
27,27,1,2022/4/15 9:30:00,68,107,-39
28,28,1,2022/4/15 9:40:00,55,108,-53
29,29,1,2022/4/15 9:50:00,50,97,-47
30,30,1,2022/4/15 10:00:00,44,76,-32
31,31,1,2022/4/15 10:10:00,42,81,-39
32,32,1,2022/4/15 10:20:00,36,77,-41
33,33,1,2022/4/15 10:30:00,31,72,-41
34,34,1,2022/4/15 10:40:00,32,75,-43
35,35,1,2022/4/15 10:50:00,35,72,-37
36,36,1,2022/4/15 11:00:00,33,65,-32
37,37,1,2022/4/15 11:10:00,26,66,-40
38,38,1,2022/4/15 11:20:00,36,61,-25
39,39,1,2022/4/15 11:30:00,33,82,-49
40,40,1,2022/4/15 11:40:00,36,70,-34
41,41,1,2022/4/15 11:50:00,35,76,-41
42,42,1,2022/4/15 12:00:00,39,75,-36
43,43,1,2022/4/15 12:10:00,41,77,-36
44,44,1,2022/4/15 12:20:00,45,70,-25
45,45,1,2022/4/15 12:30:00,43,84,-41
46,46,1,2022/4/15 12:40:00,43,81,-38
47,47,1,2022/4/15 12:50:00,44,75,-31
48,48,1,2022/4/15 13:00:00,38,92,-54
49,49,1,2022/4/15 13:10:00,38,76,-38
50,50,1,2022/4/15 13:20:00,34,91,-57
51,51,1,2022/4/15 13:30:00,37,76,-39
52,52,1,2022/4/15 13:40:00,34,77,-43
53,53,1,2022/4/15 13:50:00,36,76,-40
54,54,1,2022/4/15 14:00:00,30,74,-44
55,55,1,2022/4/15 14:10:00,35,77,-42
56,56,1,2022/4/15 14:20:00,31,84,-53
57,57,1,2022/4/15 14:30:00,30,76,-46
58,58,1,2022/4/15 14:40:00,28,76,-48
59,59,1,2022/4/15 14:50:00,27,81,-54
60,60,1,2022/4/15 15:00:00,34,91,-57
61,61,1,2022/4/15 15:10:00,39,76,-37
62,62,1,2022/4/15 15:20:00,40,92,-52
63,63,1,2022/4/15 15:30:00,42,87,-45
64,64,1,2022/4/15 15:40:00,39,96,-57
65,65,1,2022/4/15 15:50:00,36,97,-61
66,66,1,2022/4/15 16:00:00,45,97,-52
67,67,1,2022/4/15 16:10:00,53,109,-56
68,68,1,2022/4/15 16:20:00,56,103,-47
69,69,1,2022/4/15 16:30:00,52,102,-50
70,70,1,2022/4/15 16:40:00,73,110,-37
71,71,1,2022/4/15 16:50:00,68,111,-43
72,72,1,2022/4/15 17:00:00,125,103,22
73,73,1,2022/4/15 17:10:00,208,110,98
74,74,1,2022/4/15 17:20:00,174,151,23
75,75,1,2022/4/15 17:30:00,163,191,-28
76,76,1,2022/4/15 17:40:00,221,233,-12
77,77,1,2022/4/15 17:50:00,183,217,-34
78,78,1,2022/4/15 18:00:00,149,300,-151
79,79,1,2022/4/15 18:10:00,203,327,-124
80,80,1,2022/4/15 18:20:00,163,334,-171
81,81,1,2022/4/15 18:30:00,74,319,-245
82,82,1,2022/4/15 18:40:00,56,301,-245
83,83,1,2022/4/15 18:50:00,46,256,-210
84,84,1,2022/4/15 19:00:00,43,197,-154
85,85,1,2022/4/15 19:10:00,40,147,-107
86,86,1,2022/4/15 19:20:00,40,144,-104
87,87,1,2022/4/15 19:30:00,37,110,-73
88,88,1,2022/4/15 19:40:00,35,125,-90
89,89,1,2022/4/15 19:50:00,28,125,-97
90,90,1,2022/4/15 20:00:00,33,105,-72
91,91,1,2022/4/15 20:10:00,38,108,-70
92,92,1,2022/4/15 20:20:00,41,81,-40
93,93,1,2022/4/15 20:30:00,40,122,-82
94,94,1,2022/4/15 20:40:00,44,83,-39
95,95,1,2022/4/15 20:50:00,32,107,-75
96,96,1,2022/4/15 21:00:00,28,78,-50
97,97,1,2022/4/15 21:10:00,27,127,-100
98,98,1,2022/4/15 21:20:00,25,108,-83
99,99,1,2022/4/15 21:30:00,29,99,-70
100,100,1,2022/4/15 21:40:00,25,102,-77
101,101,1,2022/4/15 21:50:00,23,78,-55
102,102,1,2022/4/15 22:00:00,15,106,-91
103,103,1,2022/4/15 22:10:00,2,73,-71
104,104,1,2022/4/15 22:20:00,0,108,-108
105,105,1,2022/4/15 22:30:00,0,79,-79
106,106,1,2022/4/15 22:40:00,1,75,-74
107,107,1,2022/4/15 22:50:00,0,34,-34
108,108,2,2022/4/15 5:00:00,0,1,-1
109,109,2,2022/4/15 5:10:00,1,1,0
110,110,2,2022/4/15 5:20:00,3,1,2
111,111,2,2022/4/15 5:30:00,8,1,7
112,112,2,2022/4/15 5:40:00,18,1,17
113,113,2,2022/4/15 5:50:00,21,6,15
114,114,2,2022/4/15 6:00:00,23,21,2
115,115,2,2022/4/15 6:10:00,30,21,9
116,116,2,2022/4/15 6:20:00,33,23,10
117,117,2,2022/4/15 6:30:00,41,38,3
118,118,2,2022/4/15 6:40:00,44,33,11
119,119,2,2022/4/15 6:50:00,63,52,11
120,120,2,2022/4/15 7:00:00,76,67,9
121,121,2,2022/4/15 7:10:00,91,68,23
122,122,2,2022/4/15 7:20:00,101,75,26
123,123,2,2022/4/15 7:30:00,162,105,57
124,124,2,2022/4/15 7:40:00,226,122,104
125,125,2,2022/4/15 7:50:00,274,185,89
126,126,2,2022/4/15 8:00:00,300,281,19
127,127,2,2022/4/15 8:10:00,318,507,-189
128,128,2,2022/4/15 8:20:00,337,535,-198
129,129,2,2022/4/15 8:30:00,303,434,-131
130,130,2,2022/4/15 8:40:00,269,1126,-857
131,131,2,2022/4/15 8:50:00,224,429,-205
132,132,2,2022/4/15 9:00:00,182,317,-135
133,133,2,2022/4/15 9:10:00,145,217,-72
134,134,2,2022/4/15 9:20:00,83,181,-98
135,135,2,2022/4/15 9:30:00,65,133,-68
136,136,2,2022/4/15 9:40:00,51,121,-70
137,137,2,2022/4/15 9:50:00,48,109,-61
138,138,2,2022/4/15 10:00:00,45,105,-60
139,139,2,2022/4/15 10:10:00,44,98,-54
140,140,2,2022/4/15 10:20:00,42,90,-48
141,141,2,2022/4/15 10:30:00,37,90,-53
142,142,2,2022/4/15 10:40:00,36,93,-57
143,143,2,2022/4/15 10:50:00,36,76,-40
144,144,2,2022/4/15 11:00:00,37,70,-33
145,145,2,2022/4/15 11:10:00,36,85,-49
146,146,2,2022/4/15 11:20:00,37,81,-44
147,147,2,2022/4/15 11:30:00,38,74,-36
148,148,2,2022/4/15 11:40:00,34,76,-42
149,149,2,2022/4/15 11:50:00,34,70,-36
150,150,2,2022/4/15 12:00:00,38,76,-38
151,151,2,2022/4/15 12:10:00,45,69,-24
152,152,2,2022/4/15 12:20:00,44,76,-32
153,153,2,2022/4/15 12:30:00,41,73,-32
154,154,2,2022/4/15 12:40:00,46,76,-30
155,155,2,2022/4/15 12:50:00,41,90,-49
156,156,2,2022/4/15 13:00:00,41,73,-32
157,157,2,2022/4/15 13:10:00,38,104,-66
158,158,2,2022/4/15 13:20:00,41,76,-35
159,159,2,2022/4/15 13:30:00,38,93,-55
160,160,2,2022/4/15 13:40:00,44,82,-38
161,161,2,2022/4/15 13:50:00,41,87,-46
162,162,2,2022/4/15 14:00:00,41,93,-52
163,163,2,2022/4/15 14:10:00,44,82,-38
164,164,2,2022/4/15 14:20:00,36,94,-58
165,165,2,2022/4/15 14:30:00,35,81,-46
166,166,2,2022/4/15 14:40:00,40,79,-39
167,167,2,2022/4/15 14:50:00,37,79,-42
168,168,2,2022/4/15 15:00:00,43,77,-34
169,169,2,2022/4/15 15:10:00,41,93,-52
170,170,2,2022/4/15 15:20:00,42,83,-41
171,171,2,2022/4/15 15:30:00,45,105,-60
172,172,2,2022/4/15 15:40:00,43,87,-44
173,173,2,2022/4/15 15:50:00,46,104,-58
174,174,2,2022/4/15 16:00:00,50,92,-42
175,175,2,2022/4/15 16:10:00,53,97,-44
176,176,2,2022/4/15 16:20:00,47,100,-53
177,177,2,2022/4/15 16:30:00,68,99,-31
178,178,2,2022/4/15 16:40:00,94,112,-18
179,179,2,2022/4/15 16:50:00,85,105,-20
180,180,2,2022/4/15 17:00:00,277,108,169
181,181,2,2022/4/15 17:10:00,310,125,185
182,182,2,2022/4/15 17:20:00,275,110,165
183,183,2,2022/4/15 17:30:00,327,108,219
184,184,2,2022/4/15 17:40:00,710,142,568
185,185,2,2022/4/15 17:50:00,462,181,281
186,186,2,2022/4/15 18:00:00,326,184,142
187,187,2,2022/4/15 18:10:00,577,192,385
188,188,2,2022/4/15 18:20:00,272,159,113
189,189,2,2022/4/15 18:30:00,205,185,20
190,190,2,2022/4/15 18:40:00,176,152,24
191,191,2,2022/4/15 18:50:00,89,117,-28
192,192,2,2022/4/15 19:00:00,76,110,-34
193,193,2,2022/4/15 19:10:00,65,124,-59
194,194,2,2022/4/15 19:20:00,52,103,-51
195,195,2,2022/4/15 19:30:00,45,111,-66
196,196,2,2022/4/15 19:40:00,39,105,-66
197,197,2,2022/4/15 19:50:00,40,95,-55
198,198,2,2022/4/15 20:00:00,39,82,-43
199,199,2,2022/4/15 20:10:00,40,95,-55
200,200,2,2022/4/15 20:20:00,36,93,-57
201,201,2,2022/4/15 20:30:00,32,79,-47
202,202,2,2022/4/15 20:40:00,37,92,-55
203,203,2,2022/4/15 20:50:00,36,78,-42
204,204,2,2022/4/15 21:00:00,30,77,-47
205,205,2,2022/4/15 21:10:00,29,82,-53
206,206,2,2022/4/15 21:20:00,30,97,-67
207,207,2,2022/4/15 21:30:00,29,76,-47
208,208,2,2022/4/15 21:40:00,26,80,-54
209,209,2,2022/4/15 21:50:00,28,79,-51
210,210,2,2022/4/15 22:00:00,23,86,-63
211,211,2,2022/4/15 22:10:00,28,79,-51
212,212,2,2022/4/15 22:20:00,15,78,-63
213,213,2,2022/4/15 22:30:00,11,77,-66
214,214,2,2022/4/15 22:40:00,5,52,-47
215,215,2,2022/4/15 22:50:00,0,3,-3
216,216,3,2022/4/15 5:00:00,0,1,-1
217,217,3,2022/4/15 5:10:00,4,1,3
218,218,3,2022/4/15 5:20:00,13,1,12
219,219,3,2022/4/15 5:30:00,9,1,8
220,220,3,2022/4/15 5:40:00,16,1,15
221,221,3,2022/4/15 5:50:00,23,1,22
222,222,3,2022/4/15 6:00:00,27,1,26
223,223,3,2022/4/15 6:10:00,31,1,30
224,224,3,2022/4/15 6:20:00,47,19,28
225,225,3,2022/4/15 6:30:00,57,16,41
226,226,3,2022/4/15 6:40:00,68,23,45
227,227,3,2022/4/15 6:50:00,88,23,65
228,228,3,2022/4/15 7:00:00,144,11,133
229,229,3,2022/4/15 7:10:00,222,25,197
230,230,3,2022/4/15 7:20:00,274,40,234
231,231,3,2022/4/15 7:30:00,325,50,275
232,232,3,2022/4/15 7:40:00,593,38,555
233,233,3,2022/4/15 7:50:00,684,49,635
234,234,3,2022/4/15 8:00:00,699,54,645
235,235,3,2022/4/15 8:10:00,707,61,646
236,236,3,2022/4/15 8:20:00,629,62,567
237,237,3,2022/4/15 8:30:00,367,72,295
238,238,3,2022/4/15 8:40:00,282,71,211
239,239,3,2022/4/15 8:50:00,234,62,172
240,240,3,2022/4/15 9:00:00,169,64,105
241,241,3,2022/4/15 9:10:00,116,46,70
242,242,3,2022/4/15 9:20:00,65,52,13
243,243,3,2022/4/15 9:30:00,49,42,7
244,244,3,2022/4/15 9:40:00,41,51,-10
245,245,3,2022/4/15 9:50:00,40,47,-7
246,246,3,2022/4/15 10:00:00,33,49,-16
247,247,3,2022/4/15 10:10:00,34,42,-8
248,248,3,2022/4/15 10:20:00,30,48,-18
249,249,3,2022/4/15 10:30:00,25,50,-25
250,250,3,2022/4/15 10:40:00,28,47,-19
251,251,3,2022/4/15 10:50:00,26,48,-22
252,252,3,2022/4/15 11:00:00,26,50,-24
253,253,3,2022/4/15 11:10:00,25,50,-25
254,254,3,2022/4/15 11:20:00,26,51,-25
255,255,3,2022/4/15 11:30:00,25,49,-24
256,256,3,2022/4/15 11:40:00,25,51,-26
257,257,3,2022/4/15 11:50:00,26,50,-24
258,258,3,2022/4/15 12:00:00,28,52,-24
259,259,3,2022/4/15 12:10:00,27,50,-23
260,260,3,2022/4/15 12:20:00,27,51,-24
261,261,3,2022/4/15 12:30:00,27,52,-25
262,262,3,2022/4/15 12:40:00,29,52,-23
263,263,3,2022/4/15 12:50:00,25,54,-29
264,264,3,2022/4/15 13:00:00,27,55,-28
265,265,3,2022/4/15 13:10:00,28,58,-30
266,266,3,2022/4/15 13:20:00,28,53,-25
267,267,3,2022/4/15 13:30:00,28,54,-26
268,268,3,2022/4/15 13:40:00,28,63,-35
269,269,3,2022/4/15 13:50:00,23,63,-40
270,270,3,2022/4/15 14:00:00,25,67,-42
271,271,3,2022/4/15 14:10:00,22,66,-44
272,272,3,2022/4/15 14:20:00,24,65,-41
273,273,3,2022/4/15 14:30:00,22,59,-37
274,274,3,2022/4/15 14:40:00,20,61,-41
275,275,3,2022/4/15 14:50:00,23,70,-47
276,276,3,2022/4/15 15:00:00,21,65,-44
277,277,3,2022/4/15 15:10:00,20,67,-47
278,278,3,2022/4/15 15:20:00,21,73,-52
279,279,3,2022/4/15 15:30:00,22,81,-59
280,280,3,2022/4/15 15:40:00,19,73,-54
281,281,3,2022/4/15 15:50:00,21,76,-55
282,282,3,2022/4/15 16:00:00,21,76,-55
283,283,3,2022/4/15 16:10:00,20,74,-54
284,284,3,2022/4/15 16:20:00,22,79,-57
285,285,3,2022/4/15 16:30:00,26,93,-67
286,286,3,2022/4/15 16:40:00,29,97,-68
287,287,3,2022/4/15 16:50:00,26,103,-77
288,288,3,2022/4/15 17:00:00,24,104,-80
289,289,3,2022/4/15 17:10:00,29,111,-82
290,290,3,2022/4/15 17:20:00,31,101,-70
291,291,3,2022/4/15 17:30:00,29,115,-86
292,292,3,2022/4/15 17:40:00,29,109,-80
293,293,3,2022/4/15 17:50:00,29,181,-152
294,294,3,2022/4/15 18:00:00,26,128,-102
295,295,3,2022/4/15 18:10:00,30,179,-149
296,296,3,2022/4/15 18:20:00,27,226,-199
297,297,3,2022/4/15 18:30:00,29,234,-205
298,298,3,2022/4/15 18:40:00,23,220,-197
299,299,3,2022/4/15 18:50:00,22,223,-201
300,300,3,2022/4/15 19:00:00,19,145,-126
301,301,3,2022/4/15 19:10:00,17,139,-122
302,302,3,2022/4/15 19:20:00,18,111,-93
303,303,3,2022/4/15 19:30:00,16,119,-103
304,304,3,2022/4/15 19:40:00,15,100,-85
305,305,3,2022/4/15 19:50:00,16,112,-96
306,306,3,2022/4/15 20:00:00,15,101,-86
307,307,3,2022/4/15 20:10:00,15,95,-80
308,308,3,2022/4/15 20:20:00,17,97,-80
309,309,3,2022/4/15 20:30:00,14,78,-64
310,310,3,2022/4/15 20:40:00,14,92,-78
311,311,3,2022/4/15 20:50:00,12,85,-73
312,312,3,2022/4/15 21:00:00,13,94,-81
313,313,3,2022/4/15 21:10:00,16,95,-79
314,314,3,2022/4/15 21:20:00,12,60,-48
315,315,3,2022/4/15 21:30:00,11,86,-75
316,316,3,2022/4/15 21:40:00,10,102,-92
317,317,3,2022/4/15 21:50:00,5,114,-109
318,318,3,2022/4/15 22:00:00,1,94,-93
319,319,3,2022/4/15 22:10:00,0,77,-77
320,320,3,2022/4/15 22:20:00,0,25,-25
321,321,3,2022/4/15 22:30:00,0,86,-86
322,322,3,2022/4/15 22:40:00,1,77,-76
323,323,3,2022/4/15 22:50:00,0,54,-54
324,324,4,2022/4/15 5:00:00,0,1,-1
325,325,4,2022/4/15 5:10:00,0,1,-1
326,326,4,2022/4/15 5:20:00,0,1,-1
327,327,4,2022/4/15 5:30:00,5,1,4
328,328,4,2022/4/15 5:40:00,9,1,8
329,329,4,2022/4/15 5:50:00,10,21,-11
330,330,4,2022/4/15 6:00:00,7,5,2
331,331,4,2022/4/15 6:10:00,9,34,-25
332,332,4,2022/4/15 6:20:00,17,49,-32
333,333,4,2022/4/15 6:30:00,15,33,-18
334,334,4,2022/4/15 6:40:00,17,42,-25
335,335,4,2022/4/15 6:50:00,16,62,-46
336,336,4,2022/4/15 7:00:00,20,75,-55
337,337,4,2022/4/15 7:10:00,23,87,-64
338,338,4,2022/4/15 7:20:00,25,93,-68
339,339,4,2022/4/15 7:30:00,28,109,-81
340,340,4,2022/4/15 7:40:00,31,108,-77
341,341,4,2022/4/15 7:50:00,39,213,-174
342,342,4,2022/4/15 8:00:00,47,319,-272
343,343,4,2022/4/15 8:10:00,58,346,-288
344,344,4,2022/4/15 8:20:00,44,208,-164
345,345,4,2022/4/15 8:30:00,34,178,-144
346,346,4,2022/4/15 8:40:00,30,152,-122
347,347,4,2022/4/15 8:50:00,28,123,-95
348,348,4,2022/4/15 9:00:00,27,76,-49
349,349,4,2022/4/15 9:10:00,26,82,-56
350,350,4,2022/4/15 9:20:00,23,71,-48
351,351,4,2022/4/15 9:30:00,21,74,-53
352,352,4,2022/4/15 9:40:00,23,64,-41
353,353,4,2022/4/15 9:50:00,22,65,-43
354,354,4,2022/4/15 10:00:00,24,64,-40
355,355,4,2022/4/15 10:10:00,25,58,-33
356,356,4,2022/4/15 10:20:00,24,65,-41
357,357,4,2022/4/15 10:30:00,20,54,-34
358,358,4,2022/4/15 10:40:00,21,62,-41
359,359,4,2022/4/15 10:50:00,25,55,-30
360,360,4,2022/4/15 11:00:00,26,59,-33
361,361,4,2022/4/15 11:10:00,26,59,-33
362,362,4,2022/4/15 11:20:00,26,60,-34
363,363,4,2022/4/15 11:30:00,32,59,-27
364,364,4,2022/4/15 11:40:00,25,65,-40
365,365,4,2022/4/15 11:50:00,24,51,-27
366,366,4,2022/4/15 12:00:00,28,54,-26
367,367,4,2022/4/15 12:10:00,29,55,-26
368,368,4,2022/4/15 12:20:00,25,61,-36
369,369,4,2022/4/15 12:30:00,27,62,-35
370,370,4,2022/4/15 12:40:00,28,67,-39
371,371,4,2022/4/15 12:50:00,25,60,-35
372,372,4,2022/4/15 13:00:00,29,58,-29
373,373,4,2022/4/15 13:10:00,26,61,-35
374,374,4,2022/4/15 13:20:00,26,53,-27
375,375,4,2022/4/15 13:30:00,28,55,-27
376,376,4,2022/4/15 13:40:00,26,52,-26
377,377,4,2022/4/15 13:50:00,25,48,-23
378,378,4,2022/4/15 14:00:00,28,50,-22
379,379,4,2022/4/15 14:10:00,27,42,-15
380,380,4,2022/4/15 14:20:00,29,45,-16
381,381,4,2022/4/15 14:30:00,27,44,-17
382,382,4,2022/4/15 14:40:00,29,44,-15
383,383,4,2022/4/15 14:50:00,28,46,-18
384,384,4,2022/4/15 15:00:00,24,45,-21
385,385,4,2022/4/15 15:10:00,28,42,-14
386,386,4,2022/4/15 15:20:00,29,41,-12
387,387,4,2022/4/15 15:30:00,26,49,-23
388,388,4,2022/4/15 15:40:00,30,45,-15
389,389,4,2022/4/15 15:50:00,33,45,-12
390,390,4,2022/4/15 16:00:00,36,46,-10
391,391,4,2022/4/15 16:10:00,48,46,2
392,392,4,2022/4/15 16:20:00,41,59,-18
393,393,4,2022/4/15 16:30:00,97,46,51
394,394,4,2022/4/15 16:40:00,93,50,43
395,395,4,2022/4/15 16:50:00,157,47,110
396,396,4,2022/4/15 17:00:00,322,48,274
397,397,4,2022/4/15 17:10:00,348,53,295
398,398,4,2022/4/15 17:20:00,180,51,129
399,399,4,2022/4/15 17:30:00,137,54,83
400,400,4,2022/4/15 17:40:00,177,55,122
401,401,4,2022/4/15 17:50:00,76,52,24
402,402,4,2022/4/15 18:00:00,65,55,10
403,403,4,2022/4/15 18:10:00,56,55,1
404,404,4,2022/4/15 18:20:00,41,54,-13
405,405,4,2022/4/15 18:30:00,43,58,-15
406,406,4,2022/4/15 18:40:00,32,50,-18
407,407,4,2022/4/15 18:50:00,29,52,-23
408,408,4,2022/4/15 19:00:00,24,56,-32
409,409,4,2022/4/15 19:10:00,29,54,-25
410,410,4,2022/4/15 19:20:00,32,48,-16
411,411,4,2022/4/15 19:30:00,25,27,-2
412,412,4,2022/4/15 19:40:00,22,42,-20
413,413,4,2022/4/15 19:50:00,24,44,-20
414,414,4,2022/4/15 20:00:00,28,38,-10
415,415,4,2022/4/15 20:10:00,30,25,5
416,416,4,2022/4/15 20:20:00,23,40,-17
417,417,4,2022/4/15 20:30:00,25,34,-9
418,418,4,2022/4/15 20:40:00,17,39,-22
419,419,4,2022/4/15 20:50:00,22,30,-8
420,420,4,2022/4/15 21:00:00,22,25,-3
421,421,4,2022/4/15 21:10:00,20,33,-13
422,422,4,2022/4/15 21:20:00,17,15,2
423,423,4,2022/4/15 21:30:00,11,31,-20
424,424,4,2022/4/15 21:40:00,12,30,-18
425,425,4,2022/4/15 21:50:00,11,29,-18
426,426,4,2022/4/15 22:00:00,7,27,-20
427,427,4,2022/4/15 22:10:00,8,7,1
428,428,4,2022/4/15 22:20:00,3,25,-22
429,429,4,2022/4/15 22:30:00,0,24,-24
430,430,4,2022/4/15 22:40:00,1,23,-22
431,431,4,2022/4/15 22:50:00,1,13,-12
432,432,5,2022/4/15 5:00:00,0,1,-1
433,433,5,2022/4/15 5:10:00,0,1,-1
434,434,5,2022/4/15 5:20:00,2,1,1
435,435,5,2022/4/15 5:30:00,5,1,4
436,436,5,2022/4/15 5:40:00,7,2,5
437,437,5,2022/4/15 5:50:00,12,1,11
438,438,5,2022/4/15 6:00:00,20,13,7
439,439,5,2022/4/15 6:10:00,19,22,-3
440,440,5,2022/4/15 6:20:00,28,40,-12
441,441,5,2022/4/15 6:30:00,32,63,-31
442,442,5,2022/4/15 6:40:00,36,73,-37
443,443,5,2022/4/15 6:50:00,45,76,-31
444,444,5,2022/4/15 7:00:00,54,123,-69
445,445,5,2022/4/15 7:10:00,57,123,-66
446,446,5,2022/4/15 7:20:00,59,106,-47
447,447,5,2022/4/15 7:30:00,83,112,-29
448,448,5,2022/4/15 7:40:00,147,171,-24
449,449,5,2022/4/15 7:50:00,162,181,-19
450,450,5,2022/4/15 8:00:00,194,281,-87
451,451,5,2022/4/15 8:10:00,232,322,-90
452,452,5,2022/4/15 8:20:00,232,325,-93
453,453,5,2022/4/15 8:30:00,221,387,-166
454,454,5,2022/4/15 8:40:00,184,438,-254
455,455,5,2022/4/15 8:50:00,148,504,-356
456,456,5,2022/4/15 9:00:00,94,335,-241
457,457,5,2022/4/15 9:10:00,76,283,-207
458,458,5,2022/4/15 9:20:00,66,233,-167
459,459,5,2022/4/15 9:30:00,55,192,-137
460,460,5,2022/4/15 9:40:00,45,139,-94
461,461,5,2022/4/15 9:50:00,49,133,-84
462,462,5,2022/4/15 10:00:00,43,117,-74
463,463,5,2022/4/15 10:10:00,46,105,-59
464,464,5,2022/4/15 10:20:00,39,103,-64
465,465,5,2022/4/15 10:30:00,47,110,-63
466,466,5,2022/4/15 10:40:00,38,93,-55
467,467,5,2022/4/15 10:50:00,38,99,-61
468,468,5,2022/4/15 11:00:00,36,93,-57
469,469,5,2022/4/15 11:10:00,43,79,-36
470,470,5,2022/4/15 11:20:00,41,77,-36
471,471,5,2022/4/15 11:30:00,42,75,-33
472,472,5,2022/4/15 11:40:00,42,76,-34
473,473,5,2022/4/15 11:50:00,37,76,-39
474,474,5,2022/4/15 12:00:00,46,92,-46
475,475,5,2022/4/15 12:10:00,42,88,-46
476,476,5,2022/4/15 12:20:00,43,82,-39
477,477,5,2022/4/15 12:30:00,44,92,-48
478,478,5,2022/4/15 12:40:00,41,93,-52
479,479,5,2022/4/15 12:50:00,41,109,-68
480,480,5,2022/4/15 13:00:00,41,93,-52
481,481,5,2022/4/15 13:10:00,44,108,-64
482,482,5,2022/4/15 13:20:00,37,99,-62
483,483,5,2022/4/15 13:30:00,40,93,-53
484,484,5,2022/4/15 13:40:00,44,111,-67
485,485,5,2022/4/15 13:50:00,45,91,-46
486,486,5,2022/4/15 14:00:00,45,91,-46
487,487,5,2022/4/15 14:10:00,45,90,-45
488,488,5,2022/4/15 14:20:00,48,90,-42
489,489,5,2022/4/15 14:30:00,49,92,-43
490,490,5,2022/4/15 14:40:00,46,92,-46
491,491,5,2022/4/15 14:50:00,50,80,-30
492,492,5,2022/4/15 15:00:00,55,90,-35
493,493,5,2022/4/15 15:10:00,69,92,-23
494,494,5,2022/4/15 15:20:00,48,91,-43
495,495,5,2022/4/15 15:30:00,56,87,-31
496,496,5,2022/4/15 15:40:00,47,93,-46
497,497,5,2022/4/15 15:50:00,48,77,-29
498,498,5,2022/4/15 16:00:00,61,104,-43
499,499,5,2022/4/15 16:10:00,76,92,-16
500,500,5,2022/4/15 16:20:00,64,93,-29
501,501,5,2022/4/15 16:30:00,71,93,-22
502,502,5,2022/4/15 16:40:00,93,93,0
503,503,5,2022/4/15 16:50:00,131,110,21
504,504,5,2022/4/15 17:00:00,202,111,91
505,505,5,2022/4/15 17:10:00,244,105,139
506,506,5,2022/4/15 17:20:00,199,124,75
507,507,5,2022/4/15 17:30:00,265,102,163
508,508,5,2022/4/15 17:40:00,421,105,316
509,509,5,2022/4/15 17:50:00,268,110,158
510,510,5,2022/4/15 18:00:00,271,133,138
511,511,5,2022/4/15 18:10:00,580,133,447
512,512,5,2022/4/15 18:20:00,290,119,171
513,513,5,2022/4/15 18:30:00,223,107,116
514,514,5,2022/4/15 18:40:00,207,110,97
515,515,5,2022/4/15 18:50:00,137,126,11
516,516,5,2022/4/15 19:00:00,83,126,-43
517,517,5,2022/4/15 19:10:00,85,110,-25
518,518,5,2022/4/15 19:20:00,66,115,-49
519,519,5,2022/4/15 19:30:00,43,100,-57
520,520,5,2022/4/15 19:40:00,39,83,-44
521,521,5,2022/4/15 19:50:00,37,86,-49
522,522,5,2022/4/15 20:00:00,47,85,-38
523,523,5,2022/4/15 20:10:00,47,74,-27
524,524,5,2022/4/15 20:20:00,39,75,-36
525,525,5,2022/4/15 20:30:00,39,80,-41
526,526,5,2022/4/15 20:40:00,37,88,-51
527,527,5,2022/4/15 20:50:00,29,71,-42
528,528,5,2022/4/15 21:00:00,40,63,-23
529,529,5,2022/4/15 21:10:00,37,75,-38
530,530,5,2022/4/15 21:20:00,33,62,-29
531,531,5,2022/4/15 21:30:00,32,75,-43
532,532,5,2022/4/15 21:40:00,27,63,-36
533,533,5,2022/4/15 21:50:00,24,70,-46
534,534,5,2022/4/15 22:00:00,26,74,-48
535,535,5,2022/4/15 22:10:00,25,52,-27
536,536,5,2022/4/15 22:20:00,13,65,-52
537,537,5,2022/4/15 22:30:00,6,48,-42
538,538,5,2022/4/15 22:40:00,2,33,-31
539,539,5,2022/4/15 22:50:00,0,3,-3
540,540,6,2022/4/15 5:00:00,0,1,-1
541,541,6,2022/4/15 5:10:00,7,1,6
542,542,6,2022/4/15 5:20:00,13,1,12
543,543,6,2022/4/15 5:30:00,14,1,13
544,544,6,2022/4/15 5:40:00,16,1,15
545,545,6,2022/4/15 5:50:00,23,1,22
546,546,6,2022/4/15 6:00:00,25,1,24
547,547,6,2022/4/15 6:10:00,32,11,21
548,548,6,2022/4/15 6:20:00,37,23,14
549,549,6,2022/4/15 6:30:00,46,32,14
550,550,6,2022/4/15 6:40:00,65,40,25
551,551,6,2022/4/15 6:50:00,94,54,40
552,552,6,2022/4/15 7:00:00,151,63,88
553,553,6,2022/4/15 7:10:00,200,69,131
554,554,6,2022/4/15 7:20:00,253,76,177
555,555,6,2022/4/15 7:30:00,317,93,224
556,556,6,2022/4/15 7:40:00,324,108,216
557,557,6,2022/4/15 7:50:00,474,127,347
558,558,6,2022/4/15 8:00:00,632,105,527
559,559,6,2022/4/15 8:10:00,583,177,406
560,560,6,2022/4/15 8:20:00,474,151,323
561,561,6,2022/4/15 8:30:00,349,233,116
562,562,6,2022/4/15 8:40:00,282,513,-231
563,563,6,2022/4/15 8:50:00,239,321,-82
564,564,6,2022/4/15 9:00:00,199,296,-97
565,565,6,2022/4/15 9:10:00,145,326,-181
566,566,6,2022/4/15 9:20:00,79,298,-219
567,567,6,2022/4/15 9:30:00,65,221,-156
568,568,6,2022/4/15 9:40:00,62,197,-135
569,569,6,2022/4/15 9:50:00,43,154,-111
570,570,6,2022/4/15 10:00:00,48,133,-85
571,571,6,2022/4/15 10:10:00,44,122,-78
572,572,6,2022/4/15 10:20:00,44,98,-54
573,573,6,2022/4/15 10:30:00,41,109,-68
574,574,6,2022/4/15 10:40:00,41,112,-71
575,575,6,2022/4/15 10:50:00,41,112,-71
576,576,6,2022/4/15 11:00:00,43,105,-62
577,577,6,2022/4/15 11:10:00,37,106,-69
578,578,6,2022/4/15 11:20:00,44,102,-58
579,579,6,2022/4/15 11:30:00,44,105,-61
580,580,6,2022/4/15 11:40:00,50,114,-64
581,581,6,2022/4/15 11:50:00,57,108,-51
582,582,6,2022/4/15 12:00:00,66,102,-36
583,583,6,2022/4/15 12:10:00,74,106,-32
584,584,6,2022/4/15 12:20:00,66,105,-39
585,585,6,2022/4/15 12:30:00,75,108,-33
586,586,6,2022/4/15 12:40:00,71,111,-40
587,587,6,2022/4/15 12:50:00,77,107,-30
588,588,6,2022/4/15 13:00:00,70,109,-39
589,589,6,2022/4/15 13:10:00,72,107,-35
590,590,6,2022/4/15 13:20:00,72,106,-34
591,591,6,2022/4/15 13:30:00,63,105,-42
592,592,6,2022/4/15 13:40:00,56,107,-51
593,593,6,2022/4/15 13:50:00,70,107,-37
594,594,6,2022/4/15 14:00:00,53,109,-56
595,595,6,2022/4/15 14:10:00,60,105,-45
596,596,6,2022/4/15 14:20:00,60,103,-43
597,597,6,2022/4/15 14:30:00,73,103,-30
598,598,6,2022/4/15 14:40:00,57,106,-49
599,599,6,2022/4/15 14:50:00,53,101,-48
600,600,6,2022/4/15 15:00:00,58,106,-48
601,601,6,2022/4/15 15:10:00,72,117,-45
602,602,6,2022/4/15 15:20:00,66,122,-56
603,603,6,2022/4/15 15:30:00,74,124,-50
604,604,6,2022/4/15 15:40:00,65,124,-59
605,605,6,2022/4/15 15:50:00,70,105,-35
606,606,6,2022/4/15 16:00:00,74,111,-37
607,607,6,2022/4/15 16:10:00,73,124,-51
608,608,6,2022/4/15 16:20:00,73,109,-36
609,609,6,2022/4/15 16:30:00,85,111,-26
610,610,6,2022/4/15 16:40:00,162,119,43
611,611,6,2022/4/15 16:50:00,130,126,4
612,612,6,2022/4/15 17:00:00,175,148,27
613,613,6,2022/4/15 17:10:00,217,189,28
614,614,6,2022/4/15 17:20:00,199,223,-24
615,615,6,2022/4/15 17:30:00,236,253,-17
616,616,6,2022/4/15 17:40:00,309,330,-21
617,617,6,2022/4/15 17:50:00,265,372,-107
618,618,6,2022/4/15 18:00:00,265,507,-242
619,619,6,2022/4/15 18:10:00,576,495,81
620,620,6,2022/4/15 18:20:00,310,503,-193
621,621,6,2022/4/15 18:30:00,271,508,-237
622,622,6,2022/4/15 18:40:00,235,505,-270
623,623,6,2022/4/15 18:50:00,205,506,-301
624,624,6,2022/4/15 19:00:00,179,382,-203
625,625,6,2022/4/15 19:10:00,172,327,-155
626,626,6,2022/4/15 19:20:00,150,216,-66
627,627,6,2022/4/15 19:30:00,101,191,-90
628,628,6,2022/4/15 19:40:00,93,137,-44
629,629,6,2022/4/15 19:50:00,85,123,-38
630,630,6,2022/4/15 20:00:00,80,115,-35
631,631,6,2022/4/15 20:10:00,76,127,-51
632,632,6,2022/4/15 20:20:00,92,104,-12
633,633,6,2022/4/15 20:30:00,91,98,-7
634,634,6,2022/4/15 20:40:00,104,116,-12
635,635,6,2022/4/15 20:50:00,130,92,38
636,636,6,2022/4/15 21:00:00,150,126,24
637,637,6,2022/4/15 21:10:00,132,100,32
638,638,6,2022/4/15 21:20:00,76,117,-41
639,639,6,2022/4/15 21:30:00,86,105,-19
640,640,6,2022/4/15 21:40:00,105,92,13
641,641,6,2022/4/15 21:50:00,67,104,-37
642,642,6,2022/4/15 22:00:00,30,77,-47
643,643,6,2022/4/15 22:10:00,3,106,-103
644,644,6,2022/4/15 22:20:00,2,85,-83
645,645,6,2022/4/15 22:30:00,0,110,-110
646,646,6,2022/4/15 22:40:00,1,75,-74
647,647,6,2022/4/15 22:50:00,0,64,-64
648,648,7,2022/4/15 5:00:00,0,1,-1
649,649,7,2022/4/15 5:10:00,0,1,-1
650,650,7,2022/4/15 5:20:00,0,1,-1
651,651,7,2022/4/15 5:30:00,3,1,2
652,652,7,2022/4/15 5:40:00,8,5,3
653,653,7,2022/4/15 5:50:00,18,1,17
654,654,7,2022/4/15 6:00:00,22,29,-7
655,655,7,2022/4/15 6:10:00,30,30,0
656,656,7,2022/4/15 6:20:00,34,54,-20
657,657,7,2022/4/15 6:30:00,44,71,-27
658,658,7,2022/4/15 6:40:00,57,106,-49
659,659,7,2022/4/15 6:50:00,75,123,-48
660,660,7,2022/4/15 7:00:00,89,224,-135
661,661,7,2022/4/15 7:10:00,150,318,-168
662,662,7,2022/4/15 7:20:00,163,190,-27
663,663,7,2022/4/15 7:30:00,227,232,-5
664,664,7,2022/4/15 7:40:00,269,254,15
665,665,7,2022/4/15 7:50:00,301,255,46
666,666,7,2022/4/15 8:00:00,359,384,-25
667,667,7,2022/4/15 8:10:00,366,429,-63
668,668,7,2022/4/15 8:20:00,392,432,-40
669,669,7,2022/4/15 8:30:00,338,575,-237
670,670,7,2022/4/15 8:40:00,318,1133,-815
671,671,7,2022/4/15 8:50:00,274,1138,-864
672,672,7,2022/4/15 9:00:00,233,429,-196
673,673,7,2022/4/15 9:10:00,221,531,-310
674,674,7,2022/4/15 9:20:00,179,502,-323
675,675,7,2022/4/15 9:30:00,149,332,-183
676,676,7,2022/4/15 9:40:00,120,254,-134
677,677,7,2022/4/15 9:50:00,76,190,-114
678,678,7,2022/4/15 10:00:00,64,192,-128
679,679,7,2022/4/15 10:10:00,65,108,-43
680,680,7,2022/4/15 10:20:00,61,124,-63
681,681,7,2022/4/15 10:30:00,56,122,-66
682,682,7,2022/4/15 10:40:00,49,102,-53
683,683,7,2022/4/15 10:50:00,55,107,-52
684,684,7,2022/4/15 11:00:00,49,106,-57
685,685,7,2022/4/15 11:10:00,52,103,-51
686,686,7,2022/4/15 11:20:00,57,106,-49
687,687,7,2022/4/15 11:30:00,57,112,-55
688,688,7,2022/4/15 11:40:00,76,110,-34
689,689,7,2022/4/15 11:50:00,80,109,-29
690,690,7,2022/4/15 12:00:00,75,105,-30
691,691,7,2022/4/15 12:10:00,75,105,-30
692,692,7,2022/4/15 12:20:00,71,106,-35
693,693,7,2022/4/15 12:30:00,76,108,-32
694,694,7,2022/4/15 12:40:00,71,97,-26
695,695,7,2022/4/15 12:50:00,65,105,-40
696,696,7,2022/4/15 13:00:00,65,127,-62
697,697,7,2022/4/15 13:10:00,68,102,-34
698,698,7,2022/4/15 13:20:00,66,125,-59
699,699,7,2022/4/15 13:30:00,63,116,-53
700,700,7,2022/4/15 13:40:00,70,127,-57
701,701,7,2022/4/15 13:50:00,62,121,-59
702,702,7,2022/4/15 14:00:00,71,107,-36
703,703,7,2022/4/15 14:10:00,62,103,-41
704,704,7,2022/4/15 14:20:00,71,122,-51
705,705,7,2022/4/15 14:30:00,70,100,-30
706,706,7,2022/4/15 14:40:00,82,105,-23
707,707,7,2022/4/15 14:50:00,77,111,-34
708,708,7,2022/4/15 15:00:00,83,103,-20
709,709,7,2022/4/15 15:10:00,85,103,-18
710,710,7,2022/4/15 15:20:00,82,108,-26
711,711,7,2022/4/15 15:30:00,119,100,19
712,712,7,2022/4/15 15:40:00,109,119,-10
713,713,7,2022/4/15 15:50:00,137,125,12
714,714,7,2022/4/15 16:00:00,158,107,51
715,715,7,2022/4/15 16:10:00,189,118,71
716,716,7,2022/4/15 16:20:00,202,106,96
717,717,7,2022/4/15 16:30:00,264,120,144
718,718,7,2022/4/15 16:40:00,273,105,168
719,719,7,2022/4/15 16:50:00,265,110,155
720,720,7,2022/4/15 17:00:00,576,111,465
721,721,7,2022/4/15 17:10:00,672,108,564
722,722,7,2022/4/15 17:20:00,637,158,479
723,723,7,2022/4/15 17:30:00,653,196,457
724,724,7,2022/4/15 17:40:00,846,197,649
725,725,7,2022/4/15 17:50:00,698,207,491
726,726,7,2022/4/15 18:00:00,697,301,396
727,727,7,2022/4/15 18:10:00,717,270,447
728,728,7,2022/4/15 18:20:00,639,298,341
729,729,7,2022/4/15 18:30:00,429,284,145
730,730,7,2022/4/15 18:40:00,343,218,125
731,731,7,2022/4/15 18:50:00,268,179,89
732,732,7,2022/4/15 19:00:00,237,186,51
733,733,7,2022/4/15 19:10:00,230,132,98
734,734,7,2022/4/15 19:20:00,198,116,82
735,735,7,2022/4/15 19:30:00,143,117,26
736,736,7,2022/4/15 19:40:00,101,122,-21
737,737,7,2022/4/15 19:50:00,79,126,-47
738,738,7,2022/4/15 20:00:00,83,111,-28
739,739,7,2022/4/15 20:10:00,77,112,-35
740,740,7,2022/4/15 20:20:00,70,107,-37
741,741,7,2022/4/15 20:30:00,64,108,-44
742,742,7,2022/4/15 20:40:00,67,114,-47
743,743,7,2022/4/15 20:50:00,57,111,-54
744,744,7,2022/4/15 21:00:00,60,107,-47
745,745,7,2022/4/15 21:10:00,73,104,-31
746,746,7,2022/4/15 21:20:00,66,104,-38
747,747,7,2022/4/15 21:30:00,59,115,-56
748,748,7,2022/4/15 21:40:00,73,107,-34
749,749,7,2022/4/15 21:50:00,47,98,-51
750,750,7,2022/4/15 22:00:00,45,110,-65
751,751,7,2022/4/15 22:10:00,44,80,-36
752,752,7,2022/4/15 22:20:00,22,104,-82
753,753,7,2022/4/15 22:30:00,12,86,-74
754,754,7,2022/4/15 22:40:00,4,41,-37
755,755,7,2022/4/15 22:50:00,2,21,-19
756,756,8,2022/4/15 5:00:00,0,1,-1
757,757,8,2022/4/15 5:10:00,2,1,1
758,758,8,2022/4/15 5:20:00,10,1,9
759,759,8,2022/4/15 5:30:00,15,1,14
760,760,8,2022/4/15 5:40:00,17,1,16
761,761,8,2022/4/15 5:50:00,19,1,18
762,762,8,2022/4/15 6:00:00,26,1,25
763,763,8,2022/4/15 6:10:00,33,1,32
764,764,8,2022/4/15 6:20:00,36,19,17
765,765,8,2022/4/15 6:30:00,55,29,26
766,766,8,2022/4/15 6:40:00,67,46,21
767,767,8,2022/4/15 6:50:00,69,53,16
768,768,8,2022/4/15 7:00:00,109,57,52
769,769,8,2022/4/15 7:10:00,155,68,87
770,770,8,2022/4/15 7:20:00,231,45,186
771,771,8,2022/4/15 7:30:00,280,51,229
772,772,8,2022/4/15 7:40:00,358,86,272
773,773,8,2022/4/15 7:50:00,468,105,363
774,774,8,2022/4/15 8:00:00,467,110,357
775,775,8,2022/4/15 8:10:00,474,191,283
776,776,8,2022/4/15 8:20:00,375,222,153
777,777,8,2022/4/15 8:30:00,345,159,186
778,778,8,2022/4/15 8:40:00,253,381,-128
779,779,8,2022/4/15 8:50:00,196,91,105
780,780,8,2022/4/15 9:00:00,177,218,-41
781,781,8,2022/4/15 9:10:00,98,32,66
782,782,8,2022/4/15 9:20:00,74,115,-41
783,783,8,2022/4/15 9:30:00,53,103,-50
784,784,8,2022/4/15 9:40:00,51,112,-61
785,785,8,2022/4/15 9:50:00,45,114,-69
786,786,8,2022/4/15 10:00:00,43,93,-50
787,787,8,2022/4/15 10:10:00,41,80,-39
788,788,8,2022/4/15 10:20:00,37,76,-39
789,789,8,2022/4/15 10:30:00,38,78,-40
790,790,8,2022/4/15 10:40:00,30,76,-46
791,791,8,2022/4/15 10:50:00,32,68,-36
792,792,8,2022/4/15 11:00:00,31,85,-54
793,793,8,2022/4/15 11:10:00,31,83,-52
794,794,8,2022/4/15 11:20:00,28,74,-46
795,795,8,2022/4/15 11:30:00,31,74,-43
796,796,8,2022/4/15 11:40:00,30,77,-47
797,797,8,2022/4/15 11:50:00,35,77,-42
798,798,8,2022/4/15 12:00:00,35,80,-45
799,799,8,2022/4/15 12:10:00,39,75,-36
800,800,8,2022/4/15 12:20:00,38,77,-39
801,801,8,2022/4/15 12:30:00,38,81,-43
802,802,8,2022/4/15 12:40:00,37,79,-42
803,803,8,2022/4/15 12:50:00,43,75,-32
804,804,8,2022/4/15 13:00:00,39,79,-40
805,805,8,2022/4/15 13:10:00,38,76,-38
806,806,8,2022/4/15 13:20:00,35,76,-41
807,807,8,2022/4/15 13:30:00,40,77,-37
808,808,8,2022/4/15 13:40:00,37,82,-45
809,809,8,2022/4/15 13:50:00,34,76,-42
810,810,8,2022/4/15 14:00:00,37,81,-44
811,811,8,2022/4/15 14:10:00,33,77,-44
812,812,8,2022/4/15 14:20:00,35,75,-40
813,813,8,2022/4/15 14:30:00,37,83,-46
814,814,8,2022/4/15 14:40:00,32,92,-60
815,815,8,2022/4/15 14:50:00,29,93,-64
816,816,8,2022/4/15 15:00:00,39,91,-52
817,817,8,2022/4/15 15:10:00,32,93,-61
818,818,8,2022/4/15 15:20:00,36,93,-57
819,819,8,2022/4/15 15:30:00,33,98,-65
820,820,8,2022/4/15 15:40:00,32,111,-79
821,821,8,2022/4/15 15:50:00,36,105,-69
822,822,8,2022/4/15 16:00:00,38,111,-73
823,823,8,2022/4/15 16:10:00,38,105,-67
824,824,8,2022/4/15 16:20:00,38,111,-73
825,825,8,2022/4/15 16:30:00,44,119,-75
826,826,8,2022/4/15 16:40:00,45,107,-62
827,827,8,2022/4/15 16:50:00,48,117,-69
828,828,8,2022/4/15 17:00:00,73,121,-48
829,829,8,2022/4/15 17:10:00,176,109,67
830,830,8,2022/4/15 17:20:00,74,119,-45
831,831,8,2022/4/15 17:30:00,132,153,-21
832,832,8,2022/4/15 17:40:00,239,190,49
833,833,8,2022/4/15 17:50:00,186,433,-247
834,834,8,2022/4/15 18:00:00,169,282,-113
835,835,8,2022/4/15 18:10:00,249,267,-18
836,836,8,2022/4/15 18:20:00,176,313,-137
837,837,8,2022/4/15 18:30:00,103,328,-225
838,838,8,2022/4/15 18:40:00,71,283,-212
839,839,8,2022/4/15 18:50:00,60,293,-233
840,840,8,2022/4/15 19:00:00,48,180,-132
841,841,8,2022/4/15 19:10:00,41,192,-151
842,842,8,2022/4/15 19:20:00,35,119,-84
843,843,8,2022/4/15 19:30:00,35,109,-74
844,844,8,2022/4/15 19:40:00,39,124,-85
845,845,8,2022/4/15 19:50:00,31,106,-75
846,846,8,2022/4/15 20:00:00,43,105,-62
847,847,8,2022/4/15 20:10:00,44,113,-69
848,848,8,2022/4/15 20:20:00,30,98,-68
849,849,8,2022/4/15 20:30:00,31,102,-71
850,850,8,2022/4/15 20:40:00,37,102,-65
851,851,8,2022/4/15 20:50:00,25,99,-74
852,852,8,2022/4/15 21:00:00,31,10,21
853,853,8,2022/4/15 21:10:00,30,102,-72
854,854,8,2022/4/15 21:20:00,35,105,-70
855,855,8,2022/4/15 21:30:00,28,114,-86
856,856,8,2022/4/15 21:40:00,29,61,-32
857,857,8,2022/4/15 21:50:00,23,75,-52
858,858,8,2022/4/15 22:00:00,9,99,-90
859,859,8,2022/4/15 22:10:00,2,98,-96
860,860,8,2022/4/15 22:20:00,2,97,-95
861,861,8,2022/4/15 22:30:00,1,7,-6
862,862,8,2022/4/15 22:40:00,1,78,-77
863,863,8,2022/4/15 22:50:00,1,64,-63
864,864,9,2022/4/15 5:00:00,0,1,-1
865,865,9,2022/4/15 5:10:00,0,1,-1
866,866,9,2022/4/15 5:20:00,2,1,1
867,867,9,2022/4/15 5:30:00,5,1,4
868,868,9,2022/4/15 5:40:00,8,1,7
869,869,9,2022/4/15 5:50:00,12,1,11
870,870,9,2022/4/15 6:00:00,20,2,18
871,871,9,2022/4/15 6:10:00,26,11,15
872,872,9,2022/4/15 6:20:00,32,16,16
873,873,9,2022/4/15 6:30:00,37,32,5
874,874,9,2022/4/15 6:40:00,49,41,8
875,875,9,2022/4/15 6:50:00,53,70,-17
876,876,9,2022/4/15 7:00:00,57,77,-20
877,877,9,2022/4/15 7:10:00,62,72,-10
878,878,9,2022/4/15 7:20:00,80,95,-15
879,879,9,2022/4/15 7:30:00,150,100,50
880,880,9,2022/4/15 7:40:00,152,105,47
881,881,9,2022/4/15 7:50:00,216,122,94
882,882,9,2022/4/15 8:00:00,224,109,115
883,883,9,2022/4/15 8:10:00,222,112,110
884,884,9,2022/4/15 8:20:00,209,117,92
885,885,9,2022/4/15 8:30:00,194,185,9
886,886,9,2022/4/15 8:40:00,149,191,-42
887,887,9,2022/4/15 8:50:00,100,191,-91
888,888,9,2022/4/15 9:00:00,65,111,-46
889,889,9,2022/4/15 9:10:00,54,123,-69
890,890,9,2022/4/15 9:20:00,48,113,-65
891,891,9,2022/4/15 9:30:00,38,112,-74
892,892,9,2022/4/15 9:40:00,30,90,-60
893,893,9,2022/4/15 9:50:00,34,76,-42
894,894,9,2022/4/15 10:00:00,34,71,-37
895,895,9,2022/4/15 10:10:00,29,63,-34
896,896,9,2022/4/15 10:20:00,25,61,-36
897,897,9,2022/4/15 10:30:00,28,61,-33
898,898,9,2022/4/15 10:40:00,29,60,-31
899,899,9,2022/4/15 10:50:00,28,65,-37
900,900,9,2022/4/15 11:00:00,27,65,-38
901,901,9,2022/4/15 11:10:00,27,55,-28
902,902,9,2022/4/15 11:20:00,28,59,-31
903,903,9,2022/4/15 11:30:00,28,61,-33
904,904,9,2022/4/15 11:40:00,29,55,-26
905,905,9,2022/4/15 11:50:00,28,60,-32
906,906,9,2022/4/15 12:00:00,29,63,-34
907,907,9,2022/4/15 12:10:00,28,66,-38
908,908,9,2022/4/15 12:20:00,29,60,-31
909,909,9,2022/4/15 12:30:00,28,57,-29
910,910,9,2022/4/15 12:40:00,27,62,-35
911,911,9,2022/4/15 12:50:00,25,61,-36
912,912,9,2022/4/15 13:00:00,25,69,-44
913,913,9,2022/4/15 13:10:00,28,62,-34
914,914,9,2022/4/15 13:20:00,30,67,-37
915,915,9,2022/4/15 13:30:00,29,67,-38
916,916,9,2022/4/15 13:40:00,28,70,-42
917,917,9,2022/4/15 13:50:00,26,69,-43
918,918,9,2022/4/15 14:00:00,30,61,-31
919,919,9,2022/4/15 14:10:00,30,70,-40
920,920,9,2022/4/15 14:20:00,28,72,-44
921,921,9,2022/4/15 14:30:00,23,72,-49
922,922,9,2022/4/15 14:40:00,21,72,-51
923,923,9,2022/4/15 14:50:00,25,67,-42
924,924,9,2022/4/15 15:00:00,26,71,-45
925,925,9,2022/4/15 15:10:00,32,65,-33
926,926,9,2022/4/15 15:20:00,29,71,-42
927,927,9,2022/4/15 15:30:00,32,81,-49
928,928,9,2022/4/15 15:40:00,32,83,-51
929,929,9,2022/4/15 15:50:00,25,69,-44
930,930,9,2022/4/15 16:00:00,31,73,-42
931,931,9,2022/4/15 16:10:00,36,84,-48
932,932,9,2022/4/15 16:20:00,44,76,-32
933,933,9,2022/4/15 16:30:00,45,76,-31
934,934,9,2022/4/15 16:40:00,43,76,-33
935,935,9,2022/4/15 16:50:00,47,82,-35
936,936,9,2022/4/15 17:00:00,85,93,-8
937,937,9,2022/4/15 17:10:00,207,99,108
938,938,9,2022/4/15 17:20:00,136,109,27
939,939,9,2022/4/15 17:30:00,149,116,33
940,940,9,2022/4/15 17:40:00,144,121,23
941,941,9,2022/4/15 17:50:00,154,124,30
942,942,9,2022/4/15 18:00:00,88,126,-38
943,943,9,2022/4/15 18:10:00,198,112,86
944,944,9,2022/4/15 18:20:00,133,125,8
945,945,9,2022/4/15 18:30:00,66,106,-40
946,946,9,2022/4/15 18:40:00,48,111,-63
947,947,9,2022/4/15 18:50:00,48,126,-78
948,948,9,2022/4/15 19:00:00,36,110,-74
949,949,9,2022/4/15 19:10:00,35,114,-79
950,950,9,2022/4/15 19:20:00,29,106,-77
951,951,9,2022/4/15 19:30:00,26,92,-66
952,952,9,2022/4/15 19:40:00,28,78,-50
953,953,9,2022/4/15 19:50:00,25,77,-52
954,954,9,2022/4/15 20:00:00,26,74,-48
955,955,9,2022/4/15 20:10:00,26,68,-42
956,956,9,2022/4/15 20:20:00,27,73,-46
957,957,9,2022/4/15 20:30:00,24,72,-48
958,958,9,2022/4/15 20:40:00,24,67,-43
959,959,9,2022/4/15 20:50:00,27,69,-42
960,960,9,2022/4/15 21:00:00,27,73,-46
961,961,9,2022/4/15 21:10:00,25,59,-34
962,962,9,2022/4/15 21:20:00,22,81,-59
963,963,9,2022/4/15 21:30:00,19,65,-46
964,964,9,2022/4/15 21:40:00,17,73,-56
965,965,9,2022/4/15 21:50:00,20,75,-55
966,966,9,2022/4/15 22:00:00,13,56,-43
967,967,9,2022/4/15 22:10:00,7,73,-66
968,968,9,2022/4/15 22:20:00,4,44,-40
969,969,9,2022/4/15 22:30:00,1,71,-70
970,970,9,2022/4/15 22:40:00,2,49,-47
971,971,9,2022/4/15 22:50:00,0,18,-18
972,972,10,2022/4/15 5:00:00,0,1,-1
973,973,10,2022/4/15 5:10:00,2,1,1
974,974,10,2022/4/15 5:20:00,7,1,6
975,975,10,2022/4/15 5:30:00,10,11,-1
976,976,10,2022/4/15 5:40:00,15,6,9
977,977,10,2022/4/15 5:50:00,23,13,10
978,978,10,2022/4/15 6:00:00,22,46,-24
979,979,10,2022/4/15 6:10:00,26,58,-32
980,980,10,2022/4/15 6:20:00,29,60,-31
981,981,10,2022/4/15 6:30:00,34,73,-39
982,982,10,2022/4/15 6:40:00,38,77,-39
983,983,10,2022/4/15 6:50:00,34,106,-72
984,984,10,2022/4/15 7:00:00,42,113,-71
985,985,10,2022/4/15 7:10:00,46,117,-71
986,986,10,2022/4/15 7:20:00,52,190,-138
987,987,10,2022/4/15 7:30:00,58,325,-267
988,988,10,2022/4/15 7:40:00,68,443,-375
989,989,10,2022/4/15 7:50:00,83,440,-357
990,990,10,2022/4/15 8:00:00,113,1189,-1076
991,991,10,2022/4/15 8:10:00,154,2156,-2002
992,992,10,2022/4/15 8:20:00,155,3168,-3013
993,993,10,2022/4/15 8:30:00,128,3266,-3138
994,994,10,2022/4/15 8:40:00,83,2848,-2765
995,995,10,2022/4/15 8:50:00,78,3164,-3086
996,996,10,2022/4/15 9:00:00,69,1627,-1558
997,997,10,2022/4/15 9:10:00,66,1565,-1499
998,998,10,2022/4/15 9:20:00,70,1120,-1050
999,999,10,2022/4/15 9:30:00,71,478,-407
1000,1000,10,2022/4/15 9:40:00,65,427,-362
1001,1001,10,2022/4/15 9:50:00,67,438,-371
1002,1002,10,2022/4/15 10:00:00,66,323,-257
1003,1003,10,2022/4/15 10:10:00,72,326,-254
1004,1004,10,2022/4/15 10:20:00,73,232,-159
1005,1005,10,2022/4/15 10:30:00,69,207,-138
1006,1006,10,2022/4/15 10:40:00,82,179,-97
1007,1007,10,2022/4/15 10:50:00,74,178,-104
1008,1008,10,2022/4/15 11:00:00,91,171,-80
1009,1009,10,2022/4/15 11:10:00,100,117,-17
1010,1010,10,2022/4/15 11:20:00,100,152,-52
1011,1011,10,2022/4/15 11:30:00,127,128,-1
1012,1012,10,2022/4/15 11:40:00,114,139,-25
1013,1013,10,2022/4/15 11:50:00,132,152,-20
1014,1014,10,2022/4/15 12:00:00,128,120,8
1015,1015,10,2022/4/15 12:10:00,113,105,8
1016,1016,10,2022/4/15 12:20:00,141,150,-9
1017,1017,10,2022/4/15 12:30:00,131,112,19
1018,1018,10,2022/4/15 12:40:00,135,160,-25
1019,1019,10,2022/4/15 12:50:00,131,154,-23
1020,1020,10,2022/4/15 13:00:00,154,192,-38
1021,1021,10,2022/4/15 13:10:00,169,185,-16
1022,1022,10,2022/4/15 13:20:00,175,192,-17
1023,1023,10,2022/4/15 13:30:00,175,185,-10
1024,1024,10,2022/4/15 13:40:00,200,179,21
1025,1025,10,2022/4/15 13:50:00,196,171,25
1026,1026,10,2022/4/15 14:00:00,213,183,30
1027,1027,10,2022/4/15 14:10:00,214,144,70
1028,1028,10,2022/4/15 14:20:00,195,170,25
1029,1029,10,2022/4/15 14:30:00,210,139,71
1030,1030,10,2022/4/15 14:40:00,207,154,53
1031,1031,10,2022/4/15 14:50:00,216,139,77
1032,1032,10,2022/4/15 15:00:00,236,117,119
1033,1033,10,2022/4/15 15:10:00,270,111,159
1034,1034,10,2022/4/15 15:20:00,270,117,153
1035,1035,10,2022/4/15 15:30:00,263,117,146
1036,1036,10,2022/4/15 15:40:00,271,117,154
1037,1037,10,2022/4/15 15:50:00,272,119,153
1038,1038,10,2022/4/15 16:00:00,319,115,204
1039,1039,10,2022/4/15 16:10:00,344,109,235
1040,1040,10,2022/4/15 16:20:00,342,119,223
1041,1041,10,2022/4/15 16:30:00,552,129,423
1042,1042,10,2022/4/15 16:40:00,576,129,447
1043,1043,10,2022/4/15 16:50:00,552,128,424
1044,1044,10,2022/4/15 17:00:00,1160,123,1037
1045,1045,10,2022/4/15 17:10:00,1357,106,1251
1046,1046,10,2022/4/15 17:20:00,1025,157,868
1047,1047,10,2022/4/15 17:30:00,1357,179,1178
1048,1048,10,2022/4/15 17:40:00,1587,178,1409
1049,1049,10,2022/4/15 17:50:00,1030,213,817
1050,1050,10,2022/4/15 18:00:00,1209,223,986
1051,1051,10,2022/4/15 18:10:00,1357,235,1122
1052,1052,10,2022/4/15 18:20:00,1037,234,803
1053,1053,10,2022/4/15 18:30:00,705,200,505
1054,1054,10,2022/4/15 18:40:00,654,236,418
1055,1055,10,2022/4/15 18:50:00,568,179,389
1056,1056,10,2022/4/15 19:00:00,552,180,372
1057,1057,10,2022/4/15 19:10:00,422,114,308
1058,1058,10,2022/4/15 19:20:00,327,109,218
1059,1059,10,2022/4/15 19:30:00,306,114,192
1060,1060,10,2022/4/15 19:40:00,289,100,189
1061,1061,10,2022/4/15 19:50:00,295,99,196
1062,1062,10,2022/4/15 20:00:00,575,108,467
1063,1063,10,2022/4/15 20:10:00,576,111,465
1064,1064,10,2022/4/15 20:20:00,332,107,225
1065,1065,10,2022/4/15 20:30:00,264,105,159
1066,1066,10,2022/4/15 20:40:00,271,92,179
1067,1067,10,2022/4/15 20:50:00,270,94,176
1068,1068,10,2022/4/15 21:00:00,265,88,177
1069,1069,10,2022/4/15 21:10:00,268,81,187
1070,1070,10,2022/4/15 21:20:00,214,99,115
1071,1071,10,2022/4/15 21:30:00,261,69,192
1072,1072,10,2022/4/15 21:40:00,213,78,135
1073,1073,10,2022/4/15 21:50:00,191,64,127
1074,1074,10,2022/4/15 22:00:00,216,78,138
1075,1075,10,2022/4/15 22:10:00,168,78,90
1076,1076,10,2022/4/15 22:20:00,46,85,-39
1077,1077,10,2022/4/15 22:30:00,35,70,-35
1078,1078,10,2022/4/15 22:40:00,24,64,-40
1079,1079,10,2022/4/15 22:50:00,16,50,-34
1080,1080,11,2022/4/15 5:00:00,0,1,-1
1081,1081,11,2022/4/15 5:10:00,2,1,1
1082,1082,11,2022/4/15 5:20:00,5,1,4
1083,1083,11,2022/4/15 5:30:00,6,1,5
1084,1084,11,2022/4/15 5:40:00,6,1,5
1085,1085,11,2022/4/15 5:50:00,11,1,10
1086,1086,11,2022/4/15 6:00:00,9,1,8
1087,1087,11,2022/4/15 6:10:00,16,1,15
1088,1088,11,2022/4/15 6:20:00,18,16,2
1089,1089,11,2022/4/15 6:30:00,21,16,5
1090,1090,11,2022/4/15 6:40:00,33,14,19
1091,1091,11,2022/4/15 6:50:00,36,14,22
1092,1092,11,2022/4/15 7:00:00,46,13,33
1093,1093,11,2022/4/15 7:10:00,60,23,37
1094,1094,11,2022/4/15 7:20:00,88,38,50
1095,1095,11,2022/4/15 7:30:00,189,46,143
1096,1096,11,2022/4/15 7:40:00,192,57,135
1097,1097,11,2022/4/15 7:50:00,185,65,120
1098,1098,11,2022/4/15 8:00:00,173,82,91
1099,1099,11,2022/4/15 8:10:00,169,84,85
1100,1100,11,2022/4/15 8:20:00,108,67,41
1101,1101,11,2022/4/15 8:30:00,76,109,-33
1102,1102,11,2022/4/15 8:40:00,58,110,-52
1103,1103,11,2022/4/15 8:50:00,56,102,-46
1104,1104,11,2022/4/15 9:00:00,27,107,-80
1105,1105,11,2022/4/15 9:10:00,27,122,-95
1106,1106,11,2022/4/15 9:20:00,26,104,-78
1107,1107,11,2022/4/15 9:30:00,22,93,-71
1108,1108,11,2022/4/15 9:40:00,20,75,-55
1109,1109,11,2022/4/15 9:50:00,19,72,-53
1110,1110,11,2022/4/15 10:00:00,19,66,-47
1111,1111,11,2022/4/15 10:10:00,17,47,-30
1112,1112,11,2022/4/15 10:20:00,11,38,-27
1113,1113,11,2022/4/15 10:30:00,16,45,-29
1114,1114,11,2022/4/15 10:40:00,14,38,-24
1115,1115,11,2022/4/15 10:50:00,15,38,-23
1116,1116,11,2022/4/15 11:00:00,16,35,-19
1117,1117,11,2022/4/15 11:10:00,11,32,-21
1118,1118,11,2022/4/15 11:20:00,15,38,-23
1119,1119,11,2022/4/15 11:30:00,16,31,-15
1120,1120,11,2022/4/15 11:40:00,15,28,-13
1121,1121,11,2022/4/15 11:50:00,15,32,-17
1122,1122,11,2022/4/15 12:00:00,16,32,-16
1123,1123,11,2022/4/15 12:10:00,16,33,-17
1124,1124,11,2022/4/15 12:20:00,16,37,-21
1125,1125,11,2022/4/15 12:30:00,16,38,-22
1126,1126,11,2022/4/15 12:40:00,15,38,-23
1127,1127,11,2022/4/15 12:50:00,15,38,-23
1128,1128,11,2022/4/15 13:00:00,14,39,-25
1129,1129,11,2022/4/15 13:10:00,17,44,-27
1130,1130,11,2022/4/15 13:20:00,15,36,-21
1131,1131,11,2022/4/15 13:30:00,14,38,-24
1132,1132,11,2022/4/15 13:40:00,14,39,-25
1133,1133,11,2022/4/15 13:50:00,15,40,-25
1134,1134,11,2022/4/15 14:00:00,13,38,-25
1135,1135,11,2022/4/15 14:10:00,14,38,-24
1136,1136,11,2022/4/15 14:20:00,12,38,-26
1137,1137,11,2022/4/15 14:30:00,13,38,-25
1138,1138,11,2022/4/15 14:40:00,17,41,-24
1139,1139,11,2022/4/15 14:50:00,15,40,-25
1140,1140,11,2022/4/15 15:00:00,15,47,-32
1141,1141,11,2022/4/15 15:10:00,12,38,-26
1142,1142,11,2022/4/15 15:20:00,15,34,-19
1143,1143,11,2022/4/15 15:30:00,17,46,-29
1144,1144,11,2022/4/15 15:40:00,18,42,-24
1145,1145,11,2022/4/15 15:50:00,15,45,-30
1146,1146,11,2022/4/15 16:00:00,13,41,-28
1147,1147,11,2022/4/15 16:10:00,18,44,-26
1148,1148,11,2022/4/15 16:20:00,14,50,-36
1149,1149,11,2022/4/15 16:30:00,22,49,-27
1150,1150,11,2022/4/15 16:40:00,26,55,-29
1151,1151,11,2022/4/15 16:50:00,26,51,-25
1152,1152,11,2022/4/15 17:00:00,29,50,-21
1153,1153,11,2022/4/15 17:10:00,24,64,-40
1154,1154,11,2022/4/15 17:20:00,26,72,-46
1155,1155,11,2022/4/15 17:30:00,36,76,-40
1156,1156,11,2022/4/15 17:40:00,47,77,-30
1157,1157,11,2022/4/15 17:50:00,46,90,-44
1158,1158,11,2022/4/15 18:00:00,44,110,-66
1159,1159,11,2022/4/15 18:10:00,63,110,-47
1160,1160,11,2022/4/15 18:20:00,45,114,-69
1161,1161,11,2022/4/15 18:30:00,34,103,-69
1162,1162,11,2022/4/15 18:40:00,28,95,-67
1163,1163,11,2022/4/15 18:50:00,24,101,-77
1164,1164,11,2022/4/15 19:00:00,26,95,-69
1165,1165,11,2022/4/15 19:10:00,25,76,-51
1166,1166,11,2022/4/15 19:20:00,20,75,-55
1167,1167,11,2022/4/15 19:30:00,18,71,-53
1168,1168,11,2022/4/15 19:40:00,16,56,-40
1169,1169,11,2022/4/15 19:50:00,14,51,-37
1170,1170,11,2022/4/15 20:00:00,16,54,-38
1171,1171,11,2022/4/15 20:10:00,17,48,-31
1172,1172,11,2022/4/15 20:20:00,16,34,-18
1173,1173,11,2022/4/15 20:30:00,13,53,-40
1174,1174,11,2022/4/15 20:40:00,11,37,-26
1175,1175,11,2022/4/15 20:50:00,13,51,-38
1176,1176,11,2022/4/15 21:00:00,12,40,-28
1177,1177,11,2022/4/15 21:10:00,9,50,-41
1178,1178,11,2022/4/15 21:20:00,6,52,-46
1179,1179,11,2022/4/15 21:30:00,7,34,-27
1180,1180,11,2022/4/15 21:40:00,10,48,-38
1181,1181,11,2022/4/15 21:50:00,3,30,-27
1182,1182,11,2022/4/15 22:00:00,1,49,-48
1183,1183,11,2022/4/15 22:10:00,0,24,-24
1184,1184,11,2022/4/15 22:20:00,0,41,-41
1185,1185,11,2022/4/15 22:30:00,0,43,-43
1186,1186,11,2022/4/15 22:40:00,0,34,-34
1187,1187,11,2022/4/15 22:50:00,0,23,-23
1188,1188,12,2022/4/15 5:00:00,0,1,-1
1189,1189,12,2022/4/15 5:10:00,0,1,-1
1190,1190,12,2022/4/15 5:20:00,1,1,0
1191,1191,12,2022/4/15 5:30:00,2,1,1
1192,1192,12,2022/4/15 5:40:00,11,1,10
1193,1193,12,2022/4/15 5:50:00,19,39,-20
1194,1194,12,2022/4/15 6:00:00,25,25,0
1195,1195,12,2022/4/15 6:10:00,32,50,-18
1196,1196,12,2022/4/15 6:20:00,33,53,-20
1197,1197,12,2022/4/15 6:30:00,39,93,-54
1198,1198,12,2022/4/15 6:40:00,50,102,-52
1199,1199,12,2022/4/15 6:50:00,57,110,-53
1200,1200,12,2022/4/15 7:00:00,75,110,-35
1201,1201,12,2022/4/15 7:10:00,88,117,-29
1202,1202,12,2022/4/15 7:20:00,181,180,1
1203,1203,12,2022/4/15 7:30:00,215,233,-18
1204,1204,12,2022/4/15 7:40:00,280,326,-46
1205,1205,12,2022/4/15 7:50:00,344,320,24
1206,1206,12,2022/4/15 8:00:00,597,447,150
1207,1207,12,2022/4/15 8:10:00,628,425,203
1208,1208,12,2022/4/15 8:20:00,719,486,233
1209,1209,12,2022/4/15 8:30:00,628,1570,-942
1210,1210,12,2022/4/15 8:40:00,442,1578,-1136
1211,1211,12,2022/4/15 8:50:00,330,1623,-1293
1212,1212,12,2022/4/15 9:00:00,274,603,-329
1213,1213,12,2022/4/15 9:10:00,277,603,-326
1214,1214,12,2022/4/15 9:20:00,233,570,-337
1215,1215,12,2022/4/15 9:30:00,219,438,-219
1216,1216,12,2022/4/15 9:40:00,188,381,-193
1217,1217,12,2022/4/15 9:50:00,175,281,-106
1218,1218,12,2022/4/15 10:00:00,145,208,-63
1219,1219,12,2022/4/15 10:10:00,149,192,-43
1220,1220,12,2022/4/15 10:20:00,134,185,-51
1221,1221,12,2022/4/15 10:30:00,141,193,-52
1222,1222,12,2022/4/15 10:40:00,146,155,-9
1223,1223,12,2022/4/15 10:50:00,134,152,-18
1224,1224,12,2022/4/15 11:00:00,128,128,0
1225,1225,12,2022/4/15 11:10:00,139,133,6
1226,1226,12,2022/4/15 11:20:00,130,112,18
1227,1227,12,2022/4/15 11:30:00,149,128,21
1228,1228,12,2022/4/15 11:40:00,128,112,16
1229,1229,12,2022/4/15 11:50:00,135,128,7
1230,1230,12,2022/4/15 12:00:00,141,109,32
1231,1231,12,2022/4/15 12:10:00,150,128,22
1232,1232,12,2022/4/15 12:20:00,167,117,50
1233,1233,12,2022/4/15 12:30:00,179,152,27
1234,1234,12,2022/4/15 12:40:00,174,152,22
1235,1235,12,2022/4/15 12:50:00,178,152,26
1236,1236,12,2022/4/15 13:00:00,176,181,-5
1237,1237,12,2022/4/15 13:10:00,184,170,14
1238,1238,12,2022/4/15 13:20:00,196,150,46
1239,1239,12,2022/4/15 13:30:00,181,181,0
1240,1240,12,2022/4/15 13:40:00,173,154,19
1241,1241,12,2022/4/15 13:50:00,195,151,44
1242,1242,12,2022/4/15 14:00:00,169,151,18
1243,1243,12,2022/4/15 14:10:00,188,139,49
1244,1244,12,2022/4/15 14:20:00,181,128,53
1245,1245,12,2022/4/15 14:30:00,170,154,16
1246,1246,12,2022/4/15 14:40:00,166,146,20
1247,1247,12,2022/4/15 14:50:00,173,151,22
1248,1248,12,2022/4/15 15:00:00,183,181,2
1249,1249,12,2022/4/15 15:10:00,202,152,50
1250,1250,12,2022/4/15 15:20:00,203,150,53
1251,1251,12,2022/4/15 15:30:00,227,154,73
1252,1252,12,2022/4/15 15:40:00,214,169,45
1253,1253,12,2022/4/15 15:50:00,230,169,61
1254,1254,12,2022/4/15 16:00:00,234,181,53
1255,1255,12,2022/4/15 16:10:00,244,184,60
1256,1256,12,2022/4/15 16:20:00,226,192,34
1257,1257,12,2022/4/15 16:30:00,258,192,66
1258,1258,12,2022/4/15 16:40:00,264,179,85
1259,1259,12,2022/4/15 16:50:00,270,198,72
1260,1260,12,2022/4/15 17:00:00,354,204,150
1261,1261,12,2022/4/15 17:10:00,577,280,297
1262,1262,12,2022/4/15 17:20:00,553,376,177
1263,1263,12,2022/4/15 17:30:00,610,372,238
1264,1264,12,2022/4/15 17:40:00,711,318,393
1265,1265,12,2022/4/15 17:50:00,697,435,262
1266,1266,12,2022/4/15 18:00:00,705,423,282
1267,1267,12,2022/4/15 18:10:00,1217,419,798
1268,1268,12,2022/4/15 18:20:00,839,435,404
1269,1269,12,2022/4/15 18:30:00,678,419,259
1270,1270,12,2022/4/15 18:40:00,657,530,127
1271,1271,12,2022/4/15 18:50:00,571,329,242
1272,1272,12,2022/4/15 19:00:00,351,258,93
1273,1273,12,2022/4/15 19:10:00,332,199,133
1274,1274,12,2022/4/15 19:20:00,267,193,74
1275,1275,12,2022/4/15 19:30:00,238,126,112
1276,1276,12,2022/4/15 19:40:00,234,111,123
1277,1277,12,2022/4/15 19:50:00,210,125,85
1278,1278,12,2022/4/15 20:00:00,234,118,116
1279,1279,12,2022/4/15 20:10:00,244,107,137
1280,1280,12,2022/4/15 20:20:00,206,124,82
1281,1281,12,2022/4/15 20:30:00,223,107,116
1282,1282,12,2022/4/15 20:40:00,210,123,87
1283,1283,12,2022/4/15 20:50:00,210,103,107
1284,1284,12,2022/4/15 21:00:00,226,99,127
1285,1285,12,2022/4/15 21:10:00,262,116,146
1286,1286,12,2022/4/15 21:20:00,210,78,132
1287,1287,12,2022/4/15 21:30:00,242,115,127
1288,1288,12,2022/4/15 21:40:00,201,100,101
1289,1289,12,2022/4/15 21:50:00,171,103,68
1290,1290,12,2022/4/15 22:00:00,263,99,164
1291,1291,12,2022/4/15 22:10:00,225,83,142
1292,1292,12,2022/4/15 22:20:00,55,78,-23
1293,1293,12,2022/4/15 22:30:00,20,65,-45
1294,1294,12,2022/4/15 22:40:00,0,3,-3
1295,1295,12,2022/4/15 22:50:00,0,3,-3
1296,1296,13,2022/4/15 5:00:00,0,1,-1
1297,1297,13,2022/4/15 5:10:00,0,1,-1
1298,1298,13,2022/4/15 5:20:00,0,1,-1
1299,1299,13,2022/4/15 5:30:00,1,1,0
1300,1300,13,2022/4/15 5:40:00,5,1,4
1301,1301,13,2022/4/15 5:50:00,14,1,13
1302,1302,13,2022/4/15 6:00:00,16,2,14
1303,1303,13,2022/4/15 6:10:00,25,11,14
1304,1304,13,2022/4/15 6:20:00,31,30,1
1305,1305,13,2022/4/15 6:30:00,35,32,3
1306,1306,13,2022/4/15 6:40:00,53,29,24
1307,1307,13,2022/4/15 6:50:00,60,6,54
1308,1308,13,2022/4/15 7:00:00,75,41,34
1309,1309,13,2022/4/15 7:10:00,76,65,11
1310,1310,13,2022/4/15 7:20:00,102,70,32
1311,1311,13,2022/4/15 7:30:00,176,79,97
1312,1312,13,2022/4/15 7:40:00,205,73,132
1313,1313,13,2022/4/15 7:50:00,235,88,147
1314,1314,13,2022/4/15 8:00:00,276,103,173
1315,1315,13,2022/4/15 8:10:00,278,103,175
1316,1316,13,2022/4/15 8:20:00,234,105,129
1317,1317,13,2022/4/15 8:30:00,223,124,99
1318,1318,13,2022/4/15 8:40:00,180,102,78
1319,1319,13,2022/4/15 8:50:00,104,102,2
1320,1320,13,2022/4/15 9:00:00,78,79,-1
1321,1321,13,2022/4/15 9:10:00,50,97,-47
1322,1322,13,2022/4/15 9:20:00,46,67,-21
1323,1323,13,2022/4/15 9:30:00,40,85,-45
1324,1324,13,2022/4/15 9:40:00,33,75,-42
1325,1325,13,2022/4/15 9:50:00,26,76,-50
1326,1326,13,2022/4/15 10:00:00,35,72,-37
1327,1327,13,2022/4/15 10:10:00,30,83,-53
1328,1328,13,2022/4/15 10:20:00,28,74,-46
1329,1329,13,2022/4/15 10:30:00,23,76,-53
1330,1330,13,2022/4/15 10:40:00,29,68,-39
1331,1331,13,2022/4/15 10:50:00,27,82,-55
1332,1332,13,2022/4/15 11:00:00,28,68,-40
1333,1333,13,2022/4/15 11:10:00,30,73,-43
1334,1334,13,2022/4/15 11:20:00,28,71,-43
1335,1335,13,2022/4/15 11:30:00,27,67,-40
1336,1336,13,2022/4/15 11:40:00,29,67,-38
1337,1337,13,2022/4/15 11:50:00,28,67,-39
1338,1338,13,2022/4/15 12:00:00,28,68,-40
1339,1339,13,2022/4/15 12:10:00,28,65,-37
1340,1340,13,2022/4/15 12:20:00,31,69,-38
1341,1341,13,2022/4/15 12:30:00,26,72,-46
1342,1342,13,2022/4/15 12:40:00,32,69,-37
1343,1343,13,2022/4/15 12:50:00,28,66,-38
1344,1344,13,2022/4/15 13:00:00,26,74,-48
1345,1345,13,2022/4/15 13:10:00,31,68,-37
1346,1346,13,2022/4/15 13:20:00,29,62,-33
1347,1347,13,2022/4/15 13:30:00,25,71,-46
1348,1348,13,2022/4/15 13:40:00,29,72,-43
1349,1349,13,2022/4/15 13:50:00,26,74,-48
1350,1350,13,2022/4/15 14:00:00,30,70,-40
1351,1351,13,2022/4/15 14:10:00,28,73,-45
1352,1352,13,2022/4/15 14:20:00,27,72,-45
1353,1353,13,2022/4/15 14:30:00,27,63,-36
1354,1354,13,2022/4/15 14:40:00,27,64,-37
1355,1355,13,2022/4/15 14:50:00,30,71,-41
1356,1356,13,2022/4/15 15:00:00,29,69,-40
1357,1357,13,2022/4/15 15:10:00,31,68,-37
1358,1358,13,2022/4/15 15:20:00,26,74,-48
1359,1359,13,2022/4/15 15:30:00,33,69,-36
1360,1360,13,2022/4/15 15:40:00,31,78,-47
1361,1361,13,2022/4/15 15:50:00,27,77,-50
1362,1362,13,2022/4/15 16:00:00,30,73,-43
1363,1363,13,2022/4/15 16:10:00,28,85,-57
1364,1364,13,2022/4/15 16:20:00,33,73,-40
1365,1365,13,2022/4/15 16:30:00,35,87,-52
1366,1366,13,2022/4/15 16:40:00,37,76,-39
1367,1367,13,2022/4/15 16:50:00,40,90,-50
1368,1368,13,2022/4/15 17:00:00,45,90,-45
1369,1369,13,2022/4/15 17:10:00,43,111,-68
1370,1370,13,2022/4/15 17:20:00,41,89,-48
1371,1371,13,2022/4/15 17:30:00,47,123,-76
1372,1372,13,2022/4/15 17:40:00,42,106,-64
1373,1373,13,2022/4/15 17:50:00,35,126,-91
1374,1374,13,2022/4/15 18:00:00,35,125,-90
1375,1375,13,2022/4/15 18:10:00,39,104,-65
1376,1376,13,2022/4/15 18:20:00,37,104,-67
1377,1377,13,2022/4/15 18:30:00,28,128,-100
1378,1378,13,2022/4/15 18:40:00,30,117,-87
1379,1379,13,2022/4/15 18:50:00,28,110,-82
1380,1380,13,2022/4/15 19:00:00,28,121,-93
1381,1381,13,2022/4/15 19:10:00,27,111,-84
1382,1382,13,2022/4/15 19:20:00,18,110,-92
1383,1383,13,2022/4/15 19:30:00,20,105,-85
1384,1384,13,2022/4/15 19:40:00,20,95,-75
1385,1385,13,2022/4/15 19:50:00,17,93,-76
1386,1386,13,2022/4/15 20:00:00,14,76,-62
1387,1387,13,2022/4/15 20:10:00,14,83,-69
1388,1388,13,2022/4/15 20:20:00,16,74,-58
1389,1389,13,2022/4/15 20:30:00,16,76,-60
1390,1390,13,2022/4/15 20:40:00,14,77,-63
1391,1391,13,2022/4/15 20:50:00,14,69,-55
1392,1392,13,2022/4/15 21:00:00,12,77,-65
1393,1393,13,2022/4/15 21:10:00,15,79,-64
1394,1394,13,2022/4/15 21:20:00,14,76,-62
1395,1395,13,2022/4/15 21:30:00,13,21,-8
1396,1396,13,2022/4/15 21:40:00,10,75,-65
1397,1397,13,2022/4/15 21:50:00,11,78,-67
1398,1398,13,2022/4/15 22:00:00,6,78,-72
1399,1399,13,2022/4/15 22:10:00,2,66,-64
1400,1400,13,2022/4/15 22:20:00,1,41,-40
1401,1401,13,2022/4/15 22:30:00,2,65,-63
1402,1402,13,2022/4/15 22:40:00,1,59,-58
1403,1403,13,2022/4/15 22:50:00,0,32,-32
1404,1404,14,2022/4/15 5:00:00,0,1,-1
1405,1405,14,2022/4/15 5:10:00,0,1,-1
1406,1406,14,2022/4/15 5:20:00,0,1,-1
1407,1407,14,2022/4/15 5:30:00,1,1,0
1408,1408,14,2022/4/15 5:40:00,2,1,1
1409,1409,14,2022/4/15 5:50:00,6,5,1
1410,1410,14,2022/4/15 6:00:00,8,11,-3
1411,1411,14,2022/4/15 6:10:00,14,23,-9
1412,1412,14,2022/4/15 6:20:00,14,29,-15
1413,1413,14,2022/4/15 6:30:00,21,38,-17
1414,1414,14,2022/4/15 6:40:00,19,40,-21
1415,1415,14,2022/4/15 6:50:00,24,66,-42
1416,1416,14,2022/4/15 7:00:00,30,66,-36
1417,1417,14,2022/4/15 7:10:00,31,90,-59
1418,1418,14,2022/4/15 7:20:00,33,104,-71
1419,1419,14,2022/4/15 7:30:00,40,107,-67
1420,1420,14,2022/4/15 7:40:00,46,104,-58
1421,1421,14,2022/4/15 7:50:00,56,122,-66
1422,1422,14,2022/4/15 8:00:00,64,117,-53
1423,1423,14,2022/4/15 8:10:00,67,226,-159
1424,1424,14,2022/4/15 8:20:00,69,233,-164
1425,1425,14,2022/4/15 8:30:00,56,180,-124
1426,1426,14,2022/4/15 8:40:00,56,320,-264
1427,1427,14,2022/4/15 8:50:00,43,186,-143
1428,1428,14,2022/4/15 9:00:00,41,139,-98
1429,1429,14,2022/4/15 9:10:00,39,119,-80
1430,1430,14,2022/4/15 9:20:00,31,116,-85
1431,1431,14,2022/4/15 9:30:00,31,102,-71
1432,1432,14,2022/4/15 9:40:00,32,101,-69
1433,1433,14,2022/4/15 9:50:00,29,104,-75
1434,1434,14,2022/4/15 10:00:00,29,100,-71
1435,1435,14,2022/4/15 10:10:00,28,93,-65
1436,1436,14,2022/4/15 10:20:00,28,97,-69
1437,1437,14,2022/4/15 10:30:00,28,93,-65
1438,1438,14,2022/4/15 10:40:00,26,75,-49
1439,1439,14,2022/4/15 10:50:00,27,77,-50
1440,1440,14,2022/4/15 11:00:00,26,81,-55
1441,1441,14,2022/4/15 11:10:00,32,73,-41
1442,1442,14,2022/4/15 11:20:00,31,62,-31
1443,1443,14,2022/4/15 11:30:00,37,74,-37
1444,1444,14,2022/4/15 11:40:00,27,64,-37
1445,1445,14,2022/4/15 11:50:00,33,62,-29
1446,1446,14,2022/4/15 12:00:00,27,68,-41
1447,1447,14,2022/4/15 12:10:00,27,80,-53
1448,1448,14,2022/4/15 12:20:00,32,77,-45
1449,1449,14,2022/4/15 12:30:00,33,83,-50
1450,1450,14,2022/4/15 12:40:00,30,97,-67
1451,1451,14,2022/4/15 12:50:00,26,91,-65
1452,1452,14,2022/4/15 13:00:00,31,86,-55
1453,1453,14,2022/4/15 13:10:00,30,90,-60
1454,1454,14,2022/4/15 13:20:00,32,93,-61
1455,1455,14,2022/4/15 13:30:00,31,90,-59
1456,1456,14,2022/4/15 13:40:00,31,92,-61
1457,1457,14,2022/4/15 13:50:00,36,77,-41
1458,1458,14,2022/4/15 14:00:00,31,84,-53
1459,1459,14,2022/4/15 14:10:00,31,69,-38
1460,1460,14,2022/4/15 14:20:00,31,83,-52
1461,1461,14,2022/4/15 14:30:00,39,80,-41
1462,1462,14,2022/4/15 14:40:00,35,68,-33
1463,1463,14,2022/4/15 14:50:00,36,81,-45
1464,1464,14,2022/4/15 15:00:00,34,82,-48
1465,1465,14,2022/4/15 15:10:00,40,68,-28
1466,1466,14,2022/4/15 15:20:00,41,74,-33
1467,1467,14,2022/4/15 15:30:00,42,84,-42
1468,1468,14,2022/4/15 15:40:00,40,76,-36
1469,1469,14,2022/4/15 15:50:00,47,84,-37
1470,1470,14,2022/4/15 16:00:00,65,69,-4
1471,1471,14,2022/4/15 16:10:00,53,79,-26
1472,1472,14,2022/4/15 16:20:00,52,70,-18
1473,1473,14,2022/4/15 16:30:00,104,60,44
1474,1474,14,2022/4/15 16:40:00,97,68,29
1475,1475,14,2022/4/15 16:50:00,162,83,79
1476,1476,14,2022/4/15 17:00:00,271,73,198
1477,1477,14,2022/4/15 17:10:00,225,74,151
1478,1478,14,2022/4/15 17:20:00,194,94,100
1479,1479,14,2022/4/15 17:30:00,175,103,72
1480,1480,14,2022/4/15 17:40:00,170,108,62
1481,1481,14,2022/4/15 17:50:00,98,105,-7
1482,1482,14,2022/4/15 18:00:00,130,103,27
1483,1483,14,2022/4/15 18:10:00,179,109,70
1484,1484,14,2022/4/15 18:20:00,132,110,22
1485,1485,14,2022/4/15 18:30:00,77,106,-29
1486,1486,14,2022/4/15 18:40:00,64,101,-37
1487,1487,14,2022/4/15 18:50:00,50,106,-56
1488,1488,14,2022/4/15 19:00:00,45,93,-48
1489,1489,14,2022/4/15 19:10:00,46,82,-36
1490,1490,14,2022/4/15 19:20:00,36,79,-43
1491,1491,14,2022/4/15 19:30:00,31,62,-31
1492,1492,14,2022/4/15 19:40:00,31,70,-39
1493,1493,14,2022/4/15 19:50:00,34,67,-33
1494,1494,14,2022/4/15 20:00:00,32,51,-19
1495,1495,14,2022/4/15 20:10:00,28,63,-35
1496,1496,14,2022/4/15 20:20:00,43,52,-9
1497,1497,14,2022/4/15 20:30:00,30,60,-30
1498,1498,14,2022/4/15 20:40:00,22,46,-24
1499,1499,14,2022/4/15 20:50:00,23,47,-24
1500,1500,14,2022/4/15 21:00:00,25,58,-33
1501,1501,14,2022/4/15 21:10:00,27,41,-14
1502,1502,14,2022/4/15 21:20:00,28,67,-39
1503,1503,14,2022/4/15 21:30:00,24,46,-22
1504,1504,14,2022/4/15 21:40:00,23,46,-23
1505,1505,14,2022/4/15 21:50:00,29,51,-22
1506,1506,14,2022/4/15 22:00:00,21,38,-17
1507,1507,14,2022/4/15 22:10:00,23,48,-25
1508,1508,14,2022/4/15 22:20:00,11,34,-23
1509,1509,14,2022/4/15 22:30:00,1,31,-30
1510,1510,14,2022/4/15 22:40:00,0,10,-10
1511,1511,14,2022/4/15 22:50:00,0,3,-3
1512,1512,15,2022/4/15 5:00:00,0,1,-1
1513,1513,15,2022/4/15 5:10:00,0,1,-1
1514,1514,15,2022/4/15 5:20:00,3,1,2
1515,1515,15,2022/4/15 5:30:00,5,1,4
1516,1516,15,2022/4/15 5:40:00,7,1,6
1517,1517,15,2022/4/15 5:50:00,9,1,8
1518,1518,15,2022/4/15 6:00:00,16,2,14
1519,1519,15,2022/4/15 6:10:00,21,22,-1
1520,1520,15,2022/4/15 6:20:00,33,33,0
1521,1521,15,2022/4/15 6:30:00,34,49,-15
1522,1522,15,2022/4/15 6:40:00,44,58,-14
1523,1523,15,2022/4/15 6:50:00,54,50,4
1524,1524,15,2022/4/15 7:00:00,57,77,-20
1525,1525,15,2022/4/15 7:10:00,73,95,-22
1526,1526,15,2022/4/15 7:20:00,85,105,-20
1527,1527,15,2022/4/15 7:30:00,149,104,45
1528,1528,15,2022/4/15 7:40:00,186,108,78
1529,1529,15,2022/4/15 7:50:00,232,120,112
1530,1530,15,2022/4/15 8:00:00,256,178,78
1531,1531,15,2022/4/15 8:10:00,283,212,71
1532,1532,15,2022/4/15 8:20:00,254,221,33
1533,1533,15,2022/4/15 8:30:00,234,283,-49
1534,1534,15,2022/4/15 8:40:00,184,326,-142
1535,1535,15,2022/4/15 8:50:00,112,197,-85
1536,1536,15,2022/4/15 9:00:00,88,110,-22
1537,1537,15,2022/4/15 9:10:00,60,121,-61
1538,1538,15,2022/4/15 9:20:00,52,117,-65
1539,1539,15,2022/4/15 9:30:00,44,120,-76
1540,1540,15,2022/4/15 9:40:00,39,104,-65
1541,1541,15,2022/4/15 9:50:00,38,105,-67
1542,1542,15,2022/4/15 10:00:00,35,98,-63
1543,1543,15,2022/4/15 10:10:00,38,65,-27
1544,1544,15,2022/4/15 10:20:00,32,77,-45
1545,1545,15,2022/4/15 10:30:00,35,74,-39
1546,1546,15,2022/4/15 10:40:00,33,84,-51
1547,1547,15,2022/4/15 10:50:00,32,76,-44
1548,1548,15,2022/4/15 11:00:00,32,77,-45
1549,1549,15,2022/4/15 11:10:00,31,62,-31
1550,1550,15,2022/4/15 11:20:00,31,69,-38
1551,1551,15,2022/4/15 11:30:00,35,85,-50
1552,1552,15,2022/4/15 11:40:00,33,73,-40
1553,1553,15,2022/4/15 11:50:00,33,79,-46
1554,1554,15,2022/4/15 12:00:00,34,71,-37
1555,1555,15,2022/4/15 12:10:00,38,76,-38
1556,1556,15,2022/4/15 12:20:00,38,74,-36
1557,1557,15,2022/4/15 12:30:00,36,74,-38
1558,1558,15,2022/4/15 12:40:00,38,93,-55
1559,1559,15,2022/4/15 12:50:00,37,92,-55
1560,1560,15,2022/4/15 13:00:00,35,76,-41
1561,1561,15,2022/4/15 13:10:00,36,77,-41
1562,1562,15,2022/4/15 13:20:00,33,77,-44
1563,1563,15,2022/4/15 13:30:00,33,82,-49
1564,1564,15,2022/4/15 13:40:00,37,91,-54
1565,1565,15,2022/4/15 13:50:00,35,87,-52
1566,1566,15,2022/4/15 14:00:00,34,78,-44
1567,1567,15,2022/4/15 14:10:00,40,81,-41
1568,1568,15,2022/4/15 14:20:00,37,83,-46
1569,1569,15,2022/4/15 14:30:00,29,78,-49
1570,1570,15,2022/4/15 14:40:00,31,76,-45
1571,1571,15,2022/4/15 14:50:00,31,91,-60
1572,1572,15,2022/4/15 15:00:00,40,79,-39
1573,1573,15,2022/4/15 15:10:00,35,93,-58
1574,1574,15,2022/4/15 15:20:00,42,83,-41
1575,1575,15,2022/4/15 15:30:00,47,90,-43
1576,1576,15,2022/4/15 15:40:00,45,90,-45
1577,1577,15,2022/4/15 15:50:00,46,90,-44
1578,1578,15,2022/4/15 16:00:00,47,87,-40
1579,1579,15,2022/4/15 16:10:00,47,93,-46
1580,1580,15,2022/4/15 16:20:00,54,105,-51
1581,1581,15,2022/4/15 16:30:00,64,101,-37
1582,1582,15,2022/4/15 16:40:00,77,103,-26
1583,1583,15,2022/4/15 16:50:00,70,103,-33
1584,1584,15,2022/4/15 17:00:00,137,112,25
1585,1585,15,2022/4/15 17:10:00,207,98,109
1586,1586,15,2022/4/15 17:20:00,150,111,39
1587,1587,15,2022/4/15 17:30:00,164,104,60
1588,1588,15,2022/4/15 17:40:00,228,178,50
1589,1589,15,2022/4/15 17:50:00,224,132,92
1590,1590,15,2022/4/15 18:00:00,230,116,114
1591,1591,15,2022/4/15 18:10:00,272,142,130
1592,1592,15,2022/4/15 18:20:00,215,111,104
1593,1593,15,2022/4/15 18:30:00,138,152,-14
1594,1594,15,2022/4/15 18:40:00,96,151,-55
1595,1595,15,2022/4/15 18:50:00,70,109,-39
1596,1596,15,2022/4/15 19:00:00,60,124,-64
1597,1597,15,2022/4/15 19:10:00,44,125,-81
1598,1598,15,2022/4/15 19:20:00,45,103,-58
1599,1599,15,2022/4/15 19:30:00,41,102,-61
1600,1600,15,2022/4/15 19:40:00,34,95,-61
1601,1601,15,2022/4/15 19:50:00,35,77,-42
1602,1602,15,2022/4/15 20:00:00,37,94,-57
1603,1603,15,2022/4/15 20:10:00,40,85,-45
1604,1604,15,2022/4/15 20:20:00,40,77,-37
1605,1605,15,2022/4/15 20:30:00,28,71,-43
1606,1606,15,2022/4/15 20:40:00,36,86,-50
1607,1607,15,2022/4/15 20:50:00,36,75,-39
1608,1608,15,2022/4/15 21:00:00,34,59,-25
1609,1609,15,2022/4/15 21:10:00,37,78,-41
1610,1610,15,2022/4/15 21:20:00,30,63,-33
1611,1611,15,2022/4/15 21:30:00,26,89,-63
1612,1612,15,2022/4/15 21:40:00,28,77,-49
1613,1613,15,2022/4/15 21:50:00,27,62,-35
1614,1614,15,2022/4/15 22:00:00,25,73,-48
1615,1615,15,2022/4/15 22:10:00,13,55,-42
1616,1616,15,2022/4/15 22:20:00,2,87,-85
1617,1617,15,2022/4/15 22:30:00,2,53,-51
1618,1618,15,2022/4/15 22:40:00,1,50,-49
1619,1619,15,2022/4/15 22:50:00,0,18,-18
1620,1620,16,2022/4/15 5:00:00,0,1,-1
1621,1621,16,2022/4/15 5:10:00,0,1,-1
1622,1622,16,2022/4/15 5:20:00,2,1,1
1623,1623,16,2022/4/15 5:30:00,6,1,5
1624,1624,16,2022/4/15 5:40:00,13,1,12
1625,1625,16,2022/4/15 5:50:00,13,5,8
1626,1626,16,2022/4/15 6:00:00,17,8,9
1627,1627,16,2022/4/15 6:10:00,22,23,-1
1628,1628,16,2022/4/15 6:20:00,22,30,-8
1629,1629,16,2022/4/15 6:30:00,30,37,-7
1630,1630,16,2022/4/15 6:40:00,32,63,-31
1631,1631,16,2022/4/15 6:50:00,31,93,-62
1632,1632,16,2022/4/15 7:00:00,42,123,-81
1633,1633,16,2022/4/15 7:10:00,52,109,-57
1634,1634,16,2022/4/15 7:20:00,56,126,-70
1635,1635,16,2022/4/15 7:30:00,67,124,-57
1636,1636,16,2022/4/15 7:40:00,94,139,-45
1637,1637,16,2022/4/15 7:50:00,145,197,-52
1638,1638,16,2022/4/15 8:00:00,180,506,-326
1639,1639,16,2022/4/15 8:10:00,189,565,-376
1640,1640,16,2022/4/15 8:20:00,224,1597,-1373
1641,1641,16,2022/4/15 8:30:00,221,1522,-1301
1642,1642,16,2022/4/15 8:40:00,176,1981,-1805
1643,1643,16,2022/4/15 8:50:00,150,1521,-1371
1644,1644,16,2022/4/15 9:00:00,84,429,-345
1645,1645,16,2022/4/15 9:10:00,74,508,-434
1646,1646,16,2022/4/15 9:20:00,68,317,-249
1647,1647,16,2022/4/15 9:30:00,58,190,-132
1648,1648,16,2022/4/15 9:40:00,53,169,-116
1649,1649,16,2022/4/15 9:50:00,49,142,-93
1650,1650,16,2022/4/15 10:00:00,45,129,-84
1651,1651,16,2022/4/15 10:10:00,43,102,-59
1652,1652,16,2022/4/15 10:20:00,49,114,-65
1653,1653,16,2022/4/15 10:30:00,47,104,-57
1654,1654,16,2022/4/15 10:40:00,45,113,-68
1655,1655,16,2022/4/15 10:50:00,42,112,-70
1656,1656,16,2022/4/15 11:00:00,44,111,-67
1657,1657,16,2022/4/15 11:10:00,48,106,-58
1658,1658,16,2022/4/15 11:20:00,45,101,-56
1659,1659,16,2022/4/15 11:30:00,49,111,-62
1660,1660,16,2022/4/15 11:40:00,49,104,-55
1661,1661,16,2022/4/15 11:50:00,47,110,-63
1662,1662,16,2022/4/15 12:00:00,56,100,-44
1663,1663,16,2022/4/15 12:10:00,59,105,-46
1664,1664,16,2022/4/15 12:20:00,45,108,-63
1665,1665,16,2022/4/15 12:30:00,58,108,-50
1666,1666,16,2022/4/15 12:40:00,50,109,-59
1667,1667,16,2022/4/15 12:50:00,58,108,-50
1668,1668,16,2022/4/15 13:00:00,54,105,-51
1669,1669,16,2022/4/15 13:10:00,67,107,-40
1670,1670,16,2022/4/15 13:20:00,62,105,-43
1671,1671,16,2022/4/15 13:30:00,60,109,-49
1672,1672,16,2022/4/15 13:40:00,58,108,-50
1673,1673,16,2022/4/15 13:50:00,60,105,-45
1674,1674,16,2022/4/15 14:00:00,56,112,-56
1675,1675,16,2022/4/15 14:10:00,55,111,-56
1676,1676,16,2022/4/15 14:20:00,58,106,-48
1677,1677,16,2022/4/15 14:30:00,56,106,-50
1678,1678,16,2022/4/15 14:40:00,52,112,-60
1679,1679,16,2022/4/15 14:50:00,57,112,-55
1680,1680,16,2022/4/15 15:00:00,56,105,-49
1681,1681,16,2022/4/15 15:10:00,71,109,-38
1682,1682,16,2022/4/15 15:20:00,77,104,-27
1683,1683,16,2022/4/15 15:30:00,67,104,-37
1684,1684,16,2022/4/15 15:40:00,83,108,-25
1685,1685,16,2022/4/15 15:50:00,68,103,-35
1686,1686,16,2022/4/15 16:00:00,85,109,-24
1687,1687,16,2022/4/15 16:10:00,79,105,-26
1688,1688,16,2022/4/15 16:20:00,92,106,-14
1689,1689,16,2022/4/15 16:30:00,167,105,62
1690,1690,16,2022/4/15 16:40:00,178,105,73
1691,1691,16,2022/4/15 16:50:00,206,106,100
1692,1692,16,2022/4/15 17:00:00,342,109,233
1693,1693,16,2022/4/15 17:10:00,461,97,364
1694,1694,16,2022/4/15 17:20:00,312,120,192
1695,1695,16,2022/4/15 17:30:00,657,109,548
1696,1696,16,2022/4/15 17:40:00,1045,132,913
1697,1697,16,2022/4/15 17:50:00,710,181,529
1698,1698,16,2022/4/15 18:00:00,835,152,683
1699,1699,16,2022/4/15 18:10:00,1149,153,996
1700,1700,16,2022/4/15 18:20:00,679,153,526
1701,1701,16,2022/4/15 18:30:00,576,150,426
1702,1702,16,2022/4/15 18:40:00,311,144,167
1703,1703,16,2022/4/15 18:50:00,274,116,158
1704,1704,16,2022/4/15 19:00:00,216,111,105
1705,1705,16,2022/4/15 19:10:00,222,112,110
1706,1706,16,2022/4/15 19:20:00,178,115,63
1707,1707,16,2022/4/15 19:30:00,175,97,78
1708,1708,16,2022/4/15 19:40:00,139,95,44
1709,1709,16,2022/4/15 19:50:00,130,83,47
1710,1710,16,2022/4/15 20:00:00,102,99,3
1711,1711,16,2022/4/15 20:10:00,84,71,13
1712,1712,16,2022/4/15 20:20:00,70,79,-9
1713,1713,16,2022/4/15 20:30:00,67,63,4
1714,1714,16,2022/4/15 20:40:00,67,87,-20
1715,1715,16,2022/4/15 20:50:00,76,67,9
1716,1716,16,2022/4/15 21:00:00,64,85,-21
1717,1717,16,2022/4/15 21:10:00,59,69,-10
1718,1718,16,2022/4/15 21:20:00,43,75,-32
1719,1719,16,2022/4/15 21:30:00,39,79,-40
1720,1720,16,2022/4/15 21:40:00,38,67,-29
1721,1721,16,2022/4/15 21:50:00,30,77,-47
1722,1722,16,2022/4/15 22:00:00,39,61,-22
1723,1723,16,2022/4/15 22:10:00,26,76,-50
1724,1724,16,2022/4/15 22:20:00,12,74,-62
1725,1725,16,2022/4/15 22:30:00,5,67,-62
1726,1726,16,2022/4/15 22:40:00,0,24,-24
1727,1727,16,2022/4/15 22:50:00,0,3,-3
1728,1728,17,2022/4/15 5:00:00,0,1,-1
1729,1729,17,2022/4/15 5:10:00,0,1,-1
1730,1730,17,2022/4/15 5:20:00,1,1,0
1731,1731,17,2022/4/15 5:30:00,6,1,5
1732,1732,17,2022/4/15 5:40:00,6,2,4
1733,1733,17,2022/4/15 5:50:00,15,1,14
1734,1734,17,2022/4/15 6:00:00,20,5,15
1735,1735,17,2022/4/15 6:10:00,29,19,10
1736,1736,17,2022/4/15 6:20:00,33,29,4
1737,1737,17,2022/4/15 6:30:00,43,30,13
1738,1738,17,2022/4/15 6:40:00,48,42,6
1739,1739,17,2022/4/15 6:50:00,60,68,-8
1740,1740,17,2022/4/15 7:00:00,94,83,11
1741,1741,17,2022/4/15 7:10:00,108,72,36
1742,1742,17,2022/4/15 7:20:00,108,96,12
1743,1743,17,2022/4/15 7:30:00,224,127,97
1744,1744,17,2022/4/15 7:40:00,246,109,137
1745,1745,17,2022/4/15 7:50:00,275,139,136
1746,1746,17,2022/4/15 8:00:00,302,206,96
1747,1747,17,2022/4/15 8:10:00,280,296,-16
1748,1748,17,2022/4/15 8:20:00,279,344,-65
1749,1749,17,2022/4/15 8:30:00,266,380,-114
1750,1750,17,2022/4/15 8:40:00,217,495,-278
1751,1751,17,2022/4/15 8:50:00,168,246,-78
1752,1752,17,2022/4/15 9:00:00,115,192,-77
1753,1753,17,2022/4/15 9:10:00,74,128,-54
1754,1754,17,2022/4/15 9:20:00,61,121,-60
1755,1755,17,2022/4/15 9:30:00,52,102,-50
1756,1756,17,2022/4/15 9:40:00,46,115,-69
1757,1757,17,2022/4/15 9:50:00,39,93,-54
1758,1758,17,2022/4/15 10:00:00,38,77,-39
1759,1759,17,2022/4/15 10:10:00,40,73,-33
1760,1760,17,2022/4/15 10:20:00,38,73,-35
1761,1761,17,2022/4/15 10:30:00,35,62,-27
1762,1762,17,2022/4/15 10:40:00,31,71,-40
1763,1763,17,2022/4/15 10:50:00,29,66,-37
1764,1764,17,2022/4/15 11:00:00,37,62,-25
1765,1765,17,2022/4/15 11:10:00,35,65,-30
1766,1766,17,2022/4/15 11:20:00,29,68,-39
1767,1767,17,2022/4/15 11:30:00,32,61,-29
1768,1768,17,2022/4/15 11:40:00,28,65,-37
1769,1769,17,2022/4/15 11:50:00,27,71,-44
1770,1770,17,2022/4/15 12:00:00,29,66,-37
1771,1771,17,2022/4/15 12:10:00,31,74,-43
1772,1772,17,2022/4/15 12:20:00,34,75,-41
1773,1773,17,2022/4/15 12:30:00,28,73,-45
1774,1774,17,2022/4/15 12:40:00,33,69,-36
1775,1775,17,2022/4/15 12:50:00,34,82,-48
1776,1776,17,2022/4/15 13:00:00,29,71,-42
1777,1777,17,2022/4/15 13:10:00,31,83,-52
1778,1778,17,2022/4/15 13:20:00,32,78,-46
1779,1779,17,2022/4/15 13:30:00,29,84,-55
1780,1780,17,2022/4/15 13:40:00,28,85,-57
1781,1781,17,2022/4/15 13:50:00,32,76,-44
1782,1782,17,2022/4/15 14:00:00,32,77,-45
1783,1783,17,2022/4/15 14:10:00,26,67,-41
1784,1784,17,2022/4/15 14:20:00,36,71,-35
1785,1785,17,2022/4/15 14:30:00,27,77,-50
1786,1786,17,2022/4/15 14:40:00,34,87,-53
1787,1787,17,2022/4/15 14:50:00,36,78,-42
1788,1788,17,2022/4/15 15:00:00,35,72,-37
1789,1789,17,2022/4/15 15:10:00,44,77,-33
1790,1790,17,2022/4/15 15:20:00,41,77,-36
1791,1791,17,2022/4/15 15:30:00,35,73,-38
1792,1792,17,2022/4/15 15:40:00,41,80,-39
1793,1793,17,2022/4/15 15:50:00,30,93,-63
1794,1794,17,2022/4/15 16:00:00,50,78,-28
1795,1795,17,2022/4/15 16:10:00,66,90,-24
1796,1796,17,2022/4/15 16:20:00,44,93,-49
1797,1797,17,2022/4/15 16:30:00,69,98,-29
1798,1798,17,2022/4/15 16:40:00,70,104,-34
1799,1799,17,2022/4/15 16:50:00,75,108,-33
1800,1800,17,2022/4/15 17:00:00,197,104,93
1801,1801,17,2022/4/15 17:10:00,262,112,150
1802,1802,17,2022/4/15 17:20:00,238,126,112
1803,1803,17,2022/4/15 17:30:00,222,123,99
1804,1804,17,2022/4/15 17:40:00,326,124,202
1805,1805,17,2022/4/15 17:50:00,278,108,170
1806,1806,17,2022/4/15 18:00:00,217,109,108
1807,1807,17,2022/4/15 18:10:00,340,117,223
1808,1808,17,2022/4/15 18:20:00,256,144,112
1809,1809,17,2022/4/15 18:30:00,171,111,60
1810,1810,17,2022/4/15 18:40:00,93,109,-16
1811,1811,17,2022/4/15 18:50:00,64,112,-48
1812,1812,17,2022/4/15 19:00:00,47,121,-74
1813,1813,17,2022/4/15 19:10:00,46,122,-76
1814,1814,17,2022/4/15 19:20:00,35,104,-69
1815,1815,17,2022/4/15 19:30:00,38,101,-63
1816,1816,17,2022/4/15 19:40:00,35,81,-46
1817,1817,17,2022/4/15 19:50:00,28,92,-64
1818,1818,17,2022/4/15 20:00:00,29,78,-49
1819,1819,17,2022/4/15 20:10:00,31,76,-45
1820,1820,17,2022/4/15 20:20:00,29,64,-35
1821,1821,17,2022/4/15 20:30:00,29,94,-65
1822,1822,17,2022/4/15 20:40:00,26,72,-46
1823,1823,17,2022/4/15 20:50:00,28,79,-51
1824,1824,17,2022/4/15 21:00:00,26,81,-55
1825,1825,17,2022/4/15 21:10:00,26,62,-36
1826,1826,17,2022/4/15 21:20:00,25,91,-66
1827,1827,17,2022/4/15 21:30:00,21,74,-53
1828,1828,17,2022/4/15 21:40:00,24,92,-68
1829,1829,17,2022/4/15 21:50:00,20,83,-63
1830,1830,17,2022/4/15 22:00:00,18,62,-44
1831,1831,17,2022/4/15 22:10:00,12,77,-65
1832,1832,17,2022/4/15 22:20:00,2,55,-53
1833,1833,17,2022/4/15 22:30:00,2,64,-62
1834,1834,17,2022/4/15 22:40:00,1,40,-39
1835,1835,17,2022/4/15 22:50:00,0,3,-3
1836,1836,18,2022/4/15 5:00:00,0,1,-1
1837,1837,18,2022/4/15 5:10:00,0,1,-1
1838,1838,18,2022/4/15 5:20:00,1,1,0
1839,1839,18,2022/4/15 5:30:00,5,1,4
1840,1840,18,2022/4/15 5:40:00,10,8,2
1841,1841,18,2022/4/15 5:50:00,15,23,-8
1842,1842,18,2022/4/15 6:00:00,16,57,-41
1843,1843,18,2022/4/15 6:10:00,19,59,-40
1844,1844,18,2022/4/15 6:20:00,27,68,-41
1845,1845,18,2022/4/15 6:30:00,24,93,-69
1846,1846,18,2022/4/15 6:40:00,33,106,-73
1847,1847,18,2022/4/15 6:50:00,32,105,-73
1848,1848,18,2022/4/15 7:00:00,37,123,-86
1849,1849,18,2022/4/15 7:10:00,31,123,-92
1850,1850,18,2022/4/15 7:20:00,44,128,-84
1851,1851,18,2022/4/15 7:30:00,52,152,-100
1852,1852,18,2022/4/15 7:40:00,57,152,-95
1853,1853,18,2022/4/15 7:50:00,61,269,-208
1854,1854,18,2022/4/15 8:00:00,70,325,-255
1855,1855,18,2022/4/15 8:10:00,75,421,-346
1856,1856,18,2022/4/15 8:20:00,69,491,-422
1857,1857,18,2022/4/15 8:30:00,68,589,-521
1858,1858,18,2022/4/15 8:40:00,54,574,-520
1859,1859,18,2022/4/15 8:50:00,53,505,-452
1860,1860,18,2022/4/15 9:00:00,49,333,-284
1861,1861,18,2022/4/15 9:10:00,45,298,-253
1862,1862,18,2022/4/15 9:20:00,43,196,-153
1863,1863,18,2022/4/15 9:30:00,42,225,-183
1864,1864,18,2022/4/15 9:40:00,46,232,-186
1865,1865,18,2022/4/15 9:50:00,47,221,-174
1866,1866,18,2022/4/15 10:00:00,41,179,-138
1867,1867,18,2022/4/15 10:10:00,44,192,-148
1868,1868,18,2022/4/15 10:20:00,40,192,-152
1869,1869,18,2022/4/15 10:30:00,44,180,-136
1870,1870,18,2022/4/15 10:40:00,48,146,-98
1871,1871,18,2022/4/15 10:50:00,51,146,-95
1872,1872,18,2022/4/15 11:00:00,62,169,-107
1873,1873,18,2022/4/15 11:10:00,60,153,-93
1874,1874,18,2022/4/15 11:20:00,66,138,-72
1875,1875,18,2022/4/15 11:30:00,70,181,-111
1876,1876,18,2022/4/15 11:40:00,73,151,-78
1877,1877,18,2022/4/15 11:50:00,75,142,-67
1878,1878,18,2022/4/15 12:00:00,82,137,-55
1879,1879,18,2022/4/15 12:10:00,108,151,-43
1880,1880,18,2022/4/15 12:20:00,124,110,14
1881,1881,18,2022/4/15 12:30:00,124,170,-46
1882,1882,18,2022/4/15 12:40:00,132,138,-6
1883,1883,18,2022/4/15 12:50:00,156,153,3
1884,1884,18,2022/4/15 13:00:00,175,152,23
1885,1885,18,2022/4/15 13:10:00,174,146,28
1886,1886,18,2022/4/15 13:20:00,173,182,-9
1887,1887,18,2022/4/15 13:30:00,198,170,28
1888,1888,18,2022/4/15 13:40:00,204,192,12
1889,1889,18,2022/4/15 13:50:00,191,154,37
1890,1890,18,2022/4/15 14:00:00,203,170,33
1891,1891,18,2022/4/15 14:10:00,206,139,67
1892,1892,18,2022/4/15 14:20:00,207,119,88
1893,1893,18,2022/4/15 14:30:00,201,138,63
1894,1894,18,2022/4/15 14:40:00,217,105,112
1895,1895,18,2022/4/15 14:50:00,242,105,137
1896,1896,18,2022/4/15 15:00:00,243,109,134
1897,1897,18,2022/4/15 15:10:00,268,110,158
1898,1898,18,2022/4/15 15:20:00,272,122,150
1899,1899,18,2022/4/15 15:30:00,267,119,148
1900,1900,18,2022/4/15 15:40:00,270,116,154
1901,1901,18,2022/4/15 15:50:00,261,88,173
1902,1902,18,2022/4/15 16:00:00,265,102,163
1903,1903,18,2022/4/15 16:10:00,287,108,179
1904,1904,18,2022/4/15 16:20:00,293,102,191
1905,1905,18,2022/4/15 16:30:00,331,105,226
1906,1906,18,2022/4/15 16:40:00,350,96,254
1907,1907,18,2022/4/15 16:50:00,368,96,272
1908,1908,18,2022/4/15 17:00:00,695,99,596
1909,1909,18,2022/4/15 17:10:00,654,90,564
1910,1910,18,2022/4/15 17:20:00,598,99,499
1911,1911,18,2022/4/15 17:30:00,618,98,520
1912,1912,18,2022/4/15 17:40:00,706,93,613
1913,1913,18,2022/4/15 17:50:00,698,104,594
1914,1914,18,2022/4/15 18:00:00,575,108,467
1915,1915,18,2022/4/15 18:10:00,639,92,547
1916,1916,18,2022/4/15 18:20:00,368,99,269
1917,1917,18,2022/4/15 18:30:00,273,112,161
1918,1918,18,2022/4/15 18:40:00,218,92,126
1919,1919,18,2022/4/15 18:50:00,174,93,81
1920,1920,18,2022/4/15 19:00:00,127,68,59
1921,1921,18,2022/4/15 19:10:00,73,69,4
1922,1922,18,2022/4/15 19:20:00,42,67,-25
1923,1923,18,2022/4/15 19:30:00,36,67,-31
1924,1924,18,2022/4/15 19:40:00,30,59,-29
1925,1925,18,2022/4/15 19:50:00,29,51,-22
1926,1926,18,2022/4/15 20:00:00,31,47,-16
1927,1927,18,2022/4/15 20:10:00,31,56,-25
1928,1928,18,2022/4/15 20:20:00,26,49,-23
1929,1929,18,2022/4/15 20:30:00,24,67,-43
1930,1930,18,2022/4/15 20:40:00,25,47,-22
1931,1931,18,2022/4/15 20:50:00,23,63,-40
1932,1932,18,2022/4/15 21:00:00,29,47,-18
1933,1933,18,2022/4/15 21:10:00,27,53,-26
1934,1934,18,2022/4/15 21:20:00,23,49,-26
1935,1935,18,2022/4/15 21:30:00,20,60,-40
1936,1936,18,2022/4/15 21:40:00,22,54,-32
1937,1937,18,2022/4/15 21:50:00,15,51,-36
1938,1938,18,2022/4/15 22:00:00,20,56,-36
1939,1939,18,2022/4/15 22:10:00,11,40,-29
1940,1940,18,2022/4/15 22:20:00,6,71,-65
1941,1941,18,2022/4/15 22:30:00,2,55,-53
1942,1942,18,2022/4/15 22:40:00,0,25,-25
1943,1943,18,2022/4/15 22:50:00,0,3,-3
1944,1944,19,2022/4/15 5:00:00,0,1,-1
1945,1945,19,2022/4/15 5:10:00,2,1,1
1946,1946,19,2022/4/15 5:20:00,5,1,4
1947,1947,19,2022/4/15 5:30:00,16,1,15
1948,1948,19,2022/4/15 5:40:00,18,1,17
1949,1949,19,2022/4/15 5:50:00,16,1,15
1950,1950,19,2022/4/15 6:00:00,25,1,24
1951,1951,19,2022/4/15 6:10:00,27,19,8
1952,1952,19,2022/4/15 6:20:00,32,14,18
1953,1953,19,2022/4/15 6:30:00,36,23,13
1954,1954,19,2022/4/15 6:40:00,57,34,23
1955,1955,19,2022/4/15 6:50:00,70,25,45
1956,1956,19,2022/4/15 7:00:00,76,54,22
1957,1957,19,2022/4/15 7:10:00,109,72,37
1958,1958,19,2022/4/15 7:20:00,187,78,109
1959,1959,19,2022/4/15 7:30:00,255,105,150
1960,1960,19,2022/4/15 7:40:00,361,184,177
1961,1961,19,2022/4/15 7:50:00,376,133,243
1962,1962,19,2022/4/15 8:00:00,572,298,274
1963,1963,19,2022/4/15 8:10:00,591,212,379
1964,1964,19,2022/4/15 8:20:00,436,232,204
1965,1965,19,2022/4/15 8:30:00,392,268,124
1966,1966,19,2022/4/15 8:40:00,277,326,-49
1967,1967,19,2022/4/15 8:50:00,254,323,-69
1968,1968,19,2022/4/15 9:00:00,197,268,-71
1969,1969,19,2022/4/15 9:10:00,162,208,-46
1970,1970,19,2022/4/15 9:20:00,93,184,-91
1971,1971,19,2022/4/15 9:30:00,67,119,-52
1972,1972,19,2022/4/15 9:40:00,64,114,-50
1973,1973,19,2022/4/15 9:50:00,52,114,-62
1974,1974,19,2022/4/15 10:00:00,44,105,-61
1975,1975,19,2022/4/15 10:10:00,45,99,-54
1976,1976,19,2022/4/15 10:20:00,43,94,-51
1977,1977,19,2022/4/15 10:30:00,36,97,-61
1978,1978,19,2022/4/15 10:40:00,40,89,-49
1979,1979,19,2022/4/15 10:50:00,30,75,-45
1980,1980,19,2022/4/15 11:00:00,37,87,-50
1981,1981,19,2022/4/15 11:10:00,43,76,-33
1982,1982,19,2022/4/15 11:20:00,40,75,-35
1983,1983,19,2022/4/15 11:30:00,52,78,-26
1984,1984,19,2022/4/15 11:40:00,66,87,-21
1985,1985,19,2022/4/15 11:50:00,85,87,-2
1986,1986,19,2022/4/15 12:00:00,72,76,-4
1987,1987,19,2022/4/15 12:10:00,62,92,-30
1988,1988,19,2022/4/15 12:20:00,62,92,-30
1989,1989,19,2022/4/15 12:30:00,67,95,-28
1990,1990,19,2022/4/15 12:40:00,63,98,-35
1991,1991,19,2022/4/15 12:50:00,57,106,-49
1992,1992,19,2022/4/15 13:00:00,60,105,-45
1993,1993,19,2022/4/15 13:10:00,60,105,-45
1994,1994,19,2022/4/15 13:20:00,60,102,-42
1995,1995,19,2022/4/15 13:30:00,54,110,-56
1996,1996,19,2022/4/15 13:40:00,43,110,-67
1997,1997,19,2022/4/15 13:50:00,41,99,-58
1998,1998,19,2022/4/15 14:00:00,44,94,-50
1999,1999,19,2022/4/15 14:10:00,50,96,-46
2000,2000,19,2022/4/15 14:20:00,44,93,-49
2001,2001,19,2022/4/15 14:30:00,44,106,-62
2002,2002,19,2022/4/15 14:40:00,40,97,-57
2003,2003,19,2022/4/15 14:50:00,41,101,-60
2004,2004,19,2022/4/15 15:00:00,45,104,-59
2005,2005,19,2022/4/15 15:10:00,95,97,-2
2006,2006,19,2022/4/15 15:20:00,64,103,-39
2007,2007,19,2022/4/15 15:30:00,53,101,-48
2008,2008,19,2022/4/15 15:40:00,49,111,-62
2009,2009,19,2022/4/15 15:50:00,61,101,-40
2010,2010,19,2022/4/15 16:00:00,61,103,-42
2011,2011,19,2022/4/15 16:10:00,62,110,-48
2012,2012,19,2022/4/15 16:20:00,69,109,-40
2013,2013,19,2022/4/15 16:30:00,93,104,-11
2014,2014,19,2022/4/15 16:40:00,138,102,36
2015,2015,19,2022/4/15 16:50:00,174,109,65
2016,2016,19,2022/4/15 17:00:00,267,123,144
2017,2017,19,2022/4/15 17:10:00,310,124,186
2018,2018,19,2022/4/15 17:20:00,283,118,165
2019,2019,19,2022/4/15 17:30:00,298,110,188
2020,2020,19,2022/4/15 17:40:00,367,183,184
2021,2021,19,2022/4/15 17:50:00,334,177,157
2022,2022,19,2022/4/15 18:00:00,266,208,58
2023,2023,19,2022/4/15 18:10:00,265,223,42
2024,2024,19,2022/4/15 18:20:00,256,236,20
2025,2025,19,2022/4/15 18:30:00,183,224,-41
2026,2026,19,2022/4/15 18:40:00,150,220,-70
2027,2027,19,2022/4/15 18:50:00,96,178,-82
2028,2028,19,2022/4/15 19:00:00,68,226,-158
2029,2029,19,2022/4/15 19:10:00,70,139,-69
2030,2030,19,2022/4/15 19:20:00,53,120,-67
2031,2031,19,2022/4/15 19:30:00,44,109,-65
2032,2032,19,2022/4/15 19:40:00,41,127,-86
2033,2033,19,2022/4/15 19:50:00,41,113,-72
2034,2034,19,2022/4/15 20:00:00,45,120,-75
2035,2035,19,2022/4/15 20:10:00,45,110,-65
2036,2036,19,2022/4/15 20:20:00,43,99,-56
2037,2037,19,2022/4/15 20:30:00,44,106,-62
2038,2038,19,2022/4/15 20:40:00,47,105,-58
2039,2039,19,2022/4/15 20:50:00,45,106,-61
2040,2040,19,2022/4/15 21:00:00,44,122,-78
2041,2041,19,2022/4/15 21:10:00,37,93,-56
2042,2042,19,2022/4/15 21:20:00,37,114,-77
2043,2043,19,2022/4/15 21:30:00,35,105,-70
2044,2044,19,2022/4/15 21:40:00,30,112,-82
2045,2045,19,2022/4/15 21:50:00,33,121,-88
2046,2046,19,2022/4/15 22:00:00,25,96,-71
2047,2047,19,2022/4/15 22:10:00,12,105,-93
2048,2048,19,2022/4/15 22:20:00,3,71,-68
2049,2049,19,2022/4/15 22:30:00,2,96,-94
2050,2050,19,2022/4/15 22:40:00,2,71,-69
2051,2051,19,2022/4/15 22:50:00,0,39,-39
2052,2052,20,2022/4/15 5:00:00,0,1,-1
2053,2053,20,2022/4/15 5:10:00,3,1,2
2054,2054,20,2022/4/15 5:20:00,6,1,5
2055,2055,20,2022/4/15 5:30:00,10,1,9
2056,2056,20,2022/4/15 5:40:00,10,1,9
2057,2057,20,2022/4/15 5:50:00,13,2,11
2058,2058,20,2022/4/15 6:00:00,20,1,19
2059,2059,20,2022/4/15 6:10:00,27,21,6
2060,2060,20,2022/4/15 6:20:00,28,32,-4
2061,2061,20,2022/4/15 6:30:00,35,37,-2
2062,2062,20,2022/4/15 6:40:00,40,47,-7
2063,2063,20,2022/4/15 6:50:00,59,51,8
2064,2064,20,2022/4/15 7:00:00,64,58,6
2065,2065,20,2022/4/15 7:10:00,75,72,3
2066,2066,20,2022/4/15 7:20:00,157,75,82
2067,2067,20,2022/4/15 7:30:00,217,96,121
2068,2068,20,2022/4/15 7:40:00,282,124,158
2069,2069,20,2022/4/15 7:50:00,280,108,172
2070,2070,20,2022/4/15 8:00:00,345,189,156
2071,2071,20,2022/4/15 8:10:00,359,178,181
2072,2072,20,2022/4/15 8:20:00,318,501,-183
2073,2073,20,2022/4/15 8:30:00,245,298,-53
2074,2074,20,2022/4/15 8:40:00,227,496,-269
2075,2075,20,2022/4/15 8:50:00,163,381,-218
2076,2076,20,2022/4/15 9:00:00,90,299,-209
2077,2077,20,2022/4/15 9:10:00,74,325,-251
2078,2078,20,2022/4/15 9:20:00,70,181,-111
2079,2079,20,2022/4/15 9:30:00,52,122,-70
2080,2080,20,2022/4/15 9:40:00,43,150,-107
2081,2081,20,2022/4/15 9:50:00,42,114,-72
2082,2082,20,2022/4/15 10:00:00,37,124,-87
2083,2083,20,2022/4/15 10:10:00,43,100,-57
2084,2084,20,2022/4/15 10:20:00,35,106,-71
2085,2085,20,2022/4/15 10:30:00,33,110,-77
2086,2086,20,2022/4/15 10:40:00,37,102,-65
2087,2087,20,2022/4/15 10:50:00,38,101,-63
2088,2088,20,2022/4/15 11:00:00,39,107,-68
2089,2089,20,2022/4/15 11:10:00,38,101,-63
2090,2090,20,2022/4/15 11:20:00,37,110,-73
2091,2091,20,2022/4/15 11:30:00,36,102,-66
2092,2092,20,2022/4/15 11:40:00,43,103,-60
2093,2093,20,2022/4/15 11:50:00,41,99,-58
2094,2094,20,2022/4/15 12:00:00,41,110,-69
2095,2095,20,2022/4/15 12:10:00,43,108,-65
2096,2096,20,2022/4/15 12:20:00,52,104,-52
2097,2097,20,2022/4/15 12:30:00,43,108,-65
2098,2098,20,2022/4/15 12:40:00,46,106,-60
2099,2099,20,2022/4/15 12:50:00,54,102,-48
2100,2100,20,2022/4/15 13:00:00,54,104,-50
2101,2101,20,2022/4/15 13:10:00,60,111,-51
2102,2102,20,2022/4/15 13:20:00,53,122,-69
2103,2103,20,2022/4/15 13:30:00,41,105,-64
2104,2104,20,2022/4/15 13:40:00,57,120,-63
2105,2105,20,2022/4/15 13:50:00,47,110,-63
2106,2106,20,2022/4/15 14:00:00,47,103,-56
2107,2107,20,2022/4/15 14:10:00,55,106,-51
2108,2108,20,2022/4/15 14:20:00,46,109,-63
2109,2109,20,2022/4/15 14:30:00,49,86,-37
2110,2110,20,2022/4/15 14:40:00,55,99,-44
2111,2111,20,2022/4/15 14:50:00,62,108,-46
2112,2112,20,2022/4/15 15:00:00,58,103,-45
2113,2113,20,2022/4/15 15:10:00,56,104,-48
2114,2114,20,2022/4/15 15:20:00,58,100,-42
2115,2115,20,2022/4/15 15:30:00,55,117,-62
2116,2116,20,2022/4/15 15:40:00,53,116,-63
2117,2117,20,2022/4/15 15:50:00,65,105,-40
2118,2118,20,2022/4/15 16:00:00,64,123,-59
2119,2119,20,2022/4/15 16:10:00,77,100,-23
2120,2120,20,2022/4/15 16:20:00,75,119,-44
2121,2121,20,2022/4/15 16:30:00,75,115,-40
2122,2122,20,2022/4/15 16:40:00,76,110,-34
2123,2123,20,2022/4/15 16:50:00,70,150,-80
2124,2124,20,2022/4/15 17:00:00,139,108,31
2125,2125,20,2022/4/15 17:10:00,202,149,53
2126,2126,20,2022/4/15 17:20:00,216,178,38
2127,2127,20,2022/4/15 17:30:00,214,196,18
2128,2128,20,2022/4/15 17:40:00,334,232,102
2129,2129,20,2022/4/15 17:50:00,268,323,-55
2130,2130,20,2022/4/15 18:00:00,204,329,-125
2131,2131,20,2022/4/15 18:10:00,269,327,-58
2132,2132,20,2022/4/15 18:20:00,316,326,-10
2133,2133,20,2022/4/15 18:30:00,257,328,-71
2134,2134,20,2022/4/15 18:40:00,244,321,-77
2135,2135,20,2022/4/15 18:50:00,243,285,-42
2136,2136,20,2022/4/15 19:00:00,177,209,-32
2137,2137,20,2022/4/15 19:10:00,143,145,-2
2138,2138,20,2022/4/15 19:20:00,129,107,22
2139,2139,20,2022/4/15 19:30:00,73,111,-38
2140,2140,20,2022/4/15 19:40:00,74,120,-46
2141,2141,20,2022/4/15 19:50:00,65,109,-44
2142,2142,20,2022/4/15 20:00:00,63,104,-41
2143,2143,20,2022/4/15 20:10:00,75,87,-12
2144,2144,20,2022/4/15 20:20:00,76,98,-22
2145,2145,20,2022/4/15 20:30:00,72,106,-34
2146,2146,20,2022/4/15 20:40:00,68,89,-21
2147,2147,20,2022/4/15 20:50:00,64,113,-49
2148,2148,20,2022/4/15 21:00:00,83,72,11
2149,2149,20,2022/4/15 21:10:00,89,112,-23
2150,2150,20,2022/4/15 21:20:00,70,72,-2
2151,2151,20,2022/4/15 21:30:00,74,89,-15
2152,2152,20,2022/4/15 21:40:00,66,72,-6
2153,2153,20,2022/4/15 21:50:00,63,103,-40
2154,2154,20,2022/4/15 22:00:00,42,78,-36
2155,2155,20,2022/4/15 22:10:00,6,73,-67
2156,2156,20,2022/4/15 22:20:00,1,94,-93
2157,2157,20,2022/4/15 22:30:00,0,62,-62
2158,2158,20,2022/4/15 22:40:00,0,62,-62
2159,2159,20,2022/4/15 22:50:00,1,38,-37
2160,2160,21,2022/4/15 5:00:00,1,1,0
2161,2161,21,2022/4/15 5:10:00,3,1,2
2162,2162,21,2022/4/15 5:20:00,8,1,7
2163,2163,21,2022/4/15 5:30:00,8,1,7
2164,2164,21,2022/4/15 5:40:00,8,1,7
2165,2165,21,2022/4/15 5:50:00,9,1,8
2166,2166,21,2022/4/15 6:00:00,23,1,22
2167,2167,21,2022/4/15 6:10:00,23,1,22
2168,2168,21,2022/4/15 6:20:00,26,11,15
2169,2169,21,2022/4/15 6:30:00,32,25,7
2170,2170,21,2022/4/15 6:40:00,64,29,35
2171,2171,21,2022/4/15 6:50:00,68,32,36
2172,2172,21,2022/4/15 7:00:00,88,46,42
2173,2173,21,2022/4/15 7:10:00,196,37,159
2174,2174,21,2022/4/15 7:20:00,267,38,229
2175,2175,21,2022/4/15 7:30:00,278,50,228
2176,2176,21,2022/4/15 7:40:00,382,51,331
2177,2177,21,2022/4/15 7:50:00,597,48,549
2178,2178,21,2022/4/15 8:00:00,442,53,389
2179,2179,21,2022/4/15 8:10:00,332,71,261
2180,2180,21,2022/4/15 8:20:00,280,67,213
2181,2181,21,2022/4/15 8:30:00,233,70,163
2182,2182,21,2022/4/15 8:40:00,169,70,99
2183,2183,21,2022/4/15 8:50:00,127,51,76
2184,2184,21,2022/4/15 9:00:00,48,45,3
2185,2185,21,2022/4/15 9:10:00,42,51,-9
2186,2186,21,2022/4/15 9:20:00,41,45,-4
2187,2187,21,2022/4/15 9:30:00,37,45,-8
2188,2188,21,2022/4/15 9:40:00,32,40,-8
2189,2189,21,2022/4/15 9:50:00,28,38,-10
2190,2190,21,2022/4/15 10:00:00,25,40,-15
2191,2191,21,2022/4/15 10:10:00,20,38,-18
2192,2192,21,2022/4/15 10:20:00,23,37,-14
2193,2193,21,2022/4/15 10:30:00,19,37,-18
2194,2194,21,2022/4/15 10:40:00,20,37,-17
2195,2195,21,2022/4/15 10:50:00,17,42,-25
2196,2196,21,2022/4/15 11:00:00,16,39,-23
2197,2197,21,2022/4/15 11:10:00,18,41,-23
2198,2198,21,2022/4/15 11:20:00,20,39,-19
2199,2199,21,2022/4/15 11:30:00,17,39,-22
2200,2200,21,2022/4/15 11:40:00,20,37,-17
2201,2201,21,2022/4/15 11:50:00,23,37,-14
2202,2202,21,2022/4/15 12:00:00,27,37,-10
2203,2203,21,2022/4/15 12:10:00,23,42,-19
2204,2204,21,2022/4/15 12:20:00,21,39,-18
2205,2205,21,2022/4/15 12:30:00,23,46,-23
2206,2206,21,2022/4/15 12:40:00,23,45,-22
2207,2207,21,2022/4/15 12:50:00,21,46,-25
2208,2208,21,2022/4/15 13:00:00,17,47,-30
2209,2209,21,2022/4/15 13:10:00,17,49,-32
2210,2210,21,2022/4/15 13:20:00,20,50,-30
2211,2211,21,2022/4/15 13:30:00,19,47,-28
2212,2212,21,2022/4/15 13:40:00,17,41,-24
2213,2213,21,2022/4/15 13:50:00,17,45,-28
2214,2214,21,2022/4/15 14:00:00,19,50,-31
2215,2215,21,2022/4/15 14:10:00,16,50,-34
2216,2216,21,2022/4/15 14:20:00,18,50,-32
2217,2217,21,2022/4/15 14:30:00,17,46,-29
2218,2218,21,2022/4/15 14:40:00,16,50,-34
2219,2219,21,2022/4/15 14:50:00,14,49,-35
2220,2220,21,2022/4/15 15:00:00,19,49,-30
2221,2221,21,2022/4/15 15:10:00,19,50,-31
2222,2222,21,2022/4/15 15:20:00,23,61,-38
2223,2223,21,2022/4/15 15:30:00,23,70,-47
2224,2224,21,2022/4/15 15:40:00,20,66,-46
2225,2225,21,2022/4/15 15:50:00,17,70,-53
2226,2226,21,2022/4/15 16:00:00,24,72,-48
2227,2227,21,2022/4/15 16:10:00,23,69,-46
2228,2228,21,2022/4/15 16:20:00,26,70,-44
2229,2229,21,2022/4/15 16:30:00,24,69,-45
2230,2230,21,2022/4/15 16:40:00,22,65,-43
2231,2231,21,2022/4/15 16:50:00,26,76,-50
2232,2232,21,2022/4/15 17:00:00,33,77,-44
2233,2233,21,2022/4/15 17:10:00,35,97,-62
2234,2234,21,2022/4/15 17:20:00,30,102,-72
2235,2235,21,2022/4/15 17:30:00,26,127,-101
2236,2236,21,2022/4/15 17:40:00,30,122,-92
2237,2237,21,2022/4/15 17:50:00,25,108,-83
2238,2238,21,2022/4/15 18:00:00,27,119,-92
2239,2239,21,2022/4/15 18:10:00,26,111,-85
2240,2240,21,2022/4/15 18:20:00,24,109,-85
2241,2241,21,2022/4/15 18:30:00,22,117,-95
2242,2242,21,2022/4/15 18:40:00,23,111,-88
2243,2243,21,2022/4/15 18:50:00,16,119,-103
2244,2244,21,2022/4/15 19:00:00,15,110,-95
2245,2245,21,2022/4/15 19:10:00,13,123,-110
2246,2246,21,2022/4/15 19:20:00,12,110,-98
2247,2247,21,2022/4/15 19:30:00,10,108,-98
2248,2248,21,2022/4/15 19:40:00,9,99,-90
2249,2249,21,2022/4/15 19:50:00,9,83,-74
2250,2250,21,2022/4/15 20:00:00,11,81,-70
2251,2251,21,2022/4/15 20:10:00,10,87,-77
2252,2252,21,2022/4/15 20:20:00,7,77,-70
2253,2253,21,2022/4/15 20:30:00,10,66,-56
2254,2254,21,2022/4/15 20:40:00,8,79,-71
2255,2255,21,2022/4/15 20:50:00,9,61,-52
2256,2256,21,2022/4/15 21:00:00,8,88,-80
2257,2257,21,2022/4/15 21:10:00,7,66,-59
2258,2258,21,2022/4/15 21:20:00,8,78,-70
2259,2259,21,2022/4/15 21:30:00,7,67,-60
2260,2260,21,2022/4/15 21:40:00,6,52,-46
2261,2261,21,2022/4/15 21:50:00,4,72,-68
2262,2262,21,2022/4/15 22:00:00,1,46,-45
2263,2263,21,2022/4/15 22:10:00,0,70,-70
2264,2264,21,2022/4/15 22:20:00,0,34,-34
2265,2265,21,2022/4/15 22:30:00,0,49,-49
2266,2266,21,2022/4/15 22:40:00,0,39,-39
2267,2267,21,2022/4/15 22:50:00,0,25,-25
2268,2268,22,2022/4/15 5:00:00,0,1,-1
2269,2269,22,2022/4/15 5:10:00,0,1,-1
2270,2270,22,2022/4/15 5:20:00,0,1,-1
2271,2271,22,2022/4/15 5:30:00,2,1,1
2272,2272,22,2022/4/15 5:40:00,8,1,7
2273,2273,22,2022/4/15 5:50:00,13,6,7
2274,2274,22,2022/4/15 6:00:00,15,16,-1
2275,2275,22,2022/4/15 6:10:00,16,21,-5
2276,2276,22,2022/4/15 6:20:00,22,23,-1
2277,2277,22,2022/4/15 6:30:00,29,35,-6
2278,2278,22,2022/4/15 6:40:00,32,54,-22
2279,2279,22,2022/4/15 6:50:00,36,55,-19
2280,2280,22,2022/4/15 7:00:00,40,68,-28
2281,2281,22,2022/4/15 7:10:00,42,75,-33
2282,2282,22,2022/4/15 7:20:00,44,92,-48
2283,2283,22,2022/4/15 7:30:00,55,114,-59
2284,2284,22,2022/4/15 7:40:00,58,120,-62
2285,2285,22,2022/4/15 7:50:00,85,117,-32
2286,2286,22,2022/4/15 8:00:00,85,159,-74
2287,2287,22,2022/4/15 8:10:00,127,324,-197
2288,2288,22,2022/4/15 8:20:00,146,297,-151
2289,2289,22,2022/4/15 8:30:00,149,298,-149
2290,2290,22,2022/4/15 8:40:00,85,432,-347
2291,2291,22,2022/4/15 8:50:00,73,341,-268
2292,2292,22,2022/4/15 9:00:00,49,384,-335
2293,2293,22,2022/4/15 9:10:00,51,323,-272
2294,2294,22,2022/4/15 9:20:00,48,255,-207
2295,2295,22,2022/4/15 9:30:00,43,213,-170
2296,2296,22,2022/4/15 9:40:00,40,196,-156
2297,2297,22,2022/4/15 9:50:00,32,145,-113
2298,2298,22,2022/4/15 10:00:00,37,108,-71
2299,2299,22,2022/4/15 10:10:00,31,107,-76
2300,2300,22,2022/4/15 10:20:00,36,118,-82
2301,2301,22,2022/4/15 10:30:00,39,112,-73
2302,2302,22,2022/4/15 10:40:00,36,112,-76
2303,2303,22,2022/4/15 10:50:00,33,104,-71
2304,2304,22,2022/4/15 11:00:00,33,92,-59
2305,2305,22,2022/4/15 11:10:00,33,93,-60
2306,2306,22,2022/4/15 11:20:00,37,91,-54
2307,2307,22,2022/4/15 11:30:00,39,114,-75
2308,2308,22,2022/4/15 11:40:00,37,101,-64
2309,2309,22,2022/4/15 11:50:00,38,97,-59
2310,2310,22,2022/4/15 12:00:00,39,96,-57
2311,2311,22,2022/4/15 12:10:00,35,106,-71
2312,2312,22,2022/4/15 12:20:00,36,98,-62
2313,2313,22,2022/4/15 12:30:00,42,105,-63
2314,2314,22,2022/4/15 12:40:00,37,106,-69
2315,2315,22,2022/4/15 12:50:00,41,108,-67
2316,2316,22,2022/4/15 13:00:00,37,109,-72
2317,2317,22,2022/4/15 13:10:00,40,119,-79
2318,2318,22,2022/4/15 13:20:00,41,107,-66
2319,2319,22,2022/4/15 13:30:00,44,88,-44
2320,2320,22,2022/4/15 13:40:00,43,107,-64
2321,2321,22,2022/4/15 13:50:00,43,100,-57
2322,2322,22,2022/4/15 14:00:00,42,106,-64
2323,2323,22,2022/4/15 14:10:00,42,112,-70
2324,2324,22,2022/4/15 14:20:00,44,105,-61
2325,2325,22,2022/4/15 14:30:00,52,103,-51
2326,2326,22,2022/4/15 14:40:00,46,103,-57
2327,2327,22,2022/4/15 14:50:00,46,107,-61
2328,2328,22,2022/4/15 15:00:00,51,109,-58
2329,2329,22,2022/4/15 15:10:00,63,109,-46
2330,2330,22,2022/4/15 15:20:00,59,106,-47
2331,2331,22,2022/4/15 15:30:00,53,105,-52
2332,2332,22,2022/4/15 15:40:00,61,105,-44
2333,2333,22,2022/4/15 15:50:00,69,108,-39
2334,2334,22,2022/4/15 16:00:00,73,101,-28
2335,2335,22,2022/4/15 16:10:00,76,112,-36
2336,2336,22,2022/4/15 16:20:00,77,108,-31
2337,2337,22,2022/4/15 16:30:00,74,102,-28
2338,2338,22,2022/4/15 16:40:00,80,105,-25
2339,2339,22,2022/4/15 16:50:00,85,108,-23
2340,2340,22,2022/4/15 17:00:00,232,102,130
2341,2341,22,2022/4/15 17:10:00,216,103,113
2342,2342,22,2022/4/15 17:20:00,186,102,84
2343,2343,22,2022/4/15 17:30:00,272,103,169
2344,2344,22,2022/4/15 17:40:00,347,123,224
2345,2345,22,2022/4/15 17:50:00,247,116,131
2346,2346,22,2022/4/15 18:00:00,293,111,182
2347,2347,22,2022/4/15 18:10:00,552,116,436
2348,2348,22,2022/4/15 18:20:00,325,138,187
2349,2349,22,2022/4/15 18:30:00,272,152,120
2350,2350,22,2022/4/15 18:40:00,241,119,122
2351,2351,22,2022/4/15 18:50:00,213,112,101
2352,2352,22,2022/4/15 19:00:00,163,122,41
2353,2353,22,2022/4/15 19:10:00,141,123,18
2354,2354,22,2022/4/15 19:20:00,92,102,-10
2355,2355,22,2022/4/15 19:30:00,78,100,-22
2356,2356,22,2022/4/15 19:40:00,73,95,-22
2357,2357,22,2022/4/15 19:50:00,65,95,-30
2358,2358,22,2022/4/15 20:00:00,71,75,-4
2359,2359,22,2022/4/15 20:10:00,63,82,-19
2360,2360,22,2022/4/15 20:20:00,53,70,-17
2361,2361,22,2022/4/15 20:30:00,55,78,-23
2362,2362,22,2022/4/15 20:40:00,71,82,-11
2363,2363,22,2022/4/15 20:50:00,66,79,-13
2364,2364,22,2022/4/15 21:00:00,66,75,-9
2365,2365,22,2022/4/15 21:10:00,76,62,14
2366,2366,22,2022/4/15 21:20:00,56,77,-21
2367,2367,22,2022/4/15 21:30:00,62,63,-1
2368,2368,22,2022/4/15 21:40:00,73,78,-5
2369,2369,22,2022/4/15 21:50:00,65,67,-2
2370,2370,22,2022/4/15 22:00:00,92,63,29
2371,2371,22,2022/4/15 22:10:00,53,70,-17
2372,2372,22,2022/4/15 22:20:00,25,58,-33
2373,2373,22,2022/4/15 22:30:00,4,45,-41
2374,2374,22,2022/4/15 22:40:00,0,3,-3
2375,2375,22,2022/4/15 22:50:00,0,3,-3
2376,2376,23,2022/4/15 5:00:00,0,1,-1
2377,2377,23,2022/4/15 5:10:00,0,1,-1
2378,2378,23,2022/4/15 5:20:00,0,1,-1
2379,2379,23,2022/4/15 5:30:00,3,1,2
2380,2380,23,2022/4/15 5:40:00,2,1,1
2381,2381,23,2022/4/15 5:50:00,5,1,4
2382,2382,23,2022/4/15 6:00:00,5,8,-3
2383,2383,23,2022/4/15 6:10:00,12,21,-9
2384,2384,23,2022/4/15 6:20:00,11,19,-8
2385,2385,23,2022/4/15 6:30:00,19,38,-19
2386,2386,23,2022/4/15 6:40:00,22,66,-44
2387,2387,23,2022/4/15 6:50:00,22,65,-43
2388,2388,23,2022/4/15 7:00:00,26,53,-27
2389,2389,23,2022/4/15 7:10:00,31,75,-44
2390,2390,23,2022/4/15 7:20:00,35,104,-69
2391,2391,23,2022/4/15 7:30:00,43,125,-82
2392,2392,23,2022/4/15 7:40:00,59,226,-167
2393,2393,23,2022/4/15 7:50:00,57,330,-273
2394,2394,23,2022/4/15 8:00:00,70,642,-572
2395,2395,23,2022/4/15 8:10:00,85,1583,-1498
2396,2396,23,2022/4/15 8:20:00,67,2019,-1952
2397,2397,23,2022/4/15 8:30:00,64,3158,-3094
2398,2398,23,2022/4/15 8:40:00,68,2825,-2757
2399,2399,23,2022/4/15 8:50:00,53,2967,-2914
2400,2400,23,2022/4/15 9:00:00,39,493,-454
2401,2401,23,2022/4/15 9:10:00,36,582,-546
2402,2402,23,2022/4/15 9:20:00,39,532,-493
2403,2403,23,2022/4/15 9:30:00,33,267,-234
2404,2404,23,2022/4/15 9:40:00,29,178,-149
2405,2405,23,2022/4/15 9:50:00,29,115,-86
2406,2406,23,2022/4/15 10:00:00,33,120,-87
2407,2407,23,2022/4/15 10:10:00,29,114,-85
2408,2408,23,2022/4/15 10:20:00,34,106,-72
2409,2409,23,2022/4/15 10:30:00,35,105,-70
2410,2410,23,2022/4/15 10:40:00,28,114,-86
2411,2411,23,2022/4/15 10:50:00,37,96,-59
2412,2412,23,2022/4/15 11:00:00,37,93,-56
2413,2413,23,2022/4/15 11:10:00,39,90,-51
2414,2414,23,2022/4/15 11:20:00,39,93,-54
2415,2415,23,2022/4/15 11:30:00,37,98,-61
2416,2416,23,2022/4/15 11:40:00,43,98,-55
2417,2417,23,2022/4/15 11:50:00,43,90,-47
2418,2418,23,2022/4/15 12:00:00,38,81,-43
2419,2419,23,2022/4/15 12:10:00,45,81,-36
2420,2420,23,2022/4/15 12:20:00,42,92,-50
2421,2421,23,2022/4/15 12:30:00,40,92,-52
2422,2422,23,2022/4/15 12:40:00,37,101,-64
2423,2423,23,2022/4/15 12:50:00,41,90,-49
2424,2424,23,2022/4/15 13:00:00,40,93,-53
2425,2425,23,2022/4/15 13:10:00,45,99,-54
2426,2426,23,2022/4/15 13:20:00,42,104,-62
2427,2427,23,2022/4/15 13:30:00,39,101,-62
2428,2428,23,2022/4/15 13:40:00,42,97,-55
2429,2429,23,2022/4/15 13:50:00,46,110,-64
2430,2430,23,2022/4/15 14:00:00,44,93,-49
2431,2431,23,2022/4/15 14:10:00,44,93,-49
2432,2432,23,2022/4/15 14:20:00,43,93,-50
2433,2433,23,2022/4/15 14:30:00,44,90,-46
2434,2434,23,2022/4/15 14:40:00,44,96,-52
2435,2435,23,2022/4/15 14:50:00,44,90,-46
2436,2436,23,2022/4/15 15:00:00,45,87,-42
2437,2437,23,2022/4/15 15:10:00,44,87,-43
2438,2438,23,2022/4/15 15:20:00,46,80,-34
2439,2439,23,2022/4/15 15:30:00,51,90,-39
2440,2440,23,2022/4/15 15:40:00,52,93,-41
2441,2441,23,2022/4/15 15:50:00,64,93,-29
2442,2442,23,2022/4/15 16:00:00,66,92,-26
2443,2443,23,2022/4/15 16:10:00,80,82,-2
2444,2444,23,2022/4/15 16:20:00,67,90,-23
2445,2445,23,2022/4/15 16:30:00,137,90,47
2446,2446,23,2022/4/15 16:40:00,174,99,75
2447,2447,23,2022/4/15 16:50:00,156,88,68
2448,2448,23,2022/4/15 17:00:00,277,90,187
2449,2449,23,2022/4/15 17:10:00,576,96,480
2450,2450,23,2022/4/15 17:20:00,369,105,264
2451,2451,23,2022/4/15 17:30:00,675,105,570
2452,2452,23,2022/4/15 17:40:00,1977,103,1874
2453,2453,23,2022/4/15 17:50:00,1368,112,1256
2454,2454,23,2022/4/15 18:00:00,1167,109,1058
2455,2455,23,2022/4/15 18:10:00,1983,113,1870
2456,2456,23,2022/4/15 18:20:00,1208,107,1101
2457,2457,23,2022/4/15 18:30:00,636,110,526
2458,2458,23,2022/4/15 18:40:00,336,110,226
2459,2459,23,2022/4/15 18:50:00,279,108,171
2460,2460,23,2022/4/15 19:00:00,226,95,131
2461,2461,23,2022/4/15 19:10:00,187,99,88
2462,2462,23,2022/4/15 19:20:00,129,77,52
2463,2463,23,2022/4/15 19:30:00,77,69,8
2464,2464,23,2022/4/15 19:40:00,73,62,11
2465,2465,23,2022/4/15 19:50:00,49,68,-19
2466,2466,23,2022/4/15 20:00:00,55,61,-6
2467,2467,23,2022/4/15 20:10:00,62,58,4
2468,2468,23,2022/4/15 20:20:00,45,51,-6
2469,2469,23,2022/4/15 20:30:00,47,52,-5
2470,2470,23,2022/4/15 20:40:00,43,50,-7
2471,2471,23,2022/4/15 20:50:00,41,54,-13
2472,2472,23,2022/4/15 21:00:00,50,48,2
2473,2473,23,2022/4/15 21:10:00,66,39,27
2474,2474,23,2022/4/15 21:20:00,64,53,11
2475,2475,23,2022/4/15 21:30:00,137,34,103
2476,2476,23,2022/4/15 21:40:00,149,52,97
2477,2477,23,2022/4/15 21:50:00,41,40,1
2478,2478,23,2022/4/15 22:00:00,29,39,-10
2479,2479,23,2022/4/15 22:10:00,21,40,-19
2480,2480,23,2022/4/15 22:20:00,6,36,-30
2481,2481,23,2022/4/15 22:30:00,2,40,-38
2482,2482,23,2022/4/15 22:40:00,1,25,-24
2483,2483,23,2022/4/15 22:50:00,0,3,-3
2484,2484,24,2022/4/15 5:00:00,0,1,-1
2485,2485,24,2022/4/15 5:10:00,0,1,-1
2486,2486,24,2022/4/15 5:20:00,0,1,-1
2487,2487,24,2022/4/15 5:30:00,0,1,-1
2488,2488,24,2022/4/15 5:40:00,2,1,1
2489,2489,24,2022/4/15 5:50:00,2,1,1
2490,2490,24,2022/4/15 6:00:00,3,1,2
2491,2491,24,2022/4/15 6:10:00,7,1,6
2492,2492,24,2022/4/15 6:20:00,6,11,-5
2493,2493,24,2022/4/15 6:30:00,6,6,0
2494,2494,24,2022/4/15 6:40:00,14,8,6
2495,2495,24,2022/4/15 6:50:00,22,6,16
2496,2496,24,2022/4/15 7:00:00,25,11,14
2497,2497,24,2022/4/15 7:10:00,36,16,20
2498,2498,24,2022/4/15 7:20:00,36,23,13
2499,2499,24,2022/4/15 7:30:00,56,22,34
2500,2500,24,2022/4/15 7:40:00,46,31,15
2501,2501,24,2022/4/15 7:50:00,53,38,15
2502,2502,24,2022/4/15 8:00:00,56,21,35
2503,2503,24,2022/4/15 8:10:00,47,29,18
2504,2504,24,2022/4/15 8:20:00,36,14,22
2505,2505,24,2022/4/15 8:30:00,31,48,-17
2506,2506,24,2022/4/15 8:40:00,24,61,-37
2507,2507,24,2022/4/15 8:50:00,21,47,-26
2508,2508,24,2022/4/15 9:00:00,14,32,-18
2509,2509,24,2022/4/15 9:10:00,12,30,-18
2510,2510,24,2022/4/15 9:20:00,13,29,-16
2511,2511,24,2022/4/15 9:30:00,10,21,-11
2512,2512,24,2022/4/15 9:40:00,8,21,-13
2513,2513,24,2022/4/15 9:50:00,3,19,-16
2514,2514,24,2022/4/15 10:00:00,7,19,-12
2515,2515,24,2022/4/15 10:10:00,4,19,-15
2516,2516,24,2022/4/15 10:20:00,4,19,-15
2517,2517,24,2022/4/15 10:30:00,4,18,-14
2518,2518,24,2022/4/15 10:40:00,7,16,-9
2519,2519,24,2022/4/15 10:50:00,7,12,-5
2520,2520,24,2022/4/15 11:00:00,4,19,-15
2521,2521,24,2022/4/15 11:10:00,6,19,-13
2522,2522,24,2022/4/15 11:20:00,5,12,-7
2523,2523,24,2022/4/15 11:30:00,6,12,-6
2524,2524,24,2022/4/15 11:40:00,6,12,-6
2525,2525,24,2022/4/15 11:50:00,6,8,-2
2526,2526,24,2022/4/15 12:00:00,7,19,-12
2527,2527,24,2022/4/15 12:10:00,5,8,-3
2528,2528,24,2022/4/15 12:20:00,6,15,-9
2529,2529,24,2022/4/15 12:30:00,5,14,-9
2530,2530,24,2022/4/15 12:40:00,6,21,-15
2531,2531,24,2022/4/15 12:50:00,5,19,-14
2532,2532,24,2022/4/15 13:00:00,5,14,-9
2533,2533,24,2022/4/15 13:10:00,4,18,-14
2534,2534,24,2022/4/15 13:20:00,6,16,-10
2535,2535,24,2022/4/15 13:30:00,6,19,-13
2536,2536,24,2022/4/15 13:40:00,4,16,-12
2537,2537,24,2022/4/15 13:50:00,5,15,-10
2538,2538,24,2022/4/15 14:00:00,5,16,-11
2539,2539,24,2022/4/15 14:10:00,5,16,-11
2540,2540,24,2022/4/15 14:20:00,5,15,-10
2541,2541,24,2022/4/15 14:30:00,4,14,-10
2542,2542,24,2022/4/15 14:40:00,5,18,-13
2543,2543,24,2022/4/15 14:50:00,6,14,-8
2544,2544,24,2022/4/15 15:00:00,8,19,-11
2545,2545,24,2022/4/15 15:10:00,8,18,-10
2546,2546,24,2022/4/15 15:20:00,7,16,-9
2547,2547,24,2022/4/15 15:30:00,8,21,-13
2548,2548,24,2022/4/15 15:40:00,9,21,-12
2549,2549,24,2022/4/15 15:50:00,8,19,-11
2550,2550,24,2022/4/15 16:00:00,9,19,-10
2551,2551,24,2022/4/15 16:10:00,8,23,-15
2552,2552,24,2022/4/15 16:20:00,10,23,-13
2553,2553,24,2022/4/15 16:30:00,8,23,-15
2554,2554,24,2022/4/15 16:40:00,11,23,-12
2555,2555,24,2022/4/15 16:50:00,10,38,-28
2556,2556,24,2022/4/15 17:00:00,12,30,-18
2557,2557,24,2022/4/15 17:10:00,17,35,-18
2558,2558,24,2022/4/15 17:20:00,13,38,-25
2559,2559,24,2022/4/15 17:30:00,14,46,-32
2560,2560,24,2022/4/15 17:40:00,14,40,-26
2561,2561,24,2022/4/15 17:50:00,12,45,-33
2562,2562,24,2022/4/15 18:00:00,10,51,-41
2563,2563,24,2022/4/15 18:10:00,8,53,-45
2564,2564,24,2022/4/15 18:20:00,6,49,-43
2565,2565,24,2022/4/15 18:30:00,6,55,-49
2566,2566,24,2022/4/15 18:40:00,6,46,-40
2567,2567,24,2022/4/15 18:50:00,4,40,-36
2568,2568,24,2022/4/15 19:00:00,4,40,-36
2569,2569,24,2022/4/15 19:10:00,3,36,-33
2570,2570,24,2022/4/15 19:20:00,1,26,-25
2571,2571,24,2022/4/15 19:30:00,4,25,-21
2572,2572,24,2022/4/15 19:40:00,4,23,-19
2573,2573,24,2022/4/15 19:50:00,2,18,-16
2574,2574,24,2022/4/15 20:00:00,3,25,-22
2575,2575,24,2022/4/15 20:10:00,2,21,-19
2576,2576,24,2022/4/15 20:20:00,2,10,-8
2577,2577,24,2022/4/15 20:30:00,2,25,-23
2578,2578,24,2022/4/15 20:40:00,2,10,-8
2579,2579,24,2022/4/15 20:50:00,2,25,-23
2580,2580,24,2022/4/15 21:00:00,1,18,-17
2581,2581,24,2022/4/15 21:10:00,1,21,-20
2582,2582,24,2022/4/15 21:20:00,2,16,-14
2583,2583,24,2022/4/15 21:30:00,1,22,-21
2584,2584,24,2022/4/15 21:40:00,1,21,-20
2585,2585,24,2022/4/15 21:50:00,1,13,-12
2586,2586,24,2022/4/15 22:00:00,0,19,-19
2587,2587,24,2022/4/15 22:10:00,0,10,-10
2588,2588,24,2022/4/15 22:20:00,0,18,-18
2589,2589,24,2022/4/15 22:30:00,0,8,-8
2590,2590,24,2022/4/15 22:40:00,0,15,-15
2591,2591,24,2022/4/15 22:50:00,0,10,-10
2592,2592,25,2022/4/15 5:00:00,0,1,-1
2593,2593,25,2022/4/15 5:10:00,1,1,0
2594,2594,25,2022/4/15 5:20:00,6,1,5
2595,2595,25,2022/4/15 5:30:00,11,1,10
2596,2596,25,2022/4/15 5:40:00,20,1,19
2597,2597,25,2022/4/15 5:50:00,20,5,15
2598,2598,25,2022/4/15 6:00:00,26,1,25
2599,2599,25,2022/4/15 6:10:00,34,16,18
2600,2600,25,2022/4/15 6:20:00,40,19,21
2601,2601,25,2022/4/15 6:30:00,55,23,32
2602,2602,25,2022/4/15 6:40:00,60,25,35
2603,2603,25,2022/4/15 6:50:00,79,23,56
2604,2604,25,2022/4/15 7:00:00,186,46,140
2605,2605,25,2022/4/15 7:10:00,192,64,128
2606,2606,25,2022/4/15 7:20:00,227,62,165
2607,2607,25,2022/4/15 7:30:00,254,68,186
2608,2608,25,2022/4/15 7:40:00,350,75,275
2609,2609,25,2022/4/15 7:50:00,368,74,294
2610,2610,25,2022/4/15 8:00:00,478,110,368
2611,2611,25,2022/4/15 8:10:00,571,123,448
2612,2612,25,2022/4/15 8:20:00,573,139,434
2613,2613,25,2022/4/15 8:30:00,368,152,216
2614,2614,25,2022/4/15 8:40:00,278,222,56
2615,2615,25,2022/4/15 8:50:00,247,110,137
2616,2616,25,2022/4/15 9:00:00,212,110,102
2617,2617,25,2022/4/15 9:10:00,181,105,76
2618,2618,25,2022/4/15 9:20:00,122,108,14
2619,2619,25,2022/4/15 9:30:00,75,98,-23
2620,2620,25,2022/4/15 9:40:00,60,84,-24
2621,2621,25,2022/4/15 9:50:00,48,76,-28
2622,2622,25,2022/4/15 10:00:00,43,73,-30
2623,2623,25,2022/4/15 10:10:00,38,70,-32
2624,2624,25,2022/4/15 10:20:00,37,70,-33
2625,2625,25,2022/4/15 10:30:00,29,71,-42
2626,2626,25,2022/4/15 10:40:00,32,72,-40
2627,2627,25,2022/4/15 10:50:00,31,62,-31
2628,2628,25,2022/4/15 11:00:00,31,62,-31
2629,2629,25,2022/4/15 11:10:00,32,67,-35
2630,2630,25,2022/4/15 11:20:00,29,64,-35
2631,2631,25,2022/4/15 11:30:00,32,66,-34
2632,2632,25,2022/4/15 11:40:00,27,61,-34
2633,2633,25,2022/4/15 11:50:00,33,70,-37
2634,2634,25,2022/4/15 12:00:00,31,67,-36
2635,2635,25,2022/4/15 12:10:00,31,66,-35
2636,2636,25,2022/4/15 12:20:00,32,66,-34
2637,2637,25,2022/4/15 12:30:00,31,70,-39
2638,2638,25,2022/4/15 12:40:00,29,73,-44
2639,2639,25,2022/4/15 12:50:00,31,71,-40
2640,2640,25,2022/4/15 13:00:00,34,62,-28
2641,2641,25,2022/4/15 13:10:00,33,71,-38
2642,2642,25,2022/4/15 13:20:00,31,69,-38
2643,2643,25,2022/4/15 13:30:00,33,70,-37
2644,2644,25,2022/4/15 13:40:00,28,69,-41
2645,2645,25,2022/4/15 13:50:00,29,87,-58
2646,2646,25,2022/4/15 14:00:00,33,64,-31
2647,2647,25,2022/4/15 14:10:00,31,77,-46
2648,2648,25,2022/4/15 14:20:00,25,77,-52
2649,2649,25,2022/4/15 14:30:00,34,66,-32
2650,2650,25,2022/4/15 14:40:00,29,76,-47
2651,2651,25,2022/4/15 14:50:00,31,85,-54
2652,2652,25,2022/4/15 15:00:00,33,74,-41
2653,2653,25,2022/4/15 15:10:00,30,83,-53
2654,2654,25,2022/4/15 15:20:00,35,76,-41
2655,2655,25,2022/4/15 15:30:00,35,97,-62
2656,2656,25,2022/4/15 15:40:00,29,90,-61
2657,2657,25,2022/4/15 15:50:00,36,93,-57
2658,2658,25,2022/4/15 16:00:00,38,91,-53
2659,2659,25,2022/4/15 16:10:00,34,101,-67
2660,2660,25,2022/4/15 16:20:00,36,108,-72
2661,2661,25,2022/4/15 16:30:00,37,106,-69
2662,2662,25,2022/4/15 16:40:00,43,112,-69
2663,2663,25,2022/4/15 16:50:00,43,106,-63
2664,2664,25,2022/4/15 17:00:00,91,116,-25
2665,2665,25,2022/4/15 17:10:00,133,123,10
2666,2666,25,2022/4/15 17:20:00,61,118,-57
2667,2667,25,2022/4/15 17:30:00,80,151,-71
2668,2668,25,2022/4/15 17:40:00,185,183,2
2669,2669,25,2022/4/15 17:50:00,83,178,-95
2670,2670,25,2022/4/15 18:00:00,72,226,-154
2671,2671,25,2022/4/15 18:10:00,130,226,-96
2672,2672,25,2022/4/15 18:20:00,74,223,-149
2673,2673,25,2022/4/15 18:30:00,46,226,-180
2674,2674,25,2022/4/15 18:40:00,44,198,-154
2675,2675,25,2022/4/15 18:50:00,43,184,-141
2676,2676,25,2022/4/15 19:00:00,37,152,-115
2677,2677,25,2022/4/15 19:10:00,38,110,-72
2678,2678,25,2022/4/15 19:20:00,33,109,-76
2679,2679,25,2022/4/15 19:30:00,29,118,-89
2680,2680,25,2022/4/15 19:40:00,27,104,-77
2681,2681,25,2022/4/15 19:50:00,27,106,-79
2682,2682,25,2022/4/15 20:00:00,28,108,-80
2683,2683,25,2022/4/15 20:10:00,28,110,-82
2684,2684,25,2022/4/15 20:20:00,28,79,-51
2685,2685,25,2022/4/15 20:30:00,23,107,-84
2686,2686,25,2022/4/15 20:40:00,29,78,-49
2687,2687,25,2022/4/15 20:50:00,25,106,-81
2688,2688,25,2022/4/15 21:00:00,24,94,-70
2689,2689,25,2022/4/15 21:10:00,23,106,-83
2690,2690,25,2022/4/15 21:20:00,22,99,-77
2691,2691,25,2022/4/15 21:30:00,16,100,-84
2692,2692,25,2022/4/15 21:40:00,13,105,-92
2693,2693,25,2022/4/15 21:50:00,14,87,-73
2694,2694,25,2022/4/15 22:00:00,16,107,-91
2695,2695,25,2022/4/15 22:10:00,6,73,-67
2696,2696,25,2022/4/15 22:20:00,4,99,-95
2697,2697,25,2022/4/15 22:30:00,1,73,-72
2698,2698,25,2022/4/15 22:40:00,0,59,-59
2699,2699,25,2022/4/15 22:50:00,0,3,-3
2700,2700,26,2022/4/15 5:00:00,0,1,-1
2701,2701,26,2022/4/15 5:10:00,0,1,-1
2702,2702,26,2022/4/15 5:20:00,1,1,0
2703,2703,26,2022/4/15 5:30:00,3,1,2
2704,2704,26,2022/4/15 5:40:00,12,1,11
2705,2705,26,2022/4/15 5:50:00,20,6,14
2706,2706,26,2022/4/15 6:00:00,19,23,-4
2707,2707,26,2022/4/15 6:10:00,21,41,-20
2708,2708,26,2022/4/15 6:20:00,30,51,-21
2709,2709,26,2022/4/15 6:30:00,32,62,-30
2710,2710,26,2022/4/15 6:40:00,31,77,-46
2711,2711,26,2022/4/15 6:50:00,34,76,-42
2712,2712,26,2022/4/15 7:00:00,38,93,-55
2713,2713,26,2022/4/15 7:10:00,44,111,-67
2714,2714,26,2022/4/15 7:20:00,57,119,-62
2715,2715,26,2022/4/15 7:30:00,60,139,-79
2716,2716,26,2022/4/15 7:40:00,76,180,-104
2717,2717,26,2022/4/15 7:50:00,148,335,-187
2718,2718,26,2022/4/15 8:00:00,144,497,-353
2719,2719,26,2022/4/15 8:10:00,153,565,-412
2720,2720,26,2022/4/15 8:20:00,173,1095,-922
2721,2721,26,2022/4/15 8:30:00,150,1094,-944
2722,2722,26,2022/4/15 8:40:00,121,2051,-1930
2723,2723,26,2022/4/15 8:50:00,81,1104,-1023
2724,2724,26,2022/4/15 9:00:00,77,433,-356
2725,2725,26,2022/4/15 9:10:00,69,417,-348
2726,2726,26,2022/4/15 9:20:00,66,378,-312
2727,2727,26,2022/4/15 9:30:00,59,379,-320
2728,2728,26,2022/4/15 9:40:00,62,334,-272
2729,2729,26,2022/4/15 9:50:00,63,332,-269
2730,2730,26,2022/4/15 10:00:00,62,269,-207
2731,2731,26,2022/4/15 10:10:00,64,219,-155
2732,2732,26,2022/4/15 10:20:00,63,214,-151
2733,2733,26,2022/4/15 10:30:00,70,209,-139
2734,2734,26,2022/4/15 10:40:00,65,198,-133
2735,2735,26,2022/4/15 10:50:00,75,192,-117
2736,2736,26,2022/4/15 11:00:00,75,153,-78
2737,2737,26,2022/4/15 11:10:00,92,186,-94
2738,2738,26,2022/4/15 11:20:00,87,151,-64
2739,2739,26,2022/4/15 11:30:00,91,170,-79
2740,2740,26,2022/4/15 11:40:00,131,109,22
2741,2741,26,2022/4/15 11:50:00,133,120,13
2742,2742,26,2022/4/15 12:00:00,139,110,29
2743,2743,26,2022/4/15 12:10:00,176,120,56
2744,2744,26,2022/4/15 12:20:00,172,105,67
2745,2745,26,2022/4/15 12:30:00,156,111,45
2746,2746,26,2022/4/15 12:40:00,186,170,16
2747,2747,26,2022/4/15 12:50:00,179,152,27
2748,2748,26,2022/4/15 13:00:00,177,138,39
2749,2749,26,2022/4/15 13:10:00,204,159,45
2750,2750,26,2022/4/15 13:20:00,213,152,61
2751,2751,26,2022/4/15 13:30:00,207,156,51
2752,2752,26,2022/4/15 13:40:00,201,181,20
2753,2753,26,2022/4/15 13:50:00,202,146,56
2754,2754,26,2022/4/15 14:00:00,225,169,56
2755,2755,26,2022/4/15 14:10:00,218,171,47
2756,2756,26,2022/4/15 14:20:00,218,127,91
2757,2757,26,2022/4/15 14:30:00,210,111,99
2758,2758,26,2022/4/15 14:40:00,237,119,118
2759,2759,26,2022/4/15 14:50:00,216,128,88
2760,2760,26,2022/4/15 15:00:00,273,112,161
2761,2761,26,2022/4/15 15:10:00,272,117,155
2762,2762,26,2022/4/15 15:20:00,266,108,158
2763,2763,26,2022/4/15 15:30:00,310,125,185
2764,2764,26,2022/4/15 15:40:00,268,109,159
2765,2765,26,2022/4/15 15:50:00,254,110,144
2766,2766,26,2022/4/15 16:00:00,272,104,168
2767,2767,26,2022/4/15 16:10:00,262,120,142
2768,2768,26,2022/4/15 16:20:00,268,123,145
2769,2769,26,2022/4/15 16:30:00,338,119,219
2770,2770,26,2022/4/15 16:40:00,334,123,211
2771,2771,26,2022/4/15 16:50:00,328,126,202
2772,2772,26,2022/4/15 17:00:00,636,121,515
2773,2773,26,2022/4/15 17:10:00,657,114,543
2774,2774,26,2022/4/15 17:20:00,674,103,571
2775,2775,26,2022/4/15 17:30:00,710,120,590
2776,2776,26,2022/4/15 17:40:00,1362,111,1251
2777,2777,26,2022/4/15 17:50:00,730,110,620
2778,2778,26,2022/4/15 18:00:00,697,121,576
2779,2779,26,2022/4/15 18:10:00,1043,120,923
2780,2780,26,2022/4/15 18:20:00,697,107,590
2781,2781,26,2022/4/15 18:30:00,360,110,250
2782,2782,26,2022/4/15 18:40:00,315,110,205
2783,2783,26,2022/4/15 18:50:00,247,126,121
2784,2784,26,2022/4/15 19:00:00,205,124,81
2785,2785,26,2022/4/15 19:10:00,198,110,88
2786,2786,26,2022/4/15 19:20:00,138,97,41
2787,2787,26,2022/4/15 19:30:00,138,88,50
2788,2788,26,2022/4/15 19:40:00,113,77,36
2789,2789,26,2022/4/15 19:50:00,80,79,1
2790,2790,26,2022/4/15 20:00:00,102,79,23
2791,2791,26,2022/4/15 20:10:00,76,67,9
2792,2792,26,2022/4/15 20:20:00,67,87,-20
2793,2793,26,2022/4/15 20:30:00,64,72,-8
2794,2794,26,2022/4/15 20:40:00,71,72,-1
2795,2795,26,2022/4/15 20:50:00,88,68,20
2796,2796,26,2022/4/15 21:00:00,174,74,100
2797,2797,26,2022/4/15 21:10:00,85,78,7
2798,2798,26,2022/4/15 21:20:00,47,73,-26
2799,2799,26,2022/4/15 21:30:00,40,71,-31
2800,2800,26,2022/4/15 21:40:00,35,72,-37
2801,2801,26,2022/4/15 21:50:00,28,65,-37
2802,2802,26,2022/4/15 22:00:00,32,74,-42
2803,2803,26,2022/4/15 22:10:00,28,74,-46
2804,2804,26,2022/4/15 22:20:00,21,84,-63
2805,2805,26,2022/4/15 22:30:00,1,46,-45
2806,2806,26,2022/4/15 22:40:00,0,3,-3
2807,2807,26,2022/4/15 22:50:00,0,3,-3
2808,2808,27,2022/4/15 5:00:00,0,1,-1
2809,2809,27,2022/4/15 5:10:00,1,1,0
2810,2810,27,2022/4/15 5:20:00,7,1,6
2811,2811,27,2022/4/15 5:30:00,1,1,0
2812,2812,27,2022/4/15 5:40:00,1,1,0
2813,2813,27,2022/4/15 5:50:00,9,1,8
2814,2814,27,2022/4/15 6:00:00,8,1,7
2815,2815,27,2022/4/15 6:10:00,8,1,7
2816,2816,27,2022/4/15 6:20:00,17,1,16
2817,2817,27,2022/4/15 6:30:00,22,16,6
2818,2818,27,2022/4/15 6:40:00,22,16,6
2819,2819,27,2022/4/15 6:50:00,27,23,4
2820,2820,27,2022/4/15 7:00:00,31,37,-6
2821,2821,27,2022/4/15 7:10:00,32,8,24
2822,2822,27,2022/4/15 7:20:00,36,29,7
2823,2823,27,2022/4/15 7:30:00,38,23,15
2824,2824,27,2022/4/15 7:40:00,54,29,25
2825,2825,27,2022/4/15 7:50:00,52,40,12
2826,2826,27,2022/4/15 8:00:00,50,47,3
2827,2827,27,2022/4/15 8:10:00,50,51,-1
2828,2828,27,2022/4/15 8:20:00,44,51,-7
2829,2829,27,2022/4/15 8:30:00,36,51,-15
2830,2830,27,2022/4/15 8:40:00,33,62,-29
2831,2831,27,2022/4/15 8:50:00,30,59,-29
2832,2832,27,2022/4/15 9:00:00,25,47,-22
2833,2833,27,2022/4/15 9:10:00,23,33,-10
2834,2834,27,2022/4/15 9:20:00,18,38,-20
2835,2835,27,2022/4/15 9:30:00,17,25,-8
2836,2836,27,2022/4/15 9:40:00,15,25,-10
2837,2837,27,2022/4/15 9:50:00,14,24,-10
2838,2838,27,2022/4/15 10:00:00,12,23,-11
2839,2839,27,2022/4/15 10:10:00,12,21,-9
2840,2840,27,2022/4/15 10:20:00,11,23,-12
2841,2841,27,2022/4/15 10:30:00,11,21,-10
2842,2842,27,2022/4/15 10:40:00,9,23,-14
2843,2843,27,2022/4/15 10:50:00,8,19,-11
2844,2844,27,2022/4/15 11:00:00,9,19,-10
2845,2845,27,2022/4/15 11:10:00,10,21,-11
2846,2846,27,2022/4/15 11:20:00,10,25,-15
2847,2847,27,2022/4/15 11:30:00,9,23,-14
2848,2848,27,2022/4/15 11:40:00,11,23,-12
2849,2849,27,2022/4/15 11:50:00,11,21,-10
2850,2850,27,2022/4/15 12:00:00,11,19,-8
2851,2851,27,2022/4/15 12:10:00,11,21,-10
2852,2852,27,2022/4/15 12:20:00,11,23,-12
2853,2853,27,2022/4/15 12:30:00,11,23,-12
2854,2854,27,2022/4/15 12:40:00,12,23,-11
2855,2855,27,2022/4/15 12:50:00,9,22,-13
2856,2856,27,2022/4/15 13:00:00,10,23,-13
2857,2857,27,2022/4/15 13:10:00,11,25,-14
2858,2858,27,2022/4/15 13:20:00,11,23,-12
2859,2859,27,2022/4/15 13:30:00,9,23,-14
2860,2860,27,2022/4/15 13:40:00,8,23,-15
2861,2861,27,2022/4/15 13:50:00,11,23,-12
2862,2862,27,2022/4/15 14:00:00,10,23,-13
2863,2863,27,2022/4/15 14:10:00,12,23,-11
2864,2864,27,2022/4/15 14:20:00,11,23,-12
2865,2865,27,2022/4/15 14:30:00,11,23,-12
2866,2866,27,2022/4/15 14:40:00,8,23,-15
2867,2867,27,2022/4/15 14:50:00,10,23,-13
2868,2868,27,2022/4/15 15:00:00,11,23,-12
2869,2869,27,2022/4/15 15:10:00,10,31,-21
2870,2870,27,2022/4/15 15:20:00,11,28,-17
2871,2871,27,2022/4/15 15:30:00,10,25,-15
2872,2872,27,2022/4/15 15:40:00,10,32,-22
2873,2873,27,2022/4/15 15:50:00,9,38,-29
2874,2874,27,2022/4/15 16:00:00,14,31,-17
2875,2875,27,2022/4/15 16:10:00,12,32,-20
2876,2876,27,2022/4/15 16:20:00,14,34,-20
2877,2877,27,2022/4/15 16:30:00,18,38,-20
2878,2878,27,2022/4/15 16:40:00,15,37,-22
2879,2879,27,2022/4/15 16:50:00,17,41,-24
2880,2880,27,2022/4/15 17:00:00,26,46,-20
2881,2881,27,2022/4/15 17:10:00,29,49,-20
2882,2882,27,2022/4/15 17:20:00,22,50,-28
2883,2883,27,2022/4/15 17:30:00,16,70,-54
2884,2884,27,2022/4/15 17:40:00,17,62,-45
2885,2885,27,2022/4/15 17:50:00,15,66,-51
2886,2886,27,2022/4/15 18:00:00,21,72,-51
2887,2887,27,2022/4/15 18:10:00,21,77,-56
2888,2888,27,2022/4/15 18:20:00,19,78,-59
2889,2889,27,2022/4/15 18:30:00,16,83,-67
2890,2890,27,2022/4/15 18:40:00,14,77,-63
2891,2891,27,2022/4/15 18:50:00,15,79,-64
2892,2892,27,2022/4/15 19:00:00,12,76,-64
2893,2893,27,2022/4/15 19:10:00,12,75,-63
2894,2894,27,2022/4/15 19:20:00,11,65,-54
2895,2895,27,2022/4/15 19:30:00,10,55,-45
2896,2896,27,2022/4/15 19:40:00,9,51,-42
2897,2897,27,2022/4/15 19:50:00,9,43,-34
2898,2898,27,2022/4/15 20:00:00,10,48,-38
2899,2899,27,2022/4/15 20:10:00,10,41,-31
2900,2900,27,2022/4/15 20:20:00,7,37,-30
2901,2901,27,2022/4/15 20:30:00,10,34,-24
2902,2902,27,2022/4/15 20:40:00,10,27,-17
2903,2903,27,2022/4/15 20:50:00,6,40,-34
2904,2904,27,2022/4/15 21:00:00,6,38,-32
2905,2905,27,2022/4/15 21:10:00,6,34,-28
2906,2906,27,2022/4/15 21:20:00,7,41,-34
2907,2907,27,2022/4/15 21:30:00,6,37,-31
2908,2908,27,2022/4/15 21:40:00,6,4,2
2909,2909,27,2022/4/15 21:50:00,6,40,-34
2910,2910,27,2022/4/15 22:00:00,0,40,-40
2911,2911,27,2022/4/15 22:10:00,1,34,-33
2912,2912,27,2022/4/15 22:20:00,0,25,-25
2913,2913,27,2022/4/15 22:30:00,0,8,-8
2914,2914,27,2022/4/15 22:40:00,0,24,-24
2915,2915,27,2022/4/15 22:50:00,0,13,-13
2916,2916,28,2022/4/15 5:00:00,0,1,-1
2917,2917,28,2022/4/15 5:10:00,6,1,5
2918,2918,28,2022/4/15 5:20:00,23,1,22
2919,2919,28,2022/4/15 5:30:00,24,1,23
2920,2920,28,2022/4/15 5:40:00,26,2,24
2921,2921,28,2022/4/15 5:50:00,31,1,30
2922,2922,28,2022/4/15 6:00:00,29,5,24
2923,2923,28,2022/4/15 6:10:00,54,6,48
2924,2924,28,2022/4/15 6:20:00,59,5,54
2925,2925,28,2022/4/15 6:30:00,92,8,84
2926,2926,28,2022/4/15 6:40:00,94,19,75
2927,2927,28,2022/4/15 6:50:00,149,77,72
2928,2928,28,2022/4/15 7:00:00,195,76,119
2929,2929,28,2022/4/15 7:10:00,184,99,85
2930,2930,28,2022/4/15 7:20:00,227,108,119
2931,2931,28,2022/4/15 7:30:00,264,104,160
2932,2932,28,2022/4/15 7:40:00,215,111,104
2933,2933,28,2022/4/15 7:50:00,188,108,80
2934,2934,28,2022/4/15 8:00:00,194,98,96
2935,2935,28,2022/4/15 8:10:00,144,139,5
2936,2936,28,2022/4/15 8:20:00,99,123,-24
2937,2937,28,2022/4/15 8:30:00,68,110,-42
2938,2938,28,2022/4/15 8:40:00,60,133,-73
2939,2939,28,2022/4/15 8:50:00,56,122,-66
2940,2940,28,2022/4/15 9:00:00,45,99,-54
2941,2941,28,2022/4/15 9:10:00,38,105,-67
2942,2942,28,2022/4/15 9:20:00,38,87,-49
2943,2943,28,2022/4/15 9:30:00,36,108,-72
2944,2944,28,2022/4/15 9:40:00,28,87,-59
2945,2945,28,2022/4/15 9:50:00,29,76,-47
2946,2946,28,2022/4/15 10:00:00,32,109,-77
2947,2947,28,2022/4/15 10:10:00,29,81,-52
2948,2948,28,2022/4/15 10:20:00,29,76,-47
2949,2949,28,2022/4/15 10:30:00,30,76,-46
2950,2950,28,2022/4/15 10:40:00,30,23,7
2951,2951,28,2022/4/15 10:50:00,31,101,-70
2952,2952,28,2022/4/15 11:00:00,31,93,-62
2953,2953,28,2022/4/15 11:10:00,27,96,-69
2954,2954,28,2022/4/15 11:20:00,29,76,-47
2955,2955,28,2022/4/15 11:30:00,31,36,-5
2956,2956,28,2022/4/15 11:40:00,37,97,-60
2957,2957,28,2022/4/15 11:50:00,32,92,-60
2958,2958,28,2022/4/15 12:00:00,36,96,-60
2959,2959,28,2022/4/15 12:10:00,36,93,-57
2960,2960,28,2022/4/15 12:20:00,35,70,-35
2961,2961,28,2022/4/15 12:30:00,33,68,-35
2962,2962,28,2022/4/15 12:40:00,37,93,-56
2963,2963,28,2022/4/15 12:50:00,35,91,-56
2964,2964,28,2022/4/15 13:00:00,39,94,-55
2965,2965,28,2022/4/15 13:10:00,36,97,-61
2966,2966,28,2022/4/15 13:20:00,31,61,-30
2967,2967,28,2022/4/15 13:30:00,32,64,-32
2968,2968,28,2022/4/15 13:40:00,33,97,-64
2969,2969,28,2022/4/15 13:50:00,40,97,-57
2970,2970,28,2022/4/15 14:00:00,32,90,-58
2971,2971,28,2022/4/15 14:10:00,33,97,-64
2972,2972,28,2022/4/15 14:20:00,32,58,-26
2973,2973,28,2022/4/15 14:30:00,33,57,-24
2974,2974,28,2022/4/15 14:40:00,30,93,-63
2975,2975,28,2022/4/15 14:50:00,32,95,-63
2976,2976,28,2022/4/15 15:00:00,37,100,-63
2977,2977,28,2022/4/15 15:10:00,37,95,-58
2978,2978,28,2022/4/15 15:20:00,35,97,-62
2979,2979,28,2022/4/15 15:30:00,33,22,11
2980,2980,28,2022/4/15 15:40:00,33,102,-69
2981,2981,28,2022/4/15 15:50:00,37,102,-65
2982,2982,28,2022/4/15 16:00:00,37,102,-65
2983,2983,28,2022/4/15 16:10:00,41,101,-60
2984,2984,28,2022/4/15 16:20:00,48,85,-37
2985,2985,28,2022/4/15 16:30:00,53,59,-6
2986,2986,28,2022/4/15 16:40:00,52,118,-66
2987,2987,28,2022/4/15 16:50:00,89,102,-13
2988,2988,28,2022/4/15 17:00:00,70,122,-52
2989,2989,28,2022/4/15 17:10:00,73,124,-51
2990,2990,28,2022/4/15 17:20:00,66,103,-37
2991,2991,28,2022/4/15 17:30:00,73,78,-5
2992,2992,28,2022/4/15 17:40:00,73,132,-59
2993,2993,28,2022/4/15 17:50:00,61,179,-118
2994,2994,28,2022/4/15 18:00:00,70,124,-54
2995,2995,28,2022/4/15 18:10:00,57,123,-66
2996,2996,28,2022/4/15 18:20:00,47,110,-63
2997,2997,28,2022/4/15 18:30:00,42,214,-172
2998,2998,28,2022/4/15 18:40:00,40,110,-70
2999,2999,28,2022/4/15 18:50:00,37,110,-73
3000,3000,28,2022/4/15 19:00:00,37,110,-73
3001,3001,28,2022/4/15 19:10:00,41,180,-139
3002,3002,28,2022/4/15 19:20:00,34,126,-92
3003,3003,28,2022/4/15 19:30:00,34,99,-65
3004,3004,28,2022/4/15 19:40:00,37,117,-80
3005,3005,28,2022/4/15 19:50:00,33,103,-70
3006,3006,28,2022/4/15 20:00:00,30,95,-65
3007,3007,28,2022/4/15 20:10:00,37,88,-51
3008,3008,28,2022/4/15 20:20:00,25,84,-59
3009,3009,28,2022/4/15 20:30:00,29,92,-63
3010,3010,28,2022/4/15 20:40:00,27,82,-55
3011,3011,28,2022/4/15 20:50:00,25,88,-63
3012,3012,28,2022/4/15 21:00:00,26,75,-49
3013,3013,28,2022/4/15 21:10:00,26,23,3
3014,3014,28,2022/4/15 21:20:00,25,75,-50
3015,3015,28,2022/4/15 21:30:00,26,76,-50
3016,3016,28,2022/4/15 21:40:00,7,85,-78
3017,3017,28,2022/4/15 21:50:00,7,8,-1
3018,3018,28,2022/4/15 22:00:00,7,82,-75
3019,3019,28,2022/4/15 22:10:00,4,85,-81
3020,3020,28,2022/4/15 22:20:00,1,15,-14
3021,3021,28,2022/4/15 22:30:00,2,70,-68
3022,3022,28,2022/4/15 22:40:00,2,74,-72
3023,3023,28,2022/4/15 22:50:00,1,10,-9
3024,3024,29,2022/4/15 5:00:00,0,1,-1
3025,3025,29,2022/4/15 5:10:00,0,1,-1
3026,3026,29,2022/4/15 5:20:00,6,1,5
3027,3027,29,2022/4/15 5:30:00,18,1,17
3028,3028,29,2022/4/15 5:40:00,14,1,13
3029,3029,29,2022/4/15 5:50:00,17,1,16
3030,3030,29,2022/4/15 6:00:00,26,1,25
3031,3031,29,2022/4/15 6:10:00,28,1,27
3032,3032,29,2022/4/15 6:20:00,40,5,35
3033,3033,29,2022/4/15 6:30:00,46,23,23
3034,3034,29,2022/4/15 6:40:00,70,23,47
3035,3035,29,2022/4/15 6:50:00,84,41,43
3036,3036,29,2022/4/15 7:00:00,169,55,114
3037,3037,29,2022/4/15 7:10:00,232,38,194
3038,3038,29,2022/4/15 7:20:00,283,105,178
3039,3039,29,2022/4/15 7:30:00,279,64,215
3040,3040,29,2022/4/15 7:40:00,279,80,199
3041,3041,29,2022/4/15 7:50:00,267,70,197
3042,3042,29,2022/4/15 8:00:00,237,107,130
3043,3043,29,2022/4/15 8:10:00,189,93,96
3044,3044,29,2022/4/15 8:20:00,156,75,81
3045,3045,29,2022/4/15 8:30:00,150,75,75
3046,3046,29,2022/4/15 8:40:00,61,100,-39
3047,3047,29,2022/4/15 8:50:00,56,68,-12
3048,3048,29,2022/4/15 9:00:00,41,57,-16
3049,3049,29,2022/4/15 9:10:00,28,66,-38
3050,3050,29,2022/4/15 9:20:00,30,71,-41
3051,3051,29,2022/4/15 9:30:00,29,65,-36
3052,3052,29,2022/4/15 9:40:00,29,66,-37
3053,3053,29,2022/4/15 9:50:00,28,47,-19
3054,3054,29,2022/4/15 10:00:00,27,63,-36
3055,3055,29,2022/4/15 10:10:00,23,61,-38
3056,3056,29,2022/4/15 10:20:00,26,51,-25
3057,3057,29,2022/4/15 10:30:00,25,32,-7
3058,3058,29,2022/4/15 10:40:00,25,55,-30
3059,3059,29,2022/4/15 10:50:00,27,64,-37
3060,3060,29,2022/4/15 11:00:00,24,49,-25
3061,3061,29,2022/4/15 11:10:00,25,11,14
3062,3062,29,2022/4/15 11:20:00,27,50,-23
3063,3063,29,2022/4/15 11:30:00,28,49,-21
3064,3064,29,2022/4/15 11:40:00,28,51,-23
3065,3065,29,2022/4/15 11:50:00,29,55,-26
3066,3066,29,2022/4/15 12:00:00,26,54,-28
3067,3067,29,2022/4/15 12:10:00,23,7,16
3068,3068,29,2022/4/15 12:20:00,25,67,-42
3069,3069,29,2022/4/15 12:30:00,24,58,-34
3070,3070,29,2022/4/15 12:40:00,28,62,-34
3071,3071,29,2022/4/15 12:50:00,23,60,-37
3072,3072,29,2022/4/15 13:00:00,23,20,3
3073,3073,29,2022/4/15 13:10:00,25,52,-27
3074,3074,29,2022/4/15 13:20:00,22,63,-41
3075,3075,29,2022/4/15 13:30:00,23,70,-47
3076,3076,29,2022/4/15 13:40:00,20,66,-46
3077,3077,29,2022/4/15 13:50:00,25,62,-37
3078,3078,29,2022/4/15 14:00:00,22,30,-8
3079,3079,29,2022/4/15 14:10:00,26,48,-22
3080,3080,29,2022/4/15 14:20:00,25,61,-36
3081,3081,29,2022/4/15 14:30:00,26,61,-35
3082,3082,29,2022/4/15 14:40:00,23,62,-39
3083,3083,29,2022/4/15 14:50:00,26,65,-39
3084,3084,29,2022/4/15 15:00:00,24,27,-3
3085,3085,29,2022/4/15 15:10:00,24,49,-25
3086,3086,29,2022/4/15 15:20:00,27,67,-40
3087,3087,29,2022/4/15 15:30:00,25,66,-41
3088,3088,29,2022/4/15 15:40:00,24,67,-43
3089,3089,29,2022/4/15 15:50:00,28,70,-42
3090,3090,29,2022/4/15 16:00:00,22,36,-14
3091,3091,29,2022/4/15 16:10:00,24,48,-24
3092,3092,29,2022/4/15 16:20:00,27,60,-33
3093,3093,29,2022/4/15 16:30:00,28,67,-39
3094,3094,29,2022/4/15 16:40:00,27,77,-50
3095,3095,29,2022/4/15 16:50:00,31,77,-46
3096,3096,29,2022/4/15 17:00:00,26,43,-17
3097,3097,29,2022/4/15 17:10:00,37,76,-39
3098,3098,29,2022/4/15 17:20:00,32,105,-73
3099,3099,29,2022/4/15 17:30:00,29,111,-82
3100,3100,29,2022/4/15 17:40:00,34,122,-88
3101,3101,29,2022/4/15 17:50:00,28,100,-72
3102,3102,29,2022/4/15 18:00:00,28,110,-82
3103,3103,29,2022/4/15 18:10:00,28,106,-78
3104,3104,29,2022/4/15 18:20:00,26,122,-96
3105,3105,29,2022/4/15 18:30:00,27,128,-101
3106,3106,29,2022/4/15 18:40:00,20,125,-105
3107,3107,29,2022/4/15 18:50:00,20,98,-78
3108,3108,29,2022/4/15 19:00:00,17,121,-104
3109,3109,29,2022/4/15 19:10:00,16,110,-94
3110,3110,29,2022/4/15 19:20:00,13,107,-94
3111,3111,29,2022/4/15 19:30:00,14,112,-98
3112,3112,29,2022/4/15 19:40:00,17,106,-89
3113,3113,29,2022/4/15 19:50:00,15,101,-86
3114,3114,29,2022/4/15 20:00:00,14,79,-65
3115,3115,29,2022/4/15 20:10:00,14,85,-71
3116,3116,29,2022/4/15 20:20:00,12,84,-72
3117,3117,29,2022/4/15 20:30:00,12,94,-82
3118,3118,29,2022/4/15 20:40:00,12,35,-23
3119,3119,29,2022/4/15 20:50:00,10,79,-69
3120,3120,29,2022/4/15 21:00:00,11,77,-66
3121,3121,29,2022/4/15 21:10:00,11,86,-75
3122,3122,29,2022/4/15 21:20:00,8,75,-67
3123,3123,29,2022/4/15 21:30:00,7,10,-3
3124,3124,29,2022/4/15 21:40:00,8,76,-68
3125,3125,29,2022/4/15 21:50:00,2,78,-76
3126,3126,29,2022/4/15 22:00:00,0,14,-14
3127,3127,29,2022/4/15 22:10:00,0,69,-69
3128,3128,29,2022/4/15 22:20:00,0,77,-77
3129,3129,29,2022/4/15 22:30:00,0,23,-23
3130,3130,29,2022/4/15 22:40:00,0,56,-56
3131,3131,29,2022/4/15 22:50:00,0,62,-62
3132,3132,30,2022/4/15 5:00:00,0,1,-1
3133,3133,30,2022/4/15 5:10:00,0,1,-1
3134,3134,30,2022/4/15 5:20:00,0,1,-1
3135,3135,30,2022/4/15 5:30:00,3,1,2
3136,3136,30,2022/4/15 5:40:00,6,1,5
3137,3137,30,2022/4/15 5:50:00,18,1,17
3138,3138,30,2022/4/15 6:00:00,20,1,19
3139,3139,30,2022/4/15 6:10:00,31,33,-2
3140,3140,30,2022/4/15 6:20:00,33,45,-12
3141,3141,30,2022/4/15 6:30:00,40,55,-15
3142,3142,30,2022/4/15 6:40:00,59,71,-12
3143,3143,30,2022/4/15 6:50:00,67,79,-12
3144,3144,30,2022/4/15 7:00:00,92,88,4
3145,3145,30,2022/4/15 7:10:00,156,114,42
3146,3146,30,2022/4/15 7:20:00,216,101,115
3147,3147,30,2022/4/15 7:30:00,235,123,112
3148,3148,30,2022/4/15 7:40:00,303,128,175
3149,3149,30,2022/4/15 7:50:00,326,180,146
3150,3150,30,2022/4/15 8:00:00,443,317,126
3151,3151,30,2022/4/15 8:10:00,476,414,62
3152,3152,30,2022/4/15 8:20:00,443,485,-42
3153,3153,30,2022/4/15 8:30:00,345,567,-222
3154,3154,30,2022/4/15 8:40:00,330,1532,-1202
3155,3155,30,2022/4/15 8:50:00,254,592,-338
3156,3156,30,2022/4/15 9:00:00,225,505,-280
3157,3157,30,2022/4/15 9:10:00,193,322,-129
3158,3158,30,2022/4/15 9:20:00,173,231,-58
3159,3159,30,2022/4/15 9:30:00,145,217,-72
3160,3160,30,2022/4/15 9:40:00,91,191,-100
3161,3161,30,2022/4/15 9:50:00,76,151,-75
3162,3162,30,2022/4/15 10:00:00,73,121,-48
3163,3163,30,2022/4/15 10:10:00,67,108,-41
3164,3164,30,2022/4/15 10:20:00,57,123,-66
3165,3165,30,2022/4/15 10:30:00,55,113,-58
3166,3166,30,2022/4/15 10:40:00,48,105,-57
3167,3167,30,2022/4/15 10:50:00,47,105,-58
3168,3168,30,2022/4/15 11:00:00,50,105,-55
3169,3169,30,2022/4/15 11:10:00,45,97,-52
3170,3170,30,2022/4/15 11:20:00,43,103,-60
3171,3171,30,2022/4/15 11:30:00,49,105,-56
3172,3172,30,2022/4/15 11:40:00,54,100,-46
3173,3173,30,2022/4/15 11:50:00,48,106,-58
3174,3174,30,2022/4/15 12:00:00,60,105,-45
3175,3175,30,2022/4/15 12:10:00,60,87,-27
3176,3176,30,2022/4/15 12:20:00,67,103,-36
3177,3177,30,2022/4/15 12:30:00,60,127,-67
3178,3178,30,2022/4/15 12:40:00,67,123,-56
3179,3179,30,2022/4/15 12:50:00,62,97,-35
3180,3180,30,2022/4/15 13:00:00,68,126,-58
3181,3181,30,2022/4/15 13:10:00,74,119,-45
3182,3182,30,2022/4/15 13:20:00,71,103,-32
3183,3183,30,2022/4/15 13:30:00,77,108,-31
3184,3184,30,2022/4/15 13:40:00,71,122,-51
3185,3185,30,2022/4/15 13:50:00,61,106,-45
3186,3186,30,2022/4/15 14:00:00,67,104,-37
3187,3187,30,2022/4/15 14:10:00,67,109,-42
3188,3188,30,2022/4/15 14:20:00,68,112,-44
3189,3189,30,2022/4/15 14:30:00,70,96,-26
3190,3190,30,2022/4/15 14:40:00,66,104,-38
3191,3191,30,2022/4/15 14:50:00,66,105,-39
3192,3192,30,2022/4/15 15:00:00,70,122,-52
3193,3193,30,2022/4/15 15:10:00,65,123,-58
3194,3194,30,2022/4/15 15:20:00,64,110,-46
3195,3195,30,2022/4/15 15:30:00,117,121,-4
3196,3196,30,2022/4/15 15:40:00,85,121,-36
3197,3197,30,2022/4/15 15:50:00,168,96,72
3198,3198,30,2022/4/15 16:00:00,146,111,35
3199,3199,30,2022/4/15 16:10:00,111,100,11
3200,3200,30,2022/4/15 16:20:00,130,97,33
3201,3201,30,2022/4/15 16:30:00,180,121,59
3202,3202,30,2022/4/15 16:40:00,170,113,57
3203,3203,30,2022/4/15 16:50:00,179,118,61
3204,3204,30,2022/4/15 17:00:00,269,143,126
3205,3205,30,2022/4/15 17:10:00,336,138,198
3206,3206,30,2022/4/15 17:20:00,269,152,117
3207,3207,30,2022/4/15 17:30:00,568,178,390
3208,3208,30,2022/4/15 17:40:00,649,225,424
3209,3209,30,2022/4/15 17:50:00,422,218,204
3210,3210,30,2022/4/15 18:00:00,620,268,352
3211,3211,30,2022/4/15 18:10:00,818,313,505
3212,3212,30,2022/4/15 18:20:00,569,217,352
3213,3213,30,2022/4/15 18:30:00,351,300,51
3214,3214,30,2022/4/15 18:40:00,310,269,41
3215,3215,30,2022/4/15 18:50:00,265,232,33
3216,3216,30,2022/4/15 19:00:00,234,153,81
3217,3217,30,2022/4/15 19:10:00,216,139,77
3218,3218,30,2022/4/15 19:20:00,179,112,67
3219,3219,30,2022/4/15 19:30:00,137,125,12
3220,3220,30,2022/4/15 19:40:00,137,108,29
3221,3221,30,2022/4/15 19:50:00,115,103,12
3222,3222,30,2022/4/15 20:00:00,96,104,-8
3223,3223,30,2022/4/15 20:10:00,113,113,0
3224,3224,30,2022/4/15 20:20:00,85,92,-7
3225,3225,30,2022/4/15 20:30:00,125,97,28
3226,3226,30,2022/4/15 20:40:00,79,106,-27
3227,3227,30,2022/4/15 20:50:00,74,92,-18
3228,3228,30,2022/4/15 21:00:00,144,78,66
3229,3229,30,2022/4/15 21:10:00,138,92,46
3230,3230,30,2022/4/15 21:20:00,89,80,9
3231,3231,30,2022/4/15 21:30:00,64,111,-47
3232,3232,30,2022/4/15 21:40:00,58,77,-19
3233,3233,30,2022/4/15 21:50:00,41,67,-26
3234,3234,30,2022/4/15 22:00:00,41,92,-51
3235,3235,30,2022/4/15 22:10:00,34,78,-44
3236,3236,30,2022/4/15 22:20:00,25,84,-59
3237,3237,30,2022/4/15 22:30:00,22,80,-58
3238,3238,30,2022/4/15 22:40:00,16,59,-43
3239,3239,30,2022/4/15 22:50:00,10,51,-41
3240,3240,31,2022/4/15 5:00:00,0,1,-1
3241,3241,31,2022/4/15 5:10:00,0,1,-1
3242,3242,31,2022/4/15 5:20:00,2,1,1
3243,3243,31,2022/4/15 5:30:00,5,1,4
3244,3244,31,2022/4/15 5:40:00,3,1,2
3245,3245,31,2022/4/15 5:50:00,4,1,3
3246,3246,31,2022/4/15 6:00:00,13,1,12
3247,3247,31,2022/4/15 6:10:00,16,1,15
3248,3248,31,2022/4/15 6:20:00,19,1,18
3249,3249,31,2022/4/15 6:30:00,17,1,16
3250,3250,31,2022/4/15 6:40:00,23,23,0
3251,3251,31,2022/4/15 6:50:00,23,21,2
3252,3252,31,2022/4/15 7:00:00,29,33,-4
3253,3253,31,2022/4/15 7:10:00,31,19,12
3254,3254,31,2022/4/15 7:20:00,36,65,-29
3255,3255,31,2022/4/15 7:30:00,31,64,-33
3256,3256,31,2022/4/15 7:40:00,31,71,-40
3257,3257,31,2022/4/15 7:50:00,31,50,-19
3258,3258,31,2022/4/15 8:00:00,30,63,-33
3259,3259,31,2022/4/15 8:10:00,22,51,-29
3260,3260,31,2022/4/15 8:20:00,23,67,-44
3261,3261,31,2022/4/15 8:30:00,19,59,-40
3262,3262,31,2022/4/15 8:40:00,17,53,-36
3263,3263,31,2022/4/15 8:50:00,15,80,-65
3264,3264,31,2022/4/15 9:00:00,10,47,-37
3265,3265,31,2022/4/15 9:10:00,11,30,-19
3266,3266,31,2022/4/15 9:20:00,11,35,-24
3267,3267,31,2022/4/15 9:30:00,9,34,-25
3268,3268,31,2022/4/15 9:40:00,9,37,-28
3269,3269,31,2022/4/15 9:50:00,10,32,-22
3270,3270,31,2022/4/15 10:00:00,8,30,-22
3271,3271,31,2022/4/15 10:10:00,9,37,-28
3272,3272,31,2022/4/15 10:20:00,8,21,-13
3273,3273,31,2022/4/15 10:30:00,8,32,-24
3274,3274,31,2022/4/15 10:40:00,6,37,-31
3275,3275,31,2022/4/15 10:50:00,8,29,-21
3276,3276,31,2022/4/15 11:00:00,7,8,-1
3277,3277,31,2022/4/15 11:10:00,10,33,-23
3278,3278,31,2022/4/15 11:20:00,11,30,-19
3279,3279,31,2022/4/15 11:30:00,10,29,-19
3280,3280,31,2022/4/15 11:40:00,11,23,-12
3281,3281,31,2022/4/15 11:50:00,11,23,-12
3282,3282,31,2022/4/15 12:00:00,12,16,-4
3283,3283,31,2022/4/15 12:10:00,10,15,-5
3284,3284,31,2022/4/15 12:20:00,10,32,-22
3285,3285,31,2022/4/15 12:30:00,13,23,-10
3286,3286,31,2022/4/15 12:40:00,10,25,-15
3287,3287,31,2022/4/15 12:50:00,8,22,-14
3288,3288,31,2022/4/15 13:00:00,13,8,5
3289,3289,31,2022/4/15 13:10:00,11,25,-14
3290,3290,31,2022/4/15 13:20:00,10,31,-21
3291,3291,31,2022/4/15 13:30:00,10,25,-15
3292,3292,31,2022/4/15 13:40:00,11,29,-18
3293,3293,31,2022/4/15 13:50:00,11,23,-12
3294,3294,31,2022/4/15 14:00:00,8,12,-4
3295,3295,31,2022/4/15 14:10:00,9,35,-26
3296,3296,31,2022/4/15 14:20:00,10,32,-22
3297,3297,31,2022/4/15 14:30:00,11,31,-20
3298,3298,31,2022/4/15 14:40:00,11,23,-12
3299,3299,31,2022/4/15 14:50:00,9,21,-12
3300,3300,31,2022/4/15 15:00:00,11,21,-10
3301,3301,31,2022/4/15 15:10:00,11,32,-21
3302,3302,31,2022/4/15 15:20:00,12,35,-23
3303,3303,31,2022/4/15 15:30:00,12,29,-17
3304,3304,31,2022/4/15 15:40:00,13,32,-19
3305,3305,31,2022/4/15 15:50:00,12,30,-18
3306,3306,31,2022/4/15 16:00:00,20,12,8
3307,3307,31,2022/4/15 16:10:00,9,31,-22
3308,3308,31,2022/4/15 16:20:00,26,23,3
3309,3309,31,2022/4/15 16:30:00,20,47,-27
3310,3310,31,2022/4/15 16:40:00,19,38,-19
3311,3311,31,2022/4/15 16:50:00,26,32,-6
3312,3312,31,2022/4/15 17:00:00,22,14,8
3313,3313,31,2022/4/15 17:10:00,23,41,-18
3314,3314,31,2022/4/15 17:20:00,22,40,-18
3315,3315,31,2022/4/15 17:30:00,33,38,-5
3316,3316,31,2022/4/15 17:40:00,19,39,-20
3317,3317,31,2022/4/15 17:50:00,29,45,-16
3318,3318,31,2022/4/15 18:00:00,21,45,-24
3319,3319,31,2022/4/15 18:10:00,15,48,-33
3320,3320,31,2022/4/15 18:20:00,17,47,-30
3321,3321,31,2022/4/15 18:30:00,17,68,-51
3322,3322,31,2022/4/15 18:40:00,12,72,-60
3323,3323,31,2022/4/15 18:50:00,14,51,-37
3324,3324,31,2022/4/15 19:00:00,12,46,-34
3325,3325,31,2022/4/15 19:10:00,9,60,-51
3326,3326,31,2022/4/15 19:20:00,8,61,-53
3327,3327,31,2022/4/15 19:30:00,5,47,-42
3328,3328,31,2022/4/15 19:40:00,8,40,-32
3329,3329,31,2022/4/15 19:50:00,6,47,-41
3330,3330,31,2022/4/15 20:00:00,8,44,-36
3331,3331,31,2022/4/15 20:10:00,3,37,-34
3332,3332,31,2022/4/15 20:20:00,2,34,-32
3333,3333,31,2022/4/15 20:30:00,4,40,-36
3334,3334,31,2022/4/15 20:40:00,5,10,-5
3335,3335,31,2022/4/15 20:50:00,3,40,-37
3336,3336,31,2022/4/15 21:00:00,2,34,-32
3337,3337,31,2022/4/15 21:10:00,2,36,-34
3338,3338,31,2022/4/15 21:20:00,2,36,-34
3339,3339,31,2022/4/15 21:30:00,3,7,-4
3340,3340,31,2022/4/15 21:40:00,0,35,-35
3341,3341,31,2022/4/15 21:50:00,0,34,-34
3342,3342,31,2022/4/15 22:00:00,0,10,-10
3343,3343,31,2022/4/15 22:10:00,0,25,-25
3344,3344,31,2022/4/15 22:20:00,0,31,-31
3345,3345,31,2022/4/15 22:30:00,0,21,-21
3346,3346,31,2022/4/15 22:40:00,0,13,-13
3347,3347,31,2022/4/15 22:50:00,0,21,-21
3348,3348,32,2022/4/15 5:00:00,0,1,-1
3349,3349,32,2022/4/15 5:10:00,0,1,-1
3350,3350,32,2022/4/15 5:20:00,0,1,-1
3351,3351,32,2022/4/15 5:30:00,0,1,-1
3352,3352,32,2022/4/15 5:40:00,6,1,5
3353,3353,32,2022/4/15 5:50:00,20,1,19
3354,3354,32,2022/4/15 6:00:00,39,6,33
3355,3355,32,2022/4/15 6:10:00,43,51,-8
3356,3356,32,2022/4/15 6:20:00,55,45,10
3357,3357,32,2022/4/15 6:30:00,68,47,21
3358,3358,32,2022/4/15 6:40:00,121,70,51
3359,3359,32,2022/4/15 6:50:00,189,78,111
3360,3360,32,2022/4/15 7:00:00,222,94,128
3361,3361,32,2022/4/15 7:10:00,244,107,137
3362,3362,32,2022/4/15 7:20:00,281,106,175
3363,3363,32,2022/4/15 7:30:00,360,119,241
3364,3364,32,2022/4/15 7:40:00,475,170,305
3365,3365,32,2022/4/15 7:50:00,598,178,420
3366,3366,32,2022/4/15 8:00:00,442,117,325
3367,3367,32,2022/4/15 8:10:00,366,268,98
3368,3368,32,2022/4/15 8:20:00,341,192,149
3369,3369,32,2022/4/15 8:30:00,344,180,164
3370,3370,32,2022/4/15 8:40:00,278,180,98
3371,3371,32,2022/4/15 8:50:00,277,285,-8
3372,3372,32,2022/4/15 9:00:00,247,151,96
3373,3373,32,2022/4/15 9:10:00,201,139,62
3374,3374,32,2022/4/15 9:20:00,179,110,69
3375,3375,32,2022/4/15 9:30:00,107,109,-2
3376,3376,32,2022/4/15 9:40:00,72,112,-40
3377,3377,32,2022/4/15 9:50:00,73,97,-24
3378,3378,32,2022/4/15 10:00:00,49,101,-52
3379,3379,32,2022/4/15 10:10:00,44,114,-70
3380,3380,32,2022/4/15 10:20:00,46,80,-34
3381,3381,32,2022/4/15 10:30:00,41,79,-38
3382,3382,32,2022/4/15 10:40:00,43,80,-37
3383,3383,32,2022/4/15 10:50:00,37,81,-44
3384,3384,32,2022/4/15 11:00:00,41,87,-46
3385,3385,32,2022/4/15 11:10:00,41,79,-38
3386,3386,32,2022/4/15 11:20:00,41,83,-42
3387,3387,32,2022/4/15 11:30:00,38,94,-56
3388,3388,32,2022/4/15 11:40:00,39,69,-30
3389,3389,32,2022/4/15 11:50:00,43,90,-47
3390,3390,32,2022/4/15 12:00:00,41,101,-60
3391,3391,32,2022/4/15 12:10:00,44,81,-37
3392,3392,32,2022/4/15 12:20:00,43,93,-50
3393,3393,32,2022/4/15 12:30:00,46,106,-60
3394,3394,32,2022/4/15 12:40:00,44,78,-34
3395,3395,32,2022/4/15 12:50:00,41,103,-62
3396,3396,32,2022/4/15 13:00:00,45,111,-66
3397,3397,32,2022/4/15 13:10:00,44,76,-32
3398,3398,32,2022/4/15 13:20:00,38,100,-62
3399,3399,32,2022/4/15 13:30:00,40,98,-58
3400,3400,32,2022/4/15 13:40:00,40,73,-33
3401,3401,32,2022/4/15 13:50:00,37,96,-59
3402,3402,32,2022/4/15 14:00:00,44,108,-64
3403,3403,32,2022/4/15 14:10:00,36,68,-32
3404,3404,32,2022/4/15 14:20:00,37,94,-57
3405,3405,32,2022/4/15 14:30:00,37,105,-68
3406,3406,32,2022/4/15 14:40:00,37,76,-39
3407,3407,32,2022/4/15 14:50:00,39,105,-66
3408,3408,32,2022/4/15 15:00:00,41,111,-70
3409,3409,32,2022/4/15 15:10:00,49,84,-35
3410,3410,32,2022/4/15 15:20:00,44,112,-68
3411,3411,32,2022/4/15 15:30:00,53,104,-51
3412,3412,32,2022/4/15 15:40:00,41,81,-40
3413,3413,32,2022/4/15 15:50:00,44,108,-64
3414,3414,32,2022/4/15 16:00:00,60,123,-63
3415,3415,32,2022/4/15 16:10:00,61,96,-35
3416,3416,32,2022/4/15 16:20:00,55,106,-51
3417,3417,32,2022/4/15 16:30:00,68,126,-58
3418,3418,32,2022/4/15 16:40:00,79,103,-24
3419,3419,32,2022/4/15 16:50:00,86,125,-39
3420,3420,32,2022/4/15 17:00:00,207,103,104
3421,3421,32,2022/4/15 17:10:00,270,138,132
3422,3422,32,2022/4/15 17:20:00,214,143,71
3423,3423,32,2022/4/15 17:30:00,174,233,-59
3424,3424,32,2022/4/15 17:40:00,225,225,0
3425,3425,32,2022/4/15 17:50:00,206,298,-92
3426,3426,32,2022/4/15 18:00:00,177,285,-108
3427,3427,32,2022/4/15 18:10:00,222,328,-106
3428,3428,32,2022/4/15 18:20:00,169,284,-115
3429,3429,32,2022/4/15 18:30:00,110,301,-191
3430,3430,32,2022/4/15 18:40:00,80,285,-205
3431,3431,32,2022/4/15 18:50:00,59,235,-176
3432,3432,32,2022/4/15 19:00:00,48,192,-144
3433,3433,32,2022/4/15 19:10:00,46,154,-108
3434,3434,32,2022/4/15 19:20:00,43,128,-85
3435,3435,32,2022/4/15 19:30:00,36,110,-74
3436,3436,32,2022/4/15 19:40:00,36,109,-73
3437,3437,32,2022/4/15 19:50:00,32,106,-74
3438,3438,32,2022/4/15 20:00:00,32,128,-96
3439,3439,32,2022/4/15 20:10:00,35,107,-72
3440,3440,32,2022/4/15 20:20:00,33,100,-67
3441,3441,32,2022/4/15 20:30:00,29,100,-71
3442,3442,32,2022/4/15 20:40:00,29,77,-48
3443,3443,32,2022/4/15 20:50:00,32,129,-97
3444,3444,32,2022/4/15 21:00:00,66,83,-17
3445,3445,32,2022/4/15 21:10:00,32,125,-93
3446,3446,32,2022/4/15 21:20:00,30,78,-48
3447,3447,32,2022/4/15 21:30:00,27,107,-80
3448,3448,32,2022/4/15 21:40:00,32,103,-71
3449,3449,32,2022/4/15 21:50:00,27,94,-67
3450,3450,32,2022/4/15 22:00:00,25,95,-70
3451,3451,32,2022/4/15 22:10:00,17,110,-93
3452,3452,32,2022/4/15 22:20:00,12,77,-65
3453,3453,32,2022/4/15 22:30:00,7,108,-101
3454,3454,32,2022/4/15 22:40:00,6,64,-58
3455,3455,32,2022/4/15 22:50:00,3,66,-63
3456,3456,33,2022/4/15 5:00:00,0,1,-1
3457,3457,33,2022/4/15 5:10:00,0,1,-1
3458,3458,33,2022/4/15 5:20:00,3,1,2
3459,3459,33,2022/4/15 5:30:00,13,1,12
3460,3460,33,2022/4/15 5:40:00,8,1,7
3461,3461,33,2022/4/15 5:50:00,8,1,7
3462,3462,33,2022/4/15 6:00:00,10,1,9
3463,3463,33,2022/4/15 6:10:00,15,1,14
3464,3464,33,2022/4/15 6:20:00,24,1,23
3465,3465,33,2022/4/15 6:30:00,28,1,27
3466,3466,33,2022/4/15 6:40:00,39,1,38
3467,3467,33,2022/4/15 6:50:00,49,1,48
3468,3468,33,2022/4/15 7:00:00,55,45,10
3469,3469,33,2022/4/15 7:10:00,64,12,52
3470,3470,33,2022/4/15 7:20:00,59,29,30
3471,3471,33,2022/4/15 7:30:00,76,50,26
3472,3472,33,2022/4/15 7:40:00,48,38,10
3473,3473,33,2022/4/15 7:50:00,55,37,18
3474,3474,33,2022/4/15 8:00:00,42,59,-17
3475,3475,33,2022/4/15 8:10:00,50,45,5
3476,3476,33,2022/4/15 8:20:00,36,44,-8
3477,3477,33,2022/4/15 8:30:00,29,51,-22
3478,3478,33,2022/4/15 8:40:00,30,65,-35
3479,3479,33,2022/4/15 8:50:00,26,46,-20
3480,3480,33,2022/4/15 9:00:00,21,48,-27
3481,3481,33,2022/4/15 9:10:00,21,38,-17
3482,3482,33,2022/4/15 9:20:00,21,59,-38
3483,3483,33,2022/4/15 9:30:00,13,37,-24
3484,3484,33,2022/4/15 9:40:00,15,38,-23
3485,3485,33,2022/4/15 9:50:00,18,48,-30
3486,3486,33,2022/4/15 10:00:00,13,40,-27
3487,3487,33,2022/4/15 10:10:00,13,28,-15
3488,3488,33,2022/4/15 10:20:00,14,38,-24
3489,3489,33,2022/4/15 10:30:00,13,38,-25
3490,3490,33,2022/4/15 10:40:00,12,37,-25
3491,3491,33,2022/4/15 10:50:00,17,40,-23
3492,3492,33,2022/4/15 11:00:00,11,8,3
3493,3493,33,2022/4/15 11:10:00,16,40,-24
3494,3494,33,2022/4/15 11:20:00,11,39,-28
3495,3495,33,2022/4/15 11:30:00,10,29,-19
3496,3496,33,2022/4/15 11:40:00,19,37,-18
3497,3497,33,2022/4/15 11:50:00,12,33,-21
3498,3498,33,2022/4/15 12:00:00,14,8,6
3499,3499,33,2022/4/15 12:10:00,13,33,-20
3500,3500,33,2022/4/15 12:20:00,9,38,-29
3501,3501,33,2022/4/15 12:30:00,16,38,-22
3502,3502,33,2022/4/15 12:40:00,12,25,-13
3503,3503,33,2022/4/15 12:50:00,8,8,0
3504,3504,33,2022/4/15 13:00:00,13,25,-12
3505,3505,33,2022/4/15 13:10:00,11,33,-22
3506,3506,33,2022/4/15 13:20:00,12,38,-26
3507,3507,33,2022/4/15 13:30:00,13,32,-19
3508,3508,33,2022/4/15 13:40:00,12,38,-26
3509,3509,33,2022/4/15 13:50:00,10,8,2
3510,3510,33,2022/4/15 14:00:00,12,35,-23
3511,3511,33,2022/4/15 14:10:00,10,35,-25
3512,3512,33,2022/4/15 14:20:00,8,33,-25
3513,3513,33,2022/4/15 14:30:00,17,38,-21
3514,3514,33,2022/4/15 14:40:00,9,38,-29
3515,3515,33,2022/4/15 14:50:00,10,7,3
3516,3516,33,2022/4/15 15:00:00,15,33,-18
3517,3517,33,2022/4/15 15:10:00,15,40,-25
3518,3518,33,2022/4/15 15:20:00,13,38,-25
3519,3519,33,2022/4/15 15:30:00,14,44,-30
3520,3520,33,2022/4/15 15:40:00,13,38,-25
3521,3521,33,2022/4/15 15:50:00,19,8,11
3522,3522,33,2022/4/15 16:00:00,15,37,-22
3523,3523,33,2022/4/15 16:10:00,15,45,-30
3524,3524,33,2022/4/15 16:20:00,14,44,-30
3525,3525,33,2022/4/15 16:30:00,16,47,-31
3526,3526,33,2022/4/15 16:40:00,16,46,-30
3527,3527,33,2022/4/15 16:50:00,14,19,-5
3528,3528,33,2022/4/15 17:00:00,18,46,-28
3529,3529,33,2022/4/15 17:10:00,20,54,-34
3530,3530,33,2022/4/15 17:20:00,19,61,-42
3531,3531,33,2022/4/15 17:30:00,17,63,-46
3532,3532,33,2022/4/15 17:40:00,22,66,-44
3533,3533,33,2022/4/15 17:50:00,21,71,-50
3534,3534,33,2022/4/15 18:00:00,20,62,-42
3535,3535,33,2022/4/15 18:10:00,19,63,-44
3536,3536,33,2022/4/15 18:20:00,19,98,-79
3537,3537,33,2022/4/15 18:30:00,14,71,-57
3538,3538,33,2022/4/15 18:40:00,15,69,-54
3539,3539,33,2022/4/15 18:50:00,10,64,-54
3540,3540,33,2022/4/15 19:00:00,9,101,-92
3541,3541,33,2022/4/15 19:10:00,15,74,-59
3542,3542,33,2022/4/15 19:20:00,8,79,-71
3543,3543,33,2022/4/15 19:30:00,8,71,-63
3544,3544,33,2022/4/15 19:40:00,8,103,-95
3545,3545,33,2022/4/15 19:50:00,5,73,-68
3546,3546,33,2022/4/15 20:00:00,6,67,-61
3547,3547,33,2022/4/15 20:10:00,6,56,-50
3548,3548,33,2022/4/15 20:20:00,4,73,-69
3549,3549,33,2022/4/15 20:30:00,2,47,-45
3550,3550,33,2022/4/15 20:40:00,5,8,-3
3551,3551,33,2022/4/15 20:50:00,4,52,-48
3552,3552,33,2022/4/15 21:00:00,4,49,-45
3553,3553,33,2022/4/15 21:10:00,4,43,-39
3554,3554,33,2022/4/15 21:20:00,1,40,-39
3555,3555,33,2022/4/15 21:30:00,0,11,-11
3556,3556,33,2022/4/15 21:40:00,0,45,-45
3557,3557,33,2022/4/15 21:50:00,0,43,-43
3558,3558,33,2022/4/15 22:00:00,0,49,-49
3559,3559,33,2022/4/15 22:10:00,0,4,-4
3560,3560,33,2022/4/15 22:20:00,0,43,-43
3561,3561,33,2022/4/15 22:30:00,0,33,-33
3562,3562,33,2022/4/15 22:40:00,0,3,-3
3563,3563,33,2022/4/15 22:50:00,0,33,-33
3564,3564,34,2022/4/15 5:00:00,0,1,-1
3565,3565,34,2022/4/15 5:10:00,0,1,-1
3566,3566,34,2022/4/15 5:20:00,11,1,10
3567,3567,34,2022/4/15 5:30:00,17,1,16
3568,3568,34,2022/4/15 5:40:00,16,1,15
3569,3569,34,2022/4/15 5:50:00,20,1,19
3570,3570,34,2022/4/15 6:00:00,22,1,21
3571,3571,34,2022/4/15 6:10:00,28,1,27
3572,3572,34,2022/4/15 6:20:00,38,1,37
3573,3573,34,2022/4/15 6:30:00,57,1,56
3574,3574,34,2022/4/15 6:40:00,73,5,68
3575,3575,34,2022/4/15 6:50:00,155,5,150
3576,3576,34,2022/4/15 7:00:00,143,57,86
3577,3577,34,2022/4/15 7:10:00,283,62,221
3578,3578,34,2022/4/15 7:20:00,246,64,182
3579,3579,34,2022/4/15 7:30:00,151,69,82
3580,3580,34,2022/4/15 7:40:00,186,62,124
3581,3581,34,2022/4/15 7:50:00,124,70,54
3582,3582,34,2022/4/15 8:00:00,148,70,78
3583,3583,34,2022/4/15 8:10:00,71,81,-10
3584,3584,34,2022/4/15 8:20:00,65,96,-31
3585,3585,34,2022/4/15 8:30:00,51,69,-18
3586,3586,34,2022/4/15 8:40:00,53,65,-12
3587,3587,34,2022/4/15 8:50:00,33,95,-62
3588,3588,34,2022/4/15 9:00:00,26,71,-45
3589,3589,34,2022/4/15 9:10:00,31,61,-30
3590,3590,34,2022/4/15 9:20:00,28,75,-47
3591,3591,34,2022/4/15 9:30:00,24,87,-63
3592,3592,34,2022/4/15 9:40:00,22,67,-45
3593,3593,34,2022/4/15 9:50:00,22,75,-53
3594,3594,34,2022/4/15 10:00:00,28,60,-32
3595,3595,34,2022/4/15 10:10:00,23,98,-75
3596,3596,34,2022/4/15 10:20:00,27,67,-40
3597,3597,34,2022/4/15 10:30:00,22,66,-44
3598,3598,34,2022/4/15 10:40:00,29,62,-33
3599,3599,34,2022/4/15 10:50:00,25,7,18
3600,3600,34,2022/4/15 11:00:00,25,82,-57
3601,3601,34,2022/4/15 11:10:00,17,72,-55
3602,3602,34,2022/4/15 11:20:00,24,76,-52
3603,3603,34,2022/4/15 11:30:00,17,59,-42
3604,3604,34,2022/4/15 11:40:00,22,35,-13
3605,3605,34,2022/4/15 11:50:00,22,42,-20
3606,3606,34,2022/4/15 12:00:00,27,67,-40
3607,3607,34,2022/4/15 12:10:00,25,66,-41
3608,3608,34,2022/4/15 12:20:00,27,67,-40
3609,3609,34,2022/4/15 12:30:00,20,67,-47
3610,3610,34,2022/4/15 12:40:00,28,7,21
3611,3611,34,2022/4/15 12:50:00,21,61,-40
3612,3612,34,2022/4/15 13:00:00,24,65,-41
3613,3613,34,2022/4/15 13:10:00,26,65,-39
3614,3614,34,2022/4/15 13:20:00,29,65,-36
3615,3615,34,2022/4/15 13:30:00,24,60,-36
3616,3616,34,2022/4/15 13:40:00,28,9,19
3617,3617,34,2022/4/15 13:50:00,29,59,-30
3618,3618,34,2022/4/15 14:00:00,24,60,-36
3619,3619,34,2022/4/15 14:10:00,28,67,-39
3620,3620,34,2022/4/15 14:20:00,23,62,-39
3621,3621,34,2022/4/15 14:30:00,29,62,-33
3622,3622,34,2022/4/15 14:40:00,26,7,19
3623,3623,34,2022/4/15 14:50:00,26,61,-35
3624,3624,34,2022/4/15 15:00:00,25,68,-43
3625,3625,34,2022/4/15 15:10:00,25,66,-41
3626,3626,34,2022/4/15 15:20:00,23,61,-38
3627,3627,34,2022/4/15 15:30:00,28,69,-41
3628,3628,34,2022/4/15 15:40:00,34,2,32
3629,3629,34,2022/4/15 15:50:00,28,69,-41
3630,3630,34,2022/4/15 16:00:00,24,72,-48
3631,3631,34,2022/4/15 16:10:00,26,65,-39
3632,3632,34,2022/4/15 16:20:00,26,71,-45
3633,3633,34,2022/4/15 16:30:00,32,72,-40
3634,3634,34,2022/4/15 16:40:00,25,5,20
3635,3635,34,2022/4/15 16:50:00,27,83,-56
3636,3636,34,2022/4/15 17:00:00,24,69,-45
3637,3637,34,2022/4/15 17:10:00,25,90,-65
3638,3638,34,2022/4/15 17:20:00,28,77,-49
3639,3639,34,2022/4/15 17:30:00,24,78,-54
3640,3640,34,2022/4/15 17:40:00,26,23,3
3641,3641,34,2022/4/15 17:50:00,25,122,-97
3642,3642,34,2022/4/15 18:00:00,27,93,-66
3643,3643,34,2022/4/15 18:10:00,26,85,-59
3644,3644,34,2022/4/15 18:20:00,23,97,-74
3645,3645,34,2022/4/15 18:30:00,25,111,-86
3646,3646,34,2022/4/15 18:40:00,25,107,-82
3647,3647,34,2022/4/15 18:50:00,22,107,-85
3648,3648,34,2022/4/15 19:00:00,19,114,-95
3649,3649,34,2022/4/15 19:10:00,18,116,-98
3650,3650,34,2022/4/15 19:20:00,14,89,-75
3651,3651,34,2022/4/15 19:30:00,15,106,-91
3652,3652,34,2022/4/15 19:40:00,19,112,-93
3653,3653,34,2022/4/15 19:50:00,13,111,-98
3654,3654,34,2022/4/15 20:00:00,14,92,-78
3655,3655,34,2022/4/15 20:10:00,11,78,-67
3656,3656,34,2022/4/15 20:20:00,11,83,-72
3657,3657,34,2022/4/15 20:30:00,10,73,-63
3658,3658,34,2022/4/15 20:40:00,7,69,-62
3659,3659,34,2022/4/15 20:50:00,8,77,-69
3660,3660,34,2022/4/15 21:00:00,9,77,-68
3661,3661,34,2022/4/15 21:10:00,11,66,-55
3662,3662,34,2022/4/15 21:20:00,9,59,-50
3663,3663,34,2022/4/15 21:30:00,0,28,-28
3664,3664,34,2022/4/15 21:40:00,0,67,-67
3665,3665,34,2022/4/15 21:50:00,0,72,-72
3666,3666,34,2022/4/15 22:00:00,0,3,-3
3667,3667,34,2022/4/15 22:10:00,0,68,-68
3668,3668,34,2022/4/15 22:20:00,0,69,-69
3669,3669,34,2022/4/15 22:30:00,0,59,-59
3670,3670,34,2022/4/15 22:40:00,0,4,-4
3671,3671,34,2022/4/15 22:50:00,0,55,-55
3672,3672,35,2022/4/15 5:00:00,0,1,-1
3673,3673,35,2022/4/15 5:10:00,2,1,1
3674,3674,35,2022/4/15 5:20:00,31,1,30
3675,3675,35,2022/4/15 5:30:00,29,1,28
3676,3676,35,2022/4/15 5:40:00,37,1,36
3677,3677,35,2022/4/15 5:50:00,49,1,48
3678,3678,35,2022/4/15 6:00:00,56,2,54
3679,3679,35,2022/4/15 6:10:00,74,1,73
3680,3680,35,2022/4/15 6:20:00,91,2,89
3681,3681,35,2022/4/15 6:30:00,212,1,211
3682,3682,35,2022/4/15 6:40:00,270,104,166
3683,3683,35,2022/4/15 6:50:00,347,99,248
3684,3684,35,2022/4/15 7:00:00,597,134,463
3685,3685,35,2022/4/15 7:10:00,590,222,368
3686,3686,35,2022/4/15 7:20:00,720,150,570
3687,3687,35,2022/4/15 7:30:00,720,158,562
3688,3688,35,2022/4/15 7:40:00,661,110,551
3689,3689,35,2022/4/15 7:50:00,593,540,53
3690,3690,35,2022/4/15 8:00:00,592,319,273
3691,3691,35,2022/4/15 8:10:00,442,121,321
3692,3692,35,2022/4/15 8:20:00,347,178,169
3693,3693,35,2022/4/15 8:30:00,269,234,35
3694,3694,35,2022/4/15 8:40:00,228,299,-71
3695,3695,35,2022/4/15 8:50:00,186,110,76
3696,3696,35,2022/4/15 9:00:00,86,112,-26
3697,3697,35,2022/4/15 9:10:00,142,159,-17
3698,3698,35,2022/4/15 9:20:00,92,111,-19
3699,3699,35,2022/4/15 9:30:00,70,100,-30
3700,3700,35,2022/4/15 9:40:00,66,112,-46
3701,3701,35,2022/4/15 9:50:00,70,108,-38
3702,3702,35,2022/4/15 10:00:00,66,124,-58
3703,3703,35,2022/4/15 10:10:00,55,102,-47
3704,3704,35,2022/4/15 10:20:00,69,103,-34
3705,3705,35,2022/4/15 10:30:00,58,122,-64
3706,3706,35,2022/4/15 10:40:00,54,31,23
3707,3707,35,2022/4/15 10:50:00,56,98,-42
3708,3708,35,2022/4/15 11:00:00,64,110,-46
3709,3709,35,2022/4/15 11:10:00,63,99,-36
3710,3710,35,2022/4/15 11:20:00,63,112,-49
3711,3711,35,2022/4/15 11:30:00,83,81,2
3712,3712,35,2022/4/15 11:40:00,109,59,50
3713,3713,35,2022/4/15 11:50:00,128,104,24
3714,3714,35,2022/4/15 12:00:00,111,109,2
3715,3715,35,2022/4/15 12:10:00,156,109,47
3716,3716,35,2022/4/15 12:20:00,149,109,40
3717,3717,35,2022/4/15 12:30:00,129,42,87
3718,3718,35,2022/4/15 12:40:00,99,111,-12
3719,3719,35,2022/4/15 12:50:00,99,102,-3
3720,3720,35,2022/4/15 13:00:00,81,120,-39
3721,3721,35,2022/4/15 13:10:00,60,122,-62
3722,3722,35,2022/4/15 13:20:00,72,105,-33
3723,3723,35,2022/4/15 13:30:00,55,46,9
3724,3724,35,2022/4/15 13:40:00,64,95,-31
3725,3725,35,2022/4/15 13:50:00,57,103,-46
3726,3726,35,2022/4/15 14:00:00,63,105,-42
3727,3727,35,2022/4/15 14:10:00,65,105,-40
3728,3728,35,2022/4/15 14:20:00,81,110,-29
3729,3729,35,2022/4/15 14:30:00,60,35,25
3730,3730,35,2022/4/15 14:40:00,82,102,-20
3731,3731,35,2022/4/15 14:50:00,94,112,-18
3732,3732,35,2022/4/15 15:00:00,96,108,-12
3733,3733,35,2022/4/15 15:10:00,83,96,-13
3734,3734,35,2022/4/15 15:20:00,98,103,-5
3735,3735,35,2022/4/15 15:30:00,69,39,30
3736,3736,35,2022/4/15 15:40:00,109,123,-14
3737,3737,35,2022/4/15 15:50:00,145,119,26
3738,3738,35,2022/4/15 16:00:00,180,119,61
3739,3739,35,2022/4/15 16:10:00,207,121,86
3740,3740,35,2022/4/15 16:20:00,170,107,63
3741,3741,35,2022/4/15 16:30:00,180,57,123
3742,3742,35,2022/4/15 16:40:00,222,121,101
3743,3743,35,2022/4/15 16:50:00,222,111,111
3744,3744,35,2022/4/15 17:00:00,195,119,76
3745,3745,35,2022/4/15 17:10:00,270,140,130
3746,3746,35,2022/4/15 17:20:00,287,109,178
3747,3747,35,2022/4/15 17:30:00,265,54,211
3748,3748,35,2022/4/15 17:40:00,223,317,-94
3749,3749,35,2022/4/15 17:50:00,274,115,159
3750,3750,35,2022/4/15 18:00:00,133,111,22
3751,3751,35,2022/4/15 18:10:00,156,179,-23
3752,3752,35,2022/4/15 18:20:00,167,271,-104
3753,3753,35,2022/4/15 18:30:00,55,128,-73
3754,3754,35,2022/4/15 18:40:00,49,153,-104
3755,3755,35,2022/4/15 18:50:00,40,224,-184
3756,3756,35,2022/4/15 19:00:00,41,315,-274
3757,3757,35,2022/4/15 19:10:00,33,109,-76
3758,3758,35,2022/4/15 19:20:00,36,111,-75
3759,3759,35,2022/4/15 19:30:00,23,179,-156
3760,3760,35,2022/4/15 19:40:00,37,216,-179
3761,3761,35,2022/4/15 19:50:00,29,99,-70
3762,3762,35,2022/4/15 20:00:00,29,103,-74
3763,3763,35,2022/4/15 20:10:00,33,115,-82
3764,3764,35,2022/4/15 20:20:00,28,66,-38
3765,3765,35,2022/4/15 20:30:00,28,116,-88
3766,3766,35,2022/4/15 20:40:00,28,116,-88
3767,3767,35,2022/4/15 20:50:00,30,108,-78
3768,3768,35,2022/4/15 21:00:00,26,105,-79
3769,3769,35,2022/4/15 21:10:00,32,22,10
3770,3770,35,2022/4/15 21:20:00,27,112,-85
3771,3771,35,2022/4/15 21:30:00,21,106,-85
3772,3772,35,2022/4/15 21:40:00,13,100,-87
3773,3773,35,2022/4/15 21:50:00,0,3,-3
3774,3774,35,2022/4/15 22:00:00,0,102,-102
3775,3775,35,2022/4/15 22:10:00,0,107,-107
3776,3776,35,2022/4/15 22:20:00,0,3,-3
3777,3777,35,2022/4/15 22:30:00,0,104,-104
3778,3778,35,2022/4/15 22:40:00,0,92,-92
3779,3779,35,2022/4/15 22:50:00,0,3,-3
3780,3780,36,2022/4/15 5:00:00,0,1,-1
3781,3781,36,2022/4/15 5:10:00,1,1,0
3782,3782,36,2022/4/15 5:20:00,11,1,10
3783,3783,36,2022/4/15 5:30:00,25,1,24
3784,3784,36,2022/4/15 5:40:00,28,1,27
3785,3785,36,2022/4/15 5:50:00,30,1,29
3786,3786,36,2022/4/15 6:00:00,36,1,35
3787,3787,36,2022/4/15 6:10:00,49,1,48
3788,3788,36,2022/4/15 6:20:00,58,1,57
3789,3789,36,2022/4/15 6:30:00,73,1,72
3790,3790,36,2022/4/15 6:40:00,67,73,-6
3791,3791,36,2022/4/15 6:50:00,87,21,66
3792,3792,36,2022/4/15 7:00:00,206,63,143
3793,3793,36,2022/4/15 7:10:00,217,110,107
3794,3794,36,2022/4/15 7:20:00,282,102,180
3795,3795,36,2022/4/15 7:30:00,254,104,150
3796,3796,36,2022/4/15 7:40:00,316,109,207
3797,3797,36,2022/4/15 7:50:00,227,119,108
3798,3798,36,2022/4/15 8:00:00,229,112,117
3799,3799,36,2022/4/15 8:10:00,198,111,87
3800,3800,36,2022/4/15 8:20:00,186,171,15
3801,3801,36,2022/4/15 8:30:00,85,120,-35
3802,3802,36,2022/4/15 8:40:00,71,104,-33
3803,3803,36,2022/4/15 8:50:00,55,90,-35
3804,3804,36,2022/4/15 9:00:00,44,123,-79
3805,3805,36,2022/4/15 9:10:00,34,104,-70
3806,3806,36,2022/4/15 9:20:00,28,82,-54
3807,3807,36,2022/4/15 9:30:00,26,90,-64
3808,3808,36,2022/4/15 9:40:00,27,108,-81
3809,3809,36,2022/4/15 9:50:00,31,84,-53
3810,3810,36,2022/4/15 10:00:00,27,72,-45
3811,3811,36,2022/4/15 10:10:00,25,57,-32
3812,3812,36,2022/4/15 10:20:00,28,67,-39
3813,3813,36,2022/4/15 10:30:00,25,84,-59
3814,3814,36,2022/4/15 10:40:00,26,73,-47
3815,3815,36,2022/4/15 10:50:00,23,12,11
3816,3816,36,2022/4/15 11:00:00,28,83,-55
3817,3817,36,2022/4/15 11:10:00,25,62,-37
3818,3818,36,2022/4/15 11:20:00,25,74,-49
3819,3819,36,2022/4/15 11:30:00,25,65,-40
3820,3820,36,2022/4/15 11:40:00,28,69,-41
3821,3821,36,2022/4/15 11:50:00,25,16,9
3822,3822,36,2022/4/15 12:00:00,27,70,-43
3823,3823,36,2022/4/15 12:10:00,34,71,-37
3824,3824,36,2022/4/15 12:20:00,28,77,-49
3825,3825,36,2022/4/15 12:30:00,24,64,-40
3826,3826,36,2022/4/15 12:40:00,29,21,8
3827,3827,36,2022/4/15 12:50:00,38,61,-23
3828,3828,36,2022/4/15 13:00:00,33,85,-52
3829,3829,36,2022/4/15 13:10:00,30,69,-39
3830,3830,36,2022/4/15 13:20:00,25,85,-60
3831,3831,36,2022/4/15 13:30:00,26,71,-45
3832,3832,36,2022/4/15 13:40:00,22,23,-1
3833,3833,36,2022/4/15 13:50:00,25,66,-41
3834,3834,36,2022/4/15 14:00:00,25,83,-58
3835,3835,36,2022/4/15 14:10:00,24,63,-39
3836,3836,36,2022/4/15 14:20:00,23,63,-40
3837,3837,36,2022/4/15 14:30:00,24,65,-41
3838,3838,36,2022/4/15 14:40:00,30,19,11
3839,3839,36,2022/4/15 14:50:00,21,71,-50
3840,3840,36,2022/4/15 15:00:00,26,72,-46
3841,3841,36,2022/4/15 15:10:00,29,76,-47
3842,3842,36,2022/4/15 15:20:00,31,83,-52
3843,3843,36,2022/4/15 15:30:00,28,77,-49
3844,3844,36,2022/4/15 15:40:00,30,19,11
3845,3845,36,2022/4/15 15:50:00,28,82,-54
3846,3846,36,2022/4/15 16:00:00,29,76,-47
3847,3847,36,2022/4/15 16:10:00,26,94,-68
3848,3848,36,2022/4/15 16:20:00,37,98,-61
3849,3849,36,2022/4/15 16:30:00,30,80,-50
3850,3850,36,2022/4/15 16:40:00,41,28,13
3851,3851,36,2022/4/15 16:50:00,46,89,-43
3852,3852,36,2022/4/15 17:00:00,42,102,-60
3853,3853,36,2022/4/15 17:10:00,44,106,-62
3854,3854,36,2022/4/15 17:20:00,48,109,-61
3855,3855,36,2022/4/15 17:30:00,73,122,-49
3856,3856,36,2022/4/15 17:40:00,47,125,-78
3857,3857,36,2022/4/15 17:50:00,41,105,-64
3858,3858,36,2022/4/15 18:00:00,45,169,-124
3859,3859,36,2022/4/15 18:10:00,35,107,-72
3860,3860,36,2022/4/15 18:20:00,45,107,-62
3861,3861,36,2022/4/15 18:30:00,41,123,-82
3862,3862,36,2022/4/15 18:40:00,42,200,-158
3863,3863,36,2022/4/15 18:50:00,36,180,-144
3864,3864,36,2022/4/15 19:00:00,25,119,-94
3865,3865,36,2022/4/15 19:10:00,25,124,-99
3866,3866,36,2022/4/15 19:20:00,24,233,-209
3867,3867,36,2022/4/15 19:30:00,21,103,-82
3868,3868,36,2022/4/15 19:40:00,18,90,-72
3869,3869,36,2022/4/15 19:50:00,18,105,-87
3870,3870,36,2022/4/15 20:00:00,18,104,-86
3871,3871,36,2022/4/15 20:10:00,22,104,-82
3872,3872,36,2022/4/15 20:20:00,16,78,-62
3873,3873,36,2022/4/15 20:30:00,18,97,-79
3874,3874,36,2022/4/15 20:40:00,21,95,-74
3875,3875,36,2022/4/15 20:50:00,14,107,-93
3876,3876,36,2022/4/15 21:00:00,17,100,-83
3877,3877,36,2022/4/15 21:10:00,14,100,-86
3878,3878,36,2022/4/15 21:20:00,17,3,14
3879,3879,36,2022/4/15 21:30:00,13,102,-89
3880,3880,36,2022/4/15 21:40:00,10,103,-93
3881,3881,36,2022/4/15 21:50:00,1,62,-61
3882,3882,36,2022/4/15 22:00:00,0,72,-72
3883,3883,36,2022/4/15 22:10:00,0,98,-98
3884,3884,36,2022/4/15 22:20:00,0,99,-99
3885,3885,36,2022/4/15 22:30:00,0,10,-10
3886,3886,36,2022/4/15 22:40:00,0,80,-80
3887,3887,36,2022/4/15 22:50:00,0,67,-67
3888,3888,37,2022/4/15 5:00:00,0,1,-1
3889,3889,37,2022/4/15 5:10:00,0,1,-1
3890,3890,37,2022/4/15 5:20:00,5,1,4
3891,3891,37,2022/4/15 5:30:00,14,1,13
3892,3892,37,2022/4/15 5:40:00,23,1,22
3893,3893,37,2022/4/15 5:50:00,25,6,19
3894,3894,37,2022/4/15 6:00:00,32,6,26
3895,3895,37,2022/4/15 6:10:00,46,14,32
3896,3896,37,2022/4/15 6:20:00,58,16,42
3897,3897,37,2022/4/15 6:30:00,63,43,20
3898,3898,37,2022/4/15 6:40:00,68,61,7
3899,3899,37,2022/4/15 6:50:00,124,67,57
3900,3900,37,2022/4/15 7:00:00,245,91,154
3901,3901,37,2022/4/15 7:10:00,281,102,179
3902,3902,37,2022/4/15 7:20:00,349,102,247
3903,3903,37,2022/4/15 7:30:00,339,109,230
3904,3904,37,2022/4/15 7:40:00,474,109,365
3905,3905,37,2022/4/15 7:50:00,572,192,380
3906,3906,37,2022/4/15 8:00:00,322,110,212
3907,3907,37,2022/4/15 8:10:00,323,192,131
3908,3908,37,2022/4/15 8:20:00,277,120,157
3909,3909,37,2022/4/15 8:30:00,250,119,131
3910,3910,37,2022/4/15 8:40:00,157,115,42
3911,3911,37,2022/4/15 8:50:00,156,109,47
3912,3912,37,2022/4/15 9:00:00,72,93,-21
3913,3913,37,2022/4/15 9:10:00,47,93,-46
3914,3914,37,2022/4/15 9:20:00,51,97,-46
3915,3915,37,2022/4/15 9:30:00,38,79,-41
3916,3916,37,2022/4/15 9:40:00,42,74,-32
3917,3917,37,2022/4/15 9:50:00,27,75,-48
3918,3918,37,2022/4/15 10:00:00,38,62,-24
3919,3919,37,2022/4/15 10:10:00,31,69,-38
3920,3920,37,2022/4/15 10:20:00,27,86,-59
3921,3921,37,2022/4/15 10:30:00,34,59,-25
3922,3922,37,2022/4/15 10:40:00,35,73,-38
3923,3923,37,2022/4/15 10:50:00,30,73,-43
3924,3924,37,2022/4/15 11:00:00,35,61,-26
3925,3925,37,2022/4/15 11:10:00,30,70,-40
3926,3926,37,2022/4/15 11:20:00,30,67,-37
3927,3927,37,2022/4/15 11:30:00,30,61,-31
3928,3928,37,2022/4/15 11:40:00,33,72,-39
3929,3929,37,2022/4/15 11:50:00,36,61,-25
3930,3930,37,2022/4/15 12:00:00,31,59,-28
3931,3931,37,2022/4/15 12:10:00,29,68,-39
3932,3932,37,2022/4/15 12:20:00,35,61,-26
3933,3933,37,2022/4/15 12:30:00,34,74,-40
3934,3934,37,2022/4/15 12:40:00,32,82,-50
3935,3935,37,2022/4/15 12:50:00,33,68,-35
3936,3936,37,2022/4/15 13:00:00,33,69,-36
3937,3937,37,2022/4/15 13:10:00,31,79,-48
3938,3938,37,2022/4/15 13:20:00,31,70,-39
3939,3939,37,2022/4/15 13:30:00,28,74,-46
3940,3940,37,2022/4/15 13:40:00,28,77,-49
3941,3941,37,2022/4/15 13:50:00,31,69,-38
3942,3942,37,2022/4/15 14:00:00,26,75,-49
3943,3943,37,2022/4/15 14:10:00,33,83,-50
3944,3944,37,2022/4/15 14:20:00,36,63,-27
3945,3945,37,2022/4/15 14:30:00,31,83,-52
3946,3946,37,2022/4/15 14:40:00,27,68,-41
3947,3947,37,2022/4/15 14:50:00,28,61,-33
3948,3948,37,2022/4/15 15:00:00,29,76,-47
3949,3949,37,2022/4/15 15:10:00,23,73,-50
3950,3950,37,2022/4/15 15:20:00,25,72,-47
3951,3951,37,2022/4/15 15:30:00,29,75,-46
3952,3952,37,2022/4/15 15:40:00,27,76,-49
3953,3953,37,2022/4/15 15:50:00,30,63,-33
3954,3954,37,2022/4/15 16:00:00,24,79,-55
3955,3955,37,2022/4/15 16:10:00,41,91,-50
3956,3956,37,2022/4/15 16:20:00,34,82,-48
3957,3957,37,2022/4/15 16:30:00,42,98,-56
3958,3958,37,2022/4/15 16:40:00,75,98,-23
3959,3959,37,2022/4/15 16:50:00,67,93,-26
3960,3960,37,2022/4/15 17:00:00,75,109,-34
3961,3961,37,2022/4/15 17:10:00,174,106,68
3962,3962,37,2022/4/15 17:20:00,217,106,111
3963,3963,37,2022/4/15 17:30:00,134,110,24
3964,3964,37,2022/4/15 17:40:00,69,118,-49
3965,3965,37,2022/4/15 17:50:00,136,115,21
3966,3966,37,2022/4/15 18:00:00,65,107,-42
3967,3967,37,2022/4/15 18:10:00,42,158,-116
3968,3968,37,2022/4/15 18:20:00,42,128,-86
3969,3969,37,2022/4/15 18:30:00,38,226,-188
3970,3970,37,2022/4/15 18:40:00,28,181,-153
3971,3971,37,2022/4/15 18:50:00,32,234,-202
3972,3972,37,2022/4/15 19:00:00,25,143,-118
3973,3973,37,2022/4/15 19:10:00,27,198,-171
3974,3974,37,2022/4/15 19:20:00,25,134,-109
3975,3975,37,2022/4/15 19:30:00,24,152,-128
3976,3976,37,2022/4/15 19:40:00,25,103,-78
3977,3977,37,2022/4/15 19:50:00,23,110,-87
3978,3978,37,2022/4/15 20:00:00,27,114,-87
3979,3979,37,2022/4/15 20:10:00,20,109,-89
3980,3980,37,2022/4/15 20:20:00,17,106,-89
3981,3981,37,2022/4/15 20:30:00,19,77,-58
3982,3982,37,2022/4/15 20:40:00,17,114,-97
3983,3983,37,2022/4/15 20:50:00,16,105,-89
3984,3984,37,2022/4/15 21:00:00,17,94,-77
3985,3985,37,2022/4/15 21:10:00,17,107,-90
3986,3986,37,2022/4/15 21:20:00,14,84,-70
3987,3987,37,2022/4/15 21:30:00,12,110,-98
3988,3988,37,2022/4/15 21:40:00,9,79,-70
3989,3989,37,2022/4/15 21:50:00,9,75,-66
3990,3990,37,2022/4/15 22:00:00,3,99,-96
3991,3991,37,2022/4/15 22:10:00,2,73,-71
3992,3992,37,2022/4/15 22:20:00,2,70,-68
3993,3993,37,2022/4/15 22:30:00,2,83,-81
3994,3994,37,2022/4/15 22:40:00,2,63,-61
3995,3995,37,2022/4/15 22:50:00,1,65,-64
3996,3996,38,2022/4/15 5:00:00,0,1,-1
3997,3997,38,2022/4/15 5:10:00,0,1,-1
3998,3998,38,2022/4/15 5:20:00,3,1,2
3999,3999,38,2022/4/15 5:30:00,6,1,5
4000,4000,38,2022/4/15 5:40:00,18,1,17
4001,4001,38,2022/4/15 5:50:00,20,1,19
4002,4002,38,2022/4/15 6:00:00,20,19,1
4003,4003,38,2022/4/15 6:10:00,30,21,9
4004,4004,38,2022/4/15 6:20:00,31,57,-26
4005,4005,38,2022/4/15 6:30:00,42,65,-23
4006,4006,38,2022/4/15 6:40:00,54,74,-20
4007,4007,38,2022/4/15 6:50:00,65,114,-49
4008,4008,38,2022/4/15 7:00:00,75,120,-45
4009,4009,38,2022/4/15 7:10:00,124,226,-102
4010,4010,38,2022/4/15 7:20:00,104,180,-76
4011,4011,38,2022/4/15 7:30:00,157,144,13
4012,4012,38,2022/4/15 7:40:00,197,192,5
4013,4013,38,2022/4/15 7:50:00,239,299,-60
4014,4014,38,2022/4/15 8:00:00,279,509,-230
4015,4015,38,2022/4/15 8:10:00,279,575,-296
4016,4016,38,2022/4/15 8:20:00,251,586,-335
4017,4017,38,2022/4/15 8:30:00,247,1505,-1258
4018,4018,38,2022/4/15 8:40:00,207,1873,-1666
4019,4019,38,2022/4/15 8:50:00,192,1120,-928
4020,4020,38,2022/4/15 9:00:00,139,584,-445
4021,4021,38,2022/4/15 9:10:00,84,426,-342
4022,4022,38,2022/4/15 9:20:00,77,343,-266
4023,4023,38,2022/4/15 9:30:00,64,196,-132
4024,4024,38,2022/4/15 9:40:00,62,212,-150
4025,4025,38,2022/4/15 9:50:00,48,167,-119
4026,4026,38,2022/4/15 10:00:00,43,117,-74
4027,4027,38,2022/4/15 10:10:00,43,126,-83
4028,4028,38,2022/4/15 10:20:00,43,112,-69
4029,4029,38,2022/4/15 10:30:00,42,111,-69
4030,4030,38,2022/4/15 10:40:00,39,110,-71
4031,4031,38,2022/4/15 10:50:00,37,93,-56
4032,4032,38,2022/4/15 11:00:00,37,78,-41
4033,4033,38,2022/4/15 11:10:00,43,93,-50
4034,4034,38,2022/4/15 11:20:00,37,90,-53
4035,4035,38,2022/4/15 11:30:00,41,81,-40
4036,4036,38,2022/4/15 11:40:00,44,93,-49
4037,4037,38,2022/4/15 11:50:00,41,81,-40
4038,4038,38,2022/4/15 12:00:00,41,90,-49
4039,4039,38,2022/4/15 12:10:00,44,100,-56
4040,4040,38,2022/4/15 12:20:00,42,93,-51
4041,4041,38,2022/4/15 12:30:00,44,105,-61
4042,4042,38,2022/4/15 12:40:00,44,112,-68
4043,4043,38,2022/4/15 12:50:00,43,106,-63
4044,4044,38,2022/4/15 13:00:00,38,110,-72
4045,4045,38,2022/4/15 13:10:00,46,112,-66
4046,4046,38,2022/4/15 13:20:00,41,101,-60
4047,4047,38,2022/4/15 13:30:00,35,101,-66
4048,4048,38,2022/4/15 13:40:00,36,105,-69
4049,4049,38,2022/4/15 13:50:00,39,99,-60
4050,4050,38,2022/4/15 14:00:00,41,102,-61
4051,4051,38,2022/4/15 14:10:00,42,96,-54
4052,4052,38,2022/4/15 14:20:00,41,91,-50
4053,4053,38,2022/4/15 14:30:00,43,90,-47
4054,4054,38,2022/4/15 14:40:00,43,97,-54
4055,4055,38,2022/4/15 14:50:00,47,97,-50
4056,4056,38,2022/4/15 15:00:00,55,98,-43
4057,4057,38,2022/4/15 15:10:00,63,105,-42
4058,4058,38,2022/4/15 15:20:00,65,80,-15
4059,4059,38,2022/4/15 15:30:00,65,103,-38
4060,4060,38,2022/4/15 15:40:00,54,104,-50
4061,4061,38,2022/4/15 15:50:00,79,92,-13
4062,4062,38,2022/4/15 16:00:00,133,102,31
4063,4063,38,2022/4/15 16:10:00,139,108,31
4064,4064,38,2022/4/15 16:20:00,134,96,38
4065,4065,38,2022/4/15 16:30:00,150,103,47
4066,4066,38,2022/4/15 16:40:00,217,87,130
4067,4067,38,2022/4/15 16:50:00,214,110,104
4068,4068,38,2022/4/15 17:00:00,270,121,149
4069,4069,38,2022/4/15 17:10:00,429,122,307
4070,4070,38,2022/4/15 17:20:00,352,120,232
4071,4071,38,2022/4/15 17:30:00,307,108,199
4072,4072,38,2022/4/15 17:40:00,578,181,397
4073,4073,38,2022/4/15 17:50:00,567,127,440
4074,4074,38,2022/4/15 18:00:00,461,226,235
4075,4075,38,2022/4/15 18:10:00,830,155,675
4076,4076,38,2022/4/15 18:20:00,673,226,447
4077,4077,38,2022/4/15 18:30:00,462,146,316
4078,4078,38,2022/4/15 18:40:00,344,178,166
4079,4079,38,2022/4/15 18:50:00,250,117,133
4080,4080,38,2022/4/15 19:00:00,179,117,62
4081,4081,38,2022/4/15 19:10:00,169,126,43
4082,4082,38,2022/4/15 19:20:00,134,121,13
4083,4083,38,2022/4/15 19:30:00,67,105,-38
4084,4084,38,2022/4/15 19:40:00,70,113,-43
4085,4085,38,2022/4/15 19:50:00,53,80,-27
4086,4086,38,2022/4/15 20:00:00,52,95,-43
4087,4087,38,2022/4/15 20:10:00,62,92,-30
4088,4088,38,2022/4/15 20:20:00,48,79,-31
4089,4089,38,2022/4/15 20:30:00,49,89,-40
4090,4090,38,2022/4/15 20:40:00,47,76,-29
4091,4091,38,2022/4/15 20:50:00,43,92,-49
4092,4092,38,2022/4/15 21:00:00,43,85,-42
4093,4093,38,2022/4/15 21:10:00,63,95,-32
4094,4094,38,2022/4/15 21:20:00,43,79,-36
4095,4095,38,2022/4/15 21:30:00,44,77,-33
4096,4096,38,2022/4/15 21:40:00,37,95,-58
4097,4097,38,2022/4/15 21:50:00,29,82,-53
4098,4098,38,2022/4/15 22:00:00,31,86,-55
4099,4099,38,2022/4/15 22:10:00,29,94,-65
4100,4100,38,2022/4/15 22:20:00,29,77,-48
4101,4101,38,2022/4/15 22:30:00,22,85,-63
4102,4102,38,2022/4/15 22:40:00,13,62,-49
4103,4103,38,2022/4/15 22:50:00,9,52,-43
4104,4104,39,2022/4/15 5:00:00,0,1,-1
4105,4105,39,2022/4/15 5:10:00,0,1,-1
4106,4106,39,2022/4/15 5:20:00,0,1,-1
4107,4107,39,2022/4/15 5:30:00,0,1,-1
4108,4108,39,2022/4/15 5:40:00,5,1,4
4109,4109,39,2022/4/15 5:50:00,31,1,30
4110,4110,39,2022/4/15 6:00:00,47,17,30
4111,4111,39,2022/4/15 6:10:00,44,41,3
4112,4112,39,2022/4/15 6:20:00,72,51,21
4113,4113,39,2022/4/15 6:30:00,149,55,94
4114,4114,39,2022/4/15 6:40:00,212,64,148
4115,4115,39,2022/4/15 6:50:00,245,74,171
4116,4116,39,2022/4/15 7:00:00,278,66,212
4117,4117,39,2022/4/15 7:10:00,338,95,243
4118,4118,39,2022/4/15 7:20:00,469,110,359
4119,4119,39,2022/4/15 7:30:00,699,114,585
4120,4120,39,2022/4/15 7:40:00,829,109,720
4121,4121,39,2022/4/15 7:50:00,1062,121,941
4122,4122,39,2022/4/15 8:00:00,1061,112,949
4123,4123,39,2022/4/15 8:10:00,870,298,572
4124,4124,39,2022/4/15 8:20:00,682,159,523
4125,4125,39,2022/4/15 8:30:00,722,183,539
4126,4126,39,2022/4/15 8:40:00,595,192,403
4127,4127,39,2022/4/15 8:50:00,324,159,165
4128,4128,39,2022/4/15 9:00:00,312,123,189
4129,4129,39,2022/4/15 9:10:00,281,106,175
4130,4130,39,2022/4/15 9:20:00,207,108,99
4131,4131,39,2022/4/15 9:30:00,149,104,45
4132,4132,39,2022/4/15 9:40:00,86,103,-17
4133,4133,39,2022/4/15 9:50:00,70,101,-31
4134,4134,39,2022/4/15 10:00:00,64,97,-33
4135,4135,39,2022/4/15 10:10:00,52,69,-17
4136,4136,39,2022/4/15 10:20:00,47,87,-40
4137,4137,39,2022/4/15 10:30:00,45,77,-32
4138,4138,39,2022/4/15 10:40:00,46,94,-48
4139,4139,39,2022/4/15 10:50:00,42,92,-50
4140,4140,39,2022/4/15 11:00:00,46,88,-42
4141,4141,39,2022/4/15 11:10:00,41,65,-24
4142,4142,39,2022/4/15 11:20:00,43,76,-33
4143,4143,39,2022/4/15 11:30:00,40,91,-51
4144,4144,39,2022/4/15 11:40:00,44,75,-31
4145,4145,39,2022/4/15 11:50:00,38,104,-66
4146,4146,39,2022/4/15 12:00:00,48,97,-49
4147,4147,39,2022/4/15 12:10:00,45,75,-30
4148,4148,39,2022/4/15 12:20:00,46,97,-51
4149,4149,39,2022/4/15 12:30:00,44,92,-48
4150,4150,39,2022/4/15 12:40:00,43,92,-49
4151,4151,39,2022/4/15 12:50:00,44,93,-49
4152,4152,39,2022/4/15 13:00:00,45,108,-63
4153,4153,39,2022/4/15 13:10:00,48,76,-28
4154,4154,39,2022/4/15 13:20:00,41,92,-51
4155,4155,39,2022/4/15 13:30:00,45,96,-51
4156,4156,39,2022/4/15 13:40:00,40,77,-37
4157,4157,39,2022/4/15 13:50:00,40,93,-53
4158,4158,39,2022/4/15 14:00:00,41,94,-53
4159,4159,39,2022/4/15 14:10:00,45,80,-35
4160,4160,39,2022/4/15 14:20:00,41,99,-58
4161,4161,39,2022/4/15 14:30:00,36,101,-65
4162,4162,39,2022/4/15 14:40:00,37,105,-68
4163,4163,39,2022/4/15 14:50:00,39,83,-44
4164,4164,39,2022/4/15 15:00:00,43,96,-53
4165,4165,39,2022/4/15 15:10:00,39,93,-54
4166,4166,39,2022/4/15 15:20:00,41,112,-71
4167,4167,39,2022/4/15 15:30:00,44,106,-62
4168,4168,39,2022/4/15 15:40:00,44,97,-53
4169,4169,39,2022/4/15 15:50:00,44,107,-63
4170,4170,39,2022/4/15 16:00:00,43,102,-59
4171,4171,39,2022/4/15 16:10:00,50,105,-55
4172,4172,39,2022/4/15 16:20:00,56,121,-65
4173,4173,39,2022/4/15 16:30:00,71,125,-54
4174,4174,39,2022/4/15 16:40:00,71,107,-36
4175,4175,39,2022/4/15 16:50:00,77,111,-34
4176,4176,39,2022/4/15 17:00:00,210,114,96
4177,4177,39,2022/4/15 17:10:00,222,178,44
4178,4178,39,2022/4/15 17:20:00,164,118,46
4179,4179,39,2022/4/15 17:30:00,191,218,-27
4180,4180,39,2022/4/15 17:40:00,258,206,52
4181,4181,39,2022/4/15 17:50:00,224,344,-120
4182,4182,39,2022/4/15 18:00:00,199,254,-55
4183,4183,39,2022/4/15 18:10:00,187,432,-245
4184,4184,39,2022/4/15 18:20:00,132,298,-166
4185,4185,39,2022/4/15 18:30:00,87,535,-448
4186,4186,39,2022/4/15 18:40:00,76,300,-224
4187,4187,39,2022/4/15 18:50:00,61,510,-449
4188,4188,39,2022/4/15 19:00:00,44,219,-175
4189,4189,39,2022/4/15 19:10:00,44,341,-297
4190,4190,39,2022/4/15 19:20:00,39,158,-119
4191,4191,39,2022/4/15 19:30:00,36,225,-189
4192,4192,39,2022/4/15 19:40:00,28,111,-83
4193,4193,39,2022/4/15 19:50:00,31,120,-89
4194,4194,39,2022/4/15 20:00:00,31,116,-85
4195,4195,39,2022/4/15 20:10:00,35,104,-69
4196,4196,39,2022/4/15 20:20:00,32,111,-79
4197,4197,39,2022/4/15 20:30:00,29,107,-78
4198,4198,39,2022/4/15 20:40:00,30,104,-74
4199,4199,39,2022/4/15 20:50:00,24,133,-109
4200,4200,39,2022/4/15 21:00:00,25,107,-82
4201,4201,39,2022/4/15 21:10:00,27,116,-89
4202,4202,39,2022/4/15 21:20:00,29,106,-77
4203,4203,39,2022/4/15 21:30:00,27,112,-85
4204,4204,39,2022/4/15 21:40:00,25,109,-84
4205,4205,39,2022/4/15 21:50:00,20,111,-91
4206,4206,39,2022/4/15 22:00:00,20,111,-91
4207,4207,39,2022/4/15 22:10:00,14,106,-92
4208,4208,39,2022/4/15 22:20:00,9,95,-86
4209,4209,39,2022/4/15 22:30:00,7,105,-98
4210,4210,39,2022/4/15 22:40:00,5,95,-90
4211,4211,39,2022/4/15 22:50:00,5,63,-58
4212,4212,40,2022/4/15 5:00:00,0,1,-1
4213,4213,40,2022/4/15 5:10:00,0,1,-1
4214,4214,40,2022/4/15 5:20:00,0,1,-1
4215,4215,40,2022/4/15 5:30:00,2,1,1
4216,4216,40,2022/4/15 5:40:00,5,1,4
4217,4217,40,2022/4/15 5:50:00,8,7,1
4218,4218,40,2022/4/15 6:00:00,11,6,5
4219,4219,40,2022/4/15 6:10:00,16,6,10
4220,4220,40,2022/4/15 6:20:00,25,18,7
4221,4221,40,2022/4/15 6:30:00,29,56,-27
4222,4222,40,2022/4/15 6:40:00,30,54,-24
4223,4223,40,2022/4/15 6:50:00,35,49,-14
4224,4224,40,2022/4/15 7:00:00,42,89,-47
4225,4225,40,2022/4/15 7:10:00,51,88,-37
4226,4226,40,2022/4/15 7:20:00,58,118,-60
4227,4227,40,2022/4/15 7:30:00,86,108,-22
4228,4228,40,2022/4/15 7:40:00,126,111,15
4229,4229,40,2022/4/15 7:50:00,168,123,45
4230,4230,40,2022/4/15 8:00:00,149,134,15
4231,4231,40,2022/4/15 8:10:00,122,121,1
4232,4232,40,2022/4/15 8:20:00,146,104,42
4233,4233,40,2022/4/15 8:30:00,77,109,-32
4234,4234,40,2022/4/15 8:40:00,59,143,-84
4235,4235,40,2022/4/15 8:50:00,49,107,-58
4236,4236,40,2022/4/15 9:00:00,36,99,-63
4237,4237,40,2022/4/15 9:10:00,39,84,-45
4238,4238,40,2022/4/15 9:20:00,33,99,-66
4239,4239,40,2022/4/15 9:30:00,27,73,-46
4240,4240,40,2022/4/15 9:40:00,25,79,-54
4241,4241,40,2022/4/15 9:50:00,24,74,-50
4242,4242,40,2022/4/15 10:00:00,25,84,-59
4243,4243,40,2022/4/15 10:10:00,23,59,-36
4244,4244,40,2022/4/15 10:20:00,23,59,-36
4245,4245,40,2022/4/15 10:30:00,24,71,-47
4246,4246,40,2022/4/15 10:40:00,24,60,-36
4247,4247,40,2022/4/15 10:50:00,23,63,-40
4248,4248,40,2022/4/15 11:00:00,24,51,-27
4249,4249,40,2022/4/15 11:10:00,26,51,-25
4250,4250,40,2022/4/15 11:20:00,23,57,-34
4251,4251,40,2022/4/15 11:30:00,20,60,-40
4252,4252,40,2022/4/15 11:40:00,21,52,-31
4253,4253,40,2022/4/15 11:50:00,25,60,-35
4254,4254,40,2022/4/15 12:00:00,27,61,-34
4255,4255,40,2022/4/15 12:10:00,20,50,-30
4256,4256,40,2022/4/15 12:20:00,23,64,-41
4257,4257,40,2022/4/15 12:30:00,26,61,-35
4258,4258,40,2022/4/15 12:40:00,22,62,-40
4259,4259,40,2022/4/15 12:50:00,22,62,-40
4260,4260,40,2022/4/15 13:00:00,22,56,-34
4261,4261,40,2022/4/15 13:10:00,21,56,-35
4262,4262,40,2022/4/15 13:20:00,24,53,-29
4263,4263,40,2022/4/15 13:30:00,25,63,-38
4264,4264,40,2022/4/15 13:40:00,24,50,-26
4265,4265,40,2022/4/15 13:50:00,26,57,-31
4266,4266,40,2022/4/15 14:00:00,25,51,-26
4267,4267,40,2022/4/15 14:10:00,24,50,-26
4268,4268,40,2022/4/15 14:20:00,22,54,-32
4269,4269,40,2022/4/15 14:30:00,25,61,-36
4270,4270,40,2022/4/15 14:40:00,61,50,11
4271,4271,40,2022/4/15 14:50:00,37,60,-23
4272,4272,40,2022/4/15 15:00:00,32,62,-30
4273,4273,40,2022/4/15 15:10:00,29,64,-35
4274,4274,40,2022/4/15 15:20:00,27,68,-41
4275,4275,40,2022/4/15 15:30:00,27,59,-32
4276,4276,40,2022/4/15 15:40:00,43,57,-14
4277,4277,40,2022/4/15 15:50:00,30,66,-36
4278,4278,40,2022/4/15 16:00:00,28,59,-31
4279,4279,40,2022/4/15 16:10:00,34,72,-38
4280,4280,40,2022/4/15 16:20:00,39,61,-22
4281,4281,40,2022/4/15 16:30:00,38,62,-24
4282,4282,40,2022/4/15 16:40:00,36,84,-48
4283,4283,40,2022/4/15 16:50:00,30,71,-41
4284,4284,40,2022/4/15 17:00:00,44,93,-49
4285,4285,40,2022/4/15 17:10:00,45,69,-24
4286,4286,40,2022/4/15 17:20:00,39,111,-72
4287,4287,40,2022/4/15 17:30:00,27,97,-70
4288,4288,40,2022/4/15 17:40:00,35,126,-91
4289,4289,40,2022/4/15 17:50:00,30,97,-67
4290,4290,40,2022/4/15 18:00:00,37,102,-65
4291,4291,40,2022/4/15 18:10:00,60,114,-54
4292,4292,40,2022/4/15 18:20:00,46,107,-61
4293,4293,40,2022/4/15 18:30:00,37,107,-70
4294,4294,40,2022/4/15 18:40:00,29,108,-79
4295,4295,40,2022/4/15 18:50:00,24,106,-82
4296,4296,40,2022/4/15 19:00:00,28,112,-84
4297,4297,40,2022/4/15 19:10:00,27,75,-48
4298,4298,40,2022/4/15 19:20:00,22,95,-73
4299,4299,40,2022/4/15 19:30:00,22,75,-53
4300,4300,40,2022/4/15 19:40:00,18,76,-58
4301,4301,40,2022/4/15 19:50:00,17,60,-43
4302,4302,40,2022/4/15 20:00:00,17,73,-56
4303,4303,40,2022/4/15 20:10:00,20,59,-39
4304,4304,40,2022/4/15 20:20:00,17,67,-50
4305,4305,40,2022/4/15 20:30:00,14,60,-46
4306,4306,40,2022/4/15 20:40:00,16,67,-51
4307,4307,40,2022/4/15 20:50:00,13,63,-50
4308,4308,40,2022/4/15 21:00:00,12,75,-63
4309,4309,40,2022/4/15 21:10:00,15,52,-37
4310,4310,40,2022/4/15 21:20:00,12,69,-57
4311,4311,40,2022/4/15 21:30:00,11,68,-57
4312,4312,40,2022/4/15 21:40:00,9,62,-53
4313,4313,40,2022/4/15 21:50:00,10,71,-61
4314,4314,40,2022/4/15 22:00:00,7,47,-40
4315,4315,40,2022/4/15 22:10:00,12,64,-52
4316,4316,40,2022/4/15 22:20:00,6,66,-60
4317,4317,40,2022/4/15 22:30:00,2,42,-40
4318,4318,40,2022/4/15 22:40:00,2,49,-47
4319,4319,40,2022/4/15 22:50:00,0,8,-8
4320,4320,41,2022/4/15 5:00:00,0,1,-1
4321,4321,41,2022/4/15 5:10:00,0,1,-1
4322,4322,41,2022/4/15 5:20:00,0,1,-1
4323,4323,41,2022/4/15 5:30:00,1,1,0
4324,4324,41,2022/4/15 5:40:00,8,1,7
4325,4325,41,2022/4/15 5:50:00,7,2,5
4326,4326,41,2022/4/15 6:00:00,9,5,4
4327,4327,41,2022/4/15 6:10:00,13,5,8
4328,4328,41,2022/4/15 6:20:00,17,8,9
4329,4329,41,2022/4/15 6:30:00,26,22,4
4330,4330,41,2022/4/15 6:40:00,27,21,6
4331,4331,41,2022/4/15 6:50:00,33,30,3
4332,4332,41,2022/4/15 7:00:00,36,33,3
4333,4333,41,2022/4/15 7:10:00,34,35,-1
4334,4334,41,2022/4/15 7:20:00,54,46,8
4335,4335,41,2022/4/15 7:30:00,57,49,8
4336,4336,41,2022/4/15 7:40:00,98,67,31
4337,4337,41,2022/4/15 7:50:00,72,69,3
4338,4338,41,2022/4/15 8:00:00,149,93,56
4339,4339,41,2022/4/15 8:10:00,72,87,-15
4340,4340,41,2022/4/15 8:20:00,103,79,24
4341,4341,41,2022/4/15 8:30:00,54,62,-8
4342,4342,41,2022/4/15 8:40:00,57,68,-11
4343,4343,41,2022/4/15 8:50:00,35,55,-20
4344,4344,41,2022/4/15 9:00:00,36,45,-9
4345,4345,41,2022/4/15 9:10:00,26,37,-11
4346,4346,41,2022/4/15 9:20:00,26,42,-16
4347,4347,41,2022/4/15 9:30:00,20,32,-12
4348,4348,41,2022/4/15 9:40:00,14,25,-11
4349,4349,41,2022/4/15 9:50:00,16,23,-7
4350,4350,41,2022/4/15 10:00:00,14,30,-16
4351,4351,41,2022/4/15 10:10:00,12,29,-17
4352,4352,41,2022/4/15 10:20:00,13,21,-8
4353,4353,41,2022/4/15 10:30:00,12,23,-11
4354,4354,41,2022/4/15 10:40:00,11,19,-8
4355,4355,41,2022/4/15 10:50:00,11,21,-10
4356,4356,41,2022/4/15 11:00:00,10,21,-11
4357,4357,41,2022/4/15 11:10:00,11,19,-8
4358,4358,41,2022/4/15 11:20:00,12,21,-9
4359,4359,41,2022/4/15 11:30:00,10,21,-11
4360,4360,41,2022/4/15 11:40:00,11,19,-8
4361,4361,41,2022/4/15 11:50:00,8,21,-13
4362,4362,41,2022/4/15 12:00:00,12,31,-19
4363,4363,41,2022/4/15 12:10:00,13,21,-8
4364,4364,41,2022/4/15 12:20:00,12,23,-11
4365,4365,41,2022/4/15 12:30:00,12,28,-16
4366,4366,41,2022/4/15 12:40:00,15,21,-6
4367,4367,41,2022/4/15 12:50:00,13,25,-12
4368,4368,41,2022/4/15 13:00:00,11,25,-14
4369,4369,41,2022/4/15 13:10:00,12,23,-11
4370,4370,41,2022/4/15 13:20:00,12,31,-19
4371,4371,41,2022/4/15 13:30:00,10,29,-19
4372,4372,41,2022/4/15 13:40:00,9,21,-12
4373,4373,41,2022/4/15 13:50:00,9,23,-14
4374,4374,41,2022/4/15 14:00:00,9,32,-23
4375,4375,41,2022/4/15 14:10:00,11,25,-14
4376,4376,41,2022/4/15 14:20:00,13,31,-18
4377,4377,41,2022/4/15 14:30:00,12,32,-20
4378,4378,41,2022/4/15 14:40:00,9,23,-14
4379,4379,41,2022/4/15 14:50:00,9,25,-16
4380,4380,41,2022/4/15 15:00:00,10,35,-25
4381,4381,41,2022/4/15 15:10:00,12,25,-13
4382,4382,41,2022/4/15 15:20:00,10,32,-22
4383,4383,41,2022/4/15 15:30:00,13,40,-27
4384,4384,41,2022/4/15 15:40:00,12,32,-20
4385,4385,41,2022/4/15 15:50:00,14,38,-24
4386,4386,41,2022/4/15 16:00:00,14,46,-32
4387,4387,41,2022/4/15 16:10:00,17,37,-20
4388,4388,41,2022/4/15 16:20:00,17,44,-27
4389,4389,41,2022/4/15 16:30:00,24,45,-21
4390,4390,41,2022/4/15 16:40:00,25,52,-27
4391,4391,41,2022/4/15 16:50:00,23,46,-23
4392,4392,41,2022/4/15 17:00:00,29,61,-32
4393,4393,41,2022/4/15 17:10:00,26,57,-31
4394,4394,41,2022/4/15 17:20:00,29,75,-46
4395,4395,41,2022/4/15 17:30:00,25,70,-45
4396,4396,41,2022/4/15 17:40:00,29,93,-64
4397,4397,41,2022/4/15 17:50:00,28,76,-48
4398,4398,41,2022/4/15 18:00:00,24,97,-73
4399,4399,41,2022/4/15 18:10:00,26,77,-51
4400,4400,41,2022/4/15 18:20:00,25,106,-81
4401,4401,41,2022/4/15 18:30:00,17,77,-60
4402,4402,41,2022/4/15 18:40:00,16,107,-91
4403,4403,41,2022/4/15 18:50:00,14,85,-71
4404,4404,41,2022/4/15 19:00:00,14,76,-62
4405,4405,41,2022/4/15 19:10:00,12,71,-59
4406,4406,41,2022/4/15 19:20:00,10,61,-51
4407,4407,41,2022/4/15 19:30:00,7,57,-50
4408,4408,41,2022/4/15 19:40:00,8,54,-46
4409,4409,41,2022/4/15 19:50:00,7,46,-39
4410,4410,41,2022/4/15 20:00:00,5,55,-50
4411,4411,41,2022/4/15 20:10:00,5,33,-28
4412,4412,41,2022/4/15 20:20:00,6,47,-41
4413,4413,41,2022/4/15 20:30:00,6,39,-33
4414,4414,41,2022/4/15 20:40:00,8,52,-44
4415,4415,41,2022/4/15 20:50:00,6,36,-30
4416,4416,41,2022/4/15 21:00:00,7,47,-40
4417,4417,41,2022/4/15 21:10:00,6,37,-31
4418,4418,41,2022/4/15 21:20:00,4,34,-30
4419,4419,41,2022/4/15 21:30:00,8,47,-39
4420,4420,41,2022/4/15 21:40:00,6,40,-34
4421,4421,41,2022/4/15 21:50:00,2,36,-34
4422,4422,41,2022/4/15 22:00:00,2,40,-38
4423,4423,41,2022/4/15 22:10:00,1,32,-31
4424,4424,41,2022/4/15 22:20:00,2,35,-33
4425,4425,41,2022/4/15 22:30:00,1,41,-40
4426,4426,41,2022/4/15 22:40:00,0,32,-32
4427,4427,41,2022/4/15 22:50:00,0,8,-8
4428,4428,42,2022/4/15 5:00:00,0,1,-1
4429,4429,42,2022/4/15 5:10:00,0,1,-1
4430,4430,42,2022/4/15 5:20:00,0,1,-1
4431,4431,42,2022/4/15 5:30:00,0,1,-1
4432,4432,42,2022/4/15 5:40:00,3,1,2
4433,4433,42,2022/4/15 5:50:00,7,1,6
4434,4434,42,2022/4/15 6:00:00,20,2,18
4435,4435,42,2022/4/15 6:10:00,30,21,9
4436,4436,42,2022/4/15 6:20:00,32,38,-6
4437,4437,42,2022/4/15 6:30:00,38,23,15
4438,4438,42,2022/4/15 6:40:00,59,49,10
4439,4439,42,2022/4/15 6:50:00,78,72,6
4440,4440,42,2022/4/15 7:00:00,84,71,13
4441,4441,42,2022/4/15 7:10:00,177,74,103
4442,4442,42,2022/4/15 7:20:00,174,73,101
4443,4443,42,2022/4/15 7:30:00,234,109,125
4444,4444,42,2022/4/15 7:40:00,277,107,170
4445,4445,42,2022/4/15 7:50:00,275,109,166
4446,4446,42,2022/4/15 8:00:00,279,169,110
4447,4447,42,2022/4/15 8:10:00,318,178,140
4448,4448,42,2022/4/15 8:20:00,279,178,101
4449,4449,42,2022/4/15 8:30:00,282,332,-50
4450,4450,42,2022/4/15 8:40:00,238,434,-196
4451,4451,42,2022/4/15 8:50:00,195,436,-241
4452,4452,42,2022/4/15 9:00:00,143,213,-70
4453,4453,42,2022/4/15 9:10:00,135,320,-185
4454,4454,42,2022/4/15 9:20:00,79,208,-129
4455,4455,42,2022/4/15 9:30:00,66,110,-44
4456,4456,42,2022/4/15 9:40:00,48,109,-61
4457,4457,42,2022/4/15 9:50:00,40,103,-63
4458,4458,42,2022/4/15 10:00:00,38,109,-71
4459,4459,42,2022/4/15 10:10:00,39,80,-41
4460,4460,42,2022/4/15 10:20:00,31,99,-68
4461,4461,42,2022/4/15 10:30:00,32,88,-56
4462,4462,42,2022/4/15 10:40:00,27,69,-42
4463,4463,42,2022/4/15 10:50:00,29,75,-46
4464,4464,42,2022/4/15 11:00:00,33,83,-50
4465,4465,42,2022/4/15 11:10:00,32,65,-33
4466,4466,42,2022/4/15 11:20:00,30,75,-45
4467,4467,42,2022/4/15 11:30:00,30,62,-32
4468,4468,42,2022/4/15 11:40:00,28,78,-50
4469,4469,42,2022/4/15 11:50:00,29,64,-35
4470,4470,42,2022/4/15 12:00:00,32,64,-32
4471,4471,42,2022/4/15 12:10:00,31,74,-43
4472,4472,42,2022/4/15 12:20:00,28,82,-54
4473,4473,42,2022/4/15 12:30:00,35,81,-46
4474,4474,42,2022/4/15 12:40:00,30,70,-40
4475,4475,42,2022/4/15 12:50:00,32,87,-55
4476,4476,42,2022/4/15 13:00:00,32,77,-45
4477,4477,42,2022/4/15 13:10:00,31,70,-39
4478,4478,42,2022/4/15 13:20:00,30,80,-50
4479,4479,42,2022/4/15 13:30:00,32,70,-38
4480,4480,42,2022/4/15 13:40:00,34,72,-38
4481,4481,42,2022/4/15 13:50:00,31,74,-43
4482,4482,42,2022/4/15 14:00:00,32,69,-37
4483,4483,42,2022/4/15 14:10:00,26,75,-49
4484,4484,42,2022/4/15 14:20:00,33,84,-51
4485,4485,42,2022/4/15 14:30:00,32,77,-45
4486,4486,42,2022/4/15 14:40:00,33,66,-33
4487,4487,42,2022/4/15 14:50:00,28,76,-48
4488,4488,42,2022/4/15 15:00:00,30,82,-52
4489,4489,42,2022/4/15 15:10:00,30,75,-45
4490,4490,42,2022/4/15 15:20:00,29,91,-62
4491,4491,42,2022/4/15 15:30:00,34,91,-57
4492,4492,42,2022/4/15 15:40:00,31,81,-50
4493,4493,42,2022/4/15 15:50:00,30,101,-71
4494,4494,42,2022/4/15 16:00:00,44,93,-49
4495,4495,42,2022/4/15 16:10:00,40,90,-50
4496,4496,42,2022/4/15 16:20:00,45,114,-69
4497,4497,42,2022/4/15 16:30:00,47,93,-46
4498,4498,42,2022/4/15 16:40:00,48,106,-58
4499,4499,42,2022/4/15 16:50:00,48,116,-68
4500,4500,42,2022/4/15 17:00:00,112,109,3
4501,4501,42,2022/4/15 17:10:00,173,123,50
4502,4502,42,2022/4/15 17:20:00,88,124,-36
4503,4503,42,2022/4/15 17:30:00,97,169,-72
4504,4504,42,2022/4/15 17:40:00,239,116,123
4505,4505,42,2022/4/15 17:50:00,226,178,48
4506,4506,42,2022/4/15 18:00:00,198,151,47
4507,4507,42,2022/4/15 18:10:00,335,198,137
4508,4508,42,2022/4/15 18:20:00,307,144,163
4509,4509,42,2022/4/15 18:30:00,213,178,35
4510,4510,42,2022/4/15 18:40:00,204,126,78
4511,4511,42,2022/4/15 18:50:00,137,155,-18
4512,4512,42,2022/4/15 19:00:00,96,113,-17
4513,4513,42,2022/4/15 19:10:00,75,113,-38
4514,4514,42,2022/4/15 19:20:00,50,110,-60
4515,4515,42,2022/4/15 19:30:00,46,90,-44
4516,4516,42,2022/4/15 19:40:00,43,79,-36
4517,4517,42,2022/4/15 19:50:00,37,104,-67
4518,4518,42,2022/4/15 20:00:00,31,94,-63
4519,4519,42,2022/4/15 20:10:00,35,79,-44
4520,4520,42,2022/4/15 20:20:00,36,99,-63
4521,4521,42,2022/4/15 20:30:00,27,89,-62
4522,4522,42,2022/4/15 20:40:00,29,85,-56
4523,4523,42,2022/4/15 20:50:00,28,85,-57
4524,4524,42,2022/4/15 21:00:00,27,100,-73
4525,4525,42,2022/4/15 21:10:00,35,70,-35
4526,4526,42,2022/4/15 21:20:00,22,106,-84
4527,4527,42,2022/4/15 21:30:00,27,68,-41
4528,4528,42,2022/4/15 21:40:00,24,70,-46
4529,4529,42,2022/4/15 21:50:00,23,100,-77
4530,4530,42,2022/4/15 22:00:00,20,72,-52
4531,4531,42,2022/4/15 22:10:00,23,70,-47
4532,4532,42,2022/4/15 22:20:00,16,94,-78
4533,4533,42,2022/4/15 22:30:00,8,61,-53
4534,4534,42,2022/4/15 22:40:00,4,41,-37
4535,4535,42,2022/4/15 22:50:00,2,65,-63
4536,4536,43,2022/4/15 5:00:00,0,1,-1
4537,4537,43,2022/4/15 5:10:00,1,1,0
4538,4538,43,2022/4/15 5:20:00,10,1,9
4539,4539,43,2022/4/15 5:30:00,7,1,6
4540,4540,43,2022/4/15 5:40:00,14,1,13
4541,4541,43,2022/4/15 5:50:00,16,1,15
4542,4542,43,2022/4/15 6:00:00,20,1,19
4543,4543,43,2022/4/15 6:10:00,29,1,28
4544,4544,43,2022/4/15 6:20:00,34,1,33
4545,4545,43,2022/4/15 6:30:00,30,21,9
4546,4546,43,2022/4/15 6:40:00,33,21,12
4547,4547,43,2022/4/15 6:50:00,53,64,-11
4548,4548,43,2022/4/15 7:00:00,58,68,-10
4549,4549,43,2022/4/15 7:10:00,91,60,31
4550,4550,43,2022/4/15 7:20:00,151,100,51
4551,4551,43,2022/4/15 7:30:00,148,91,57
4552,4552,43,2022/4/15 7:40:00,161,93,68
4553,4553,43,2022/4/15 7:50:00,184,118,66
4554,4554,43,2022/4/15 8:00:00,173,109,64
4555,4555,43,2022/4/15 8:10:00,92,110,-18
4556,4556,43,2022/4/15 8:20:00,79,144,-65
4557,4557,43,2022/4/15 8:30:00,53,121,-68
4558,4558,43,2022/4/15 8:40:00,44,112,-68
4559,4559,43,2022/4/15 8:50:00,39,87,-48
4560,4560,43,2022/4/15 9:00:00,34,126,-92
4561,4561,43,2022/4/15 9:10:00,28,93,-65
4562,4562,43,2022/4/15 9:20:00,27,81,-54
4563,4563,43,2022/4/15 9:30:00,22,77,-55
4564,4564,43,2022/4/15 9:40:00,22,87,-65
4565,4565,43,2022/4/15 9:50:00,23,67,-44
4566,4566,43,2022/4/15 10:00:00,25,52,-27
4567,4567,43,2022/4/15 10:10:00,25,51,-26
4568,4568,43,2022/4/15 10:20:00,25,50,-25
4569,4569,43,2022/4/15 10:30:00,24,41,-17
4570,4570,43,2022/4/15 10:40:00,23,44,-21
4571,4571,43,2022/4/15 10:50:00,25,49,-24
4572,4572,43,2022/4/15 11:00:00,23,51,-28
4573,4573,43,2022/4/15 11:10:00,25,50,-25
4574,4574,43,2022/4/15 11:20:00,21,50,-29
4575,4575,43,2022/4/15 11:30:00,36,25,11
4576,4576,43,2022/4/15 11:40:00,23,49,-26
4577,4577,43,2022/4/15 11:50:00,21,52,-31
4578,4578,43,2022/4/15 12:00:00,23,52,-29
4579,4579,43,2022/4/15 12:10:00,23,50,-27
4580,4580,43,2022/4/15 12:20:00,23,66,-43
4581,4581,43,2022/4/15 12:30:00,19,37,-18
4582,4582,43,2022/4/15 12:40:00,25,59,-34
4583,4583,43,2022/4/15 12:50:00,25,62,-37
4584,4584,43,2022/4/15 13:00:00,22,65,-43
4585,4585,43,2022/4/15 13:10:00,26,66,-40
4586,4586,43,2022/4/15 13:20:00,25,47,-22
4587,4587,43,2022/4/15 13:30:00,22,25,-3
4588,4588,43,2022/4/15 13:40:00,24,49,-25
4589,4589,43,2022/4/15 13:50:00,22,55,-33
4590,4590,43,2022/4/15 14:00:00,24,55,-31
4591,4591,43,2022/4/15 14:10:00,24,50,-26
4592,4592,43,2022/4/15 14:20:00,22,51,-29
4593,4593,43,2022/4/15 14:30:00,22,23,-1
4594,4594,43,2022/4/15 14:40:00,34,54,-20
4595,4595,43,2022/4/15 14:50:00,19,54,-35
4596,4596,43,2022/4/15 15:00:00,19,54,-35
4597,4597,43,2022/4/15 15:10:00,23,65,-42
4598,4598,43,2022/4/15 15:20:00,21,53,-32
4599,4599,43,2022/4/15 15:30:00,22,32,-10
4600,4600,43,2022/4/15 15:40:00,22,64,-42
4601,4601,43,2022/4/15 15:50:00,25,60,-35
4602,4602,43,2022/4/15 16:00:00,21,70,-49
4603,4603,43,2022/4/15 16:10:00,29,63,-34
4604,4604,43,2022/4/15 16:20:00,29,71,-42
4605,4605,43,2022/4/15 16:30:00,32,45,-13
4606,4606,43,2022/4/15 16:40:00,33,73,-40
4607,4607,43,2022/4/15 16:50:00,39,71,-32
4608,4608,43,2022/4/15 17:00:00,42,67,-25
4609,4609,43,2022/4/15 17:10:00,204,75,129
4610,4610,43,2022/4/15 17:20:00,137,74,63
4611,4611,43,2022/4/15 17:30:00,73,69,4
4612,4612,43,2022/4/15 17:40:00,69,86,-17
4613,4613,43,2022/4/15 17:50:00,63,76,-13
4614,4614,43,2022/4/15 18:00:00,59,104,-45
4615,4615,43,2022/4/15 18:10:00,48,92,-44
4616,4616,43,2022/4/15 18:20:00,63,115,-52
4617,4617,43,2022/4/15 18:30:00,38,101,-63
4618,4618,43,2022/4/15 18:40:00,34,111,-77
4619,4619,43,2022/4/15 18:50:00,26,97,-71
4620,4620,43,2022/4/15 19:00:00,25,92,-67
4621,4621,43,2022/4/15 19:10:00,37,106,-69
4622,4622,43,2022/4/15 19:20:00,17,105,-88
4623,4623,43,2022/4/15 19:30:00,17,79,-62
4624,4624,43,2022/4/15 19:40:00,16,76,-60
4625,4625,43,2022/4/15 19:50:00,14,71,-57
4626,4626,43,2022/4/15 20:00:00,19,82,-63
4627,4627,43,2022/4/15 20:10:00,22,52,-30
4628,4628,43,2022/4/15 20:20:00,14,56,-42
4629,4629,43,2022/4/15 20:30:00,14,69,-55
4630,4630,43,2022/4/15 20:40:00,18,70,-52
4631,4631,43,2022/4/15 20:50:00,11,54,-43
4632,4632,43,2022/4/15 21:00:00,11,56,-45
4633,4633,43,2022/4/15 21:10:00,11,55,-44
4634,4634,43,2022/4/15 21:20:00,14,59,-45
4635,4635,43,2022/4/15 21:30:00,9,53,-44
4636,4636,43,2022/4/15 21:40:00,7,60,-53
4637,4637,43,2022/4/15 21:50:00,5,62,-57
4638,4638,43,2022/4/15 22:00:00,6,48,-42
4639,4639,43,2022/4/15 22:10:00,3,57,-54
4640,4640,43,2022/4/15 22:20:00,1,50,-49
4641,4641,43,2022/4/15 22:30:00,2,50,-48
4642,4642,43,2022/4/15 22:40:00,0,43,-43
4643,4643,43,2022/4/15 22:50:00,0,47,-47
4644,4644,44,2022/4/15 5:00:00,0,1,-1
4645,4645,44,2022/4/15 5:10:00,0,1,-1
4646,4646,44,2022/4/15 5:20:00,0,1,-1
4647,4647,44,2022/4/15 5:30:00,14,1,13
4648,4648,44,2022/4/15 5:40:00,25,1,24
4649,4649,44,2022/4/15 5:50:00,24,5,19
4650,4650,44,2022/4/15 6:00:00,30,5,25
4651,4651,44,2022/4/15 6:10:00,26,6,20
4652,4652,44,2022/4/15 6:20:00,45,8,37
4653,4653,44,2022/4/15 6:30:00,55,69,-14
4654,4654,44,2022/4/15 6:40:00,57,60,-3
4655,4655,44,2022/4/15 6:50:00,74,76,-2
4656,4656,44,2022/4/15 7:00:00,188,73,115
4657,4657,44,2022/4/15 7:10:00,123,98,25
4658,4658,44,2022/4/15 7:20:00,244,99,145
4659,4659,44,2022/4/15 7:30:00,244,92,152
4660,4660,44,2022/4/15 7:40:00,280,92,188
4661,4661,44,2022/4/15 7:50:00,279,107,172
4662,4662,44,2022/4/15 8:00:00,234,104,130
4663,4663,44,2022/4/15 8:10:00,215,105,110
4664,4664,44,2022/4/15 8:20:00,167,95,72
4665,4665,44,2022/4/15 8:30:00,182,105,77
4666,4666,44,2022/4/15 8:40:00,89,77,12
4667,4667,44,2022/4/15 8:50:00,53,81,-28
4668,4668,44,2022/4/15 9:00:00,48,79,-31
4669,4669,44,2022/4/15 9:10:00,45,76,-31
4670,4670,44,2022/4/15 9:20:00,32,69,-37
4671,4671,44,2022/4/15 9:30:00,24,70,-46
4672,4672,44,2022/4/15 9:40:00,27,74,-47
4673,4673,44,2022/4/15 9:50:00,27,69,-42
4674,4674,44,2022/4/15 10:00:00,27,66,-39
4675,4675,44,2022/4/15 10:10:00,27,67,-40
4676,4676,44,2022/4/15 10:20:00,25,62,-37
4677,4677,44,2022/4/15 10:30:00,27,66,-39
4678,4678,44,2022/4/15 10:40:00,29,46,-17
4679,4679,44,2022/4/15 10:50:00,26,74,-48
4680,4680,44,2022/4/15 11:00:00,25,68,-43
4681,4681,44,2022/4/15 11:10:00,28,48,-20
4682,4682,44,2022/4/15 11:20:00,27,67,-40
4683,4683,44,2022/4/15 11:30:00,26,65,-39
4684,4684,44,2022/4/15 11:40:00,28,50,-22
4685,4685,44,2022/4/15 11:50:00,26,66,-40
4686,4686,44,2022/4/15 12:00:00,25,68,-43
4687,4687,44,2022/4/15 12:10:00,27,52,-25
4688,4688,44,2022/4/15 12:20:00,28,71,-43
4689,4689,44,2022/4/15 12:30:00,28,67,-39
4690,4690,44,2022/4/15 12:40:00,27,61,-34
4691,4691,44,2022/4/15 12:50:00,22,79,-57
4692,4692,44,2022/4/15 13:00:00,29,65,-36
4693,4693,44,2022/4/15 13:10:00,24,65,-41
4694,4694,44,2022/4/15 13:20:00,26,65,-39
4695,4695,44,2022/4/15 13:30:00,26,63,-37
4696,4696,44,2022/4/15 13:40:00,26,54,-28
4697,4697,44,2022/4/15 13:50:00,23,68,-45
4698,4698,44,2022/4/15 14:00:00,28,68,-40
4699,4699,44,2022/4/15 14:10:00,28,56,-28
4700,4700,44,2022/4/15 14:20:00,28,64,-36
4701,4701,44,2022/4/15 14:30:00,25,65,-40
4702,4702,44,2022/4/15 14:40:00,26,51,-25
4703,4703,44,2022/4/15 14:50:00,27,67,-40
4704,4704,44,2022/4/15 15:00:00,24,74,-50
4705,4705,44,2022/4/15 15:10:00,29,61,-32
4706,4706,44,2022/4/15 15:20:00,31,82,-51
4707,4707,44,2022/4/15 15:30:00,26,78,-52
4708,4708,44,2022/4/15 15:40:00,29,69,-40
4709,4709,44,2022/4/15 15:50:00,26,76,-50
4710,4710,44,2022/4/15 16:00:00,35,84,-49
4711,4711,44,2022/4/15 16:10:00,24,70,-46
4712,4712,44,2022/4/15 16:20:00,27,93,-66
4713,4713,44,2022/4/15 16:30:00,31,77,-46
4714,4714,44,2022/4/15 16:40:00,39,76,-37
4715,4715,44,2022/4/15 16:50:00,53,103,-50
4716,4716,44,2022/4/15 17:00:00,30,99,-69
4717,4717,44,2022/4/15 17:10:00,47,93,-46
4718,4718,44,2022/4/15 17:20:00,28,105,-77
4719,4719,44,2022/4/15 17:30:00,39,107,-68
4720,4720,44,2022/4/15 17:40:00,42,102,-60
4721,4721,44,2022/4/15 17:50:00,42,110,-68
4722,4722,44,2022/4/15 18:00:00,37,128,-91
4723,4723,44,2022/4/15 18:10:00,34,119,-85
4724,4724,44,2022/4/15 18:20:00,29,110,-81
4725,4725,44,2022/4/15 18:30:00,28,111,-83
4726,4726,44,2022/4/15 18:40:00,24,110,-86
4727,4727,44,2022/4/15 18:50:00,25,139,-114
4728,4728,44,2022/4/15 19:00:00,24,109,-85
4729,4729,44,2022/4/15 19:10:00,24,116,-92
4730,4730,44,2022/4/15 19:20:00,18,123,-105
4731,4731,44,2022/4/15 19:30:00,17,120,-103
4732,4732,44,2022/4/15 19:40:00,15,107,-92
4733,4733,44,2022/4/15 19:50:00,24,106,-82
4734,4734,44,2022/4/15 20:00:00,13,78,-65
4735,4735,44,2022/4/15 20:10:00,14,95,-81
4736,4736,44,2022/4/15 20:20:00,16,79,-63
4737,4737,44,2022/4/15 20:30:00,13,92,-79
4738,4738,44,2022/4/15 20:40:00,16,70,-54
4739,4739,44,2022/4/15 20:50:00,9,77,-68
4740,4740,44,2022/4/15 21:00:00,16,79,-63
4741,4741,44,2022/4/15 21:10:00,10,71,-61
4742,4742,44,2022/4/15 21:20:00,7,95,-88
4743,4743,44,2022/4/15 21:30:00,9,73,-64
4744,4744,44,2022/4/15 21:40:00,8,72,-64
4745,4745,44,2022/4/15 21:50:00,5,83,-78
4746,4746,44,2022/4/15 22:00:00,1,63,-62
4747,4747,44,2022/4/15 22:10:00,1,77,-76
4748,4748,44,2022/4/15 22:20:00,1,61,-60
4749,4749,44,2022/4/15 22:30:00,1,50,-49
4750,4750,44,2022/4/15 22:40:00,0,70,-70
4751,4751,44,2022/4/15 22:50:00,0,41,-41
4752,4752,45,2022/4/15 5:00:00,1,1,0
4753,4753,45,2022/4/15 5:10:00,0,1,-1
4754,4754,45,2022/4/15 5:20:00,0,1,-1
4755,4755,45,2022/4/15 5:30:00,10,1,9
4756,4756,45,2022/4/15 5:40:00,34,1,33
4757,4757,45,2022/4/15 5:50:00,60,8,52
4758,4758,45,2022/4/15 6:00:00,67,19,48
4759,4759,45,2022/4/15 6:10:00,145,23,122
4760,4760,45,2022/4/15 6:20:00,188,68,120
4761,4761,45,2022/4/15 6:30:00,237,80,157
4762,4762,45,2022/4/15 6:40:00,347,71,276
4763,4763,45,2022/4/15 6:50:00,386,86,300
4764,4764,45,2022/4/15 7:00:00,652,105,547
4765,4765,45,2022/4/15 7:10:00,854,127,727
4766,4766,45,2022/4/15 7:20:00,1162,133,1029
4767,4767,45,2022/4/15 7:30:00,1215,159,1056
4768,4768,45,2022/4/15 7:40:00,1604,269,1335
4769,4769,45,2022/4/15 7:50:00,1395,227,1168
4770,4770,45,2022/4/15 8:00:00,1585,298,1287
4771,4771,45,2022/4/15 8:10:00,1222,231,991
4772,4772,45,2022/4/15 8:20:00,1061,326,735
4773,4773,45,2022/4/15 8:30:00,847,332,515
4774,4774,45,2022/4/15 8:40:00,683,326,357
4775,4775,45,2022/4/15 8:50:00,574,144,430
4776,4776,45,2022/4/15 9:00:00,342,159,183
4777,4777,45,2022/4/15 9:10:00,311,185,126
4778,4778,45,2022/4/15 9:20:00,229,119,110
4779,4779,45,2022/4/15 9:30:00,178,121,57
4780,4780,45,2022/4/15 9:40:00,175,104,71
4781,4781,45,2022/4/15 9:50:00,108,144,-36
4782,4782,45,2022/4/15 10:00:00,82,110,-28
4783,4783,45,2022/4/15 10:10:00,84,108,-24
4784,4784,45,2022/4/15 10:20:00,72,118,-46
4785,4785,45,2022/4/15 10:30:00,71,120,-49
4786,4786,45,2022/4/15 10:40:00,69,126,-57
4787,4787,45,2022/4/15 10:50:00,56,86,-30
4788,4788,45,2022/4/15 11:00:00,64,106,-42
4789,4789,45,2022/4/15 11:10:00,67,108,-41
4790,4790,45,2022/4/15 11:20:00,57,123,-66
4791,4791,45,2022/4/15 11:30:00,68,120,-52
4792,4792,45,2022/4/15 11:40:00,72,103,-31
4793,4793,45,2022/4/15 11:50:00,76,100,-24
4794,4794,45,2022/4/15 12:00:00,74,106,-32
4795,4795,45,2022/4/15 12:10:00,133,114,19
4796,4796,45,2022/4/15 12:20:00,82,104,-22
4797,4797,45,2022/4/15 12:30:00,130,99,31
4798,4798,45,2022/4/15 12:40:00,95,107,-12
4799,4799,45,2022/4/15 12:50:00,101,111,-10
4800,4800,45,2022/4/15 13:00:00,73,107,-34
4801,4801,45,2022/4/15 13:10:00,113,117,-4
4802,4802,45,2022/4/15 13:20:00,89,110,-21
4803,4803,45,2022/4/15 13:30:00,97,105,-8
4804,4804,45,2022/4/15 13:40:00,80,116,-36
4805,4805,45,2022/4/15 13:50:00,72,106,-34
4806,4806,45,2022/4/15 14:00:00,73,105,-32
4807,4807,45,2022/4/15 14:10:00,76,127,-51
4808,4808,45,2022/4/15 14:20:00,75,124,-49
4809,4809,45,2022/4/15 14:30:00,76,104,-28
4810,4810,45,2022/4/15 14:40:00,67,116,-49
4811,4811,45,2022/4/15 14:50:00,72,109,-37
4812,4812,45,2022/4/15 15:00:00,73,122,-49
4813,4813,45,2022/4/15 15:10:00,92,123,-31
4814,4814,45,2022/4/15 15:20:00,82,127,-45
4815,4815,45,2022/4/15 15:30:00,126,115,11
4816,4816,45,2022/4/15 15:40:00,100,119,-19
4817,4817,45,2022/4/15 15:50:00,96,119,-23
4818,4818,45,2022/4/15 16:00:00,91,106,-15
4819,4819,45,2022/4/15 16:10:00,137,139,-2
4820,4820,45,2022/4/15 16:20:00,96,198,-102
4821,4821,45,2022/4/15 16:30:00,168,105,63
4822,4822,45,2022/4/15 16:40:00,209,213,-4
4823,4823,45,2022/4/15 16:50:00,181,234,-53
4824,4824,45,2022/4/15 17:00:00,212,179,33
4825,4825,45,2022/4/15 17:10:00,270,230,40
4826,4826,45,2022/4/15 17:20:00,265,343,-78
4827,4827,45,2022/4/15 17:30:00,268,325,-57
4828,4828,45,2022/4/15 17:40:00,312,321,-9
4829,4829,45,2022/4/15 17:50:00,343,426,-83
4830,4830,45,2022/4/15 18:00:00,265,534,-269
4831,4831,45,2022/4/15 18:10:00,246,490,-244
4832,4832,45,2022/4/15 18:20:00,225,419,-194
4833,4833,45,2022/4/15 18:30:00,136,578,-442
4834,4834,45,2022/4/15 18:40:00,130,430,-300
4835,4835,45,2022/4/15 18:50:00,61,580,-519
4836,4836,45,2022/4/15 19:00:00,74,438,-364
4837,4837,45,2022/4/15 19:10:00,60,431,-371
4838,4838,45,2022/4/15 19:20:00,60,377,-317
4839,4839,45,2022/4/15 19:30:00,40,535,-495
4840,4840,45,2022/4/15 19:40:00,48,196,-148
4841,4841,45,2022/4/15 19:50:00,44,256,-212
4842,4842,45,2022/4/15 20:00:00,46,191,-145
4843,4843,45,2022/4/15 20:10:00,47,115,-68
4844,4844,45,2022/4/15 20:20:00,56,180,-124
4845,4845,45,2022/4/15 20:30:00,46,137,-91
4846,4846,45,2022/4/15 20:40:00,44,121,-77
4847,4847,45,2022/4/15 20:50:00,44,181,-137
4848,4848,45,2022/4/15 21:00:00,41,104,-63
4849,4849,45,2022/4/15 21:10:00,36,143,-107
4850,4850,45,2022/4/15 21:20:00,35,121,-86
4851,4851,45,2022/4/15 21:30:00,35,192,-157
4852,4852,45,2022/4/15 21:40:00,31,114,-83
4853,4853,45,2022/4/15 21:50:00,25,108,-83
4854,4854,45,2022/4/15 22:00:00,25,116,-91
4855,4855,45,2022/4/15 22:10:00,11,105,-94
4856,4856,45,2022/4/15 22:20:00,10,108,-98
4857,4857,45,2022/4/15 22:30:00,6,94,-88
4858,4858,45,2022/4/15 22:40:00,4,92,-88
4859,4859,45,2022/4/15 22:50:00,4,101,-97
4860,4860,46,2022/4/15 5:00:00,0,1,-1
4861,4861,46,2022/4/15 5:10:00,1,1,0
4862,4862,46,2022/4/15 5:20:00,10,1,9
4863,4863,46,2022/4/15 5:30:00,14,1,13
4864,4864,46,2022/4/15 5:40:00,15,1,14
4865,4865,46,2022/4/15 5:50:00,18,1,17
4866,4866,46,2022/4/15 6:00:00,25,1,24
4867,4867,46,2022/4/15 6:10:00,31,1,30
4868,4868,46,2022/4/15 6:20:00,32,1,31
4869,4869,46,2022/4/15 6:30:00,48,1,47
4870,4870,46,2022/4/15 6:40:00,58,23,35
4871,4871,46,2022/4/15 6:50:00,78,47,31
4872,4872,46,2022/4/15 7:00:00,70,47,23
4873,4873,46,2022/4/15 7:10:00,152,65,87
4874,4874,46,2022/4/15 7:20:00,245,69,176
4875,4875,46,2022/4/15 7:30:00,283,50,233
4876,4876,46,2022/4/15 7:40:00,328,60,268
4877,4877,46,2022/4/15 7:50:00,328,69,259
4878,4878,46,2022/4/15 8:00:00,326,72,254
4879,4879,46,2022/4/15 8:10:00,301,72,229
4880,4880,46,2022/4/15 8:20:00,254,106,148
4881,4881,46,2022/4/15 8:30:00,184,100,84
4882,4882,46,2022/4/15 8:40:00,163,87,76
4883,4883,46,2022/4/15 8:50:00,104,73,31
4884,4884,46,2022/4/15 9:00:00,68,84,-16
4885,4885,46,2022/4/15 9:10:00,49,55,-6
4886,4886,46,2022/4/15 9:20:00,43,48,-5
4887,4887,46,2022/4/15 9:30:00,32,40,-8
4888,4888,46,2022/4/15 9:40:00,32,63,-31
4889,4889,46,2022/4/15 9:50:00,27,38,-11
4890,4890,46,2022/4/15 10:00:00,28,61,-33
4891,4891,46,2022/4/15 10:10:00,27,45,-18
4892,4892,46,2022/4/15 10:20:00,25,8,17
4893,4893,46,2022/4/15 10:30:00,20,51,-31
4894,4894,46,2022/4/15 10:40:00,23,50,-27
4895,4895,46,2022/4/15 10:50:00,23,41,-18
4896,4896,46,2022/4/15 11:00:00,18,45,-27
4897,4897,46,2022/4/15 11:10:00,23,38,-15
4898,4898,46,2022/4/15 11:20:00,17,23,-6
4899,4899,46,2022/4/15 11:30:00,20,44,-24
4900,4900,46,2022/4/15 11:40:00,20,48,-28
4901,4901,46,2022/4/15 11:50:00,22,49,-27
4902,4902,46,2022/4/15 12:00:00,22,45,-23
4903,4903,46,2022/4/15 12:10:00,23,22,1
4904,4904,46,2022/4/15 12:20:00,27,40,-13
4905,4905,46,2022/4/15 12:30:00,19,62,-43
4906,4906,46,2022/4/15 12:40:00,23,56,-33
4907,4907,46,2022/4/15 12:50:00,24,51,-27
4908,4908,46,2022/4/15 13:00:00,23,49,-26
4909,4909,46,2022/4/15 13:10:00,22,23,-1
4910,4910,46,2022/4/15 13:20:00,19,46,-27
4911,4911,46,2022/4/15 13:30:00,20,52,-32
4912,4912,46,2022/4/15 13:40:00,21,48,-27
4913,4913,46,2022/4/15 13:50:00,19,50,-31
4914,4914,46,2022/4/15 14:00:00,17,60,-43
4915,4915,46,2022/4/15 14:10:00,20,32,-12
4916,4916,46,2022/4/15 14:20:00,17,47,-30
4917,4917,46,2022/4/15 14:30:00,16,64,-48
4918,4918,46,2022/4/15 14:40:00,20,65,-45
4919,4919,46,2022/4/15 14:50:00,20,61,-41
4920,4920,46,2022/4/15 15:00:00,17,66,-49
4921,4921,46,2022/4/15 15:10:00,17,35,-18
4922,4922,46,2022/4/15 15:20:00,20,57,-37
4923,4923,46,2022/4/15 15:30:00,15,68,-53
4924,4924,46,2022/4/15 15:40:00,21,72,-51
4925,4925,46,2022/4/15 15:50:00,22,77,-55
4926,4926,46,2022/4/15 16:00:00,21,77,-56
4927,4927,46,2022/4/15 16:10:00,30,43,-13
4928,4928,46,2022/4/15 16:20:00,28,68,-40
4929,4929,46,2022/4/15 16:30:00,27,75,-48
4930,4930,46,2022/4/15 16:40:00,28,106,-78
4931,4931,46,2022/4/15 16:50:00,34,78,-44
4932,4932,46,2022/4/15 17:00:00,31,77,-46
4933,4933,46,2022/4/15 17:10:00,44,76,-32
4934,4934,46,2022/4/15 17:20:00,35,115,-80
4935,4935,46,2022/4/15 17:30:00,30,103,-73
4936,4936,46,2022/4/15 17:40:00,30,105,-75
4937,4937,46,2022/4/15 17:50:00,35,105,-70
4938,4938,46,2022/4/15 18:00:00,29,151,-122
4939,4939,46,2022/4/15 18:10:00,28,128,-100
4940,4940,46,2022/4/15 18:20:00,29,110,-81
4941,4941,46,2022/4/15 18:30:00,28,112,-84
4942,4942,46,2022/4/15 18:40:00,20,235,-215
4943,4943,46,2022/4/15 18:50:00,20,111,-91
4944,4944,46,2022/4/15 19:00:00,19,105,-86
4945,4945,46,2022/4/15 19:10:00,15,114,-99
4946,4946,46,2022/4/15 19:20:00,15,139,-124
4947,4947,46,2022/4/15 19:30:00,14,104,-90
4948,4948,46,2022/4/15 19:40:00,16,106,-90
4949,4949,46,2022/4/15 19:50:00,12,76,-64
4950,4950,46,2022/4/15 20:00:00,14,114,-100
4951,4951,46,2022/4/15 20:10:00,13,71,-58
4952,4952,46,2022/4/15 20:20:00,12,78,-66
4953,4953,46,2022/4/15 20:30:00,11,54,-43
4954,4954,46,2022/4/15 20:40:00,13,98,-85
4955,4955,46,2022/4/15 20:50:00,14,66,-52
4956,4956,46,2022/4/15 21:00:00,10,92,-82
4957,4957,46,2022/4/15 21:10:00,15,47,-32
4958,4958,46,2022/4/15 21:20:00,11,95,-84
4959,4959,46,2022/4/15 21:30:00,8,71,-63
4960,4960,46,2022/4/15 21:40:00,7,73,-66
4961,4961,46,2022/4/15 21:50:00,5,86,-81
4962,4962,46,2022/4/15 22:00:00,4,43,-39
4963,4963,46,2022/4/15 22:10:00,2,96,-94
4964,4964,46,2022/4/15 22:20:00,2,83,-81
4965,4965,46,2022/4/15 22:30:00,2,64,-62
4966,4966,46,2022/4/15 22:40:00,0,63,-63
4967,4967,46,2022/4/15 22:50:00,0,54,-54
4968,4968,47,2022/4/15 5:00:00,0,1,-1
4969,4969,47,2022/4/15 5:10:00,0,1,-1
4970,4970,47,2022/4/15 5:20:00,0,1,-1
4971,4971,47,2022/4/15 5:30:00,0,1,-1
4972,4972,47,2022/4/15 5:40:00,4,1,3
4973,4973,47,2022/4/15 5:50:00,17,1,16
4974,4974,47,2022/4/15 6:00:00,30,13,17
4975,4975,47,2022/4/15 6:10:00,34,21,13
4976,4976,47,2022/4/15 6:20:00,29,34,-5
4977,4977,47,2022/4/15 6:30:00,39,33,6
4978,4978,47,2022/4/15 6:40:00,57,65,-8
4979,4979,47,2022/4/15 6:50:00,59,78,-19
4980,4980,47,2022/4/15 7:00:00,84,115,-31
4981,4981,47,2022/4/15 7:10:00,162,104,58
4982,4982,47,2022/4/15 7:20:00,246,185,61
4983,4983,47,2022/4/15 7:30:00,268,208,60
4984,4984,47,2022/4/15 7:40:00,302,153,149
4985,4985,47,2022/4/15 7:50:00,347,234,113
4986,4986,47,2022/4/15 8:00:00,318,298,20
4987,4987,47,2022/4/15 8:10:00,281,332,-51
4988,4988,47,2022/4/15 8:20:00,252,378,-126
4989,4989,47,2022/4/15 8:30:00,204,380,-176
4990,4990,47,2022/4/15 8:40:00,193,437,-244
4991,4991,47,2022/4/15 8:50:00,152,332,-180
4992,4992,47,2022/4/15 9:00:00,92,208,-116
4993,4993,47,2022/4/15 9:10:00,69,147,-78
4994,4994,47,2022/4/15 9:20:00,49,110,-61
4995,4995,47,2022/4/15 9:30:00,47,108,-61
4996,4996,47,2022/4/15 9:40:00,45,123,-78
4997,4997,47,2022/4/15 9:50:00,41,93,-52
4998,4998,47,2022/4/15 10:00:00,36,76,-40
4999,4999,47,2022/4/15 10:10:00,36,93,-57
5000,5000,47,2022/4/15 10:20:00,26,92,-66
5001,5001,47,2022/4/15 10:30:00,36,79,-43
5002,5002,47,2022/4/15 10:40:00,28,85,-57
5003,5003,47,2022/4/15 10:50:00,27,81,-54
5004,5004,47,2022/4/15 11:00:00,30,60,-30
5005,5005,47,2022/4/15 11:10:00,31,83,-52
5006,5006,47,2022/4/15 11:20:00,32,79,-47
5007,5007,47,2022/4/15 11:30:00,31,57,-26
5008,5008,47,2022/4/15 11:40:00,37,92,-55
5009,5009,47,2022/4/15 11:50:00,41,83,-42
5010,5010,47,2022/4/15 12:00:00,36,78,-42
5011,5011,47,2022/4/15 12:10:00,35,75,-40
5012,5012,47,2022/4/15 12:20:00,45,72,-27
5013,5013,47,2022/4/15 12:30:00,34,81,-47
5014,5014,47,2022/4/15 12:40:00,39,93,-54
5015,5015,47,2022/4/15 12:50:00,36,76,-40
5016,5016,47,2022/4/15 13:00:00,35,86,-51
5017,5017,47,2022/4/15 13:10:00,39,93,-54
5018,5018,47,2022/4/15 13:20:00,38,73,-35
5019,5019,47,2022/4/15 13:30:00,32,76,-44
5020,5020,47,2022/4/15 13:40:00,33,80,-47
5021,5021,47,2022/4/15 13:50:00,39,80,-41
5022,5022,47,2022/4/15 14:00:00,36,76,-40
5023,5023,47,2022/4/15 14:10:00,34,94,-60
5024,5024,47,2022/4/15 14:20:00,32,81,-49
5025,5025,47,2022/4/15 14:30:00,71,76,-5
5026,5026,47,2022/4/15 14:40:00,143,90,53
5027,5027,47,2022/4/15 14:50:00,57,73,-16
5028,5028,47,2022/4/15 15:00:00,57,77,-20
5029,5029,47,2022/4/15 15:10:00,41,92,-51
5030,5030,47,2022/4/15 15:20:00,46,80,-34
5031,5031,47,2022/4/15 15:30:00,43,84,-41
5032,5032,47,2022/4/15 15:40:00,45,101,-56
5033,5033,47,2022/4/15 15:50:00,44,75,-31
5034,5034,47,2022/4/15 16:00:00,47,96,-49
5035,5035,47,2022/4/15 16:10:00,54,99,-45
5036,5036,47,2022/4/15 16:20:00,70,83,-13
5037,5037,47,2022/4/15 16:30:00,136,92,44
5038,5038,47,2022/4/15 16:40:00,113,112,1
5039,5039,47,2022/4/15 16:50:00,92,87,5
5040,5040,47,2022/4/15 17:00:00,268,105,163
5041,5041,47,2022/4/15 17:10:00,270,109,161
5042,5042,47,2022/4/15 17:20:00,195,124,71
5043,5043,47,2022/4/15 17:30:00,273,106,167
5044,5044,47,2022/4/15 17:40:00,553,116,437
5045,5045,47,2022/4/15 17:50:00,272,124,148
5046,5046,47,2022/4/15 18:00:00,235,116,119
5047,5047,47,2022/4/15 18:10:00,336,110,226
5048,5048,47,2022/4/15 18:20:00,218,179,39
5049,5049,47,2022/4/15 18:30:00,135,109,26
5050,5050,47,2022/4/15 18:40:00,82,170,-88
5051,5051,47,2022/4/15 18:50:00,58,109,-51
5052,5052,47,2022/4/15 19:00:00,44,117,-73
5053,5053,47,2022/4/15 19:10:00,37,107,-70
5054,5054,47,2022/4/15 19:20:00,32,126,-94
5055,5055,47,2022/4/15 19:30:00,28,95,-67
5056,5056,47,2022/4/15 19:40:00,25,110,-85
5057,5057,47,2022/4/15 19:50:00,29,80,-51
5058,5058,47,2022/4/15 20:00:00,28,73,-45
5059,5059,47,2022/4/15 20:10:00,27,83,-56
5060,5060,47,2022/4/15 20:20:00,29,75,-46
5061,5061,47,2022/4/15 20:30:00,26,70,-44
5062,5062,47,2022/4/15 20:40:00,26,79,-53
5063,5063,47,2022/4/15 20:50:00,21,70,-49
5064,5064,47,2022/4/15 21:00:00,26,85,-59
5065,5065,47,2022/4/15 21:10:00,22,70,-48
5066,5066,47,2022/4/15 21:20:00,23,95,-72
5067,5067,47,2022/4/15 21:30:00,16,65,-49
5068,5068,47,2022/4/15 21:40:00,19,83,-64
5069,5069,47,2022/4/15 21:50:00,15,70,-55
5070,5070,47,2022/4/15 22:00:00,13,57,-44
5071,5071,47,2022/4/15 22:10:00,9,71,-62
5072,5072,47,2022/4/15 22:20:00,5,53,-48
5073,5073,47,2022/4/15 22:30:00,6,50,-44
5074,5074,47,2022/4/15 22:40:00,2,74,-72
5075,5075,47,2022/4/15 22:50:00,2,27,-25
5076,5076,48,2022/4/15 5:00:00,0,1,-1
5077,5077,48,2022/4/15 5:10:00,0,1,-1
5078,5078,48,2022/4/15 5:20:00,5,1,4
5079,5079,48,2022/4/15 5:30:00,25,1,24
5080,5080,48,2022/4/15 5:40:00,25,1,24
5081,5081,48,2022/4/15 5:50:00,30,1,29
5082,5082,48,2022/4/15 6:00:00,32,2,30
5083,5083,48,2022/4/15 6:10:00,47,2,45
5084,5084,48,2022/4/15 6:20:00,60,5,55
5085,5085,48,2022/4/15 6:30:00,79,5,74
5086,5086,48,2022/4/15 6:40:00,149,61,88
5087,5087,48,2022/4/15 6:50:00,176,38,138
5088,5088,48,2022/4/15 7:00:00,223,52,171
5089,5089,48,2022/4/15 7:10:00,321,54,267
5090,5090,48,2022/4/15 7:20:00,369,67,302
5091,5091,48,2022/4/15 7:30:00,654,62,592
5092,5092,48,2022/4/15 7:40:00,737,88,649
5093,5093,48,2022/4/15 7:50:00,1186,76,1110
5094,5094,48,2022/4/15 8:00:00,1177,76,1101
5095,5095,48,2022/4/15 8:10:00,1175,79,1096
5096,5096,48,2022/4/15 8:20:00,736,76,660
5097,5097,48,2022/4/15 8:30:00,638,81,557
5098,5098,48,2022/4/15 8:40:00,442,79,363
5099,5099,48,2022/4/15 8:50:00,318,67,251
5100,5100,48,2022/4/15 9:00:00,274,83,191
5101,5101,48,2022/4/15 9:10:00,191,73,118
5102,5102,48,2022/4/15 9:20:00,149,64,85
5103,5103,48,2022/4/15 9:30:00,78,64,14
5104,5104,48,2022/4/15 9:40:00,67,68,-1
5105,5105,48,2022/4/15 9:50:00,47,69,-22
5106,5106,48,2022/4/15 10:00:00,44,73,-29
5107,5107,48,2022/4/15 10:10:00,42,58,-16
5108,5108,48,2022/4/15 10:20:00,40,68,-28
5109,5109,48,2022/4/15 10:30:00,30,72,-42
5110,5110,48,2022/4/15 10:40:00,37,64,-27
5111,5111,48,2022/4/15 10:50:00,32,74,-42
5112,5112,48,2022/4/15 11:00:00,29,69,-40
5113,5113,48,2022/4/15 11:10:00,32,61,-29
5114,5114,48,2022/4/15 11:20:00,31,64,-33
5115,5115,48,2022/4/15 11:30:00,32,83,-51
5116,5116,48,2022/4/15 11:40:00,29,61,-32
5117,5117,48,2022/4/15 11:50:00,33,77,-44
5118,5118,48,2022/4/15 12:00:00,34,71,-37
5119,5119,48,2022/4/15 12:10:00,34,69,-35
5120,5120,48,2022/4/15 12:20:00,37,70,-33
5121,5121,48,2022/4/15 12:30:00,38,77,-39
5122,5122,48,2022/4/15 12:40:00,38,70,-32
5123,5123,48,2022/4/15 12:50:00,34,76,-42
5124,5124,48,2022/4/15 13:00:00,36,68,-32
5125,5125,48,2022/4/15 13:10:00,28,64,-36
5126,5126,48,2022/4/15 13:20:00,30,81,-51
5127,5127,48,2022/4/15 13:30:00,34,76,-42
5128,5128,48,2022/4/15 13:40:00,36,66,-30
5129,5129,48,2022/4/15 13:50:00,29,76,-47
5130,5130,48,2022/4/15 14:00:00,29,73,-44
5131,5131,48,2022/4/15 14:10:00,29,70,-41
5132,5132,48,2022/4/15 14:20:00,29,77,-48
5133,5133,48,2022/4/15 14:30:00,26,93,-67
5134,5134,48,2022/4/15 14:40:00,29,71,-42
5135,5135,48,2022/4/15 14:50:00,27,93,-66
5136,5136,48,2022/4/15 15:00:00,27,80,-53
5137,5137,48,2022/4/15 15:10:00,27,75,-48
5138,5138,48,2022/4/15 15:20:00,27,99,-72
5139,5139,48,2022/4/15 15:30:00,28,108,-80
5140,5140,48,2022/4/15 15:40:00,27,73,-46
5141,5141,48,2022/4/15 15:50:00,27,101,-74
5142,5142,48,2022/4/15 16:00:00,28,103,-75
5143,5143,48,2022/4/15 16:10:00,30,91,-61
5144,5144,48,2022/4/15 16:20:00,31,101,-70
5145,5145,48,2022/4/15 16:30:00,31,106,-75
5146,5146,48,2022/4/15 16:40:00,37,125,-88
5147,5147,48,2022/4/15 16:50:00,35,114,-79
5148,5148,48,2022/4/15 17:00:00,37,110,-73
5149,5149,48,2022/4/15 17:10:00,39,109,-70
5150,5150,48,2022/4/15 17:20:00,45,152,-107
5151,5151,48,2022/4/15 17:30:00,44,177,-133
5152,5152,48,2022/4/15 17:40:00,45,195,-150
5153,5153,48,2022/4/15 17:50:00,44,212,-168
5154,5154,48,2022/4/15 18:00:00,35,380,-345
5155,5155,48,2022/4/15 18:10:00,43,325,-282
5156,5156,48,2022/4/15 18:20:00,33,433,-400
5157,5157,48,2022/4/15 18:30:00,29,329,-300
5158,5158,48,2022/4/15 18:40:00,28,421,-393
5159,5159,48,2022/4/15 18:50:00,30,537,-507
5160,5160,48,2022/4/15 19:00:00,28,536,-508
5161,5161,48,2022/4/15 19:10:00,29,235,-206
5162,5162,48,2022/4/15 19:20:00,28,285,-257
5163,5163,48,2022/4/15 19:30:00,24,191,-167
5164,5164,48,2022/4/15 19:40:00,26,150,-124
5165,5165,48,2022/4/15 19:50:00,29,107,-78
5166,5166,48,2022/4/15 20:00:00,22,124,-102
5167,5167,48,2022/4/15 20:10:00,28,116,-88
5168,5168,48,2022/4/15 20:20:00,24,114,-90
5169,5169,48,2022/4/15 20:30:00,29,106,-77
5170,5170,48,2022/4/15 20:40:00,24,124,-100
5171,5171,48,2022/4/15 20:50:00,25,111,-86
5172,5172,48,2022/4/15 21:00:00,25,124,-99
5173,5173,48,2022/4/15 21:10:00,28,110,-82
5174,5174,48,2022/4/15 21:20:00,26,115,-89
5175,5175,48,2022/4/15 21:30:00,24,101,-77
5176,5176,48,2022/4/15 21:40:00,22,100,-78
5177,5177,48,2022/4/15 21:50:00,21,110,-89
5178,5178,48,2022/4/15 22:00:00,21,113,-92
5179,5179,48,2022/4/15 22:10:00,17,109,-92
5180,5180,48,2022/4/15 22:20:00,10,93,-83
5181,5181,48,2022/4/15 22:30:00,6,113,-107
5182,5182,48,2022/4/15 22:40:00,2,124,-122
5183,5183,48,2022/4/15 22:50:00,1,74,-73
5184,5184,49,2022/4/15 5:00:00,0,1,-1
5185,5185,49,2022/4/15 5:10:00,0,1,-1
5186,5186,49,2022/4/15 5:20:00,7,1,6
5187,5187,49,2022/4/15 5:30:00,20,1,19
5188,5188,49,2022/4/15 5:40:00,19,1,18
5189,5189,49,2022/4/15 5:50:00,21,1,20
5190,5190,49,2022/4/15 6:00:00,26,1,25
5191,5191,49,2022/4/15 6:10:00,34,1,33
5192,5192,49,2022/4/15 6:20:00,40,2,38
5193,5193,49,2022/4/15 6:30:00,58,5,53
5194,5194,49,2022/4/15 6:40:00,100,34,66
5195,5195,49,2022/4/15 6:50:00,180,38,142
5196,5196,49,2022/4/15 7:00:00,169,23,146
5197,5197,49,2022/4/15 7:10:00,254,65,189
5198,5198,49,2022/4/15 7:20:00,361,47,314
5199,5199,49,2022/4/15 7:30:00,325,69,256
5200,5200,49,2022/4/15 7:40:00,591,61,530
5201,5201,49,2022/4/15 7:50:00,663,65,598
5202,5202,49,2022/4/15 8:00:00,629,69,560
5203,5203,49,2022/4/15 8:10:00,592,93,499
5204,5204,49,2022/4/15 8:20:00,376,74,302
5205,5205,49,2022/4/15 8:30:00,301,74,227
5206,5206,49,2022/4/15 8:40:00,280,62,218
5207,5207,49,2022/4/15 8:50:00,218,77,141
5208,5208,49,2022/4/15 9:00:00,148,61,87
5209,5209,49,2022/4/15 9:10:00,94,45,49
5210,5210,49,2022/4/15 9:20:00,68,50,18
5211,5211,49,2022/4/15 9:30:00,53,65,-12
5212,5212,49,2022/4/15 9:40:00,40,45,-5
5213,5213,49,2022/4/15 9:50:00,33,51,-18
5214,5214,49,2022/4/15 10:00:00,31,41,-10
5215,5215,49,2022/4/15 10:10:00,29,46,-17
5216,5216,49,2022/4/15 10:20:00,27,49,-22
5217,5217,49,2022/4/15 10:30:00,27,8,19
5218,5218,49,2022/4/15 10:40:00,29,48,-19
5219,5219,49,2022/4/15 10:50:00,28,50,-22
5220,5220,49,2022/4/15 11:00:00,26,50,-24
5221,5221,49,2022/4/15 11:10:00,29,50,-21
5222,5222,49,2022/4/15 11:20:00,22,51,-29
5223,5223,49,2022/4/15 11:30:00,23,8,15
5224,5224,49,2022/4/15 11:40:00,27,61,-34
5225,5225,49,2022/4/15 11:50:00,28,60,-32
5226,5226,49,2022/4/15 12:00:00,27,51,-24
5227,5227,49,2022/4/15 12:10:00,30,62,-32
5228,5228,49,2022/4/15 12:20:00,27,51,-24
5229,5229,49,2022/4/15 12:30:00,30,8,22
5230,5230,49,2022/4/15 12:40:00,26,67,-41
5231,5231,49,2022/4/15 12:50:00,28,63,-35
5232,5232,49,2022/4/15 13:00:00,28,64,-36
5233,5233,49,2022/4/15 13:10:00,25,60,-35
5234,5234,49,2022/4/15 13:20:00,25,58,-33
5235,5235,49,2022/4/15 13:30:00,29,17,12
5236,5236,49,2022/4/15 13:40:00,22,60,-38
5237,5237,49,2022/4/15 13:50:00,26,68,-42
5238,5238,49,2022/4/15 14:00:00,21,65,-44
5239,5239,49,2022/4/15 14:10:00,22,72,-50
5240,5240,49,2022/4/15 14:20:00,20,63,-43
5241,5241,49,2022/4/15 14:30:00,22,15,7
5242,5242,49,2022/4/15 14:40:00,21,70,-49
5243,5243,49,2022/4/15 14:50:00,22,70,-48
5244,5244,49,2022/4/15 15:00:00,20,76,-56
5245,5245,49,2022/4/15 15:10:00,27,74,-47
5246,5246,49,2022/4/15 15:20:00,24,70,-46
5247,5247,49,2022/4/15 15:30:00,20,22,-2
5248,5248,49,2022/4/15 15:40:00,24,78,-54
5249,5249,49,2022/4/15 15:50:00,24,90,-66
5250,5250,49,2022/4/15 16:00:00,22,97,-75
5251,5251,49,2022/4/15 16:10:00,28,99,-71
5252,5252,49,2022/4/15 16:20:00,28,88,-60
5253,5253,49,2022/4/15 16:30:00,28,101,-73
5254,5254,49,2022/4/15 16:40:00,29,76,-47
5255,5255,49,2022/4/15 16:50:00,26,91,-65
5256,5256,49,2022/4/15 17:00:00,30,101,-71
5257,5257,49,2022/4/15 17:10:00,31,118,-87
5258,5258,49,2022/4/15 17:20:00,31,93,-62
5259,5259,49,2022/4/15 17:30:00,34,116,-82
5260,5260,49,2022/4/15 17:40:00,29,116,-87
5261,5261,49,2022/4/15 17:50:00,26,255,-229
5262,5262,49,2022/4/15 18:00:00,28,150,-122
5263,5263,49,2022/4/15 18:10:00,32,154,-122
5264,5264,49,2022/4/15 18:20:00,33,197,-164
5265,5265,49,2022/4/15 18:30:00,27,537,-510
5266,5266,49,2022/4/15 18:40:00,23,197,-174
5267,5267,49,2022/4/15 18:50:00,25,191,-166
5268,5268,49,2022/4/15 19:00:00,21,198,-177
5269,5269,49,2022/4/15 19:10:00,18,286,-268
5270,5270,49,2022/4/15 19:20:00,15,109,-94
5271,5271,49,2022/4/15 19:30:00,15,123,-108
5272,5272,49,2022/4/15 19:40:00,17,121,-104
5273,5273,49,2022/4/15 19:50:00,17,126,-109
5274,5274,49,2022/4/15 20:00:00,14,97,-83
5275,5275,49,2022/4/15 20:10:00,14,95,-81
5276,5276,49,2022/4/15 20:20:00,14,110,-96
5277,5277,49,2022/4/15 20:30:00,15,107,-92
5278,5278,49,2022/4/15 20:40:00,15,78,-63
5279,5279,49,2022/4/15 20:50:00,14,92,-78
5280,5280,49,2022/4/15 21:00:00,13,110,-97
5281,5281,49,2022/4/15 21:10:00,14,106,-92
5282,5282,49,2022/4/15 21:20:00,8,89,-81
5283,5283,49,2022/4/15 21:30:00,10,97,-87
5284,5284,49,2022/4/15 21:40:00,9,100,-91
5285,5285,49,2022/4/15 21:50:00,7,95,-88
5286,5286,49,2022/4/15 22:00:00,7,104,-97
5287,5287,49,2022/4/15 22:10:00,10,95,-85
5288,5288,49,2022/4/15 22:20:00,3,85,-82
5289,5289,49,2022/4/15 22:30:00,2,78,-76
5290,5290,49,2022/4/15 22:40:00,1,92,-91
5291,5291,49,2022/4/15 22:50:00,0,63,-63
5292,5292,50,2022/4/15 5:00:00,0,1,-1
5293,5293,50,2022/4/15 5:10:00,0,1,-1
5294,5294,50,2022/4/15 5:20:00,3,1,2
5295,5295,50,2022/4/15 5:30:00,15,1,14
5296,5296,50,2022/4/15 5:40:00,11,1,10
5297,5297,50,2022/4/15 5:50:00,12,1,11
5298,5298,50,2022/4/15 6:00:00,14,1,13
5299,5299,50,2022/4/15 6:10:00,17,1,16
5300,5300,50,2022/4/15 6:20:00,30,1,29
5301,5301,50,2022/4/15 6:30:00,30,1,29
5302,5302,50,2022/4/15 6:40:00,32,8,24
5303,5303,50,2022/4/15 6:50:00,41,38,3
5304,5304,50,2022/4/15 7:00:00,45,33,12
5305,5305,50,2022/4/15 7:10:00,60,59,1
5306,5306,50,2022/4/15 7:20:00,70,77,-7
5307,5307,50,2022/4/15 7:30:00,56,72,-16
5308,5308,50,2022/4/15 7:40:00,80,83,-3
5309,5309,50,2022/4/15 7:50:00,77,123,-46
5310,5310,50,2022/4/15 8:00:00,40,103,-63
5311,5311,50,2022/4/15 8:10:00,79,104,-25
5312,5312,50,2022/4/15 8:20:00,34,105,-71
5313,5313,50,2022/4/15 8:30:00,29,116,-87
5314,5314,50,2022/4/15 8:40:00,23,93,-70
5315,5315,50,2022/4/15 8:50:00,18,87,-69
5316,5316,50,2022/4/15 9:00:00,21,69,-48
5317,5317,50,2022/4/15 9:10:00,25,100,-75
5318,5318,50,2022/4/15 9:20:00,13,54,-41
5319,5319,50,2022/4/15 9:30:00,15,45,-30
5320,5320,50,2022/4/15 9:40:00,13,49,-36
5321,5321,50,2022/4/15 9:50:00,12,44,-32
5322,5322,50,2022/4/15 10:00:00,15,49,-34
5323,5323,50,2022/4/15 10:10:00,22,38,-16
5324,5324,50,2022/4/15 10:20:00,12,39,-27
5325,5325,50,2022/4/15 10:30:00,10,37,-27
5326,5326,50,2022/4/15 10:40:00,13,38,-25
5327,5327,50,2022/4/15 10:50:00,12,12,0
5328,5328,50,2022/4/15 11:00:00,11,38,-27
5329,5329,50,2022/4/15 11:10:00,18,47,-29
5330,5330,50,2022/4/15 11:20:00,19,38,-19
5331,5331,50,2022/4/15 11:30:00,17,43,-26
5332,5332,50,2022/4/15 11:40:00,16,25,-9
5333,5333,50,2022/4/15 11:50:00,14,23,-9
5334,5334,50,2022/4/15 12:00:00,25,41,-16
5335,5335,50,2022/4/15 12:10:00,25,46,-21
5336,5336,50,2022/4/15 12:20:00,17,46,-29
5337,5337,50,2022/4/15 12:30:00,17,38,-21
5338,5338,50,2022/4/15 12:40:00,16,8,8
5339,5339,50,2022/4/15 12:50:00,13,49,-36
5340,5340,50,2022/4/15 13:00:00,17,45,-28
5341,5341,50,2022/4/15 13:10:00,21,46,-25
5342,5342,50,2022/4/15 13:20:00,14,38,-24
5343,5343,50,2022/4/15 13:30:00,12,37,-25
5344,5344,50,2022/4/15 13:40:00,15,19,-4
5345,5345,50,2022/4/15 13:50:00,13,41,-28
5346,5346,50,2022/4/15 14:00:00,12,38,-26
5347,5347,50,2022/4/15 14:10:00,16,38,-22
5348,5348,50,2022/4/15 14:20:00,16,37,-21
5349,5349,50,2022/4/15 14:30:00,17,41,-24
5350,5350,50,2022/4/15 14:40:00,16,14,2
5351,5351,50,2022/4/15 14:50:00,13,40,-27
5352,5352,50,2022/4/15 15:00:00,15,45,-30
5353,5353,50,2022/4/15 15:10:00,20,40,-20
5354,5354,50,2022/4/15 15:20:00,17,46,-29
5355,5355,50,2022/4/15 15:30:00,15,46,-31
5356,5356,50,2022/4/15 15:40:00,19,12,7
5357,5357,50,2022/4/15 15:50:00,19,50,-31
5358,5358,50,2022/4/15 16:00:00,28,52,-24
5359,5359,50,2022/4/15 16:10:00,41,63,-22
5360,5360,50,2022/4/15 16:20:00,25,50,-25
5361,5361,50,2022/4/15 16:30:00,37,51,-14
5362,5362,50,2022/4/15 16:40:00,45,23,22
5363,5363,50,2022/4/15 16:50:00,38,54,-16
5364,5364,50,2022/4/15 17:00:00,48,66,-18
5365,5365,50,2022/4/15 17:10:00,72,61,11
5366,5366,50,2022/4/15 17:20:00,36,69,-33
5367,5367,50,2022/4/15 17:30:00,37,66,-29
5368,5368,50,2022/4/15 17:40:00,40,71,-31
5369,5369,50,2022/4/15 17:50:00,31,60,-29
5370,5370,50,2022/4/15 18:00:00,33,63,-30
5371,5371,50,2022/4/15 18:10:00,41,78,-37
5372,5372,50,2022/4/15 18:20:00,22,69,-47
5373,5373,50,2022/4/15 18:30:00,25,70,-45
5374,5374,50,2022/4/15 18:40:00,20,74,-54
5375,5375,50,2022/4/15 18:50:00,17,97,-80
5376,5376,50,2022/4/15 19:00:00,18,91,-73
5377,5377,50,2022/4/15 19:10:00,28,72,-44
5378,5378,50,2022/4/15 19:20:00,16,75,-59
5379,5379,50,2022/4/15 19:30:00,13,94,-81
5380,5380,50,2022/4/15 19:40:00,11,77,-66
5381,5381,50,2022/4/15 19:50:00,10,74,-64
5382,5382,50,2022/4/15 20:00:00,13,71,-58
5383,5383,50,2022/4/15 20:10:00,18,67,-49
5384,5384,50,2022/4/15 20:20:00,9,33,-24
5385,5385,50,2022/4/15 20:30:00,8,59,-51
5386,5386,50,2022/4/15 20:40:00,12,68,-56
5387,5387,50,2022/4/15 20:50:00,8,64,-56
5388,5388,50,2022/4/15 21:00:00,6,63,-57
5389,5389,50,2022/4/15 21:10:00,11,66,-55
5390,5390,50,2022/4/15 21:20:00,6,15,-9
5391,5391,50,2022/4/15 21:30:00,2,52,-50
5392,5392,50,2022/4/15 21:40:00,1,65,-64
5393,5393,50,2022/4/15 21:50:00,1,44,-43
5394,5394,50,2022/4/15 22:00:00,0,31,-31
5395,5395,50,2022/4/15 22:10:00,0,55,-55
5396,5396,50,2022/4/15 22:20:00,0,47,-47
5397,5397,50,2022/4/15 22:30:00,0,3,-3
5398,5398,50,2022/4/15 22:40:00,0,46,-46
5399,5399,50,2022/4/15 22:50:00,0,38,-38
5400,5400,51,2022/4/15 5:00:00,0,1,-1
5401,5401,51,2022/4/15 5:10:00,0,1,-1
5402,5402,51,2022/4/15 5:20:00,0,1,-1
5403,5403,51,2022/4/15 5:30:00,7,1,6
5404,5404,51,2022/4/15 5:40:00,16,1,15
5405,5405,51,2022/4/15 5:50:00,9,1,8
5406,5406,51,2022/4/15 6:00:00,11,1,10
5407,5407,51,2022/4/15 6:10:00,16,1,15
5408,5408,51,2022/4/15 6:20:00,12,1,11
5409,5409,51,2022/4/15 6:30:00,19,12,7
5410,5410,51,2022/4/15 6:40:00,17,67,-50
5411,5411,51,2022/4/15 6:50:00,25,60,-35
5412,5412,51,2022/4/15 7:00:00,28,62,-34
5413,5413,51,2022/4/15 7:10:00,25,91,-66
5414,5414,51,2022/4/15 7:20:00,33,99,-66
5415,5415,51,2022/4/15 7:30:00,34,99,-65
5416,5416,51,2022/4/15 7:40:00,28,97,-69
5417,5417,51,2022/4/15 7:50:00,30,106,-76
5418,5418,51,2022/4/15 8:00:00,24,117,-93
5419,5419,51,2022/4/15 8:10:00,30,95,-65
5420,5420,51,2022/4/15 8:20:00,27,106,-79
5421,5421,51,2022/4/15 8:30:00,23,128,-105
5422,5422,51,2022/4/15 8:40:00,26,101,-75
5423,5423,51,2022/4/15 8:50:00,26,92,-66
5424,5424,51,2022/4/15 9:00:00,24,103,-79
5425,5425,51,2022/4/15 9:10:00,24,99,-75
5426,5426,51,2022/4/15 9:20:00,20,109,-89
5427,5427,51,2022/4/15 9:30:00,21,114,-93
5428,5428,51,2022/4/15 9:40:00,18,91,-73
5429,5429,51,2022/4/15 9:50:00,30,128,-98
5430,5430,51,2022/4/15 10:00:00,24,106,-82
5431,5431,51,2022/4/15 10:10:00,33,91,-58
5432,5432,51,2022/4/15 10:20:00,36,87,-51
5433,5433,51,2022/4/15 10:30:00,27,47,-20
5434,5434,51,2022/4/15 10:40:00,42,84,-42
5435,5435,51,2022/4/15 10:50:00,30,93,-63
5436,5436,51,2022/4/15 11:00:00,65,73,-8
5437,5437,51,2022/4/15 11:10:00,42,65,-23
5438,5438,51,2022/4/15 11:20:00,50,69,-19
5439,5439,51,2022/4/15 11:30:00,47,34,13
5440,5440,51,2022/4/15 11:40:00,39,67,-28
5441,5441,51,2022/4/15 11:50:00,33,57,-24
5442,5442,51,2022/4/15 12:00:00,30,60,-30
5443,5443,51,2022/4/15 12:10:00,33,60,-27
5444,5444,51,2022/4/15 12:20:00,35,18,17
5445,5445,51,2022/4/15 12:30:00,30,56,-26
5446,5446,51,2022/4/15 12:40:00,22,58,-36
5447,5447,51,2022/4/15 12:50:00,23,55,-32
5448,5448,51,2022/4/15 13:00:00,21,55,-34
5449,5449,51,2022/4/15 13:10:00,25,63,-38
5450,5450,51,2022/4/15 13:20:00,26,22,4
5451,5451,51,2022/4/15 13:30:00,21,61,-40
5452,5452,51,2022/4/15 13:40:00,22,61,-39
5453,5453,51,2022/4/15 13:50:00,23,51,-28
5454,5454,51,2022/4/15 14:00:00,15,55,-40
5455,5455,51,2022/4/15 14:10:00,23,51,-28
5456,5456,51,2022/4/15 14:20:00,20,19,1
5457,5457,51,2022/4/15 14:30:00,25,48,-23
5458,5458,51,2022/4/15 14:40:00,15,43,-28
5459,5459,51,2022/4/15 14:50:00,22,39,-17
5460,5460,51,2022/4/15 15:00:00,18,42,-24
5461,5461,51,2022/4/15 15:10:00,21,47,-26
5462,5462,51,2022/4/15 15:20:00,22,18,4
5463,5463,51,2022/4/15 15:30:00,19,41,-22
5464,5464,51,2022/4/15 15:40:00,23,50,-27
5465,5465,51,2022/4/15 15:50:00,15,38,-23
5466,5466,51,2022/4/15 16:00:00,20,38,-18
5467,5467,51,2022/4/15 16:10:00,21,42,-21
5468,5468,51,2022/4/15 16:20:00,25,22,3
5469,5469,51,2022/4/15 16:30:00,23,38,-15
5470,5470,51,2022/4/15 16:40:00,22,41,-19
5471,5471,51,2022/4/15 16:50:00,30,49,-19
5472,5472,51,2022/4/15 17:00:00,35,51,-16
5473,5473,51,2022/4/15 17:10:00,36,61,-25
5474,5474,51,2022/4/15 17:20:00,31,29,2
5475,5475,51,2022/4/15 17:30:00,20,70,-50
5476,5476,51,2022/4/15 17:40:00,17,59,-42
5477,5477,51,2022/4/15 17:50:00,19,45,-26
5478,5478,51,2022/4/15 18:00:00,22,39,-17
5479,5479,51,2022/4/15 18:10:00,21,62,-41
5480,5480,51,2022/4/15 18:20:00,19,60,-41
5481,5481,51,2022/4/15 18:30:00,13,52,-39
5482,5482,51,2022/4/15 18:40:00,17,51,-34
5483,5483,51,2022/4/15 18:50:00,11,68,-57
5484,5484,51,2022/4/15 19:00:00,21,48,-27
5485,5485,51,2022/4/15 19:10:00,11,43,-32
5486,5486,51,2022/4/15 19:20:00,14,49,-35
5487,5487,51,2022/4/15 19:30:00,8,54,-46
5488,5488,51,2022/4/15 19:40:00,10,41,-31
5489,5489,51,2022/4/15 19:50:00,6,27,-21
5490,5490,51,2022/4/15 20:00:00,22,25,-3
5491,5491,51,2022/4/15 20:10:00,8,25,-17
5492,5492,51,2022/4/15 20:20:00,11,25,-14
5493,5493,51,2022/4/15 20:30:00,5,32,-27
5494,5494,51,2022/4/15 20:40:00,12,31,-19
5495,5495,51,2022/4/15 20:50:00,6,27,-21
5496,5496,51,2022/4/15 21:00:00,16,10,6
5497,5497,51,2022/4/15 21:10:00,15,23,-8
5498,5498,51,2022/4/15 21:20:00,1,37,-36
5499,5499,51,2022/4/15 21:30:00,1,31,-30
5500,5500,51,2022/4/15 21:40:00,1,3,-2
5501,5501,51,2022/4/15 21:50:00,0,31,-31
5502,5502,51,2022/4/15 22:00:00,0,33,-33
5503,5503,51,2022/4/15 22:10:00,0,21,-21
5504,5504,51,2022/4/15 22:20:00,0,13,-13
5505,5505,51,2022/4/15 22:30:00,0,25,-25
5506,5506,51,2022/4/15 22:40:00,0,10,-10
5507,5507,51,2022/4/15 22:50:00,0,8,-8
5508,5508,52,2022/4/15 5:00:00,0,1,-1
5509,5509,52,2022/4/15 5:10:00,0,1,-1
5510,5510,52,2022/4/15 5:20:00,0,1,-1
5511,5511,52,2022/4/15 5:30:00,0,1,-1
5512,5512,52,2022/4/15 5:40:00,6,1,5
5513,5513,52,2022/4/15 5:50:00,20,1,19
5514,5514,52,2022/4/15 6:00:00,42,6,36
5515,5515,52,2022/4/15 6:10:00,54,29,25
5516,5516,52,2022/4/15 6:20:00,70,30,40
5517,5517,52,2022/4/15 6:30:00,109,37,72
5518,5518,52,2022/4/15 6:40:00,212,46,166
5519,5519,52,2022/4/15 6:50:00,247,71,176
5520,5520,52,2022/4/15 7:00:00,359,82,277
5521,5521,52,2022/4/15 7:10:00,596,75,521
5522,5522,52,2022/4/15 7:20:00,721,76,645
5523,5523,52,2022/4/15 7:30:00,737,75,662
5524,5524,52,2022/4/15 7:40:00,1051,105,946
5525,5525,52,2022/4/15 7:50:00,1233,90,1143
5526,5526,52,2022/4/15 8:00:00,1055,113,942
5527,5527,52,2022/4/15 8:10:00,836,121,715
5528,5528,52,2022/4/15 8:20:00,722,104,618
5529,5529,52,2022/4/15 8:30:00,665,123,542
5530,5530,52,2022/4/15 8:40:00,597,109,488
5531,5531,52,2022/4/15 8:50:00,374,108,266
5532,5532,52,2022/4/15 9:00:00,324,91,233
5533,5533,52,2022/4/15 9:10:00,269,100,169
5534,5534,52,2022/4/15 9:20:00,230,79,151
5535,5535,52,2022/4/15 9:30:00,149,84,65
5536,5536,52,2022/4/15 9:40:00,91,82,9
5537,5537,52,2022/4/15 9:50:00,62,75,-13
5538,5538,52,2022/4/15 10:00:00,57,70,-13
5539,5539,52,2022/4/15 10:10:00,49,73,-24
5540,5540,52,2022/4/15 10:20:00,41,69,-28
5541,5541,52,2022/4/15 10:30:00,37,78,-41
5542,5542,52,2022/4/15 10:40:00,35,72,-37
5543,5543,52,2022/4/15 10:50:00,36,73,-37
5544,5544,52,2022/4/15 11:00:00,35,75,-40
5545,5545,52,2022/4/15 11:10:00,39,82,-43
5546,5546,52,2022/4/15 11:20:00,33,70,-37
5547,5547,52,2022/4/15 11:30:00,31,68,-37
5548,5548,52,2022/4/15 11:40:00,38,76,-38
5549,5549,52,2022/4/15 11:50:00,35,74,-39
5550,5550,52,2022/4/15 12:00:00,37,81,-44
5551,5551,52,2022/4/15 12:10:00,42,80,-38
5552,5552,52,2022/4/15 12:20:00,41,66,-25
5553,5553,52,2022/4/15 12:30:00,37,75,-38
5554,5554,52,2022/4/15 12:40:00,37,82,-45
5555,5555,52,2022/4/15 12:50:00,37,72,-35
5556,5556,52,2022/4/15 13:00:00,39,87,-48
5557,5557,52,2022/4/15 13:10:00,35,92,-57
5558,5558,52,2022/4/15 13:20:00,38,72,-34
5559,5559,52,2022/4/15 13:30:00,31,81,-50
5560,5560,52,2022/4/15 13:40:00,33,90,-57
5561,5561,52,2022/4/15 13:50:00,30,71,-41
5562,5562,52,2022/4/15 14:00:00,33,81,-48
5563,5563,52,2022/4/15 14:10:00,32,90,-58
5564,5564,52,2022/4/15 14:20:00,29,71,-42
5565,5565,52,2022/4/15 14:30:00,33,93,-60
5566,5566,52,2022/4/15 14:40:00,33,98,-65
5567,5567,52,2022/4/15 14:50:00,25,77,-52
5568,5568,52,2022/4/15 15:00:00,27,101,-74
5569,5569,52,2022/4/15 15:10:00,33,103,-70
5570,5570,52,2022/4/15 15:20:00,32,76,-44
5571,5571,52,2022/4/15 15:30:00,35,110,-75
5572,5572,52,2022/4/15 15:40:00,29,114,-85
5573,5573,52,2022/4/15 15:50:00,30,93,-63
5574,5574,52,2022/4/15 16:00:00,35,122,-87
5575,5575,52,2022/4/15 16:10:00,32,125,-93
5576,5576,52,2022/4/15 16:20:00,29,94,-65
5577,5577,52,2022/4/15 16:30:00,40,110,-70
5578,5578,52,2022/4/15 16:40:00,43,123,-80
5579,5579,52,2022/4/15 16:50:00,35,120,-85
5580,5580,52,2022/4/15 17:00:00,60,144,-84
5581,5581,52,2022/4/15 17:10:00,93,143,-50
5582,5582,52,2022/4/15 17:20:00,52,296,-244
5583,5583,52,2022/4/15 17:30:00,56,205,-149
5584,5584,52,2022/4/15 17:40:00,65,431,-366
5585,5585,52,2022/4/15 17:50:00,47,332,-285
5586,5586,52,2022/4/15 18:00:00,45,501,-456
5587,5587,52,2022/4/15 18:10:00,57,345,-288
5588,5588,52,2022/4/15 18:20:00,51,430,-379
5589,5589,52,2022/4/15 18:30:00,45,323,-278
5590,5590,52,2022/4/15 18:40:00,39,429,-390
5591,5591,52,2022/4/15 18:50:00,29,334,-305
5592,5592,52,2022/4/15 19:00:00,33,435,-402
5593,5593,52,2022/4/15 19:10:00,35,223,-188
5594,5594,52,2022/4/15 19:20:00,26,234,-208
5595,5595,52,2022/4/15 19:30:00,28,116,-88
5596,5596,52,2022/4/15 19:40:00,29,158,-129
5597,5597,52,2022/4/15 19:50:00,25,113,-88
5598,5598,52,2022/4/15 20:00:00,28,109,-81
5599,5599,52,2022/4/15 20:10:00,26,107,-81
5600,5600,52,2022/4/15 20:20:00,26,92,-66
5601,5601,52,2022/4/15 20:30:00,24,110,-86
5602,5602,52,2022/4/15 20:40:00,22,111,-89
5603,5603,52,2022/4/15 20:50:00,20,100,-80
5604,5604,52,2022/4/15 21:00:00,21,123,-102
5605,5605,52,2022/4/15 21:10:00,24,114,-90
5606,5606,52,2022/4/15 21:20:00,18,97,-79
5607,5607,52,2022/4/15 21:30:00,18,133,-115
5608,5608,52,2022/4/15 21:40:00,18,108,-90
5609,5609,52,2022/4/15 21:50:00,18,127,-109
5610,5610,52,2022/4/15 22:00:00,13,106,-93
5611,5611,52,2022/4/15 22:10:00,14,93,-79
5612,5612,52,2022/4/15 22:20:00,7,118,-111
5613,5613,52,2022/4/15 22:30:00,4,105,-101
5614,5614,52,2022/4/15 22:40:00,3,89,-86
5615,5615,52,2022/4/15 22:50:00,1,57,-56
5616,5616,53,2022/4/15 5:00:00,0,1,-1
5617,5617,53,2022/4/15 5:10:00,0,1,-1
5618,5618,53,2022/4/15 5:20:00,0,1,-1
5619,5619,53,2022/4/15 5:30:00,2,1,1
5620,5620,53,2022/4/15 5:40:00,2,1,1
5621,5621,53,2022/4/15 5:50:00,13,6,7
5622,5622,53,2022/4/15 6:00:00,11,2,9
5623,5623,53,2022/4/15 6:10:00,16,11,5
5624,5624,53,2022/4/15 6:20:00,25,19,6
5625,5625,53,2022/4/15 6:30:00,31,61,-30
5626,5626,53,2022/4/15 6:40:00,37,71,-34
5627,5627,53,2022/4/15 6:50:00,41,91,-50
5628,5628,53,2022/4/15 7:00:00,43,87,-44
5629,5629,53,2022/4/15 7:10:00,57,108,-51
5630,5630,53,2022/4/15 7:20:00,55,105,-50
5631,5631,53,2022/4/15 7:30:00,63,107,-44
5632,5632,53,2022/4/15 7:40:00,123,107,16
5633,5633,53,2022/4/15 7:50:00,164,125,39
5634,5634,53,2022/4/15 8:00:00,167,131,36
5635,5635,53,2022/4/15 8:10:00,181,334,-153
5636,5636,53,2022/4/15 8:20:00,186,296,-110
5637,5637,53,2022/4/15 8:30:00,149,344,-195
5638,5638,53,2022/4/15 8:40:00,93,377,-284
5639,5639,53,2022/4/15 8:50:00,79,332,-253
5640,5640,53,2022/4/15 9:00:00,62,222,-160
5641,5641,53,2022/4/15 9:10:00,53,233,-180
5642,5642,53,2022/4/15 9:20:00,52,108,-56
5643,5643,53,2022/4/15 9:30:00,41,110,-69
5644,5644,53,2022/4/15 9:40:00,38,107,-69
5645,5645,53,2022/4/15 9:50:00,29,96,-67
5646,5646,53,2022/4/15 10:00:00,29,76,-47
5647,5647,53,2022/4/15 10:10:00,28,76,-48
5648,5648,53,2022/4/15 10:20:00,27,67,-40
5649,5649,53,2022/4/15 10:30:00,25,76,-51
5650,5650,53,2022/4/15 10:40:00,29,69,-40
5651,5651,53,2022/4/15 10:50:00,28,61,-33
5652,5652,53,2022/4/15 11:00:00,28,73,-45
5653,5653,53,2022/4/15 11:10:00,28,49,-21
5654,5654,53,2022/4/15 11:20:00,27,59,-32
5655,5655,53,2022/4/15 11:30:00,25,66,-41
5656,5656,53,2022/4/15 11:40:00,27,67,-40
5657,5657,53,2022/4/15 11:50:00,26,60,-34
5658,5658,53,2022/4/15 12:00:00,27,66,-39
5659,5659,53,2022/4/15 12:10:00,28,69,-41
5660,5660,53,2022/4/15 12:20:00,23,60,-37
5661,5661,53,2022/4/15 12:30:00,26,65,-39
5662,5662,53,2022/4/15 12:40:00,25,78,-53
5663,5663,53,2022/4/15 12:50:00,23,60,-37
5664,5664,53,2022/4/15 13:00:00,23,72,-49
5665,5665,53,2022/4/15 13:10:00,23,70,-47
5666,5666,53,2022/4/15 13:20:00,28,61,-33
5667,5667,53,2022/4/15 13:30:00,27,75,-48
5668,5668,53,2022/4/15 13:40:00,24,68,-44
5669,5669,53,2022/4/15 13:50:00,29,62,-33
5670,5670,53,2022/4/15 14:00:00,25,72,-47
5671,5671,53,2022/4/15 14:10:00,26,67,-41
5672,5672,53,2022/4/15 14:20:00,31,52,-21
5673,5673,53,2022/4/15 14:30:00,23,67,-44
5674,5674,53,2022/4/15 14:40:00,22,64,-42
5675,5675,53,2022/4/15 14:50:00,26,60,-34
5676,5676,53,2022/4/15 15:00:00,27,64,-37
5677,5677,53,2022/4/15 15:10:00,29,73,-44
5678,5678,53,2022/4/15 15:20:00,31,59,-28
5679,5679,53,2022/4/15 15:30:00,26,72,-46
5680,5680,53,2022/4/15 15:40:00,26,78,-52
5681,5681,53,2022/4/15 15:50:00,36,59,-23
5682,5682,53,2022/4/15 16:00:00,35,63,-28
5683,5683,53,2022/4/15 16:10:00,35,70,-35
5684,5684,53,2022/4/15 16:20:00,38,77,-39
5685,5685,53,2022/4/15 16:30:00,44,85,-41
5686,5686,53,2022/4/15 16:40:00,44,82,-38
5687,5687,53,2022/4/15 16:50:00,43,87,-44
5688,5688,53,2022/4/15 17:00:00,85,90,-5
5689,5689,53,2022/4/15 17:10:00,169,99,70
5690,5690,53,2022/4/15 17:20:00,140,108,32
5691,5691,53,2022/4/15 17:30:00,175,106,69
5692,5692,53,2022/4/15 17:40:00,233,103,130
5693,5693,53,2022/4/15 17:50:00,217,127,90
5694,5694,53,2022/4/15 18:00:00,223,125,98
5695,5695,53,2022/4/15 18:10:00,304,121,183
5696,5696,53,2022/4/15 18:20:00,267,125,142
5697,5697,53,2022/4/15 18:30:00,191,110,81
5698,5698,53,2022/4/15 18:40:00,164,121,43
5699,5699,53,2022/4/15 18:50:00,82,88,-6
5700,5700,53,2022/4/15 19:00:00,69,106,-37
5701,5701,53,2022/4/15 19:10:00,50,102,-52
5702,5702,53,2022/4/15 19:20:00,45,91,-46
5703,5703,53,2022/4/15 19:30:00,41,89,-48
5704,5704,53,2022/4/15 19:40:00,40,79,-39
5705,5705,53,2022/4/15 19:50:00,33,73,-40
5706,5706,53,2022/4/15 20:00:00,35,72,-37
5707,5707,53,2022/4/15 20:10:00,31,64,-33
5708,5708,53,2022/4/15 20:20:00,30,60,-30
5709,5709,53,2022/4/15 20:30:00,30,63,-33
5710,5710,53,2022/4/15 20:40:00,33,67,-34
5711,5711,53,2022/4/15 20:50:00,29,71,-42
5712,5712,53,2022/4/15 21:00:00,35,56,-21
5713,5713,53,2022/4/15 21:10:00,27,63,-36
5714,5714,53,2022/4/15 21:20:00,26,62,-36
5715,5715,53,2022/4/15 21:30:00,25,65,-40
5716,5716,53,2022/4/15 21:40:00,28,58,-30
5717,5717,53,2022/4/15 21:50:00,29,70,-41
5718,5718,53,2022/4/15 22:00:00,24,59,-35
5719,5719,53,2022/4/15 22:10:00,24,48,-24
5720,5720,53,2022/4/15 22:20:00,17,51,-34
5721,5721,53,2022/4/15 22:30:00,10,49,-39
5722,5722,53,2022/4/15 22:40:00,4,18,-14
5723,5723,53,2022/4/15 22:50:00,1,10,-9
5724,5724,54,2022/4/15 5:00:00,0,1,-1
5725,5725,54,2022/4/15 5:10:00,0,1,-1
5726,5726,54,2022/4/15 5:20:00,0,1,-1
5727,5727,54,2022/4/15 5:30:00,1,1,0
5728,5728,54,2022/4/15 5:40:00,20,1,19
5729,5729,54,2022/4/15 5:50:00,60,5,55
5730,5730,54,2022/4/15 6:00:00,106,19,87
5731,5731,54,2022/4/15 6:10:00,148,8,140
5732,5732,54,2022/4/15 6:20:00,205,43,162
5733,5733,54,2022/4/15 6:30:00,258,34,224
5734,5734,54,2022/4/15 6:40:00,276,52,224
5735,5735,54,2022/4/15 6:50:00,348,65,283
5736,5736,54,2022/4/15 7:00:00,571,96,475
5737,5737,54,2022/4/15 7:10:00,588,109,479
5738,5738,54,2022/4/15 7:20:00,687,109,578
5739,5739,54,2022/4/15 7:30:00,862,111,751
5740,5740,54,2022/4/15 7:40:00,1221,105,1116
5741,5741,54,2022/4/15 7:50:00,1370,100,1270
5742,5742,54,2022/4/15 8:00:00,1232,122,1110
5743,5743,54,2022/4/15 8:10:00,1175,104,1071
5744,5744,54,2022/4/15 8:20:00,830,110,720
5745,5745,54,2022/4/15 8:30:00,731,106,625
5746,5746,54,2022/4/15 8:40:00,627,125,502
5747,5747,54,2022/4/15 8:50:00,365,109,256
5748,5748,54,2022/4/15 9:00:00,311,93,218
5749,5749,54,2022/4/15 9:10:00,247,78,169
5750,5750,54,2022/4/15 9:20:00,191,90,101
5751,5751,54,2022/4/15 9:30:00,144,83,61
5752,5752,54,2022/4/15 9:40:00,71,76,-5
5753,5753,54,2022/4/15 9:50:00,62,84,-22
5754,5754,54,2022/4/15 10:00:00,55,69,-14
5755,5755,54,2022/4/15 10:10:00,47,70,-23
5756,5756,54,2022/4/15 10:20:00,43,76,-33
5757,5757,54,2022/4/15 10:30:00,44,64,-20
5758,5758,54,2022/4/15 10:40:00,39,92,-53
5759,5759,54,2022/4/15 10:50:00,39,75,-36
5760,5760,54,2022/4/15 11:00:00,37,60,-23
5761,5761,54,2022/4/15 11:10:00,38,91,-53
5762,5762,54,2022/4/15 11:20:00,38,81,-43
5763,5763,54,2022/4/15 11:30:00,37,68,-31
5764,5764,54,2022/4/15 11:40:00,45,79,-34
5765,5765,54,2022/4/15 11:50:00,44,75,-31
5766,5766,54,2022/4/15 12:00:00,51,80,-29
5767,5767,54,2022/4/15 12:10:00,46,92,-46
5768,5768,54,2022/4/15 12:20:00,48,74,-26
5769,5769,54,2022/4/15 12:30:00,45,82,-37
5770,5770,54,2022/4/15 12:40:00,45,87,-42
5771,5771,54,2022/4/15 12:50:00,45,75,-30
5772,5772,54,2022/4/15 13:00:00,45,76,-31
5773,5773,54,2022/4/15 13:10:00,45,80,-35
5774,5774,54,2022/4/15 13:20:00,35,73,-38
5775,5775,54,2022/4/15 13:30:00,36,78,-42
5776,5776,54,2022/4/15 13:40:00,37,97,-60
5777,5777,54,2022/4/15 13:50:00,36,76,-40
5778,5778,54,2022/4/15 14:00:00,34,76,-42
5779,5779,54,2022/4/15 14:10:00,37,91,-54
5780,5780,54,2022/4/15 14:20:00,36,87,-51
5781,5781,54,2022/4/15 14:30:00,33,77,-44
5782,5782,54,2022/4/15 14:40:00,31,103,-72
5783,5783,54,2022/4/15 14:50:00,29,101,-72
5784,5784,54,2022/4/15 15:00:00,31,83,-52
5785,5785,54,2022/4/15 15:10:00,34,101,-67
5786,5786,54,2022/4/15 15:20:00,30,105,-75
5787,5787,54,2022/4/15 15:30:00,33,108,-75
5788,5788,54,2022/4/15 15:40:00,31,126,-95
5789,5789,54,2022/4/15 15:50:00,28,120,-92
5790,5790,54,2022/4/15 16:00:00,38,103,-65
5791,5791,54,2022/4/15 16:10:00,37,109,-72
5792,5792,54,2022/4/15 16:20:00,36,108,-72
5793,5793,54,2022/4/15 16:30:00,47,122,-75
5794,5794,54,2022/4/15 16:40:00,50,128,-78
5795,5795,54,2022/4/15 16:50:00,42,117,-75
5796,5796,54,2022/4/15 17:00:00,56,115,-59
5797,5797,54,2022/4/15 17:10:00,73,222,-149
5798,5798,54,2022/4/15 17:20:00,65,214,-149
5799,5799,54,2022/4/15 17:30:00,55,282,-227
5800,5800,54,2022/4/15 17:40:00,68,317,-249
5801,5801,54,2022/4/15 17:50:00,62,431,-369
5802,5802,54,2022/4/15 18:00:00,74,320,-246
5803,5803,54,2022/4/15 18:10:00,63,431,-368
5804,5804,54,2022/4/15 18:20:00,43,503,-460
5805,5805,54,2022/4/15 18:30:00,35,417,-382
5806,5806,54,2022/4/15 18:40:00,30,537,-507
5807,5807,54,2022/4/15 18:50:00,32,433,-401
5808,5808,54,2022/4/15 19:00:00,31,434,-403
5809,5809,54,2022/4/15 19:10:00,27,533,-506
5810,5810,54,2022/4/15 19:20:00,29,283,-254
5811,5811,54,2022/4/15 19:30:00,27,255,-228
5812,5812,54,2022/4/15 19:40:00,27,176,-149
5813,5813,54,2022/4/15 19:50:00,24,190,-166
5814,5814,54,2022/4/15 20:00:00,24,104,-80
5815,5815,54,2022/4/15 20:10:00,28,115,-87
5816,5816,54,2022/4/15 20:20:00,27,128,-101
5817,5817,54,2022/4/15 20:30:00,23,105,-82
5818,5818,54,2022/4/15 20:40:00,26,128,-102
5819,5819,54,2022/4/15 20:50:00,24,119,-95
5820,5820,54,2022/4/15 21:00:00,23,110,-87
5821,5821,54,2022/4/15 21:10:00,22,119,-97
5822,5822,54,2022/4/15 21:20:00,23,109,-86
5823,5823,54,2022/4/15 21:30:00,20,102,-82
5824,5824,54,2022/4/15 21:40:00,20,153,-133
5825,5825,54,2022/4/15 21:50:00,16,109,-93
5826,5826,54,2022/4/15 22:00:00,13,117,-104
5827,5827,54,2022/4/15 22:10:00,6,107,-101
5828,5828,54,2022/4/15 22:20:00,4,100,-96
5829,5829,54,2022/4/15 22:30:00,3,111,-108
5830,5830,54,2022/4/15 22:40:00,2,124,-122
5831,5831,54,2022/4/15 22:50:00,1,109,-108
5832,5832,55,2022/4/15 5:00:00,0,1,-1
5833,5833,55,2022/4/15 5:10:00,0,1,-1
5834,5834,55,2022/4/15 5:20:00,0,1,-1
5835,5835,55,2022/4/15 5:30:00,0,1,-1
5836,5836,55,2022/4/15 5:40:00,3,1,2
5837,5837,55,2022/4/15 5:50:00,10,1,9
5838,5838,55,2022/4/15 6:00:00,9,5,4
5839,5839,55,2022/4/15 6:10:00,11,16,-5
5840,5840,55,2022/4/15 6:20:00,16,14,2
5841,5841,55,2022/4/15 6:30:00,18,23,-5
5842,5842,55,2022/4/15 6:40:00,17,23,-6
5843,5843,55,2022/4/15 6:50:00,20,23,-3
5844,5844,55,2022/4/15 7:00:00,21,32,-11
5845,5845,55,2022/4/15 7:10:00,22,38,-16
5846,5846,55,2022/4/15 7:20:00,31,51,-20
5847,5847,55,2022/4/15 7:30:00,37,69,-32
5848,5848,55,2022/4/15 7:40:00,40,75,-35
5849,5849,55,2022/4/15 7:50:00,34,87,-53
5850,5850,55,2022/4/15 8:00:00,43,78,-35
5851,5851,55,2022/4/15 8:10:00,40,99,-59
5852,5852,55,2022/4/15 8:20:00,38,75,-37
5853,5853,55,2022/4/15 8:30:00,35,76,-41
5854,5854,55,2022/4/15 8:40:00,30,79,-49
5855,5855,55,2022/4/15 8:50:00,24,70,-46
5856,5856,55,2022/4/15 9:00:00,20,49,-29
5857,5857,55,2022/4/15 9:10:00,21,55,-34
5858,5858,55,2022/4/15 9:20:00,19,46,-27
5859,5859,55,2022/4/15 9:30:00,16,47,-31
5860,5860,55,2022/4/15 9:40:00,16,40,-24
5861,5861,55,2022/4/15 9:50:00,14,40,-26
5862,5862,55,2022/4/15 10:00:00,16,38,-22
5863,5863,55,2022/4/15 10:10:00,15,33,-18
5864,5864,55,2022/4/15 10:20:00,16,30,-14
5865,5865,55,2022/4/15 10:30:00,15,40,-25
5866,5866,55,2022/4/15 10:40:00,13,31,-18
5867,5867,55,2022/4/15 10:50:00,13,23,-10
5868,5868,55,2022/4/15 11:00:00,14,38,-24
5869,5869,55,2022/4/15 11:10:00,13,32,-19
5870,5870,55,2022/4/15 11:20:00,13,23,-10
5871,5871,55,2022/4/15 11:30:00,12,34,-22
5872,5872,55,2022/4/15 11:40:00,15,31,-16
5873,5873,55,2022/4/15 11:50:00,14,25,-11
5874,5874,55,2022/4/15 12:00:00,13,25,-12
5875,5875,55,2022/4/15 12:10:00,14,23,-9
5876,5876,55,2022/4/15 12:20:00,13,32,-19
5877,5877,55,2022/4/15 12:30:00,13,38,-25
5878,5878,55,2022/4/15 12:40:00,13,23,-10
5879,5879,55,2022/4/15 12:50:00,15,38,-23
5880,5880,55,2022/4/15 13:00:00,13,40,-27
5881,5881,55,2022/4/15 13:10:00,15,23,-8
5882,5882,55,2022/4/15 13:20:00,12,38,-26
5883,5883,55,2022/4/15 13:30:00,13,38,-25
5884,5884,55,2022/4/15 13:40:00,15,23,-8
5885,5885,55,2022/4/15 13:50:00,15,38,-23
5886,5886,55,2022/4/15 14:00:00,14,37,-23
5887,5887,55,2022/4/15 14:10:00,14,23,-9
5888,5888,55,2022/4/15 14:20:00,14,38,-24
5889,5889,55,2022/4/15 14:30:00,15,38,-23
5890,5890,55,2022/4/15 14:40:00,14,23,-9
5891,5891,55,2022/4/15 14:50:00,14,32,-18
5892,5892,55,2022/4/15 15:00:00,20,33,-13
5893,5893,55,2022/4/15 15:10:00,17,19,-2
5894,5894,55,2022/4/15 15:20:00,19,38,-19
5895,5895,55,2022/4/15 15:30:00,16,37,-21
5896,5896,55,2022/4/15 15:40:00,15,19,-4
5897,5897,55,2022/4/15 15:50:00,16,35,-19
5898,5898,55,2022/4/15 16:00:00,19,37,-18
5899,5899,55,2022/4/15 16:10:00,18,21,-3
5900,5900,55,2022/4/15 16:20:00,18,35,-17
5901,5901,55,2022/4/15 16:30:00,25,37,-12
5902,5902,55,2022/4/15 16:40:00,25,23,2
5903,5903,55,2022/4/15 16:50:00,20,38,-18
5904,5904,55,2022/4/15 17:00:00,44,39,5
5905,5905,55,2022/4/15 17:10:00,33,37,-4
5906,5906,55,2022/4/15 17:20:00,26,38,-12
5907,5907,55,2022/4/15 17:30:00,19,45,-26
5908,5908,55,2022/4/15 17:40:00,28,38,-10
5909,5909,55,2022/4/15 17:50:00,29,51,-22
5910,5910,55,2022/4/15 18:00:00,28,46,-18
5911,5911,55,2022/4/15 18:10:00,24,62,-38
5912,5912,55,2022/4/15 18:20:00,18,52,-34
5913,5913,55,2022/4/15 18:30:00,20,60,-40
5914,5914,55,2022/4/15 18:40:00,15,48,-33
5915,5915,55,2022/4/15 18:50:00,16,67,-51
5916,5916,55,2022/4/15 19:00:00,17,52,-35
5917,5917,55,2022/4/15 19:10:00,13,63,-50
5918,5918,55,2022/4/15 19:20:00,11,40,-29
5919,5919,55,2022/4/15 19:30:00,12,49,-37
5920,5920,55,2022/4/15 19:40:00,9,34,-25
5921,5921,55,2022/4/15 19:50:00,8,25,-17
5922,5922,55,2022/4/15 20:00:00,11,40,-29
5923,5923,55,2022/4/15 20:10:00,7,40,-33
5924,5924,55,2022/4/15 20:20:00,6,27,-21
5925,5925,55,2022/4/15 20:30:00,7,38,-31
5926,5926,55,2022/4/15 20:40:00,9,37,-28
5927,5927,55,2022/4/15 20:50:00,6,27,-21
5928,5928,55,2022/4/15 21:00:00,8,34,-26
5929,5929,55,2022/4/15 21:10:00,6,33,-27
5930,5930,55,2022/4/15 21:20:00,4,35,-31
5931,5931,55,2022/4/15 21:30:00,4,43,-39
5932,5932,55,2022/4/15 21:40:00,2,32,-30
5933,5933,55,2022/4/15 21:50:00,4,44,-40
5934,5934,55,2022/4/15 22:00:00,5,25,-20
5935,5935,55,2022/4/15 22:10:00,2,25,-23
5936,5936,55,2022/4/15 22:20:00,0,40,-40
5937,5937,55,2022/4/15 22:30:00,0,33,-33
5938,5938,55,2022/4/15 22:40:00,0,23,-23
5939,5939,55,2022/4/15 22:50:00,0,34,-34
5940,5940,56,2022/4/15 5:00:00,0,1,-1
5941,5941,56,2022/4/15 5:10:00,4,1,3
5942,5942,56,2022/4/15 5:20:00,15,1,14
5943,5943,56,2022/4/15 5:30:00,12,1,11
5944,5944,56,2022/4/15 5:40:00,15,1,14
5945,5945,56,2022/4/15 5:50:00,20,1,19
5946,5946,56,2022/4/15 6:00:00,30,1,29
5947,5947,56,2022/4/15 6:10:00,35,2,33
5948,5948,56,2022/4/15 6:20:00,44,2,42
5949,5949,56,2022/4/15 6:30:00,70,5,65
5950,5950,56,2022/4/15 6:40:00,108,13,95
5951,5951,56,2022/4/15 6:50:00,147,62,85
5952,5952,56,2022/4/15 7:00:00,227,59,168
5953,5953,56,2022/4/15 7:10:00,245,52,193
5954,5954,56,2022/4/15 7:20:00,343,51,292
5955,5955,56,2022/4/15 7:30:00,325,78,247
5956,5956,56,2022/4/15 7:40:00,572,77,495
5957,5957,56,2022/4/15 7:50:00,632,90,542
5958,5958,56,2022/4/15 8:00:00,662,127,535
5959,5959,56,2022/4/15 8:10:00,392,93,299
5960,5960,56,2022/4/15 8:20:00,330,99,231
5961,5961,56,2022/4/15 8:30:00,284,75,209
5962,5962,56,2022/4/15 8:40:00,226,121,105
5963,5963,56,2022/4/15 8:50:00,168,83,85
5964,5964,56,2022/4/15 9:00:00,96,72,24
5965,5965,56,2022/4/15 9:10:00,68,77,-9
5966,5966,56,2022/4/15 9:20:00,44,99,-55
5967,5967,56,2022/4/15 9:30:00,43,72,-29
5968,5968,56,2022/4/15 9:40:00,38,62,-24
5969,5969,56,2022/4/15 9:50:00,37,74,-37
5970,5970,56,2022/4/15 10:00:00,29,69,-40
5971,5971,56,2022/4/15 10:10:00,29,52,-23
5972,5972,56,2022/4/15 10:20:00,26,65,-39
5973,5973,56,2022/4/15 10:30:00,28,68,-40
5974,5974,56,2022/4/15 10:40:00,28,67,-39
5975,5975,56,2022/4/15 10:50:00,27,66,-39
5976,5976,56,2022/4/15 11:00:00,25,23,2
5977,5977,56,2022/4/15 11:10:00,24,62,-38
5978,5978,56,2022/4/15 11:20:00,29,69,-40
5979,5979,56,2022/4/15 11:30:00,28,71,-43
5980,5980,56,2022/4/15 11:40:00,30,74,-44
5981,5981,56,2022/4/15 11:50:00,28,50,-22
5982,5982,56,2022/4/15 12:00:00,31,45,-14
5983,5983,56,2022/4/15 12:10:00,30,61,-31
5984,5984,56,2022/4/15 12:20:00,32,64,-32
5985,5985,56,2022/4/15 12:30:00,33,74,-41
5986,5986,56,2022/4/15 12:40:00,28,74,-46
5987,5987,56,2022/4/15 12:50:00,27,52,-25
5988,5988,56,2022/4/15 13:00:00,28,55,-27
5989,5989,56,2022/4/15 13:10:00,25,72,-47
5990,5990,56,2022/4/15 13:20:00,28,81,-53
5991,5991,56,2022/4/15 13:30:00,27,68,-41
5992,5992,56,2022/4/15 13:40:00,28,72,-44
5993,5993,56,2022/4/15 13:50:00,24,50,-26
5994,5994,56,2022/4/15 14:00:00,28,63,-35
5995,5995,56,2022/4/15 14:10:00,27,71,-44
5996,5996,56,2022/4/15 14:20:00,27,69,-42
5997,5997,56,2022/4/15 14:30:00,25,77,-52
5998,5998,56,2022/4/15 14:40:00,28,83,-55
5999,5999,56,2022/4/15 14:50:00,27,48,-21
6000,6000,56,2022/4/15 15:00:00,26,66,-40
6001,6001,56,2022/4/15 15:10:00,29,67,-38
6002,6002,56,2022/4/15 15:20:00,26,81,-55
6003,6003,56,2022/4/15 15:30:00,29,83,-54
6004,6004,56,2022/4/15 15:40:00,26,83,-57
6005,6005,56,2022/4/15 15:50:00,27,60,-33
6006,6006,56,2022/4/15 16:00:00,28,64,-36
6007,6007,56,2022/4/15 16:10:00,28,82,-54
6008,6008,56,2022/4/15 16:20:00,26,109,-83
6009,6009,56,2022/4/15 16:30:00,33,103,-70
6010,6010,56,2022/4/15 16:40:00,31,95,-64
6011,6011,56,2022/4/15 16:50:00,31,90,-59
6012,6012,56,2022/4/15 17:00:00,29,107,-78
6013,6013,56,2022/4/15 17:10:00,53,108,-55
6014,6014,56,2022/4/15 17:20:00,42,126,-84
6015,6015,56,2022/4/15 17:30:00,45,106,-61
6016,6016,56,2022/4/15 17:40:00,47,177,-130
6017,6017,56,2022/4/15 17:50:00,47,118,-71
6018,6018,56,2022/4/15 18:00:00,45,119,-74
6019,6019,56,2022/4/15 18:10:00,38,147,-109
6020,6020,56,2022/4/15 18:20:00,32,326,-294
6021,6021,56,2022/4/15 18:30:00,33,180,-147
6022,6022,56,2022/4/15 18:40:00,28,180,-152
6023,6023,56,2022/4/15 18:50:00,26,198,-172
6024,6024,56,2022/4/15 19:00:00,28,328,-300
6025,6025,56,2022/4/15 19:10:00,27,145,-118
6026,6026,56,2022/4/15 19:20:00,21,180,-159
6027,6027,56,2022/4/15 19:30:00,20,97,-77
6028,6028,56,2022/4/15 19:40:00,21,180,-159
6029,6029,56,2022/4/15 19:50:00,19,107,-88
6030,6030,56,2022/4/15 20:00:00,19,106,-87
6031,6031,56,2022/4/15 20:10:00,19,118,-99
6032,6032,56,2022/4/15 20:20:00,17,108,-91
6033,6033,56,2022/4/15 20:30:00,20,90,-70
6034,6034,56,2022/4/15 20:40:00,16,95,-79
6035,6035,56,2022/4/15 20:50:00,19,105,-86
6036,6036,56,2022/4/15 21:00:00,14,104,-90
6037,6037,56,2022/4/15 21:10:00,18,94,-76
6038,6038,56,2022/4/15 21:20:00,16,110,-94
6039,6039,56,2022/4/15 21:30:00,16,75,-59
6040,6040,56,2022/4/15 21:40:00,12,92,-80
6041,6041,56,2022/4/15 21:50:00,10,100,-90
6042,6042,56,2022/4/15 22:00:00,9,72,-63
6043,6043,56,2022/4/15 22:10:00,8,109,-101
6044,6044,56,2022/4/15 22:20:00,5,78,-73
6045,6045,56,2022/4/15 22:30:00,1,90,-89
6046,6046,56,2022/4/15 22:40:00,0,79,-79
6047,6047,56,2022/4/15 22:50:00,0,49,-49
6048,6048,57,2022/4/15 5:00:00,0,1,-1
6049,6049,57,2022/4/15 5:10:00,0,1,-1
6050,6050,57,2022/4/15 5:20:00,0,1,-1
6051,6051,57,2022/4/15 5:30:00,0,1,-1
6052,6052,57,2022/4/15 5:40:00,2,1,1
6053,6053,57,2022/4/15 5:50:00,3,1,2
6054,6054,57,2022/4/15 6:00:00,3,1,2
6055,6055,57,2022/4/15 6:10:00,6,1,5
6056,6056,57,2022/4/15 6:20:00,10,1,9
6057,6057,57,2022/4/15 6:30:00,11,19,-8
6058,6058,57,2022/4/15 6:40:00,15,16,-1
6059,6059,57,2022/4/15 6:50:00,16,21,-5
6060,6060,57,2022/4/15 7:00:00,20,31,-11
6061,6061,57,2022/4/15 7:10:00,23,33,-10
6062,6062,57,2022/4/15 7:20:00,21,64,-43
6063,6063,57,2022/4/15 7:30:00,26,64,-38
6064,6064,57,2022/4/15 7:40:00,31,62,-31
6065,6065,57,2022/4/15 7:50:00,33,103,-70
6066,6066,57,2022/4/15 8:00:00,29,126,-97
6067,6067,57,2022/4/15 8:10:00,32,107,-75
6068,6068,57,2022/4/15 8:20:00,30,97,-67
6069,6069,57,2022/4/15 8:30:00,29,92,-63
6070,6070,57,2022/4/15 8:40:00,27,105,-78
6071,6071,57,2022/4/15 8:50:00,22,96,-74
6072,6072,57,2022/4/15 9:00:00,17,64,-47
6073,6073,57,2022/4/15 9:10:00,14,94,-80
6074,6074,57,2022/4/15 9:20:00,13,77,-64
6075,6075,57,2022/4/15 9:30:00,12,69,-57
6076,6076,57,2022/4/15 9:40:00,12,70,-58
6077,6077,57,2022/4/15 9:50:00,10,74,-64
6078,6078,57,2022/4/15 10:00:00,9,50,-41
6079,6079,57,2022/4/15 10:10:00,12,58,-46
6080,6080,57,2022/4/15 10:20:00,10,37,-27
6081,6081,57,2022/4/15 10:30:00,9,23,-14
6082,6082,57,2022/4/15 10:40:00,10,33,-23
6083,6083,57,2022/4/15 10:50:00,11,23,-12
6084,6084,57,2022/4/15 11:00:00,14,23,-9
6085,6085,57,2022/4/15 11:10:00,10,23,-13
6086,6086,57,2022/4/15 11:20:00,9,21,-12
6087,6087,57,2022/4/15 11:30:00,10,16,-6
6088,6088,57,2022/4/15 11:40:00,13,23,-10
6089,6089,57,2022/4/15 11:50:00,19,19,0
6090,6090,57,2022/4/15 12:00:00,20,23,-3
6091,6091,57,2022/4/15 12:10:00,20,24,-4
6092,6092,57,2022/4/15 12:20:00,16,22,-6
6093,6093,57,2022/4/15 12:30:00,13,23,-10
6094,6094,57,2022/4/15 12:40:00,16,36,-20
6095,6095,57,2022/4/15 12:50:00,12,30,-18
6096,6096,57,2022/4/15 13:00:00,12,32,-20
6097,6097,57,2022/4/15 13:10:00,12,37,-25
6098,6098,57,2022/4/15 13:20:00,12,32,-20
6099,6099,57,2022/4/15 13:30:00,13,34,-21
6100,6100,57,2022/4/15 13:40:00,14,37,-23
6101,6101,57,2022/4/15 13:50:00,14,29,-15
6102,6102,57,2022/4/15 14:00:00,12,33,-21
6103,6103,57,2022/4/15 14:10:00,14,38,-24
6104,6104,57,2022/4/15 14:20:00,15,31,-16
6105,6105,57,2022/4/15 14:30:00,20,23,-3
6106,6106,57,2022/4/15 14:40:00,34,37,-3
6107,6107,57,2022/4/15 14:50:00,29,21,8
6108,6108,57,2022/4/15 15:00:00,18,28,-10
6109,6109,57,2022/4/15 15:10:00,19,31,-12
6110,6110,57,2022/4/15 15:20:00,16,23,-7
6111,6111,57,2022/4/15 15:30:00,22,23,-1
6112,6112,57,2022/4/15 15:40:00,26,33,-7
6113,6113,57,2022/4/15 15:50:00,24,32,-8
6114,6114,57,2022/4/15 16:00:00,19,31,-12
6115,6115,57,2022/4/15 16:10:00,21,36,-15
6116,6116,57,2022/4/15 16:20:00,25,31,-6
6117,6117,57,2022/4/15 16:30:00,25,38,-13
6118,6118,57,2022/4/15 16:40:00,25,38,-13
6119,6119,57,2022/4/15 16:50:00,25,44,-19
6120,6120,57,2022/4/15 17:00:00,35,38,-3
6121,6121,57,2022/4/15 17:10:00,43,52,-9
6122,6122,57,2022/4/15 17:20:00,30,37,-7
6123,6123,57,2022/4/15 17:30:00,32,57,-25
6124,6124,57,2022/4/15 17:40:00,40,49,-9
6125,6125,57,2022/4/15 17:50:00,27,58,-31
6126,6126,57,2022/4/15 18:00:00,35,53,-18
6127,6127,57,2022/4/15 18:10:00,30,61,-31
6128,6128,57,2022/4/15 18:20:00,25,51,-26
6129,6129,57,2022/4/15 18:30:00,27,59,-32
6130,6130,57,2022/4/15 18:40:00,28,50,-22
6131,6131,57,2022/4/15 18:50:00,21,52,-31
6132,6132,57,2022/4/15 19:00:00,20,41,-21
6133,6133,57,2022/4/15 19:10:00,18,43,-25
6134,6134,57,2022/4/15 19:20:00,14,33,-19
6135,6135,57,2022/4/15 19:30:00,12,39,-27
6136,6136,57,2022/4/15 19:40:00,12,25,-13
6137,6137,57,2022/4/15 19:50:00,12,25,-13
6138,6138,57,2022/4/15 20:00:00,10,23,-13
6139,6139,57,2022/4/15 20:10:00,11,27,-16
6140,6140,57,2022/4/15 20:20:00,9,23,-14
6141,6141,57,2022/4/15 20:30:00,10,32,-22
6142,6142,57,2022/4/15 20:40:00,14,25,-11
6143,6143,57,2022/4/15 20:50:00,10,25,-15
6144,6144,57,2022/4/15 21:00:00,7,23,-16
6145,6145,57,2022/4/15 21:10:00,6,25,-19
6146,6146,57,2022/4/15 21:20:00,8,25,-17
6147,6147,57,2022/4/15 21:30:00,5,25,-20
6148,6148,57,2022/4/15 21:40:00,7,25,-18
6149,6149,57,2022/4/15 21:50:00,6,27,-21
6150,6150,57,2022/4/15 22:00:00,5,23,-18
6151,6151,57,2022/4/15 22:10:00,4,18,-14
6152,6152,57,2022/4/15 22:20:00,2,21,-19
6153,6153,57,2022/4/15 22:30:00,1,21,-20
6154,6154,57,2022/4/15 22:40:00,1,15,-14
6155,6155,57,2022/4/15 22:50:00,0,3,-3
6156,6156,58,2022/4/15 5:00:00,0,1,-1
6157,6157,58,2022/4/15 5:10:00,0,1,-1
6158,6158,58,2022/4/15 5:20:00,0,1,-1
6159,6159,58,2022/4/15 5:30:00,18,1,17
6160,6160,58,2022/4/15 5:40:00,21,1,20
6161,6161,58,2022/4/15 5:50:00,19,1,18
6162,6162,58,2022/4/15 6:00:00,22,1,21
6163,6163,58,2022/4/15 6:10:00,30,1,29
6164,6164,58,2022/4/15 6:20:00,36,1,35
6165,6165,58,2022/4/15 6:30:00,57,1,56
6166,6166,58,2022/4/15 6:40:00,78,1,77
6167,6167,58,2022/4/15 6:50:00,111,38,73
6168,6168,58,2022/4/15 7:00:00,183,38,145
6169,6169,58,2022/4/15 7:10:00,180,45,135
6170,6170,58,2022/4/15 7:20:00,207,11,196
6171,6171,58,2022/4/15 7:30:00,219,59,160
6172,6172,58,2022/4/15 7:40:00,200,46,154
6173,6173,58,2022/4/15 7:50:00,200,65,135
6174,6174,58,2022/4/15 8:00:00,162,64,98
6175,6175,58,2022/4/15 8:10:00,107,93,14
6176,6176,58,2022/4/15 8:20:00,85,121,-36
6177,6177,58,2022/4/15 8:30:00,51,95,-44
6178,6178,58,2022/4/15 8:40:00,54,75,-21
6179,6179,58,2022/4/15 8:50:00,34,66,-32
6180,6180,58,2022/4/15 9:00:00,37,79,-42
6181,6181,58,2022/4/15 9:10:00,32,57,-25
6182,6182,58,2022/4/15 9:20:00,30,46,-16
6183,6183,58,2022/4/15 9:30:00,27,60,-33
6184,6184,58,2022/4/15 9:40:00,29,50,-21
6185,6185,58,2022/4/15 9:50:00,27,40,-13
6186,6186,58,2022/4/15 10:00:00,25,40,-15
6187,6187,58,2022/4/15 10:10:00,25,46,-21
6188,6188,58,2022/4/15 10:20:00,26,61,-35
6189,6189,58,2022/4/15 10:30:00,22,22,0
6190,6190,58,2022/4/15 10:40:00,22,38,-16
6191,6191,58,2022/4/15 10:50:00,21,62,-41
6192,6192,58,2022/4/15 11:00:00,21,51,-30
6193,6193,58,2022/4/15 11:10:00,18,12,6
6194,6194,58,2022/4/15 11:20:00,23,51,-28
6195,6195,58,2022/4/15 11:30:00,22,42,-20
6196,6196,58,2022/4/15 11:40:00,21,45,-24
6197,6197,58,2022/4/15 11:50:00,21,49,-28
6198,6198,58,2022/4/15 12:00:00,22,50,-28
6199,6199,58,2022/4/15 12:10:00,26,54,-28
6200,6200,58,2022/4/15 12:20:00,28,12,16
6201,6201,58,2022/4/15 12:30:00,24,54,-30
6202,6202,58,2022/4/15 12:40:00,21,52,-31
6203,6203,58,2022/4/15 12:50:00,25,61,-36
6204,6204,58,2022/4/15 13:00:00,22,54,-32
6205,6205,58,2022/4/15 13:10:00,28,44,-16
6206,6206,58,2022/4/15 13:20:00,20,25,-5
6207,6207,58,2022/4/15 13:30:00,21,58,-37
6208,6208,58,2022/4/15 13:40:00,20,52,-32
6209,6209,58,2022/4/15 13:50:00,18,57,-39
6210,6210,58,2022/4/15 14:00:00,22,50,-28
6211,6211,58,2022/4/15 14:10:00,15,37,-22
6212,6212,58,2022/4/15 14:20:00,17,37,-20
6213,6213,58,2022/4/15 14:30:00,21,48,-27
6214,6214,58,2022/4/15 14:40:00,21,54,-33
6215,6215,58,2022/4/15 14:50:00,19,52,-33
6216,6216,58,2022/4/15 15:00:00,21,61,-40
6217,6217,58,2022/4/15 15:10:00,21,37,-16
6218,6218,58,2022/4/15 15:20:00,24,70,-46
6219,6219,58,2022/4/15 15:30:00,22,25,-3
6220,6220,58,2022/4/15 15:40:00,18,66,-48
6221,6221,58,2022/4/15 15:50:00,23,64,-41
6222,6222,58,2022/4/15 16:00:00,21,66,-45
6223,6223,58,2022/4/15 16:10:00,20,50,-30
6224,6224,58,2022/4/15 16:20:00,21,36,-15
6225,6225,58,2022/4/15 16:30:00,25,60,-35
6226,6226,58,2022/4/15 16:40:00,24,85,-61
6227,6227,58,2022/4/15 16:50:00,27,74,-47
6228,6228,58,2022/4/15 17:00:00,26,69,-43
6229,6229,58,2022/4/15 17:10:00,25,70,-45
6230,6230,58,2022/4/15 17:20:00,25,49,-24
6231,6231,58,2022/4/15 17:30:00,29,88,-59
6232,6232,58,2022/4/15 17:40:00,36,90,-54
6233,6233,58,2022/4/15 17:50:00,33,93,-60
6234,6234,58,2022/4/15 18:00:00,31,104,-73
6235,6235,58,2022/4/15 18:10:00,31,93,-62
6236,6236,58,2022/4/15 18:20:00,29,95,-66
6237,6237,58,2022/4/15 18:30:00,25,115,-90
6238,6238,58,2022/4/15 18:40:00,28,128,-100
6239,6239,58,2022/4/15 18:50:00,26,114,-88
6240,6240,58,2022/4/15 19:00:00,23,107,-84
6241,6241,58,2022/4/15 19:10:00,21,112,-91
6242,6242,58,2022/4/15 19:20:00,19,109,-90
6243,6243,58,2022/4/15 19:30:00,14,108,-94
6244,6244,58,2022/4/15 19:40:00,13,113,-100
6245,6245,58,2022/4/15 19:50:00,16,100,-84
6246,6246,58,2022/4/15 20:00:00,15,129,-114
6247,6247,58,2022/4/15 20:10:00,15,77,-62
6248,6248,58,2022/4/15 20:20:00,12,74,-62
6249,6249,58,2022/4/15 20:30:00,13,83,-70
6250,6250,58,2022/4/15 20:40:00,9,76,-67
6251,6251,58,2022/4/15 20:50:00,9,77,-68
6252,6252,58,2022/4/15 21:00:00,10,18,-8
6253,6253,58,2022/4/15 21:10:00,13,74,-61
6254,6254,58,2022/4/15 21:20:00,12,71,-59
6255,6255,58,2022/4/15 21:30:00,8,79,-71
6256,6256,58,2022/4/15 21:40:00,1,31,-30
6257,6257,58,2022/4/15 21:50:00,2,69,-67
6258,6258,58,2022/4/15 22:00:00,1,74,-73
6259,6259,58,2022/4/15 22:10:00,2,74,-72
6260,6260,58,2022/4/15 22:20:00,2,4,-2
6261,6261,58,2022/4/15 22:30:00,1,68,-67
6262,6262,58,2022/4/15 22:40:00,0,61,-61
6263,6263,58,2022/4/15 22:50:00,1,3,-2
6264,6264,59,2022/4/15 5:00:00,0,1,-1
6265,6265,59,2022/4/15 5:10:00,0,1,-1
6266,6266,59,2022/4/15 5:20:00,0,1,-1
6267,6267,59,2022/4/15 5:30:00,0,1,-1
6268,6268,59,2022/4/15 5:40:00,2,1,1
6269,6269,59,2022/4/15 5:50:00,14,1,13
6270,6270,59,2022/4/15 6:00:00,29,2,27
6271,6271,59,2022/4/15 6:10:00,31,29,2
6272,6272,59,2022/4/15 6:20:00,35,32,3
6273,6273,59,2022/4/15 6:30:00,33,32,1
6274,6274,59,2022/4/15 6:40:00,54,38,16
6275,6275,59,2022/4/15 6:50:00,70,37,33
6276,6276,59,2022/4/15 7:00:00,88,50,38
6277,6277,59,2022/4/15 7:10:00,157,52,105
6278,6278,59,2022/4/15 7:20:00,186,65,121
6279,6279,59,2022/4/15 7:30:00,227,72,155
6280,6280,59,2022/4/15 7:40:00,276,80,196
6281,6281,59,2022/4/15 7:50:00,277,92,185
6282,6282,59,2022/4/15 8:00:00,318,104,214
6283,6283,59,2022/4/15 8:10:00,278,106,172
6284,6284,59,2022/4/15 8:20:00,233,104,129
6285,6285,59,2022/4/15 8:30:00,215,108,107
6286,6286,59,2022/4/15 8:40:00,199,124,75
6287,6287,59,2022/4/15 8:50:00,123,90,33
6288,6288,59,2022/4/15 9:00:00,76,95,-19
6289,6289,59,2022/4/15 9:10:00,63,77,-14
6290,6290,59,2022/4/15 9:20:00,50,62,-12
6291,6291,59,2022/4/15 9:30:00,43,70,-27
6292,6292,59,2022/4/15 9:40:00,39,71,-32
6293,6293,59,2022/4/15 9:50:00,35,79,-44
6294,6294,59,2022/4/15 10:00:00,32,69,-37
6295,6295,59,2022/4/15 10:10:00,26,60,-34
6296,6296,59,2022/4/15 10:20:00,26,71,-45
6297,6297,59,2022/4/15 10:30:00,22,72,-50
6298,6298,59,2022/4/15 10:40:00,23,53,-30
6299,6299,59,2022/4/15 10:50:00,29,70,-41
6300,6300,59,2022/4/15 11:00:00,29,68,-39
6301,6301,59,2022/4/15 11:10:00,28,52,-24
6302,6302,59,2022/4/15 11:20:00,25,60,-35
6303,6303,59,2022/4/15 11:30:00,30,64,-34
6304,6304,59,2022/4/15 11:40:00,31,60,-29
6305,6305,59,2022/4/15 11:50:00,27,65,-38
6306,6306,59,2022/4/15 12:00:00,34,52,-18
6307,6307,59,2022/4/15 12:10:00,31,66,-35
6308,6308,59,2022/4/15 12:20:00,33,63,-30
6309,6309,59,2022/4/15 12:30:00,37,57,-20
6310,6310,59,2022/4/15 12:40:00,30,72,-42
6311,6311,59,2022/4/15 12:50:00,27,61,-34
6312,6312,59,2022/4/15 13:00:00,30,65,-35
6313,6313,59,2022/4/15 13:10:00,28,72,-44
6314,6314,59,2022/4/15 13:20:00,26,74,-48
6315,6315,59,2022/4/15 13:30:00,29,60,-31
6316,6316,59,2022/4/15 13:40:00,28,71,-43
6317,6317,59,2022/4/15 13:50:00,28,66,-38
6318,6318,59,2022/4/15 14:00:00,29,70,-41
6319,6319,59,2022/4/15 14:10:00,30,82,-52
6320,6320,59,2022/4/15 14:20:00,26,64,-38
6321,6321,59,2022/4/15 14:30:00,28,65,-37
6322,6322,59,2022/4/15 14:40:00,25,85,-60
6323,6323,59,2022/4/15 14:50:00,29,69,-40
6324,6324,59,2022/4/15 15:00:00,29,62,-33
6325,6325,59,2022/4/15 15:10:00,28,77,-49
6326,6326,59,2022/4/15 15:20:00,28,67,-39
6327,6327,59,2022/4/15 15:30:00,28,60,-32
6328,6328,59,2022/4/15 15:40:00,30,74,-44
6329,6329,59,2022/4/15 15:50:00,32,76,-44
6330,6330,59,2022/4/15 16:00:00,32,68,-36
6331,6331,59,2022/4/15 16:10:00,29,77,-48
6332,6332,59,2022/4/15 16:20:00,26,87,-61
6333,6333,59,2022/4/15 16:30:00,33,69,-36
6334,6334,59,2022/4/15 16:40:00,41,91,-50
6335,6335,59,2022/4/15 16:50:00,33,92,-59
6336,6336,59,2022/4/15 17:00:00,39,93,-54
6337,6337,59,2022/4/15 17:10:00,41,108,-67
6338,6338,59,2022/4/15 17:20:00,39,105,-66
6339,6339,59,2022/4/15 17:30:00,38,125,-87
6340,6340,59,2022/4/15 17:40:00,54,103,-49
6341,6341,59,2022/4/15 17:50:00,43,105,-62
6342,6342,59,2022/4/15 18:00:00,70,110,-40
6343,6343,59,2022/4/15 18:10:00,45,109,-64
6344,6344,59,2022/4/15 18:20:00,46,105,-59
6345,6345,59,2022/4/15 18:30:00,32,107,-75
6346,6346,59,2022/4/15 18:40:00,26,109,-83
6347,6347,59,2022/4/15 18:50:00,29,104,-75
6348,6348,59,2022/4/15 19:00:00,26,125,-99
6349,6349,59,2022/4/15 19:10:00,22,110,-88
6350,6350,59,2022/4/15 19:20:00,23,100,-77
6351,6351,59,2022/4/15 19:30:00,19,101,-82
6352,6352,59,2022/4/15 19:40:00,21,86,-65
6353,6353,59,2022/4/15 19:50:00,19,80,-61
6354,6354,59,2022/4/15 20:00:00,19,62,-43
6355,6355,59,2022/4/15 20:10:00,23,71,-48
6356,6356,59,2022/4/15 20:20:00,23,78,-55
6357,6357,59,2022/4/15 20:30:00,19,64,-45
6358,6358,59,2022/4/15 20:40:00,21,84,-63
6359,6359,59,2022/4/15 20:50:00,22,66,-44
6360,6360,59,2022/4/15 21:00:00,18,84,-66
6361,6361,59,2022/4/15 21:10:00,18,68,-50
6362,6362,59,2022/4/15 21:20:00,16,78,-62
6363,6363,59,2022/4/15 21:30:00,17,62,-45
6364,6364,59,2022/4/15 21:40:00,15,75,-60
6365,6365,59,2022/4/15 21:50:00,12,69,-57
6366,6366,59,2022/4/15 22:00:00,13,66,-53
6367,6367,59,2022/4/15 22:10:00,12,73,-61
6368,6368,59,2022/4/15 22:20:00,7,66,-59
6369,6369,59,2022/4/15 22:30:00,3,62,-59
6370,6370,59,2022/4/15 22:40:00,2,62,-60
6371,6371,59,2022/4/15 22:50:00,1,39,-38
6372,6372,60,2022/4/15 5:00:00,0,1,-1
6373,6373,60,2022/4/15 5:10:00,0,1,-1
6374,6374,60,2022/4/15 5:20:00,0,1,-1
6375,6375,60,2022/4/15 5:30:00,0,1,-1
6376,6376,60,2022/4/15 5:40:00,3,1,2
6377,6377,60,2022/4/15 5:50:00,8,1,7
6378,6378,60,2022/4/15 6:00:00,20,1,19
6379,6379,60,2022/4/15 6:10:00,37,13,24
6380,6380,60,2022/4/15 6:20:00,35,21,14
6381,6381,60,2022/4/15 6:30:00,45,23,22
6382,6382,60,2022/4/15 6:40:00,53,21,32
6383,6383,60,2022/4/15 6:50:00,73,33,40
6384,6384,60,2022/4/15 7:00:00,99,38,61
6385,6385,60,2022/4/15 7:10:00,154,49,105
6386,6386,60,2022/4/15 7:20:00,196,62,134
6387,6387,60,2022/4/15 7:30:00,245,72,173
6388,6388,60,2022/4/15 7:40:00,282,81,201
6389,6389,60,2022/4/15 7:50:00,360,90,270
6390,6390,60,2022/4/15 8:00:00,343,90,253
6391,6391,60,2022/4/15 8:10:00,279,103,176
6392,6392,60,2022/4/15 8:20:00,253,75,178
6393,6393,60,2022/4/15 8:30:00,192,64,128
6394,6394,60,2022/4/15 8:40:00,154,67,87
6395,6395,60,2022/4/15 8:50:00,79,61,18
6396,6396,60,2022/4/15 9:00:00,52,54,-2
6397,6397,60,2022/4/15 9:10:00,48,60,-12
6398,6398,60,2022/4/15 9:20:00,40,45,-5
6399,6399,60,2022/4/15 9:30:00,29,57,-28
6400,6400,60,2022/4/15 9:40:00,28,50,-22
6401,6401,60,2022/4/15 9:50:00,27,38,-11
6402,6402,60,2022/4/15 10:00:00,28,45,-17
6403,6403,60,2022/4/15 10:10:00,26,38,-12
6404,6404,60,2022/4/15 10:20:00,20,42,-22
6405,6405,60,2022/4/15 10:30:00,22,46,-24
6406,6406,60,2022/4/15 10:40:00,19,46,-27
6407,6407,60,2022/4/15 10:50:00,19,38,-19
6408,6408,60,2022/4/15 11:00:00,22,38,-16
6409,6409,60,2022/4/15 11:10:00,17,46,-29
6410,6410,60,2022/4/15 11:20:00,22,45,-23
6411,6411,60,2022/4/15 11:30:00,21,41,-20
6412,6412,60,2022/4/15 11:40:00,22,46,-24
6413,6413,60,2022/4/15 11:50:00,23,45,-22
6414,6414,60,2022/4/15 12:00:00,24,41,-17
6415,6415,60,2022/4/15 12:10:00,24,45,-21
6416,6416,60,2022/4/15 12:20:00,26,44,-18
6417,6417,60,2022/4/15 12:30:00,22,40,-18
6418,6418,60,2022/4/15 12:40:00,23,48,-25
6419,6419,60,2022/4/15 12:50:00,22,45,-23
6420,6420,60,2022/4/15 13:00:00,23,51,-28
6421,6421,60,2022/4/15 13:10:00,23,45,-22
6422,6422,60,2022/4/15 13:20:00,20,48,-28
6423,6423,60,2022/4/15 13:30:00,17,50,-33
6424,6424,60,2022/4/15 13:40:00,21,50,-29
6425,6425,60,2022/4/15 13:50:00,18,49,-31
6426,6426,60,2022/4/15 14:00:00,20,45,-25
6427,6427,60,2022/4/15 14:10:00,16,58,-42
6428,6428,60,2022/4/15 14:20:00,18,49,-31
6429,6429,60,2022/4/15 14:30:00,20,58,-38
6430,6430,60,2022/4/15 14:40:00,20,54,-34
6431,6431,60,2022/4/15 14:50:00,21,49,-28
6432,6432,60,2022/4/15 15:00:00,19,54,-35
6433,6433,60,2022/4/15 15:10:00,21,56,-35
6434,6434,60,2022/4/15 15:20:00,23,61,-38
6435,6435,60,2022/4/15 15:30:00,24,61,-37
6436,6436,60,2022/4/15 15:40:00,19,59,-40
6437,6437,60,2022/4/15 15:50:00,22,67,-45
6438,6438,60,2022/4/15 16:00:00,27,69,-42
6439,6439,60,2022/4/15 16:10:00,28,72,-44
6440,6440,60,2022/4/15 16:20:00,25,72,-47
6441,6441,60,2022/4/15 16:30:00,27,70,-43
6442,6442,60,2022/4/15 16:40:00,28,73,-45
6443,6443,60,2022/4/15 16:50:00,25,83,-58
6444,6444,60,2022/4/15 17:00:00,41,76,-35
6445,6445,60,2022/4/15 17:10:00,43,105,-62
6446,6446,60,2022/4/15 17:20:00,31,102,-71
6447,6447,60,2022/4/15 17:30:00,27,122,-95
6448,6448,60,2022/4/15 17:40:00,25,121,-96
6449,6449,60,2022/4/15 17:50:00,28,123,-95
6450,6450,60,2022/4/15 18:00:00,28,111,-83
6451,6451,60,2022/4/15 18:10:00,25,181,-156
6452,6452,60,2022/4/15 18:20:00,24,143,-119
6453,6453,60,2022/4/15 18:30:00,21,181,-160
6454,6454,60,2022/4/15 18:40:00,23,124,-101
6455,6455,60,2022/4/15 18:50:00,17,109,-92
6456,6456,60,2022/4/15 19:00:00,17,109,-92
6457,6457,60,2022/4/15 19:10:00,20,124,-104
6458,6458,60,2022/4/15 19:20:00,17,104,-87
6459,6459,60,2022/4/15 19:30:00,17,98,-81
6460,6460,60,2022/4/15 19:40:00,13,93,-80
6461,6461,60,2022/4/15 19:50:00,13,77,-64
6462,6462,60,2022/4/15 20:00:00,13,83,-70
6463,6463,60,2022/4/15 20:10:00,14,87,-73
6464,6464,60,2022/4/15 20:20:00,13,64,-51
6465,6465,60,2022/4/15 20:30:00,15,77,-62
6466,6466,60,2022/4/15 20:40:00,14,73,-59
6467,6467,60,2022/4/15 20:50:00,14,71,-57
6468,6468,60,2022/4/15 21:00:00,13,71,-58
6469,6469,60,2022/4/15 21:10:00,12,84,-72
6470,6470,60,2022/4/15 21:20:00,11,71,-60
6471,6471,60,2022/4/15 21:30:00,8,70,-62
6472,6472,60,2022/4/15 21:40:00,8,78,-70
6473,6473,60,2022/4/15 21:50:00,9,83,-74
6474,6474,60,2022/4/15 22:00:00,6,70,-64
6475,6475,60,2022/4/15 22:10:00,5,67,-62
6476,6476,60,2022/4/15 22:20:00,1,74,-73
6477,6477,60,2022/4/15 22:30:00,2,49,-47
6478,6478,60,2022/4/15 22:40:00,0,3,-3
6479,6479,60,2022/4/15 22:50:00,0,3,-3
6480,6480,61,2022/4/15 5:00:00,0,1,-1
6481,6481,61,2022/4/15 5:10:00,0,1,-1
6482,6482,61,2022/4/15 5:20:00,0,1,-1
6483,6483,61,2022/4/15 5:30:00,0,1,-1
6484,6484,61,2022/4/15 5:40:00,1,1,0
6485,6485,61,2022/4/15 5:50:00,5,1,4
6486,6486,61,2022/4/15 6:00:00,26,1,25
6487,6487,61,2022/4/15 6:10:00,37,5,32
6488,6488,61,2022/4/15 6:20:00,41,21,20
6489,6489,61,2022/4/15 6:30:00,54,21,33
6490,6490,61,2022/4/15 6:40:00,60,23,37
6491,6491,61,2022/4/15 6:50:00,81,45,36
6492,6492,61,2022/4/15 7:00:00,151,47,104
6493,6493,61,2022/4/15 7:10:00,185,49,136
6494,6494,61,2022/4/15 7:20:00,236,51,185
6495,6495,61,2022/4/15 7:30:00,277,55,222
6496,6496,61,2022/4/15 7:40:00,303,51,252
6497,6497,61,2022/4/15 7:50:00,339,46,293
6498,6498,61,2022/4/15 8:00:00,359,41,318
6499,6499,61,2022/4/15 8:10:00,327,46,281
6500,6500,61,2022/4/15 8:20:00,283,44,239
6501,6501,61,2022/4/15 8:30:00,230,37,193
6502,6502,61,2022/4/15 8:40:00,127,37,90
6503,6503,61,2022/4/15 8:50:00,87,24,63
6504,6504,61,2022/4/15 9:00:00,53,29,24
6505,6505,61,2022/4/15 9:10:00,48,29,19
6506,6506,61,2022/4/15 9:20:00,34,37,-3
6507,6507,61,2022/4/15 9:30:00,29,29,0
6508,6508,61,2022/4/15 9:40:00,27,32,-5
6509,6509,61,2022/4/15 9:50:00,28,32,-4
6510,6510,61,2022/4/15 10:00:00,23,23,0
6511,6511,61,2022/4/15 10:10:00,19,19,0
6512,6512,61,2022/4/15 10:20:00,20,42,-22
6513,6513,61,2022/4/15 10:30:00,18,32,-14
6514,6514,61,2022/4/15 10:40:00,18,23,-5
6515,6515,61,2022/4/15 10:50:00,15,29,-14
6516,6516,61,2022/4/15 11:00:00,19,32,-13
6517,6517,61,2022/4/15 11:10:00,15,33,-18
6518,6518,61,2022/4/15 11:20:00,14,32,-18
6519,6519,61,2022/4/15 11:30:00,15,38,-23
6520,6520,61,2022/4/15 11:40:00,17,32,-15
6521,6521,61,2022/4/15 11:50:00,18,38,-20
6522,6522,61,2022/4/15 12:00:00,19,35,-16
6523,6523,61,2022/4/15 12:10:00,21,34,-13
6524,6524,61,2022/4/15 12:20:00,21,38,-17
6525,6525,61,2022/4/15 12:30:00,17,38,-21
6526,6526,61,2022/4/15 12:40:00,17,38,-21
6527,6527,61,2022/4/15 12:50:00,18,38,-20
6528,6528,61,2022/4/15 13:00:00,18,34,-16
6529,6529,61,2022/4/15 13:10:00,15,32,-17
6530,6530,61,2022/4/15 13:20:00,16,38,-22
6531,6531,61,2022/4/15 13:30:00,17,38,-21
6532,6532,61,2022/4/15 13:40:00,12,36,-24
6533,6533,61,2022/4/15 13:50:00,14,46,-32
6534,6534,61,2022/4/15 14:00:00,13,38,-25
6535,6535,61,2022/4/15 14:10:00,16,46,-30
6536,6536,61,2022/4/15 14:20:00,13,47,-34
6537,6537,61,2022/4/15 14:30:00,14,43,-29
6538,6538,61,2022/4/15 14:40:00,12,45,-33
6539,6539,61,2022/4/15 14:50:00,14,51,-37
6540,6540,61,2022/4/15 15:00:00,13,42,-29
6541,6541,61,2022/4/15 15:10:00,14,56,-42
6542,6542,61,2022/4/15 15:20:00,15,49,-34
6543,6543,61,2022/4/15 15:30:00,14,61,-47
6544,6544,61,2022/4/15 15:40:00,14,61,-47
6545,6545,61,2022/4/15 15:50:00,14,57,-43
6546,6546,61,2022/4/15 16:00:00,16,71,-55
6547,6547,61,2022/4/15 16:10:00,14,70,-56
6548,6548,61,2022/4/15 16:20:00,17,75,-58
6549,6549,61,2022/4/15 16:30:00,20,67,-47
6550,6550,61,2022/4/15 16:40:00,27,77,-50
6551,6551,61,2022/4/15 16:50:00,27,93,-66
6552,6552,61,2022/4/15 17:00:00,29,90,-61
6553,6553,61,2022/4/15 17:10:00,29,106,-77
6554,6554,61,2022/4/15 17:20:00,22,102,-80
6555,6555,61,2022/4/15 17:30:00,20,96,-76
6556,6556,61,2022/4/15 17:40:00,14,110,-96
6557,6557,61,2022/4/15 17:50:00,18,111,-93
6558,6558,61,2022/4/15 18:00:00,15,104,-89
6559,6559,61,2022/4/15 18:10:00,16,117,-101
6560,6560,61,2022/4/15 18:20:00,14,117,-103
6561,6561,61,2022/4/15 18:30:00,13,116,-103
6562,6562,61,2022/4/15 18:40:00,13,121,-108
6563,6563,61,2022/4/15 18:50:00,14,124,-110
6564,6564,61,2022/4/15 19:00:00,12,106,-94
6565,6565,61,2022/4/15 19:10:00,11,103,-92
6566,6566,61,2022/4/15 19:20:00,11,107,-96
6567,6567,61,2022/4/15 19:30:00,8,111,-103
6568,6568,61,2022/4/15 19:40:00,8,91,-83
6569,6569,61,2022/4/15 19:50:00,9,77,-68
6570,6570,61,2022/4/15 20:00:00,9,76,-67
6571,6571,61,2022/4/15 20:10:00,8,78,-70
6572,6572,61,2022/4/15 20:20:00,9,77,-68
6573,6573,61,2022/4/15 20:30:00,11,70,-59
6574,6574,61,2022/4/15 20:40:00,6,85,-79
6575,6575,61,2022/4/15 20:50:00,11,55,-44
6576,6576,61,2022/4/15 21:00:00,8,68,-60
6577,6577,61,2022/4/15 21:10:00,8,66,-58
6578,6578,61,2022/4/15 21:20:00,5,72,-67
6579,6579,61,2022/4/15 21:30:00,4,66,-62
6580,6580,61,2022/4/15 21:40:00,4,61,-57
6581,6581,61,2022/4/15 21:50:00,4,71,-67
6582,6582,61,2022/4/15 22:00:00,2,71,-69
6583,6583,61,2022/4/15 22:10:00,1,68,-67
6584,6584,61,2022/4/15 22:20:00,0,49,-49
6585,6585,61,2022/4/15 22:30:00,0,53,-53
6586,6586,61,2022/4/15 22:40:00,0,36,-36
6587,6587,61,2022/4/15 22:50:00,0,3,-3
6588,6588,62,2022/4/15 5:00:00,0,1,-1
6589,6589,62,2022/4/15 5:10:00,0,1,-1
6590,6590,62,2022/4/15 5:20:00,0,1,-1
6591,6591,62,2022/4/15 5:30:00,0,1,-1
6592,6592,62,2022/4/15 5:40:00,0,1,-1
6593,6593,62,2022/4/15 5:50:00,1,1,0
6594,6594,62,2022/4/15 6:00:00,2,1,1
6595,6595,62,2022/4/15 6:10:00,6,22,-16
6596,6596,62,2022/4/15 6:20:00,6,38,-32
6597,6597,62,2022/4/15 6:30:00,8,42,-34
6598,6598,62,2022/4/15 6:40:00,8,75,-67
6599,6599,62,2022/4/15 6:50:00,10,66,-56
6600,6600,62,2022/4/15 7:00:00,16,111,-95
6601,6601,62,2022/4/15 7:10:00,18,64,-46
6602,6602,62,2022/4/15 7:20:00,10,46,-36
6603,6603,62,2022/4/15 7:30:00,12,34,-22
6604,6604,62,2022/4/15 7:40:00,14,63,-49
6605,6605,62,2022/4/15 7:50:00,18,61,-43
6606,6606,62,2022/4/15 8:00:00,19,69,-50
6607,6607,62,2022/4/15 8:10:00,15,62,-47
6608,6608,62,2022/4/15 8:20:00,14,67,-53
6609,6609,62,2022/4/15 8:30:00,12,33,-21
6610,6610,62,2022/4/15 8:40:00,11,42,-31
6611,6611,62,2022/4/15 8:50:00,6,23,-17
6612,6612,62,2022/4/15 9:00:00,4,23,-19
6613,6613,62,2022/4/15 9:10:00,4,23,-19
6614,6614,62,2022/4/15 9:20:00,4,25,-21
6615,6615,62,2022/4/15 9:30:00,7,19,-12
6616,6616,62,2022/4/15 9:40:00,2,21,-19
6617,6617,62,2022/4/15 9:50:00,4,23,-19
6618,6618,62,2022/4/15 10:00:00,6,23,-17
6619,6619,62,2022/4/15 10:10:00,2,23,-21
6620,6620,62,2022/4/15 10:20:00,5,19,-14
6621,6621,62,2022/4/15 10:30:00,4,22,-18
6622,6622,62,2022/4/15 10:40:00,4,19,-15
6623,6623,62,2022/4/15 10:50:00,2,19,-17
6624,6624,62,2022/4/15 11:00:00,7,17,-10
6625,6625,62,2022/4/15 11:10:00,7,16,-9
6626,6626,62,2022/4/15 11:20:00,5,16,-11
6627,6627,62,2022/4/15 11:30:00,6,14,-8
6628,6628,62,2022/4/15 11:40:00,5,15,-10
6629,6629,62,2022/4/15 11:50:00,7,18,-11
6630,6630,62,2022/4/15 12:00:00,4,15,-11
6631,6631,62,2022/4/15 12:10:00,8,18,-10
6632,6632,62,2022/4/15 12:20:00,5,19,-14
6633,6633,62,2022/4/15 12:30:00,4,14,-10
6634,6634,62,2022/4/15 12:40:00,4,14,-10
6635,6635,62,2022/4/15 12:50:00,7,16,-9
6636,6636,62,2022/4/15 13:00:00,6,19,-13
6637,6637,62,2022/4/15 13:10:00,2,18,-16
6638,6638,62,2022/4/15 13:20:00,7,21,-14
6639,6639,62,2022/4/15 13:30:00,7,12,-5
6640,6640,62,2022/4/15 13:40:00,6,15,-9
6641,6641,62,2022/4/15 13:50:00,3,19,-16
6642,6642,62,2022/4/15 14:00:00,5,16,-11
6643,6643,62,2022/4/15 14:10:00,7,14,-7
6644,6644,62,2022/4/15 14:20:00,6,16,-10
6645,6645,62,2022/4/15 14:30:00,7,8,-1
6646,6646,62,2022/4/15 14:40:00,4,8,-4
6647,6647,62,2022/4/15 14:50:00,8,12,-4
6648,6648,62,2022/4/15 15:00:00,9,12,-3
6649,6649,62,2022/4/15 15:10:00,8,12,-4
6650,6650,62,2022/4/15 15:20:00,9,12,-3
6651,6651,62,2022/4/15 15:30:00,8,8,0
6652,6652,62,2022/4/15 15:40:00,10,12,-2
6653,6653,62,2022/4/15 15:50:00,8,16,-8
6654,6654,62,2022/4/15 16:00:00,11,11,0
6655,6655,62,2022/4/15 16:10:00,14,12,2
6656,6656,62,2022/4/15 16:20:00,13,14,-1
6657,6657,62,2022/4/15 16:30:00,26,8,18
6658,6658,62,2022/4/15 16:40:00,51,23,28
6659,6659,62,2022/4/15 16:50:00,32,23,9
6660,6660,62,2022/4/15 17:00:00,30,21,9
6661,6661,62,2022/4/15 17:10:00,26,19,7
6662,6662,62,2022/4/15 17:20:00,20,23,-3
6663,6663,62,2022/4/15 17:30:00,15,23,-8
6664,6664,62,2022/4/15 17:40:00,15,23,-8
6665,6665,62,2022/4/15 17:50:00,11,23,-12
6666,6666,62,2022/4/15 18:00:00,13,32,-19
6667,6667,62,2022/4/15 18:10:00,13,26,-13
6668,6668,62,2022/4/15 18:20:00,12,27,-15
6669,6669,62,2022/4/15 18:30:00,12,23,-11
6670,6670,62,2022/4/15 18:40:00,14,25,-11
6671,6671,62,2022/4/15 18:50:00,11,25,-14
6672,6672,62,2022/4/15 19:00:00,10,25,-15
6673,6673,62,2022/4/15 19:10:00,6,25,-19
6674,6674,62,2022/4/15 19:20:00,4,21,-17
6675,6675,62,2022/4/15 19:30:00,6,22,-16
6676,6676,62,2022/4/15 19:40:00,5,13,-8
6677,6677,62,2022/4/15 19:50:00,3,15,-12
6678,6678,62,2022/4/15 20:00:00,2,15,-13
6679,6679,62,2022/4/15 20:10:00,2,15,-13
6680,6680,62,2022/4/15 20:20:00,2,8,-6
6681,6681,62,2022/4/15 20:30:00,3,13,-10
6682,6682,62,2022/4/15 20:40:00,2,13,-11
6683,6683,62,2022/4/15 20:50:00,2,10,-8
6684,6684,62,2022/4/15 21:00:00,2,13,-11
6685,6685,62,2022/4/15 21:10:00,2,10,-8
6686,6686,62,2022/4/15 21:20:00,2,13,-11
6687,6687,62,2022/4/15 21:30:00,2,15,-13
6688,6688,62,2022/4/15 21:40:00,1,10,-9
6689,6689,62,2022/4/15 21:50:00,1,8,-7
6690,6690,62,2022/4/15 22:00:00,2,10,-8
6691,6691,62,2022/4/15 22:10:00,1,7,-6
6692,6692,62,2022/4/15 22:20:00,0,8,-8
6693,6693,62,2022/4/15 22:30:00,0,10,-10
6694,6694,62,2022/4/15 22:40:00,0,3,-3
6695,6695,62,2022/4/15 22:50:00,0,3,-3
6696,6696,63,2022/4/15 5:00:00,0,1,-1
6697,6697,63,2022/4/15 5:10:00,0,1,-1
6698,6698,63,2022/4/15 5:20:00,0,1,-1
6699,6699,63,2022/4/15 5:30:00,1,1,0
6700,6700,63,2022/4/15 5:40:00,1,1,0
6701,6701,63,2022/4/15 5:50:00,10,1,9
6702,6702,63,2022/4/15 6:00:00,6,1,5
6703,6703,63,2022/4/15 6:10:00,12,21,-9
6704,6704,63,2022/4/15 6:20:00,15,6,9
6705,6705,63,2022/4/15 6:30:00,17,32,-15
6706,6706,63,2022/4/15 6:40:00,26,25,1
6707,6707,63,2022/4/15 6:50:00,29,37,-8
6708,6708,63,2022/4/15 7:00:00,30,50,-20
6709,6709,63,2022/4/15 7:10:00,34,69,-35
6710,6710,63,2022/4/15 7:20:00,36,78,-42
6711,6711,63,2022/4/15 7:30:00,41,90,-49
6712,6712,63,2022/4/15 7:40:00,48,108,-60
6713,6713,63,2022/4/15 7:50:00,53,169,-116
6714,6714,63,2022/4/15 8:00:00,55,432,-377
6715,6715,63,2022/4/15 8:10:00,59,433,-374
6716,6716,63,2022/4/15 8:20:00,52,436,-384
6717,6717,63,2022/4/15 8:30:00,44,533,-489
6718,6718,63,2022/4/15 8:40:00,36,495,-459
6719,6719,63,2022/4/15 8:50:00,32,332,-300
6720,6720,63,2022/4/15 9:00:00,32,234,-202
6721,6721,63,2022/4/15 9:10:00,29,146,-117
6722,6722,63,2022/4/15 9:20:00,28,111,-83
6723,6723,63,2022/4/15 9:30:00,26,105,-79
6724,6724,63,2022/4/15 9:40:00,24,105,-81
6725,6725,63,2022/4/15 9:50:00,20,84,-64
6726,6726,63,2022/4/15 10:00:00,21,92,-71
6727,6727,63,2022/4/15 10:10:00,22,70,-48
6728,6728,63,2022/4/15 10:20:00,22,67,-45
6729,6729,63,2022/4/15 10:30:00,21,62,-41
6730,6730,63,2022/4/15 10:40:00,22,61,-39
6731,6731,63,2022/4/15 10:50:00,19,54,-35
6732,6732,63,2022/4/15 11:00:00,22,47,-25
6733,6733,63,2022/4/15 11:10:00,23,50,-27
6734,6734,63,2022/4/15 11:20:00,25,44,-19
6735,6735,63,2022/4/15 11:30:00,26,58,-32
6736,6736,63,2022/4/15 11:40:00,28,51,-23
6737,6737,63,2022/4/15 11:50:00,24,50,-26
6738,6738,63,2022/4/15 12:00:00,30,46,-16
6739,6739,63,2022/4/15 12:10:00,27,47,-20
6740,6740,63,2022/4/15 12:20:00,22,51,-29
6741,6741,63,2022/4/15 12:30:00,24,55,-31
6742,6742,63,2022/4/15 12:40:00,26,67,-41
6743,6743,63,2022/4/15 12:50:00,22,62,-40
6744,6744,63,2022/4/15 13:00:00,26,64,-38
6745,6745,63,2022/4/15 13:10:00,23,70,-47
6746,6746,63,2022/4/15 13:20:00,26,61,-35
6747,6747,63,2022/4/15 13:30:00,27,65,-38
6748,6748,63,2022/4/15 13:40:00,24,62,-38
6749,6749,63,2022/4/15 13:50:00,22,54,-32
6750,6750,63,2022/4/15 14:00:00,22,52,-30
6751,6751,63,2022/4/15 14:10:00,26,54,-28
6752,6752,63,2022/4/15 14:20:00,26,54,-28
6753,6753,63,2022/4/15 14:30:00,27,56,-29
6754,6754,63,2022/4/15 14:40:00,25,53,-28
6755,6755,63,2022/4/15 14:50:00,28,56,-28
6756,6756,63,2022/4/15 15:00:00,29,56,-27
6757,6757,63,2022/4/15 15:10:00,27,57,-30
6758,6758,63,2022/4/15 15:20:00,25,52,-27
6759,6759,63,2022/4/15 15:30:00,29,61,-32
6760,6760,63,2022/4/15 15:40:00,26,54,-28
6761,6761,63,2022/4/15 15:50:00,29,62,-33
6762,6762,63,2022/4/15 16:00:00,30,62,-32
6763,6763,63,2022/4/15 16:10:00,32,61,-29
6764,6764,63,2022/4/15 16:20:00,32,66,-34
6765,6765,63,2022/4/15 16:30:00,44,57,-13
6766,6766,63,2022/4/15 16:40:00,41,74,-33
6767,6767,63,2022/4/15 16:50:00,50,55,-5
6768,6768,63,2022/4/15 17:00:00,274,70,204
6769,6769,63,2022/4/15 17:10:00,368,67,301
6770,6770,63,2022/4/15 17:20:00,227,65,162
6771,6771,63,2022/4/15 17:30:00,260,75,185
6772,6772,63,2022/4/15 17:40:00,577,84,493
6773,6773,63,2022/4/15 17:50:00,287,79,208
6774,6774,63,2022/4/15 18:00:00,227,93,134
6775,6775,63,2022/4/15 18:10:00,291,92,199
6776,6776,63,2022/4/15 18:20:00,213,99,114
6777,6777,63,2022/4/15 18:30:00,132,81,51
6778,6778,63,2022/4/15 18:40:00,131,78,53
6779,6779,63,2022/4/15 18:50:00,63,80,-17
6780,6780,63,2022/4/15 19:00:00,44,77,-33
6781,6781,63,2022/4/15 19:10:00,42,64,-22
6782,6782,63,2022/4/15 19:20:00,31,68,-37
6783,6783,63,2022/4/15 19:30:00,28,55,-27
6784,6784,63,2022/4/15 19:40:00,24,55,-31
6785,6785,63,2022/4/15 19:50:00,28,57,-29
6786,6786,63,2022/4/15 20:00:00,29,52,-23
6787,6787,63,2022/4/15 20:10:00,28,48,-20
6788,6788,63,2022/4/15 20:20:00,27,47,-20
6789,6789,63,2022/4/15 20:30:00,27,48,-21
6790,6790,63,2022/4/15 20:40:00,26,50,-24
6791,6791,63,2022/4/15 20:50:00,22,41,-19
6792,6792,63,2022/4/15 21:00:00,21,52,-31
6793,6793,63,2022/4/15 21:10:00,24,47,-23
6794,6794,63,2022/4/15 21:20:00,22,51,-29
6795,6795,63,2022/4/15 21:30:00,24,52,-28
6796,6796,63,2022/4/15 21:40:00,21,44,-23
6797,6797,63,2022/4/15 21:50:00,11,48,-37
6798,6798,63,2022/4/15 22:00:00,12,40,-28
6799,6799,63,2022/4/15 22:10:00,13,38,-25
6800,6800,63,2022/4/15 22:20:00,3,34,-31
6801,6801,63,2022/4/15 22:30:00,1,15,-14
6802,6802,63,2022/4/15 22:40:00,0,3,-3
6803,6803,63,2022/4/15 22:50:00,0,3,-3
6804,6804,64,2022/4/15 5:00:00,0,1,-1
6805,6805,64,2022/4/15 5:10:00,0,1,-1
6806,6806,64,2022/4/15 5:20:00,0,1,-1
6807,6807,64,2022/4/15 5:30:00,0,1,-1
6808,6808,64,2022/4/15 5:40:00,3,1,2
6809,6809,64,2022/4/15 5:50:00,8,1,7
6810,6810,64,2022/4/15 6:00:00,14,16,-2
6811,6811,64,2022/4/15 6:10:00,29,11,18
6812,6812,64,2022/4/15 6:20:00,40,30,10
6813,6813,64,2022/4/15 6:30:00,56,32,24
6814,6814,64,2022/4/15 6:40:00,57,40,17
6815,6815,64,2022/4/15 6:50:00,74,50,24
6816,6816,64,2022/4/15 7:00:00,152,66,86
6817,6817,64,2022/4/15 7:10:00,192,68,124
6818,6818,64,2022/4/15 7:20:00,225,84,141
6819,6819,64,2022/4/15 7:30:00,282,100,182
6820,6820,64,2022/4/15 7:40:00,367,106,261
6821,6821,64,2022/4/15 7:50:00,597,108,489
6822,6822,64,2022/4/15 8:00:00,590,122,468
6823,6823,64,2022/4/15 8:10:00,474,109,365
6824,6824,64,2022/4/15 8:20:00,357,119,238
6825,6825,64,2022/4/15 8:30:00,278,124,154
6826,6826,64,2022/4/15 8:40:00,246,100,146
6827,6827,64,2022/4/15 8:50:00,191,119,72
6828,6828,64,2022/4/15 9:00:00,145,109,36
6829,6829,64,2022/4/15 9:10:00,101,99,2
6830,6830,64,2022/4/15 9:20:00,70,87,-17
6831,6831,64,2022/4/15 9:30:00,50,71,-21
6832,6832,64,2022/4/15 9:40:00,44,69,-25
6833,6833,64,2022/4/15 9:50:00,36,78,-42
6834,6834,64,2022/4/15 10:00:00,34,71,-37
6835,6835,64,2022/4/15 10:10:00,34,62,-28
6836,6836,64,2022/4/15 10:20:00,30,63,-33
6837,6837,64,2022/4/15 10:30:00,27,61,-34
6838,6838,64,2022/4/15 10:40:00,28,67,-39
6839,6839,64,2022/4/15 10:50:00,31,61,-30
6840,6840,64,2022/4/15 11:00:00,31,53,-22
6841,6841,64,2022/4/15 11:10:00,27,61,-34
6842,6842,64,2022/4/15 11:20:00,31,55,-24
6843,6843,64,2022/4/15 11:30:00,27,57,-30
6844,6844,64,2022/4/15 11:40:00,28,60,-32
6845,6845,64,2022/4/15 11:50:00,30,65,-35
6846,6846,64,2022/4/15 12:00:00,30,60,-30
6847,6847,64,2022/4/15 12:10:00,33,61,-28
6848,6848,64,2022/4/15 12:20:00,30,63,-33
6849,6849,64,2022/4/15 12:30:00,35,69,-34
6850,6850,64,2022/4/15 12:40:00,35,64,-29
6851,6851,64,2022/4/15 12:50:00,32,70,-38
6852,6852,64,2022/4/15 13:00:00,30,67,-37
6853,6853,64,2022/4/15 13:10:00,34,72,-38
6854,6854,64,2022/4/15 13:20:00,24,68,-44
6855,6855,64,2022/4/15 13:30:00,23,70,-47
6856,6856,64,2022/4/15 13:40:00,26,72,-46
6857,6857,64,2022/4/15 13:50:00,32,71,-39
6858,6858,64,2022/4/15 14:00:00,24,69,-45
6859,6859,64,2022/4/15 14:10:00,24,72,-48
6860,6860,64,2022/4/15 14:20:00,27,65,-38
6861,6861,64,2022/4/15 14:30:00,26,69,-43
6862,6862,64,2022/4/15 14:40:00,28,71,-43
6863,6863,64,2022/4/15 14:50:00,24,73,-49
6864,6864,64,2022/4/15 15:00:00,27,72,-45
6865,6865,64,2022/4/15 15:10:00,29,73,-44
6866,6866,64,2022/4/15 15:20:00,30,73,-43
6867,6867,64,2022/4/15 15:30:00,29,76,-47
6868,6868,64,2022/4/15 15:40:00,24,76,-52
6869,6869,64,2022/4/15 15:50:00,29,79,-50
6870,6870,64,2022/4/15 16:00:00,28,79,-51
6871,6871,64,2022/4/15 16:10:00,33,76,-43
6872,6872,64,2022/4/15 16:20:00,31,90,-59
6873,6873,64,2022/4/15 16:30:00,43,84,-41
6874,6874,64,2022/4/15 16:40:00,46,103,-57
6875,6875,64,2022/4/15 16:50:00,44,106,-62
6876,6876,64,2022/4/15 17:00:00,129,102,27
6877,6877,64,2022/4/15 17:10:00,139,109,30
6878,6878,64,2022/4/15 17:20:00,62,118,-56
6879,6879,64,2022/4/15 17:30:00,74,168,-94
6880,6880,64,2022/4/15 17:40:00,77,153,-76
6881,6881,64,2022/4/15 17:50:00,49,179,-130
6882,6882,64,2022/4/15 18:00:00,53,213,-160
6883,6883,64,2022/4/15 18:10:00,42,226,-184
6884,6884,64,2022/4/15 18:20:00,36,234,-198
6885,6885,64,2022/4/15 18:30:00,37,227,-190
6886,6886,64,2022/4/15 18:40:00,32,199,-167
6887,6887,64,2022/4/15 18:50:00,31,178,-147
6888,6888,64,2022/4/15 19:00:00,28,128,-100
6889,6889,64,2022/4/15 19:10:00,25,105,-80
6890,6890,64,2022/4/15 19:20:00,28,103,-75
6891,6891,64,2022/4/15 19:30:00,27,107,-80
6892,6892,64,2022/4/15 19:40:00,21,110,-89
6893,6893,64,2022/4/15 19:50:00,21,106,-85
6894,6894,64,2022/4/15 20:00:00,21,93,-72
6895,6895,64,2022/4/15 20:10:00,21,93,-72
6896,6896,64,2022/4/15 20:20:00,18,80,-62
6897,6897,64,2022/4/15 20:30:00,18,77,-59
6898,6898,64,2022/4/15 20:40:00,20,71,-51
6899,6899,64,2022/4/15 20:50:00,19,78,-59
6900,6900,64,2022/4/15 21:00:00,20,85,-65
6901,6901,64,2022/4/15 21:10:00,16,99,-83
6902,6902,64,2022/4/15 21:20:00,19,95,-76
6903,6903,64,2022/4/15 21:30:00,14,84,-70
6904,6904,64,2022/4/15 21:40:00,14,95,-81
6905,6905,64,2022/4/15 21:50:00,9,83,-74
6906,6906,64,2022/4/15 22:00:00,12,89,-77
6907,6907,64,2022/4/15 22:10:00,10,83,-73
6908,6908,64,2022/4/15 22:20:00,4,105,-101
6909,6909,64,2022/4/15 22:30:00,0,16,-16
6910,6910,64,2022/4/15 22:40:00,0,3,-3
6911,6911,64,2022/4/15 22:50:00,0,3,-3
6912,6912,65,2022/4/15 5:00:00,0,1,-1
6913,6913,65,2022/4/15 5:10:00,0,1,-1
6914,6914,65,2022/4/15 5:20:00,0,1,-1
6915,6915,65,2022/4/15 5:30:00,1,1,0
6916,6916,65,2022/4/15 5:40:00,19,1,18
6917,6917,65,2022/4/15 5:50:00,31,1,30
6918,6918,65,2022/4/15 6:00:00,24,1,23
6919,6919,65,2022/4/15 6:10:00,27,1,26
6920,6920,65,2022/4/15 6:20:00,38,1,37
6921,6921,65,2022/4/15 6:30:00,47,53,-6
6922,6922,65,2022/4/15 6:40:00,58,38,20
6923,6923,65,2022/4/15 6:50:00,56,46,10
6924,6924,65,2022/4/15 7:00:00,83,78,5
6925,6925,65,2022/4/15 7:10:00,150,102,48
6926,6926,65,2022/4/15 7:20:00,187,96,91
6927,6927,65,2022/4/15 7:30:00,223,109,114
6928,6928,65,2022/4/15 7:40:00,274,269,5
6929,6929,65,2022/4/15 7:50:00,282,297,-15
6930,6930,65,2022/4/15 8:00:00,183,221,-38
6931,6931,65,2022/4/15 8:10:00,146,324,-178
6932,6932,65,2022/4/15 8:20:00,79,425,-346
6933,6933,65,2022/4/15 8:30:00,60,486,-426
6934,6934,65,2022/4/15 8:40:00,54,231,-177
6935,6935,65,2022/4/15 8:50:00,51,120,-69
6936,6936,65,2022/4/15 9:00:00,36,112,-76
6937,6937,65,2022/4/15 9:10:00,28,99,-71
6938,6938,65,2022/4/15 9:20:00,32,90,-58
6939,6939,65,2022/4/15 9:30:00,23,96,-73
6940,6940,65,2022/4/15 9:40:00,27,71,-44
6941,6941,65,2022/4/15 9:50:00,22,77,-55
6942,6942,65,2022/4/15 10:00:00,22,72,-50
6943,6943,65,2022/4/15 10:10:00,27,57,-30
6944,6944,65,2022/4/15 10:20:00,25,67,-42
6945,6945,65,2022/4/15 10:30:00,21,65,-44
6946,6946,65,2022/4/15 10:40:00,21,62,-41
6947,6947,65,2022/4/15 10:50:00,24,69,-45
6948,6948,65,2022/4/15 11:00:00,27,67,-40
6949,6949,65,2022/4/15 11:10:00,28,59,-31
6950,6950,65,2022/4/15 11:20:00,20,65,-45
6951,6951,65,2022/4/15 11:30:00,26,65,-39
6952,6952,65,2022/4/15 11:40:00,28,62,-34
6953,6953,65,2022/4/15 11:50:00,27,73,-46
6954,6954,65,2022/4/15 12:00:00,26,71,-45
6955,6955,65,2022/4/15 12:10:00,33,65,-32
6956,6956,65,2022/4/15 12:20:00,30,74,-44
6957,6957,65,2022/4/15 12:30:00,39,66,-27
6958,6958,65,2022/4/15 12:40:00,30,69,-39
6959,6959,65,2022/4/15 12:50:00,30,68,-38
6960,6960,65,2022/4/15 13:00:00,22,68,-46
6961,6961,65,2022/4/15 13:10:00,26,75,-49
6962,6962,65,2022/4/15 13:20:00,24,71,-47
6963,6963,65,2022/4/15 13:30:00,24,62,-38
6964,6964,65,2022/4/15 13:40:00,23,67,-44
6965,6965,65,2022/4/15 13:50:00,24,71,-47
6966,6966,65,2022/4/15 14:00:00,21,73,-52
6967,6967,65,2022/4/15 14:10:00,20,68,-48
6968,6968,65,2022/4/15 14:20:00,24,67,-43
6969,6969,65,2022/4/15 14:30:00,21,71,-50
6970,6970,65,2022/4/15 14:40:00,24,68,-44
6971,6971,65,2022/4/15 14:50:00,23,67,-44
6972,6972,65,2022/4/15 15:00:00,26,62,-36
6973,6973,65,2022/4/15 15:10:00,23,73,-50
6974,6974,65,2022/4/15 15:20:00,21,66,-45
6975,6975,65,2022/4/15 15:30:00,24,65,-41
6976,6976,65,2022/4/15 15:40:00,30,69,-39
6977,6977,65,2022/4/15 15:50:00,31,69,-38
6978,6978,65,2022/4/15 16:00:00,35,86,-51
6979,6979,65,2022/4/15 16:10:00,45,75,-30
6980,6980,65,2022/4/15 16:20:00,62,83,-21
6981,6981,65,2022/4/15 16:30:00,41,92,-51
6982,6982,65,2022/4/15 16:40:00,57,76,-19
6983,6983,65,2022/4/15 16:50:00,73,82,-9
6984,6984,65,2022/4/15 17:00:00,73,87,-14
6985,6985,65,2022/4/15 17:10:00,128,90,38
6986,6986,65,2022/4/15 17:20:00,137,92,45
6987,6987,65,2022/4/15 17:30:00,96,101,-5
6988,6988,65,2022/4/15 17:40:00,257,106,151
6989,6989,65,2022/4/15 17:50:00,302,109,193
6990,6990,65,2022/4/15 18:00:00,236,107,129
6991,6991,65,2022/4/15 18:10:00,163,118,45
6992,6992,65,2022/4/15 18:20:00,90,109,-19
6993,6993,65,2022/4/15 18:30:00,70,123,-53
6994,6994,65,2022/4/15 18:40:00,43,111,-68
6995,6995,65,2022/4/15 18:50:00,39,110,-71
6996,6996,65,2022/4/15 19:00:00,31,113,-82
6997,6997,65,2022/4/15 19:10:00,34,109,-75
6998,6998,65,2022/4/15 19:20:00,35,105,-70
6999,6999,65,2022/4/15 19:30:00,29,117,-88
7000,7000,65,2022/4/15 19:40:00,28,114,-86
7001,7001,65,2022/4/15 19:50:00,28,106,-78
7002,7002,65,2022/4/15 20:00:00,29,104,-75
7003,7003,65,2022/4/15 20:10:00,28,86,-58
7004,7004,65,2022/4/15 20:20:00,27,99,-72
7005,7005,65,2022/4/15 20:30:00,27,92,-65
7006,7006,65,2022/4/15 20:40:00,27,79,-52
7007,7007,65,2022/4/15 20:50:00,27,74,-47
7008,7008,65,2022/4/15 21:00:00,28,100,-72
7009,7009,65,2022/4/15 21:10:00,27,85,-58
7010,7010,65,2022/4/15 21:20:00,23,73,-50
7011,7011,65,2022/4/15 21:30:00,25,92,-67
7012,7012,65,2022/4/15 21:40:00,21,77,-56
7013,7013,65,2022/4/15 21:50:00,12,77,-65
7014,7014,65,2022/4/15 22:00:00,0,85,-85
7015,7015,65,2022/4/15 22:10:00,0,78,-78
7016,7016,65,2022/4/15 22:20:00,0,71,-71
7017,7017,65,2022/4/15 22:30:00,0,66,-66
7018,7018,65,2022/4/15 22:40:00,0,65,-65
7019,7019,65,2022/4/15 22:50:00,0,47,-47
7020,7020,66,2022/4/15 5:00:00,0,1,-1
7021,7021,66,2022/4/15 5:10:00,0,1,-1
7022,7022,66,2022/4/15 5:20:00,0,1,-1
7023,7023,66,2022/4/15 5:30:00,0,1,-1
7024,7024,66,2022/4/15 5:40:00,6,1,5
7025,7025,66,2022/4/15 5:50:00,20,1,19
7026,7026,66,2022/4/15 6:00:00,32,1,31
7027,7027,66,2022/4/15 6:10:00,32,1,31
7028,7028,66,2022/4/15 6:20:00,32,33,-1
7029,7029,66,2022/4/15 6:30:00,58,19,39
7030,7030,66,2022/4/15 6:40:00,60,29,31
7031,7031,66,2022/4/15 6:50:00,67,48,19
7032,7032,66,2022/4/15 7:00:00,99,6,93
7033,7033,66,2022/4/15 7:10:00,187,91,96
7034,7034,66,2022/4/15 7:20:00,207,76,131
7035,7035,66,2022/4/15 7:30:00,274,89,185
7036,7036,66,2022/4/15 7:40:00,302,89,213
7037,7037,66,2022/4/15 7:50:00,343,181,162
7038,7038,66,2022/4/15 8:00:00,327,99,228
7039,7039,66,2022/4/15 8:10:00,276,105,171
7040,7040,66,2022/4/15 8:20:00,234,91,143
7041,7041,66,2022/4/15 8:30:00,183,113,70
7042,7042,66,2022/4/15 8:40:00,81,60,21
7043,7043,66,2022/4/15 8:50:00,59,51,8
7044,7044,66,2022/4/15 9:00:00,44,46,-2
7045,7045,66,2022/4/15 9:10:00,38,72,-34
7046,7046,66,2022/4/15 9:20:00,32,49,-17
7047,7047,66,2022/4/15 9:30:00,31,63,-32
7048,7048,66,2022/4/15 9:40:00,28,47,-19
7049,7049,66,2022/4/15 9:50:00,25,42,-17
7050,7050,66,2022/4/15 10:00:00,22,47,-25
7051,7051,66,2022/4/15 10:10:00,26,44,-18
7052,7052,66,2022/4/15 10:20:00,19,41,-22
7053,7053,66,2022/4/15 10:30:00,19,31,-12
7054,7054,66,2022/4/15 10:40:00,20,40,-20
7055,7055,66,2022/4/15 10:50:00,20,38,-18
7056,7056,66,2022/4/15 11:00:00,17,32,-15
7057,7057,66,2022/4/15 11:10:00,17,39,-22
7058,7058,66,2022/4/15 11:20:00,19,45,-26
7059,7059,66,2022/4/15 11:30:00,19,38,-19
7060,7060,66,2022/4/15 11:40:00,18,41,-23
7061,7061,66,2022/4/15 11:50:00,22,42,-20
7062,7062,66,2022/4/15 12:00:00,23,40,-17
7063,7063,66,2022/4/15 12:10:00,21,47,-26
7064,7064,66,2022/4/15 12:20:00,26,38,-12
7065,7065,66,2022/4/15 12:30:00,21,47,-26
7066,7066,66,2022/4/15 12:40:00,22,45,-23
7067,7067,66,2022/4/15 12:50:00,20,50,-30
7068,7068,66,2022/4/15 13:00:00,19,45,-26
7069,7069,66,2022/4/15 13:10:00,18,42,-24
7070,7070,66,2022/4/15 13:20:00,19,46,-27
7071,7071,66,2022/4/15 13:30:00,16,46,-30
7072,7072,66,2022/4/15 13:40:00,20,50,-30
7073,7073,66,2022/4/15 13:50:00,21,47,-26
7074,7074,66,2022/4/15 14:00:00,18,49,-31
7075,7075,66,2022/4/15 14:10:00,17,50,-33
7076,7076,66,2022/4/15 14:20:00,16,47,-31
7077,7077,66,2022/4/15 14:30:00,18,51,-33
7078,7078,66,2022/4/15 14:40:00,16,57,-41
7079,7079,66,2022/4/15 14:50:00,14,51,-37
7080,7080,66,2022/4/15 15:00:00,19,57,-38
7081,7081,66,2022/4/15 15:10:00,14,58,-44
7082,7082,66,2022/4/15 15:20:00,19,61,-42
7083,7083,66,2022/4/15 15:30:00,20,62,-42
7084,7084,66,2022/4/15 15:40:00,22,66,-44
7085,7085,66,2022/4/15 15:50:00,24,59,-35
7086,7086,66,2022/4/15 16:00:00,24,67,-43
7087,7087,66,2022/4/15 16:10:00,25,68,-43
7088,7088,66,2022/4/15 16:20:00,28,65,-37
7089,7089,66,2022/4/15 16:30:00,30,65,-35
7090,7090,66,2022/4/15 16:40:00,32,70,-38
7091,7091,66,2022/4/15 16:50:00,30,75,-45
7092,7092,66,2022/4/15 17:00:00,63,98,-35
7093,7093,66,2022/4/15 17:10:00,70,90,-20
7094,7094,66,2022/4/15 17:20:00,73,99,-26
7095,7095,66,2022/4/15 17:30:00,43,89,-46
7096,7096,66,2022/4/15 17:40:00,39,111,-72
7097,7097,66,2022/4/15 17:50:00,29,118,-89
7098,7098,66,2022/4/15 18:00:00,28,123,-95
7099,7099,66,2022/4/15 18:10:00,28,112,-84
7100,7100,66,2022/4/15 18:20:00,28,109,-81
7101,7101,66,2022/4/15 18:30:00,27,111,-84
7102,7102,66,2022/4/15 18:40:00,19,109,-90
7103,7103,66,2022/4/15 18:50:00,19,104,-85
7104,7104,66,2022/4/15 19:00:00,21,107,-86
7105,7105,66,2022/4/15 19:10:00,18,109,-91
7106,7106,66,2022/4/15 19:20:00,17,122,-105
7107,7107,66,2022/4/15 19:30:00,14,107,-93
7108,7108,66,2022/4/15 19:40:00,15,102,-87
7109,7109,66,2022/4/15 19:50:00,15,94,-79
7110,7110,66,2022/4/15 20:00:00,12,78,-66
7111,7111,66,2022/4/15 20:10:00,13,79,-66
7112,7112,66,2022/4/15 20:20:00,12,64,-52
7113,7113,66,2022/4/15 20:30:00,11,79,-68
7114,7114,66,2022/4/15 20:40:00,12,84,-72
7115,7115,66,2022/4/15 20:50:00,11,62,-51
7116,7116,66,2022/4/15 21:00:00,10,56,-46
7117,7117,66,2022/4/15 21:10:00,9,72,-63
7118,7118,66,2022/4/15 21:20:00,10,72,-62
7119,7119,66,2022/4/15 21:30:00,6,73,-67
7120,7120,66,2022/4/15 21:40:00,6,71,-65
7121,7121,66,2022/4/15 21:50:00,6,72,-66
7122,7122,66,2022/4/15 22:00:00,1,59,-58
7123,7123,66,2022/4/15 22:10:00,0,64,-64
7124,7124,66,2022/4/15 22:20:00,0,63,-63
7125,7125,66,2022/4/15 22:30:00,0,68,-68
7126,7126,66,2022/4/15 22:40:00,0,63,-63
7127,7127,66,2022/4/15 22:50:00,0,3,-3
7128,7128,67,2022/4/15 5:00:00,0,1,-1
7129,7129,67,2022/4/15 5:10:00,0,1,-1
7130,7130,67,2022/4/15 5:20:00,0,1,-1
7131,7131,67,2022/4/15 5:30:00,0,1,-1
7132,7132,67,2022/4/15 5:40:00,2,1,1
7133,7133,67,2022/4/15 5:50:00,6,1,5
7134,7134,67,2022/4/15 6:00:00,20,1,19
7135,7135,67,2022/4/15 6:10:00,20,5,15
7136,7136,67,2022/4/15 6:20:00,27,23,4
7137,7137,67,2022/4/15 6:30:00,33,23,10
7138,7138,67,2022/4/15 6:40:00,40,37,3
7139,7139,67,2022/4/15 6:50:00,47,49,-2
7140,7140,67,2022/4/15 7:00:00,76,34,42
7141,7141,67,2022/4/15 7:10:00,130,57,73
7142,7142,67,2022/4/15 7:20:00,193,63,130
7143,7143,67,2022/4/15 7:30:00,235,77,158
7144,7144,67,2022/4/15 7:40:00,278,99,179
7145,7145,67,2022/4/15 7:50:00,349,82,267
7146,7146,67,2022/4/15 8:00:00,330,69,261
7147,7147,67,2022/4/15 8:10:00,281,76,205
7148,7148,67,2022/4/15 8:20:00,240,69,171
7149,7149,67,2022/4/15 8:30:00,184,83,101
7150,7150,67,2022/4/15 8:40:00,87,57,30
7151,7151,67,2022/4/15 8:50:00,71,53,18
7152,7152,67,2022/4/15 9:00:00,42,52,-10
7153,7153,67,2022/4/15 9:10:00,29,51,-22
7154,7154,67,2022/4/15 9:20:00,30,35,-5
7155,7155,67,2022/4/15 9:30:00,28,41,-13
7156,7156,67,2022/4/15 9:40:00,22,32,-10
7157,7157,67,2022/4/15 9:50:00,22,32,-10
7158,7158,67,2022/4/15 10:00:00,19,29,-10
7159,7159,67,2022/4/15 10:10:00,18,23,-5
7160,7160,67,2022/4/15 10:20:00,15,31,-16
7161,7161,67,2022/4/15 10:30:00,14,30,-16
7162,7162,67,2022/4/15 10:40:00,16,33,-17
7163,7163,67,2022/4/15 10:50:00,15,32,-17
7164,7164,67,2022/4/15 11:00:00,14,32,-18
7165,7165,67,2022/4/15 11:10:00,13,37,-24
7166,7166,67,2022/4/15 11:20:00,12,38,-26
7167,7167,67,2022/4/15 11:30:00,13,37,-24
7168,7168,67,2022/4/15 11:40:00,14,38,-24
7169,7169,67,2022/4/15 11:50:00,15,37,-22
7170,7170,67,2022/4/15 12:00:00,15,40,-25
7171,7171,67,2022/4/15 12:10:00,17,38,-21
7172,7172,67,2022/4/15 12:20:00,18,38,-20
7173,7173,67,2022/4/15 12:30:00,19,40,-21
7174,7174,67,2022/4/15 12:40:00,14,42,-28
7175,7175,67,2022/4/15 12:50:00,15,40,-25
7176,7176,67,2022/4/15 13:00:00,14,33,-19
7177,7177,67,2022/4/15 13:10:00,13,38,-25
7178,7178,67,2022/4/15 13:20:00,12,38,-26
7179,7179,67,2022/4/15 13:30:00,13,38,-25
7180,7180,67,2022/4/15 13:40:00,13,43,-30
7181,7181,67,2022/4/15 13:50:00,13,37,-24
7182,7182,67,2022/4/15 14:00:00,10,48,-38
7183,7183,67,2022/4/15 14:10:00,9,47,-38
7184,7184,67,2022/4/15 14:20:00,12,45,-33
7185,7185,67,2022/4/15 14:30:00,11,45,-34
7186,7186,67,2022/4/15 14:40:00,11,41,-30
7187,7187,67,2022/4/15 14:50:00,11,50,-39
7188,7188,67,2022/4/15 15:00:00,11,52,-41
7189,7189,67,2022/4/15 15:10:00,13,55,-42
7190,7190,67,2022/4/15 15:20:00,11,51,-40
7191,7191,67,2022/4/15 15:30:00,13,54,-41
7192,7192,67,2022/4/15 15:40:00,11,63,-52
7193,7193,67,2022/4/15 15:50:00,13,57,-44
7194,7194,67,2022/4/15 16:00:00,12,66,-54
7195,7195,67,2022/4/15 16:10:00,15,66,-51
7196,7196,67,2022/4/15 16:20:00,16,69,-53
7197,7197,67,2022/4/15 16:30:00,17,70,-53
7198,7198,67,2022/4/15 16:40:00,21,69,-48
7199,7199,67,2022/4/15 16:50:00,21,70,-49
7200,7200,67,2022/4/15 17:00:00,24,92,-68
7201,7201,67,2022/4/15 17:10:00,26,98,-72
7202,7202,67,2022/4/15 17:20:00,26,96,-70
7203,7203,67,2022/4/15 17:30:00,24,117,-93
7204,7204,67,2022/4/15 17:40:00,28,116,-88
7205,7205,67,2022/4/15 17:50:00,32,109,-77
7206,7206,67,2022/4/15 18:00:00,41,133,-92
7207,7207,67,2022/4/15 18:10:00,26,143,-117
7208,7208,67,2022/4/15 18:20:00,22,117,-95
7209,7209,67,2022/4/15 18:30:00,19,111,-92
7210,7210,67,2022/4/15 18:40:00,17,117,-100
7211,7211,67,2022/4/15 18:50:00,12,111,-99
7212,7212,67,2022/4/15 19:00:00,12,112,-100
7213,7213,67,2022/4/15 19:10:00,12,123,-111
7214,7214,67,2022/4/15 19:20:00,12,91,-79
7215,7215,67,2022/4/15 19:30:00,13,105,-92
7216,7216,67,2022/4/15 19:40:00,12,95,-83
7217,7217,67,2022/4/15 19:50:00,12,79,-67
7218,7218,67,2022/4/15 20:00:00,10,78,-68
7219,7219,67,2022/4/15 20:10:00,12,76,-64
7220,7220,67,2022/4/15 20:20:00,11,72,-61
7221,7221,67,2022/4/15 20:30:00,10,71,-61
7222,7222,67,2022/4/15 20:40:00,10,57,-47
7223,7223,67,2022/4/15 20:50:00,10,77,-67
7224,7224,67,2022/4/15 21:00:00,11,73,-62
7225,7225,67,2022/4/15 21:10:00,9,67,-58
7226,7226,67,2022/4/15 21:20:00,10,73,-63
7227,7227,67,2022/4/15 21:30:00,8,62,-54
7228,7228,67,2022/4/15 21:40:00,6,62,-56
7229,7229,67,2022/4/15 21:50:00,3,74,-71
7230,7230,67,2022/4/15 22:00:00,4,59,-55
7231,7231,67,2022/4/15 22:10:00,2,62,-60
7232,7232,67,2022/4/15 22:20:00,2,67,-65
7233,7233,67,2022/4/15 22:30:00,1,50,-49
7234,7234,67,2022/4/15 22:40:00,0,49,-49
7235,7235,67,2022/4/15 22:50:00,0,3,-3
7236,7236,68,2022/4/15 5:00:00,0,1,-1
7237,7237,68,2022/4/15 5:10:00,0,1,-1
7238,7238,68,2022/4/15 5:20:00,0,1,-1
7239,7239,68,2022/4/15 5:30:00,0,1,-1
7240,7240,68,2022/4/15 5:40:00,0,1,-1
7241,7241,68,2022/4/15 5:50:00,6,1,5
7242,7242,68,2022/4/15 6:00:00,22,1,21
7243,7243,68,2022/4/15 6:10:00,35,16,19
7244,7244,68,2022/4/15 6:20:00,42,32,10
7245,7245,68,2022/4/15 6:30:00,54,37,17
7246,7246,68,2022/4/15 6:40:00,61,45,16
7247,7247,68,2022/4/15 6:50:00,87,52,35
7248,7248,68,2022/4/15 7:00:00,156,72,84
7249,7249,68,2022/4/15 7:10:00,234,73,161
7250,7250,68,2022/4/15 7:20:00,238,105,133
7251,7251,68,2022/4/15 7:30:00,319,90,229
7252,7252,68,2022/4/15 7:40:00,573,123,450
7253,7253,68,2022/4/15 7:50:00,590,108,482
7254,7254,68,2022/4/15 8:00:00,599,192,407
7255,7255,68,2022/4/15 8:10:00,597,121,476
7256,7256,68,2022/4/15 8:20:00,337,192,145
7257,7257,68,2022/4/15 8:30:00,277,152,125
7258,7258,68,2022/4/15 8:40:00,227,336,-109
7259,7259,68,2022/4/15 8:50:00,184,150,34
7260,7260,68,2022/4/15 9:00:00,120,226,-106
7261,7261,68,2022/4/15 9:10:00,61,159,-98
7262,7262,68,2022/4/15 9:20:00,51,179,-128
7263,7263,68,2022/4/15 9:30:00,40,125,-85
7264,7264,68,2022/4/15 9:40:00,38,105,-67
7265,7265,68,2022/4/15 9:50:00,31,112,-81
7266,7266,68,2022/4/15 10:00:00,31,76,-45
7267,7267,68,2022/4/15 10:10:00,33,77,-44
7268,7268,68,2022/4/15 10:20:00,32,76,-44
7269,7269,68,2022/4/15 10:30:00,26,77,-51
7270,7270,68,2022/4/15 10:40:00,28,69,-41
7271,7271,68,2022/4/15 10:50:00,28,74,-46
7272,7272,68,2022/4/15 11:00:00,30,71,-41
7273,7273,68,2022/4/15 11:10:00,26,66,-40
7274,7274,68,2022/4/15 11:20:00,30,66,-36
7275,7275,68,2022/4/15 11:30:00,28,69,-41
7276,7276,68,2022/4/15 11:40:00,30,66,-36
7277,7277,68,2022/4/15 11:50:00,32,72,-40
7278,7278,68,2022/4/15 12:00:00,30,62,-32
7279,7279,68,2022/4/15 12:10:00,36,64,-28
7280,7280,68,2022/4/15 12:20:00,33,62,-29
7281,7281,68,2022/4/15 12:30:00,33,74,-41
7282,7282,68,2022/4/15 12:40:00,35,74,-39
7283,7283,68,2022/4/15 12:50:00,28,71,-43
7284,7284,68,2022/4/15 13:00:00,29,82,-53
7285,7285,68,2022/4/15 13:10:00,29,82,-53
7286,7286,68,2022/4/15 13:20:00,26,85,-59
7287,7287,68,2022/4/15 13:30:00,35,65,-30
7288,7288,68,2022/4/15 13:40:00,29,74,-45
7289,7289,68,2022/4/15 13:50:00,28,81,-53
7290,7290,68,2022/4/15 14:00:00,25,72,-47
7291,7291,68,2022/4/15 14:10:00,26,62,-36
7292,7292,68,2022/4/15 14:20:00,29,69,-40
7293,7293,68,2022/4/15 14:30:00,30,66,-36
7294,7294,68,2022/4/15 14:40:00,32,74,-42
7295,7295,68,2022/4/15 14:50:00,31,76,-45
7296,7296,68,2022/4/15 15:00:00,29,81,-52
7297,7297,68,2022/4/15 15:10:00,31,69,-38
7298,7298,68,2022/4/15 15:20:00,35,82,-47
7299,7299,68,2022/4/15 15:30:00,28,83,-55
7300,7300,68,2022/4/15 15:40:00,32,84,-52
7301,7301,68,2022/4/15 15:50:00,33,78,-45
7302,7302,68,2022/4/15 16:00:00,40,76,-36
7303,7303,68,2022/4/15 16:10:00,35,90,-55
7304,7304,68,2022/4/15 16:20:00,36,90,-54
7305,7305,68,2022/4/15 16:30:00,43,92,-49
7306,7306,68,2022/4/15 16:40:00,45,97,-52
7307,7307,68,2022/4/15 16:50:00,43,104,-61
7308,7308,68,2022/4/15 17:00:00,198,125,73
7309,7309,68,2022/4/15 17:10:00,144,122,22
7310,7310,68,2022/4/15 17:20:00,70,110,-40
7311,7311,68,2022/4/15 17:30:00,103,191,-88
7312,7312,68,2022/4/15 17:40:00,204,191,13
7313,7313,68,2022/4/15 17:50:00,149,178,-29
7314,7314,68,2022/4/15 18:00:00,143,215,-72
7315,7315,68,2022/4/15 18:10:00,217,257,-40
7316,7316,68,2022/4/15 18:20:00,137,219,-82
7317,7317,68,2022/4/15 18:30:00,110,223,-113
7318,7318,68,2022/4/15 18:40:00,88,214,-126
7319,7319,68,2022/4/15 18:50:00,60,191,-131
7320,7320,68,2022/4/15 19:00:00,45,153,-108
7321,7321,68,2022/4/15 19:10:00,44,104,-60
7322,7322,68,2022/4/15 19:20:00,38,126,-88
7323,7323,68,2022/4/15 19:30:00,33,90,-57
7324,7324,68,2022/4/15 19:40:00,29,114,-85
7325,7325,68,2022/4/15 19:50:00,28,108,-80
7326,7326,68,2022/4/15 20:00:00,24,95,-71
7327,7327,68,2022/4/15 20:10:00,33,95,-62
7328,7328,68,2022/4/15 20:20:00,29,85,-56
7329,7329,68,2022/4/15 20:30:00,29,71,-42
7330,7330,68,2022/4/15 20:40:00,29,112,-83
7331,7331,68,2022/4/15 20:50:00,28,85,-57
7332,7332,68,2022/4/15 21:00:00,28,79,-51
7333,7333,68,2022/4/15 21:10:00,25,92,-67
7334,7334,68,2022/4/15 21:20:00,28,77,-49
7335,7335,68,2022/4/15 21:30:00,25,79,-54
7336,7336,68,2022/4/15 21:40:00,23,95,-72
7337,7337,68,2022/4/15 21:50:00,19,89,-70
7338,7338,68,2022/4/15 22:00:00,18,79,-61
7339,7339,68,2022/4/15 22:10:00,14,85,-71
7340,7340,68,2022/4/15 22:20:00,3,82,-79
7341,7341,68,2022/4/15 22:30:00,0,54,-54
7342,7342,68,2022/4/15 22:40:00,0,3,-3
7343,7343,68,2022/4/15 22:50:00,0,3,-3
7344,7344,69,2022/4/15 5:00:00,0,1,-1
7345,7345,69,2022/4/15 5:10:00,0,1,-1
7346,7346,69,2022/4/15 5:20:00,0,1,-1
7347,7347,69,2022/4/15 5:30:00,1,1,0
7348,7348,69,2022/4/15 5:40:00,2,1,1
7349,7349,69,2022/4/15 5:50:00,5,1,4
7350,7350,69,2022/4/15 6:00:00,16,1,15
7351,7351,69,2022/4/15 6:10:00,31,19,12
7352,7352,69,2022/4/15 6:20:00,33,41,-8
7353,7353,69,2022/4/15 6:30:00,39,38,1
7354,7354,69,2022/4/15 6:40:00,54,63,-9
7355,7355,69,2022/4/15 6:50:00,57,63,-6
7356,7356,69,2022/4/15 7:00:00,82,73,9
7357,7357,69,2022/4/15 7:10:00,114,84,30
7358,7358,69,2022/4/15 7:20:00,231,106,125
7359,7359,69,2022/4/15 7:30:00,264,102,162
7360,7360,69,2022/4/15 7:40:00,330,102,228
7361,7361,69,2022/4/15 7:50:00,442,109,333
7362,7362,69,2022/4/15 8:00:00,323,144,179
7363,7363,69,2022/4/15 8:10:00,324,231,93
7364,7364,69,2022/4/15 8:20:00,357,225,132
7365,7365,69,2022/4/15 8:30:00,252,225,27
7366,7366,69,2022/4/15 8:40:00,222,325,-103
7367,7367,69,2022/4/15 8:50:00,167,321,-154
7368,7368,69,2022/4/15 9:00:00,78,191,-113
7369,7369,69,2022/4/15 9:10:00,70,116,-46
7370,7370,69,2022/4/15 9:20:00,54,133,-79
7371,7371,69,2022/4/15 9:30:00,44,108,-64
7372,7372,69,2022/4/15 9:40:00,39,106,-67
7373,7373,69,2022/4/15 9:50:00,35,78,-43
7374,7374,69,2022/4/15 10:00:00,31,91,-60
7375,7375,69,2022/4/15 10:10:00,31,97,-66
7376,7376,69,2022/4/15 10:20:00,29,77,-48
7377,7377,69,2022/4/15 10:30:00,33,87,-54
7378,7378,69,2022/4/15 10:40:00,27,72,-45
7379,7379,69,2022/4/15 10:50:00,30,83,-53
7380,7380,69,2022/4/15 11:00:00,32,74,-42
7381,7381,69,2022/4/15 11:10:00,29,64,-35
7382,7382,69,2022/4/15 11:20:00,29,74,-45
7383,7383,69,2022/4/15 11:30:00,31,72,-41
7384,7384,69,2022/4/15 11:40:00,31,69,-38
7385,7385,69,2022/4/15 11:50:00,31,66,-35
7386,7386,69,2022/4/15 12:00:00,34,62,-28
7387,7387,69,2022/4/15 12:10:00,31,61,-30
7388,7388,69,2022/4/15 12:20:00,35,69,-34
7389,7389,69,2022/4/15 12:30:00,31,83,-52
7390,7390,69,2022/4/15 12:40:00,30,73,-43
7391,7391,69,2022/4/15 12:50:00,30,73,-43
7392,7392,69,2022/4/15 13:00:00,32,69,-37
7393,7393,69,2022/4/15 13:10:00,32,77,-45
7394,7394,69,2022/4/15 13:20:00,33,78,-45
7395,7395,69,2022/4/15 13:30:00,32,84,-52
7396,7396,69,2022/4/15 13:40:00,28,76,-48
7397,7397,69,2022/4/15 13:50:00,32,84,-52
7398,7398,69,2022/4/15 14:00:00,33,77,-44
7399,7399,69,2022/4/15 14:10:00,31,74,-43
7400,7400,69,2022/4/15 14:20:00,31,69,-38
7401,7401,69,2022/4/15 14:30:00,34,84,-50
7402,7402,69,2022/4/15 14:40:00,33,82,-49
7403,7403,69,2022/4/15 14:50:00,33,69,-36
7404,7404,69,2022/4/15 15:00:00,33,81,-48
7405,7405,69,2022/4/15 15:10:00,35,76,-41
7406,7406,69,2022/4/15 15:20:00,37,76,-39
7407,7407,69,2022/4/15 15:30:00,33,83,-50
7408,7408,69,2022/4/15 15:40:00,33,76,-43
7409,7409,69,2022/4/15 15:50:00,35,88,-53
7410,7410,69,2022/4/15 16:00:00,39,90,-51
7411,7411,69,2022/4/15 16:10:00,45,77,-32
7412,7412,69,2022/4/15 16:20:00,46,99,-53
7413,7413,69,2022/4/15 16:30:00,49,90,-41
7414,7414,69,2022/4/15 16:40:00,45,103,-58
7415,7415,69,2022/4/15 16:50:00,48,109,-61
7416,7416,69,2022/4/15 17:00:00,243,106,137
7417,7417,69,2022/4/15 17:10:00,222,108,114
7418,7418,69,2022/4/15 17:20:00,130,115,15
7419,7419,69,2022/4/15 17:30:00,207,170,37
7420,7420,69,2022/4/15 17:40:00,245,153,92
7421,7421,69,2022/4/15 17:50:00,142,190,-48
7422,7422,69,2022/4/15 18:00:00,149,234,-85
7423,7423,69,2022/4/15 18:10:00,234,224,10
7424,7424,69,2022/4/15 18:20:00,157,234,-77
7425,7425,69,2022/4/15 18:30:00,77,178,-101
7426,7426,69,2022/4/15 18:40:00,67,180,-113
7427,7427,69,2022/4/15 18:50:00,48,184,-136
7428,7428,69,2022/4/15 19:00:00,39,154,-115
7429,7429,69,2022/4/15 19:10:00,41,124,-83
7430,7430,69,2022/4/15 19:20:00,29,99,-70
7431,7431,69,2022/4/15 19:30:00,31,110,-79
7432,7432,69,2022/4/15 19:40:00,31,110,-79
7433,7433,69,2022/4/15 19:50:00,29,98,-69
7434,7434,69,2022/4/15 20:00:00,36,95,-59
7435,7435,69,2022/4/15 20:10:00,38,89,-51
7436,7436,69,2022/4/15 20:20:00,35,77,-42
7437,7437,69,2022/4/15 20:30:00,29,110,-81
7438,7438,69,2022/4/15 20:40:00,26,68,-42
7439,7439,69,2022/4/15 20:50:00,24,79,-55
7440,7440,69,2022/4/15 21:00:00,29,78,-49
7441,7441,69,2022/4/15 21:10:00,25,83,-58
7442,7442,69,2022/4/15 21:20:00,25,83,-58
7443,7443,69,2022/4/15 21:30:00,25,77,-52
7444,7444,69,2022/4/15 21:40:00,25,86,-61
7445,7445,69,2022/4/15 21:50:00,24,79,-55
7446,7446,69,2022/4/15 22:00:00,20,87,-67
7447,7447,69,2022/4/15 22:10:00,15,67,-52
7448,7448,69,2022/4/15 22:20:00,8,70,-62
7449,7449,69,2022/4/15 22:30:00,1,59,-58
7450,7450,69,2022/4/15 22:40:00,0,3,-3
7451,7451,69,2022/4/15 22:50:00,0,3,-3
7452,7452,70,2022/4/15 5:00:00,0,1,-1
7453,7453,70,2022/4/15 5:10:00,0,1,-1
7454,7454,70,2022/4/15 5:20:00,0,1,-1
7455,7455,70,2022/4/15 5:30:00,0,1,-1
7456,7456,70,2022/4/15 5:40:00,4,1,3
7457,7457,70,2022/4/15 5:50:00,13,1,12
7458,7458,70,2022/4/15 6:00:00,12,1,11
7459,7459,70,2022/4/15 6:10:00,17,1,16
7460,7460,70,2022/4/15 6:20:00,32,1,31
7461,7461,70,2022/4/15 6:30:00,31,33,-2
7462,7462,70,2022/4/15 6:40:00,29,31,-2
7463,7463,70,2022/4/15 6:50:00,32,7,25
7464,7464,70,2022/4/15 7:00:00,52,22,30
7465,7465,70,2022/4/15 7:10:00,57,48,9
7466,7466,70,2022/4/15 7:20:00,55,75,-20
7467,7467,70,2022/4/15 7:30:00,64,64,0
7468,7468,70,2022/4/15 7:40:00,69,93,-24
7469,7469,70,2022/4/15 7:50:00,76,98,-22
7470,7470,70,2022/4/15 8:00:00,72,213,-141
7471,7471,70,2022/4/15 8:10:00,57,128,-71
7472,7472,70,2022/4/15 8:20:00,45,75,-30
7473,7473,70,2022/4/15 8:30:00,48,87,-39
7474,7474,70,2022/4/15 8:40:00,28,111,-83
7475,7475,70,2022/4/15 8:50:00,25,71,-46
7476,7476,70,2022/4/15 9:00:00,25,59,-34
7477,7477,70,2022/4/15 9:10:00,15,63,-48
7478,7478,70,2022/4/15 9:20:00,15,65,-50
7479,7479,70,2022/4/15 9:30:00,22,47,-25
7480,7480,70,2022/4/15 9:40:00,12,38,-26
7481,7481,70,2022/4/15 9:50:00,16,38,-22
7482,7482,70,2022/4/15 10:00:00,14,32,-18
7483,7483,70,2022/4/15 10:10:00,14,25,-11
7484,7484,70,2022/4/15 10:20:00,15,31,-16
7485,7485,70,2022/4/15 10:30:00,12,38,-26
7486,7486,70,2022/4/15 10:40:00,14,21,-7
7487,7487,70,2022/4/15 10:50:00,13,19,-6
7488,7488,70,2022/4/15 11:00:00,15,21,-6
7489,7489,70,2022/4/15 11:10:00,16,19,-3
7490,7490,70,2022/4/15 11:20:00,15,23,-8
7491,7491,70,2022/4/15 11:30:00,16,25,-9
7492,7492,70,2022/4/15 11:40:00,16,21,-5
7493,7493,70,2022/4/15 11:50:00,15,23,-8
7494,7494,70,2022/4/15 12:00:00,19,23,-4
7495,7495,70,2022/4/15 12:10:00,13,23,-10
7496,7496,70,2022/4/15 12:20:00,16,25,-9
7497,7497,70,2022/4/15 12:30:00,19,31,-12
7498,7498,70,2022/4/15 12:40:00,22,31,-9
7499,7499,70,2022/4/15 12:50:00,12,30,-18
7500,7500,70,2022/4/15 13:00:00,18,23,-5
7501,7501,70,2022/4/15 13:10:00,16,23,-7
7502,7502,70,2022/4/15 13:20:00,16,23,-7
7503,7503,70,2022/4/15 13:30:00,12,23,-11
7504,7504,70,2022/4/15 13:40:00,16,29,-13
7505,7505,70,2022/4/15 13:50:00,15,21,-6
7506,7506,70,2022/4/15 14:00:00,13,23,-10
7507,7507,70,2022/4/15 14:10:00,16,23,-7
7508,7508,70,2022/4/15 14:20:00,17,23,-6
7509,7509,70,2022/4/15 14:30:00,16,19,-3
7510,7510,70,2022/4/15 14:40:00,21,21,0
7511,7511,70,2022/4/15 14:50:00,17,22,-5
7512,7512,70,2022/4/15 15:00:00,16,23,-7
7513,7513,70,2022/4/15 15:10:00,21,23,-2
7514,7514,70,2022/4/15 15:20:00,19,21,-2
7515,7515,70,2022/4/15 15:30:00,24,23,1
7516,7516,70,2022/4/15 15:40:00,20,23,-3
7517,7517,70,2022/4/15 15:50:00,22,25,-3
7518,7518,70,2022/4/15 16:00:00,22,23,-1
7519,7519,70,2022/4/15 16:10:00,24,23,1
7520,7520,70,2022/4/15 16:20:00,25,23,2
7521,7521,70,2022/4/15 16:30:00,34,23,11
7522,7522,70,2022/4/15 16:40:00,35,30,5
7523,7523,70,2022/4/15 16:50:00,36,33,3
7524,7524,70,2022/4/15 17:00:00,52,33,19
7525,7525,70,2022/4/15 17:10:00,203,38,165
7526,7526,70,2022/4/15 17:20:00,70,35,35
7527,7527,70,2022/4/15 17:30:00,45,52,-7
7528,7528,70,2022/4/15 17:40:00,47,32,15
7529,7529,70,2022/4/15 17:50:00,43,48,-5
7530,7530,70,2022/4/15 18:00:00,26,52,-26
7531,7531,70,2022/4/15 18:10:00,28,51,-23
7532,7532,70,2022/4/15 18:20:00,28,63,-35
7533,7533,70,2022/4/15 18:30:00,22,64,-42
7534,7534,70,2022/4/15 18:40:00,16,61,-45
7535,7535,70,2022/4/15 18:50:00,20,67,-47
7536,7536,70,2022/4/15 19:00:00,15,47,-32
7537,7537,70,2022/4/15 19:10:00,12,45,-33
7538,7538,70,2022/4/15 19:20:00,14,51,-37
7539,7539,70,2022/4/15 19:30:00,12,47,-35
7540,7540,70,2022/4/15 19:40:00,13,29,-16
7541,7541,70,2022/4/15 19:50:00,12,47,-35
7542,7542,70,2022/4/15 20:00:00,12,38,-26
7543,7543,70,2022/4/15 20:10:00,10,30,-20
7544,7544,70,2022/4/15 20:20:00,8,25,-17
7545,7545,70,2022/4/15 20:30:00,7,34,-27
7546,7546,70,2022/4/15 20:40:00,7,23,-16
7547,7547,70,2022/4/15 20:50:00,9,34,-25
7548,7548,70,2022/4/15 21:00:00,5,21,-16
7549,7549,70,2022/4/15 21:10:00,6,25,-19
7550,7550,70,2022/4/15 21:20:00,4,21,-17
7551,7551,70,2022/4/15 21:30:00,2,27,-25
7552,7552,70,2022/4/15 21:40:00,4,23,-19
7553,7553,70,2022/4/15 21:50:00,2,22,-20
7554,7554,70,2022/4/15 22:00:00,1,23,-22
7555,7555,70,2022/4/15 22:10:00,0,25,-25
7556,7556,70,2022/4/15 22:20:00,0,25,-25
7557,7557,70,2022/4/15 22:30:00,0,23,-23
7558,7558,70,2022/4/15 22:40:00,0,25,-25
7559,7559,70,2022/4/15 22:50:00,0,13,-13
7560,7560,71,2022/4/15 5:00:00,0,1,-1
7561,7561,71,2022/4/15 5:10:00,0,1,-1
7562,7562,71,2022/4/15 5:20:00,0,1,-1
7563,7563,71,2022/4/15 5:30:00,0,1,-1
7564,7564,71,2022/4/15 5:40:00,1,1,0
7565,7565,71,2022/4/15 5:50:00,8,1,7
7566,7566,71,2022/4/15 6:00:00,8,1,7
7567,7567,71,2022/4/15 6:10:00,10,2,8
7568,7568,71,2022/4/15 6:20:00,17,37,-20
7569,7569,71,2022/4/15 6:30:00,15,23,-8
7570,7570,71,2022/4/15 6:40:00,22,41,-19
7571,7571,71,2022/4/15 6:50:00,22,47,-25
7572,7572,71,2022/4/15 7:00:00,25,59,-34
7573,7573,71,2022/4/15 7:10:00,27,62,-35
7574,7574,71,2022/4/15 7:20:00,30,74,-44
7575,7575,71,2022/4/15 7:30:00,36,93,-57
7576,7576,71,2022/4/15 7:40:00,42,102,-60
7577,7577,71,2022/4/15 7:50:00,53,109,-56
7578,7578,71,2022/4/15 8:00:00,62,137,-75
7579,7579,71,2022/4/15 8:10:00,53,380,-327
7580,7580,71,2022/4/15 8:20:00,42,231,-189
7581,7581,71,2022/4/15 8:30:00,33,382,-349
7582,7582,71,2022/4/15 8:40:00,35,534,-499
7583,7583,71,2022/4/15 8:50:00,30,332,-302
7584,7584,71,2022/4/15 9:00:00,29,181,-152
7585,7585,71,2022/4/15 9:10:00,27,170,-143
7586,7586,71,2022/4/15 9:20:00,26,105,-79
7587,7587,71,2022/4/15 9:30:00,22,82,-60
7588,7588,71,2022/4/15 9:40:00,18,76,-58
7589,7589,71,2022/4/15 9:50:00,17,67,-50
7590,7590,71,2022/4/15 10:00:00,17,68,-51
7591,7591,71,2022/4/15 10:10:00,16,63,-47
7592,7592,71,2022/4/15 10:20:00,15,60,-45
7593,7593,71,2022/4/15 10:30:00,16,52,-36
7594,7594,71,2022/4/15 10:40:00,16,49,-33
7595,7595,71,2022/4/15 10:50:00,19,51,-32
7596,7596,71,2022/4/15 11:00:00,16,40,-24
7597,7597,71,2022/4/15 11:10:00,23,47,-24
7598,7598,71,2022/4/15 11:20:00,22,45,-23
7599,7599,71,2022/4/15 11:30:00,21,46,-25
7600,7600,71,2022/4/15 11:40:00,22,42,-20
7601,7601,71,2022/4/15 11:50:00,21,46,-25
7602,7602,71,2022/4/15 12:00:00,26,47,-21
7603,7603,71,2022/4/15 12:10:00,22,40,-18
7604,7604,71,2022/4/15 12:20:00,21,47,-26
7605,7605,71,2022/4/15 12:30:00,20,46,-26
7606,7606,71,2022/4/15 12:40:00,25,49,-24
7607,7607,71,2022/4/15 12:50:00,20,51,-31
7608,7608,71,2022/4/15 13:00:00,18,49,-31
7609,7609,71,2022/4/15 13:10:00,22,53,-31
7610,7610,71,2022/4/15 13:20:00,18,50,-32
7611,7611,71,2022/4/15 13:30:00,20,48,-28
7612,7612,71,2022/4/15 13:40:00,22,49,-27
7613,7613,71,2022/4/15 13:50:00,22,49,-27
7614,7614,71,2022/4/15 14:00:00,21,47,-26
7615,7615,71,2022/4/15 14:10:00,19,50,-31
7616,7616,71,2022/4/15 14:20:00,22,48,-26
7617,7617,71,2022/4/15 14:30:00,21,45,-24
7618,7618,71,2022/4/15 14:40:00,21,48,-27
7619,7619,71,2022/4/15 14:50:00,24,46,-22
7620,7620,71,2022/4/15 15:00:00,23,45,-22
7621,7621,71,2022/4/15 15:10:00,26,46,-20
7622,7622,71,2022/4/15 15:20:00,25,41,-16
7623,7623,71,2022/4/15 15:30:00,21,47,-26
7624,7624,71,2022/4/15 15:40:00,25,47,-22
7625,7625,71,2022/4/15 15:50:00,27,51,-24
7626,7626,71,2022/4/15 16:00:00,28,40,-12
7627,7627,71,2022/4/15 16:10:00,27,37,-10
7628,7628,71,2022/4/15 16:20:00,28,55,-27
7629,7629,71,2022/4/15 16:30:00,44,55,-11
7630,7630,71,2022/4/15 16:40:00,40,42,-2
7631,7631,71,2022/4/15 16:50:00,47,52,-5
7632,7632,71,2022/4/15 17:00:00,94,62,32
7633,7633,71,2022/4/15 17:10:00,197,60,137
7634,7634,71,2022/4/15 17:20:00,79,64,15
7635,7635,71,2022/4/15 17:30:00,266,70,196
7636,7636,71,2022/4/15 17:40:00,461,72,389
7637,7637,71,2022/4/15 17:50:00,227,69,158
7638,7638,71,2022/4/15 18:00:00,216,85,131
7639,7639,71,2022/4/15 18:10:00,268,77,191
7640,7640,71,2022/4/15 18:20:00,137,77,60
7641,7641,71,2022/4/15 18:30:00,65,72,-7
7642,7642,71,2022/4/15 18:40:00,44,64,-20
7643,7643,71,2022/4/15 18:50:00,38,76,-38
7644,7644,71,2022/4/15 19:00:00,35,64,-29
7645,7645,71,2022/4/15 19:10:00,32,74,-42
7646,7646,71,2022/4/15 19:20:00,28,65,-37
7647,7647,71,2022/4/15 19:30:00,26,63,-37
7648,7648,71,2022/4/15 19:40:00,26,54,-28
7649,7649,71,2022/4/15 19:50:00,19,52,-33
7650,7650,71,2022/4/15 20:00:00,19,50,-31
7651,7651,71,2022/4/15 20:10:00,21,47,-26
7652,7652,71,2022/4/15 20:20:00,20,34,-14
7653,7653,71,2022/4/15 20:30:00,17,48,-31
7654,7654,71,2022/4/15 20:40:00,18,40,-22
7655,7655,71,2022/4/15 20:50:00,15,42,-27
7656,7656,71,2022/4/15 21:00:00,15,50,-35
7657,7657,71,2022/4/15 21:10:00,19,39,-20
7658,7658,71,2022/4/15 21:20:00,15,50,-35
7659,7659,71,2022/4/15 21:30:00,12,50,-38
7660,7660,71,2022/4/15 21:40:00,12,44,-32
7661,7661,71,2022/4/15 21:50:00,12,48,-36
7662,7662,71,2022/4/15 22:00:00,10,49,-39
7663,7663,71,2022/4/15 22:10:00,10,47,-37
7664,7664,71,2022/4/15 22:20:00,3,25,-22
7665,7665,71,2022/4/15 22:30:00,0,4,-4
7666,7666,71,2022/4/15 22:40:00,0,3,-3
7667,7667,71,2022/4/15 22:50:00,0,3,-3
7668,7668,72,2022/4/15 5:00:00,0,1,-1
7669,7669,72,2022/4/15 5:10:00,0,1,-1
7670,7670,72,2022/4/15 5:20:00,0,1,-1
7671,7671,72,2022/4/15 5:30:00,0,1,-1
7672,7672,72,2022/4/15 5:40:00,3,1,2
7673,7673,72,2022/4/15 5:50:00,11,1,10
7674,7674,72,2022/4/15 6:00:00,31,1,30
7675,7675,72,2022/4/15 6:10:00,30,1,29
7676,7676,72,2022/4/15 6:20:00,37,19,18
7677,7677,72,2022/4/15 6:30:00,44,19,25
7678,7678,72,2022/4/15 6:40:00,60,38,22
7679,7679,72,2022/4/15 6:50:00,76,47,29
7680,7680,72,2022/4/15 7:00:00,85,41,44
7681,7681,72,2022/4/15 7:10:00,155,39,116
7682,7682,72,2022/4/15 7:20:00,236,51,185
7683,7683,72,2022/4/15 7:30:00,281,48,233
7684,7684,72,2022/4/15 7:40:00,278,70,208
7685,7685,72,2022/4/15 7:50:00,331,63,268
7686,7686,72,2022/4/15 8:00:00,346,53,293
7687,7687,72,2022/4/15 8:10:00,303,54,249
7688,7688,72,2022/4/15 8:20:00,244,76,168
7689,7689,72,2022/4/15 8:30:00,195,62,133
7690,7690,72,2022/4/15 8:40:00,86,47,39
7691,7691,72,2022/4/15 8:50:00,72,47,25
7692,7692,72,2022/4/15 9:00:00,48,56,-8
7693,7693,72,2022/4/15 9:10:00,37,41,-4
7694,7694,72,2022/4/15 9:20:00,30,50,-20
7695,7695,72,2022/4/15 9:30:00,28,38,-10
7696,7696,72,2022/4/15 9:40:00,24,41,-17
7697,7697,72,2022/4/15 9:50:00,27,38,-11
7698,7698,72,2022/4/15 10:00:00,25,23,2
7699,7699,72,2022/4/15 10:10:00,22,47,-25
7700,7700,72,2022/4/15 10:20:00,21,31,-10
7701,7701,72,2022/4/15 10:30:00,18,38,-20
7702,7702,72,2022/4/15 10:40:00,18,38,-20
7703,7703,72,2022/4/15 10:50:00,18,36,-18
7704,7704,72,2022/4/15 11:00:00,16,33,-17
7705,7705,72,2022/4/15 11:10:00,18,38,-20
7706,7706,72,2022/4/15 11:20:00,18,38,-20
7707,7707,72,2022/4/15 11:30:00,17,39,-22
7708,7708,72,2022/4/15 11:40:00,17,38,-21
7709,7709,72,2022/4/15 11:50:00,20,46,-26
7710,7710,72,2022/4/15 12:00:00,22,42,-20
7711,7711,72,2022/4/15 12:10:00,22,38,-16
7712,7712,72,2022/4/15 12:20:00,21,38,-17
7713,7713,72,2022/4/15 12:30:00,19,46,-27
7714,7714,72,2022/4/15 12:40:00,23,38,-15
7715,7715,72,2022/4/15 12:50:00,17,38,-21
7716,7716,72,2022/4/15 13:00:00,17,41,-24
7717,7717,72,2022/4/15 13:10:00,19,47,-28
7718,7718,72,2022/4/15 13:20:00,13,47,-34
7719,7719,72,2022/4/15 13:30:00,15,42,-27
7720,7720,72,2022/4/15 13:40:00,18,50,-32
7721,7721,72,2022/4/15 13:50:00,17,41,-24
7722,7722,72,2022/4/15 14:00:00,17,44,-27
7723,7723,72,2022/4/15 14:10:00,15,49,-34
7724,7724,72,2022/4/15 14:20:00,13,48,-35
7725,7725,72,2022/4/15 14:30:00,14,50,-36
7726,7726,72,2022/4/15 14:40:00,15,45,-30
7727,7727,72,2022/4/15 14:50:00,16,57,-41
7728,7728,72,2022/4/15 15:00:00,10,57,-47
7729,7729,72,2022/4/15 15:10:00,15,57,-42
7730,7730,72,2022/4/15 15:20:00,16,57,-41
7731,7731,72,2022/4/15 15:30:00,16,62,-46
7732,7732,72,2022/4/15 15:40:00,17,62,-45
7733,7733,72,2022/4/15 15:50:00,14,62,-48
7734,7734,72,2022/4/15 16:00:00,17,66,-49
7735,7735,72,2022/4/15 16:10:00,20,71,-51
7736,7736,72,2022/4/15 16:20:00,22,72,-50
7737,7737,72,2022/4/15 16:30:00,25,68,-43
7738,7738,72,2022/4/15 16:40:00,27,71,-44
7739,7739,72,2022/4/15 16:50:00,35,82,-47
7740,7740,72,2022/4/15 17:00:00,37,76,-39
7741,7741,72,2022/4/15 17:10:00,43,90,-47
7742,7742,72,2022/4/15 17:20:00,33,104,-71
7743,7743,72,2022/4/15 17:30:00,28,118,-90
7744,7744,72,2022/4/15 17:40:00,26,117,-91
7745,7745,72,2022/4/15 17:50:00,33,116,-83
7746,7746,72,2022/4/15 18:00:00,39,110,-71
7747,7747,72,2022/4/15 18:10:00,25,132,-107
7748,7748,72,2022/4/15 18:20:00,26,133,-107
7749,7749,72,2022/4/15 18:30:00,21,121,-100
7750,7750,72,2022/4/15 18:40:00,19,124,-105
7751,7751,72,2022/4/15 18:50:00,17,107,-90
7752,7752,72,2022/4/15 19:00:00,14,107,-93
7753,7753,72,2022/4/15 19:10:00,18,106,-88
7754,7754,72,2022/4/15 19:20:00,15,120,-105
7755,7755,72,2022/4/15 19:30:00,14,117,-103
7756,7756,72,2022/4/15 19:40:00,15,102,-87
7757,7757,72,2022/4/15 19:50:00,15,94,-79
7758,7758,72,2022/4/15 20:00:00,20,79,-59
7759,7759,72,2022/4/15 20:10:00,15,78,-63
7760,7760,72,2022/4/15 20:20:00,13,80,-67
7761,7761,72,2022/4/15 20:30:00,17,75,-58
7762,7762,72,2022/4/15 20:40:00,15,70,-55
7763,7763,72,2022/4/15 20:50:00,13,64,-51
7764,7764,72,2022/4/15 21:00:00,14,71,-57
7765,7765,72,2022/4/15 21:10:00,16,73,-57
7766,7766,72,2022/4/15 21:20:00,14,75,-61
7767,7767,72,2022/4/15 21:30:00,12,73,-61
7768,7768,72,2022/4/15 21:40:00,12,74,-62
7769,7769,72,2022/4/15 21:50:00,9,75,-66
7770,7770,72,2022/4/15 22:00:00,6,71,-65
7771,7771,72,2022/4/15 22:10:00,0,64,-64
7772,7772,72,2022/4/15 22:20:00,0,65,-65
7773,7773,72,2022/4/15 22:30:00,0,56,-56
7774,7774,72,2022/4/15 22:40:00,0,40,-40
7775,7775,72,2022/4/15 22:50:00,0,3,-3
7776,7776,73,2022/4/15 5:00:00,0,1,-1
7777,7777,73,2022/4/15 5:10:00,0,1,-1
7778,7778,73,2022/4/15 5:20:00,0,1,-1
7779,7779,73,2022/4/15 5:30:00,0,1,-1
7780,7780,73,2022/4/15 5:40:00,0,1,-1
7781,7781,73,2022/4/15 5:50:00,3,1,2
7782,7782,73,2022/4/15 6:00:00,20,1,19
7783,7783,73,2022/4/15 6:10:00,22,8,14
7784,7784,73,2022/4/15 6:20:00,27,30,-3
7785,7785,73,2022/4/15 6:30:00,34,31,3
7786,7786,73,2022/4/15 6:40:00,47,45,2
7787,7787,73,2022/4/15 6:50:00,57,50,7
7788,7788,73,2022/4/15 7:00:00,66,46,20
7789,7789,73,2022/4/15 7:10:00,88,81,7
7790,7790,73,2022/4/15 7:20:00,105,89,16
7791,7791,73,2022/4/15 7:30:00,187,93,94
7792,7792,73,2022/4/15 7:40:00,217,107,110
7793,7793,73,2022/4/15 7:50:00,236,117,119
7794,7794,73,2022/4/15 8:00:00,256,190,66
7795,7795,73,2022/4/15 8:10:00,268,509,-241
7796,7796,73,2022/4/15 8:20:00,243,500,-257
7797,7797,73,2022/4/15 8:30:00,233,326,-93
7798,7798,73,2022/4/15 8:40:00,199,493,-294
7799,7799,73,2022/4/15 8:50:00,155,421,-266
7800,7800,73,2022/4/15 9:00:00,76,226,-150
7801,7801,73,2022/4/15 9:10:00,59,300,-241
7802,7802,73,2022/4/15 9:20:00,49,120,-71
7803,7803,73,2022/4/15 9:30:00,40,183,-143
7804,7804,73,2022/4/15 9:40:00,37,103,-66
7805,7805,73,2022/4/15 9:50:00,31,88,-57
7806,7806,73,2022/4/15 10:00:00,27,76,-49
7807,7807,73,2022/4/15 10:10:00,30,105,-75
7808,7808,73,2022/4/15 10:20:00,27,69,-42
7809,7809,73,2022/4/15 10:30:00,29,67,-38
7810,7810,73,2022/4/15 10:40:00,27,67,-40
7811,7811,73,2022/4/15 10:50:00,27,76,-49
7812,7812,73,2022/4/15 11:00:00,31,62,-31
7813,7813,73,2022/4/15 11:10:00,28,67,-39
7814,7814,73,2022/4/15 11:20:00,26,61,-35
7815,7815,73,2022/4/15 11:30:00,29,62,-33
7816,7816,73,2022/4/15 11:40:00,27,64,-37
7817,7817,73,2022/4/15 11:50:00,32,55,-23
7818,7818,73,2022/4/15 12:00:00,32,62,-30
7819,7819,73,2022/4/15 12:10:00,32,79,-47
7820,7820,73,2022/4/15 12:20:00,28,62,-34
7821,7821,73,2022/4/15 12:30:00,35,64,-29
7822,7822,73,2022/4/15 12:40:00,31,63,-32
7823,7823,73,2022/4/15 12:50:00,33,90,-57
7824,7824,73,2022/4/15 13:00:00,30,63,-33
7825,7825,73,2022/4/15 13:10:00,30,62,-32
7826,7826,73,2022/4/15 13:20:00,28,66,-38
7827,7827,73,2022/4/15 13:30:00,28,97,-69
7828,7828,73,2022/4/15 13:40:00,30,69,-39
7829,7829,73,2022/4/15 13:50:00,26,70,-44
7830,7830,73,2022/4/15 14:00:00,29,61,-32
7831,7831,73,2022/4/15 14:10:00,33,93,-60
7832,7832,73,2022/4/15 14:20:00,33,70,-37
7833,7833,73,2022/4/15 14:30:00,25,60,-35
7834,7834,73,2022/4/15 14:40:00,31,64,-33
7835,7835,73,2022/4/15 14:50:00,27,80,-53
7836,7836,73,2022/4/15 15:00:00,34,70,-36
7837,7837,73,2022/4/15 15:10:00,26,69,-43
7838,7838,73,2022/4/15 15:20:00,31,69,-38
7839,7839,73,2022/4/15 15:30:00,33,87,-54
7840,7840,73,2022/4/15 15:40:00,29,67,-38
7841,7841,73,2022/4/15 15:50:00,25,67,-42
7842,7842,73,2022/4/15 16:00:00,32,65,-33
7843,7843,73,2022/4/15 16:10:00,38,93,-55
7844,7844,73,2022/4/15 16:20:00,40,81,-41
7845,7845,73,2022/4/15 16:30:00,47,78,-31
7846,7846,73,2022/4/15 16:40:00,46,74,-28
7847,7847,73,2022/4/15 16:50:00,48,106,-58
7848,7848,73,2022/4/15 17:00:00,110,77,33
7849,7849,73,2022/4/15 17:10:00,227,103,124
7850,7850,73,2022/4/15 17:20:00,137,117,20
7851,7851,73,2022/4/15 17:30:00,228,112,116
7852,7852,73,2022/4/15 17:40:00,351,132,219
7853,7853,73,2022/4/15 17:50:00,305,151,154
7854,7854,73,2022/4/15 18:00:00,271,120,151
7855,7855,73,2022/4/15 18:10:00,352,191,161
7856,7856,73,2022/4/15 18:20:00,319,192,127
7857,7857,73,2022/4/15 18:30:00,205,114,91
7858,7858,73,2022/4/15 18:40:00,175,139,36
7859,7859,73,2022/4/15 18:50:00,132,143,-11
7860,7860,73,2022/4/15 19:00:00,77,108,-31
7861,7861,73,2022/4/15 19:10:00,58,115,-57
7862,7862,73,2022/4/15 19:20:00,52,127,-75
7863,7863,73,2022/4/15 19:30:00,46,104,-58
7864,7864,73,2022/4/15 19:40:00,40,110,-70
7865,7865,73,2022/4/15 19:50:00,35,97,-62
7866,7866,73,2022/4/15 20:00:00,32,70,-38
7867,7867,73,2022/4/15 20:10:00,34,93,-59
7868,7868,73,2022/4/15 20:20:00,35,66,-31
7869,7869,73,2022/4/15 20:30:00,31,71,-40
7870,7870,73,2022/4/15 20:40:00,28,109,-81
7871,7871,73,2022/4/15 20:50:00,29,74,-45
7872,7872,73,2022/4/15 21:00:00,26,72,-46
7873,7873,73,2022/4/15 21:10:00,31,68,-37
7874,7874,73,2022/4/15 21:20:00,33,95,-62
7875,7875,73,2022/4/15 21:30:00,29,76,-47
7876,7876,73,2022/4/15 21:40:00,28,70,-42
7877,7877,73,2022/4/15 21:50:00,26,83,-57
7878,7878,73,2022/4/15 22:00:00,20,89,-69
7879,7879,73,2022/4/15 22:10:00,17,65,-48
7880,7880,73,2022/4/15 22:20:00,9,55,-46
7881,7881,73,2022/4/15 22:30:00,3,62,-59
7882,7882,73,2022/4/15 22:40:00,0,46,-46
7883,7883,73,2022/4/15 22:50:00,0,3,-3
7884,7884,74,2022/4/15 5:00:00,0,1,-1
7885,7885,74,2022/4/15 5:10:00,0,1,-1
7886,7886,74,2022/4/15 5:20:00,0,1,-1
7887,7887,74,2022/4/15 5:30:00,0,1,-1
7888,7888,74,2022/4/15 5:40:00,3,1,2
7889,7889,74,2022/4/15 5:50:00,17,1,16
7890,7890,74,2022/4/15 6:00:00,31,2,29
7891,7891,74,2022/4/15 6:10:00,31,1,30
7892,7892,74,2022/4/15 6:20:00,43,2,41
7893,7893,74,2022/4/15 6:30:00,57,22,35
7894,7894,74,2022/4/15 6:40:00,72,30,42
7895,7895,74,2022/4/15 6:50:00,85,23,62
7896,7896,74,2022/4/15 7:00:00,148,32,116
7897,7897,74,2022/4/15 7:10:00,217,48,169
7898,7898,74,2022/4/15 7:20:00,280,44,236
7899,7899,74,2022/4/15 7:30:00,351,51,300
7900,7900,74,2022/4/15 7:40:00,474,69,405
7901,7901,74,2022/4/15 7:50:00,598,66,532
7902,7902,74,2022/4/15 8:00:00,631,72,559
7903,7903,74,2022/4/15 8:10:00,590,93,497
7904,7904,74,2022/4/15 8:20:00,474,86,388
7905,7905,74,2022/4/15 8:30:00,331,98,233
7906,7906,74,2022/4/15 8:40:00,278,110,168
7907,7907,74,2022/4/15 8:50:00,200,124,76
7908,7908,74,2022/4/15 9:00:00,145,97,48
7909,7909,74,2022/4/15 9:10:00,95,77,18
7910,7910,74,2022/4/15 9:20:00,64,56,8
7911,7911,74,2022/4/15 9:30:00,46,71,-25
7912,7912,74,2022/4/15 9:40:00,43,54,-11
7913,7913,74,2022/4/15 9:50:00,40,52,-12
7914,7914,74,2022/4/15 10:00:00,31,61,-30
7915,7915,74,2022/4/15 10:10:00,30,58,-28
7916,7916,74,2022/4/15 10:20:00,28,47,-19
7917,7917,74,2022/4/15 10:30:00,29,50,-21
7918,7918,74,2022/4/15 10:40:00,28,48,-20
7919,7919,74,2022/4/15 10:50:00,28,64,-36
7920,7920,74,2022/4/15 11:00:00,24,45,-21
7921,7921,74,2022/4/15 11:10:00,28,48,-20
7922,7922,74,2022/4/15 11:20:00,25,64,-39
7923,7923,74,2022/4/15 11:30:00,22,62,-40
7924,7924,74,2022/4/15 11:40:00,28,54,-26
7925,7925,74,2022/4/15 11:50:00,28,54,-26
7926,7926,74,2022/4/15 12:00:00,30,60,-30
7927,7927,74,2022/4/15 12:10:00,28,64,-36
7928,7928,74,2022/4/15 12:20:00,29,48,-19
7929,7929,74,2022/4/15 12:30:00,30,51,-21
7930,7930,74,2022/4/15 12:40:00,29,64,-35
7931,7931,74,2022/4/15 12:50:00,27,72,-45
7932,7932,74,2022/4/15 13:00:00,29,66,-37
7933,7933,74,2022/4/15 13:10:00,28,49,-21
7934,7934,74,2022/4/15 13:20:00,28,65,-37
7935,7935,74,2022/4/15 13:30:00,29,84,-55
7936,7936,74,2022/4/15 13:40:00,28,54,-26
7937,7937,74,2022/4/15 13:50:00,26,58,-32
7938,7938,74,2022/4/15 14:00:00,28,59,-31
7939,7939,74,2022/4/15 14:10:00,27,83,-56
7940,7940,74,2022/4/15 14:20:00,29,60,-31
7941,7941,74,2022/4/15 14:30:00,22,66,-44
7942,7942,74,2022/4/15 14:40:00,27,67,-40
7943,7943,74,2022/4/15 14:50:00,28,77,-49
7944,7944,74,2022/4/15 15:00:00,22,64,-42
7945,7945,74,2022/4/15 15:10:00,26,66,-40
7946,7946,74,2022/4/15 15:20:00,27,75,-48
7947,7947,74,2022/4/15 15:30:00,25,93,-68
7948,7948,74,2022/4/15 15:40:00,26,69,-43
7949,7949,74,2022/4/15 15:50:00,25,83,-58
7950,7950,74,2022/4/15 16:00:00,29,90,-61
7951,7951,74,2022/4/15 16:10:00,27,110,-83
7952,7952,74,2022/4/15 16:20:00,28,77,-49
7953,7953,74,2022/4/15 16:30:00,27,77,-50
7954,7954,74,2022/4/15 16:40:00,29,110,-81
7955,7955,74,2022/4/15 16:50:00,30,108,-78
7956,7956,74,2022/4/15 17:00:00,28,108,-80
7957,7957,74,2022/4/15 17:10:00,39,122,-83
7958,7958,74,2022/4/15 17:20:00,29,106,-77
7959,7959,74,2022/4/15 17:30:00,35,120,-85
7960,7960,74,2022/4/15 17:40:00,40,183,-143
7961,7961,74,2022/4/15 17:50:00,29,110,-81
7962,7962,74,2022/4/15 18:00:00,48,223,-175
7963,7963,74,2022/4/15 18:10:00,77,322,-245
7964,7964,74,2022/4/15 18:20:00,45,110,-65
7965,7965,74,2022/4/15 18:30:00,35,337,-302
7966,7966,74,2022/4/15 18:40:00,39,322,-283
7967,7967,74,2022/4/15 18:50:00,29,119,-90
7968,7968,74,2022/4/15 19:00:00,28,285,-257
7969,7969,74,2022/4/15 19:10:00,26,178,-152
7970,7970,74,2022/4/15 19:20:00,25,113,-88
7971,7971,74,2022/4/15 19:30:00,24,103,-79
7972,7972,74,2022/4/15 19:40:00,23,112,-89
7973,7973,74,2022/4/15 19:50:00,21,97,-76
7974,7974,74,2022/4/15 20:00:00,22,103,-81
7975,7975,74,2022/4/15 20:10:00,19,109,-90
7976,7976,74,2022/4/15 20:20:00,18,81,-63
7977,7977,74,2022/4/15 20:30:00,17,104,-87
7978,7978,74,2022/4/15 20:40:00,19,89,-70
7979,7979,74,2022/4/15 20:50:00,17,83,-66
7980,7980,74,2022/4/15 21:00:00,19,78,-59
7981,7981,74,2022/4/15 21:10:00,16,107,-91
7982,7982,74,2022/4/15 21:20:00,13,75,-62
7983,7983,74,2022/4/15 21:30:00,13,85,-72
7984,7984,74,2022/4/15 21:40:00,13,92,-79
7985,7985,74,2022/4/15 21:50:00,11,109,-98
7986,7986,74,2022/4/15 22:00:00,12,94,-82
7987,7987,74,2022/4/15 22:10:00,6,78,-72
7988,7988,74,2022/4/15 22:20:00,1,71,-70
7989,7989,74,2022/4/15 22:30:00,1,92,-91
7990,7990,74,2022/4/15 22:40:00,1,59,-58
7991,7991,74,2022/4/15 22:50:00,0,3,-3
7992,7992,75,2022/4/15 5:00:00,0,1,-1
7993,7993,75,2022/4/15 5:10:00,0,1,-1
7994,7994,75,2022/4/15 5:20:00,0,1,-1
7995,7995,75,2022/4/15 5:30:00,0,1,-1
7996,7996,75,2022/4/15 5:40:00,0,1,-1
7997,7997,75,2022/4/15 5:50:00,3,1,2
7998,7998,75,2022/4/15 6:00:00,13,1,12
7999,7999,75,2022/4/15 6:10:00,18,19,-1
8000,8000,75,2022/4/15 6:20:00,23,25,-2
8001,8001,75,2022/4/15 6:30:00,32,37,-5
8002,8002,75,2022/4/15 6:40:00,32,50,-18
8003,8003,75,2022/4/15 6:50:00,41,52,-11
8004,8004,75,2022/4/15 7:00:00,36,51,-15
8005,8005,75,2022/4/15 7:10:00,57,73,-16
8006,8006,75,2022/4/15 7:20:00,56,88,-32
8007,8007,75,2022/4/15 7:30:00,68,99,-31
8008,8008,75,2022/4/15 7:40:00,87,124,-37
8009,8009,75,2022/4/15 7:50:00,155,88,67
8010,8010,75,2022/4/15 8:00:00,168,133,35
8011,8011,75,2022/4/15 8:10:00,198,197,1
8012,8012,75,2022/4/15 8:20:00,183,155,28
8013,8013,75,2022/4/15 8:30:00,181,214,-33
8014,8014,75,2022/4/15 8:40:00,148,268,-120
8015,8015,75,2022/4/15 8:50:00,122,155,-33
8016,8016,75,2022/4/15 9:00:00,69,139,-70
8017,8017,75,2022/4/15 9:10:00,64,125,-61
8018,8018,75,2022/4/15 9:20:00,49,110,-61
8019,8019,75,2022/4/15 9:30:00,46,105,-59
8020,8020,75,2022/4/15 9:40:00,38,125,-87
8021,8021,75,2022/4/15 9:50:00,38,123,-85
8022,8022,75,2022/4/15 10:00:00,29,103,-74
8023,8023,75,2022/4/15 10:10:00,32,110,-78
8024,8024,75,2022/4/15 10:20:00,31,108,-77
8025,8025,75,2022/4/15 10:30:00,27,114,-87
8026,8026,75,2022/4/15 10:40:00,29,103,-74
8027,8027,75,2022/4/15 10:50:00,29,99,-70
8028,8028,75,2022/4/15 11:00:00,34,110,-76
8029,8029,75,2022/4/15 11:10:00,28,105,-77
8030,8030,75,2022/4/15 11:20:00,29,99,-70
8031,8031,75,2022/4/15 11:30:00,31,101,-70
8032,8032,75,2022/4/15 11:40:00,39,108,-69
8033,8033,75,2022/4/15 11:50:00,45,110,-65
8034,8034,75,2022/4/15 12:00:00,45,112,-67
8035,8035,75,2022/4/15 12:10:00,52,99,-47
8036,8036,75,2022/4/15 12:20:00,44,105,-61
8037,8037,75,2022/4/15 12:30:00,47,108,-61
8038,8038,75,2022/4/15 12:40:00,40,104,-64
8039,8039,75,2022/4/15 12:50:00,49,103,-54
8040,8040,75,2022/4/15 13:00:00,56,113,-57
8041,8041,75,2022/4/15 13:10:00,59,105,-46
8042,8042,75,2022/4/15 13:20:00,47,104,-57
8043,8043,75,2022/4/15 13:30:00,55,104,-49
8044,8044,75,2022/4/15 13:40:00,51,107,-56
8045,8045,75,2022/4/15 13:50:00,47,105,-58
8046,8046,75,2022/4/15 14:00:00,56,110,-54
8047,8047,75,2022/4/15 14:10:00,55,106,-51
8048,8048,75,2022/4/15 14:20:00,59,102,-43
8049,8049,75,2022/4/15 14:30:00,59,110,-51
8050,8050,75,2022/4/15 14:40:00,57,112,-55
8051,8051,75,2022/4/15 14:50:00,64,97,-33
8052,8052,75,2022/4/15 15:00:00,55,104,-49
8053,8053,75,2022/4/15 15:10:00,67,108,-41
8054,8054,75,2022/4/15 15:20:00,72,112,-40
8055,8055,75,2022/4/15 15:30:00,64,104,-40
8056,8056,75,2022/4/15 15:40:00,76,110,-34
8057,8057,75,2022/4/15 15:50:00,76,103,-27
8058,8058,75,2022/4/15 16:00:00,73,108,-35
8059,8059,75,2022/4/15 16:10:00,71,101,-30
8060,8060,75,2022/4/15 16:20:00,70,99,-29
8061,8061,75,2022/4/15 16:30:00,168,95,73
8062,8062,75,2022/4/15 16:40:00,128,121,7
8063,8063,75,2022/4/15 16:50:00,175,116,59
8064,8064,75,2022/4/15 17:00:00,234,110,124
8065,8065,75,2022/4/15 17:10:00,272,143,129
8066,8066,75,2022/4/15 17:20:00,205,149,56
8067,8067,75,2022/4/15 17:30:00,213,221,-8
8068,8068,75,2022/4/15 17:40:00,235,232,3
8069,8069,75,2022/4/15 17:50:00,255,268,-13
8070,8070,75,2022/4/15 18:00:00,202,336,-134
8071,8071,75,2022/4/15 18:10:00,268,320,-52
8072,8072,75,2022/4/15 18:20:00,205,321,-116
8073,8073,75,2022/4/15 18:30:00,211,387,-176
8074,8074,75,2022/4/15 18:40:00,165,336,-171
8075,8075,75,2022/4/15 18:50:00,142,285,-143
8076,8076,75,2022/4/15 19:00:00,127,197,-70
8077,8077,75,2022/4/15 19:10:00,110,158,-48
8078,8078,75,2022/4/15 19:20:00,96,128,-32
8079,8079,75,2022/4/15 19:30:00,83,111,-28
8080,8080,75,2022/4/15 19:40:00,101,115,-14
8081,8081,75,2022/4/15 19:50:00,133,116,17
8082,8082,75,2022/4/15 20:00:00,170,106,64
8083,8083,75,2022/4/15 20:10:00,167,107,60
8084,8084,75,2022/4/15 20:20:00,196,112,84
8085,8085,75,2022/4/15 20:30:00,273,99,174
8086,8086,75,2022/4/15 20:40:00,268,89,179
8087,8087,75,2022/4/15 20:50:00,208,94,114
8088,8088,75,2022/4/15 21:00:00,204,93,111
8089,8089,75,2022/4/15 21:10:00,149,94,55
8090,8090,75,2022/4/15 21:20:00,157,76,81
8091,8091,75,2022/4/15 21:30:00,159,78,81
8092,8092,75,2022/4/15 21:40:00,114,78,36
8093,8093,75,2022/4/15 21:50:00,124,75,49
8094,8094,75,2022/4/15 22:00:00,271,76,195
8095,8095,75,2022/4/15 22:10:00,90,62,28
8096,8096,75,2022/4/15 22:20:00,24,69,-45
8097,8097,75,2022/4/15 22:30:00,10,67,-57
8098,8098,75,2022/4/15 22:40:00,1,21,-20
8099,8099,75,2022/4/15 22:50:00,0,3,-3
8100,8100,76,2022/4/15 5:00:00,0,1,-1
8101,8101,76,2022/4/15 5:10:00,0,1,-1
8102,8102,76,2022/4/15 5:20:00,0,1,-1
8103,8103,76,2022/4/15 5:30:00,0,1,-1
8104,8104,76,2022/4/15 5:40:00,4,1,3
8105,8105,76,2022/4/15 5:50:00,17,1,16
8106,8106,76,2022/4/15 6:00:00,19,1,18
8107,8107,76,2022/4/15 6:10:00,23,1,22
8108,8108,76,2022/4/15 6:20:00,25,1,24
8109,8109,76,2022/4/15 6:30:00,32,19,13
8110,8110,76,2022/4/15 6:40:00,31,8,23
8111,8111,76,2022/4/15 6:50:00,32,31,1
8112,8112,76,2022/4/15 7:00:00,27,23,4
8113,8113,76,2022/4/15 7:10:00,43,21,22
8114,8114,76,2022/4/15 7:20:00,49,40,9
8115,8115,76,2022/4/15 7:30:00,47,37,10
8116,8116,76,2022/4/15 7:40:00,80,41,39
8117,8117,76,2022/4/15 7:50:00,80,67,13
8118,8118,76,2022/4/15 8:00:00,56,102,-46
8119,8119,76,2022/4/15 8:10:00,52,89,-37
8120,8120,76,2022/4/15 8:20:00,59,112,-53
8121,8121,76,2022/4/15 8:30:00,53,108,-55
8122,8122,76,2022/4/15 8:40:00,39,114,-75
8123,8123,76,2022/4/15 8:50:00,32,125,-93
8124,8124,76,2022/4/15 9:00:00,27,98,-71
8125,8125,76,2022/4/15 9:10:00,24,60,-36
8126,8126,76,2022/4/15 9:20:00,24,77,-53
8127,8127,76,2022/4/15 9:30:00,23,58,-35
8128,8128,76,2022/4/15 9:40:00,20,72,-52
8129,8129,76,2022/4/15 9:50:00,20,51,-31
8130,8130,76,2022/4/15 10:00:00,19,38,-19
8131,8131,76,2022/4/15 10:10:00,18,40,-22
8132,8132,76,2022/4/15 10:20:00,19,60,-41
8133,8133,76,2022/4/15 10:30:00,14,41,-27
8134,8134,76,2022/4/15 10:40:00,16,33,-17
8135,8135,76,2022/4/15 10:50:00,16,31,-15
8136,8136,76,2022/4/15 11:00:00,17,45,-28
8137,8137,76,2022/4/15 11:10:00,17,33,-16
8138,8138,76,2022/4/15 11:20:00,16,31,-15
8139,8139,76,2022/4/15 11:30:00,15,32,-17
8140,8140,76,2022/4/15 11:40:00,17,44,-27
8141,8141,76,2022/4/15 11:50:00,17,34,-17
8142,8142,76,2022/4/15 12:00:00,18,29,-11
8143,8143,76,2022/4/15 12:10:00,18,31,-13
8144,8144,76,2022/4/15 12:20:00,20,49,-29
8145,8145,76,2022/4/15 12:30:00,20,34,-14
8146,8146,76,2022/4/15 12:40:00,17,40,-23
8147,8147,76,2022/4/15 12:50:00,17,31,-14
8148,8148,76,2022/4/15 13:00:00,19,52,-33
8149,8149,76,2022/4/15 13:10:00,15,39,-24
8150,8150,76,2022/4/15 13:20:00,16,38,-22
8151,8151,76,2022/4/15 13:30:00,19,38,-19
8152,8152,76,2022/4/15 13:40:00,19,61,-42
8153,8153,76,2022/4/15 13:50:00,19,47,-28
8154,8154,76,2022/4/15 14:00:00,20,40,-20
8155,8155,76,2022/4/15 14:10:00,17,38,-21
8156,8156,76,2022/4/15 14:20:00,20,61,-41
8157,8157,76,2022/4/15 14:30:00,16,46,-30
8158,8158,76,2022/4/15 14:40:00,16,38,-22
8159,8159,76,2022/4/15 14:50:00,19,38,-19
8160,8160,76,2022/4/15 15:00:00,16,62,-46
8161,8161,76,2022/4/15 15:10:00,17,38,-21
8162,8162,76,2022/4/15 15:20:00,18,37,-19
8163,8163,76,2022/4/15 15:30:00,18,38,-20
8164,8164,76,2022/4/15 15:40:00,20,67,-47
8165,8165,76,2022/4/15 15:50:00,18,48,-30
8166,8166,76,2022/4/15 16:00:00,19,38,-19
8167,8167,76,2022/4/15 16:10:00,20,41,-21
8168,8168,76,2022/4/15 16:20:00,17,63,-46
8169,8169,76,2022/4/15 16:30:00,22,49,-27
8170,8170,76,2022/4/15 16:40:00,25,45,-20
8171,8171,76,2022/4/15 16:50:00,23,47,-24
8172,8172,76,2022/4/15 17:00:00,28,73,-45
8173,8173,76,2022/4/15 17:10:00,28,48,-20
8174,8174,76,2022/4/15 17:20:00,33,63,-30
8175,8175,76,2022/4/15 17:30:00,35,70,-35
8176,8176,76,2022/4/15 17:40:00,68,61,7
8177,8177,76,2022/4/15 17:50:00,35,75,-40
8178,8178,76,2022/4/15 18:00:00,37,79,-42
8179,8179,76,2022/4/15 18:10:00,62,71,-9
8180,8180,76,2022/4/15 18:20:00,47,89,-42
8181,8181,76,2022/4/15 18:30:00,35,97,-62
8182,8182,76,2022/4/15 18:40:00,29,75,-46
8183,8183,76,2022/4/15 18:50:00,29,92,-63
8184,8184,76,2022/4/15 19:00:00,26,88,-62
8185,8185,76,2022/4/15 19:10:00,24,65,-41
8186,8186,76,2022/4/15 19:20:00,20,72,-52
8187,8187,76,2022/4/15 19:30:00,15,75,-60
8188,8188,76,2022/4/15 19:40:00,16,53,-37
8189,8189,76,2022/4/15 19:50:00,16,70,-54
8190,8190,76,2022/4/15 20:00:00,13,60,-47
8191,8191,76,2022/4/15 20:10:00,15,38,-23
8192,8192,76,2022/4/15 20:20:00,12,52,-40
8193,8193,76,2022/4/15 20:30:00,12,39,-27
8194,8194,76,2022/4/15 20:40:00,11,43,-32
8195,8195,76,2022/4/15 20:50:00,10,53,-43
8196,8196,76,2022/4/15 21:00:00,12,30,-18
8197,8197,76,2022/4/15 21:10:00,15,32,-17
8198,8198,76,2022/4/15 21:20:00,13,32,-19
8199,8199,76,2022/4/15 21:30:00,10,51,-41
8200,8200,76,2022/4/15 21:40:00,11,34,-23
8201,8201,76,2022/4/15 21:50:00,8,27,-19
8202,8202,76,2022/4/15 22:00:00,9,37,-28
8203,8203,76,2022/4/15 22:10:00,1,46,-45
8204,8204,76,2022/4/15 22:20:00,0,34,-34
8205,8205,76,2022/4/15 22:30:00,0,27,-27
8206,8206,76,2022/4/15 22:40:00,0,26,-26
8207,8207,76,2022/4/15 22:50:00,0,21,-21
8208,8208,77,2022/4/15 5:00:00,0,1,-1
8209,8209,77,2022/4/15 5:10:00,0,1,-1
8210,8210,77,2022/4/15 5:20:00,0,1,-1
8211,8211,77,2022/4/15 5:30:00,3,1,2
8212,8212,77,2022/4/15 5:40:00,30,1,29
8213,8213,77,2022/4/15 5:50:00,67,1,66
8214,8214,77,2022/4/15 6:00:00,60,1,59
8215,8215,77,2022/4/15 6:10:00,97,1,96
8216,8216,77,2022/4/15 6:20:00,215,1,214
8217,8217,77,2022/4/15 6:30:00,235,54,181
8218,8218,77,2022/4/15 6:40:00,277,37,240
8219,8219,77,2022/4/15 6:50:00,328,37,291
8220,8220,77,2022/4/15 7:00:00,599,49,550
8221,8221,77,2022/4/15 7:10:00,730,56,674
8222,8222,77,2022/4/15 7:20:00,824,83,741
8223,8223,77,2022/4/15 7:30:00,1214,75,1139
8224,8224,77,2022/4/15 7:40:00,1600,92,1508
8225,8225,77,2022/4/15 7:50:00,1987,87,1900
8226,8226,77,2022/4/15 8:00:00,1988,109,1879
8227,8227,77,2022/4/15 8:10:00,1638,121,1517
8228,8228,77,2022/4/15 8:20:00,1384,110,1274
8229,8229,77,2022/4/15 8:30:00,1167,108,1059
8230,8230,77,2022/4/15 8:40:00,726,111,615
8231,8231,77,2022/4/15 8:50:00,639,106,533
8232,8232,77,2022/4/15 9:00:00,432,106,326
8233,8233,77,2022/4/15 9:10:00,275,121,154
8234,8234,77,2022/4/15 9:20:00,275,93,182
8235,8235,77,2022/4/15 9:30:00,219,93,126
8236,8236,77,2022/4/15 9:40:00,177,74,103
8237,8237,77,2022/4/15 9:50:00,140,94,46
8238,8238,77,2022/4/15 10:00:00,85,104,-19
8239,8239,77,2022/4/15 10:10:00,76,85,-9
8240,8240,77,2022/4/15 10:20:00,62,84,-22
8241,8241,77,2022/4/15 10:30:00,58,87,-29
8242,8242,77,2022/4/15 10:40:00,57,102,-45
8243,8243,77,2022/4/15 10:50:00,48,80,-32
8244,8244,77,2022/4/15 11:00:00,47,77,-30
8245,8245,77,2022/4/15 11:10:00,47,106,-59
8246,8246,77,2022/4/15 11:20:00,45,108,-63
8247,8247,77,2022/4/15 11:30:00,44,87,-43
8248,8248,77,2022/4/15 11:40:00,59,69,-10
8249,8249,77,2022/4/15 11:50:00,66,107,-41
8250,8250,77,2022/4/15 12:00:00,62,102,-40
8251,8251,77,2022/4/15 12:10:00,62,77,-15
8252,8252,77,2022/4/15 12:20:00,68,75,-7
8253,8253,77,2022/4/15 12:30:00,67,103,-36
8254,8254,77,2022/4/15 12:40:00,64,103,-39
8255,8255,77,2022/4/15 12:50:00,56,79,-23
8256,8256,77,2022/4/15 13:00:00,54,75,-21
8257,8257,77,2022/4/15 13:10:00,55,108,-53
8258,8258,77,2022/4/15 13:20:00,45,110,-65
8259,8259,77,2022/4/15 13:30:00,43,90,-47
8260,8260,77,2022/4/15 13:40:00,43,82,-39
8261,8261,77,2022/4/15 13:50:00,48,93,-45
8262,8262,77,2022/4/15 14:00:00,42,124,-82
8263,8263,77,2022/4/15 14:10:00,41,87,-46
8264,8264,77,2022/4/15 14:20:00,41,93,-52
8265,8265,77,2022/4/15 14:30:00,40,108,-68
8266,8266,77,2022/4/15 14:40:00,43,115,-72
8267,8267,77,2022/4/15 14:50:00,40,105,-65
8268,8268,77,2022/4/15 15:00:00,40,93,-53
8269,8269,77,2022/4/15 15:10:00,41,102,-61
8270,8270,77,2022/4/15 15:20:00,38,109,-71
8271,8271,77,2022/4/15 15:30:00,46,106,-60
8272,8272,77,2022/4/15 15:40:00,46,105,-59
8273,8273,77,2022/4/15 15:50:00,41,121,-80
8274,8274,77,2022/4/15 16:00:00,44,184,-140
8275,8275,77,2022/4/15 16:10:00,44,120,-76
8276,8276,77,2022/4/15 16:20:00,43,124,-81
8277,8277,77,2022/4/15 16:30:00,44,115,-71
8278,8278,77,2022/4/15 16:40:00,50,198,-148
8279,8279,77,2022/4/15 16:50:00,44,120,-76
8280,8280,77,2022/4/15 17:00:00,49,118,-69
8281,8281,77,2022/4/15 17:10:00,70,317,-247
8282,8282,77,2022/4/15 17:20:00,53,175,-122
8283,8283,77,2022/4/15 17:30:00,54,231,-177
8284,8284,77,2022/4/15 17:40:00,128,531,-403
8285,8285,77,2022/4/15 17:50:00,75,317,-242
8286,8286,77,2022/4/15 18:00:00,66,477,-411
8287,8287,77,2022/4/15 18:10:00,70,573,-503
8288,8288,77,2022/4/15 18:20:00,67,503,-436
8289,8289,77,2022/4/15 18:30:00,46,601,-555
8290,8290,77,2022/4/15 18:40:00,42,1109,-1067
8291,8291,77,2022/4/15 18:50:00,36,402,-366
8292,8292,77,2022/4/15 19:00:00,43,626,-583
8293,8293,77,2022/4/15 19:10:00,29,584,-555
8294,8294,77,2022/4/15 19:20:00,28,326,-298
8295,8295,77,2022/4/15 19:30:00,33,504,-471
8296,8296,77,2022/4/15 19:40:00,31,435,-404
8297,8297,77,2022/4/15 19:50:00,26,169,-143
8298,8298,77,2022/4/15 20:00:00,30,272,-242
8299,8299,77,2022/4/15 20:10:00,33,219,-186
8300,8300,77,2022/4/15 20:20:00,30,112,-82
8301,8301,77,2022/4/15 20:30:00,28,237,-209
8302,8302,77,2022/4/15 20:40:00,36,109,-73
8303,8303,77,2022/4/15 20:50:00,24,144,-120
8304,8304,77,2022/4/15 21:00:00,32,198,-166
8305,8305,77,2022/4/15 21:10:00,25,109,-84
8306,8306,77,2022/4/15 21:20:00,24,128,-104
8307,8307,77,2022/4/15 21:30:00,27,111,-84
8308,8308,77,2022/4/15 21:40:00,28,273,-245
8309,8309,77,2022/4/15 21:50:00,26,153,-127
8310,8310,77,2022/4/15 22:00:00,20,110,-90
8311,8311,77,2022/4/15 22:10:00,1,115,-114
8312,8312,77,2022/4/15 22:20:00,1,209,-208
8313,8313,77,2022/4/15 22:30:00,0,122,-122
8314,8314,77,2022/4/15 22:40:00,0,100,-100
8315,8315,77,2022/4/15 22:50:00,0,95,-95
8316,8316,78,2022/4/15 5:00:00,0,1,-1
8317,8317,78,2022/4/15 5:10:00,0,1,-1
8318,8318,78,2022/4/15 5:20:00,0,1,-1
8319,8319,78,2022/4/15 5:30:00,0,1,-1
8320,8320,78,2022/4/15 5:40:00,1,1,0
8321,8321,78,2022/4/15 5:50:00,13,1,12
8322,8322,78,2022/4/15 6:00:00,30,1,29
8323,8323,78,2022/4/15 6:10:00,31,1,30
8324,8324,78,2022/4/15 6:20:00,46,23,23
8325,8325,78,2022/4/15 6:30:00,57,33,24
8326,8326,78,2022/4/15 6:40:00,87,41,46
8327,8327,78,2022/4/15 6:50:00,154,39,115
8328,8328,78,2022/4/15 7:00:00,225,45,180
8329,8329,78,2022/4/15 7:10:00,279,46,233
8330,8330,78,2022/4/15 7:20:00,350,60,290
8331,8331,78,2022/4/15 7:30:00,441,77,364
8332,8332,78,2022/4/15 7:40:00,593,68,525
8333,8333,78,2022/4/15 7:50:00,599,126,473
8334,8334,78,2022/4/15 8:00:00,688,109,579
8335,8335,78,2022/4/15 8:10:00,663,115,548
8336,8336,78,2022/4/15 8:20:00,590,180,410
8337,8337,78,2022/4/15 8:30:00,375,106,269
8338,8338,78,2022/4/15 8:40:00,281,194,87
8339,8339,78,2022/4/15 8:50:00,247,181,66
8340,8340,78,2022/4/15 9:00:00,200,133,67
8341,8341,78,2022/4/15 9:10:00,149,102,47
8342,8342,78,2022/4/15 9:20:00,81,89,-8
8343,8343,78,2022/4/15 9:30:00,58,79,-21
8344,8344,78,2022/4/15 9:40:00,51,83,-32
8345,8345,78,2022/4/15 9:50:00,43,75,-32
8346,8346,78,2022/4/15 10:00:00,36,80,-44
8347,8347,78,2022/4/15 10:10:00,37,54,-17
8348,8348,78,2022/4/15 10:20:00,31,63,-32
8349,8349,78,2022/4/15 10:30:00,35,71,-36
8350,8350,78,2022/4/15 10:40:00,27,64,-37
8351,8351,78,2022/4/15 10:50:00,29,51,-22
8352,8352,78,2022/4/15 11:00:00,29,45,-16
8353,8353,78,2022/4/15 11:10:00,28,60,-32
8354,8354,78,2022/4/15 11:20:00,26,59,-33
8355,8355,78,2022/4/15 11:30:00,26,46,-20
8356,8356,78,2022/4/15 11:40:00,27,55,-28
8357,8357,78,2022/4/15 11:50:00,33,63,-30
8358,8358,78,2022/4/15 12:00:00,25,61,-36
8359,8359,78,2022/4/15 12:10:00,34,57,-23
8360,8360,78,2022/4/15 12:20:00,33,65,-32
8361,8361,78,2022/4/15 12:30:00,28,85,-57
8362,8362,78,2022/4/15 12:40:00,31,64,-33
8363,8363,78,2022/4/15 12:50:00,31,53,-22
8364,8364,78,2022/4/15 13:00:00,29,63,-34
8365,8365,78,2022/4/15 13:10:00,32,69,-37
8366,8366,78,2022/4/15 13:20:00,27,69,-42
8367,8367,78,2022/4/15 13:30:00,28,65,-37
8368,8368,78,2022/4/15 13:40:00,29,64,-35
8369,8369,78,2022/4/15 13:50:00,28,73,-45
8370,8370,78,2022/4/15 14:00:00,26,73,-47
8371,8371,78,2022/4/15 14:10:00,28,62,-34
8372,8372,78,2022/4/15 14:20:00,25,66,-41
8373,8373,78,2022/4/15 14:30:00,26,76,-50
8374,8374,78,2022/4/15 14:40:00,23,75,-52
8375,8375,78,2022/4/15 14:50:00,26,60,-34
8376,8376,78,2022/4/15 15:00:00,29,69,-40
8377,8377,78,2022/4/15 15:10:00,30,80,-50
8378,8378,78,2022/4/15 15:20:00,27,75,-48
8379,8379,78,2022/4/15 15:30:00,31,73,-42
8380,8380,78,2022/4/15 15:40:00,27,83,-56
8381,8381,78,2022/4/15 15:50:00,28,105,-77
8382,8382,78,2022/4/15 16:00:00,32,92,-60
8383,8383,78,2022/4/15 16:10:00,26,74,-48
8384,8384,78,2022/4/15 16:20:00,27,80,-53
8385,8385,78,2022/4/15 16:30:00,36,121,-85
8386,8386,78,2022/4/15 16:40:00,37,112,-75
8387,8387,78,2022/4/15 16:50:00,33,105,-72
8388,8388,78,2022/4/15 17:00:00,54,109,-55
8389,8389,78,2022/4/15 17:10:00,81,100,-19
8390,8390,78,2022/4/15 17:20:00,57,181,-124
8391,8391,78,2022/4/15 17:30:00,73,144,-71
8392,8392,78,2022/4/15 17:40:00,216,157,59
8393,8393,78,2022/4/15 17:50:00,139,333,-194
8394,8394,78,2022/4/15 18:00:00,70,225,-155
8395,8395,78,2022/4/15 18:10:00,197,299,-102
8396,8396,78,2022/4/15 18:20:00,92,328,-236
8397,8397,78,2022/4/15 18:30:00,56,227,-171
8398,8398,78,2022/4/15 18:40:00,48,300,-252
8399,8399,78,2022/4/15 18:50:00,43,329,-286
8400,8400,78,2022/4/15 19:00:00,38,158,-120
8401,8401,78,2022/4/15 19:10:00,38,154,-116
8402,8402,78,2022/4/15 19:20:00,31,146,-115
8403,8403,78,2022/4/15 19:30:00,28,122,-94
8404,8404,78,2022/4/15 19:40:00,33,124,-91
8405,8405,78,2022/4/15 19:50:00,27,115,-88
8406,8406,78,2022/4/15 20:00:00,27,109,-82
8407,8407,78,2022/4/15 20:10:00,28,92,-64
8408,8408,78,2022/4/15 20:20:00,26,122,-96
8409,8409,78,2022/4/15 20:30:00,25,89,-64
8410,8410,78,2022/4/15 20:40:00,22,91,-69
8411,8411,78,2022/4/15 20:50:00,20,91,-71
8412,8412,78,2022/4/15 21:00:00,21,123,-102
8413,8413,78,2022/4/15 21:10:00,22,92,-70
8414,8414,78,2022/4/15 21:20:00,17,77,-60
8415,8415,78,2022/4/15 21:30:00,17,95,-78
8416,8416,78,2022/4/15 21:40:00,16,127,-111
8417,8417,78,2022/4/15 21:50:00,16,75,-59
8418,8418,78,2022/4/15 22:00:00,13,78,-65
8419,8419,78,2022/4/15 22:10:00,10,84,-74
8420,8420,78,2022/4/15 22:20:00,2,103,-101
8421,8421,78,2022/4/15 22:30:00,2,71,-69
8422,8422,78,2022/4/15 22:40:00,0,54,-54
8423,8423,78,2022/4/15 22:50:00,0,3,-3
8424,8424,79,2022/4/15 5:00:00,0,1,-1
8425,8425,79,2022/4/15 5:10:00,0,1,-1
8426,8426,79,2022/4/15 5:20:00,0,1,-1
8427,8427,79,2022/4/15 5:30:00,0,1,-1
8428,8428,79,2022/4/15 5:40:00,0,1,-1
8429,8429,79,2022/4/15 5:50:00,3,1,2
8430,8430,79,2022/4/15 6:00:00,7,1,6
8431,8431,79,2022/4/15 6:10:00,13,2,11
8432,8432,79,2022/4/15 6:20:00,15,23,-8
8433,8433,79,2022/4/15 6:30:00,20,23,-3
8434,8434,79,2022/4/15 6:40:00,21,33,-12
8435,8435,79,2022/4/15 6:50:00,29,46,-17
8436,8436,79,2022/4/15 7:00:00,31,60,-29
8437,8437,79,2022/4/15 7:10:00,39,64,-25
8438,8438,79,2022/4/15 7:20:00,36,80,-44
8439,8439,79,2022/4/15 7:30:00,38,81,-43
8440,8440,79,2022/4/15 7:40:00,57,97,-40
8441,8441,79,2022/4/15 7:50:00,58,98,-40
8442,8442,79,2022/4/15 8:00:00,58,121,-63
8443,8443,79,2022/4/15 8:10:00,69,178,-109
8444,8444,79,2022/4/15 8:20:00,67,217,-150
8445,8445,79,2022/4/15 8:30:00,63,206,-143
8446,8446,79,2022/4/15 8:40:00,52,321,-269
8447,8447,79,2022/4/15 8:50:00,40,382,-342
8448,8448,79,2022/4/15 9:00:00,38,185,-147
8449,8449,79,2022/4/15 9:10:00,35,119,-84
8450,8450,79,2022/4/15 9:20:00,30,121,-91
8451,8451,79,2022/4/15 9:30:00,30,183,-153
8452,8452,79,2022/4/15 9:40:00,28,120,-92
8453,8453,79,2022/4/15 9:50:00,25,98,-73
8454,8454,79,2022/4/15 10:00:00,27,97,-70
8455,8455,79,2022/4/15 10:10:00,29,106,-77
8456,8456,79,2022/4/15 10:20:00,28,76,-48
8457,8457,79,2022/4/15 10:30:00,29,61,-32
8458,8458,79,2022/4/15 10:40:00,23,72,-49
8459,8459,79,2022/4/15 10:50:00,29,83,-54
8460,8460,79,2022/4/15 11:00:00,26,61,-35
8461,8461,79,2022/4/15 11:10:00,28,50,-22
8462,8462,79,2022/4/15 11:20:00,26,62,-36
8463,8463,79,2022/4/15 11:30:00,27,84,-57
8464,8464,79,2022/4/15 11:40:00,29,54,-25
8465,8465,79,2022/4/15 11:50:00,28,50,-22
8466,8466,79,2022/4/15 12:00:00,27,64,-37
8467,8467,79,2022/4/15 12:10:00,29,82,-53
8468,8468,79,2022/4/15 12:20:00,25,57,-32
8469,8469,79,2022/4/15 12:30:00,25,62,-37
8470,8470,79,2022/4/15 12:40:00,28,62,-34
8471,8471,79,2022/4/15 12:50:00,29,75,-46
8472,8472,79,2022/4/15 13:00:00,26,63,-37
8473,8473,79,2022/4/15 13:10:00,28,59,-31
8474,8474,79,2022/4/15 13:20:00,28,71,-43
8475,8475,79,2022/4/15 13:30:00,29,79,-50
8476,8476,79,2022/4/15 13:40:00,27,70,-43
8477,8477,79,2022/4/15 13:50:00,28,61,-33
8478,8478,79,2022/4/15 14:00:00,29,62,-33
8479,8479,79,2022/4/15 14:10:00,26,81,-55
8480,8480,79,2022/4/15 14:20:00,25,60,-35
8481,8481,79,2022/4/15 14:30:00,28,63,-35
8482,8482,79,2022/4/15 14:40:00,25,64,-39
8483,8483,79,2022/4/15 14:50:00,27,76,-49
8484,8484,79,2022/4/15 15:00:00,30,62,-32
8485,8485,79,2022/4/15 15:10:00,26,60,-34
8486,8486,79,2022/4/15 15:20:00,28,63,-35
8487,8487,79,2022/4/15 15:30:00,32,77,-45
8488,8488,79,2022/4/15 15:40:00,35,70,-35
8489,8489,79,2022/4/15 15:50:00,29,70,-41
8490,8490,79,2022/4/15 16:00:00,34,66,-32
8491,8491,79,2022/4/15 16:10:00,37,80,-43
8492,8492,79,2022/4/15 16:20:00,37,65,-28
8493,8493,79,2022/4/15 16:30:00,43,72,-29
8494,8494,79,2022/4/15 16:40:00,46,73,-27
8495,8495,79,2022/4/15 16:50:00,46,93,-47
8496,8496,79,2022/4/15 17:00:00,148,69,79
8497,8497,79,2022/4/15 17:10:00,167,77,90
8498,8498,79,2022/4/15 17:20:00,98,99,-1
8499,8499,79,2022/4/15 17:30:00,206,99,107
8500,8500,79,2022/4/15 17:40:00,233,112,121
8501,8501,79,2022/4/15 17:50:00,139,120,19
8502,8502,79,2022/4/15 18:00:00,225,107,118
8503,8503,79,2022/4/15 18:10:00,308,101,207
8504,8504,79,2022/4/15 18:20:00,216,110,106
8505,8505,79,2022/4/15 18:30:00,154,95,59
8506,8506,79,2022/4/15 18:40:00,129,107,22
8507,8507,79,2022/4/15 18:50:00,65,107,-42
8508,8508,79,2022/4/15 19:00:00,59,78,-19
8509,8509,79,2022/4/15 19:10:00,54,77,-23
8510,8510,79,2022/4/15 19:20:00,44,95,-51
8511,8511,79,2022/4/15 19:30:00,37,67,-30
8512,8512,79,2022/4/15 19:40:00,35,70,-35
8513,8513,79,2022/4/15 19:50:00,28,66,-38
8514,8514,79,2022/4/15 20:00:00,31,50,-19
8515,8515,79,2022/4/15 20:10:00,34,70,-36
8516,8516,79,2022/4/15 20:20:00,27,50,-23
8517,8517,79,2022/4/15 20:30:00,29,48,-19
8518,8518,79,2022/4/15 20:40:00,29,62,-33
8519,8519,79,2022/4/15 20:50:00,29,67,-38
8520,8520,79,2022/4/15 21:00:00,27,47,-20
8521,8521,79,2022/4/15 21:10:00,28,40,-12
8522,8522,79,2022/4/15 21:20:00,28,60,-32
8523,8523,79,2022/4/15 21:30:00,26,61,-35
8524,8524,79,2022/4/15 21:40:00,26,50,-24
8525,8525,79,2022/4/15 21:50:00,25,51,-26
8526,8526,79,2022/4/15 22:00:00,26,56,-30
8527,8527,79,2022/4/15 22:10:00,24,53,-29
8528,8528,79,2022/4/15 22:20:00,13,40,-27
8529,8529,79,2022/4/15 22:30:00,2,32,-30
8530,8530,79,2022/4/15 22:40:00,0,3,-3
8531,8531,79,2022/4/15 22:50:00,0,3,-3
8532,8532,80,2022/4/15 5:00:00,0,1,-1
8533,8533,80,2022/4/15 5:10:00,0,1,-1
8534,8534,80,2022/4/15 5:20:00,0,1,-1
8535,8535,80,2022/4/15 5:30:00,0,1,-1
8536,8536,80,2022/4/15 5:40:00,0,1,-1
8537,8537,80,2022/4/15 5:50:00,4,1,3
8538,8538,80,2022/4/15 6:00:00,11,1,10
8539,8539,80,2022/4/15 6:10:00,10,6,4
8540,8540,80,2022/4/15 6:20:00,16,35,-19
8541,8541,80,2022/4/15 6:30:00,20,23,-3
8542,8542,80,2022/4/15 6:40:00,29,50,-21
8543,8543,80,2022/4/15 6:50:00,32,84,-52
8544,8544,80,2022/4/15 7:00:00,32,66,-34
8545,8545,80,2022/4/15 7:10:00,33,99,-66
8546,8546,80,2022/4/15 7:20:00,54,97,-43
8547,8547,80,2022/4/15 7:30:00,60,124,-64
8548,8548,80,2022/4/15 7:40:00,88,184,-96
8549,8549,80,2022/4/15 7:50:00,112,131,-19
8550,8550,80,2022/4/15 8:00:00,157,322,-165
8551,8551,80,2022/4/15 8:10:00,150,428,-278
8552,8552,80,2022/4/15 8:20:00,163,494,-331
8553,8553,80,2022/4/15 8:30:00,143,1459,-1316
8554,8554,80,2022/4/15 8:40:00,87,1904,-1817
8555,8555,80,2022/4/15 8:50:00,57,411,-354
8556,8556,80,2022/4/15 9:00:00,48,434,-386
8557,8557,80,2022/4/15 9:10:00,37,501,-464
8558,8558,80,2022/4/15 9:20:00,39,316,-277
8559,8559,80,2022/4/15 9:30:00,29,196,-167
8560,8560,80,2022/4/15 9:40:00,30,376,-346
8561,8561,80,2022/4/15 9:50:00,33,177,-144
8562,8562,80,2022/4/15 10:00:00,28,110,-82
8563,8563,80,2022/4/15 10:10:00,28,106,-78
8564,8564,80,2022/4/15 10:20:00,33,110,-77
8565,8565,80,2022/4/15 10:30:00,31,97,-66
8566,8566,80,2022/4/15 10:40:00,33,93,-60
8567,8567,80,2022/4/15 10:50:00,30,77,-47
8568,8568,80,2022/4/15 11:00:00,31,108,-77
8569,8569,80,2022/4/15 11:10:00,29,75,-46
8570,8570,80,2022/4/15 11:20:00,33,61,-28
8571,8571,80,2022/4/15 11:30:00,33,64,-31
8572,8572,80,2022/4/15 11:40:00,33,101,-68
8573,8573,80,2022/4/15 11:50:00,30,83,-53
8574,8574,80,2022/4/15 12:00:00,32,78,-46
8575,8575,80,2022/4/15 12:10:00,35,72,-37
8576,8576,80,2022/4/15 12:20:00,42,105,-63
8577,8577,80,2022/4/15 12:30:00,36,82,-46
8578,8578,80,2022/4/15 12:40:00,36,76,-40
8579,8579,80,2022/4/15 12:50:00,37,73,-36
8580,8580,80,2022/4/15 13:00:00,36,110,-74
8581,8581,80,2022/4/15 13:10:00,39,75,-36
8582,8582,80,2022/4/15 13:20:00,36,74,-38
8583,8583,80,2022/4/15 13:30:00,35,77,-42
8584,8584,80,2022/4/15 13:40:00,38,104,-66
8585,8585,80,2022/4/15 13:50:00,37,76,-39
8586,8586,80,2022/4/15 14:00:00,39,74,-35
8587,8587,80,2022/4/15 14:10:00,35,69,-34
8588,8588,80,2022/4/15 14:20:00,43,106,-63
8589,8589,80,2022/4/15 14:30:00,38,84,-46
8590,8590,80,2022/4/15 14:40:00,44,84,-40
8591,8591,80,2022/4/15 14:50:00,40,62,-22
8592,8592,80,2022/4/15 15:00:00,39,101,-62
8593,8593,80,2022/4/15 15:10:00,43,85,-42
8594,8594,80,2022/4/15 15:20:00,43,81,-38
8595,8595,80,2022/4/15 15:30:00,38,74,-36
8596,8596,80,2022/4/15 15:40:00,45,109,-64
8597,8597,80,2022/4/15 15:50:00,43,85,-42
8598,8598,80,2022/4/15 16:00:00,48,83,-35
8599,8599,80,2022/4/15 16:10:00,49,67,-18
8600,8600,80,2022/4/15 16:20:00,54,104,-50
8601,8601,80,2022/4/15 16:30:00,62,81,-19
8602,8602,80,2022/4/15 16:40:00,98,84,14
8603,8603,80,2022/4/15 16:50:00,72,74,-2
8604,8604,80,2022/4/15 17:00:00,177,103,74
8605,8605,80,2022/4/15 17:10:00,271,109,162
8606,8606,80,2022/4/15 17:20:00,319,83,236
8607,8607,80,2022/4/15 17:30:00,317,112,205
8608,8608,80,2022/4/15 17:40:00,660,110,550
8609,8609,80,2022/4/15 17:50:00,432,108,324
8610,8610,80,2022/4/15 18:00:00,369,111,258
8611,8611,80,2022/4/15 18:10:00,723,143,580
8612,8612,80,2022/4/15 18:20:00,657,123,534
8613,8613,80,2022/4/15 18:30:00,326,152,174
8614,8614,80,2022/4/15 18:40:00,361,111,250
8615,8615,80,2022/4/15 18:50:00,275,107,168
8616,8616,80,2022/4/15 19:00:00,214,111,103
8617,8617,80,2022/4/15 19:10:00,225,123,102
8618,8618,80,2022/4/15 19:20:00,177,76,101
8619,8619,80,2022/4/15 19:30:00,129,106,23
8620,8620,80,2022/4/15 19:40:00,110,91,19
8621,8621,80,2022/4/15 19:50:00,77,56,21
8622,8622,80,2022/4/15 20:00:00,77,81,-4
8623,8623,80,2022/4/15 20:10:00,85,73,12
8624,8624,80,2022/4/15 20:20:00,70,59,11
8625,8625,80,2022/4/15 20:30:00,63,57,6
8626,8626,80,2022/4/15 20:40:00,63,67,-4
8627,8627,80,2022/4/15 20:50:00,55,71,-16
8628,8628,80,2022/4/15 21:00:00,56,52,4
8629,8629,80,2022/4/15 21:10:00,74,53,21
8630,8630,80,2022/4/15 21:20:00,75,64,11
8631,8631,80,2022/4/15 21:30:00,59,73,-14
8632,8632,80,2022/4/15 21:40:00,63,51,12
8633,8633,80,2022/4/15 21:50:00,48,51,-3
8634,8634,80,2022/4/15 22:00:00,42,58,-16
8635,8635,80,2022/4/15 22:10:00,40,66,-26
8636,8636,80,2022/4/15 22:20:00,12,42,-30
8637,8637,80,2022/4/15 22:30:00,2,36,-34
8638,8638,80,2022/4/15 22:40:00,0,31,-31
8639,8639,80,2022/4/15 22:50:00,0,3,-3
8640,8640,81,2022/4/15 5:00:00,0,1,-1
8641,8641,81,2022/4/15 5:10:00,0,1,-1
8642,8642,81,2022/4/15 5:20:00,0,1,-1
8643,8643,81,2022/4/15 5:30:00,0,1,-1
8644,8644,81,2022/4/15 5:40:00,8,1,7
8645,8645,81,2022/4/15 5:50:00,5,1,4
8646,8646,81,2022/4/15 6:00:00,11,1,10
8647,8647,81,2022/4/15 6:10:00,18,1,17
8648,8648,81,2022/4/15 6:20:00,18,1,17
8649,8649,81,2022/4/15 6:30:00,22,1,21
8650,8650,81,2022/4/15 6:40:00,28,1,27
8651,8651,81,2022/4/15 6:50:00,29,68,-39
8652,8652,81,2022/4/15 7:00:00,41,52,-11
8653,8653,81,2022/4/15 7:10:00,24,71,-47
8654,8654,81,2022/4/15 7:20:00,34,76,-42
8655,8655,81,2022/4/15 7:30:00,19,70,-51
8656,8656,81,2022/4/15 7:40:00,26,50,-24
8657,8657,81,2022/4/15 7:50:00,22,62,-40
8658,8658,81,2022/4/15 8:00:00,23,75,-52
8659,8659,81,2022/4/15 8:10:00,21,78,-57
8660,8660,81,2022/4/15 8:20:00,16,82,-66
8661,8661,81,2022/4/15 8:30:00,18,75,-57
8662,8662,81,2022/4/15 8:40:00,13,76,-63
8663,8663,81,2022/4/15 8:50:00,22,81,-59
8664,8664,81,2022/4/15 9:00:00,12,69,-57
8665,8665,81,2022/4/15 9:10:00,13,61,-48
8666,8666,81,2022/4/15 9:20:00,11,62,-51
8667,8667,81,2022/4/15 9:30:00,13,38,-25
8668,8668,81,2022/4/15 9:40:00,14,57,-43
8669,8669,81,2022/4/15 9:50:00,20,51,-31
8670,8670,81,2022/4/15 10:00:00,12,49,-37
8671,8671,81,2022/4/15 10:10:00,24,47,-23
8672,8672,81,2022/4/15 10:20:00,18,49,-31
8673,8673,81,2022/4/15 10:30:00,21,52,-31
8674,8674,81,2022/4/15 10:40:00,18,69,-51
8675,8675,81,2022/4/15 10:50:00,22,51,-29
8676,8676,81,2022/4/15 11:00:00,18,48,-30
8677,8677,81,2022/4/15 11:10:00,20,48,-28
8678,8678,81,2022/4/15 11:20:00,17,66,-49
8679,8679,81,2022/4/15 11:30:00,23,46,-23
8680,8680,81,2022/4/15 11:40:00,17,48,-31
8681,8681,81,2022/4/15 11:50:00,23,33,-10
8682,8682,81,2022/4/15 12:00:00,19,60,-41
8683,8683,81,2022/4/15 12:10:00,23,34,-11
8684,8684,81,2022/4/15 12:20:00,20,40,-20
8685,8685,81,2022/4/15 12:30:00,20,38,-18
8686,8686,81,2022/4/15 12:40:00,18,53,-35
8687,8687,81,2022/4/15 12:50:00,20,45,-25
8688,8688,81,2022/4/15 13:00:00,21,35,-14
8689,8689,81,2022/4/15 13:10:00,22,38,-16
8690,8690,81,2022/4/15 13:20:00,20,53,-33
8691,8691,81,2022/4/15 13:30:00,23,38,-15
8692,8692,81,2022/4/15 13:40:00,21,44,-23
8693,8693,81,2022/4/15 13:50:00,20,37,-17
8694,8694,81,2022/4/15 14:00:00,24,67,-43
8695,8695,81,2022/4/15 14:10:00,25,41,-16
8696,8696,81,2022/4/15 14:20:00,25,38,-13
8697,8697,81,2022/4/15 14:30:00,22,38,-16
8698,8698,81,2022/4/15 14:40:00,22,50,-28
8699,8699,81,2022/4/15 14:50:00,23,38,-15
8700,8700,81,2022/4/15 15:00:00,26,36,-10
8701,8701,81,2022/4/15 15:10:00,29,35,-6
8702,8702,81,2022/4/15 15:20:00,23,40,-17
8703,8703,81,2022/4/15 15:30:00,30,50,-20
8704,8704,81,2022/4/15 15:40:00,42,35,7
8705,8705,81,2022/4/15 15:50:00,34,32,2
8706,8706,81,2022/4/15 16:00:00,26,62,-36
8707,8707,81,2022/4/15 16:10:00,39,32,7
8708,8708,81,2022/4/15 16:20:00,26,36,-10
8709,8709,81,2022/4/15 16:30:00,34,38,-4
8710,8710,81,2022/4/15 16:40:00,25,45,-20
8711,8711,81,2022/4/15 16:50:00,24,45,-21
8712,8712,81,2022/4/15 17:00:00,31,31,0
8713,8713,81,2022/4/15 17:10:00,21,45,-24
8714,8714,81,2022/4/15 17:20:00,26,35,-9
8715,8715,81,2022/4/15 17:30:00,23,53,-30
8716,8716,81,2022/4/15 17:40:00,22,37,-15
8717,8717,81,2022/4/15 17:50:00,11,34,-23
8718,8718,81,2022/4/15 18:00:00,17,69,-52
8719,8719,81,2022/4/15 18:10:00,16,47,-31
8720,8720,81,2022/4/15 18:20:00,14,55,-41
8721,8721,81,2022/4/15 18:30:00,8,39,-31
8722,8722,81,2022/4/15 18:40:00,13,59,-46
8723,8723,81,2022/4/15 18:50:00,14,49,-35
8724,8724,81,2022/4/15 19:00:00,5,41,-36
8725,8725,81,2022/4/15 19:10:00,4,60,-56
8726,8726,81,2022/4/15 19:20:00,10,38,-28
8727,8727,81,2022/4/15 19:30:00,10,63,-53
8728,8728,81,2022/4/15 19:40:00,4,34,-30
8729,8729,81,2022/4/15 19:50:00,6,34,-28
8730,8730,81,2022/4/15 20:00:00,1,56,-55
8731,8731,81,2022/4/15 20:10:00,7,39,-32
8732,8732,81,2022/4/15 20:20:00,4,40,-36
8733,8733,81,2022/4/15 20:30:00,4,25,-21
8734,8734,81,2022/4/15 20:40:00,2,41,-39
8735,8735,81,2022/4/15 20:50:00,1,25,-24
8736,8736,81,2022/4/15 21:00:00,1,25,-24
8737,8737,81,2022/4/15 21:10:00,2,25,-23
8738,8738,81,2022/4/15 21:20:00,0,33,-33
8739,8739,81,2022/4/15 21:30:00,1,23,-22
8740,8740,81,2022/4/15 21:40:00,0,25,-25
8741,8741,81,2022/4/15 21:50:00,1,29,-28
8742,8742,81,2022/4/15 22:00:00,0,3,-3
8743,8743,81,2022/4/15 22:10:00,0,25,-25
8744,8744,81,2022/4/15 22:20:00,0,34,-34
8745,8745,81,2022/4/15 22:30:00,0,3,-3
8746,8746,81,2022/4/15 22:40:00,0,27,-27
8747,8747,81,2022/4/15 22:50:00,0,4,-4
8748,8748,82,2022/4/15 5:00:00,0,1,-1
8749,8749,82,2022/4/15 5:10:00,0,1,-1
8750,8750,82,2022/4/15 5:20:00,0,1,-1
8751,8751,82,2022/4/15 5:30:00,0,1,-1
8752,8752,82,2022/4/15 5:40:00,0,1,-1
8753,8753,82,2022/4/15 5:50:00,2,1,1
8754,8754,82,2022/4/15 6:00:00,27,1,26
8755,8755,82,2022/4/15 6:10:00,21,1,20
8756,8756,82,2022/4/15 6:20:00,30,1,29
8757,8757,82,2022/4/15 6:30:00,21,2,19
8758,8758,82,2022/4/15 6:40:00,33,5,28
8759,8759,82,2022/4/15 6:50:00,28,6,22
8760,8760,82,2022/4/15 7:00:00,40,8,32
8761,8761,82,2022/4/15 7:10:00,32,21,11
8762,8762,82,2022/4/15 7:20:00,77,23,54
8763,8763,82,2022/4/15 7:30:00,58,25,33
8764,8764,82,2022/4/15 7:40:00,82,23,59
8765,8765,82,2022/4/15 7:50:00,62,23,39
8766,8766,82,2022/4/15 8:00:00,52,21,31
8767,8767,82,2022/4/15 8:10:00,36,21,15
8768,8768,82,2022/4/15 8:20:00,36,21,15
8769,8769,82,2022/4/15 8:30:00,35,21,14
8770,8770,82,2022/4/15 8:40:00,18,21,-3
8771,8771,82,2022/4/15 8:50:00,29,19,10
8772,8772,82,2022/4/15 9:00:00,12,14,-2
8773,8773,82,2022/4/15 9:10:00,13,19,-6
8774,8774,82,2022/4/15 9:20:00,16,21,-5
8775,8775,82,2022/4/15 9:30:00,5,18,-13
8776,8776,82,2022/4/15 9:40:00,14,21,-7
8777,8777,82,2022/4/15 9:50:00,10,19,-9
8778,8778,82,2022/4/15 10:00:00,4,23,-19
8779,8779,82,2022/4/15 10:10:00,12,21,-9
8780,8780,82,2022/4/15 10:20:00,5,19,-14
8781,8781,82,2022/4/15 10:30:00,8,21,-13
8782,8782,82,2022/4/15 10:40:00,9,19,-10
8783,8783,82,2022/4/15 10:50:00,4,23,-19
8784,8784,82,2022/4/15 11:00:00,8,21,-13
8785,8785,82,2022/4/15 11:10:00,4,16,-12
8786,8786,82,2022/4/15 11:20:00,11,15,-4
8787,8787,82,2022/4/15 11:30:00,4,23,-19
8788,8788,82,2022/4/15 11:40:00,11,16,-5
8789,8789,82,2022/4/15 11:50:00,2,21,-19
8790,8790,82,2022/4/15 12:00:00,13,16,-3
8791,8791,82,2022/4/15 12:10:00,6,25,-19
8792,8792,82,2022/4/15 12:20:00,10,16,-6
8793,8793,82,2022/4/15 12:30:00,10,18,-8
8794,8794,82,2022/4/15 12:40:00,5,21,-16
8795,8795,82,2022/4/15 12:50:00,8,29,-21
8796,8796,82,2022/4/15 13:00:00,3,23,-20
8797,8797,82,2022/4/15 13:10:00,9,14,-5
8798,8798,82,2022/4/15 13:20:00,7,21,-14
8799,8799,82,2022/4/15 13:30:00,4,23,-19
8800,8800,82,2022/4/15 13:40:00,8,23,-15
8801,8801,82,2022/4/15 13:50:00,2,21,-19
8802,8802,82,2022/4/15 14:00:00,7,19,-12
8803,8803,82,2022/4/15 14:10:00,6,33,-27
8804,8804,82,2022/4/15 14:20:00,4,19,-15
8805,8805,82,2022/4/15 14:30:00,7,23,-16
8806,8806,82,2022/4/15 14:40:00,2,23,-21
8807,8807,82,2022/4/15 14:50:00,6,29,-23
8808,8808,82,2022/4/15 15:00:00,6,21,-15
8809,8809,82,2022/4/15 15:10:00,4,17,-13
8810,8810,82,2022/4/15 15:20:00,6,28,-22
8811,8811,82,2022/4/15 15:30:00,2,38,-36
8812,8812,82,2022/4/15 15:40:00,9,37,-28
8813,8813,82,2022/4/15 15:50:00,8,36,-28
8814,8814,82,2022/4/15 16:00:00,3,31,-28
8815,8815,82,2022/4/15 16:10:00,9,53,-44
8816,8816,82,2022/4/15 16:20:00,4,29,-25
8817,8817,82,2022/4/15 16:30:00,10,50,-40
8818,8818,82,2022/4/15 16:40:00,12,44,-32
8819,8819,82,2022/4/15 16:50:00,7,38,-31
8820,8820,82,2022/4/15 17:00:00,11,59,-48
8821,8821,82,2022/4/15 17:10:00,6,38,-32
8822,8822,82,2022/4/15 17:20:00,6,67,-61
8823,8823,82,2022/4/15 17:30:00,10,51,-41
8824,8824,82,2022/4/15 17:40:00,4,56,-52
8825,8825,82,2022/4/15 17:50:00,12,82,-70
8826,8826,82,2022/4/15 18:00:00,9,61,-52
8827,8827,82,2022/4/15 18:10:00,5,94,-89
8828,8828,82,2022/4/15 18:20:00,3,65,-62
8829,8829,82,2022/4/15 18:30:00,6,99,-93
8830,8830,82,2022/4/15 18:40:00,5,62,-57
8831,8831,82,2022/4/15 18:50:00,2,70,-68
8832,8832,82,2022/4/15 19:00:00,5,92,-87
8833,8833,82,2022/4/15 19:10:00,4,72,-68
8834,8834,82,2022/4/15 19:20:00,2,92,-90
8835,8835,82,2022/4/15 19:30:00,2,56,-54
8836,8836,82,2022/4/15 19:40:00,2,70,-68
8837,8837,82,2022/4/15 19:50:00,1,47,-46
8838,8838,82,2022/4/15 20:00:00,2,46,-44
8839,8839,82,2022/4/15 20:10:00,1,67,-66
8840,8840,82,2022/4/15 20:20:00,2,39,-37
8841,8841,82,2022/4/15 20:30:00,1,36,-35
8842,8842,82,2022/4/15 20:40:00,2,25,-23
8843,8843,82,2022/4/15 20:50:00,1,50,-49
8844,8844,82,2022/4/15 21:00:00,2,40,-38
8845,8845,82,2022/4/15 21:10:00,2,41,-39
8846,8846,82,2022/4/15 21:20:00,1,8,-7
8847,8847,82,2022/4/15 21:30:00,2,43,-41
8848,8848,82,2022/4/15 21:40:00,0,40,-40
8849,8849,82,2022/4/15 21:50:00,0,33,-33
8850,8850,82,2022/4/15 22:00:00,0,7,-7
8851,8851,82,2022/4/15 22:10:00,0,40,-40
8852,8852,82,2022/4/15 22:20:00,0,38,-38
8853,8853,82,2022/4/15 22:30:00,0,3,-3
8854,8854,82,2022/4/15 22:40:00,0,3,-3
8855,8855,82,2022/4/15 22:50:00,0,3,-3
8856,8856,83,2022/4/15 5:00:00,0,1,-1
8857,8857,83,2022/4/15 5:10:00,0,1,-1
8858,8858,83,2022/4/15 5:20:00,0,1,-1
8859,8859,83,2022/4/15 5:30:00,0,1,-1
8860,8860,83,2022/4/15 5:40:00,0,1,-1
8861,8861,83,2022/4/15 5:50:00,12,1,11
8862,8862,83,2022/4/15 6:00:00,36,1,35
8863,8863,83,2022/4/15 6:10:00,77,2,75
8864,8864,83,2022/4/15 6:20:00,70,11,59
8865,8865,83,2022/4/15 6:30:00,91,6,85
8866,8866,83,2022/4/15 6:40:00,155,25,130
8867,8867,83,2022/4/15 6:50:00,190,21,169
8868,8868,83,2022/4/15 7:00:00,218,25,193
8869,8869,83,2022/4/15 7:10:00,229,32,197
8870,8870,83,2022/4/15 7:20:00,284,41,243
8871,8871,83,2022/4/15 7:30:00,277,32,245
8872,8872,83,2022/4/15 7:40:00,279,39,240
8873,8873,83,2022/4/15 7:50:00,284,38,246
8874,8874,83,2022/4/15 8:00:00,280,40,240
8875,8875,83,2022/4/15 8:10:00,252,42,210
8876,8876,83,2022/4/15 8:20:00,193,38,155
8877,8877,83,2022/4/15 8:30:00,185,41,144
8878,8878,83,2022/4/15 8:40:00,149,40,109
8879,8879,83,2022/4/15 8:50:00,86,49,37
8880,8880,83,2022/4/15 9:00:00,61,37,24
8881,8881,83,2022/4/15 9:10:00,53,47,6
8882,8882,83,2022/4/15 9:20:00,44,38,6
8883,8883,83,2022/4/15 9:30:00,36,45,-9
8884,8884,83,2022/4/15 9:40:00,25,50,-25
8885,8885,83,2022/4/15 9:50:00,29,57,-28
8886,8886,83,2022/4/15 10:00:00,30,40,-10
8887,8887,83,2022/4/15 10:10:00,27,44,-17
8888,8888,83,2022/4/15 10:20:00,26,47,-21
8889,8889,83,2022/4/15 10:30:00,28,65,-37
8890,8890,83,2022/4/15 10:40:00,27,42,-15
8891,8891,83,2022/4/15 10:50:00,21,47,-26
8892,8892,83,2022/4/15 11:00:00,28,38,-10
8893,8893,83,2022/4/15 11:10:00,19,49,-30
8894,8894,83,2022/4/15 11:20:00,25,49,-24
8895,8895,83,2022/4/15 11:30:00,21,32,-11
8896,8896,83,2022/4/15 11:40:00,33,41,-8
8897,8897,83,2022/4/15 11:50:00,25,51,-26
8898,8898,83,2022/4/15 12:00:00,28,47,-19
8899,8899,83,2022/4/15 12:10:00,23,45,-22
8900,8900,83,2022/4/15 12:20:00,33,37,-4
8901,8901,83,2022/4/15 12:30:00,22,60,-38
8902,8902,83,2022/4/15 12:40:00,27,43,-16
8903,8903,83,2022/4/15 12:50:00,22,50,-28
8904,8904,83,2022/4/15 13:00:00,24,47,-23
8905,8905,83,2022/4/15 13:10:00,21,53,-32
8906,8906,83,2022/4/15 13:20:00,28,66,-38
8907,8907,83,2022/4/15 13:30:00,19,46,-27
8908,8908,83,2022/4/15 13:40:00,24,52,-28
8909,8909,83,2022/4/15 13:50:00,20,61,-41
8910,8910,83,2022/4/15 14:00:00,23,52,-29
8911,8911,83,2022/4/15 14:10:00,17,60,-43
8912,8912,83,2022/4/15 14:20:00,23,46,-23
8913,8913,83,2022/4/15 14:30:00,17,71,-54
8914,8914,83,2022/4/15 14:40:00,16,59,-43
8915,8915,83,2022/4/15 14:50:00,19,56,-37
8916,8916,83,2022/4/15 15:00:00,19,63,-44
8917,8917,83,2022/4/15 15:10:00,16,64,-48
8918,8918,83,2022/4/15 15:20:00,17,83,-66
8919,8919,83,2022/4/15 15:30:00,20,53,-33
8920,8920,83,2022/4/15 15:40:00,15,69,-54
8921,8921,83,2022/4/15 15:50:00,15,72,-57
8922,8922,83,2022/4/15 16:00:00,18,90,-72
8923,8923,83,2022/4/15 16:10:00,17,75,-58
8924,8924,83,2022/4/15 16:20:00,18,71,-53
8925,8925,83,2022/4/15 16:30:00,20,102,-82
8926,8926,83,2022/4/15 16:40:00,18,76,-58
8927,8927,83,2022/4/15 16:50:00,22,87,-65
8928,8928,83,2022/4/15 17:00:00,17,83,-66
8929,8929,83,2022/4/15 17:10:00,20,122,-102
8930,8930,83,2022/4/15 17:20:00,13,89,-76
8931,8931,83,2022/4/15 17:30:00,17,108,-91
8932,8932,83,2022/4/15 17:40:00,18,103,-85
8933,8933,83,2022/4/15 17:50:00,19,108,-89
8934,8934,83,2022/4/15 18:00:00,15,144,-129
8935,8935,83,2022/4/15 18:10:00,15,110,-95
8936,8936,83,2022/4/15 18:20:00,15,139,-124
8937,8937,83,2022/4/15 18:30:00,14,180,-166
8938,8938,83,2022/4/15 18:40:00,15,127,-112
8939,8939,83,2022/4/15 18:50:00,16,235,-219
8940,8940,83,2022/4/15 19:00:00,14,110,-96
8941,8941,83,2022/4/15 19:10:00,12,222,-210
8942,8942,83,2022/4/15 19:20:00,11,192,-181
8943,8943,83,2022/4/15 19:30:00,13,180,-167
8944,8944,83,2022/4/15 19:40:00,11,104,-93
8945,8945,83,2022/4/15 19:50:00,11,95,-84
8946,8946,83,2022/4/15 20:00:00,11,119,-108
8947,8947,83,2022/4/15 20:10:00,13,92,-79
8948,8948,83,2022/4/15 20:20:00,7,95,-88
8949,8949,83,2022/4/15 20:30:00,11,101,-90
8950,8950,83,2022/4/15 20:40:00,8,126,-118
8951,8951,83,2022/4/15 20:50:00,8,85,-77
8952,8952,83,2022/4/15 21:00:00,7,95,-88
8953,8953,83,2022/4/15 21:10:00,7,104,-97
8954,8954,83,2022/4/15 21:20:00,6,69,-63
8955,8955,83,2022/4/15 21:30:00,4,62,-58
8956,8956,83,2022/4/15 21:40:00,5,104,-99
8957,8957,83,2022/4/15 21:50:00,1,101,-100
8958,8958,83,2022/4/15 22:00:00,1,91,-90
8959,8959,83,2022/4/15 22:10:00,1,69,-68
8960,8960,83,2022/4/15 22:20:00,1,102,-101
8961,8961,83,2022/4/15 22:30:00,0,7,-7
8962,8962,83,2022/4/15 22:40:00,0,3,-3
8963,8963,83,2022/4/15 22:50:00,0,3,-3
8964,8964,84,2022/4/15 5:00:00,0,1,-1
8965,8965,84,2022/4/15 5:10:00,0,1,-1
8966,8966,84,2022/4/15 5:20:00,0,1,-1
8967,8967,84,2022/4/15 5:30:00,0,1,-1
8968,8968,84,2022/4/15 5:40:00,1,1,0
8969,8969,84,2022/4/15 5:50:00,0,2,-2
8970,8970,84,2022/4/15 6:00:00,1,1,0
8971,8971,84,2022/4/15 6:10:00,3,1,2
8972,8972,84,2022/4/15 6:20:00,1,1,0
8973,8973,84,2022/4/15 6:30:00,4,1,3
8974,8974,84,2022/4/15 6:40:00,5,12,-7
8975,8975,84,2022/4/15 6:50:00,1,8,-7
8976,8976,84,2022/4/15 7:00:00,4,21,-17
8977,8977,84,2022/4/15 7:10:00,3,16,-13
8978,8978,84,2022/4/15 7:20:00,6,19,-13
8979,8979,84,2022/4/15 7:30:00,8,21,-13
8980,8980,84,2022/4/15 7:40:00,14,19,-5
8981,8981,84,2022/4/15 7:50:00,8,23,-15
8982,8982,84,2022/4/15 8:00:00,7,25,-18
8983,8983,84,2022/4/15 8:10:00,6,31,-25
8984,8984,84,2022/4/15 8:20:00,8,39,-31
8985,8985,84,2022/4/15 8:30:00,6,38,-32
8986,8986,84,2022/4/15 8:40:00,3,23,-20
8987,8987,84,2022/4/15 8:50:00,3,31,-28
8988,8988,84,2022/4/15 9:00:00,2,17,-15
8989,8989,84,2022/4/15 9:10:00,1,21,-20
8990,8990,84,2022/4/15 9:20:00,1,13,-12
8991,8991,84,2022/4/15 9:30:00,1,14,-13
8992,8992,84,2022/4/15 9:40:00,1,8,-7
8993,8993,84,2022/4/15 9:50:00,2,8,-6
8994,8994,84,2022/4/15 10:00:00,1,5,-4
8995,8995,84,2022/4/15 10:10:00,1,7,-6
8996,8996,84,2022/4/15 10:20:00,1,5,-4
8997,8997,84,2022/4/15 10:30:00,1,2,-1
8998,8998,84,2022/4/15 10:40:00,2,2,0
8999,8999,84,2022/4/15 10:50:00,1,1,0
9000,9000,84,2022/4/15 11:00:00,1,5,-4
9001,9001,84,2022/4/15 11:10:00,1,5,-4
9002,9002,84,2022/4/15 11:20:00,2,5,-3
9003,9003,84,2022/4/15 11:30:00,1,5,-4
9004,9004,84,2022/4/15 11:40:00,2,2,0
9005,9005,84,2022/4/15 11:50:00,2,1,1
9006,9006,84,2022/4/15 12:00:00,3,5,-2
9007,9007,84,2022/4/15 12:10:00,2,1,1
9008,9008,84,2022/4/15 12:20:00,2,5,-3
9009,9009,84,2022/4/15 12:30:00,1,5,-4
9010,9010,84,2022/4/15 12:40:00,2,8,-6
9011,9011,84,2022/4/15 12:50:00,2,5,-3
9012,9012,84,2022/4/15 13:00:00,1,5,-4
9013,9013,84,2022/4/15 13:10:00,1,5,-4
9014,9014,84,2022/4/15 13:20:00,2,2,0
9015,9015,84,2022/4/15 13:30:00,1,7,-6
9016,9016,84,2022/4/15 13:40:00,1,1,0
9017,9017,84,2022/4/15 13:50:00,3,5,-2
9018,9018,84,2022/4/15 14:00:00,2,5,-3
9019,9019,84,2022/4/15 14:10:00,2,2,0
9020,9020,84,2022/4/15 14:20:00,2,7,-5
9021,9021,84,2022/4/15 14:30:00,2,5,-3
9022,9022,84,2022/4/15 14:40:00,2,5,-3
9023,9023,84,2022/4/15 14:50:00,2,5,-3
9024,9024,84,2022/4/15 15:00:00,2,7,-5
9025,9025,84,2022/4/15 15:10:00,2,5,-3
9026,9026,84,2022/4/15 15:20:00,1,2,-1
9027,9027,84,2022/4/15 15:30:00,2,5,-3
9028,9028,84,2022/4/15 15:40:00,3,7,-4
9029,9029,84,2022/4/15 15:50:00,3,5,-2
9030,9030,84,2022/4/15 16:00:00,3,5,-2
9031,9031,84,2022/4/15 16:10:00,4,2,2
9032,9032,84,2022/4/15 16:20:00,7,5,2
9033,9033,84,2022/4/15 16:30:00,6,5,1
9034,9034,84,2022/4/15 16:40:00,12,5,7
9035,9035,84,2022/4/15 16:50:00,11,7,4
9036,9036,84,2022/4/15 17:00:00,11,5,6
9037,9037,84,2022/4/15 17:10:00,11,11,0
9038,9038,84,2022/4/15 17:20:00,11,21,-10
9039,9039,84,2022/4/15 17:30:00,11,15,-4
9040,9040,84,2022/4/15 17:40:00,10,12,-2
9041,9041,84,2022/4/15 17:50:00,10,8,2
9042,9042,84,2022/4/15 18:00:00,8,10,-2
9043,9043,84,2022/4/15 18:10:00,11,13,-2
9044,9044,84,2022/4/15 18:20:00,11,10,1
9045,9045,84,2022/4/15 18:30:00,9,15,-6
9046,9046,84,2022/4/15 18:40:00,7,8,-1
9047,9047,84,2022/4/15 18:50:00,4,13,-9
9048,9048,84,2022/4/15 19:00:00,3,15,-12
9049,9049,84,2022/4/15 19:10:00,4,13,-9
9050,9050,84,2022/4/15 19:20:00,2,15,-13
9051,9051,84,2022/4/15 19:30:00,2,8,-6
9052,9052,84,2022/4/15 19:40:00,2,15,-13
9053,9053,84,2022/4/15 19:50:00,1,8,-7
9054,9054,84,2022/4/15 20:00:00,1,3,-2
9055,9055,84,2022/4/15 20:10:00,2,7,-5
9056,9056,84,2022/4/15 20:20:00,2,8,-6
9057,9057,84,2022/4/15 20:30:00,1,7,-6
9058,9058,84,2022/4/15 20:40:00,2,8,-6
9059,9059,84,2022/4/15 20:50:00,2,4,-2
9060,9060,84,2022/4/15 21:00:00,1,7,-6
9061,9061,84,2022/4/15 21:10:00,1,10,-9
9062,9062,84,2022/4/15 21:20:00,2,7,-5
9063,9063,84,2022/4/15 21:30:00,1,3,-2
9064,9064,84,2022/4/15 21:40:00,1,8,-7
9065,9065,84,2022/4/15 21:50:00,1,8,-7
9066,9066,84,2022/4/15 22:00:00,0,8,-8
9067,9067,84,2022/4/15 22:10:00,0,3,-3
9068,9068,84,2022/4/15 22:20:00,0,3,-3
9069,9069,84,2022/4/15 22:30:00,0,3,-3
9070,9070,84,2022/4/15 22:40:00,0,3,-3
9071,9071,84,2022/4/15 22:50:00,0,3,-3
9072,9072,85,2022/4/15 5:00:00,0,1,-1
9073,9073,85,2022/4/15 5:10:00,0,1,-1
9074,9074,85,2022/4/15 5:20:00,0,1,-1
9075,9075,85,2022/4/15 5:30:00,0,1,-1
9076,9076,85,2022/4/15 5:40:00,6,1,5
9077,9077,85,2022/4/15 5:50:00,72,1,71
9078,9078,85,2022/4/15 6:00:00,113,1,112
9079,9079,85,2022/4/15 6:10:00,169,1,168
9080,9080,85,2022/4/15 6:20:00,233,49,184
9081,9081,85,2022/4/15 6:30:00,249,38,211
9082,9082,85,2022/4/15 6:40:00,348,46,302
9083,9083,85,2022/4/15 6:50:00,339,41,298
9084,9084,85,2022/4/15 7:00:00,390,69,321
9085,9085,85,2022/4/15 7:10:00,345,75,270
9086,9086,85,2022/4/15 7:20:00,340,86,254
9087,9087,85,2022/4/15 7:30:00,347,105,242
9088,9088,85,2022/4/15 7:40:00,280,92,188
9089,9089,85,2022/4/15 7:50:00,274,96,178
9090,9090,85,2022/4/15 8:00:00,222,85,137
9091,9091,85,2022/4/15 8:10:00,220,105,115
9092,9092,85,2022/4/15 8:20:00,185,101,84
9093,9093,85,2022/4/15 8:30:00,147,105,42
9094,9094,85,2022/4/15 8:40:00,111,103,8
9095,9095,85,2022/4/15 8:50:00,90,88,2
9096,9096,85,2022/4/15 9:00:00,57,85,-28
9097,9097,85,2022/4/15 9:10:00,65,74,-9
9098,9098,85,2022/4/15 9:20:00,47,92,-45
9099,9099,85,2022/4/15 9:30:00,50,87,-37
9100,9100,85,2022/4/15 9:40:00,43,100,-57
9101,9101,85,2022/4/15 9:50:00,41,103,-62
9102,9102,85,2022/4/15 10:00:00,39,102,-63
9103,9103,85,2022/4/15 10:10:00,40,98,-58
9104,9104,85,2022/4/15 10:20:00,42,77,-35
9105,9105,85,2022/4/15 10:30:00,41,76,-35
9106,9106,85,2022/4/15 10:40:00,41,124,-83
9107,9107,85,2022/4/15 10:50:00,42,98,-56
9108,9108,85,2022/4/15 11:00:00,41,67,-26
9109,9109,85,2022/4/15 11:10:00,42,93,-51
9110,9110,85,2022/4/15 11:20:00,43,105,-62
9111,9111,85,2022/4/15 11:30:00,47,98,-51
9112,9112,85,2022/4/15 11:40:00,61,93,-32
9113,9113,85,2022/4/15 11:50:00,61,66,-5
9114,9114,85,2022/4/15 12:00:00,44,123,-79
9115,9115,85,2022/4/15 12:10:00,58,92,-34
9116,9116,85,2022/4/15 12:20:00,47,90,-43
9117,9117,85,2022/4/15 12:30:00,55,91,-36
9118,9118,85,2022/4/15 12:40:00,45,118,-73
9119,9119,85,2022/4/15 12:50:00,46,106,-60
9120,9120,85,2022/4/15 13:00:00,37,97,-60
9121,9121,85,2022/4/15 13:10:00,47,103,-56
9122,9122,85,2022/4/15 13:20:00,49,114,-65
9123,9123,85,2022/4/15 13:30:00,43,100,-57
9124,9124,85,2022/4/15 13:40:00,39,105,-66
9125,9125,85,2022/4/15 13:50:00,40,82,-42
9126,9126,85,2022/4/15 14:00:00,41,108,-67
9127,9127,85,2022/4/15 14:10:00,49,89,-40
9128,9128,85,2022/4/15 14:20:00,54,99,-45
9129,9129,85,2022/4/15 14:30:00,52,100,-48
9130,9130,85,2022/4/15 14:40:00,44,119,-75
9131,9131,85,2022/4/15 14:50:00,55,83,-28
9132,9132,85,2022/4/15 15:00:00,45,89,-44
9133,9133,85,2022/4/15 15:10:00,49,102,-53
9134,9134,85,2022/4/15 15:20:00,50,108,-58
9135,9135,85,2022/4/15 15:30:00,45,97,-52
9136,9136,85,2022/4/15 15:40:00,44,117,-73
9137,9137,85,2022/4/15 15:50:00,41,99,-58
9138,9138,85,2022/4/15 16:00:00,43,110,-67
9139,9139,85,2022/4/15 16:10:00,54,146,-92
9140,9140,85,2022/4/15 16:20:00,44,119,-75
9141,9141,85,2022/4/15 16:30:00,54,119,-65
9142,9142,85,2022/4/15 16:40:00,43,179,-136
9143,9143,85,2022/4/15 16:50:00,55,105,-50
9144,9144,85,2022/4/15 17:00:00,51,283,-232
9145,9145,85,2022/4/15 17:10:00,62,110,-48
9146,9146,85,2022/4/15 17:20:00,46,180,-134
9147,9147,85,2022/4/15 17:30:00,44,125,-81
9148,9148,85,2022/4/15 17:40:00,38,116,-78
9149,9149,85,2022/4/15 17:50:00,35,233,-198
9150,9150,85,2022/4/15 18:00:00,32,110,-78
9151,9151,85,2022/4/15 18:10:00,33,235,-202
9152,9152,85,2022/4/15 18:20:00,29,104,-75
9153,9153,85,2022/4/15 18:30:00,28,198,-170
9154,9154,85,2022/4/15 18:40:00,30,180,-150
9155,9155,85,2022/4/15 18:50:00,25,119,-94
9156,9156,85,2022/4/15 19:00:00,24,330,-306
9157,9157,85,2022/4/15 19:10:00,22,110,-88
9158,9158,85,2022/4/15 19:20:00,28,256,-228
9159,9159,85,2022/4/15 19:30:00,25,128,-103
9160,9160,85,2022/4/15 19:40:00,23,192,-169
9161,9161,85,2022/4/15 19:50:00,22,121,-99
9162,9162,85,2022/4/15 20:00:00,21,109,-88
9163,9163,85,2022/4/15 20:10:00,25,101,-76
9164,9164,85,2022/4/15 20:20:00,21,106,-85
9165,9165,85,2022/4/15 20:30:00,24,93,-69
9166,9166,85,2022/4/15 20:40:00,17,123,-106
9167,9167,85,2022/4/15 20:50:00,18,87,-69
9168,9168,85,2022/4/15 21:00:00,19,95,-76
9169,9169,85,2022/4/15 21:10:00,19,77,-58
9170,9170,85,2022/4/15 21:20:00,15,76,-61
9171,9171,85,2022/4/15 21:30:00,12,101,-89
9172,9172,85,2022/4/15 21:40:00,12,98,-86
9173,9173,85,2022/4/15 21:50:00,7,17,-10
9174,9174,85,2022/4/15 22:00:00,6,91,-85
9175,9175,85,2022/4/15 22:10:00,5,89,-84
9176,9176,85,2022/4/15 22:20:00,1,7,-6
9177,9177,85,2022/4/15 22:30:00,0,90,-90
9178,9178,85,2022/4/15 22:40:00,0,89,-89
9179,9179,85,2022/4/15 22:50:00,0,3,-3
9180,9180,86,2022/4/15 5:00:00,0,1,-1
9181,9181,86,2022/4/15 5:10:00,0,1,-1
9182,9182,86,2022/4/15 5:20:00,0,1,-1
9183,9183,86,2022/4/15 5:30:00,0,1,-1
9184,9184,86,2022/4/15 5:40:00,0,1,-1
9185,9185,86,2022/4/15 5:50:00,0,1,-1
9186,9186,86,2022/4/15 6:00:00,24,1,23
9187,9187,86,2022/4/15 6:10:00,32,1,31
9188,9188,86,2022/4/15 6:20:00,30,2,28
9189,9189,86,2022/4/15 6:30:00,26,2,24
9190,9190,86,2022/4/15 6:40:00,35,1,34
9191,9191,86,2022/4/15 6:50:00,36,2,34
9192,9192,86,2022/4/15 7:00:00,55,8,47
9193,9193,86,2022/4/15 7:10:00,44,6,38
9194,9194,86,2022/4/15 7:20:00,37,14,23
9195,9195,86,2022/4/15 7:30:00,49,25,24
9196,9196,86,2022/4/15 7:40:00,34,23,11
9197,9197,86,2022/4/15 7:50:00,26,23,3
9198,9198,86,2022/4/15 8:00:00,29,23,6
9199,9199,86,2022/4/15 8:10:00,24,21,3
9200,9200,86,2022/4/15 8:20:00,19,19,0
9201,9201,86,2022/4/15 8:30:00,16,21,-5
9202,9202,86,2022/4/15 8:40:00,17,19,-2
9203,9203,86,2022/4/15 8:50:00,13,19,-6
9204,9204,86,2022/4/15 9:00:00,9,19,-10
9205,9205,86,2022/4/15 9:10:00,8,16,-8
9206,9206,86,2022/4/15 9:20:00,8,21,-13
9207,9207,86,2022/4/15 9:30:00,6,23,-17
9208,9208,86,2022/4/15 9:40:00,9,19,-10
9209,9209,86,2022/4/15 9:50:00,6,16,-10
9210,9210,86,2022/4/15 10:00:00,11,18,-7
9211,9211,86,2022/4/15 10:10:00,8,19,-11
9212,9212,86,2022/4/15 10:20:00,7,23,-16
9213,9213,86,2022/4/15 10:30:00,10,17,-7
9214,9214,86,2022/4/15 10:40:00,8,16,-8
9215,9215,86,2022/4/15 10:50:00,9,17,-8
9216,9216,86,2022/4/15 11:00:00,6,14,-8
9217,9217,86,2022/4/15 11:10:00,9,21,-12
9218,9218,86,2022/4/15 11:20:00,11,18,-7
9219,9219,86,2022/4/15 11:30:00,17,8,9
9220,9220,86,2022/4/15 11:40:00,16,16,0
9221,9221,86,2022/4/15 11:50:00,13,23,-10
9222,9222,86,2022/4/15 12:00:00,14,17,-3
9223,9223,86,2022/4/15 12:10:00,14,16,-2
9224,9224,86,2022/4/15 12:20:00,7,12,-5
9225,9225,86,2022/4/15 12:30:00,12,32,-20
9226,9226,86,2022/4/15 12:40:00,13,14,-1
9227,9227,86,2022/4/15 12:50:00,10,17,-7
9228,9228,86,2022/4/15 13:00:00,12,21,-9
9229,9229,86,2022/4/15 13:10:00,11,19,-8
9230,9230,86,2022/4/15 13:20:00,6,19,-13
9231,9231,86,2022/4/15 13:30:00,7,12,-5
9232,9232,86,2022/4/15 13:40:00,6,19,-13
9233,9233,86,2022/4/15 13:50:00,10,21,-11
9234,9234,86,2022/4/15 14:00:00,10,14,-4
9235,9235,86,2022/4/15 14:10:00,9,11,-2
9236,9236,86,2022/4/15 14:20:00,7,16,-9
9237,9237,86,2022/4/15 14:30:00,7,23,-16
9238,9238,86,2022/4/15 14:40:00,10,14,-4
9239,9239,86,2022/4/15 14:50:00,7,14,-7
9240,9240,86,2022/4/15 15:00:00,10,21,-11
9241,9241,86,2022/4/15 15:10:00,8,23,-15
9242,9242,86,2022/4/15 15:20:00,7,22,-15
9243,9243,86,2022/4/15 15:30:00,8,18,-10
9244,9244,86,2022/4/15 15:40:00,12,22,-10
9245,9245,86,2022/4/15 15:50:00,5,37,-32
9246,9246,86,2022/4/15 16:00:00,6,22,-16
9247,9247,86,2022/4/15 16:10:00,10,35,-25
9248,9248,86,2022/4/15 16:20:00,12,23,-11
9249,9249,86,2022/4/15 16:30:00,8,46,-38
9250,9250,86,2022/4/15 16:40:00,7,22,-15
9251,9251,86,2022/4/15 16:50:00,6,44,-38
9252,9252,86,2022/4/15 17:00:00,3,36,-33
9253,9253,86,2022/4/15 17:10:00,8,32,-24
9254,9254,86,2022/4/15 17:20:00,6,46,-40
9255,9255,86,2022/4/15 17:30:00,7,25,-18
9256,9256,86,2022/4/15 17:40:00,3,46,-43
9257,9257,86,2022/4/15 17:50:00,6,37,-31
9258,9258,86,2022/4/15 18:00:00,3,40,-37
9259,9259,86,2022/4/15 18:10:00,2,46,-44
9260,9260,86,2022/4/15 18:20:00,2,32,-30
9261,9261,86,2022/4/15 18:30:00,3,43,-40
9262,9262,86,2022/4/15 18:40:00,3,38,-35
9263,9263,86,2022/4/15 18:50:00,1,57,-56
9264,9264,86,2022/4/15 19:00:00,2,39,-37
9265,9265,86,2022/4/15 19:10:00,2,39,-37
9266,9266,86,2022/4/15 19:20:00,2,56,-54
9267,9267,86,2022/4/15 19:30:00,1,35,-34
9268,9268,86,2022/4/15 19:40:00,1,48,-47
9269,9269,86,2022/4/15 19:50:00,1,23,-22
9270,9270,86,2022/4/15 20:00:00,1,40,-39
9271,9271,86,2022/4/15 20:10:00,0,18,-18
9272,9272,86,2022/4/15 20:20:00,1,18,-17
9273,9273,86,2022/4/15 20:30:00,1,25,-24
9274,9274,86,2022/4/15 20:40:00,1,15,-14
9275,9275,86,2022/4/15 20:50:00,1,15,-14
9276,9276,86,2022/4/15 21:00:00,0,10,-10
9277,9277,86,2022/4/15 21:10:00,0,25,-25
9278,9278,86,2022/4/15 21:20:00,0,21,-21
9279,9279,86,2022/4/15 21:30:00,0,21,-21
9280,9280,86,2022/4/15 21:40:00,0,3,-3
9281,9281,86,2022/4/15 21:50:00,0,15,-15
9282,9282,86,2022/4/15 22:00:00,0,23,-23
9283,9283,86,2022/4/15 22:10:00,0,3,-3
9284,9284,86,2022/4/15 22:20:00,0,15,-15
9285,9285,86,2022/4/15 22:30:00,0,3,-3
9286,9286,86,2022/4/15 22:40:00,0,13,-13
9287,9287,86,2022/4/15 22:50:00,0,10,-10
9288,9288,87,2022/4/15 5:00:00,0,1,-1
9289,9289,87,2022/4/15 5:10:00,0,1,-1
9290,9290,87,2022/4/15 5:20:00,0,1,-1
9291,9291,87,2022/4/15 5:30:00,0,1,-1
9292,9292,87,2022/4/15 5:40:00,1,1,0
9293,9293,87,2022/4/15 5:50:00,9,1,8
9294,9294,87,2022/4/15 6:00:00,7,1,6
9295,9295,87,2022/4/15 6:10:00,3,1,2
9296,9296,87,2022/4/15 6:20:00,30,1,29
9297,9297,87,2022/4/15 6:30:00,22,1,21
9298,9298,87,2022/4/15 6:40:00,30,1,29
9299,9299,87,2022/4/15 6:50:00,28,23,5
9300,9300,87,2022/4/15 7:00:00,29,11,18
9301,9301,87,2022/4/15 7:10:00,26,17,9
9302,9302,87,2022/4/15 7:20:00,51,36,15
9303,9303,87,2022/4/15 7:30:00,28,36,-8
9304,9304,87,2022/4/15 7:40:00,28,60,-32
9305,9305,87,2022/4/15 7:50:00,29,57,-28
9306,9306,87,2022/4/15 8:00:00,18,32,-14
9307,9307,87,2022/4/15 8:10:00,19,45,-26
9308,9308,87,2022/4/15 8:20:00,25,55,-30
9309,9309,87,2022/4/15 8:30:00,11,43,-32
9310,9310,87,2022/4/15 8:40:00,16,40,-24
9311,9311,87,2022/4/15 8:50:00,18,64,-46
9312,9312,87,2022/4/15 9:00:00,17,49,-32
9313,9313,87,2022/4/15 9:10:00,12,35,-23
9314,9314,87,2022/4/15 9:20:00,11,60,-49
9315,9315,87,2022/4/15 9:30:00,12,46,-34
9316,9316,87,2022/4/15 9:40:00,12,50,-38
9317,9317,87,2022/4/15 9:50:00,19,37,-18
9318,9318,87,2022/4/15 10:00:00,15,46,-31
9319,9319,87,2022/4/15 10:10:00,19,45,-26
9320,9320,87,2022/4/15 10:20:00,22,53,-31
9321,9321,87,2022/4/15 10:30:00,20,40,-20
9322,9322,87,2022/4/15 10:40:00,19,38,-19
9323,9323,87,2022/4/15 10:50:00,13,36,-23
9324,9324,87,2022/4/15 11:00:00,19,66,-47
9325,9325,87,2022/4/15 11:10:00,18,37,-19
9326,9326,87,2022/4/15 11:20:00,19,37,-18
9327,9327,87,2022/4/15 11:30:00,14,38,-24
9328,9328,87,2022/4/15 11:40:00,22,50,-28
9329,9329,87,2022/4/15 11:50:00,14,49,-35
9330,9330,87,2022/4/15 12:00:00,23,40,-17
9331,9331,87,2022/4/15 12:10:00,25,29,-4
9332,9332,87,2022/4/15 12:20:00,23,56,-33
9333,9333,87,2022/4/15 12:30:00,23,38,-15
9334,9334,87,2022/4/15 12:40:00,22,34,-12
9335,9335,87,2022/4/15 12:50:00,19,37,-18
9336,9336,87,2022/4/15 13:00:00,24,49,-25
9337,9337,87,2022/4/15 13:10:00,25,38,-13
9338,9338,87,2022/4/15 13:20:00,22,32,-10
9339,9339,87,2022/4/15 13:30:00,19,29,-10
9340,9340,87,2022/4/15 13:40:00,16,51,-35
9341,9341,87,2022/4/15 13:50:00,21,34,-13
9342,9342,87,2022/4/15 14:00:00,21,31,-10
9343,9343,87,2022/4/15 14:10:00,21,25,-4
9344,9344,87,2022/4/15 14:20:00,21,51,-30
9345,9345,87,2022/4/15 14:30:00,26,38,-12
9346,9346,87,2022/4/15 14:40:00,19,32,-13
9347,9347,87,2022/4/15 14:50:00,22,38,-16
9348,9348,87,2022/4/15 15:00:00,22,43,-21
9349,9349,87,2022/4/15 15:10:00,26,38,-12
9350,9350,87,2022/4/15 15:20:00,31,32,-1
9351,9351,87,2022/4/15 15:30:00,28,33,-5
9352,9352,87,2022/4/15 15:40:00,25,53,-28
9353,9353,87,2022/4/15 15:50:00,19,37,-18
9354,9354,87,2022/4/15 16:00:00,26,38,-12
9355,9355,87,2022/4/15 16:10:00,24,37,-13
9356,9356,87,2022/4/15 16:20:00,28,44,-16
9357,9357,87,2022/4/15 16:30:00,22,62,-40
9358,9358,87,2022/4/15 16:40:00,24,45,-21
9359,9359,87,2022/4/15 16:50:00,21,45,-24
9360,9360,87,2022/4/15 17:00:00,25,60,-35
9361,9361,87,2022/4/15 17:10:00,21,32,-11
9362,9362,87,2022/4/15 17:20:00,22,69,-47
9363,9363,87,2022/4/15 17:30:00,12,45,-33
9364,9364,87,2022/4/15 17:40:00,21,60,-39
9365,9365,87,2022/4/15 17:50:00,23,40,-17
9366,9366,87,2022/4/15 18:00:00,7,41,-34
9367,9367,87,2022/4/15 18:10:00,17,63,-46
9368,9368,87,2022/4/15 18:20:00,11,48,-37
9369,9369,87,2022/4/15 18:30:00,7,69,-62
9370,9370,87,2022/4/15 18:40:00,10,50,-40
9371,9371,87,2022/4/15 18:50:00,12,74,-62
9372,9372,87,2022/4/15 19:00:00,2,56,-54
9373,9373,87,2022/4/15 19:10:00,13,49,-36
9374,9374,87,2022/4/15 19:20:00,8,73,-65
9375,9375,87,2022/4/15 19:30:00,5,46,-41
9376,9376,87,2022/4/15 19:40:00,7,62,-55
9377,9377,87,2022/4/15 19:50:00,8,49,-41
9378,9378,87,2022/4/15 20:00:00,4,71,-67
9379,9379,87,2022/4/15 20:10:00,10,50,-40
9380,9380,87,2022/4/15 20:20:00,4,47,-43
9381,9381,87,2022/4/15 20:30:00,5,43,-38
9382,9382,87,2022/4/15 20:40:00,0,39,-39
9383,9383,87,2022/4/15 20:50:00,9,38,-29
9384,9384,87,2022/4/15 21:00:00,2,49,-47
9385,9385,87,2022/4/15 21:10:00,3,39,-36
9386,9386,87,2022/4/15 21:20:00,1,25,-24
9387,9387,87,2022/4/15 21:30:00,2,27,-25
9388,9388,87,2022/4/15 21:40:00,1,25,-24
9389,9389,87,2022/4/15 21:50:00,1,30,-29
9390,9390,87,2022/4/15 22:00:00,0,33,-33
9391,9391,87,2022/4/15 22:10:00,0,3,-3
9392,9392,87,2022/4/15 22:20:00,0,31,-31
9393,9393,87,2022/4/15 22:30:00,0,24,-24
9394,9394,87,2022/4/15 22:40:00,0,7,-7
9395,9395,87,2022/4/15 22:50:00,0,25,-25
9396,9396,88,2022/4/15 5:00:00,0,1,-1
9397,9397,88,2022/4/15 5:10:00,0,1,-1
9398,9398,88,2022/4/15 5:20:00,0,1,-1
9399,9399,88,2022/4/15 5:30:00,2,1,1
9400,9400,88,2022/4/15 5:40:00,4,1,3
9401,9401,88,2022/4/15 5:50:00,7,1,6
9402,9402,88,2022/4/15 6:00:00,4,1,3
9403,9403,88,2022/4/15 6:10:00,14,1,13
9404,9404,88,2022/4/15 6:20:00,13,5,8
9405,9405,88,2022/4/15 6:30:00,12,5,7
9406,9406,88,2022/4/15 6:40:00,12,23,-11
9407,9407,88,2022/4/15 6:50:00,17,38,-21
9408,9408,88,2022/4/15 7:00:00,14,54,-40
9409,9409,88,2022/4/15 7:10:00,16,61,-45
9410,9410,88,2022/4/15 7:20:00,15,57,-42
9411,9411,88,2022/4/15 7:30:00,17,46,-29
9412,9412,88,2022/4/15 7:40:00,18,47,-29
9413,9413,88,2022/4/15 7:50:00,19,50,-31
9414,9414,88,2022/4/15 8:00:00,16,50,-34
9415,9415,88,2022/4/15 8:10:00,16,68,-52
9416,9416,88,2022/4/15 8:20:00,19,54,-35
9417,9417,88,2022/4/15 8:30:00,18,51,-33
9418,9418,88,2022/4/15 8:40:00,16,41,-25
9419,9419,88,2022/4/15 8:50:00,14,33,-19
9420,9420,88,2022/4/15 9:00:00,11,23,-12
9421,9421,88,2022/4/15 9:10:00,13,23,-10
9422,9422,88,2022/4/15 9:20:00,15,31,-16
9423,9423,88,2022/4/15 9:30:00,11,32,-21
9424,9424,88,2022/4/15 9:40:00,13,24,-11
9425,9425,88,2022/4/15 9:50:00,11,23,-12
9426,9426,88,2022/4/15 10:00:00,10,16,-6
9427,9427,88,2022/4/15 10:10:00,7,19,-12
9428,9428,88,2022/4/15 10:20:00,9,23,-14
9429,9429,88,2022/4/15 10:30:00,10,16,-6
9430,9430,88,2022/4/15 10:40:00,10,12,-2
9431,9431,88,2022/4/15 10:50:00,8,21,-13
9432,9432,88,2022/4/15 11:00:00,10,19,-9
9433,9433,88,2022/4/15 11:10:00,8,18,-10
9434,9434,88,2022/4/15 11:20:00,11,23,-12
9435,9435,88,2022/4/15 11:30:00,10,19,-9
9436,9436,88,2022/4/15 11:40:00,8,21,-13
9437,9437,88,2022/4/15 11:50:00,12,25,-13
9438,9438,88,2022/4/15 12:00:00,12,21,-9
9439,9439,88,2022/4/15 12:10:00,10,19,-9
9440,9440,88,2022/4/15 12:20:00,13,25,-12
9441,9441,88,2022/4/15 12:30:00,10,19,-9
9442,9442,88,2022/4/15 12:40:00,10,19,-9
9443,9443,88,2022/4/15 12:50:00,10,23,-13
9444,9444,88,2022/4/15 13:00:00,12,23,-11
9445,9445,88,2022/4/15 13:10:00,8,22,-14
9446,9446,88,2022/4/15 13:20:00,10,22,-12
9447,9447,88,2022/4/15 13:30:00,11,19,-8
9448,9448,88,2022/4/15 13:40:00,11,19,-8
9449,9449,88,2022/4/15 13:50:00,8,21,-13
9450,9450,88,2022/4/15 14:00:00,11,19,-8
9451,9451,88,2022/4/15 14:10:00,10,23,-13
9452,9452,88,2022/4/15 14:20:00,10,23,-13
9453,9453,88,2022/4/15 14:30:00,11,21,-10
9454,9454,88,2022/4/15 14:40:00,10,14,-4
9455,9455,88,2022/4/15 14:50:00,12,21,-9
9456,9456,88,2022/4/15 15:00:00,13,29,-16
9457,9457,88,2022/4/15 15:10:00,13,23,-10
9458,9458,88,2022/4/15 15:20:00,12,19,-7
9459,9459,88,2022/4/15 15:30:00,15,21,-6
9460,9460,88,2022/4/15 15:40:00,16,22,-6
9461,9461,88,2022/4/15 15:50:00,12,23,-11
9462,9462,88,2022/4/15 16:00:00,14,23,-9
9463,9463,88,2022/4/15 16:10:00,16,22,-6
9464,9464,88,2022/4/15 16:20:00,18,23,-5
9465,9465,88,2022/4/15 16:30:00,13,23,-10
9466,9466,88,2022/4/15 16:40:00,19,21,-2
9467,9467,88,2022/4/15 16:50:00,19,23,-4
9468,9468,88,2022/4/15 17:00:00,17,39,-22
9469,9469,88,2022/4/15 17:10:00,19,23,-4
9470,9470,88,2022/4/15 17:20:00,22,25,-3
9471,9471,88,2022/4/15 17:30:00,20,38,-18
9472,9472,88,2022/4/15 17:40:00,24,30,-6
9473,9473,88,2022/4/15 17:50:00,27,38,-11
9474,9474,88,2022/4/15 18:00:00,22,25,-3
9475,9475,88,2022/4/15 18:10:00,20,32,-12
9476,9476,88,2022/4/15 18:20:00,22,23,-1
9477,9477,88,2022/4/15 18:30:00,25,21,4
9478,9478,88,2022/4/15 18:40:00,21,23,-2
9479,9479,88,2022/4/15 18:50:00,17,23,-6
9480,9480,88,2022/4/15 19:00:00,16,23,-7
9481,9481,88,2022/4/15 19:10:00,12,13,-1
9482,9482,88,2022/4/15 19:20:00,11,21,-10
9483,9483,88,2022/4/15 19:30:00,14,18,-4
9484,9484,88,2022/4/15 19:40:00,12,13,-1
9485,9485,88,2022/4/15 19:50:00,10,18,-8
9486,9486,88,2022/4/15 20:00:00,9,10,-1
9487,9487,88,2022/4/15 20:10:00,8,13,-5
9488,9488,88,2022/4/15 20:20:00,8,15,-7
9489,9489,88,2022/4/15 20:30:00,9,10,-1
9490,9490,88,2022/4/15 20:40:00,7,8,-1
9491,9491,88,2022/4/15 20:50:00,7,10,-3
9492,9492,88,2022/4/15 21:00:00,7,8,-1
9493,9493,88,2022/4/15 21:10:00,8,7,1
9494,9494,88,2022/4/15 21:20:00,12,4,8
9495,9495,88,2022/4/15 21:30:00,6,8,-2
9496,9496,88,2022/4/15 21:40:00,8,7,1
9497,9497,88,2022/4/15 21:50:00,6,13,-7
9498,9498,88,2022/4/15 22:00:00,1,8,-7
9499,9499,88,2022/4/15 22:10:00,0,3,-3
9500,9500,88,2022/4/15 22:20:00,0,8,-8
9501,9501,88,2022/4/15 22:30:00,0,3,-3
9502,9502,88,2022/4/15 22:40:00,0,3,-3
9503,9503,88,2022/4/15 22:50:00,0,4,-4
9504,9504,89,2022/4/15 5:00:00,0,1,-1
9505,9505,89,2022/4/15 5:10:00,0,1,-1
9506,9506,89,2022/4/15 5:20:00,0,1,-1
9507,9507,89,2022/4/15 5:30:00,0,1,-1
9508,9508,89,2022/4/15 5:40:00,0,1,-1
9509,9509,89,2022/4/15 5:50:00,1,1,0
9510,9510,89,2022/4/15 6:00:00,16,1,15
9511,9511,89,2022/4/15 6:10:00,51,1,50
9512,9512,89,2022/4/15 6:20:00,28,6,22
9513,9513,89,2022/4/15 6:30:00,35,6,29
9514,9514,89,2022/4/15 6:40:00,68,5,63
9515,9515,89,2022/4/15 6:50:00,55,23,32
9516,9516,89,2022/4/15 7:00:00,80,23,57
9517,9517,89,2022/4/15 7:10:00,85,23,62
9518,9518,89,2022/4/15 7:20:00,151,50,101
9519,9519,89,2022/4/15 7:30:00,150,66,84
9520,9520,89,2022/4/15 7:40:00,149,60,89
9521,9521,89,2022/4/15 7:50:00,54,65,-11
9522,9522,89,2022/4/15 8:00:00,77,68,9
9523,9523,89,2022/4/15 8:10:00,38,66,-28
9524,9524,89,2022/4/15 8:20:00,47,71,-24
9525,9525,89,2022/4/15 8:30:00,28,53,-25
9526,9526,89,2022/4/15 8:40:00,37,60,-23
9527,9527,89,2022/4/15 8:50:00,25,53,-28
9528,9528,89,2022/4/15 9:00:00,22,44,-22
9529,9529,89,2022/4/15 9:10:00,25,39,-14
9530,9530,89,2022/4/15 9:20:00,17,50,-33
9531,9531,89,2022/4/15 9:30:00,22,51,-29
9532,9532,89,2022/4/15 9:40:00,15,47,-32
9533,9533,89,2022/4/15 9:50:00,13,47,-34
9534,9534,89,2022/4/15 10:00:00,14,45,-31
9535,9535,89,2022/4/15 10:10:00,16,65,-49
9536,9536,89,2022/4/15 10:20:00,24,41,-17
9537,9537,89,2022/4/15 10:30:00,18,49,-31
9538,9538,89,2022/4/15 10:40:00,20,41,-21
9539,9539,89,2022/4/15 10:50:00,18,54,-36
9540,9540,89,2022/4/15 11:00:00,16,45,-29
9541,9541,89,2022/4/15 11:10:00,18,45,-27
9542,9542,89,2022/4/15 11:20:00,18,28,-10
9543,9543,89,2022/4/15 11:30:00,18,62,-44
9544,9544,89,2022/4/15 11:40:00,20,32,-12
9545,9545,89,2022/4/15 11:50:00,20,47,-27
9546,9546,89,2022/4/15 12:00:00,21,38,-17
9547,9547,89,2022/4/15 12:10:00,19,51,-32
9548,9548,89,2022/4/15 12:20:00,19,43,-24
9549,9549,89,2022/4/15 12:30:00,23,29,-6
9550,9550,89,2022/4/15 12:40:00,20,44,-24
9551,9551,89,2022/4/15 12:50:00,20,58,-38
9552,9552,89,2022/4/15 13:00:00,18,48,-30
9553,9553,89,2022/4/15 13:10:00,14,44,-30
9554,9554,89,2022/4/15 13:20:00,15,31,-16
9555,9555,89,2022/4/15 13:30:00,13,57,-44
9556,9556,89,2022/4/15 13:40:00,11,29,-18
9557,9557,89,2022/4/15 13:50:00,16,40,-24
9558,9558,89,2022/4/15 14:00:00,16,42,-26
9559,9559,89,2022/4/15 14:10:00,16,48,-32
9560,9560,89,2022/4/15 14:20:00,19,44,-25
9561,9561,89,2022/4/15 14:30:00,18,32,-14
9562,9562,89,2022/4/15 14:40:00,20,39,-19
9563,9563,89,2022/4/15 14:50:00,18,45,-27
9564,9564,89,2022/4/15 15:00:00,18,45,-27
9565,9565,89,2022/4/15 15:10:00,20,41,-21
9566,9566,89,2022/4/15 15:20:00,22,37,-15
9567,9567,89,2022/4/15 15:30:00,21,58,-37
9568,9568,89,2022/4/15 15:40:00,21,44,-23
9569,9569,89,2022/4/15 15:50:00,26,49,-23
9570,9570,89,2022/4/15 16:00:00,24,55,-31
9571,9571,89,2022/4/15 16:10:00,28,62,-34
9572,9572,89,2022/4/15 16:20:00,27,68,-41
9573,9573,89,2022/4/15 16:30:00,26,41,-15
9574,9574,89,2022/4/15 16:40:00,20,68,-48
9575,9575,89,2022/4/15 16:50:00,30,61,-31
9576,9576,89,2022/4/15 17:00:00,25,78,-53
9577,9577,89,2022/4/15 17:10:00,36,60,-24
9578,9578,89,2022/4/15 17:20:00,24,59,-35
9579,9579,89,2022/4/15 17:30:00,20,88,-68
9580,9580,89,2022/4/15 17:40:00,25,73,-48
9581,9581,89,2022/4/15 17:50:00,15,93,-78
9582,9582,89,2022/4/15 18:00:00,15,74,-59
9583,9583,89,2022/4/15 18:10:00,16,100,-84
9584,9584,89,2022/4/15 18:20:00,12,77,-65
9585,9585,89,2022/4/15 18:30:00,8,83,-75
9586,9586,89,2022/4/15 18:40:00,14,126,-112
9587,9587,89,2022/4/15 18:50:00,9,86,-77
9588,9588,89,2022/4/15 19:00:00,8,105,-97
9589,9589,89,2022/4/15 19:10:00,8,86,-78
9590,9590,89,2022/4/15 19:20:00,7,75,-68
9591,9591,89,2022/4/15 19:30:00,6,115,-109
9592,9592,89,2022/4/15 19:40:00,4,67,-63
9593,9593,89,2022/4/15 19:50:00,3,75,-72
9594,9594,89,2022/4/15 20:00:00,4,44,-40
9595,9595,89,2022/4/15 20:10:00,2,70,-68
9596,9596,89,2022/4/15 20:20:00,3,51,-48
9597,9597,89,2022/4/15 20:30:00,2,44,-42
9598,9598,89,2022/4/15 20:40:00,3,41,-38
9599,9599,89,2022/4/15 20:50:00,4,56,-52
9600,9600,89,2022/4/15 21:00:00,2,47,-45
9601,9601,89,2022/4/15 21:10:00,1,39,-38
9602,9602,89,2022/4/15 21:20:00,2,46,-44
9603,9603,89,2022/4/15 21:30:00,2,3,-1
9604,9604,89,2022/4/15 21:40:00,2,46,-44
9605,9605,89,2022/4/15 21:50:00,2,46,-44
9606,9606,89,2022/4/15 22:00:00,1,40,-39
9607,9607,89,2022/4/15 22:10:00,1,7,-6
9608,9608,89,2022/4/15 22:20:00,0,45,-45
9609,9609,89,2022/4/15 22:30:00,0,30,-30
9610,9610,89,2022/4/15 22:40:00,0,10,-10
9611,9611,89,2022/4/15 22:50:00,0,3,-3
9612,9612,90,2022/4/15 5:00:00,0,1,-1
9613,9613,90,2022/4/15 5:10:00,0,1,-1
9614,9614,90,2022/4/15 5:20:00,0,1,-1
9615,9615,90,2022/4/15 5:30:00,0,1,-1
9616,9616,90,2022/4/15 5:40:00,1,1,0
9617,9617,90,2022/4/15 5:50:00,36,1,35
9618,9618,90,2022/4/15 6:00:00,34,1,33
9619,9619,90,2022/4/15 6:10:00,32,1,31
9620,9620,90,2022/4/15 6:20:00,28,1,27
9621,9621,90,2022/4/15 6:30:00,43,1,42
9622,9622,90,2022/4/15 6:40:00,34,19,15
9623,9623,90,2022/4/15 6:50:00,55,6,49
9624,9624,90,2022/4/15 7:00:00,47,6,41
9625,9625,90,2022/4/15 7:10:00,51,19,32
9626,9626,90,2022/4/15 7:20:00,54,19,35
9627,9627,90,2022/4/15 7:30:00,38,19,19
9628,9628,90,2022/4/15 7:40:00,43,23,20
9629,9629,90,2022/4/15 7:50:00,29,32,-3
9630,9630,90,2022/4/15 8:00:00,29,22,7
9631,9631,90,2022/4/15 8:10:00,21,23,-2
9632,9632,90,2022/4/15 8:20:00,23,21,2
9633,9633,90,2022/4/15 8:30:00,15,29,-14
9634,9634,90,2022/4/15 8:40:00,15,32,-17
9635,9635,90,2022/4/15 8:50:00,11,23,-12
9636,9636,90,2022/4/15 9:00:00,13,30,-17
9637,9637,90,2022/4/15 9:10:00,6,32,-26
9638,9638,90,2022/4/15 9:20:00,15,21,-6
9639,9639,90,2022/4/15 9:30:00,8,23,-15
9640,9640,90,2022/4/15 9:40:00,9,31,-22
9641,9641,90,2022/4/15 9:50:00,8,23,-15
9642,9642,90,2022/4/15 10:00:00,12,23,-11
9643,9643,90,2022/4/15 10:10:00,6,31,-25
9644,9644,90,2022/4/15 10:20:00,3,32,-29
9645,9645,90,2022/4/15 10:30:00,5,38,-33
9646,9646,90,2022/4/15 10:40:00,9,23,-14
9647,9647,90,2022/4/15 10:50:00,6,25,-19
9648,9648,90,2022/4/15 11:00:00,6,27,-21
9649,9649,90,2022/4/15 11:10:00,7,37,-30
9650,9650,90,2022/4/15 11:20:00,12,23,-11
9651,9651,90,2022/4/15 11:30:00,7,23,-16
9652,9652,90,2022/4/15 11:40:00,8,18,-10
9653,9653,90,2022/4/15 11:50:00,9,37,-28
9654,9654,90,2022/4/15 12:00:00,8,21,-13
9655,9655,90,2022/4/15 12:10:00,7,23,-16
9656,9656,90,2022/4/15 12:20:00,6,23,-17
9657,9657,90,2022/4/15 12:30:00,7,32,-25
9658,9658,90,2022/4/15 12:40:00,15,23,-8
9659,9659,90,2022/4/15 12:50:00,5,15,-10
9660,9660,90,2022/4/15 13:00:00,10,29,-19
9661,9661,90,2022/4/15 13:10:00,9,37,-28
9662,9662,90,2022/4/15 13:20:00,12,23,-11
9663,9663,90,2022/4/15 13:30:00,7,31,-24
9664,9664,90,2022/4/15 13:40:00,6,22,-16
9665,9665,90,2022/4/15 13:50:00,6,37,-31
9666,9666,90,2022/4/15 14:00:00,10,19,-9
9667,9667,90,2022/4/15 14:10:00,8,34,-26
9668,9668,90,2022/4/15 14:20:00,7,28,-21
9669,9669,90,2022/4/15 14:30:00,8,40,-32
9670,9670,90,2022/4/15 14:40:00,9,31,-22
9671,9671,90,2022/4/15 14:50:00,9,23,-14
9672,9672,90,2022/4/15 15:00:00,6,32,-26
9673,9673,90,2022/4/15 15:10:00,7,43,-36
9674,9674,90,2022/4/15 15:20:00,11,34,-23
9675,9675,90,2022/4/15 15:30:00,8,31,-23
9676,9676,90,2022/4/15 15:40:00,6,29,-23
9677,9677,90,2022/4/15 15:50:00,8,60,-52
9678,9678,90,2022/4/15 16:00:00,9,36,-27
9679,9679,90,2022/4/15 16:10:00,13,40,-27
9680,9680,90,2022/4/15 16:20:00,13,38,-25
9681,9681,90,2022/4/15 16:30:00,9,63,-54
9682,9682,90,2022/4/15 16:40:00,9,51,-42
9683,9683,90,2022/4/15 16:50:00,14,38,-24
9684,9684,90,2022/4/15 17:00:00,9,59,-50
9685,9685,90,2022/4/15 17:10:00,9,48,-39
9686,9686,90,2022/4/15 17:20:00,9,68,-59
9687,9687,90,2022/4/15 17:30:00,9,51,-42
9688,9688,90,2022/4/15 17:40:00,6,57,-51
9689,9689,90,2022/4/15 17:50:00,10,71,-61
9690,9690,90,2022/4/15 18:00:00,8,52,-44
9691,9691,90,2022/4/15 18:10:00,7,72,-65
9692,9692,90,2022/4/15 18:20:00,5,47,-42
9693,9693,90,2022/4/15 18:30:00,6,72,-66
9694,9694,90,2022/4/15 18:40:00,4,49,-45
9695,9695,90,2022/4/15 18:50:00,2,58,-56
9696,9696,90,2022/4/15 19:00:00,2,73,-71
9697,9697,90,2022/4/15 19:10:00,4,53,-49
9698,9698,90,2022/4/15 19:20:00,2,66,-64
9699,9699,90,2022/4/15 19:30:00,2,47,-45
9700,9700,90,2022/4/15 19:40:00,1,62,-61
9701,9701,90,2022/4/15 19:50:00,4,63,-59
9702,9702,90,2022/4/15 20:00:00,1,52,-51
9703,9703,90,2022/4/15 20:10:00,3,42,-39
9704,9704,90,2022/4/15 20:20:00,1,33,-32
9705,9705,90,2022/4/15 20:30:00,2,54,-52
9706,9706,90,2022/4/15 20:40:00,1,27,-26
9707,9707,90,2022/4/15 20:50:00,1,32,-31
9708,9708,90,2022/4/15 21:00:00,1,25,-24
9709,9709,90,2022/4/15 21:10:00,2,47,-45
9710,9710,90,2022/4/15 21:20:00,2,32,-30
9711,9711,90,2022/4/15 21:30:00,0,25,-25
9712,9712,90,2022/4/15 21:40:00,0,40,-40
9713,9713,90,2022/4/15 21:50:00,0,4,-4
9714,9714,90,2022/4/15 22:00:00,0,39,-39
9715,9715,90,2022/4/15 22:10:00,0,31,-31
9716,9716,90,2022/4/15 22:20:00,0,3,-3
9717,9717,90,2022/4/15 22:30:00,0,32,-32
9718,9718,90,2022/4/15 22:40:00,0,27,-27
9719,9719,90,2022/4/15 22:50:00,0,7,-7
9720,9720,91,2022/4/15 5:00:00,0,1,-1
9721,9721,91,2022/4/15 5:10:00,0,1,-1
9722,9722,91,2022/4/15 5:20:00,0,1,-1
9723,9723,91,2022/4/15 5:30:00,0,1,-1
9724,9724,91,2022/4/15 5:40:00,0,1,-1
9725,9725,91,2022/4/15 5:50:00,28,1,27
9726,9726,91,2022/4/15 6:00:00,121,1,120
9727,9727,91,2022/4/15 6:10:00,42,16,26
9728,9728,91,2022/4/15 6:20:00,73,16,57
9729,9729,91,2022/4/15 6:30:00,94,22,72
9730,9730,91,2022/4/15 6:40:00,168,19,149
9731,9731,91,2022/4/15 6:50:00,134,43,91
9732,9732,91,2022/4/15 7:00:00,147,52,95
9733,9733,91,2022/4/15 7:10:00,209,83,126
9734,9734,91,2022/4/15 7:20:00,227,81,146
9735,9735,91,2022/4/15 7:30:00,239,67,172
9736,9736,91,2022/4/15 7:40:00,318,76,242
9737,9737,91,2022/4/15 7:50:00,173,72,101
9738,9738,91,2022/4/15 8:00:00,161,77,84
9739,9739,91,2022/4/15 8:10:00,158,83,75
9740,9740,91,2022/4/15 8:20:00,85,62,23
9741,9741,91,2022/4/15 8:30:00,71,74,-3
9742,9742,91,2022/4/15 8:40:00,72,61,11
9743,9743,91,2022/4/15 8:50:00,55,64,-9
9744,9744,91,2022/4/15 9:00:00,35,49,-14
9745,9745,91,2022/4/15 9:10:00,27,60,-33
9746,9746,91,2022/4/15 9:20:00,37,64,-27
9747,9747,91,2022/4/15 9:30:00,26,68,-42
9748,9748,91,2022/4/15 9:40:00,28,80,-52
9749,9749,91,2022/4/15 9:50:00,31,65,-34
9750,9750,91,2022/4/15 10:00:00,24,66,-42
9751,9751,91,2022/4/15 10:10:00,24,55,-31
9752,9752,91,2022/4/15 10:20:00,24,63,-39
9753,9753,91,2022/4/15 10:30:00,29,73,-44
9754,9754,91,2022/4/15 10:40:00,21,54,-33
9755,9755,91,2022/4/15 10:50:00,21,46,-25
9756,9756,91,2022/4/15 11:00:00,26,64,-38
9757,9757,91,2022/4/15 11:10:00,26,69,-43
9758,9758,91,2022/4/15 11:20:00,26,54,-28
9759,9759,91,2022/4/15 11:30:00,25,57,-32
9760,9760,91,2022/4/15 11:40:00,25,44,-19
9761,9761,91,2022/4/15 11:50:00,22,65,-43
9762,9762,91,2022/4/15 12:00:00,28,38,-10
9763,9763,91,2022/4/15 12:10:00,24,58,-34
9764,9764,91,2022/4/15 12:20:00,25,53,-28
9765,9765,91,2022/4/15 12:30:00,22,71,-49
9766,9766,91,2022/4/15 12:40:00,22,53,-31
9767,9767,91,2022/4/15 12:50:00,29,45,-16
9768,9768,91,2022/4/15 13:00:00,22,65,-43
9769,9769,91,2022/4/15 13:10:00,24,80,-56
9770,9770,91,2022/4/15 13:20:00,26,63,-37
9771,9771,91,2022/4/15 13:30:00,24,59,-35
9772,9772,91,2022/4/15 13:40:00,24,51,-27
9773,9773,91,2022/4/15 13:50:00,26,81,-55
9774,9774,91,2022/4/15 14:00:00,28,49,-21
9775,9775,91,2022/4/15 14:10:00,26,62,-36
9776,9776,91,2022/4/15 14:20:00,25,63,-38
9777,9777,91,2022/4/15 14:30:00,25,68,-43
9778,9778,91,2022/4/15 14:40:00,25,57,-32
9779,9779,91,2022/4/15 14:50:00,26,54,-28
9780,9780,91,2022/4/15 15:00:00,25,57,-32
9781,9781,91,2022/4/15 15:10:00,23,73,-50
9782,9782,91,2022/4/15 15:20:00,27,60,-33
9783,9783,91,2022/4/15 15:30:00,25,68,-43
9784,9784,91,2022/4/15 15:40:00,29,56,-27
9785,9785,91,2022/4/15 15:50:00,24,92,-68
9786,9786,91,2022/4/15 16:00:00,26,76,-50
9787,9787,91,2022/4/15 16:10:00,23,71,-48
9788,9788,91,2022/4/15 16:20:00,28,90,-62
9789,9789,91,2022/4/15 16:30:00,27,93,-66
9790,9790,91,2022/4/15 16:40:00,23,67,-44
9791,9791,91,2022/4/15 16:50:00,25,100,-75
9792,9792,91,2022/4/15 17:00:00,31,75,-44
9793,9793,91,2022/4/15 17:10:00,37,105,-68
9794,9794,91,2022/4/15 17:20:00,29,87,-58
9795,9795,91,2022/4/15 17:30:00,29,111,-82
9796,9796,91,2022/4/15 17:40:00,27,110,-83
9797,9797,91,2022/4/15 17:50:00,27,108,-81
9798,9798,91,2022/4/15 18:00:00,27,128,-101
9799,9799,91,2022/4/15 18:10:00,20,114,-94
9800,9800,91,2022/4/15 18:20:00,15,192,-177
9801,9801,91,2022/4/15 18:30:00,23,129,-106
9802,9802,91,2022/4/15 18:40:00,18,113,-95
9803,9803,91,2022/4/15 18:50:00,15,184,-169
9804,9804,91,2022/4/15 19:00:00,15,104,-89
9805,9805,91,2022/4/15 19:10:00,12,179,-167
9806,9806,91,2022/4/15 19:20:00,11,104,-93
9807,9807,91,2022/4/15 19:30:00,7,109,-102
9808,9808,91,2022/4/15 19:40:00,10,92,-82
9809,9809,91,2022/4/15 19:50:00,9,108,-99
9810,9810,91,2022/4/15 20:00:00,7,86,-79
9811,9811,91,2022/4/15 20:10:00,7,85,-78
9812,9812,91,2022/4/15 20:20:00,6,70,-64
9813,9813,91,2022/4/15 20:30:00,6,107,-101
9814,9814,91,2022/4/15 20:40:00,4,67,-63
9815,9815,91,2022/4/15 20:50:00,2,73,-71
9816,9816,91,2022/4/15 21:00:00,5,67,-62
9817,9817,91,2022/4/15 21:10:00,2,61,-59
9818,9818,91,2022/4/15 21:20:00,3,83,-80
9819,9819,91,2022/4/15 21:30:00,2,71,-69
9820,9820,91,2022/4/15 21:40:00,2,64,-62
9821,9821,91,2022/4/15 21:50:00,1,8,-7
9822,9822,91,2022/4/15 22:00:00,1,73,-72
9823,9823,91,2022/4/15 22:10:00,0,70,-70
9824,9824,91,2022/4/15 22:20:00,0,13,-13
9825,9825,91,2022/4/15 22:30:00,0,62,-62
9826,9826,91,2022/4/15 22:40:00,0,3,-3
9827,9827,91,2022/4/15 22:50:00,0,3,-3
9828,9828,92,2022/4/15 5:00:00,0,1,-1
9829,9829,92,2022/4/15 5:10:00,0,1,-1
9830,9830,92,2022/4/15 5:20:00,0,1,-1
9831,9831,92,2022/4/15 5:30:00,0,1,-1
9832,9832,92,2022/4/15 5:40:00,2,1,1
9833,9833,92,2022/4/15 5:50:00,13,1,12
9834,9834,92,2022/4/15 6:00:00,19,1,18
9835,9835,92,2022/4/15 6:10:00,35,2,33
9836,9836,92,2022/4/15 6:20:00,60,2,58
9837,9837,92,2022/4/15 6:30:00,60,23,37
9838,9838,92,2022/4/15 6:40:00,61,32,29
9839,9839,92,2022/4/15 6:50:00,150,42,108
9840,9840,92,2022/4/15 7:00:00,107,63,44
9841,9841,92,2022/4/15 7:10:00,142,68,74
9842,9842,92,2022/4/15 7:20:00,225,72,153
9843,9843,92,2022/4/15 7:30:00,244,98,146
9844,9844,92,2022/4/15 7:40:00,286,106,180
9845,9845,92,2022/4/15 7:50:00,283,106,177
9846,9846,92,2022/4/15 8:00:00,263,104,159
9847,9847,92,2022/4/15 8:10:00,250,96,154
9848,9848,92,2022/4/15 8:20:00,182,104,78
9849,9849,92,2022/4/15 8:30:00,156,96,60
9850,9850,92,2022/4/15 8:40:00,142,107,35
9851,9851,92,2022/4/15 8:50:00,73,86,-13
9852,9852,92,2022/4/15 9:00:00,68,81,-13
9853,9853,92,2022/4/15 9:10:00,49,68,-19
9854,9854,92,2022/4/15 9:20:00,38,77,-39
9855,9855,92,2022/4/15 9:30:00,28,81,-53
9856,9856,92,2022/4/15 9:40:00,37,66,-29
9857,9857,92,2022/4/15 9:50:00,23,62,-39
9858,9858,92,2022/4/15 10:00:00,26,47,-21
9859,9859,92,2022/4/15 10:10:00,29,69,-40
9860,9860,92,2022/4/15 10:20:00,28,63,-35
9861,9861,92,2022/4/15 10:30:00,28,62,-34
9862,9862,92,2022/4/15 10:40:00,27,38,-11
9863,9863,92,2022/4/15 10:50:00,32,63,-31
9864,9864,92,2022/4/15 11:00:00,24,59,-35
9865,9865,92,2022/4/15 11:10:00,20,65,-45
9866,9866,92,2022/4/15 11:20:00,25,63,-38
9867,9867,92,2022/4/15 11:30:00,20,49,-29
9868,9868,92,2022/4/15 11:40:00,28,66,-38
9869,9869,92,2022/4/15 11:50:00,32,47,-15
9870,9870,92,2022/4/15 12:00:00,21,65,-44
9871,9871,92,2022/4/15 12:10:00,25,68,-43
9872,9872,92,2022/4/15 12:20:00,31,70,-39
9873,9873,92,2022/4/15 12:30:00,21,62,-41
9874,9874,92,2022/4/15 12:40:00,24,57,-33
9875,9875,92,2022/4/15 12:50:00,25,72,-47
9876,9876,92,2022/4/15 13:00:00,25,64,-39
9877,9877,92,2022/4/15 13:10:00,26,71,-45
9878,9878,92,2022/4/15 13:20:00,25,68,-43
9879,9879,92,2022/4/15 13:30:00,22,62,-40
9880,9880,92,2022/4/15 13:40:00,23,83,-60
9881,9881,92,2022/4/15 13:50:00,24,54,-30
9882,9882,92,2022/4/15 14:00:00,26,60,-34
9883,9883,92,2022/4/15 14:10:00,24,66,-42
9884,9884,92,2022/4/15 14:20:00,25,69,-44
9885,9885,92,2022/4/15 14:30:00,28,72,-44
9886,9886,92,2022/4/15 14:40:00,22,59,-37
9887,9887,92,2022/4/15 14:50:00,21,71,-50
9888,9888,92,2022/4/15 15:00:00,22,84,-62
9889,9889,92,2022/4/15 15:10:00,23,82,-59
9890,9890,92,2022/4/15 15:20:00,22,73,-51
9891,9891,92,2022/4/15 15:30:00,23,62,-39
9892,9892,92,2022/4/15 15:40:00,26,104,-78
9893,9893,92,2022/4/15 15:50:00,22,76,-54
9894,9894,92,2022/4/15 16:00:00,27,76,-49
9895,9895,92,2022/4/15 16:10:00,27,103,-76
9896,9896,92,2022/4/15 16:20:00,31,97,-66
9897,9897,92,2022/4/15 16:30:00,40,71,-31
9898,9898,92,2022/4/15 16:40:00,62,122,-60
9899,9899,92,2022/4/15 16:50:00,35,85,-50
9900,9900,92,2022/4/15 17:00:00,45,126,-81
9901,9901,92,2022/4/15 17:10:00,70,97,-27
9902,9902,92,2022/4/15 17:20:00,56,118,-62
9903,9903,92,2022/4/15 17:30:00,38,118,-80
9904,9904,92,2022/4/15 17:40:00,39,106,-67
9905,9905,92,2022/4/15 17:50:00,43,151,-108
9906,9906,92,2022/4/15 18:00:00,27,109,-82
9907,9907,92,2022/4/15 18:10:00,26,197,-171
9908,9908,92,2022/4/15 18:20:00,25,128,-103
9909,9909,92,2022/4/15 18:30:00,27,120,-93
9910,9910,92,2022/4/15 18:40:00,26,184,-158
9911,9911,92,2022/4/15 18:50:00,21,128,-107
9912,9912,92,2022/4/15 19:00:00,16,198,-182
9913,9913,92,2022/4/15 19:10:00,19,123,-104
9914,9914,92,2022/4/15 19:20:00,16,178,-162
9915,9915,92,2022/4/15 19:30:00,15,115,-100
9916,9916,92,2022/4/15 19:40:00,14,124,-110
9917,9917,92,2022/4/15 19:50:00,14,113,-99
9918,9918,92,2022/4/15 20:00:00,14,98,-84
9919,9919,92,2022/4/15 20:10:00,12,77,-65
9920,9920,92,2022/4/15 20:20:00,12,107,-95
9921,9921,92,2022/4/15 20:30:00,12,73,-61
9922,9922,92,2022/4/15 20:40:00,10,80,-70
9923,9923,92,2022/4/15 20:50:00,13,77,-64
9924,9924,92,2022/4/15 21:00:00,8,76,-68
9925,9925,92,2022/4/15 21:10:00,10,92,-82
9926,9926,92,2022/4/15 21:20:00,7,92,-85
9927,9927,92,2022/4/15 21:30:00,8,93,-85
9928,9928,92,2022/4/15 21:40:00,5,18,-13
9929,9929,92,2022/4/15 21:50:00,2,84,-82
9930,9930,92,2022/4/15 22:00:00,2,101,-99
9931,9931,92,2022/4/15 22:10:00,1,95,-94
9932,9932,92,2022/4/15 22:20:00,0,8,-8
9933,9933,92,2022/4/15 22:30:00,0,3,-3
9934,9934,92,2022/4/15 22:40:00,0,4,-4
9935,9935,92,2022/4/15 22:50:00,0,3,-3
9936,9936,93,2022/4/15 5:00:00,0,1,-1
9937,9937,93,2022/4/15 5:10:00,10,1,9
9938,9938,93,2022/4/15 5:20:00,26,1,25
9939,9939,93,2022/4/15 5:30:00,27,1,26
9940,9940,93,2022/4/15 5:40:00,31,2,29
9941,9941,93,2022/4/15 5:50:00,34,1,33
9942,9942,93,2022/4/15 6:00:00,52,25,27
9943,9943,93,2022/4/15 6:10:00,59,5,54
9944,9944,93,2022/4/15 6:20:00,81,6,75
9945,9945,93,2022/4/15 6:30:00,155,23,132
9946,9946,93,2022/4/15 6:40:00,227,23,204
9947,9947,93,2022/4/15 6:50:00,277,29,248
9948,9948,93,2022/4/15 7:00:00,316,51,265
9949,9949,93,2022/4/15 7:10:00,589,42,547
9950,9950,93,2022/4/15 7:20:00,706,101,605
9951,9951,93,2022/4/15 7:30:00,839,100,739
9952,9952,93,2022/4/15 7:40:00,1061,84,977
9953,9953,93,2022/4/15 7:50:00,1056,87,969
9954,9954,93,2022/4/15 8:00:00,1057,71,986
9955,9955,93,2022/4/15 8:10:00,857,73,784
9956,9956,93,2022/4/15 8:20:00,654,71,583
9957,9957,93,2022/4/15 8:30:00,573,73,500
9958,9958,93,2022/4/15 8:40:00,350,60,290
9959,9959,93,2022/4/15 8:50:00,281,75,206
9960,9960,93,2022/4/15 9:00:00,229,48,181
9961,9961,93,2022/4/15 9:10:00,162,69,93
9962,9962,93,2022/4/15 9:20:00,77,70,7
9963,9963,93,2022/4/15 9:30:00,62,75,-13
9964,9964,93,2022/4/15 9:40:00,50,68,-18
9965,9965,93,2022/4/15 9:50:00,45,85,-40
9966,9966,93,2022/4/15 10:00:00,42,69,-27
9967,9967,93,2022/4/15 10:10:00,35,67,-32
9968,9968,93,2022/4/15 10:20:00,35,62,-27
9969,9969,93,2022/4/15 10:30:00,36,59,-23
9970,9970,93,2022/4/15 10:40:00,30,60,-30
9971,9971,93,2022/4/15 10:50:00,35,51,-16
9972,9972,93,2022/4/15 11:00:00,29,67,-38
9973,9973,93,2022/4/15 11:10:00,30,66,-36
9974,9974,93,2022/4/15 11:20:00,30,57,-27
9975,9975,93,2022/4/15 11:30:00,45,66,-21
9976,9976,93,2022/4/15 11:40:00,42,38,4
9977,9977,93,2022/4/15 11:50:00,36,71,-35
9978,9978,93,2022/4/15 12:00:00,39,70,-31
9979,9979,93,2022/4/15 12:10:00,38,74,-36
9980,9980,93,2022/4/15 12:20:00,37,59,-22
9981,9981,93,2022/4/15 12:30:00,37,60,-23
9982,9982,93,2022/4/15 12:40:00,30,46,-16
9983,9983,93,2022/4/15 12:50:00,32,71,-39
9984,9984,93,2022/4/15 13:00:00,28,62,-34
9985,9985,93,2022/4/15 13:10:00,28,68,-40
9986,9986,93,2022/4/15 13:20:00,27,64,-37
9987,9987,93,2022/4/15 13:30:00,27,64,-37
9988,9988,93,2022/4/15 13:40:00,25,57,-32
9989,9989,93,2022/4/15 13:50:00,26,76,-50
9990,9990,93,2022/4/15 14:00:00,28,61,-33
9991,9991,93,2022/4/15 14:10:00,25,71,-46
9992,9992,93,2022/4/15 14:20:00,23,68,-45
9993,9993,93,2022/4/15 14:30:00,26,66,-40
9994,9994,93,2022/4/15 14:40:00,29,70,-41
9995,9995,93,2022/4/15 14:50:00,34,75,-41
9996,9996,93,2022/4/15 15:00:00,24,91,-67
9997,9997,93,2022/4/15 15:10:00,25,78,-53
9998,9998,93,2022/4/15 15:20:00,28,91,-63
9999,9999,93,2022/4/15 15:30:00,26,65,-39
10000,10000,93,2022/4/15 15:40:00,29,72,-43
10001,10001,93,2022/4/15 15:50:00,27,95,-68
10002,10002,93,2022/4/15 16:00:00,27,101,-74
10003,10003,93,2022/4/15 16:10:00,29,91,-62
10004,10004,93,2022/4/15 16:20:00,29,93,-64
10005,10005,93,2022/4/15 16:30:00,39,93,-54
10006,10006,93,2022/4/15 16:40:00,31,96,-65
10007,10007,93,2022/4/15 16:50:00,29,100,-71
10008,10008,93,2022/4/15 17:00:00,30,122,-92
10009,10009,93,2022/4/15 17:10:00,42,103,-61
10010,10010,93,2022/4/15 17:20:00,40,111,-71
10011,10011,93,2022/4/15 17:30:00,35,125,-90
10012,10012,93,2022/4/15 17:40:00,28,143,-115
10013,10013,93,2022/4/15 17:50:00,28,194,-166
10014,10014,93,2022/4/15 18:00:00,29,269,-240
10015,10015,93,2022/4/15 18:10:00,25,197,-172
10016,10016,93,2022/4/15 18:20:00,29,340,-311
10017,10017,93,2022/4/15 18:30:00,26,257,-231
10018,10018,93,2022/4/15 18:40:00,23,365,-342
10019,10019,93,2022/4/15 18:50:00,22,483,-461
10020,10020,93,2022/4/15 19:00:00,25,382,-357
10021,10021,93,2022/4/15 19:10:00,25,225,-200
10022,10022,93,2022/4/15 19:20:00,22,334,-312
10023,10023,93,2022/4/15 19:30:00,17,181,-164
10024,10024,93,2022/4/15 19:40:00,20,206,-186
10025,10025,93,2022/4/15 19:50:00,18,125,-107
10026,10026,93,2022/4/15 20:00:00,16,124,-108
10027,10027,93,2022/4/15 20:10:00,19,104,-85
10028,10028,93,2022/4/15 20:20:00,17,117,-100
10029,10029,93,2022/4/15 20:30:00,17,107,-90
10030,10030,93,2022/4/15 20:40:00,14,113,-99
10031,10031,93,2022/4/15 20:50:00,20,109,-89
10032,10032,93,2022/4/15 21:00:00,19,127,-108
10033,10033,93,2022/4/15 21:10:00,16,107,-91
10034,10034,93,2022/4/15 21:20:00,14,106,-92
10035,10035,93,2022/4/15 21:30:00,12,75,-63
10036,10036,93,2022/4/15 21:40:00,10,98,-88
10037,10037,93,2022/4/15 21:50:00,11,105,-94
10038,10038,93,2022/4/15 22:00:00,10,100,-90
10039,10039,93,2022/4/15 22:10:00,8,103,-95
10040,10040,93,2022/4/15 22:20:00,6,59,-53
10041,10041,93,2022/4/15 22:30:00,3,103,-100
10042,10042,93,2022/4/15 22:40:00,2,80,-78
10043,10043,93,2022/4/15 22:50:00,2,105,-103
10044,10044,94,2022/4/15 5:00:00,2,1,1
10045,10045,94,2022/4/15 5:10:00,6,1,5
10046,10046,94,2022/4/15 5:20:00,14,1,13
10047,10047,94,2022/4/15 5:30:00,18,1,17
10048,10048,94,2022/4/15 5:40:00,24,2,22
10049,10049,94,2022/4/15 5:50:00,30,23,7
10050,10050,94,2022/4/15 6:00:00,42,19,23
10051,10051,94,2022/4/15 6:10:00,54,38,16
10052,10052,94,2022/4/15 6:20:00,75,59,16
10053,10053,94,2022/4/15 6:30:00,184,71,113
10054,10054,94,2022/4/15 6:40:00,256,98,158
10055,10055,94,2022/4/15 6:50:00,317,105,212
10056,10056,94,2022/4/15 7:00:00,386,118,268
10057,10057,94,2022/4/15 7:10:00,598,138,460
10058,10058,94,2022/4/15 7:20:00,656,177,479
10059,10059,94,2022/4/15 7:30:00,741,325,416
10060,10060,94,2022/4/15 7:40:00,870,378,492
10061,10061,94,2022/4/15 7:50:00,1193,439,754
10062,10062,94,2022/4/15 8:00:00,1054,554,500
10063,10063,94,2022/4/15 8:10:00,1063,1779,-716
10064,10064,94,2022/4/15 8:20:00,837,1013,-176
10065,10065,94,2022/4/15 8:30:00,705,1707,-1002
10066,10066,94,2022/4/15 8:40:00,720,1674,-954
10067,10067,94,2022/4/15 8:50:00,722,1457,-735
10068,10068,94,2022/4/15 9:00:00,584,578,6
10069,10069,94,2022/4/15 9:10:00,466,415,51
10070,10070,94,2022/4/15 9:20:00,363,519,-156
10071,10071,94,2022/4/15 9:30:00,297,319,-22
10072,10072,94,2022/4/15 9:40:00,269,298,-29
10073,10073,94,2022/4/15 9:50:00,212,224,-12
10074,10074,94,2022/4/15 10:00:00,202,145,57
10075,10075,94,2022/4/15 10:10:00,202,170,32
10076,10076,94,2022/4/15 10:20:00,176,115,61
10077,10077,94,2022/4/15 10:30:00,167,106,61
10078,10078,94,2022/4/15 10:40:00,153,105,48
10079,10079,94,2022/4/15 10:50:00,143,106,37
10080,10080,94,2022/4/15 11:00:00,149,103,46
10081,10081,94,2022/4/15 11:10:00,149,109,40
10082,10082,94,2022/4/15 11:20:00,137,102,35
10083,10083,94,2022/4/15 11:30:00,173,100,73
10084,10084,94,2022/4/15 11:40:00,135,105,30
10085,10085,94,2022/4/15 11:50:00,164,121,43
10086,10086,94,2022/4/15 12:00:00,167,120,47
10087,10087,94,2022/4/15 12:10:00,170,108,62
10088,10088,94,2022/4/15 12:20:00,174,115,59
10089,10089,94,2022/4/15 12:30:00,187,111,76
10090,10090,94,2022/4/15 12:40:00,176,103,73
10091,10091,94,2022/4/15 12:50:00,173,121,52
10092,10092,94,2022/4/15 13:00:00,162,112,50
10093,10093,94,2022/4/15 13:10:00,173,125,48
10094,10094,94,2022/4/15 13:20:00,162,121,41
10095,10095,94,2022/4/15 13:30:00,166,117,49
10096,10096,94,2022/4/15 13:40:00,160,115,45
10097,10097,94,2022/4/15 13:50:00,158,117,41
10098,10098,94,2022/4/15 14:00:00,167,109,58
10099,10099,94,2022/4/15 14:10:00,142,138,4
10100,10100,94,2022/4/15 14:20:00,141,108,33
10101,10101,94,2022/4/15 14:30:00,157,111,46
10102,10102,94,2022/4/15 14:40:00,157,121,36
10103,10103,94,2022/4/15 14:50:00,166,110,56
10104,10104,94,2022/4/15 15:00:00,199,133,66
10105,10105,94,2022/4/15 15:10:00,220,108,112
10106,10106,94,2022/4/15 15:20:00,196,133,63
10107,10107,94,2022/4/15 15:30:00,204,111,93
10108,10108,94,2022/4/15 15:40:00,207,128,79
10109,10109,94,2022/4/15 15:50:00,204,108,96
10110,10110,94,2022/4/15 16:00:00,268,119,149
10111,10111,94,2022/4/15 16:10:00,272,115,157
10112,10112,94,2022/4/15 16:20:00,263,145,118
10113,10113,94,2022/4/15 16:30:00,331,109,222
10114,10114,94,2022/4/15 16:40:00,585,159,426
10115,10115,94,2022/4/15 16:50:00,606,154,452
10116,10116,94,2022/4/15 17:00:00,680,193,487
10117,10117,94,2022/4/15 17:10:00,1037,230,807
10118,10118,94,2022/4/15 17:20:00,810,295,515
10119,10119,94,2022/4/15 17:30:00,838,377,461
10120,10120,94,2022/4/15 17:40:00,1163,372,791
10121,10121,94,2022/4/15 17:50:00,848,492,356
10122,10122,94,2022/4/15 18:00:00,654,506,148
10123,10123,94,2022/4/15 18:10:00,1039,535,504
10124,10124,94,2022/4/15 18:20:00,804,534,270
10125,10125,94,2022/4/15 18:30:00,571,493,78
10126,10126,94,2022/4/15 18:40:00,350,504,-154
10127,10127,94,2022/4/15 18:50:00,317,365,-48
10128,10128,94,2022/4/15 19:00:00,266,342,-76
10129,10129,94,2022/4/15 19:10:00,222,285,-63
10130,10130,94,2022/4/15 19:20:00,187,217,-30
10131,10131,94,2022/4/15 19:30:00,156,177,-21
10132,10132,94,2022/4/15 19:40:00,114,190,-76
10133,10133,94,2022/4/15 19:50:00,133,126,7
10134,10134,94,2022/4/15 20:00:00,73,142,-69
10135,10135,94,2022/4/15 20:10:00,91,128,-37
10136,10136,94,2022/4/15 20:20:00,84,107,-23
10137,10137,94,2022/4/15 20:30:00,76,111,-35
10138,10138,94,2022/4/15 20:40:00,70,128,-58
10139,10139,94,2022/4/15 20:50:00,82,103,-21
10140,10140,94,2022/4/15 21:00:00,77,121,-44
10141,10141,94,2022/4/15 21:10:00,61,107,-46
10142,10142,94,2022/4/15 21:20:00,59,109,-50
10143,10143,94,2022/4/15 21:30:00,44,116,-72
10144,10144,94,2022/4/15 21:40:00,47,119,-72
10145,10145,94,2022/4/15 21:50:00,37,121,-84
10146,10146,94,2022/4/15 22:00:00,27,102,-75
10147,10147,94,2022/4/15 22:10:00,29,105,-76
10148,10148,94,2022/4/15 22:20:00,21,120,-99
10149,10149,94,2022/4/15 22:30:00,24,106,-82
10150,10150,94,2022/4/15 22:40:00,12,103,-91
10151,10151,94,2022/4/15 22:50:00,1,77,-76
10152,10152,95,2022/4/15 5:00:00,2,1,1
10153,10153,95,2022/4/15 5:10:00,4,1,3
10154,10154,95,2022/4/15 5:20:00,8,1,7
10155,10155,95,2022/4/15 5:30:00,7,1,6
10156,10156,95,2022/4/15 5:40:00,7,5,2
10157,10157,95,2022/4/15 5:50:00,9,19,-10
10158,10158,95,2022/4/15 6:00:00,7,23,-16
10159,10159,95,2022/4/15 6:10:00,13,53,-40
10160,10160,95,2022/4/15 6:20:00,14,74,-60
10161,10161,95,2022/4/15 6:30:00,22,73,-51
10162,10162,95,2022/4/15 6:40:00,29,102,-73
10163,10163,95,2022/4/15 6:50:00,31,109,-78
10164,10164,95,2022/4/15 7:00:00,36,108,-72
10165,10165,95,2022/4/15 7:10:00,36,112,-76
10166,10166,95,2022/4/15 7:20:00,35,152,-117
10167,10167,95,2022/4/15 7:30:00,32,227,-195
10168,10168,95,2022/4/15 7:40:00,34,256,-222
10169,10169,95,2022/4/15 7:50:00,38,299,-261
10170,10170,95,2022/4/15 8:00:00,54,267,-213
10171,10171,95,2022/4/15 8:10:00,52,332,-280
10172,10172,95,2022/4/15 8:20:00,57,316,-259
10173,10173,95,2022/4/15 8:30:00,57,436,-379
10174,10174,95,2022/4/15 8:40:00,51,422,-371
10175,10175,95,2022/4/15 8:50:00,55,503,-448
10176,10176,95,2022/4/15 9:00:00,42,318,-276
10177,10177,95,2022/4/15 9:10:00,43,284,-241
10178,10178,95,2022/4/15 9:20:00,38,256,-218
10179,10179,95,2022/4/15 9:30:00,40,192,-152
10180,10180,95,2022/4/15 9:40:00,39,150,-111
10181,10181,95,2022/4/15 9:50:00,37,108,-71
10182,10182,95,2022/4/15 10:00:00,35,99,-64
10183,10183,95,2022/4/15 10:10:00,30,111,-81
10184,10184,95,2022/4/15 10:20:00,29,103,-74
10185,10185,95,2022/4/15 10:30:00,33,109,-76
10186,10186,95,2022/4/15 10:40:00,29,106,-77
10187,10187,95,2022/4/15 10:50:00,28,93,-65
10188,10188,95,2022/4/15 11:00:00,27,93,-66
10189,10189,95,2022/4/15 11:10:00,33,81,-48
10190,10190,95,2022/4/15 11:20:00,37,76,-39
10191,10191,95,2022/4/15 11:30:00,29,75,-46
10192,10192,95,2022/4/15 11:40:00,30,91,-61
10193,10193,95,2022/4/15 11:50:00,30,75,-45
10194,10194,95,2022/4/15 12:00:00,32,73,-41
10195,10195,95,2022/4/15 12:10:00,31,76,-45
10196,10196,95,2022/4/15 12:20:00,29,77,-48
10197,10197,95,2022/4/15 12:30:00,31,91,-60
10198,10198,95,2022/4/15 12:40:00,31,108,-77
10199,10199,95,2022/4/15 12:50:00,36,98,-62
10200,10200,95,2022/4/15 13:00:00,29,105,-76
10201,10201,95,2022/4/15 13:10:00,31,101,-70
10202,10202,95,2022/4/15 13:20:00,30,109,-79
10203,10203,95,2022/4/15 13:30:00,32,93,-61
10204,10204,95,2022/4/15 13:40:00,32,93,-61
10205,10205,95,2022/4/15 13:50:00,32,88,-56
10206,10206,95,2022/4/15 14:00:00,37,94,-57
10207,10207,95,2022/4/15 14:10:00,38,76,-38
10208,10208,95,2022/4/15 14:20:00,38,76,-38
10209,10209,95,2022/4/15 14:30:00,37,76,-39
10210,10210,95,2022/4/15 14:40:00,40,81,-41
10211,10211,95,2022/4/15 14:50:00,37,76,-39
10212,10212,95,2022/4/15 15:00:00,41,75,-34
10213,10213,95,2022/4/15 15:10:00,41,84,-43
10214,10214,95,2022/4/15 15:20:00,44,81,-37
10215,10215,95,2022/4/15 15:30:00,55,77,-22
10216,10216,95,2022/4/15 15:40:00,50,75,-25
10217,10217,95,2022/4/15 15:50:00,56,85,-29
10218,10218,95,2022/4/15 16:00:00,57,76,-19
10219,10219,95,2022/4/15 16:10:00,68,72,-4
10220,10220,95,2022/4/15 16:20:00,64,71,-7
10221,10221,95,2022/4/15 16:30:00,83,86,-3
10222,10222,95,2022/4/15 16:40:00,140,79,61
10223,10223,95,2022/4/15 16:50:00,242,74,168
10224,10224,95,2022/4/15 17:00:00,325,85,240
10225,10225,95,2022/4/15 17:10:00,344,76,268
10226,10226,95,2022/4/15 17:20:00,224,90,134
10227,10227,95,2022/4/15 17:30:00,270,98,172
10228,10228,95,2022/4/15 17:40:00,344,110,234
10229,10229,95,2022/4/15 17:50:00,230,104,126
10230,10230,95,2022/4/15 18:00:00,240,106,134
10231,10231,95,2022/4/15 18:10:00,352,107,245
10232,10232,95,2022/4/15 18:20:00,249,104,145
10233,10233,95,2022/4/15 18:30:00,170,105,65
10234,10234,95,2022/4/15 18:40:00,139,104,35
10235,10235,95,2022/4/15 18:50:00,81,96,-15
10236,10236,95,2022/4/15 19:00:00,65,78,-13
10237,10237,95,2022/4/15 19:10:00,55,81,-26
10238,10238,95,2022/4/15 19:20:00,43,77,-34
10239,10239,95,2022/4/15 19:30:00,43,64,-21
10240,10240,95,2022/4/15 19:40:00,38,69,-31
10241,10241,95,2022/4/15 19:50:00,37,58,-21
10242,10242,95,2022/4/15 20:00:00,36,58,-22
10243,10243,95,2022/4/15 20:10:00,37,54,-17
10244,10244,95,2022/4/15 20:20:00,30,55,-25
10245,10245,95,2022/4/15 20:30:00,33,49,-16
10246,10246,95,2022/4/15 20:40:00,31,43,-12
10247,10247,95,2022/4/15 20:50:00,31,52,-21
10248,10248,95,2022/4/15 21:00:00,25,48,-23
10249,10249,95,2022/4/15 21:10:00,35,52,-17
10250,10250,95,2022/4/15 21:20:00,25,61,-36
10251,10251,95,2022/4/15 21:30:00,29,51,-22
10252,10252,95,2022/4/15 21:40:00,25,50,-25
10253,10253,95,2022/4/15 21:50:00,26,51,-25
10254,10254,95,2022/4/15 22:00:00,26,47,-21
10255,10255,95,2022/4/15 22:10:00,24,49,-25
10256,10256,95,2022/4/15 22:20:00,23,49,-26
10257,10257,95,2022/4/15 22:30:00,18,34,-16
10258,10258,95,2022/4/15 22:40:00,15,32,-17
10259,10259,95,2022/4/15 22:50:00,10,25,-15
10260,10260,96,2022/4/15 5:00:00,0,1,-1
10261,10261,96,2022/4/15 5:10:00,16,1,15
10262,10262,96,2022/4/15 5:20:00,23,1,22
10263,10263,96,2022/4/15 5:30:00,25,1,24
10264,10264,96,2022/4/15 5:40:00,29,1,28
10265,10265,96,2022/4/15 5:50:00,38,1,37
10266,10266,96,2022/4/15 6:00:00,47,1,46
10267,10267,96,2022/4/15 6:10:00,66,64,2
10268,10268,96,2022/4/15 6:20:00,148,61,87
10269,10269,96,2022/4/15 6:30:00,185,84,101
10270,10270,96,2022/4/15 6:40:00,236,108,128
10271,10271,96,2022/4/15 6:50:00,275,91,184
10272,10272,96,2022/4/15 7:00:00,325,93,232
10273,10273,96,2022/4/15 7:10:00,593,119,474
10274,10274,96,2022/4/15 7:20:00,683,123,560
10275,10275,96,2022/4/15 7:30:00,666,114,552
10276,10276,96,2022/4/15 7:40:00,687,108,579
10277,10277,96,2022/4/15 7:50:00,862,127,735
10278,10278,96,2022/4/15 8:00:00,753,144,609
10279,10279,96,2022/4/15 8:10:00,665,106,559
10280,10280,96,2022/4/15 8:20:00,611,114,497
10281,10281,96,2022/4/15 8:30:00,474,122,352
10282,10282,96,2022/4/15 8:40:00,282,111,171
10283,10283,96,2022/4/15 8:50:00,246,110,136
10284,10284,96,2022/4/15 9:00:00,173,109,64
10285,10285,96,2022/4/15 9:10:00,121,110,11
10286,10286,96,2022/4/15 9:20:00,94,108,-14
10287,10287,96,2022/4/15 9:30:00,63,90,-27
10288,10288,96,2022/4/15 9:40:00,77,94,-17
10289,10289,96,2022/4/15 9:50:00,58,77,-19
10290,10290,96,2022/4/15 10:00:00,42,91,-49
10291,10291,96,2022/4/15 10:10:00,46,87,-41
10292,10292,96,2022/4/15 10:20:00,45,77,-32
10293,10293,96,2022/4/15 10:30:00,45,74,-29
10294,10294,96,2022/4/15 10:40:00,51,71,-20
10295,10295,96,2022/4/15 10:50:00,53,90,-37
10296,10296,96,2022/4/15 11:00:00,46,79,-33
10297,10297,96,2022/4/15 11:10:00,58,76,-18
10298,10298,96,2022/4/15 11:20:00,42,61,-19
10299,10299,96,2022/4/15 11:30:00,73,82,-9
10300,10300,96,2022/4/15 11:40:00,69,93,-24
10301,10301,96,2022/4/15 11:50:00,57,94,-37
10302,10302,96,2022/4/15 12:00:00,63,75,-12
10303,10303,96,2022/4/15 12:10:00,62,78,-16
10304,10304,96,2022/4/15 12:20:00,60,80,-20
10305,10305,96,2022/4/15 12:30:00,47,109,-62
10306,10306,96,2022/4/15 12:40:00,42,101,-59
10307,10307,96,2022/4/15 12:50:00,44,82,-38
10308,10308,96,2022/4/15 13:00:00,41,105,-64
10309,10309,96,2022/4/15 13:10:00,43,73,-30
10310,10310,96,2022/4/15 13:20:00,41,83,-42
10311,10311,96,2022/4/15 13:30:00,45,92,-47
10312,10312,96,2022/4/15 13:40:00,41,90,-49
10313,10313,96,2022/4/15 13:50:00,42,73,-31
10314,10314,96,2022/4/15 14:00:00,39,91,-52
10315,10315,96,2022/4/15 14:10:00,39,64,-25
10316,10316,96,2022/4/15 14:20:00,45,70,-25
10317,10317,96,2022/4/15 14:30:00,38,97,-59
10318,10318,96,2022/4/15 14:40:00,47,90,-43
10319,10319,96,2022/4/15 14:50:00,43,75,-32
10320,10320,96,2022/4/15 15:00:00,40,75,-35
10321,10321,96,2022/4/15 15:10:00,41,76,-35
10322,10322,96,2022/4/15 15:20:00,45,96,-51
10323,10323,96,2022/4/15 15:30:00,39,97,-58
10324,10324,96,2022/4/15 15:40:00,43,113,-70
10325,10325,96,2022/4/15 15:50:00,44,90,-46
10326,10326,96,2022/4/15 16:00:00,45,98,-53
10327,10327,96,2022/4/15 16:10:00,58,74,-16
10328,10328,96,2022/4/15 16:20:00,63,108,-45
10329,10329,96,2022/4/15 16:30:00,61,107,-46
10330,10330,96,2022/4/15 16:40:00,92,111,-19
10331,10331,96,2022/4/15 16:50:00,128,103,25
10332,10332,96,2022/4/15 17:00:00,129,124,5
10333,10333,96,2022/4/15 17:10:00,156,102,54
10334,10334,96,2022/4/15 17:20:00,158,118,40
10335,10335,96,2022/4/15 17:30:00,59,107,-48
10336,10336,96,2022/4/15 17:40:00,86,222,-136
10337,10337,96,2022/4/15 17:50:00,47,118,-71
10338,10338,96,2022/4/15 18:00:00,41,284,-243
10339,10339,96,2022/4/15 18:10:00,39,269,-230
10340,10340,96,2022/4/15 18:20:00,30,217,-187
10341,10341,96,2022/4/15 18:30:00,28,314,-286
10342,10342,96,2022/4/15 18:40:00,27,300,-273
10343,10343,96,2022/4/15 18:50:00,29,333,-304
10344,10344,96,2022/4/15 19:00:00,23,304,-281
10345,10345,96,2022/4/15 19:10:00,23,299,-276
10346,10346,96,2022/4/15 19:20:00,20,149,-129
10347,10347,96,2022/4/15 19:30:00,18,180,-162
10348,10348,96,2022/4/15 19:40:00,19,128,-109
10349,10349,96,2022/4/15 19:50:00,18,106,-88
10350,10350,96,2022/4/15 20:00:00,15,120,-105
10351,10351,96,2022/4/15 20:10:00,16,122,-106
10352,10352,96,2022/4/15 20:20:00,16,92,-76
10353,10353,96,2022/4/15 20:30:00,13,127,-114
10354,10354,96,2022/4/15 20:40:00,18,77,-59
10355,10355,96,2022/4/15 20:50:00,10,106,-96
10356,10356,96,2022/4/15 21:00:00,12,106,-94
10357,10357,96,2022/4/15 21:10:00,9,107,-98
10358,10358,96,2022/4/15 21:20:00,7,106,-99
10359,10359,96,2022/4/15 21:30:00,10,110,-100
10360,10360,96,2022/4/15 21:40:00,8,88,-80
10361,10361,96,2022/4/15 21:50:00,7,92,-85
10362,10362,96,2022/4/15 22:00:00,4,95,-91
10363,10363,96,2022/4/15 22:10:00,7,82,-75
10364,10364,96,2022/4/15 22:20:00,2,83,-81
10365,10365,96,2022/4/15 22:30:00,0,95,-95
10366,10366,96,2022/4/15 22:40:00,0,89,-89
10367,10367,96,2022/4/15 22:50:00,0,95,-95
10368,10368,97,2022/4/15 5:00:00,1,1,0
10369,10369,97,2022/4/15 5:10:00,7,1,6
10370,10370,97,2022/4/15 5:20:00,27,1,26
10371,10371,97,2022/4/15 5:30:00,34,2,32
10372,10372,97,2022/4/15 5:40:00,34,1,33
10373,10373,97,2022/4/15 5:50:00,54,1,53
10374,10374,97,2022/4/15 6:00:00,115,46,69
10375,10375,97,2022/4/15 6:10:00,225,38,187
10376,10376,97,2022/4/15 6:20:00,319,38,281
10377,10377,97,2022/4/15 6:30:00,391,39,352
10378,10378,97,2022/4/15 6:40:00,573,55,518
10379,10379,97,2022/4/15 6:50:00,638,76,562
10380,10380,97,2022/4/15 7:00:00,679,58,621
10381,10381,97,2022/4/15 7:10:00,1060,103,957
10382,10382,97,2022/4/15 7:20:00,1215,101,1114
10383,10383,97,2022/4/15 7:30:00,1581,117,1464
10384,10384,97,2022/4/15 7:40:00,1584,144,1440
10385,10385,97,2022/4/15 7:50:00,1979,117,1862
10386,10386,97,2022/4/15 8:00:00,1596,110,1486
10387,10387,97,2022/4/15 8:10:00,1595,114,1481
10388,10388,97,2022/4/15 8:20:00,1367,115,1252
10389,10389,97,2022/4/15 8:30:00,1060,128,932
10390,10390,97,2022/4/15 8:40:00,679,109,570
10391,10391,97,2022/4/15 8:50:00,600,108,492
10392,10392,97,2022/4/15 9:00:00,464,98,366
10393,10393,97,2022/4/15 9:10:00,289,100,189
10394,10394,97,2022/4/15 9:20:00,244,105,139
10395,10395,97,2022/4/15 9:30:00,220,100,120
10396,10396,97,2022/4/15 9:40:00,156,88,68
10397,10397,97,2022/4/15 9:50:00,148,103,45
10398,10398,97,2022/4/15 10:00:00,112,91,21
10399,10399,97,2022/4/15 10:10:00,73,81,-8
10400,10400,97,2022/4/15 10:20:00,80,83,-3
10401,10401,97,2022/4/15 10:30:00,55,96,-41
10402,10402,97,2022/4/15 10:40:00,60,97,-37
10403,10403,97,2022/4/15 10:50:00,47,65,-18
10404,10404,97,2022/4/15 11:00:00,43,87,-44
10405,10405,97,2022/4/15 11:10:00,52,97,-45
10406,10406,97,2022/4/15 11:20:00,52,97,-45
10407,10407,97,2022/4/15 11:30:00,42,76,-34
10408,10408,97,2022/4/15 11:40:00,59,93,-34
10409,10409,97,2022/4/15 11:50:00,66,73,-7
10410,10410,97,2022/4/15 12:00:00,62,93,-31
10411,10411,97,2022/4/15 12:10:00,68,108,-40
10412,10412,97,2022/4/15 12:20:00,74,111,-37
10413,10413,97,2022/4/15 12:30:00,51,80,-29
10414,10414,97,2022/4/15 12:40:00,69,104,-35
10415,10415,97,2022/4/15 12:50:00,54,71,-17
10416,10416,97,2022/4/15 13:00:00,58,106,-48
10417,10417,97,2022/4/15 13:10:00,54,108,-54
10418,10418,97,2022/4/15 13:20:00,42,103,-61
10419,10419,97,2022/4/15 13:30:00,43,96,-53
10420,10420,97,2022/4/15 13:40:00,44,91,-47
10421,10421,97,2022/4/15 13:50:00,45,102,-57
10422,10422,97,2022/4/15 14:00:00,37,100,-63
10423,10423,97,2022/4/15 14:10:00,38,105,-67
10424,10424,97,2022/4/15 14:20:00,37,109,-72
10425,10425,97,2022/4/15 14:30:00,39,98,-59
10426,10426,97,2022/4/15 14:40:00,35,101,-66
10427,10427,97,2022/4/15 14:50:00,41,98,-57
10428,10428,97,2022/4/15 15:00:00,35,99,-64
10429,10429,97,2022/4/15 15:10:00,35,119,-84
10430,10430,97,2022/4/15 15:20:00,37,119,-82
10431,10431,97,2022/4/15 15:30:00,32,121,-89
10432,10432,97,2022/4/15 15:40:00,46,108,-62
10433,10433,97,2022/4/15 15:50:00,42,123,-81
10434,10434,97,2022/4/15 16:00:00,43,129,-86
10435,10435,97,2022/4/15 16:10:00,47,137,-90
10436,10436,97,2022/4/15 16:20:00,42,111,-69
10437,10437,97,2022/4/15 16:30:00,46,169,-123
10438,10438,97,2022/4/15 16:40:00,45,132,-87
10439,10439,97,2022/4/15 16:50:00,51,128,-77
10440,10440,97,2022/4/15 17:00:00,135,214,-79
10441,10441,97,2022/4/15 17:10:00,202,279,-77
10442,10442,97,2022/4/15 17:20:00,76,230,-154
10443,10443,97,2022/4/15 17:30:00,157,367,-210
10444,10444,97,2022/4/15 17:40:00,130,371,-241
10445,10445,97,2022/4/15 17:50:00,111,484,-373
10446,10446,97,2022/4/15 18:00:00,79,434,-355
10447,10447,97,2022/4/15 18:10:00,132,314,-182
10448,10448,97,2022/4/15 18:20:00,76,595,-519
10449,10449,97,2022/4/15 18:30:00,55,407,-352
10450,10450,97,2022/4/15 18:40:00,46,1099,-1053
10451,10451,97,2022/4/15 18:50:00,43,621,-578
10452,10452,97,2022/4/15 19:00:00,35,492,-457
10453,10453,97,2022/4/15 19:10:00,29,292,-263
10454,10454,97,2022/4/15 19:20:00,28,484,-456
10455,10455,97,2022/4/15 19:30:00,27,223,-196
10456,10456,97,2022/4/15 19:40:00,25,385,-360
10457,10457,97,2022/4/15 19:50:00,28,254,-226
10458,10458,97,2022/4/15 20:00:00,25,128,-103
10459,10459,97,2022/4/15 20:10:00,28,234,-206
10460,10460,97,2022/4/15 20:20:00,26,123,-97
10461,10461,97,2022/4/15 20:30:00,25,179,-154
10462,10462,97,2022/4/15 20:40:00,25,171,-146
10463,10463,97,2022/4/15 20:50:00,23,151,-128
10464,10464,97,2022/4/15 21:00:00,22,128,-106
10465,10465,97,2022/4/15 21:10:00,25,126,-101
10466,10466,97,2022/4/15 21:20:00,24,119,-95
10467,10467,97,2022/4/15 21:30:00,16,128,-112
10468,10468,97,2022/4/15 21:40:00,19,110,-91
10469,10469,97,2022/4/15 21:50:00,14,124,-110
10470,10470,97,2022/4/15 22:00:00,14,136,-122
10471,10471,97,2022/4/15 22:10:00,13,114,-101
10472,10472,97,2022/4/15 22:20:00,12,115,-103
10473,10473,97,2022/4/15 22:30:00,6,120,-114
10474,10474,97,2022/4/15 22:40:00,2,155,-153
10475,10475,97,2022/4/15 22:50:00,1,123,-122
10476,10476,98,2022/4/15 5:00:00,0,1,-1
10477,10477,98,2022/4/15 5:10:00,1,1,0
10478,10478,98,2022/4/15 5:20:00,10,1,9
10479,10479,98,2022/4/15 5:30:00,31,1,30
10480,10480,98,2022/4/15 5:40:00,33,2,31
10481,10481,98,2022/4/15 5:50:00,54,16,38
10482,10482,98,2022/4/15 6:00:00,72,19,53
10483,10483,98,2022/4/15 6:10:00,151,19,132
10484,10484,98,2022/4/15 6:20:00,225,25,200
10485,10485,98,2022/4/15 6:30:00,302,35,267
10486,10486,98,2022/4/15 6:40:00,468,46,422
10487,10487,98,2022/4/15 6:50:00,630,50,580
10488,10488,98,2022/4/15 7:00:00,672,61,611
10489,10489,98,2022/4/15 7:10:00,741,77,664
10490,10490,98,2022/4/15 7:20:00,1172,75,1097
10491,10491,98,2022/4/15 7:30:00,1578,99,1479
10492,10492,98,2022/4/15 7:40:00,1584,100,1484
10493,10493,98,2022/4/15 7:50:00,1584,98,1486
10494,10494,98,2022/4/15 8:00:00,1584,104,1480
10495,10495,98,2022/4/15 8:10:00,1604,133,1471
10496,10496,98,2022/4/15 8:20:00,1369,182,1187
10497,10497,98,2022/4/15 8:30:00,1060,150,910
10498,10498,98,2022/4/15 8:40:00,690,298,392
10499,10499,98,2022/4/15 8:50:00,596,108,488
10500,10500,98,2022/4/15 9:00:00,428,151,277
10501,10501,98,2022/4/15 9:10:00,341,122,219
10502,10502,98,2022/4/15 9:20:00,237,125,112
10503,10503,98,2022/4/15 9:30:00,193,102,91
10504,10504,98,2022/4/15 9:40:00,168,127,41
10505,10505,98,2022/4/15 9:50:00,106,110,-4
10506,10506,98,2022/4/15 10:00:00,84,102,-18
10507,10507,98,2022/4/15 10:10:00,76,99,-23
10508,10508,98,2022/4/15 10:20:00,57,103,-46
10509,10509,98,2022/4/15 10:30:00,54,103,-49
10510,10510,98,2022/4/15 10:40:00,45,77,-32
10511,10511,98,2022/4/15 10:50:00,41,107,-66
10512,10512,98,2022/4/15 11:00:00,46,101,-55
10513,10513,98,2022/4/15 11:10:00,46,101,-55
10514,10514,98,2022/4/15 11:20:00,48,108,-60
10515,10515,98,2022/4/15 11:30:00,47,81,-34
10516,10516,98,2022/4/15 11:40:00,43,105,-62
10517,10517,98,2022/4/15 11:50:00,56,106,-50
10518,10518,98,2022/4/15 12:00:00,61,110,-49
10519,10519,98,2022/4/15 12:10:00,67,101,-34
10520,10520,98,2022/4/15 12:20:00,65,103,-38
10521,10521,98,2022/4/15 12:30:00,63,84,-21
10522,10522,98,2022/4/15 12:40:00,64,107,-43
10523,10523,98,2022/4/15 12:50:00,54,126,-72
10524,10524,98,2022/4/15 13:00:00,68,100,-32
10525,10525,98,2022/4/15 13:10:00,50,111,-61
10526,10526,98,2022/4/15 13:20:00,56,108,-52
10527,10527,98,2022/4/15 13:30:00,45,87,-42
10528,10528,98,2022/4/15 13:40:00,46,107,-61
10529,10529,98,2022/4/15 13:50:00,45,85,-40
10530,10530,98,2022/4/15 14:00:00,47,106,-59
10531,10531,98,2022/4/15 14:10:00,46,106,-60
10532,10532,98,2022/4/15 14:20:00,46,109,-63
10533,10533,98,2022/4/15 14:30:00,44,104,-60
10534,10534,98,2022/4/15 14:40:00,46,107,-61
10535,10535,98,2022/4/15 14:50:00,45,111,-66
10536,10536,98,2022/4/15 15:00:00,47,107,-60
10537,10537,98,2022/4/15 15:10:00,45,122,-77
10538,10538,98,2022/4/15 15:20:00,48,103,-55
10539,10539,98,2022/4/15 15:30:00,44,109,-65
10540,10540,98,2022/4/15 15:40:00,47,108,-61
10541,10541,98,2022/4/15 15:50:00,47,115,-68
10542,10542,98,2022/4/15 16:00:00,43,133,-90
10543,10543,98,2022/4/15 16:10:00,53,116,-63
10544,10544,98,2022/4/15 16:20:00,59,111,-52
10545,10545,98,2022/4/15 16:30:00,64,104,-40
10546,10546,98,2022/4/15 16:40:00,63,159,-96
10547,10547,98,2022/4/15 16:50:00,70,233,-163
10548,10548,98,2022/4/15 17:00:00,114,150,-36
10549,10549,98,2022/4/15 17:10:00,154,316,-162
10550,10550,98,2022/4/15 17:20:00,84,317,-233
10551,10551,98,2022/4/15 17:30:00,97,317,-220
10552,10552,98,2022/4/15 17:40:00,204,478,-274
10553,10553,98,2022/4/15 17:50:00,132,486,-354
10554,10554,98,2022/4/15 18:00:00,148,412,-264
10555,10555,98,2022/4/15 18:10:00,213,574,-361
10556,10556,98,2022/4/15 18:20:00,176,462,-286
10557,10557,98,2022/4/15 18:30:00,116,565,-449
10558,10558,98,2022/4/15 18:40:00,89,1110,-1021
10559,10559,98,2022/4/15 18:50:00,64,563,-499
10560,10560,98,2022/4/15 19:00:00,58,486,-428
10561,10561,98,2022/4/15 19:10:00,60,491,-431
10562,10562,98,2022/4/15 19:20:00,44,328,-284
10563,10563,98,2022/4/15 19:30:00,43,383,-340
10564,10564,98,2022/4/15 19:40:00,43,196,-153
10565,10565,98,2022/4/15 19:50:00,36,114,-78
10566,10566,98,2022/4/15 20:00:00,44,179,-135
10567,10567,98,2022/4/15 20:10:00,45,115,-70
10568,10568,98,2022/4/15 20:20:00,38,159,-121
10569,10569,98,2022/4/15 20:30:00,44,122,-78
10570,10570,98,2022/4/15 20:40:00,41,104,-63
10571,10571,98,2022/4/15 20:50:00,43,125,-82
10572,10572,98,2022/4/15 21:00:00,56,109,-53
10573,10573,98,2022/4/15 21:10:00,48,112,-64
10574,10574,98,2022/4/15 21:20:00,37,95,-58
10575,10575,98,2022/4/15 21:30:00,40,126,-86
10576,10576,98,2022/4/15 21:40:00,37,117,-80
10577,10577,98,2022/4/15 21:50:00,31,104,-73
10578,10578,98,2022/4/15 22:00:00,31,116,-85
10579,10579,98,2022/4/15 22:10:00,26,66,-40
10580,10580,98,2022/4/15 22:20:00,23,109,-86
10581,10581,98,2022/4/15 22:30:00,19,107,-88
10582,10582,98,2022/4/15 22:40:00,12,108,-96
10583,10583,98,2022/4/15 22:50:00,8,122,-114
10584,10584,99,2022/4/15 5:00:00,0,1,-1
10585,10585,99,2022/4/15 5:10:00,1,1,0
10586,10586,99,2022/4/15 5:20:00,5,1,4
10587,10587,99,2022/4/15 5:30:00,6,2,4
10588,10588,99,2022/4/15 5:40:00,13,5,8
10589,10589,99,2022/4/15 5:50:00,16,12,4
10590,10590,99,2022/4/15 6:00:00,14,31,-17
10591,10591,99,2022/4/15 6:10:00,20,33,-13
10592,10592,99,2022/4/15 6:20:00,28,41,-13
10593,10593,99,2022/4/15 6:30:00,35,51,-16
10594,10594,99,2022/4/15 6:40:00,37,69,-32
10595,10595,99,2022/4/15 6:50:00,45,70,-25
10596,10596,99,2022/4/15 7:00:00,54,76,-22
10597,10597,99,2022/4/15 7:10:00,56,111,-55
10598,10598,99,2022/4/15 7:20:00,55,107,-52
10599,10599,99,2022/4/15 7:30:00,76,110,-34
10600,10600,99,2022/4/15 7:40:00,97,182,-85
10601,10601,99,2022/4/15 7:50:00,149,282,-133
10602,10602,99,2022/4/15 8:00:00,184,505,-321
10603,10603,99,2022/4/15 8:10:00,189,567,-378
10604,10604,99,2022/4/15 8:20:00,217,1091,-874
10605,10605,99,2022/4/15 8:30:00,221,1478,-1257
10606,10606,99,2022/4/15 8:40:00,238,2339,-2101
10607,10607,99,2022/4/15 8:50:00,238,2280,-2042
10608,10608,99,2022/4/15 9:00:00,207,1797,-1590
10609,10609,99,2022/4/15 9:10:00,192,1095,-903
10610,10610,99,2022/4/15 9:20:00,150,407,-257
10611,10611,99,2022/4/15 9:30:00,137,511,-374
10612,10612,99,2022/4/15 9:40:00,144,333,-189
10613,10613,99,2022/4/15 9:50:00,82,204,-122
10614,10614,99,2022/4/15 10:00:00,74,192,-118
10615,10615,99,2022/4/15 10:10:00,75,142,-67
10616,10616,99,2022/4/15 10:20:00,73,109,-36
10617,10617,99,2022/4/15 10:30:00,74,121,-47
10618,10618,99,2022/4/15 10:40:00,72,86,-14
10619,10619,99,2022/4/15 10:50:00,73,116,-43
10620,10620,99,2022/4/15 11:00:00,74,105,-31
10621,10621,99,2022/4/15 11:10:00,70,105,-35
10622,10622,99,2022/4/15 11:20:00,70,104,-34
10623,10623,99,2022/4/15 11:30:00,77,105,-28
10624,10624,99,2022/4/15 11:40:00,71,98,-27
10625,10625,99,2022/4/15 11:50:00,64,90,-26
10626,10626,99,2022/4/15 12:00:00,65,110,-45
10627,10627,99,2022/4/15 12:10:00,72,106,-34
10628,10628,99,2022/4/15 12:20:00,76,105,-29
10629,10629,99,2022/4/15 12:30:00,64,110,-46
10630,10630,99,2022/4/15 12:40:00,58,104,-46
10631,10631,99,2022/4/15 12:50:00,64,119,-55
10632,10632,99,2022/4/15 13:00:00,62,108,-46
10633,10633,99,2022/4/15 13:10:00,77,108,-31
10634,10634,99,2022/4/15 13:20:00,76,102,-26
10635,10635,99,2022/4/15 13:30:00,77,122,-45
10636,10636,99,2022/4/15 13:40:00,86,123,-37
10637,10637,99,2022/4/15 13:50:00,76,100,-24
10638,10638,99,2022/4/15 14:00:00,82,110,-28
10639,10639,99,2022/4/15 14:10:00,81,101,-20
10640,10640,99,2022/4/15 14:20:00,77,105,-28
10641,10641,99,2022/4/15 14:30:00,83,112,-29
10642,10642,99,2022/4/15 14:40:00,80,112,-32
10643,10643,99,2022/4/15 14:50:00,81,103,-22
10644,10644,99,2022/4/15 15:00:00,102,105,-3
10645,10645,99,2022/4/15 15:10:00,126,108,18
10646,10646,99,2022/4/15 15:20:00,92,109,-17
10647,10647,99,2022/4/15 15:30:00,79,99,-20
10648,10648,99,2022/4/15 15:40:00,134,111,23
10649,10649,99,2022/4/15 15:50:00,157,110,47
10650,10650,99,2022/4/15 16:00:00,173,112,61
10651,10651,99,2022/4/15 16:10:00,172,99,73
10652,10652,99,2022/4/15 16:20:00,145,106,39
10653,10653,99,2022/4/15 16:30:00,205,111,94
10654,10654,99,2022/4/15 16:40:00,216,109,107
10655,10655,99,2022/4/15 16:50:00,265,105,160
10656,10656,99,2022/4/15 17:00:00,651,105,546
10657,10657,99,2022/4/15 17:10:00,712,101,611
10658,10658,99,2022/4/15 17:20:00,574,125,449
10659,10659,99,2022/4/15 17:30:00,828,126,702
10660,10660,99,2022/4/15 17:40:00,1358,115,1243
10661,10661,99,2022/4/15 17:50:00,824,121,703
10662,10662,99,2022/4/15 18:00:00,1038,110,928
10663,10663,99,2022/4/15 18:10:00,1361,119,1242
10664,10664,99,2022/4/15 18:20:00,819,104,715
10665,10665,99,2022/4/15 18:30:00,607,124,483
10666,10666,99,2022/4/15 18:40:00,461,112,349
10667,10667,99,2022/4/15 18:50:00,270,114,156
10668,10668,99,2022/4/15 19:00:00,240,120,120
10669,10669,99,2022/4/15 19:10:00,222,110,112
10670,10670,99,2022/4/15 19:20:00,161,102,59
10671,10671,99,2022/4/15 19:30:00,131,89,42
10672,10672,99,2022/4/15 19:40:00,88,84,4
10673,10673,99,2022/4/15 19:50:00,70,83,-13
10674,10674,99,2022/4/15 20:00:00,77,76,1
10675,10675,99,2022/4/15 20:10:00,68,76,-8
10676,10676,99,2022/4/15 20:20:00,55,62,-7
10677,10677,99,2022/4/15 20:30:00,49,69,-20
10678,10678,99,2022/4/15 20:40:00,49,82,-33
10679,10679,99,2022/4/15 20:50:00,44,72,-28
10680,10680,99,2022/4/15 21:00:00,42,76,-34
10681,10681,99,2022/4/15 21:10:00,42,83,-41
10682,10682,99,2022/4/15 21:20:00,42,64,-22
10683,10683,99,2022/4/15 21:30:00,30,80,-50
10684,10684,99,2022/4/15 21:40:00,33,70,-37
10685,10685,99,2022/4/15 21:50:00,35,80,-45
10686,10686,99,2022/4/15 22:00:00,29,70,-41
10687,10687,99,2022/4/15 22:10:00,29,80,-51
10688,10688,99,2022/4/15 22:20:00,24,76,-52
10689,10689,99,2022/4/15 22:30:00,18,66,-48
10690,10690,99,2022/4/15 22:40:00,17,55,-38
10691,10691,99,2022/4/15 22:50:00,12,38,-26
10692,10692,100,2022/4/15 5:00:00,0,1,-1
10693,10693,100,2022/4/15 5:10:00,2,1,1
10694,10694,100,2022/4/15 5:20:00,3,1,2
10695,10695,100,2022/4/15 5:30:00,5,1,4
10696,10696,100,2022/4/15 5:40:00,9,5,4
10697,10697,100,2022/4/15 5:50:00,6,6,0
10698,10698,100,2022/4/15 6:00:00,6,21,-15
10699,10699,100,2022/4/15 6:10:00,10,32,-22
10700,10700,100,2022/4/15 6:20:00,19,46,-27
10701,10701,100,2022/4/15 6:30:00,23,50,-27
10702,10702,100,2022/4/15 6:40:00,30,71,-41
10703,10703,100,2022/4/15 6:50:00,33,106,-73
10704,10704,100,2022/4/15 7:00:00,37,109,-72
10705,10705,100,2022/4/15 7:10:00,46,139,-93
10706,10706,100,2022/4/15 7:20:00,38,117,-79
10707,10707,100,2022/4/15 7:30:00,42,154,-112
10708,10708,100,2022/4/15 7:40:00,41,227,-186
10709,10709,100,2022/4/15 7:50:00,59,208,-149
10710,10710,100,2022/4/15 8:00:00,64,208,-144
10711,10711,100,2022/4/15 8:10:00,63,226,-163
10712,10712,100,2022/4/15 8:20:00,57,192,-135
10713,10713,100,2022/4/15 8:30:00,60,218,-158
10714,10714,100,2022/4/15 8:40:00,58,284,-226
10715,10715,100,2022/4/15 8:50:00,54,198,-144
10716,10716,100,2022/4/15 9:00:00,41,144,-103
10717,10717,100,2022/4/15 9:10:00,40,117,-77
10718,10718,100,2022/4/15 9:20:00,33,121,-88
10719,10719,100,2022/4/15 9:30:00,30,124,-94
10720,10720,100,2022/4/15 9:40:00,28,102,-74
10721,10721,100,2022/4/15 9:50:00,29,105,-76
10722,10722,100,2022/4/15 10:00:00,26,96,-70
10723,10723,100,2022/4/15 10:10:00,28,76,-48
10724,10724,100,2022/4/15 10:20:00,28,76,-48
10725,10725,100,2022/4/15 10:30:00,29,73,-44
10726,10726,100,2022/4/15 10:40:00,28,83,-55
10727,10727,100,2022/4/15 10:50:00,29,64,-35
10728,10728,100,2022/4/15 11:00:00,27,70,-43
10729,10729,100,2022/4/15 11:10:00,28,66,-38
10730,10730,100,2022/4/15 11:20:00,28,75,-47
10731,10731,100,2022/4/15 11:30:00,29,72,-43
10732,10732,100,2022/4/15 11:40:00,27,70,-43
10733,10733,100,2022/4/15 11:50:00,28,63,-35
10734,10734,100,2022/4/15 12:00:00,29,71,-42
10735,10735,100,2022/4/15 12:10:00,27,66,-39
10736,10736,100,2022/4/15 12:20:00,27,71,-44
10737,10737,100,2022/4/15 12:30:00,25,68,-43
10738,10738,100,2022/4/15 12:40:00,28,76,-48
10739,10739,100,2022/4/15 12:50:00,28,77,-49
10740,10740,100,2022/4/15 13:00:00,28,75,-47
10741,10741,100,2022/4/15 13:10:00,30,76,-46
10742,10742,100,2022/4/15 13:20:00,30,89,-59
10743,10743,100,2022/4/15 13:30:00,30,93,-63
10744,10744,100,2022/4/15 13:40:00,29,77,-48
10745,10745,100,2022/4/15 13:50:00,32,77,-45
10746,10746,100,2022/4/15 14:00:00,24,85,-61
10747,10747,100,2022/4/15 14:10:00,31,81,-50
10748,10748,100,2022/4/15 14:20:00,27,81,-54
10749,10749,100,2022/4/15 14:30:00,30,71,-41
10750,10750,100,2022/4/15 14:40:00,32,77,-45
10751,10751,100,2022/4/15 14:50:00,33,72,-39
10752,10752,100,2022/4/15 15:00:00,41,69,-28
10753,10753,100,2022/4/15 15:10:00,40,83,-43
10754,10754,100,2022/4/15 15:20:00,42,75,-33
10755,10755,100,2022/4/15 15:30:00,43,82,-39
10756,10756,100,2022/4/15 15:40:00,38,73,-35
10757,10757,100,2022/4/15 15:50:00,42,85,-43
10758,10758,100,2022/4/15 16:00:00,59,69,-10
10759,10759,100,2022/4/15 16:10:00,59,69,-10
10760,10760,100,2022/4/15 16:20:00,57,74,-17
10761,10761,100,2022/4/15 16:30:00,129,69,60
10762,10762,100,2022/4/15 16:40:00,195,85,110
10763,10763,100,2022/4/15 16:50:00,162,76,86
10764,10764,100,2022/4/15 17:00:00,201,77,124
10765,10765,100,2022/4/15 17:10:00,293,75,218
10766,10766,100,2022/4/15 17:20:00,271,97,174
10767,10767,100,2022/4/15 17:30:00,264,102,162
10768,10768,100,2022/4/15 17:40:00,274,105,169
10769,10769,100,2022/4/15 17:50:00,177,106,71
10770,10770,100,2022/4/15 18:00:00,173,89,84
10771,10771,100,2022/4/15 18:10:00,224,108,116
10772,10772,100,2022/4/15 18:20:00,174,106,68
10773,10773,100,2022/4/15 18:30:00,99,104,-5
10774,10774,100,2022/4/15 18:40:00,75,104,-29
10775,10775,100,2022/4/15 18:50:00,55,105,-50
10776,10776,100,2022/4/15 19:00:00,44,105,-61
10777,10777,100,2022/4/15 19:10:00,47,89,-42
10778,10778,100,2022/4/15 19:20:00,39,80,-41
10779,10779,100,2022/4/15 19:30:00,35,73,-38
10780,10780,100,2022/4/15 19:40:00,32,80,-48
10781,10781,100,2022/4/15 19:50:00,29,68,-39
10782,10782,100,2022/4/15 20:00:00,38,61,-23
10783,10783,100,2022/4/15 20:10:00,36,62,-26
10784,10784,100,2022/4/15 20:20:00,42,59,-17
10785,10785,100,2022/4/15 20:30:00,30,62,-32
10786,10786,100,2022/4/15 20:40:00,36,64,-28
10787,10787,100,2022/4/15 20:50:00,32,56,-24
10788,10788,100,2022/4/15 21:00:00,28,57,-29
10789,10789,100,2022/4/15 21:10:00,29,62,-33
10790,10790,100,2022/4/15 21:20:00,33,53,-20
10791,10791,100,2022/4/15 21:30:00,26,66,-40
10792,10792,100,2022/4/15 21:40:00,23,62,-39
10793,10793,100,2022/4/15 21:50:00,27,56,-29
10794,10794,100,2022/4/15 22:00:00,26,52,-26
10795,10795,100,2022/4/15 22:10:00,25,55,-30
10796,10796,100,2022/4/15 22:20:00,22,50,-28
10797,10797,100,2022/4/15 22:30:00,22,45,-23
10798,10798,100,2022/4/15 22:40:00,14,38,-24
10799,10799,100,2022/4/15 22:50:00,4,25,-21
10800,10800,101,2022/4/15 5:00:00,0,1,-1
10801,10801,101,2022/4/15 5:10:00,1,1,0
10802,10802,101,2022/4/15 5:20:00,12,1,11
10803,10803,101,2022/4/15 5:30:00,25,1,24
10804,10804,101,2022/4/15 5:40:00,30,1,29
10805,10805,101,2022/4/15 5:50:00,36,1,35
10806,10806,101,2022/4/15 6:00:00,45,13,32
10807,10807,101,2022/4/15 6:10:00,61,11,50
10808,10808,101,2022/4/15 6:20:00,87,21,66
10809,10809,101,2022/4/15 6:30:00,108,42,66
10810,10810,101,2022/4/15 6:40:00,128,47,81
10811,10811,101,2022/4/15 6:50:00,215,66,149
10812,10812,101,2022/4/15 7:00:00,245,85,160
10813,10813,101,2022/4/15 7:10:00,304,71,233
10814,10814,101,2022/4/15 7:20:00,393,123,270
10815,10815,101,2022/4/15 7:30:00,630,109,521
10816,10816,101,2022/4/15 7:40:00,718,146,572
10817,10817,101,2022/4/15 7:50:00,687,108,579
10818,10818,101,2022/4/15 8:00:00,713,106,607
10819,10819,101,2022/4/15 8:10:00,630,108,522
10820,10820,101,2022/4/15 8:20:00,447,115,332
10821,10821,101,2022/4/15 8:30:00,317,119,198
10822,10822,101,2022/4/15 8:40:00,235,152,83
10823,10823,101,2022/4/15 8:50:00,188,108,80
10824,10824,101,2022/4/15 9:00:00,83,114,-31
10825,10825,101,2022/4/15 9:10:00,72,100,-28
10826,10826,101,2022/4/15 9:20:00,57,83,-26
10827,10827,101,2022/4/15 9:30:00,45,77,-32
10828,10828,101,2022/4/15 9:40:00,35,59,-24
10829,10829,101,2022/4/15 9:50:00,36,72,-36
10830,10830,101,2022/4/15 10:00:00,34,61,-27
10831,10831,101,2022/4/15 10:10:00,31,59,-28
10832,10832,101,2022/4/15 10:20:00,27,64,-37
10833,10833,101,2022/4/15 10:30:00,28,51,-23
10834,10834,101,2022/4/15 10:40:00,29,61,-32
10835,10835,101,2022/4/15 10:50:00,29,55,-26
10836,10836,101,2022/4/15 11:00:00,29,51,-22
10837,10837,101,2022/4/15 11:10:00,27,36,-9
10838,10838,101,2022/4/15 11:20:00,27,64,-37
10839,10839,101,2022/4/15 11:30:00,23,65,-42
10840,10840,101,2022/4/15 11:40:00,23,62,-39
10841,10841,101,2022/4/15 11:50:00,26,48,-22
10842,10842,101,2022/4/15 12:00:00,31,47,-16
10843,10843,101,2022/4/15 12:10:00,29,44,-15
10844,10844,101,2022/4/15 12:20:00,30,61,-31
10845,10845,101,2022/4/15 12:30:00,23,63,-40
10846,10846,101,2022/4/15 12:40:00,23,55,-32
10847,10847,101,2022/4/15 12:50:00,23,57,-34
10848,10848,101,2022/4/15 13:00:00,26,50,-24
10849,10849,101,2022/4/15 13:10:00,29,54,-25
10850,10850,101,2022/4/15 13:20:00,24,62,-38
10851,10851,101,2022/4/15 13:30:00,23,60,-37
10852,10852,101,2022/4/15 13:40:00,24,59,-35
10853,10853,101,2022/4/15 13:50:00,22,62,-40
10854,10854,101,2022/4/15 14:00:00,29,49,-20
10855,10855,101,2022/4/15 14:10:00,26,60,-34
10856,10856,101,2022/4/15 14:20:00,24,67,-43
10857,10857,101,2022/4/15 14:30:00,24,67,-43
10858,10858,101,2022/4/15 14:40:00,27,61,-34
10859,10859,101,2022/4/15 14:50:00,25,64,-39
10860,10860,101,2022/4/15 15:00:00,26,56,-30
10861,10861,101,2022/4/15 15:10:00,24,68,-44
10862,10862,101,2022/4/15 15:20:00,27,82,-55
10863,10863,101,2022/4/15 15:30:00,34,75,-41
10864,10864,101,2022/4/15 15:40:00,39,81,-42
10865,10865,101,2022/4/15 15:50:00,31,83,-52
10866,10866,101,2022/4/15 16:00:00,38,69,-31
10867,10867,101,2022/4/15 16:10:00,38,74,-36
10868,10868,101,2022/4/15 16:20:00,36,77,-41
10869,10869,101,2022/4/15 16:30:00,41,97,-56
10870,10870,101,2022/4/15 16:40:00,58,91,-33
10871,10871,101,2022/4/15 16:50:00,42,96,-54
10872,10872,101,2022/4/15 17:00:00,38,85,-47
10873,10873,101,2022/4/15 17:10:00,40,106,-66
10874,10874,101,2022/4/15 17:20:00,38,105,-67
10875,10875,101,2022/4/15 17:30:00,57,110,-53
10876,10876,101,2022/4/15 17:40:00,139,97,42
10877,10877,101,2022/4/15 17:50:00,60,225,-165
10878,10878,101,2022/4/15 18:00:00,75,152,-77
10879,10879,101,2022/4/15 18:10:00,86,127,-41
10880,10880,101,2022/4/15 18:20:00,52,198,-146
10881,10881,101,2022/4/15 18:30:00,43,143,-100
10882,10882,101,2022/4/15 18:40:00,29,209,-180
10883,10883,101,2022/4/15 18:50:00,28,174,-146
10884,10884,101,2022/4/15 19:00:00,28,213,-185
10885,10885,101,2022/4/15 19:10:00,30,105,-75
10886,10886,101,2022/4/15 19:20:00,27,137,-110
10887,10887,101,2022/4/15 19:30:00,28,127,-99
10888,10888,101,2022/4/15 19:40:00,23,95,-72
10889,10889,101,2022/4/15 19:50:00,19,102,-83
10890,10890,101,2022/4/15 20:00:00,17,106,-89
10891,10891,101,2022/4/15 20:10:00,22,66,-44
10892,10892,101,2022/4/15 20:20:00,17,110,-93
10893,10893,101,2022/4/15 20:30:00,15,73,-58
10894,10894,101,2022/4/15 20:40:00,16,85,-69
10895,10895,101,2022/4/15 20:50:00,16,78,-62
10896,10896,101,2022/4/15 21:00:00,17,89,-72
10897,10897,101,2022/4/15 21:10:00,22,76,-54
10898,10898,101,2022/4/15 21:20:00,12,80,-68
10899,10899,101,2022/4/15 21:30:00,12,83,-71
10900,10900,101,2022/4/15 21:40:00,10,72,-62
10901,10901,101,2022/4/15 21:50:00,9,85,-76
10902,10902,101,2022/4/15 22:00:00,9,78,-69
10903,10903,101,2022/4/15 22:10:00,8,76,-68
10904,10904,101,2022/4/15 22:20:00,5,80,-75
10905,10905,101,2022/4/15 22:30:00,4,80,-76
10906,10906,101,2022/4/15 22:40:00,2,84,-82
10907,10907,101,2022/4/15 22:50:00,1,78,-77
10908,10908,102,2022/4/15 5:00:00,3,1,2
10909,10909,102,2022/4/15 5:10:00,7,5,2
10910,10910,102,2022/4/15 5:20:00,12,11,1
10911,10911,102,2022/4/15 5:30:00,15,8,7
10912,10912,102,2022/4/15 5:40:00,12,8,4
10913,10913,102,2022/4/15 5:50:00,16,25,-9
10914,10914,102,2022/4/15 6:00:00,21,69,-48
10915,10915,102,2022/4/15 6:10:00,23,66,-43
10916,10916,102,2022/4/15 6:20:00,34,63,-29
10917,10917,102,2022/4/15 6:30:00,32,97,-65
10918,10918,102,2022/4/15 6:40:00,38,101,-63
10919,10919,102,2022/4/15 6:50:00,41,117,-76
10920,10920,102,2022/4/15 7:00:00,47,106,-59
10921,10921,102,2022/4/15 7:10:00,53,142,-89
10922,10922,102,2022/4/15 7:20:00,58,230,-172
10923,10923,102,2022/4/15 7:30:00,60,325,-265
10924,10924,102,2022/4/15 7:40:00,83,507,-424
10925,10925,102,2022/4/15 7:50:00,76,417,-341
10926,10926,102,2022/4/15 8:00:00,99,878,-779
10927,10927,102,2022/4/15 8:10:00,150,2212,-2062
10928,10928,102,2022/4/15 8:20:00,167,2866,-2699
10929,10929,102,2022/4/15 8:30:00,150,2532,-2382
10930,10930,102,2022/4/15 8:40:00,128,4979,-4851
10931,10931,102,2022/4/15 8:50:00,128,5856,-5728
10932,10932,102,2022/4/15 9:00:00,108,5302,-5194
10933,10933,102,2022/4/15 9:10:00,139,2931,-2792
10934,10934,102,2022/4/15 9:20:00,88,3128,-3040
10935,10935,102,2022/4/15 9:30:00,79,1701,-1622
10936,10936,102,2022/4/15 9:40:00,92,1707,-1615
10937,10937,102,2022/4/15 9:50:00,71,719,-648
10938,10938,102,2022/4/15 10:00:00,74,430,-356
10939,10939,102,2022/4/15 10:10:00,75,374,-299
10940,10940,102,2022/4/15 10:20:00,79,332,-253
10941,10941,102,2022/4/15 10:30:00,73,298,-225
10942,10942,102,2022/4/15 10:40:00,109,281,-172
10943,10943,102,2022/4/15 10:50:00,82,177,-95
10944,10944,102,2022/4/15 11:00:00,128,227,-99
10945,10945,102,2022/4/15 11:10:00,89,139,-50
10946,10946,102,2022/4/15 11:20:00,113,153,-40
10947,10947,102,2022/4/15 11:30:00,136,170,-34
10948,10948,102,2022/4/15 11:40:00,141,192,-51
10949,10949,102,2022/4/15 11:50:00,137,146,-9
10950,10950,102,2022/4/15 12:00:00,137,146,-9
10951,10951,102,2022/4/15 12:10:00,162,117,45
10952,10952,102,2022/4/15 12:20:00,147,184,-37
10953,10953,102,2022/4/15 12:30:00,131,181,-50
10954,10954,102,2022/4/15 12:40:00,138,146,-8
10955,10955,102,2022/4/15 12:50:00,141,214,-73
10956,10956,102,2022/4/15 13:00:00,156,179,-23
10957,10957,102,2022/4/15 13:10:00,156,185,-29
10958,10958,102,2022/4/15 13:20:00,179,226,-47
10959,10959,102,2022/4/15 13:30:00,188,198,-10
10960,10960,102,2022/4/15 13:40:00,179,214,-35
10961,10961,102,2022/4/15 13:50:00,197,181,16
10962,10962,102,2022/4/15 14:00:00,206,184,22
10963,10963,102,2022/4/15 14:10:00,207,152,55
10964,10964,102,2022/4/15 14:20:00,205,152,53
10965,10965,102,2022/4/15 14:30:00,207,123,84
10966,10966,102,2022/4/15 14:40:00,191,110,81
10967,10967,102,2022/4/15 14:50:00,197,128,69
10968,10968,102,2022/4/15 15:00:00,208,133,75
10969,10969,102,2022/4/15 15:10:00,220,110,110
10970,10970,102,2022/4/15 15:20:00,238,105,133
10971,10971,102,2022/4/15 15:30:00,242,129,113
10972,10972,102,2022/4/15 15:40:00,269,125,144
10973,10973,102,2022/4/15 15:50:00,258,109,149
10974,10974,102,2022/4/15 16:00:00,267,108,159
10975,10975,102,2022/4/15 16:10:00,333,110,223
10976,10976,102,2022/4/15 16:20:00,311,108,203
10977,10977,102,2022/4/15 16:30:00,345,128,217
10978,10978,102,2022/4/15 16:40:00,428,105,323
10979,10979,102,2022/4/15 16:50:00,454,109,345
10980,10980,102,2022/4/15 17:00:00,712,115,597
10981,10981,102,2022/4/15 17:10:00,1140,152,988
10982,10982,102,2022/4/15 17:20:00,803,180,623
10983,10983,102,2022/4/15 17:30:00,1196,197,999
10984,10984,102,2022/4/15 17:40:00,1978,225,1753
10985,10985,102,2022/4/15 17:50:00,1352,217,1135
10986,10986,102,2022/4/15 18:00:00,1972,231,1741
10987,10987,102,2022/4/15 18:10:00,3023,219,2804
10988,10988,102,2022/4/15 18:20:00,1987,235,1752
10989,10989,102,2022/4/15 18:30:00,1359,256,1103
10990,10990,102,2022/4/15 18:40:00,1197,234,963
10991,10991,102,2022/4/15 18:50:00,1036,179,857
10992,10992,102,2022/4/15 19:00:00,803,181,622
10993,10993,102,2022/4/15 19:10:00,625,127,498
10994,10994,102,2022/4/15 19:20:00,566,125,441
10995,10995,102,2022/4/15 19:30:00,429,124,305
10996,10996,102,2022/4/15 19:40:00,310,104,206
10997,10997,102,2022/4/15 19:50:00,333,107,226
10998,10998,102,2022/4/15 20:00:00,327,96,231
10999,10999,102,2022/4/15 20:10:00,358,89,269
11000,11000,102,2022/4/15 20:20:00,316,95,221
11001,11001,102,2022/4/15 20:30:00,309,77,232
11002,11002,102,2022/4/15 20:40:00,331,77,254
11003,11003,102,2022/4/15 20:50:00,272,78,194
11004,11004,102,2022/4/15 21:00:00,319,75,244
11005,11005,102,2022/4/15 21:10:00,339,75,264
11006,11006,102,2022/4/15 21:20:00,317,80,237
11007,11007,102,2022/4/15 21:30:00,267,77,190
11008,11008,102,2022/4/15 21:40:00,267,72,195
11009,11009,102,2022/4/15 21:50:00,249,78,171
11010,11010,102,2022/4/15 22:00:00,595,74,521
11011,11011,102,2022/4/15 22:10:00,265,75,190
11012,11012,102,2022/4/15 22:20:00,131,83,48
11013,11013,102,2022/4/15 22:30:00,65,73,-8
11014,11014,102,2022/4/15 22:40:00,41,68,-27
11015,11015,102,2022/4/15 22:50:00,23,55,-32
11016,11016,103,2022/4/15 5:00:00,0,1,-1
11017,11017,103,2022/4/15 5:10:00,2,1,1
11018,11018,103,2022/4/15 5:20:00,16,1,15
11019,11019,103,2022/4/15 5:30:00,24,1,23
11020,11020,103,2022/4/15 5:40:00,30,2,28
11021,11021,103,2022/4/15 5:50:00,33,43,-10
11022,11022,103,2022/4/15 6:00:00,53,23,30
11023,11023,103,2022/4/15 6:10:00,67,23,44
11024,11024,103,2022/4/15 6:20:00,91,65,26
11025,11025,103,2022/4/15 6:30:00,227,70,157
11026,11026,103,2022/4/15 6:40:00,280,104,176
11027,11027,103,2022/4/15 6:50:00,389,105,284
11028,11028,103,2022/4/15 7:00:00,475,100,375
11029,11029,103,2022/4/15 7:10:00,686,110,576
11030,11030,103,2022/4/15 7:20:00,738,152,586
11031,11031,103,2022/4/15 7:30:00,1180,234,946
11032,11032,103,2022/4/15 7:40:00,1370,223,1147
11033,11033,103,2022/4/15 7:50:00,1370,192,1178
11034,11034,103,2022/4/15 8:00:00,1576,197,1379
11035,11035,103,2022/4/15 8:10:00,1214,233,981
11036,11036,103,2022/4/15 8:20:00,1175,213,962
11037,11037,103,2022/4/15 8:30:00,870,198,672
11038,11038,103,2022/4/15 8:40:00,844,180,664
11039,11039,103,2022/4/15 8:50:00,684,146,538
11040,11040,103,2022/4/15 9:00:00,615,150,465
11041,11041,103,2022/4/15 9:10:00,367,120,247
11042,11042,103,2022/4/15 9:20:00,311,121,190
11043,11043,103,2022/4/15 9:30:00,245,107,138
11044,11044,103,2022/4/15 9:40:00,216,106,110
11045,11045,103,2022/4/15 9:50:00,188,114,74
11046,11046,103,2022/4/15 10:00:00,132,101,31
11047,11047,103,2022/4/15 10:10:00,96,106,-10
11048,11048,103,2022/4/15 10:20:00,86,105,-19
11049,11049,103,2022/4/15 10:30:00,66,91,-25
11050,11050,103,2022/4/15 10:40:00,58,105,-47
11051,11051,103,2022/4/15 10:50:00,59,97,-38
11052,11052,103,2022/4/15 11:00:00,43,117,-74
11053,11053,103,2022/4/15 11:10:00,53,92,-39
11054,11054,103,2022/4/15 11:20:00,56,109,-53
11055,11055,103,2022/4/15 11:30:00,51,109,-58
11056,11056,103,2022/4/15 11:40:00,46,104,-58
11057,11057,103,2022/4/15 11:50:00,44,104,-60
11058,11058,103,2022/4/15 12:00:00,69,105,-36
11059,11059,103,2022/4/15 12:10:00,67,103,-36
11060,11060,103,2022/4/15 12:20:00,78,108,-30
11061,11061,103,2022/4/15 12:30:00,75,102,-27
11062,11062,103,2022/4/15 12:40:00,70,99,-29
11063,11063,103,2022/4/15 12:50:00,71,112,-41
11064,11064,103,2022/4/15 13:00:00,66,110,-44
11065,11065,103,2022/4/15 13:10:00,76,86,-10
11066,11066,103,2022/4/15 13:20:00,60,117,-57
11067,11067,103,2022/4/15 13:30:00,59,104,-45
11068,11068,103,2022/4/15 13:40:00,44,102,-58
11069,11069,103,2022/4/15 13:50:00,55,126,-71
11070,11070,103,2022/4/15 14:00:00,45,108,-63
11071,11071,103,2022/4/15 14:10:00,53,104,-51
11072,11072,103,2022/4/15 14:20:00,45,117,-72
11073,11073,103,2022/4/15 14:30:00,53,119,-66
11074,11074,103,2022/4/15 14:40:00,48,106,-58
11075,11075,103,2022/4/15 14:50:00,52,110,-58
11076,11076,103,2022/4/15 15:00:00,46,121,-75
11077,11077,103,2022/4/15 15:10:00,45,109,-64
11078,11078,103,2022/4/15 15:20:00,53,117,-64
11079,11079,103,2022/4/15 15:30:00,45,126,-81
11080,11080,103,2022/4/15 15:40:00,56,142,-86
11081,11081,103,2022/4/15 15:50:00,58,150,-92
11082,11082,103,2022/4/15 16:00:00,65,117,-52
11083,11083,103,2022/4/15 16:10:00,73,179,-106
11084,11084,103,2022/4/15 16:20:00,86,185,-99
11085,11085,103,2022/4/15 16:30:00,129,198,-69
11086,11086,103,2022/4/15 16:40:00,134,234,-100
11087,11087,103,2022/4/15 16:50:00,136,208,-72
11088,11088,103,2022/4/15 17:00:00,208,316,-108
11089,11089,103,2022/4/15 17:10:00,265,320,-55
11090,11090,103,2022/4/15 17:20:00,223,432,-209
11091,11091,103,2022/4/15 17:30:00,256,432,-176
11092,11092,103,2022/4/15 17:40:00,264,428,-164
11093,11093,103,2022/4/15 17:50:00,196,471,-275
11094,11094,103,2022/4/15 18:00:00,221,421,-200
11095,11095,103,2022/4/15 18:10:00,208,560,-352
11096,11096,103,2022/4/15 18:20:00,174,421,-247
11097,11097,103,2022/4/15 18:30:00,164,565,-401
11098,11098,103,2022/4/15 18:40:00,134,584,-450
11099,11099,103,2022/4/15 18:50:00,73,568,-495
11100,11100,103,2022/4/15 19:00:00,56,413,-357
11101,11101,103,2022/4/15 19:10:00,44,495,-451
11102,11102,103,2022/4/15 19:20:00,41,318,-277
11103,11103,103,2022/4/15 19:30:00,34,322,-288
11104,11104,103,2022/4/15 19:40:00,30,224,-194
11105,11105,103,2022/4/15 19:50:00,27,207,-180
11106,11106,103,2022/4/15 20:00:00,25,128,-103
11107,11107,103,2022/4/15 20:10:00,30,192,-162
11108,11108,103,2022/4/15 20:20:00,31,132,-101
11109,11109,103,2022/4/15 20:30:00,27,119,-92
11110,11110,103,2022/4/15 20:40:00,29,198,-169
11111,11111,103,2022/4/15 20:50:00,28,109,-81
11112,11112,103,2022/4/15 21:00:00,24,133,-109
11113,11113,103,2022/4/15 21:10:00,31,116,-85
11114,11114,103,2022/4/15 21:20:00,31,118,-87
11115,11115,103,2022/4/15 21:30:00,27,137,-110
11116,11116,103,2022/4/15 21:40:00,28,109,-81
11117,11117,103,2022/4/15 21:50:00,21,112,-91
11118,11118,103,2022/4/15 22:00:00,16,122,-106
11119,11119,103,2022/4/15 22:10:00,21,116,-95
11120,11120,103,2022/4/15 22:20:00,12,104,-92
11121,11121,103,2022/4/15 22:30:00,9,119,-110
11122,11122,103,2022/4/15 22:40:00,1,99,-98
11123,11123,103,2022/4/15 22:50:00,1,80,-79
11124,11124,104,2022/4/15 5:00:00,1,1,0
11125,11125,104,2022/4/15 5:10:00,7,1,6
11126,11126,104,2022/4/15 5:20:00,21,1,20
11127,11127,104,2022/4/15 5:30:00,40,1,39
11128,11128,104,2022/4/15 5:40:00,75,2,73
11129,11129,104,2022/4/15 5:50:00,149,5,144
11130,11130,104,2022/4/15 6:00:00,211,60,151
11131,11131,104,2022/4/15 6:10:00,280,43,237
11132,11132,104,2022/4/15 6:20:00,580,83,497
11133,11133,104,2022/4/15 6:30:00,653,95,558
11134,11134,104,2022/4/15 6:40:00,735,137,598
11135,11135,104,2022/4/15 6:50:00,1166,233,933
11136,11136,104,2022/4/15 7:00:00,1213,216,997
11137,11137,104,2022/4/15 7:10:00,1967,326,1641
11138,11138,104,2022/4/15 7:20:00,2043,378,1665
11139,11139,104,2022/4/15 7:30:00,3211,432,2779
11140,11140,104,2022/4/15 7:40:00,3181,533,2648
11141,11141,104,2022/4/15 7:50:00,3264,494,2770
11142,11142,104,2022/4/15 8:00:00,3372,494,2878
11143,11143,104,2022/4/15 8:10:00,3339,420,2919
11144,11144,104,2022/4/15 8:20:00,3279,499,2780
11145,11145,104,2022/4/15 8:30:00,2571,428,2143
11146,11146,104,2022/4/15 8:40:00,2479,434,2045
11147,11147,104,2022/4/15 8:50:00,2075,439,1636
11148,11148,104,2022/4/15 9:00:00,1632,420,1212
11149,11149,104,2022/4/15 9:10:00,1387,315,1072
11150,11150,104,2022/4/15 9:20:00,1155,297,858
11151,11151,104,2022/4/15 9:30:00,830,297,533
11152,11152,104,2022/4/15 9:40:00,660,232,428
11153,11153,104,2022/4/15 9:50:00,613,177,436
11154,11154,104,2022/4/15 10:00:00,456,208,248
11155,11155,104,2022/4/15 10:10:00,461,179,282
11156,11156,104,2022/4/15 10:20:00,310,198,112
11157,11157,104,2022/4/15 10:30:00,314,170,144
11158,11158,104,2022/4/15 10:40:00,311,181,130
11159,11159,104,2022/4/15 10:50:00,305,227,78
11160,11160,104,2022/4/15 11:00:00,273,192,81
11161,11161,104,2022/4/15 11:10:00,289,223,66
11162,11162,104,2022/4/15 11:20:00,270,145,125
11163,11163,104,2022/4/15 11:30:00,270,180,90
11164,11164,104,2022/4/15 11:40:00,268,192,76
11165,11165,104,2022/4/15 11:50:00,285,193,92
11166,11166,104,2022/4/15 12:00:00,311,223,88
11167,11167,104,2022/4/15 12:10:00,333,185,148
11168,11168,104,2022/4/15 12:20:00,333,196,137
11169,11169,104,2022/4/15 12:30:00,325,222,103
11170,11170,104,2022/4/15 12:40:00,376,234,142
11171,11171,104,2022/4/15 12:50:00,312,225,87
11172,11172,104,2022/4/15 13:00:00,332,233,99
11173,11173,104,2022/4/15 13:10:00,332,213,119
11174,11174,104,2022/4/15 13:20:00,288,208,80
11175,11175,104,2022/4/15 13:30:00,265,180,85
11176,11176,104,2022/4/15 13:40:00,271,254,17
11177,11177,104,2022/4/15 13:50:00,267,178,89
11178,11178,104,2022/4/15 14:00:00,270,254,16
11179,11179,104,2022/4/15 14:10:00,261,207,54
11180,11180,104,2022/4/15 14:20:00,274,297,-23
11181,11181,104,2022/4/15 14:30:00,267,206,61
11182,11182,104,2022/4/15 14:40:00,265,325,-60
11183,11183,104,2022/4/15 14:50:00,270,217,53
11184,11184,104,2022/4/15 15:00:00,272,322,-50
11185,11185,104,2022/4/15 15:10:00,315,290,25
11186,11186,104,2022/4/15 15:20:00,264,379,-115
11187,11187,104,2022/4/15 15:30:00,268,317,-49
11188,11188,104,2022/4/15 15:40:00,287,364,-77
11189,11189,104,2022/4/15 15:50:00,262,421,-159
11190,11190,104,2022/4/15 16:00:00,332,427,-95
11191,11191,104,2022/4/15 16:10:00,346,310,36
11192,11192,104,2022/4/15 16:20:00,326,408,-82
11193,11193,104,2022/4/15 16:30:00,430,410,20
11194,11194,104,2022/4/15 16:40:00,421,408,13
11195,11195,104,2022/4/15 16:50:00,587,414,173
11196,11196,104,2022/4/15 17:00:00,617,552,65
11197,11197,104,2022/4/15 17:10:00,697,550,147
11198,11198,104,2022/4/15 17:20:00,696,1413,-717
11199,11199,104,2022/4/15 17:30:00,679,1474,-795
11200,11200,104,2022/4/15 17:40:00,709,1640,-931
11201,11201,104,2022/4/15 17:50:00,652,1627,-975
11202,11202,104,2022/4/15 18:00:00,639,2051,-1412
11203,11203,104,2022/4/15 18:10:00,712,2436,-1724
11204,11204,104,2022/4/15 18:20:00,617,2441,-1824
11205,11205,104,2022/4/15 18:30:00,609,2387,-1778
11206,11206,104,2022/4/15 18:40:00,457,2621,-2164
11207,11207,104,2022/4/15 18:50:00,335,2167,-1832
11208,11208,104,2022/4/15 19:00:00,264,1980,-1716
11209,11209,104,2022/4/15 19:10:00,227,2106,-1879
11210,11210,104,2022/4/15 19:20:00,192,1101,-909
11211,11211,104,2022/4/15 19:30:00,182,556,-374
11212,11212,104,2022/4/15 19:40:00,159,454,-295
11213,11213,104,2022/4/15 19:50:00,168,399,-231
11214,11214,104,2022/4/15 20:00:00,139,417,-278
11215,11215,104,2022/4/15 20:10:00,169,430,-261
11216,11216,104,2022/4/15 20:20:00,146,340,-194
11217,11217,104,2022/4/15 20:30:00,128,340,-212
11218,11218,104,2022/4/15 20:40:00,160,320,-160
11219,11219,104,2022/4/15 20:50:00,140,506,-366
11220,11220,104,2022/4/15 21:00:00,127,338,-211
11221,11221,104,2022/4/15 21:10:00,151,326,-175
11222,11222,104,2022/4/15 21:20:00,132,263,-131
11223,11223,104,2022/4/15 21:30:00,225,196,29
11224,11224,104,2022/4/15 21:40:00,132,316,-184
11225,11225,104,2022/4/15 21:50:00,44,314,-270
11226,11226,104,2022/4/15 22:00:00,45,238,-193
11227,11227,104,2022/4/15 22:10:00,35,288,-253
11228,11228,104,2022/4/15 22:20:00,28,319,-291
11229,11229,104,2022/4/15 22:30:00,12,202,-190
11230,11230,104,2022/4/15 22:40:00,2,217,-215
11231,11231,104,2022/4/15 22:50:00,2,136,-134
11232,11232,105,2022/4/15 5:00:00,0,1,-1
11233,11233,105,2022/4/15 5:10:00,6,1,5
11234,11234,105,2022/4/15 5:20:00,10,1,9
11235,11235,105,2022/4/15 5:30:00,35,1,34
11236,11236,105,2022/4/15 5:40:00,65,21,44
11237,11237,105,2022/4/15 5:50:00,145,29,116
11238,11238,105,2022/4/15 6:00:00,185,23,162
11239,11239,105,2022/4/15 6:10:00,279,38,241
11240,11240,105,2022/4/15 6:20:00,325,42,283
11241,11241,105,2022/4/15 6:30:00,688,55,633
11242,11242,105,2022/4/15 6:40:00,825,80,745
11243,11243,105,2022/4/15 6:50:00,1063,93,970
11244,11244,105,2022/4/15 7:00:00,1209,126,1083
11245,11245,105,2022/4/15 7:10:00,1363,103,1260
11246,11246,105,2022/4/15 7:20:00,1982,125,1857
11247,11247,105,2022/4/15 7:30:00,1980,123,1857
11248,11248,105,2022/4/15 7:40:00,2532,110,2422
11249,11249,105,2022/4/15 7:50:00,2005,105,1900
11250,11250,105,2022/4/15 8:00:00,2070,153,1917
11251,11251,105,2022/4/15 8:10:00,2468,182,2286
11252,11252,105,2022/4/15 8:20:00,1994,185,1809
11253,11253,105,2022/4/15 8:30:00,1992,109,1883
11254,11254,105,2022/4/15 8:40:00,1363,178,1185
11255,11255,105,2022/4/15 8:50:00,1226,117,1109
11256,11256,105,2022/4/15 9:00:00,852,110,742
11257,11257,105,2022/4/15 9:10:00,698,114,584
11258,11258,105,2022/4/15 9:20:00,581,114,467
11259,11259,105,2022/4/15 9:30:00,320,105,215
11260,11260,105,2022/4/15 9:40:00,274,121,153
11261,11261,105,2022/4/15 9:50:00,261,95,166
11262,11262,105,2022/4/15 10:00:00,232,104,128
11263,11263,105,2022/4/15 10:10:00,211,107,104
11264,11264,105,2022/4/15 10:20:00,176,108,68
11265,11265,105,2022/4/15 10:30:00,162,113,49
11266,11266,105,2022/4/15 10:40:00,112,97,15
11267,11267,105,2022/4/15 10:50:00,114,104,10
11268,11268,105,2022/4/15 11:00:00,91,103,-12
11269,11269,105,2022/4/15 11:10:00,88,124,-36
11270,11270,105,2022/4/15 11:20:00,80,105,-25
11271,11271,105,2022/4/15 11:30:00,76,104,-28
11272,11272,105,2022/4/15 11:40:00,108,99,9
11273,11273,105,2022/4/15 11:50:00,107,102,5
11274,11274,105,2022/4/15 12:00:00,137,117,20
11275,11275,105,2022/4/15 12:10:00,167,123,44
11276,11276,105,2022/4/15 12:20:00,176,102,74
11277,11277,105,2022/4/15 12:30:00,176,112,64
11278,11278,105,2022/4/15 12:40:00,131,106,25
11279,11279,105,2022/4/15 12:50:00,140,101,39
11280,11280,105,2022/4/15 13:00:00,141,119,22
11281,11281,105,2022/4/15 13:10:00,136,122,14
11282,11282,105,2022/4/15 13:20:00,88,83,5
11283,11283,105,2022/4/15 13:30:00,84,99,-15
11284,11284,105,2022/4/15 13:40:00,75,102,-27
11285,11285,105,2022/4/15 13:50:00,71,97,-26
11286,11286,105,2022/4/15 14:00:00,67,109,-42
11287,11287,105,2022/4/15 14:10:00,69,112,-43
11288,11288,105,2022/4/15 14:20:00,68,112,-44
11289,11289,105,2022/4/15 14:30:00,64,99,-35
11290,11290,105,2022/4/15 14:40:00,65,116,-51
11291,11291,105,2022/4/15 14:50:00,64,129,-65
11292,11292,105,2022/4/15 15:00:00,64,110,-46
11293,11293,105,2022/4/15 15:10:00,71,192,-121
11294,11294,105,2022/4/15 15:20:00,64,126,-62
11295,11295,105,2022/4/15 15:30:00,68,169,-101
11296,11296,105,2022/4/15 15:40:00,53,152,-99
11297,11297,105,2022/4/15 15:50:00,68,179,-111
11298,11298,105,2022/4/15 16:00:00,65,216,-151
11299,11299,105,2022/4/15 16:10:00,83,224,-141
11300,11300,105,2022/4/15 16:20:00,82,195,-113
11301,11301,105,2022/4/15 16:30:00,105,196,-91
11302,11302,105,2022/4/15 16:40:00,156,213,-57
11303,11303,105,2022/4/15 16:50:00,176,327,-151
11304,11304,105,2022/4/15 17:00:00,215,424,-209
11305,11305,105,2022/4/15 17:10:00,260,309,-49
11306,11306,105,2022/4/15 17:20:00,243,400,-157
11307,11307,105,2022/4/15 17:30:00,222,467,-245
11308,11308,105,2022/4/15 17:40:00,242,1488,-1246
11309,11309,105,2022/4/15 17:50:00,201,1099,-898
11310,11310,105,2022/4/15 18:00:00,184,403,-219
11311,11311,105,2022/4/15 18:10:00,222,2667,-2445
11312,11312,105,2022/4/15 18:20:00,198,568,-370
11313,11313,105,2022/4/15 18:30:00,166,1777,-1611
11314,11314,105,2022/4/15 18:40:00,181,1753,-1572
11315,11315,105,2022/4/15 18:50:00,139,1773,-1634
11316,11316,105,2022/4/15 19:00:00,71,423,-352
11317,11317,105,2022/4/15 19:10:00,137,1929,-1792
11318,11318,105,2022/4/15 19:20:00,66,366,-300
11319,11319,105,2022/4/15 19:30:00,64,469,-405
11320,11320,105,2022/4/15 19:40:00,46,384,-338
11321,11321,105,2022/4/15 19:50:00,41,307,-266
11322,11322,105,2022/4/15 20:00:00,46,314,-268
11323,11323,105,2022/4/15 20:10:00,43,217,-174
11324,11324,105,2022/4/15 20:20:00,41,293,-252
11325,11325,105,2022/4/15 20:30:00,41,269,-228
11326,11326,105,2022/4/15 20:40:00,40,269,-229
11327,11327,105,2022/4/15 20:50:00,37,269,-232
11328,11328,105,2022/4/15 21:00:00,41,234,-193
11329,11329,105,2022/4/15 21:10:00,34,178,-144
11330,11330,105,2022/4/15 21:20:00,29,198,-169
11331,11331,105,2022/4/15 21:30:00,27,227,-200
11332,11332,105,2022/4/15 21:40:00,28,236,-208
11333,11333,105,2022/4/15 21:50:00,26,229,-203
11334,11334,105,2022/4/15 22:00:00,25,185,-160
11335,11335,105,2022/4/15 22:10:00,28,218,-190
11336,11336,105,2022/4/15 22:20:00,24,213,-189
11337,11337,105,2022/4/15 22:30:00,17,291,-274
11338,11338,105,2022/4/15 22:40:00,11,151,-140
11339,11339,105,2022/4/15 22:50:00,8,116,-108
11340,11340,106,2022/4/15 5:00:00,1,1,0
11341,11341,106,2022/4/15 5:10:00,6,6,0
11342,11342,106,2022/4/15 5:20:00,16,1,15
11343,11343,106,2022/4/15 5:30:00,14,17,-3
11344,11344,106,2022/4/15 5:40:00,20,29,-9
11345,11345,106,2022/4/15 5:50:00,29,23,6
11346,11346,106,2022/4/15 6:00:00,32,113,-81
11347,11347,106,2022/4/15 6:10:00,37,112,-75
11348,11348,106,2022/4/15 6:20:00,37,117,-80
11349,11349,106,2022/4/15 6:30:00,39,102,-63
11350,11350,106,2022/4/15 6:40:00,52,121,-69
11351,11351,106,2022/4/15 6:50:00,75,121,-46
11352,11352,106,2022/4/15 7:00:00,69,224,-155
11353,11353,106,2022/4/15 7:10:00,80,267,-187
11354,11354,106,2022/4/15 7:20:00,85,345,-260
11355,11355,106,2022/4/15 7:30:00,150,509,-359
11356,11356,106,2022/4/15 7:40:00,146,436,-290
11357,11357,106,2022/4/15 7:50:00,195,578,-383
11358,11358,106,2022/4/15 8:00:00,230,1792,-1562
11359,11359,106,2022/4/15 8:10:00,232,2954,-2722
11360,11360,106,2022/4/15 8:20:00,226,2619,-2393
11361,11361,106,2022/4/15 8:30:00,231,4745,-4514
11362,11362,106,2022/4/15 8:40:00,192,6335,-6143
11363,11363,106,2022/4/15 8:50:00,202,5623,-5421
11364,11364,106,2022/4/15 9:00:00,185,4993,-4808
11365,11365,106,2022/4/15 9:10:00,188,2869,-2681
11366,11366,106,2022/4/15 9:20:00,169,1712,-1543
11367,11367,106,2022/4/15 9:30:00,156,563,-407
11368,11368,106,2022/4/15 9:40:00,155,553,-398
11369,11369,106,2022/4/15 9:50:00,147,417,-270
11370,11370,106,2022/4/15 10:00:00,160,531,-371
11371,11371,106,2022/4/15 10:10:00,153,318,-165
11372,11372,106,2022/4/15 10:20:00,175,332,-157
11373,11373,106,2022/4/15 10:30:00,183,332,-149
11374,11374,106,2022/4/15 10:40:00,181,331,-150
11375,11375,106,2022/4/15 10:50:00,211,298,-87
11376,11376,106,2022/4/15 11:00:00,216,232,-16
11377,11377,106,2022/4/15 11:10:00,215,254,-39
11378,11378,106,2022/4/15 11:20:00,218,254,-36
11379,11379,106,2022/4/15 11:30:00,218,233,-15
11380,11380,106,2022/4/15 11:40:00,266,255,11
11381,11381,106,2022/4/15 11:50:00,262,269,-7
11382,11382,106,2022/4/15 12:00:00,263,195,68
11383,11383,106,2022/4/15 12:10:00,267,217,50
11384,11384,106,2022/4/15 12:20:00,300,255,45
11385,11385,106,2022/4/15 12:30:00,346,268,78
11386,11386,106,2022/4/15 12:40:00,343,299,44
11387,11387,106,2022/4/15 12:50:00,333,299,34
11388,11388,106,2022/4/15 13:00:00,367,283,84
11389,11389,106,2022/4/15 13:10:00,367,318,49
11390,11390,106,2022/4/15 13:20:00,454,318,136
11391,11391,106,2022/4/15 13:30:00,457,298,159
11392,11392,106,2022/4/15 13:40:00,422,298,124
11393,11393,106,2022/4/15 13:50:00,456,299,157
11394,11394,106,2022/4/15 14:00:00,545,267,278
11395,11395,106,2022/4/15 14:10:00,549,232,317
11396,11396,106,2022/4/15 14:20:00,574,232,342
11397,11397,106,2022/4/15 14:30:00,558,197,361
11398,11398,106,2022/4/15 14:40:00,580,207,373
11399,11399,106,2022/4/15 14:50:00,570,232,338
11400,11400,106,2022/4/15 15:00:00,573,223,350
11401,11401,106,2022/4/15 15:10:00,591,223,368
11402,11402,106,2022/4/15 15:20:00,587,233,354
11403,11403,106,2022/4/15 15:30:00,639,226,413
11404,11404,106,2022/4/15 15:40:00,637,226,411
11405,11405,106,2022/4/15 15:50:00,596,214,382
11406,11406,106,2022/4/15 16:00:00,638,225,413
11407,11407,106,2022/4/15 16:10:00,640,223,417
11408,11408,106,2022/4/15 16:20:00,686,208,478
11409,11409,106,2022/4/15 16:30:00,635,198,437
11410,11410,106,2022/4/15 16:40:00,708,226,482
11411,11411,106,2022/4/15 16:50:00,705,233,472
11412,11412,106,2022/4/15 17:00:00,1145,265,880
11413,11413,106,2022/4/15 17:10:00,1576,294,1282
11414,11414,106,2022/4/15 17:20:00,1377,336,1041
11415,11415,106,2022/4/15 17:30:00,1967,363,1604
11416,11416,106,2022/4/15 17:40:00,3043,363,2680
11417,11417,106,2022/4/15 17:50:00,1988,494,1494
11418,11418,106,2022/4/15 18:00:00,1966,414,1552
11419,11419,106,2022/4/15 18:10:00,3308,411,2897
11420,11420,106,2022/4/15 18:20:00,3001,418,2583
11421,11421,106,2022/4/15 18:30:00,1609,417,1192
11422,11422,106,2022/4/15 18:40:00,1360,424,936
11423,11423,106,2022/4/15 18:50:00,1140,459,681
11424,11424,106,2022/4/15 19:00:00,1034,321,713
11425,11425,106,2022/4/15 19:10:00,833,212,621
11426,11426,106,2022/4/15 19:20:00,711,180,531
11427,11427,106,2022/4/15 19:30:00,658,150,508
11428,11428,106,2022/4/15 19:40:00,645,116,529
11429,11429,106,2022/4/15 19:50:00,627,111,516
11430,11430,106,2022/4/15 20:00:00,645,105,540
11431,11431,106,2022/4/15 20:10:00,726,108,618
11432,11432,106,2022/4/15 20:20:00,637,106,531
11433,11433,106,2022/4/15 20:30:00,658,85,573
11434,11434,106,2022/4/15 20:40:00,726,104,622
11435,11435,106,2022/4/15 20:50:00,721,99,622
11436,11436,106,2022/4/15 21:00:00,817,104,713
11437,11437,106,2022/4/15 21:10:00,840,97,743
11438,11438,106,2022/4/15 21:20:00,723,97,626
11439,11439,106,2022/4/15 21:30:00,679,102,577
11440,11440,106,2022/4/15 21:40:00,673,88,585
11441,11441,106,2022/4/15 21:50:00,642,95,547
11442,11442,106,2022/4/15 22:00:00,1404,92,1312
11443,11443,106,2022/4/15 22:10:00,1248,94,1154
11444,11444,106,2022/4/15 22:20:00,238,89,149
11445,11445,106,2022/4/15 22:30:00,124,79,45
11446,11446,106,2022/4/15 22:40:00,60,83,-23
11447,11447,106,2022/4/15 22:50:00,26,72,-46
11448,11448,107,2022/4/15 5:00:00,1,2,-1
11449,11449,107,2022/4/15 5:10:00,2,1,1
11450,11450,107,2022/4/15 5:20:00,4,2,2
11451,11451,107,2022/4/15 5:30:00,10,14,-4
11452,11452,107,2022/4/15 5:40:00,12,23,-11
11453,11453,107,2022/4/15 5:50:00,18,33,-15
11454,11454,107,2022/4/15 6:00:00,23,48,-25
11455,11455,107,2022/4/15 6:10:00,31,80,-49
11456,11456,107,2022/4/15 6:20:00,29,107,-78
11457,11457,107,2022/4/15 6:30:00,49,108,-59
11458,11458,107,2022/4/15 6:40:00,57,119,-62
11459,11459,107,2022/4/15 6:50:00,65,223,-158
11460,11460,107,2022/4/15 7:00:00,71,317,-246
11461,11461,107,2022/4/15 7:10:00,97,500,-403
11462,11462,107,2022/4/15 7:20:00,151,438,-287
11463,11463,107,2022/4/15 7:30:00,182,431,-249
11464,11464,107,2022/4/15 7:40:00,184,475,-291
11465,11465,107,2022/4/15 7:50:00,259,605,-346
11466,11466,107,2022/4/15 8:00:00,281,1172,-891
11467,11467,107,2022/4/15 8:10:00,361,1931,-1570
11468,11468,107,2022/4/15 8:20:00,339,2046,-1707
11469,11469,107,2022/4/15 8:30:00,357,2230,-1873
11470,11470,107,2022/4/15 8:40:00,357,2489,-2132
11471,11471,107,2022/4/15 8:50:00,280,2760,-2480
11472,11472,107,2022/4/15 9:00:00,271,2275,-2004
11473,11473,107,2022/4/15 9:10:00,248,2946,-2698
11474,11474,107,2022/4/15 9:20:00,228,1726,-1498
11475,11475,107,2022/4/15 9:30:00,192,565,-373
11476,11476,107,2022/4/15 9:40:00,188,578,-390
11477,11477,107,2022/4/15 9:50:00,174,391,-217
11478,11478,107,2022/4/15 10:00:00,173,421,-248
11479,11479,107,2022/4/15 10:10:00,171,427,-256
11480,11480,107,2022/4/15 10:20:00,176,320,-144
11481,11481,107,2022/4/15 10:30:00,173,432,-259
11482,11482,107,2022/4/15 10:40:00,178,334,-156
11483,11483,107,2022/4/15 10:50:00,181,319,-138
11484,11484,107,2022/4/15 11:00:00,173,282,-109
11485,11485,107,2022/4/15 11:10:00,203,266,-63
11486,11486,107,2022/4/15 11:20:00,172,232,-60
11487,11487,107,2022/4/15 11:30:00,203,268,-65
11488,11488,107,2022/4/15 11:40:00,208,283,-75
11489,11489,107,2022/4/15 11:50:00,216,284,-68
11490,11490,107,2022/4/15 12:00:00,222,231,-9
11491,11491,107,2022/4/15 12:10:00,234,267,-33
11492,11492,107,2022/4/15 12:20:00,236,231,5
11493,11493,107,2022/4/15 12:30:00,227,268,-41
11494,11494,107,2022/4/15 12:40:00,233,326,-93
11495,11495,107,2022/4/15 12:50:00,242,333,-91
11496,11496,107,2022/4/15 13:00:00,271,295,-24
11497,11497,107,2022/4/15 13:10:00,272,331,-59
11498,11498,107,2022/4/15 13:20:00,268,317,-49
11499,11499,107,2022/4/15 13:30:00,269,282,-13
11500,11500,107,2022/4/15 13:40:00,270,335,-65
11501,11501,107,2022/4/15 13:50:00,265,298,-33
11502,11502,107,2022/4/15 14:00:00,288,283,5
11503,11503,107,2022/4/15 14:10:00,334,254,80
11504,11504,107,2022/4/15 14:20:00,315,225,90
11505,11505,107,2022/4/15 14:30:00,336,196,140
11506,11506,107,2022/4/15 14:40:00,334,231,103
11507,11507,107,2022/4/15 14:50:00,327,218,109
11508,11508,107,2022/4/15 15:00:00,349,208,141
11509,11509,107,2022/4/15 15:10:00,350,181,169
11510,11510,107,2022/4/15 15:20:00,429,208,221
11511,11511,107,2022/4/15 15:30:00,461,233,228
11512,11512,107,2022/4/15 15:40:00,550,198,352
11513,11513,107,2022/4/15 15:50:00,576,226,350
11514,11514,107,2022/4/15 16:00:00,572,207,365
11515,11515,107,2022/4/15 16:10:00,637,180,457
11516,11516,107,2022/4/15 16:20:00,587,198,389
11517,11517,107,2022/4/15 16:30:00,638,180,458
11518,11518,107,2022/4/15 16:40:00,658,234,424
11519,11519,107,2022/4/15 16:50:00,657,197,460
11520,11520,107,2022/4/15 17:00:00,843,230,613
11521,11521,107,2022/4/15 17:10:00,1206,316,890
11522,11522,107,2022/4/15 17:20:00,1157,328,829
11523,11523,107,2022/4/15 17:30:00,1156,336,820
11524,11524,107,2022/4/15 17:40:00,1592,431,1161
11525,11525,107,2022/4/15 17:50:00,1360,498,862
11526,11526,107,2022/4/15 18:00:00,1585,492,1093
11527,11527,107,2022/4/15 18:10:00,1996,427,1569
11528,11528,107,2022/4/15 18:20:00,1564,425,1139
11529,11529,107,2022/4/15 18:30:00,1585,416,1169
11530,11530,107,2022/4/15 18:40:00,1351,520,831
11531,11531,107,2022/4/15 18:50:00,1160,370,790
11532,11532,107,2022/4/15 19:00:00,816,321,495
11533,11533,107,2022/4/15 19:10:00,659,279,380
11534,11534,107,2022/4/15 19:20:00,616,180,436
11535,11535,107,2022/4/15 19:30:00,579,137,442
11536,11536,107,2022/4/15 19:40:00,457,120,337
11537,11537,107,2022/4/15 19:50:00,350,124,226
11538,11538,107,2022/4/15 20:00:00,422,126,296
11539,11539,107,2022/4/15 20:10:00,578,105,473
11540,11540,107,2022/4/15 20:20:00,455,106,349
11541,11541,107,2022/4/15 20:30:00,422,98,324
11542,11542,107,2022/4/15 20:40:00,592,108,484
11543,11543,107,2022/4/15 20:50:00,457,100,357
11544,11544,107,2022/4/15 21:00:00,597,106,491
11545,11545,107,2022/4/15 21:10:00,641,109,532
11546,11546,107,2022/4/15 21:20:00,573,106,467
11547,11547,107,2022/4/15 21:30:00,570,111,459
11548,11548,107,2022/4/15 21:40:00,573,108,465
11549,11549,107,2022/4/15 21:50:00,582,112,470
11550,11550,107,2022/4/15 22:00:00,674,97,577
11551,11551,107,2022/4/15 22:10:00,842,102,740
11552,11552,107,2022/4/15 22:20:00,272,82,190
11553,11553,107,2022/4/15 22:30:00,159,70,89
11554,11554,107,2022/4/15 22:40:00,70,72,-2
11555,11555,107,2022/4/15 22:50:00,34,52,-18
11556,11556,108,2022/4/15 5:00:00,3,1,2
11557,11557,108,2022/4/15 5:10:00,43,1,42
11558,11558,108,2022/4/15 5:20:00,39,16,23
11559,11559,108,2022/4/15 5:30:00,35,13,22
11560,11560,108,2022/4/15 5:40:00,33,25,8
11561,11561,108,2022/4/15 5:50:00,31,28,3
11562,11562,108,2022/4/15 6:00:00,27,111,-84
11563,11563,108,2022/4/15 6:10:00,36,124,-88
11564,11564,108,2022/4/15 6:20:00,49,130,-81
11565,11565,108,2022/4/15 6:30:00,181,152,29
11566,11566,108,2022/4/15 6:40:00,129,335,-206
11567,11567,108,2022/4/15 6:50:00,147,218,-71
11568,11568,108,2022/4/15 7:00:00,228,286,-58
11569,11569,108,2022/4/15 7:10:00,257,411,-154
11570,11570,108,2022/4/15 7:20:00,362,560,-198
11571,11571,108,2022/4/15 7:30:00,708,1415,-707
11572,11572,108,2022/4/15 7:40:00,916,1603,-687
11573,11573,108,2022/4/15 7:50:00,1039,2206,-1167
11574,11574,108,2022/4/15 8:00:00,1043,1834,-791
11575,11575,108,2022/4/15 8:10:00,1272,4865,-3593
11576,11576,108,2022/4/15 8:20:00,1049,6873,-5824
11577,11577,108,2022/4/15 8:30:00,1654,4451,-2797
11578,11578,108,2022/4/15 8:40:00,1423,5303,-3880
11579,11579,108,2022/4/15 8:50:00,1154,4613,-3459
11580,11580,108,2022/4/15 9:00:00,666,2292,-1626
11581,11581,108,2022/4/15 9:10:00,697,1754,-1057
11582,11582,108,2022/4/15 9:20:00,671,1492,-821
11583,11583,108,2022/4/15 9:30:00,582,553,29
11584,11584,108,2022/4/15 9:40:00,650,395,255
11585,11585,108,2022/4/15 9:50:00,352,392,-40
11586,11586,108,2022/4/15 10:00:00,316,495,-179
11587,11587,108,2022/4/15 10:10:00,376,500,-124
11588,11588,108,2022/4/15 10:20:00,592,377,215
11589,11589,108,2022/4/15 10:30:00,422,314,108
11590,11590,108,2022/4/15 10:40:00,546,529,17
11591,11591,108,2022/4/15 10:50:00,548,317,231
11592,11592,108,2022/4/15 11:00:00,267,318,-51
11593,11593,108,2022/4/15 11:10:00,264,291,-27
11594,11594,108,2022/4/15 11:20:00,308,330,-22
11595,11595,108,2022/4/15 11:30:00,304,285,19
11596,11596,108,2022/4/15 11:40:00,551,318,233
11597,11597,108,2022/4/15 11:50:00,295,323,-28
11598,11598,108,2022/4/15 12:00:00,316,319,-3
11599,11599,108,2022/4/15 12:10:00,327,308,19
11600,11600,108,2022/4/15 12:20:00,329,295,34
11601,11601,108,2022/4/15 12:30:00,349,312,37
11602,11602,108,2022/4/15 12:40:00,587,401,186
11603,11603,108,2022/4/15 12:50:00,300,365,-65
11604,11604,108,2022/4/15 13:00:00,343,349,-6
11605,11605,108,2022/4/15 13:10:00,310,419,-109
11606,11606,108,2022/4/15 13:20:00,285,301,-16
11607,11607,108,2022/4/15 13:30:00,288,309,-21
11608,11608,108,2022/4/15 13:40:00,633,322,311
11609,11609,108,2022/4/15 13:50:00,351,345,6
11610,11610,108,2022/4/15 14:00:00,297,302,-5
11611,11611,108,2022/4/15 14:10:00,353,272,81
11612,11612,108,2022/4/15 14:20:00,288,305,-17
11613,11613,108,2022/4/15 14:30:00,301,303,-2
11614,11614,108,2022/4/15 14:40:00,585,326,259
11615,11615,108,2022/4/15 14:50:00,344,317,27
11616,11616,108,2022/4/15 15:00:00,312,275,37
11617,11617,108,2022/4/15 15:10:00,584,339,245
11618,11618,108,2022/4/15 15:20:00,369,290,79
11619,11619,108,2022/4/15 15:30:00,549,297,252
11620,11620,108,2022/4/15 15:40:00,651,306,345
11621,11621,108,2022/4/15 15:50:00,616,339,277
11622,11622,108,2022/4/15 16:00:00,543,284,259
11623,11623,108,2022/4/15 16:10:00,592,285,307
11624,11624,108,2022/4/15 16:20:00,584,270,314
11625,11625,108,2022/4/15 16:30:00,807,506,301
11626,11626,108,2022/4/15 16:40:00,812,467,345
11627,11627,108,2022/4/15 16:50:00,713,306,407
11628,11628,108,2022/4/15 17:00:00,1145,384,761
11629,11629,108,2022/4/15 17:10:00,1584,400,1184
11630,11630,108,2022/4/15 17:20:00,1590,458,1132
11631,11631,108,2022/4/15 17:30:00,1360,549,811
11632,11632,108,2022/4/15 17:40:00,2478,455,2023
11633,11633,108,2022/4/15 17:50:00,1970,550,1420
11634,11634,108,2022/4/15 18:00:00,1995,1067,928
11635,11635,108,2022/4/15 18:10:00,1994,563,1431
11636,11636,108,2022/4/15 18:20:00,1993,1057,936
11637,11637,108,2022/4/15 18:30:00,1972,566,1406
11638,11638,108,2022/4/15 18:40:00,1969,560,1409
11639,11639,108,2022/4/15 18:50:00,1397,482,915
11640,11640,108,2022/4/15 19:00:00,1165,386,779
11641,11641,108,2022/4/15 19:10:00,831,456,375
11642,11642,108,2022/4/15 19:20:00,727,349,378
11643,11643,108,2022/4/15 19:30:00,636,293,343
11644,11644,108,2022/4/15 19:40:00,676,242,434
11645,11645,108,2022/4/15 19:50:00,431,198,233
11646,11646,108,2022/4/15 20:00:00,314,203,111
11647,11647,108,2022/4/15 20:10:00,271,179,92
11648,11648,108,2022/4/15 20:20:00,246,174,72
11649,11649,108,2022/4/15 20:30:00,325,182,143
11650,11650,108,2022/4/15 20:40:00,325,181,144
11651,11651,108,2022/4/15 20:50:00,206,141,65
11652,11652,108,2022/4/15 21:00:00,273,108,165
11653,11653,108,2022/4/15 21:10:00,192,140,52
11654,11654,108,2022/4/15 21:20:00,188,204,-16
11655,11655,108,2022/4/15 21:30:00,200,192,8
11656,11656,108,2022/4/15 21:40:00,244,170,74
11657,11657,108,2022/4/15 21:50:00,175,120,55
11658,11658,108,2022/4/15 22:00:00,225,119,106
11659,11659,108,2022/4/15 22:10:00,117,152,-35
11660,11660,108,2022/4/15 22:20:00,109,153,-44
11661,11661,108,2022/4/15 22:30:00,83,120,-37
11662,11662,108,2022/4/15 22:40:00,59,112,-53
11663,11663,108,2022/4/15 22:50:00,30,88,-58
11664,11664,109,2022/4/15 5:00:00,0,1,-1
11665,11665,109,2022/4/15 5:10:00,0,1,-1
11666,11666,109,2022/4/15 5:20:00,3,1,2
11667,11667,109,2022/4/15 5:30:00,7,1,6
11668,11668,109,2022/4/15 5:40:00,17,1,16
11669,11669,109,2022/4/15 5:50:00,19,23,-4
11670,11670,109,2022/4/15 6:00:00,32,31,1
11671,11671,109,2022/4/15 6:10:00,35,36,-1
11672,11672,109,2022/4/15 6:20:00,43,65,-22
11673,11673,109,2022/4/15 6:30:00,61,76,-15
11674,11674,109,2022/4/15 6:40:00,101,90,11
11675,11675,109,2022/4/15 6:50:00,186,109,77
11676,11676,109,2022/4/15 7:00:00,223,110,113
11677,11677,109,2022/4/15 7:10:00,277,85,192
11678,11678,109,2022/4/15 7:20:00,275,104,171
11679,11679,109,2022/4/15 7:30:00,436,171,265
11680,11680,109,2022/4/15 7:40:00,630,214,416
11681,11681,109,2022/4/15 7:50:00,721,300,421
11682,11682,109,2022/4/15 8:00:00,717,524,193
11683,11683,109,2022/4/15 8:10:00,734,557,177
11684,11684,109,2022/4/15 8:20:00,682,1076,-394
11685,11685,109,2022/4/15 8:30:00,652,1718,-1066
11686,11686,109,2022/4/15 8:40:00,392,1494,-1102
11687,11687,109,2022/4/15 8:50:00,355,1103,-748
11688,11688,109,2022/4/15 9:00:00,277,417,-140
11689,11689,109,2022/4/15 9:10:00,232,436,-204
11690,11690,109,2022/4/15 9:20:00,192,330,-138
11691,11691,109,2022/4/15 9:30:00,143,229,-86
11692,11692,109,2022/4/15 9:40:00,106,304,-198
11693,11693,109,2022/4/15 9:50:00,72,178,-106
11694,11694,109,2022/4/15 10:00:00,54,118,-64
11695,11695,109,2022/4/15 10:10:00,59,121,-62
11696,11696,109,2022/4/15 10:20:00,53,110,-57
11697,11697,109,2022/4/15 10:30:00,51,105,-54
11698,11698,109,2022/4/15 10:40:00,46,121,-75
11699,11699,109,2022/4/15 10:50:00,47,99,-52
11700,11700,109,2022/4/15 11:00:00,48,97,-49
11701,11701,109,2022/4/15 11:10:00,44,80,-36
11702,11702,109,2022/4/15 11:20:00,45,100,-55
11703,11703,109,2022/4/15 11:30:00,45,87,-42
11704,11704,109,2022/4/15 11:40:00,56,105,-49
11705,11705,109,2022/4/15 11:50:00,59,91,-32
11706,11706,109,2022/4/15 12:00:00,57,87,-30
11707,11707,109,2022/4/15 12:10:00,65,89,-24
11708,11708,109,2022/4/15 12:20:00,71,111,-40
11709,11709,109,2022/4/15 12:30:00,67,126,-59
11710,11710,109,2022/4/15 12:40:00,72,109,-37
11711,11711,109,2022/4/15 12:50:00,54,105,-51
11712,11712,109,2022/4/15 13:00:00,62,110,-48
11713,11713,109,2022/4/15 13:10:00,62,90,-28
11714,11714,109,2022/4/15 13:20:00,73,117,-44
11715,11715,109,2022/4/15 13:30:00,66,126,-60
11716,11716,109,2022/4/15 13:40:00,57,108,-51
11717,11717,109,2022/4/15 13:50:00,62,110,-48
11718,11718,109,2022/4/15 14:00:00,66,104,-38
11719,11719,109,2022/4/15 14:10:00,64,101,-37
11720,11720,109,2022/4/15 14:20:00,68,110,-42
11721,11721,109,2022/4/15 14:30:00,59,96,-37
11722,11722,109,2022/4/15 14:40:00,63,109,-46
11723,11723,109,2022/4/15 14:50:00,70,101,-31
11724,11724,109,2022/4/15 15:00:00,76,90,-14
11725,11725,109,2022/4/15 15:10:00,92,95,-3
11726,11726,109,2022/4/15 15:20:00,94,104,-10
11727,11727,109,2022/4/15 15:30:00,84,114,-30
11728,11728,109,2022/4/15 15:40:00,75,109,-34
11729,11729,109,2022/4/15 15:50:00,87,105,-18
11730,11730,109,2022/4/15 16:00:00,92,102,-10
11731,11731,109,2022/4/15 16:10:00,133,100,33
11732,11732,109,2022/4/15 16:20:00,142,120,22
11733,11733,109,2022/4/15 16:30:00,179,117,62
11734,11734,109,2022/4/15 16:40:00,190,107,83
11735,11735,109,2022/4/15 16:50:00,211,104,107
11736,11736,109,2022/4/15 17:00:00,288,108,180
11737,11737,109,2022/4/15 17:10:00,641,181,460
11738,11738,109,2022/4/15 17:20:00,547,123,424
11739,11739,109,2022/4/15 17:30:00,368,232,136
11740,11740,109,2022/4/15 17:40:00,1046,233,813
11741,11741,109,2022/4/15 17:50:00,806,207,599
11742,11742,109,2022/4/15 18:00:00,697,253,444
11743,11743,109,2022/4/15 18:10:00,1163,270,893
11744,11744,109,2022/4/15 18:20:00,1162,179,983
11745,11745,109,2022/4/15 18:30:00,648,329,319
11746,11746,109,2022/4/15 18:40:00,568,228,340
11747,11747,109,2022/4/15 18:50:00,462,206,256
11748,11748,109,2022/4/15 19:00:00,307,192,115
11749,11749,109,2022/4/15 19:10:00,268,193,75
11750,11750,109,2022/4/15 19:20:00,225,111,114
11751,11751,109,2022/4/15 19:30:00,188,112,76
11752,11752,109,2022/4/15 19:40:00,137,109,28
11753,11753,109,2022/4/15 19:50:00,132,104,28
11754,11754,109,2022/4/15 20:00:00,110,99,11
11755,11755,109,2022/4/15 20:10:00,129,100,29
11756,11756,109,2022/4/15 20:20:00,84,95,-11
11757,11757,109,2022/4/15 20:30:00,73,95,-22
11758,11758,109,2022/4/15 20:40:00,74,82,-8
11759,11759,109,2022/4/15 20:50:00,75,101,-26
11760,11760,109,2022/4/15 21:00:00,70,78,-8
11761,11761,109,2022/4/15 21:10:00,67,87,-20
11762,11762,109,2022/4/15 21:20:00,85,89,-4
11763,11763,109,2022/4/15 21:30:00,56,99,-43
11764,11764,109,2022/4/15 21:40:00,42,92,-50
11765,11765,109,2022/4/15 21:50:00,38,89,-51
11766,11766,109,2022/4/15 22:00:00,38,78,-40
11767,11767,109,2022/4/15 22:10:00,27,83,-56
11768,11768,109,2022/4/15 22:20:00,26,95,-69
11769,11769,109,2022/4/15 22:30:00,22,78,-56
11770,11770,109,2022/4/15 22:40:00,16,70,-54
11771,11771,109,2022/4/15 22:50:00,9,83,-74
11772,11772,110,2022/4/15 5:00:00,26,1,25
11773,11773,110,2022/4/15 5:10:00,32,1,31
11774,11774,110,2022/4/15 5:20:00,31,1,30
11775,11775,110,2022/4/15 5:30:00,29,1,28
11776,11776,110,2022/4/15 5:40:00,28,8,20
11777,11777,110,2022/4/15 5:50:00,27,38,-11
11778,11778,110,2022/4/15 6:00:00,31,38,-7
11779,11779,110,2022/4/15 6:10:00,53,47,6
11780,11780,110,2022/4/15 6:20:00,91,76,15
11781,11781,110,2022/4/15 6:30:00,162,89,73
11782,11782,110,2022/4/15 6:40:00,155,108,47
11783,11783,110,2022/4/15 6:50:00,186,111,75
11784,11784,110,2022/4/15 7:00:00,271,119,152
11785,11785,110,2022/4/15 7:10:00,286,125,161
11786,11786,110,2022/4/15 7:20:00,608,135,473
11787,11787,110,2022/4/15 7:30:00,679,145,534
11788,11788,110,2022/4/15 7:40:00,746,152,594
11789,11789,110,2022/4/15 7:50:00,843,152,691
11790,11790,110,2022/4/15 8:00:00,1240,213,1027
11791,11791,110,2022/4/15 8:10:00,1051,197,854
11792,11792,110,2022/4/15 8:20:00,682,178,504
11793,11793,110,2022/4/15 8:30:00,1164,197,967
11794,11794,110,2022/4/15 8:40:00,592,219,373
11795,11795,110,2022/4/15 8:50:00,324,192,132
11796,11796,110,2022/4/15 9:00:00,586,139,447
11797,11797,110,2022/4/15 9:10:00,346,110,236
11798,11798,110,2022/4/15 9:20:00,266,118,148
11799,11799,110,2022/4/15 9:30:00,278,110,168
11800,11800,110,2022/4/15 9:40:00,187,118,69
11801,11801,110,2022/4/15 9:50:00,140,127,13
11802,11802,110,2022/4/15 10:00:00,62,108,-46
11803,11803,110,2022/4/15 10:10:00,135,123,12
11804,11804,110,2022/4/15 10:20:00,86,96,-10
11805,11805,110,2022/4/15 10:30:00,53,112,-59
11806,11806,110,2022/4/15 10:40:00,106,94,12
11807,11807,110,2022/4/15 10:50:00,133,114,19
11808,11808,110,2022/4/15 11:00:00,89,103,-14
11809,11809,110,2022/4/15 11:10:00,74,111,-37
11810,11810,110,2022/4/15 11:20:00,93,102,-9
11811,11811,110,2022/4/15 11:30:00,80,115,-35
11812,11812,110,2022/4/15 11:40:00,62,86,-24
11813,11813,110,2022/4/15 11:50:00,65,111,-46
11814,11814,110,2022/4/15 12:00:00,122,98,24
11815,11815,110,2022/4/15 12:10:00,66,124,-58
11816,11816,110,2022/4/15 12:20:00,74,97,-23
11817,11817,110,2022/4/15 12:30:00,164,109,55
11818,11818,110,2022/4/15 12:40:00,54,119,-65
11819,11819,110,2022/4/15 12:50:00,108,107,1
11820,11820,110,2022/4/15 13:00:00,115,108,7
11821,11821,110,2022/4/15 13:10:00,129,109,20
11822,11822,110,2022/4/15 13:20:00,75,113,-38
11823,11823,110,2022/4/15 13:30:00,79,108,-29
11824,11824,110,2022/4/15 13:40:00,60,97,-37
11825,11825,110,2022/4/15 13:50:00,53,117,-64
11826,11826,110,2022/4/15 14:00:00,108,123,-15
11827,11827,110,2022/4/15 14:10:00,70,117,-47
11828,11828,110,2022/4/15 14:20:00,56,109,-53
11829,11829,110,2022/4/15 14:30:00,68,102,-34
11830,11830,110,2022/4/15 14:40:00,41,121,-80
11831,11831,110,2022/4/15 14:50:00,61,129,-68
11832,11832,110,2022/4/15 15:00:00,78,114,-36
11833,11833,110,2022/4/15 15:10:00,112,104,8
11834,11834,110,2022/4/15 15:20:00,63,117,-54
11835,11835,110,2022/4/15 15:30:00,89,120,-31
11836,11836,110,2022/4/15 15:40:00,51,150,-99
11837,11837,110,2022/4/15 15:50:00,68,172,-104
11838,11838,110,2022/4/15 16:00:00,96,168,-72
11839,11839,110,2022/4/15 16:10:00,194,169,25
11840,11840,110,2022/4/15 16:20:00,74,156,-82
11841,11841,110,2022/4/15 16:30:00,94,160,-66
11842,11842,110,2022/4/15 16:40:00,177,191,-14
11843,11843,110,2022/4/15 16:50:00,202,225,-23
11844,11844,110,2022/4/15 17:00:00,240,213,27
11845,11845,110,2022/4/15 17:10:00,270,251,19
11846,11846,110,2022/4/15 17:20:00,207,295,-88
11847,11847,110,2022/4/15 17:30:00,262,301,-39
11848,11848,110,2022/4/15 17:40:00,238,427,-189
11849,11849,110,2022/4/15 17:50:00,228,401,-173
11850,11850,110,2022/4/15 18:00:00,270,515,-245
11851,11851,110,2022/4/15 18:10:00,256,471,-215
11852,11852,110,2022/4/15 18:20:00,227,471,-244
11853,11853,110,2022/4/15 18:30:00,209,420,-211
11854,11854,110,2022/4/15 18:40:00,153,414,-261
11855,11855,110,2022/4/15 18:50:00,125,366,-241
11856,11856,110,2022/4/15 19:00:00,85,417,-332
11857,11857,110,2022/4/15 19:10:00,50,322,-272
11858,11858,110,2022/4/15 19:20:00,45,285,-240
11859,11859,110,2022/4/15 19:30:00,44,219,-175
11860,11860,110,2022/4/15 19:40:00,36,191,-155
11861,11861,110,2022/4/15 19:50:00,40,150,-110
11862,11862,110,2022/4/15 20:00:00,39,109,-70
11863,11863,110,2022/4/15 20:10:00,33,137,-104
11864,11864,110,2022/4/15 20:20:00,42,151,-109
11865,11865,110,2022/4/15 20:30:00,37,110,-73
11866,11866,110,2022/4/15 20:40:00,64,122,-58
11867,11867,110,2022/4/15 20:50:00,56,119,-63
11868,11868,110,2022/4/15 21:00:00,131,111,20
11869,11869,110,2022/4/15 21:10:00,56,115,-59
11870,11870,110,2022/4/15 21:20:00,31,106,-75
11871,11871,110,2022/4/15 21:30:00,28,108,-80
11872,11872,110,2022/4/15 21:40:00,24,124,-100
11873,11873,110,2022/4/15 21:50:00,25,118,-93
11874,11874,110,2022/4/15 22:00:00,30,102,-72
11875,11875,110,2022/4/15 22:10:00,25,105,-80
11876,11876,110,2022/4/15 22:20:00,15,120,-105
11877,11877,110,2022/4/15 22:30:00,18,112,-94
11878,11878,110,2022/4/15 22:40:00,3,82,-79
11879,11879,110,2022/4/15 22:50:00,0,69,-69
11880,11880,111,2022/4/15 5:00:00,0,1,-1
11881,11881,111,2022/4/15 5:10:00,4,1,3
11882,11882,111,2022/4/15 5:20:00,6,1,5
11883,11883,111,2022/4/15 5:30:00,6,1,5
11884,11884,111,2022/4/15 5:40:00,7,13,-6
11885,11885,111,2022/4/15 5:50:00,13,12,1
11886,11886,111,2022/4/15 6:00:00,16,21,-5
11887,11887,111,2022/4/15 6:10:00,18,38,-20
11888,11888,111,2022/4/15 6:20:00,22,45,-23
11889,11889,111,2022/4/15 6:30:00,31,76,-45
11890,11890,111,2022/4/15 6:40:00,32,111,-79
11891,11891,111,2022/4/15 6:50:00,47,112,-65
11892,11892,111,2022/4/15 7:00:00,47,127,-80
11893,11893,111,2022/4/15 7:10:00,57,114,-57
11894,11894,111,2022/4/15 7:20:00,63,108,-45
11895,11895,111,2022/4/15 7:30:00,88,144,-56
11896,11896,111,2022/4/15 7:40:00,95,192,-97
11897,11897,111,2022/4/15 7:50:00,187,326,-139
11898,11898,111,2022/4/15 8:00:00,194,508,-314
11899,11899,111,2022/4/15 8:10:00,230,564,-334
11900,11900,111,2022/4/15 8:20:00,213,418,-205
11901,11901,111,2022/4/15 8:30:00,169,1128,-959
11902,11902,111,2022/4/15 8:40:00,143,1565,-1422
11903,11903,111,2022/4/15 8:50:00,87,595,-508
11904,11904,111,2022/4/15 9:00:00,71,424,-353
11905,11905,111,2022/4/15 9:10:00,65,500,-435
11906,11906,111,2022/4/15 9:20:00,46,377,-331
11907,11907,111,2022/4/15 9:30:00,43,298,-255
11908,11908,111,2022/4/15 9:40:00,38,179,-141
11909,11909,111,2022/4/15 9:50:00,39,151,-112
11910,11910,111,2022/4/15 10:00:00,34,125,-91
11911,11911,111,2022/4/15 10:10:00,37,109,-72
11912,11912,111,2022/4/15 10:20:00,34,121,-87
11913,11913,111,2022/4/15 10:30:00,35,115,-80
11914,11914,111,2022/4/15 10:40:00,31,120,-89
11915,11915,111,2022/4/15 10:50:00,33,100,-67
11916,11916,111,2022/4/15 11:00:00,30,125,-95
11917,11917,111,2022/4/15 11:10:00,30,99,-69
11918,11918,111,2022/4/15 11:20:00,26,108,-82
11919,11919,111,2022/4/15 11:30:00,31,88,-57
11920,11920,111,2022/4/15 11:40:00,32,84,-52
11921,11921,111,2022/4/15 11:50:00,36,102,-66
11922,11922,111,2022/4/15 12:00:00,36,126,-90
11923,11923,111,2022/4/15 12:10:00,35,108,-73
11924,11924,111,2022/4/15 12:20:00,37,122,-85
11925,11925,111,2022/4/15 12:30:00,38,122,-84
11926,11926,111,2022/4/15 12:40:00,40,117,-77
11927,11927,111,2022/4/15 12:50:00,38,103,-65
11928,11928,111,2022/4/15 13:00:00,39,125,-86
11929,11929,111,2022/4/15 13:10:00,42,109,-67
11930,11930,111,2022/4/15 13:20:00,37,119,-82
11931,11931,111,2022/4/15 13:30:00,40,114,-74
11932,11932,111,2022/4/15 13:40:00,41,104,-63
11933,11933,111,2022/4/15 13:50:00,43,106,-63
11934,11934,111,2022/4/15 14:00:00,38,100,-62
11935,11935,111,2022/4/15 14:10:00,38,120,-82
11936,11936,111,2022/4/15 14:20:00,41,116,-75
11937,11937,111,2022/4/15 14:30:00,41,124,-83
11938,11938,111,2022/4/15 14:40:00,44,123,-79
11939,11939,111,2022/4/15 14:50:00,48,102,-54
11940,11940,111,2022/4/15 15:00:00,41,104,-63
11941,11941,111,2022/4/15 15:10:00,41,122,-81
11942,11942,111,2022/4/15 15:20:00,42,109,-67
11943,11943,111,2022/4/15 15:30:00,43,126,-83
11944,11944,111,2022/4/15 15:40:00,42,126,-84
11945,11945,111,2022/4/15 15:50:00,46,103,-57
11946,11946,111,2022/4/15 16:00:00,45,102,-57
11947,11947,111,2022/4/15 16:10:00,47,108,-61
11948,11948,111,2022/4/15 16:20:00,62,121,-59
11949,11949,111,2022/4/15 16:30:00,67,103,-36
11950,11950,111,2022/4/15 16:40:00,104,110,-6
11951,11951,111,2022/4/15 16:50:00,80,117,-37
11952,11952,111,2022/4/15 17:00:00,163,127,36
11953,11953,111,2022/4/15 17:10:00,236,152,84
11954,11954,111,2022/4/15 17:20:00,214,178,36
11955,11955,111,2022/4/15 17:30:00,247,207,40
11956,11956,111,2022/4/15 17:40:00,551,224,327
11957,11957,111,2022/4/15 17:50:00,324,268,56
11958,11958,111,2022/4/15 18:00:00,259,320,-61
11959,11959,111,2022/4/15 18:10:00,421,255,166
11960,11960,111,2022/4/15 18:20:00,305,320,-15
11961,11961,111,2022/4/15 18:30:00,216,322,-106
11962,11962,111,2022/4/15 18:40:00,198,308,-110
11963,11963,111,2022/4/15 18:50:00,174,287,-113
11964,11964,111,2022/4/15 19:00:00,77,215,-138
11965,11965,111,2022/4/15 19:10:00,70,109,-39
11966,11966,111,2022/4/15 19:20:00,56,117,-61
11967,11967,111,2022/4/15 19:30:00,46,122,-76
11968,11968,111,2022/4/15 19:40:00,45,121,-76
11969,11969,111,2022/4/15 19:50:00,35,114,-79
11970,11970,111,2022/4/15 20:00:00,37,108,-71
11971,11971,111,2022/4/15 20:10:00,35,111,-76
11972,11972,111,2022/4/15 20:20:00,36,100,-64
11973,11973,111,2022/4/15 20:30:00,35,92,-57
11974,11974,111,2022/4/15 20:40:00,37,100,-63
11975,11975,111,2022/4/15 20:50:00,35,95,-60
11976,11976,111,2022/4/15 21:00:00,37,95,-58
11977,11977,111,2022/4/15 21:10:00,40,89,-49
11978,11978,111,2022/4/15 21:20:00,30,94,-64
11979,11979,111,2022/4/15 21:30:00,31,97,-66
11980,11980,111,2022/4/15 21:40:00,29,99,-70
11981,11981,111,2022/4/15 21:50:00,24,92,-68
11982,11982,111,2022/4/15 22:00:00,37,94,-57
11983,11983,111,2022/4/15 22:10:00,24,89,-65
11984,11984,111,2022/4/15 22:20:00,20,92,-72
11985,11985,111,2022/4/15 22:30:00,13,89,-76
11986,11986,111,2022/4/15 22:40:00,9,66,-57
11987,11987,111,2022/4/15 22:50:00,6,64,-58
11988,11988,112,2022/4/15 5:00:00,5,1,4
11989,11989,112,2022/4/15 5:10:00,24,1,23
11990,11990,112,2022/4/15 5:20:00,45,1,44
11991,11991,112,2022/4/15 5:30:00,34,2,32
11992,11992,112,2022/4/15 5:40:00,57,1,56
11993,11993,112,2022/4/15 5:50:00,109,1,108
11994,11994,112,2022/4/15 6:00:00,173,67,106
11995,11995,112,2022/4/15 6:10:00,390,56,334
11996,11996,112,2022/4/15 6:20:00,598,111,487
11997,11997,112,2022/4/15 6:30:00,742,108,634
11998,11998,112,2022/4/15 6:40:00,1401,191,1210
11999,11999,112,2022/4/15 6:50:00,1399,340,1059
12000,12000,112,2022/4/15 7:00:00,1993,429,1564
12001,12001,112,2022/4/15 7:10:00,3074,430,2644
12002,12002,112,2022/4/15 7:20:00,3335,415,2920
12003,12003,112,2022/4/15 7:30:00,3430,568,2862
12004,12004,112,2022/4/15 7:40:00,3426,1130,2296
12005,12005,112,2022/4/15 7:50:00,3540,1121,2419
12006,12006,112,2022/4/15 8:00:00,3462,1514,1948
12007,12007,112,2022/4/15 8:10:00,3429,1467,1962
12008,12008,112,2022/4/15 8:20:00,3357,1498,1859
12009,12009,112,2022/4/15 8:30:00,3407,1711,1696
12010,12010,112,2022/4/15 8:40:00,3092,1435,1657
12011,12011,112,2022/4/15 8:50:00,2550,552,1998
12012,12012,112,2022/4/15 9:00:00,1976,426,1550
12013,12013,112,2022/4/15 9:10:00,1709,433,1276
12014,12014,112,2022/4/15 9:20:00,1347,490,857
12015,12015,112,2022/4/15 9:30:00,1151,516,635
12016,12016,112,2022/4/15 9:40:00,811,316,495
12017,12017,112,2022/4/15 9:50:00,672,343,329
12018,12018,112,2022/4/15 10:00:00,701,320,381
12019,12019,112,2022/4/15 10:10:00,608,221,387
12020,12020,112,2022/4/15 10:20:00,577,333,244
12021,12021,112,2022/4/15 10:30:00,551,312,239
12022,12022,112,2022/4/15 10:40:00,377,268,109
12023,12023,112,2022/4/15 10:50:00,455,221,234
12024,12024,112,2022/4/15 11:00:00,325,266,59
12025,12025,112,2022/4/15 11:10:00,309,318,-9
12026,12026,112,2022/4/15 11:20:00,372,297,75
12027,12027,112,2022/4/15 11:30:00,332,297,35
12028,12028,112,2022/4/15 11:40:00,336,332,4
12029,12029,112,2022/4/15 11:50:00,366,318,48
12030,12030,112,2022/4/15 12:00:00,462,290,172
12031,12031,112,2022/4/15 12:10:00,544,317,227
12032,12032,112,2022/4/15 12:20:00,576,326,250
12033,12033,112,2022/4/15 12:30:00,580,327,253
12034,12034,112,2022/4/15 12:40:00,576,341,235
12035,12035,112,2022/4/15 12:50:00,426,339,87
12036,12036,112,2022/4/15 13:00:00,563,309,254
12037,12037,112,2022/4/15 13:10:00,421,427,-6
12038,12038,112,2022/4/15 13:20:00,455,288,167
12039,12039,112,2022/4/15 13:30:00,367,378,-11
12040,12040,112,2022/4/15 13:40:00,308,320,-12
12041,12041,112,2022/4/15 13:50:00,308,357,-49
12042,12042,112,2022/4/15 14:00:00,308,318,-10
12043,12043,112,2022/4/15 14:10:00,327,376,-49
12044,12044,112,2022/4/15 14:20:00,309,325,-16
12045,12045,112,2022/4/15 14:30:00,335,432,-97
12046,12046,112,2022/4/15 14:40:00,333,430,-97
12047,12047,112,2022/4/15 14:50:00,334,377,-43
12048,12048,112,2022/4/15 15:00:00,345,364,-19
12049,12049,112,2022/4/15 15:10:00,327,417,-90
12050,12050,112,2022/4/15 15:20:00,339,337,2
12051,12051,112,2022/4/15 15:30:00,326,428,-102
12052,12052,112,2022/4/15 15:40:00,308,486,-178
12053,12053,112,2022/4/15 15:50:00,371,427,-56
12054,12054,112,2022/4/15 16:00:00,313,419,-106
12055,12055,112,2022/4/15 16:10:00,457,472,-15
12056,12056,112,2022/4/15 16:20:00,580,413,167
12057,12057,112,2022/4/15 16:30:00,623,582,41
12058,12058,112,2022/4/15 16:40:00,635,570,65
12059,12059,112,2022/4/15 16:50:00,673,1140,-467
12060,12060,112,2022/4/15 17:00:00,804,1081,-277
12061,12061,112,2022/4/15 17:10:00,1157,1696,-539
12062,12062,112,2022/4/15 17:20:00,1034,1730,-696
12063,12063,112,2022/4/15 17:30:00,1158,1683,-525
12064,12064,112,2022/4/15 17:40:00,1369,2409,-1040
12065,12065,112,2022/4/15 17:50:00,1396,2295,-899
12066,12066,112,2022/4/15 18:00:00,1160,3869,-2709
12067,12067,112,2022/4/15 18:10:00,1215,1746,-531
12068,12068,112,2022/4/15 18:20:00,1025,3586,-2561
12069,12069,112,2022/4/15 18:30:00,812,4338,-3526
12070,12070,112,2022/4/15 18:40:00,672,2859,-2187
12071,12071,112,2022/4/15 18:50:00,607,5038,-4431
12072,12072,112,2022/4/15 19:00:00,455,4584,-4129
12073,12073,112,2022/4/15 19:10:00,345,2076,-1731
12074,12074,112,2022/4/15 19:20:00,303,2359,-2056
12075,12075,112,2022/4/15 19:30:00,269,1824,-1555
12076,12076,112,2022/4/15 19:40:00,263,1572,-1309
12077,12077,112,2022/4/15 19:50:00,225,593,-368
12078,12078,112,2022/4/15 20:00:00,217,574,-357
12079,12079,112,2022/4/15 20:10:00,263,424,-161
12080,12080,112,2022/4/15 20:20:00,273,378,-105
12081,12081,112,2022/4/15 20:30:00,235,485,-250
12082,12082,112,2022/4/15 20:40:00,230,425,-195
12083,12083,112,2022/4/15 20:50:00,267,427,-160
12084,12084,112,2022/4/15 21:00:00,228,502,-274
12085,12085,112,2022/4/15 21:10:00,275,519,-244
12086,12086,112,2022/4/15 21:20:00,229,504,-275
12087,12087,112,2022/4/15 21:30:00,198,360,-162
12088,12088,112,2022/4/15 21:40:00,190,416,-226
12089,12089,112,2022/4/15 21:50:00,143,495,-352
12090,12090,112,2022/4/15 22:00:00,138,371,-233
12091,12091,112,2022/4/15 22:10:00,183,339,-156
12092,12092,112,2022/4/15 22:20:00,33,323,-290
12093,12093,112,2022/4/15 22:30:00,2,431,-429
12094,12094,112,2022/4/15 22:40:00,2,374,-372
12095,12095,112,2022/4/15 22:50:00,2,297,-295
12096,12096,113,2022/4/15 5:00:00,0,1,-1
12097,12097,113,2022/4/15 5:10:00,5,1,4
12098,12098,113,2022/4/15 5:20:00,20,1,19
12099,12099,113,2022/4/15 5:30:00,50,1,49
12100,12100,113,2022/4/15 5:40:00,65,6,59
12101,12101,113,2022/4/15 5:50:00,99,14,85
12102,12102,113,2022/4/15 6:00:00,187,38,149
12103,12103,113,2022/4/15 6:10:00,277,33,244
12104,12104,113,2022/4/15 6:20:00,360,46,314
12105,12105,113,2022/4/15 6:30:00,574,51,523
12106,12106,113,2022/4/15 6:40:00,687,67,620
12107,12107,113,2022/4/15 6:50:00,866,80,786
12108,12108,113,2022/4/15 7:00:00,1177,75,1102
12109,12109,113,2022/4/15 7:10:00,1367,73,1294
12110,12110,113,2022/4/15 7:20:00,1983,112,1871
12111,12111,113,2022/4/15 7:30:00,1990,111,1879
12112,12112,113,2022/4/15 7:40:00,2479,105,2374
12113,12113,113,2022/4/15 7:50:00,2560,111,2449
12114,12114,113,2022/4/15 8:00:00,2570,104,2466
12115,12115,113,2022/4/15 8:10:00,2557,110,2447
12116,12116,113,2022/4/15 8:20:00,1990,107,1883
12117,12117,113,2022/4/15 8:30:00,1550,107,1443
12118,12118,113,2022/4/15 8:40:00,1215,107,1108
12119,12119,113,2022/4/15 8:50:00,858,97,761
12120,12120,113,2022/4/15 9:00:00,709,101,608
12121,12121,113,2022/4/15 9:10:00,578,90,488
12122,12122,113,2022/4/15 9:20:00,339,105,234
12123,12123,113,2022/4/15 9:30:00,275,91,184
12124,12124,113,2022/4/15 9:40:00,237,80,157
12125,12125,113,2022/4/15 9:50:00,205,104,101
12126,12126,113,2022/4/15 10:00:00,174,96,78
12127,12127,113,2022/4/15 10:10:00,147,87,60
12128,12128,113,2022/4/15 10:20:00,81,110,-29
12129,12129,113,2022/4/15 10:30:00,77,110,-33
12130,12130,113,2022/4/15 10:40:00,75,80,-5
12131,12131,113,2022/4/15 10:50:00,70,106,-36
12132,12132,113,2022/4/15 11:00:00,66,96,-30
12133,12133,113,2022/4/15 11:10:00,74,90,-16
12134,12134,113,2022/4/15 11:20:00,64,84,-20
12135,12135,113,2022/4/15 11:30:00,59,107,-48
12136,12136,113,2022/4/15 11:40:00,72,112,-40
12137,12137,113,2022/4/15 11:50:00,114,108,6
12138,12138,113,2022/4/15 12:00:00,75,90,-15
12139,12139,113,2022/4/15 12:10:00,93,77,16
12140,12140,113,2022/4/15 12:20:00,96,106,-10
12141,12141,113,2022/4/15 12:30:00,86,104,-18
12142,12142,113,2022/4/15 12:40:00,75,95,-20
12143,12143,113,2022/4/15 12:50:00,77,101,-24
12144,12144,113,2022/4/15 13:00:00,70,100,-30
12145,12145,113,2022/4/15 13:10:00,74,96,-22
12146,12146,113,2022/4/15 13:20:00,63,105,-42
12147,12147,113,2022/4/15 13:30:00,65,102,-37
12148,12148,113,2022/4/15 13:40:00,48,105,-57
12149,12149,113,2022/4/15 13:50:00,57,102,-45
12150,12150,113,2022/4/15 14:00:00,43,103,-60
12151,12151,113,2022/4/15 14:10:00,42,96,-54
12152,12152,113,2022/4/15 14:20:00,45,119,-74
12153,12153,113,2022/4/15 14:30:00,45,108,-63
12154,12154,113,2022/4/15 14:40:00,45,124,-79
12155,12155,113,2022/4/15 14:50:00,46,111,-65
12156,12156,113,2022/4/15 15:00:00,41,110,-69
12157,12157,113,2022/4/15 15:10:00,48,104,-56
12158,12158,113,2022/4/15 15:20:00,44,124,-80
12159,12159,113,2022/4/15 15:30:00,41,118,-77
12160,12160,113,2022/4/15 15:40:00,44,159,-115
12161,12161,113,2022/4/15 15:50:00,43,111,-68
12162,12162,113,2022/4/15 16:00:00,44,192,-148
12163,12163,113,2022/4/15 16:10:00,49,109,-60
12164,12164,113,2022/4/15 16:20:00,54,192,-138
12165,12165,113,2022/4/15 16:30:00,66,198,-132
12166,12166,113,2022/4/15 16:40:00,68,234,-166
12167,12167,113,2022/4/15 16:50:00,66,181,-115
12168,12168,113,2022/4/15 17:00:00,71,295,-224
12169,12169,113,2022/4/15 17:10:00,75,221,-146
12170,12170,113,2022/4/15 17:20:00,78,426,-348
12171,12171,113,2022/4/15 17:30:00,69,303,-234
12172,12172,113,2022/4/15 17:40:00,76,473,-397
12173,12173,113,2022/4/15 17:50:00,76,1140,-1064
12174,12174,113,2022/4/15 18:00:00,92,564,-472
12175,12175,113,2022/4/15 18:10:00,64,563,-499
12176,12176,113,2022/4/15 18:20:00,68,1589,-1521
12177,12177,113,2022/4/15 18:30:00,54,559,-505
12178,12178,113,2022/4/15 18:40:00,56,1915,-1859
12179,12179,113,2022/4/15 18:50:00,43,1067,-1024
12180,12180,113,2022/4/15 19:00:00,44,1164,-1120
12181,12181,113,2022/4/15 19:10:00,39,413,-374
12182,12182,113,2022/4/15 19:20:00,34,477,-443
12183,12183,113,2022/4/15 19:30:00,30,381,-351
12184,12184,113,2022/4/15 19:40:00,30,330,-300
12185,12185,113,2022/4/15 19:50:00,29,234,-205
12186,12186,113,2022/4/15 20:00:00,31,181,-150
12187,12187,113,2022/4/15 20:10:00,30,234,-204
12188,12188,113,2022/4/15 20:20:00,27,229,-202
12189,12189,113,2022/4/15 20:30:00,30,122,-92
12190,12190,113,2022/4/15 20:40:00,33,191,-158
12191,12191,113,2022/4/15 20:50:00,31,118,-87
12192,12192,113,2022/4/15 21:00:00,32,179,-147
12193,12193,113,2022/4/15 21:10:00,31,126,-95
12194,12194,113,2022/4/15 21:20:00,26,184,-158
12195,12195,113,2022/4/15 21:30:00,26,121,-95
12196,12196,113,2022/4/15 21:40:00,26,111,-85
12197,12197,113,2022/4/15 21:50:00,23,137,-114
12198,12198,113,2022/4/15 22:00:00,26,111,-85
12199,12199,113,2022/4/15 22:10:00,22,124,-102
12200,12200,113,2022/4/15 22:20:00,21,155,-134
12201,12201,113,2022/4/15 22:30:00,16,130,-114
12202,12202,113,2022/4/15 22:40:00,5,202,-197
12203,12203,113,2022/4/15 22:50:00,6,114,-108
12204,12204,114,2022/4/15 5:00:00,0,1,-1
12205,12205,114,2022/4/15 5:10:00,3,1,2
12206,12206,114,2022/4/15 5:20:00,12,1,11
12207,12207,114,2022/4/15 5:30:00,13,1,12
12208,12208,114,2022/4/15 5:40:00,19,1,18
12209,12209,114,2022/4/15 5:50:00,25,1,24
12210,12210,114,2022/4/15 6:00:00,32,22,10
12211,12211,114,2022/4/15 6:10:00,48,14,34
12212,12212,114,2022/4/15 6:20:00,76,23,53
12213,12213,114,2022/4/15 6:30:00,128,38,90
12214,12214,114,2022/4/15 6:40:00,186,64,122
12215,12215,114,2022/4/15 6:50:00,245,69,176
12216,12216,114,2022/4/15 7:00:00,302,97,205
12217,12217,114,2022/4/15 7:10:00,474,98,376
12218,12218,114,2022/4/15 7:20:00,661,127,534
12219,12219,114,2022/4/15 7:30:00,820,146,674
12220,12220,114,2022/4/15 7:40:00,1062,109,953
12221,12221,114,2022/4/15 7:50:00,1374,104,1270
12222,12222,114,2022/4/15 8:00:00,1371,110,1261
12223,12223,114,2022/4/15 8:10:00,1173,113,1060
12224,12224,114,2022/4/15 8:20:00,874,97,777
12225,12225,114,2022/4/15 8:30:00,818,104,714
12226,12226,114,2022/4/15 8:40:00,661,95,566
12227,12227,114,2022/4/15 8:50:00,570,83,487
12228,12228,114,2022/4/15 9:00:00,354,85,269
12229,12229,114,2022/4/15 9:10:00,278,72,206
12230,12230,114,2022/4/15 9:20:00,207,76,131
12231,12231,114,2022/4/15 9:30:00,141,71,70
12232,12232,114,2022/4/15 9:40:00,90,69,21
12233,12233,114,2022/4/15 9:50:00,71,66,5
12234,12234,114,2022/4/15 10:00:00,59,72,-13
12235,12235,114,2022/4/15 10:10:00,49,67,-18
12236,12236,114,2022/4/15 10:20:00,43,63,-20
12237,12237,114,2022/4/15 10:30:00,46,61,-15
12238,12238,114,2022/4/15 10:40:00,36,69,-33
12239,12239,114,2022/4/15 10:50:00,36,66,-30
12240,12240,114,2022/4/15 11:00:00,29,72,-43
12241,12241,114,2022/4/15 11:10:00,31,68,-37
12242,12242,114,2022/4/15 11:20:00,36,62,-26
12243,12243,114,2022/4/15 11:30:00,35,62,-27
12244,12244,114,2022/4/15 11:40:00,36,67,-31
12245,12245,114,2022/4/15 11:50:00,34,68,-34
12246,12246,114,2022/4/15 12:00:00,42,63,-21
12247,12247,114,2022/4/15 12:10:00,42,74,-32
12248,12248,114,2022/4/15 12:20:00,36,66,-30
12249,12249,114,2022/4/15 12:30:00,43,84,-41
12250,12250,114,2022/4/15 12:40:00,37,60,-23
12251,12251,114,2022/4/15 12:50:00,34,85,-51
12252,12252,114,2022/4/15 13:00:00,39,77,-38
12253,12253,114,2022/4/15 13:10:00,33,76,-43
12254,12254,114,2022/4/15 13:20:00,28,65,-37
12255,12255,114,2022/4/15 13:30:00,30,78,-48
12256,12256,114,2022/4/15 13:40:00,32,85,-53
12257,12257,114,2022/4/15 13:50:00,30,75,-45
12258,12258,114,2022/4/15 14:00:00,27,80,-53
12259,12259,114,2022/4/15 14:10:00,26,75,-49
12260,12260,114,2022/4/15 14:20:00,48,93,-45
12261,12261,114,2022/4/15 14:30:00,43,90,-47
12262,12262,114,2022/4/15 14:40:00,31,77,-46
12263,12263,114,2022/4/15 14:50:00,24,90,-66
12264,12264,114,2022/4/15 15:00:00,31,90,-59
12265,12265,114,2022/4/15 15:10:00,38,103,-65
12266,12266,114,2022/4/15 15:20:00,38,102,-64
12267,12267,114,2022/4/15 15:30:00,35,110,-75
12268,12268,114,2022/4/15 15:40:00,28,103,-75
12269,12269,114,2022/4/15 15:50:00,26,106,-80
12270,12270,114,2022/4/15 16:00:00,45,105,-60
12271,12271,114,2022/4/15 16:10:00,46,117,-71
12272,12272,114,2022/4/15 16:20:00,37,122,-85
12273,12273,114,2022/4/15 16:30:00,31,121,-90
12274,12274,114,2022/4/15 16:40:00,38,133,-95
12275,12275,114,2022/4/15 16:50:00,47,132,-85
12276,12276,114,2022/4/15 17:00:00,56,115,-59
12277,12277,114,2022/4/15 17:10:00,65,195,-130
12278,12278,114,2022/4/15 17:20:00,46,175,-129
12279,12279,114,2022/4/15 17:30:00,45,204,-159
12280,12280,114,2022/4/15 17:40:00,58,339,-281
12281,12281,114,2022/4/15 17:50:00,45,340,-295
12282,12282,114,2022/4/15 18:00:00,60,426,-366
12283,12283,114,2022/4/15 18:10:00,58,427,-369
12284,12284,114,2022/4/15 18:20:00,48,421,-373
12285,12285,114,2022/4/15 18:30:00,38,495,-457
12286,12286,114,2022/4/15 18:40:00,35,534,-499
12287,12287,114,2022/4/15 18:50:00,29,440,-411
12288,12288,114,2022/4/15 19:00:00,26,430,-404
12289,12289,114,2022/4/15 19:10:00,23,318,-295
12290,12290,114,2022/4/15 19:20:00,29,234,-205
12291,12291,114,2022/4/15 19:30:00,25,179,-154
12292,12292,114,2022/4/15 19:40:00,23,142,-119
12293,12293,114,2022/4/15 19:50:00,21,115,-94
12294,12294,114,2022/4/15 20:00:00,20,111,-91
12295,12295,114,2022/4/15 20:10:00,18,125,-107
12296,12296,114,2022/4/15 20:20:00,22,118,-96
12297,12297,114,2022/4/15 20:30:00,17,126,-109
12298,12298,114,2022/4/15 20:40:00,20,121,-101
12299,12299,114,2022/4/15 20:50:00,14,103,-89
12300,12300,114,2022/4/15 21:00:00,16,105,-89
12301,12301,114,2022/4/15 21:10:00,15,103,-88
12302,12302,114,2022/4/15 21:20:00,18,106,-88
12303,12303,114,2022/4/15 21:30:00,14,126,-112
12304,12304,114,2022/4/15 21:40:00,13,124,-111
12305,12305,114,2022/4/15 21:50:00,13,106,-93
12306,12306,114,2022/4/15 22:00:00,11,106,-95
12307,12307,114,2022/4/15 22:10:00,8,110,-102
12308,12308,114,2022/4/15 22:20:00,4,97,-93
12309,12309,114,2022/4/15 22:30:00,1,89,-88
12310,12310,114,2022/4/15 22:40:00,0,77,-77
12311,12311,114,2022/4/15 22:50:00,1,62,-61
12312,12312,115,2022/4/15 5:00:00,0,1,-1
12313,12313,115,2022/4/15 5:10:00,0,1,-1
12314,12314,115,2022/4/15 5:20:00,3,1,2
12315,12315,115,2022/4/15 5:30:00,5,1,4
12316,12316,115,2022/4/15 5:40:00,15,1,14
12317,12317,115,2022/4/15 5:50:00,16,50,-34
12318,12318,115,2022/4/15 6:00:00,21,46,-25
12319,12319,115,2022/4/15 6:10:00,27,66,-39
12320,12320,115,2022/4/15 6:20:00,36,62,-26
12321,12321,115,2022/4/15 6:30:00,42,76,-34
12322,12322,115,2022/4/15 6:40:00,55,61,-6
12323,12323,115,2022/4/15 6:50:00,88,111,-23
12324,12324,115,2022/4/15 7:00:00,108,112,-4
12325,12325,115,2022/4/15 7:10:00,155,104,51
12326,12326,115,2022/4/15 7:20:00,223,127,96
12327,12327,115,2022/4/15 7:30:00,285,180,105
12328,12328,115,2022/4/15 7:40:00,319,300,19
12329,12329,115,2022/4/15 7:50:00,299,335,-36
12330,12330,115,2022/4/15 8:00:00,358,1069,-711
12331,12331,115,2022/4/15 8:10:00,333,1845,-1512
12332,12332,115,2022/4/15 8:20:00,346,1484,-1138
12333,12333,115,2022/4/15 8:30:00,315,1058,-743
12334,12334,115,2022/4/15 8:40:00,277,1709,-1432
12335,12335,115,2022/4/15 8:50:00,238,546,-308
12336,12336,115,2022/4/15 9:00:00,191,421,-230
12337,12337,115,2022/4/15 9:10:00,172,339,-167
12338,12338,115,2022/4/15 9:20:00,152,375,-223
12339,12339,115,2022/4/15 9:30:00,78,191,-113
12340,12340,115,2022/4/15 9:40:00,65,171,-106
12341,12341,115,2022/4/15 9:50:00,62,127,-65
12342,12342,115,2022/4/15 10:00:00,60,109,-49
12343,12343,115,2022/4/15 10:10:00,61,123,-62
12344,12344,115,2022/4/15 10:20:00,54,97,-43
12345,12345,115,2022/4/15 10:30:00,58,120,-62
12346,12346,115,2022/4/15 10:40:00,59,104,-45
12347,12347,115,2022/4/15 10:50:00,59,105,-46
12348,12348,115,2022/4/15 11:00:00,54,87,-33
12349,12349,115,2022/4/15 11:10:00,59,112,-53
12350,12350,115,2022/4/15 11:20:00,58,105,-47
12351,12351,115,2022/4/15 11:30:00,57,112,-55
12352,12352,115,2022/4/15 11:40:00,61,89,-28
12353,12353,115,2022/4/15 11:50:00,50,87,-37
12354,12354,115,2022/4/15 12:00:00,55,91,-36
12355,12355,115,2022/4/15 12:10:00,62,107,-45
12356,12356,115,2022/4/15 12:20:00,66,103,-37
12357,12357,115,2022/4/15 12:30:00,62,104,-42
12358,12358,115,2022/4/15 12:40:00,59,102,-43
12359,12359,115,2022/4/15 12:50:00,61,105,-44
12360,12360,115,2022/4/15 13:00:00,63,102,-39
12361,12361,115,2022/4/15 13:10:00,60,120,-60
12362,12362,115,2022/4/15 13:20:00,57,120,-63
12363,12363,115,2022/4/15 13:30:00,52,107,-55
12364,12364,115,2022/4/15 13:40:00,65,119,-54
12365,12365,115,2022/4/15 13:50:00,52,100,-48
12366,12366,115,2022/4/15 14:00:00,65,109,-44
12367,12367,115,2022/4/15 14:10:00,77,119,-42
12368,12368,115,2022/4/15 14:20:00,62,119,-57
12369,12369,115,2022/4/15 14:30:00,68,100,-32
12370,12370,115,2022/4/15 14:40:00,66,84,-18
12371,12371,115,2022/4/15 14:50:00,64,102,-38
12372,12372,115,2022/4/15 15:00:00,83,111,-28
12373,12373,115,2022/4/15 15:10:00,76,103,-27
12374,12374,115,2022/4/15 15:20:00,89,126,-37
12375,12375,115,2022/4/15 15:30:00,71,98,-27
12376,12376,115,2022/4/15 15:40:00,82,112,-30
12377,12377,115,2022/4/15 15:50:00,138,102,36
12378,12378,115,2022/4/15 16:00:00,132,86,46
12379,12379,115,2022/4/15 16:10:00,157,110,47
12380,12380,115,2022/4/15 16:20:00,156,119,37
12381,12381,115,2022/4/15 16:30:00,242,99,143
12382,12382,115,2022/4/15 16:40:00,235,109,126
12383,12383,115,2022/4/15 16:50:00,227,99,128
12384,12384,115,2022/4/15 17:00:00,269,123,146
12385,12385,115,2022/4/15 17:10:00,694,106,588
12386,12386,115,2022/4/15 17:20:00,630,114,516
12387,12387,115,2022/4/15 17:30:00,550,121,429
12388,12388,115,2022/4/15 17:40:00,847,190,657
12389,12389,115,2022/4/15 17:50:00,1171,136,1035
12390,12390,115,2022/4/15 18:00:00,660,122,538
12391,12391,115,2022/4/15 18:10:00,838,222,616
12392,12392,115,2022/4/15 18:20:00,1044,110,934
12393,12393,115,2022/4/15 18:30:00,639,182,457
12394,12394,115,2022/4/15 18:40:00,455,181,274
12395,12395,115,2022/4/15 18:50:00,278,192,86
12396,12396,115,2022/4/15 19:00:00,198,105,93
12397,12397,115,2022/4/15 19:10:00,184,111,73
12398,12398,115,2022/4/15 19:20:00,115,120,-5
12399,12399,115,2022/4/15 19:30:00,77,101,-24
12400,12400,115,2022/4/15 19:40:00,72,106,-34
12401,12401,115,2022/4/15 19:50:00,67,106,-39
12402,12402,115,2022/4/15 20:00:00,46,77,-31
12403,12403,115,2022/4/15 20:10:00,50,97,-47
12404,12404,115,2022/4/15 20:20:00,43,72,-29
12405,12405,115,2022/4/15 20:30:00,39,85,-46
12406,12406,115,2022/4/15 20:40:00,42,76,-34
12407,12407,115,2022/4/15 20:50:00,39,84,-45
12408,12408,115,2022/4/15 21:00:00,30,62,-32
12409,12409,115,2022/4/15 21:10:00,33,74,-41
12410,12410,115,2022/4/15 21:20:00,26,74,-48
12411,12411,115,2022/4/15 21:30:00,27,65,-38
12412,12412,115,2022/4/15 21:40:00,28,70,-42
12413,12413,115,2022/4/15 21:50:00,26,74,-48
12414,12414,115,2022/4/15 22:00:00,25,64,-39
12415,12415,115,2022/4/15 22:10:00,28,67,-39
12416,12416,115,2022/4/15 22:20:00,20,66,-46
12417,12417,115,2022/4/15 22:30:00,16,71,-55
12418,12418,115,2022/4/15 22:40:00,11,62,-51
12419,12419,115,2022/4/15 22:50:00,6,52,-46
12420,12420,116,2022/4/15 5:00:00,1,1,0
12421,12421,116,2022/4/15 5:10:00,6,6,0
12422,12422,116,2022/4/15 5:20:00,7,5,2
12423,12423,116,2022/4/15 5:30:00,11,2,9
12424,12424,116,2022/4/15 5:40:00,16,5,11
12425,12425,116,2022/4/15 5:50:00,19,6,13
12426,12426,116,2022/4/15 6:00:00,26,42,-16
12427,12427,116,2022/4/15 6:10:00,30,47,-17
12428,12428,116,2022/4/15 6:20:00,31,38,-7
12429,12429,116,2022/4/15 6:30:00,40,65,-25
12430,12430,116,2022/4/15 6:40:00,49,62,-13
12431,12431,116,2022/4/15 6:50:00,57,93,-36
12432,12432,116,2022/4/15 7:00:00,67,106,-39
12433,12433,116,2022/4/15 7:10:00,70,107,-37
12434,12434,116,2022/4/15 7:20:00,86,119,-33
12435,12435,116,2022/4/15 7:30:00,84,126,-42
12436,12436,116,2022/4/15 7:40:00,104,147,-43
12437,12437,116,2022/4/15 7:50:00,162,197,-35
12438,12438,116,2022/4/15 8:00:00,183,296,-113
12439,12439,116,2022/4/15 8:10:00,204,431,-227
12440,12440,116,2022/4/15 8:20:00,199,432,-233
12441,12441,116,2022/4/15 8:30:00,188,431,-243
12442,12442,116,2022/4/15 8:40:00,179,578,-399
12443,12443,116,2022/4/15 8:50:00,155,425,-270
12444,12444,116,2022/4/15 9:00:00,136,502,-366
12445,12445,116,2022/4/15 9:10:00,105,317,-212
12446,12446,116,2022/4/15 9:20:00,79,266,-187
12447,12447,116,2022/4/15 9:30:00,74,178,-104
12448,12448,116,2022/4/15 9:40:00,62,149,-87
12449,12449,116,2022/4/15 9:50:00,59,116,-57
12450,12450,116,2022/4/15 10:00:00,48,117,-69
12451,12451,116,2022/4/15 10:10:00,45,110,-65
12452,12452,116,2022/4/15 10:20:00,49,113,-64
12453,12453,116,2022/4/15 10:30:00,47,106,-59
12454,12454,116,2022/4/15 10:40:00,45,108,-63
12455,12455,116,2022/4/15 10:50:00,42,91,-49
12456,12456,116,2022/4/15 11:00:00,40,96,-56
12457,12457,116,2022/4/15 11:10:00,41,87,-46
12458,12458,116,2022/4/15 11:20:00,41,90,-49
12459,12459,116,2022/4/15 11:30:00,43,77,-34
12460,12460,116,2022/4/15 11:40:00,43,93,-50
12461,12461,116,2022/4/15 11:50:00,40,81,-41
12462,12462,116,2022/4/15 12:00:00,45,74,-29
12463,12463,116,2022/4/15 12:10:00,48,90,-42
12464,12464,116,2022/4/15 12:20:00,45,105,-60
12465,12465,116,2022/4/15 12:30:00,45,98,-53
12466,12466,116,2022/4/15 12:40:00,47,90,-43
12467,12467,116,2022/4/15 12:50:00,43,109,-66
12468,12468,116,2022/4/15 13:00:00,45,98,-53
12469,12469,116,2022/4/15 13:10:00,48,108,-60
12470,12470,116,2022/4/15 13:20:00,44,103,-59
12471,12471,116,2022/4/15 13:30:00,45,93,-48
12472,12472,116,2022/4/15 13:40:00,44,109,-65
12473,12473,116,2022/4/15 13:50:00,44,90,-46
12474,12474,116,2022/4/15 14:00:00,48,91,-43
12475,12475,116,2022/4/15 14:10:00,50,96,-46
12476,12476,116,2022/4/15 14:20:00,49,88,-39
12477,12477,116,2022/4/15 14:30:00,42,99,-57
12478,12478,116,2022/4/15 14:40:00,48,82,-34
12479,12479,116,2022/4/15 14:50:00,45,93,-48
12480,12480,116,2022/4/15 15:00:00,69,86,-17
12481,12481,116,2022/4/15 15:10:00,61,93,-32
12482,12482,116,2022/4/15 15:20:00,66,91,-25
12483,12483,116,2022/4/15 15:30:00,61,97,-36
12484,12484,116,2022/4/15 15:40:00,65,93,-28
12485,12485,116,2022/4/15 15:50:00,69,101,-32
12486,12486,116,2022/4/15 16:00:00,83,88,-5
12487,12487,116,2022/4/15 16:10:00,128,96,32
12488,12488,116,2022/4/15 16:20:00,131,93,38
12489,12489,116,2022/4/15 16:30:00,147,109,38
12490,12490,116,2022/4/15 16:40:00,169,96,73
12491,12491,116,2022/4/15 16:50:00,190,109,81
12492,12492,116,2022/4/15 17:00:00,273,105,168
12493,12493,116,2022/4/15 17:10:00,269,112,157
12494,12494,116,2022/4/15 17:20:00,272,121,151
12495,12495,116,2022/4/15 17:30:00,425,100,325
12496,12496,116,2022/4/15 17:40:00,575,112,463
12497,12497,116,2022/4/15 17:50:00,311,106,205
12498,12498,116,2022/4/15 18:00:00,327,124,203
12499,12499,116,2022/4/15 18:10:00,550,123,427
12500,12500,116,2022/4/15 18:20:00,336,128,208
12501,12501,116,2022/4/15 18:30:00,275,107,168
12502,12502,116,2022/4/15 18:40:00,214,111,103
12503,12503,116,2022/4/15 18:50:00,170,113,57
12504,12504,116,2022/4/15 19:00:00,132,109,23
12505,12505,116,2022/4/15 19:10:00,105,107,-2
12506,12506,116,2022/4/15 19:20:00,70,102,-32
12507,12507,116,2022/4/15 19:30:00,55,99,-44
12508,12508,116,2022/4/15 19:40:00,50,81,-31
12509,12509,116,2022/4/15 19:50:00,40,86,-46
12510,12510,116,2022/4/15 20:00:00,41,76,-35
12511,12511,116,2022/4/15 20:10:00,42,77,-35
12512,12512,116,2022/4/15 20:20:00,40,83,-43
12513,12513,116,2022/4/15 20:30:00,43,83,-40
12514,12514,116,2022/4/15 20:40:00,34,78,-44
12515,12515,116,2022/4/15 20:50:00,34,79,-45
12516,12516,116,2022/4/15 21:00:00,42,73,-31
12517,12517,116,2022/4/15 21:10:00,40,77,-37
12518,12518,116,2022/4/15 21:20:00,37,74,-37
12519,12519,116,2022/4/15 21:30:00,31,79,-48
12520,12520,116,2022/4/15 21:40:00,27,93,-66
12521,12521,116,2022/4/15 21:50:00,27,69,-42
12522,12522,116,2022/4/15 22:00:00,25,77,-52
12523,12523,116,2022/4/15 22:10:00,27,78,-51
12524,12524,116,2022/4/15 22:20:00,23,100,-77
12525,12525,116,2022/4/15 22:30:00,17,78,-61
12526,12526,116,2022/4/15 22:40:00,15,75,-60
12527,12527,116,2022/4/15 22:50:00,10,68,-58
12528,12528,117,2022/4/15 5:00:00,2,1,1
12529,12529,117,2022/4/15 5:10:00,5,1,4
12530,12530,117,2022/4/15 5:20:00,7,1,6
12531,12531,117,2022/4/15 5:30:00,8,2,6
12532,12532,117,2022/4/15 5:40:00,15,22,-7
12533,12533,117,2022/4/15 5:50:00,22,16,6
12534,12534,117,2022/4/15 6:00:00,25,21,4
12535,12535,117,2022/4/15 6:10:00,32,68,-36
12536,12536,117,2022/4/15 6:20:00,32,70,-38
12537,12537,117,2022/4/15 6:30:00,36,104,-68
12538,12538,117,2022/4/15 6:40:00,58,114,-56
12539,12539,117,2022/4/15 6:50:00,60,159,-99
12540,12540,117,2022/4/15 7:00:00,85,195,-110
12541,12541,117,2022/4/15 7:10:00,128,435,-307
12542,12542,117,2022/4/15 7:20:00,157,435,-278
12543,12543,117,2022/4/15 7:30:00,215,509,-294
12544,12544,117,2022/4/15 7:40:00,234,421,-187
12545,12545,117,2022/4/15 7:50:00,279,588,-309
12546,12546,117,2022/4/15 8:00:00,277,1550,-1273
12547,12547,117,2022/4/15 8:10:00,346,3229,-2883
12548,12548,117,2022/4/15 8:20:00,344,4136,-3792
12549,12549,117,2022/4/15 8:30:00,334,6610,-6276
12550,12550,117,2022/4/15 8:40:00,316,7797,-7481
12551,12551,117,2022/4/15 8:50:00,286,6941,-6655
12552,12552,117,2022/4/15 9:00:00,277,6583,-6306
12553,12553,117,2022/4/15 9:10:00,260,4899,-4639
12554,12554,117,2022/4/15 9:20:00,239,2864,-2625
12555,12555,117,2022/4/15 9:30:00,232,2192,-1960
12556,12556,117,2022/4/15 9:40:00,225,1713,-1488
12557,12557,117,2022/4/15 9:50:00,207,1208,-1001
12558,12558,117,2022/4/15 10:00:00,223,556,-333
12559,12559,117,2022/4/15 10:10:00,232,416,-184
12560,12560,117,2022/4/15 10:20:00,254,434,-180
12561,12561,117,2022/4/15 10:30:00,273,422,-149
12562,12562,117,2022/4/15 10:40:00,269,425,-156
12563,12563,117,2022/4/15 10:50:00,274,427,-153
12564,12564,117,2022/4/15 11:00:00,271,315,-44
12565,12565,117,2022/4/15 11:10:00,270,518,-248
12566,12566,117,2022/4/15 11:20:00,268,378,-110
12567,12567,117,2022/4/15 11:30:00,270,532,-262
12568,12568,117,2022/4/15 11:40:00,303,432,-129
12569,12569,117,2022/4/15 11:50:00,335,434,-99
12570,12570,117,2022/4/15 12:00:00,334,373,-39
12571,12571,117,2022/4/15 12:10:00,326,317,9
12572,12572,117,2022/4/15 12:20:00,368,431,-63
12573,12573,117,2022/4/15 12:30:00,348,432,-84
12574,12574,117,2022/4/15 12:40:00,368,499,-131
12575,12575,117,2022/4/15 12:50:00,456,432,24
12576,12576,117,2022/4/15 13:00:00,570,532,38
12577,12577,117,2022/4/15 13:10:00,569,527,42
12578,12578,117,2022/4/15 13:20:00,578,531,47
12579,12579,117,2022/4/15 13:30:00,569,525,44
12580,12580,117,2022/4/15 13:40:00,569,500,69
12581,12581,117,2022/4/15 13:50:00,587,492,95
12582,12582,117,2022/4/15 14:00:00,609,431,178
12583,12583,117,2022/4/15 14:10:00,609,431,178
12584,12584,117,2022/4/15 14:20:00,592,433,159
12585,12585,117,2022/4/15 14:30:00,620,376,244
12586,12586,117,2022/4/15 14:40:00,587,379,208
12587,12587,117,2022/4/15 14:50:00,587,319,268
12588,12588,117,2022/4/15 15:00:00,637,431,206
12589,12589,117,2022/4/15 15:10:00,638,339,299
12590,12590,117,2022/4/15 15:20:00,648,315,333
12591,12591,117,2022/4/15 15:30:00,657,319,338
12592,12592,117,2022/4/15 15:40:00,673,377,296
12593,12593,117,2022/4/15 15:50:00,680,332,348
12594,12594,117,2022/4/15 16:00:00,807,372,435
12595,12595,117,2022/4/15 16:10:00,832,378,454
12596,12596,117,2022/4/15 16:20:00,845,371,474
12597,12597,117,2022/4/15 16:30:00,1151,374,777
12598,12598,117,2022/4/15 16:40:00,1160,377,783
12599,12599,117,2022/4/15 16:50:00,1169,520,649
12600,12600,117,2022/4/15 17:00:00,1584,489,1095
12601,12601,117,2022/4/15 17:10:00,1973,425,1548
12602,12602,117,2022/4/15 17:20:00,1966,402,1564
12603,12603,117,2022/4/15 17:30:00,2477,558,1919
12604,12604,117,2022/4/15 17:40:00,3302,561,2741
12605,12605,117,2022/4/15 17:50:00,1989,584,1405
12606,12606,117,2022/4/15 18:00:00,2546,1091,1455
12607,12607,117,2022/4/15 18:10:00,3366,1094,2272
12608,12608,117,2022/4/15 18:20:00,2539,1090,1449
12609,12609,117,2022/4/15 18:30:00,1982,1089,893
12610,12610,117,2022/4/15 18:40:00,1969,1096,873
12611,12611,117,2022/4/15 18:50:00,1583,558,1025
12612,12612,117,2022/4/15 19:00:00,1366,419,947
12613,12613,117,2022/4/15 19:10:00,1197,427,770
12614,12614,117,2022/4/15 19:20:00,1148,314,834
12615,12615,117,2022/4/15 19:30:00,1035,314,721
12616,12616,117,2022/4/15 19:40:00,823,233,590
12617,12617,117,2022/4/15 19:50:00,806,183,623
12618,12618,117,2022/4/15 20:00:00,1027,159,868
12619,12619,117,2022/4/15 20:10:00,835,114,721
12620,12620,117,2022/4/15 20:20:00,821,108,713
12621,12621,117,2022/4/15 20:30:00,1027,122,905
12622,12622,117,2022/4/15 20:40:00,1019,101,918
12623,12623,117,2022/4/15 20:50:00,837,101,736
12624,12624,117,2022/4/15 21:00:00,1257,121,1136
12625,12625,117,2022/4/15 21:10:00,1218,105,1113
12626,12626,117,2022/4/15 21:20:00,827,117,710
12627,12627,117,2022/4/15 21:30:00,1208,86,1122
12628,12628,117,2022/4/15 21:40:00,812,88,724
12629,12629,117,2022/4/15 21:50:00,647,111,536
12630,12630,117,2022/4/15 22:00:00,1649,111,1538
12631,12631,117,2022/4/15 22:10:00,1028,105,923
12632,12632,117,2022/4/15 22:20:00,608,107,501
12633,12633,117,2022/4/15 22:30:00,75,74,1
12634,12634,117,2022/4/15 22:40:00,31,67,-36
12635,12635,117,2022/4/15 22:50:00,15,71,-56
12636,12636,118,2022/4/15 5:00:00,0,1,-1
12637,12637,118,2022/4/15 5:10:00,0,1,-1
12638,12638,118,2022/4/15 5:20:00,0,1,-1
12639,12639,118,2022/4/15 5:30:00,16,1,15
12640,12640,118,2022/4/15 5:40:00,28,12,16
12641,12641,118,2022/4/15 5:50:00,32,32,0
12642,12642,118,2022/4/15 6:00:00,41,38,3
12643,12643,118,2022/4/15 6:10:00,58,56,2
12644,12644,118,2022/4/15 6:20:00,83,83,0
12645,12645,118,2022/4/15 6:30:00,157,93,64
12646,12646,118,2022/4/15 6:40:00,234,117,117
12647,12647,118,2022/4/15 6:50:00,247,108,139
12648,12648,118,2022/4/15 7:00:00,322,336,-14
12649,12649,118,2022/4/15 7:10:00,367,378,-11
12650,12650,118,2022/4/15 7:20:00,440,297,143
12651,12651,118,2022/4/15 7:30:00,688,331,357
12652,12652,118,2022/4/15 7:40:00,1057,320,737
12653,12653,118,2022/4/15 7:50:00,1055,377,678
12654,12654,118,2022/4/15 8:00:00,1190,296,894
12655,12655,118,2022/4/15 8:10:00,1181,371,810
12656,12656,118,2022/4/15 8:20:00,1183,330,853
12657,12657,118,2022/4/15 8:30:00,1054,493,561
12658,12658,118,2022/4/15 8:40:00,829,338,491
12659,12659,118,2022/4/15 8:50:00,721,526,195
12660,12660,118,2022/4/15 9:00:00,579,327,252
12661,12661,118,2022/4/15 9:10:00,466,377,89
12662,12662,118,2022/4/15 9:20:00,351,206,145
12663,12663,118,2022/4/15 9:30:00,277,290,-13
12664,12664,118,2022/4/15 9:40:00,247,152,95
12665,12665,118,2022/4/15 9:50:00,227,179,48
12666,12666,118,2022/4/15 10:00:00,213,142,71
12667,12667,118,2022/4/15 10:10:00,208,118,90
12668,12668,118,2022/4/15 10:20:00,176,108,68
12669,12669,118,2022/4/15 10:30:00,173,100,73
12670,12670,118,2022/4/15 10:40:00,173,117,56
12671,12671,118,2022/4/15 10:50:00,148,111,37
12672,12672,118,2022/4/15 11:00:00,169,106,63
12673,12673,118,2022/4/15 11:10:00,160,121,39
12674,12674,118,2022/4/15 11:20:00,173,110,63
12675,12675,118,2022/4/15 11:30:00,173,102,71
12676,12676,118,2022/4/15 11:40:00,153,120,33
12677,12677,118,2022/4/15 11:50:00,166,117,49
12678,12678,118,2022/4/15 12:00:00,167,120,47
12679,12679,118,2022/4/15 12:10:00,161,100,61
12680,12680,118,2022/4/15 12:20:00,168,102,66
12681,12681,118,2022/4/15 12:30:00,142,104,38
12682,12682,118,2022/4/15 12:40:00,144,128,16
12683,12683,118,2022/4/15 12:50:00,137,109,28
12684,12684,118,2022/4/15 13:00:00,141,119,22
12685,12685,118,2022/4/15 13:10:00,161,108,53
12686,12686,118,2022/4/15 13:20:00,173,121,52
12687,12687,118,2022/4/15 13:30:00,156,120,36
12688,12688,118,2022/4/15 13:40:00,176,128,48
12689,12689,118,2022/4/15 13:50:00,166,109,57
12690,12690,118,2022/4/15 14:00:00,156,110,46
12691,12691,118,2022/4/15 14:10:00,174,119,55
12692,12692,118,2022/4/15 14:20:00,176,107,69
12693,12693,118,2022/4/15 14:30:00,174,109,65
12694,12694,118,2022/4/15 14:40:00,175,169,6
12695,12695,118,2022/4/15 14:50:00,185,114,71
12696,12696,118,2022/4/15 15:00:00,271,131,140
12697,12697,118,2022/4/15 15:10:00,258,100,158
12698,12698,118,2022/4/15 15:20:00,236,138,98
12699,12699,118,2022/4/15 15:30:00,219,117,102
12700,12700,118,2022/4/15 15:40:00,260,138,122
12701,12701,118,2022/4/15 15:50:00,244,119,125
12702,12702,118,2022/4/15 16:00:00,225,127,98
12703,12703,118,2022/4/15 16:10:00,223,127,96
12704,12704,118,2022/4/15 16:20:00,228,118,110
12705,12705,118,2022/4/15 16:30:00,266,170,96
12706,12706,118,2022/4/15 16:40:00,305,226,79
12707,12707,118,2022/4/15 16:50:00,274,108,166
12708,12708,118,2022/4/15 17:00:00,311,193,118
12709,12709,118,2022/4/15 17:10:00,577,227,350
12710,12710,118,2022/4/15 17:20:00,325,325,0
12711,12711,118,2022/4/15 17:30:00,328,479,-151
12712,12712,118,2022/4/15 17:40:00,576,428,148
12713,12713,118,2022/4/15 17:50:00,311,410,-99
12714,12714,118,2022/4/15 18:00:00,308,564,-256
12715,12715,118,2022/4/15 18:10:00,568,520,48
12716,12716,118,2022/4/15 18:20:00,321,406,-85
12717,12717,118,2022/4/15 18:30:00,316,559,-243
12718,12718,118,2022/4/15 18:40:00,271,470,-199
12719,12719,118,2022/4/15 18:50:00,214,367,-153
12720,12720,118,2022/4/15 19:00:00,208,433,-225
12721,12721,118,2022/4/15 19:10:00,206,328,-122
12722,12722,118,2022/4/15 19:20:00,156,383,-227
12723,12723,118,2022/4/15 19:30:00,131,232,-101
12724,12724,118,2022/4/15 19:40:00,113,139,-26
12725,12725,118,2022/4/15 19:50:00,90,197,-107
12726,12726,118,2022/4/15 20:00:00,97,108,-11
12727,12727,118,2022/4/15 20:10:00,111,153,-42
12728,12728,118,2022/4/15 20:20:00,111,128,-17
12729,12729,118,2022/4/15 20:30:00,92,110,-18
12730,12730,118,2022/4/15 20:40:00,129,112,17
12731,12731,118,2022/4/15 20:50:00,86,109,-23
12732,12732,118,2022/4/15 21:00:00,94,109,-15
12733,12733,118,2022/4/15 21:10:00,78,105,-27
12734,12734,118,2022/4/15 21:20:00,68,102,-34
12735,12735,118,2022/4/15 21:30:00,67,108,-41
12736,12736,118,2022/4/15 21:40:00,63,110,-47
12737,12737,118,2022/4/15 21:50:00,41,123,-82
12738,12738,118,2022/4/15 22:00:00,42,70,-28
12739,12739,118,2022/4/15 22:10:00,62,118,-56
12740,12740,118,2022/4/15 22:20:00,30,93,-63
12741,12741,118,2022/4/15 22:30:00,25,100,-75
12742,12742,118,2022/4/15 22:40:00,21,113,-92
12743,12743,118,2022/4/15 22:50:00,14,120,-106
12744,12744,119,2022/4/15 5:00:00,0,1,-1
12745,12745,119,2022/4/15 5:10:00,5,1,4
12746,12746,119,2022/4/15 5:20:00,11,1,10
12747,12747,119,2022/4/15 5:30:00,10,1,9
12748,12748,119,2022/4/15 5:40:00,14,1,13
12749,12749,119,2022/4/15 5:50:00,19,1,18
12750,12750,119,2022/4/15 6:00:00,26,1,25
12751,12751,119,2022/4/15 6:10:00,27,13,14
12752,12752,119,2022/4/15 6:20:00,32,6,26
12753,12753,119,2022/4/15 6:30:00,37,8,29
12754,12754,119,2022/4/15 6:40:00,48,14,34
12755,12755,119,2022/4/15 6:50:00,71,19,52
12756,12756,119,2022/4/15 7:00:00,85,23,62
12757,12757,119,2022/4/15 7:10:00,181,23,158
12758,12758,119,2022/4/15 7:20:00,222,34,188
12759,12759,119,2022/4/15 7:30:00,236,62,174
12760,12760,119,2022/4/15 7:40:00,236,53,183
12761,12761,119,2022/4/15 7:50:00,234,63,171
12762,12762,119,2022/4/15 8:00:00,224,61,163
12763,12763,119,2022/4/15 8:10:00,188,78,110
12764,12764,119,2022/4/15 8:20:00,122,67,55
12765,12765,119,2022/4/15 8:30:00,76,72,4
12766,12766,119,2022/4/15 8:40:00,63,72,-9
12767,12767,119,2022/4/15 8:50:00,50,72,-22
12768,12768,119,2022/4/15 9:00:00,39,38,1
12769,12769,119,2022/4/15 9:10:00,30,48,-18
12770,12770,119,2022/4/15 9:20:00,25,38,-13
12771,12771,119,2022/4/15 9:30:00,28,40,-12
12772,12772,119,2022/4/15 9:40:00,20,37,-17
12773,12773,119,2022/4/15 9:50:00,21,34,-13
12774,12774,119,2022/4/15 10:00:00,21,38,-17
12775,12775,119,2022/4/15 10:10:00,17,31,-14
12776,12776,119,2022/4/15 10:20:00,22,37,-15
12777,12777,119,2022/4/15 10:30:00,18,32,-14
12778,12778,119,2022/4/15 10:40:00,16,32,-16
12779,12779,119,2022/4/15 10:50:00,14,23,-9
12780,12780,119,2022/4/15 11:00:00,16,38,-22
12781,12781,119,2022/4/15 11:10:00,15,31,-16
12782,12782,119,2022/4/15 11:20:00,18,23,-5
12783,12783,119,2022/4/15 11:30:00,17,19,-2
12784,12784,119,2022/4/15 11:40:00,16,32,-16
12785,12785,119,2022/4/15 11:50:00,17,29,-12
12786,12786,119,2022/4/15 12:00:00,18,37,-19
12787,12787,119,2022/4/15 12:10:00,19,30,-11
12788,12788,119,2022/4/15 12:20:00,16,25,-9
12789,12789,119,2022/4/15 12:30:00,18,21,-3
12790,12790,119,2022/4/15 12:40:00,15,35,-20
12791,12791,119,2022/4/15 12:50:00,15,35,-20
12792,12792,119,2022/4/15 13:00:00,19,38,-19
12793,12793,119,2022/4/15 13:10:00,16,31,-15
12794,12794,119,2022/4/15 13:20:00,16,32,-16
12795,12795,119,2022/4/15 13:30:00,16,25,-9
12796,12796,119,2022/4/15 13:40:00,14,38,-24
12797,12797,119,2022/4/15 13:50:00,15,38,-23
12798,12798,119,2022/4/15 14:00:00,12,30,-18
12799,12799,119,2022/4/15 14:10:00,14,37,-23
12800,12800,119,2022/4/15 14:20:00,12,32,-20
12801,12801,119,2022/4/15 14:30:00,14,32,-18
12802,12802,119,2022/4/15 14:40:00,15,33,-18
12803,12803,119,2022/4/15 14:50:00,14,38,-24
12804,12804,119,2022/4/15 15:00:00,16,38,-22
12805,12805,119,2022/4/15 15:10:00,17,37,-20
12806,12806,119,2022/4/15 15:20:00,16,31,-15
12807,12807,119,2022/4/15 15:30:00,16,33,-17
12808,12808,119,2022/4/15 15:40:00,16,50,-34
12809,12809,119,2022/4/15 15:50:00,17,47,-30
12810,12810,119,2022/4/15 16:00:00,22,38,-16
12811,12811,119,2022/4/15 16:10:00,15,45,-30
12812,12812,119,2022/4/15 16:20:00,19,45,-26
12813,12813,119,2022/4/15 16:30:00,24,48,-24
12814,12814,119,2022/4/15 16:40:00,22,52,-30
12815,12815,119,2022/4/15 16:50:00,20,62,-42
12816,12816,119,2022/4/15 17:00:00,31,60,-29
12817,12817,119,2022/4/15 17:10:00,32,64,-32
12818,12818,119,2022/4/15 17:20:00,27,54,-27
12819,12819,119,2022/4/15 17:30:00,27,76,-49
12820,12820,119,2022/4/15 17:40:00,26,60,-34
12821,12821,119,2022/4/15 17:50:00,20,101,-81
12822,12822,119,2022/4/15 18:00:00,19,107,-88
12823,12823,119,2022/4/15 18:10:00,22,102,-80
12824,12824,119,2022/4/15 18:20:00,12,98,-86
12825,12825,119,2022/4/15 18:30:00,14,113,-99
12826,12826,119,2022/4/15 18:40:00,11,91,-80
12827,12827,119,2022/4/15 18:50:00,13,126,-113
12828,12828,119,2022/4/15 19:00:00,9,110,-101
12829,12829,119,2022/4/15 19:10:00,11,107,-96
12830,12830,119,2022/4/15 19:20:00,8,95,-87
12831,12831,119,2022/4/15 19:30:00,7,92,-85
12832,12832,119,2022/4/15 19:40:00,10,71,-61
12833,12833,119,2022/4/15 19:50:00,8,74,-66
12834,12834,119,2022/4/15 20:00:00,6,73,-67
12835,12835,119,2022/4/15 20:10:00,9,52,-43
12836,12836,119,2022/4/15 20:20:00,8,70,-62
12837,12837,119,2022/4/15 20:30:00,7,64,-57
12838,12838,119,2022/4/15 20:40:00,4,62,-58
12839,12839,119,2022/4/15 20:50:00,8,63,-55
12840,12840,119,2022/4/15 21:00:00,5,54,-49
12841,12841,119,2022/4/15 21:10:00,6,55,-49
12842,12842,119,2022/4/15 21:20:00,3,46,-43
12843,12843,119,2022/4/15 21:30:00,3,60,-57
12844,12844,119,2022/4/15 21:40:00,2,52,-50
12845,12845,119,2022/4/15 21:50:00,5,48,-43
12846,12846,119,2022/4/15 22:00:00,5,51,-46
12847,12847,119,2022/4/15 22:10:00,2,52,-50
12848,12848,119,2022/4/15 22:20:00,1,52,-51
12849,12849,119,2022/4/15 22:30:00,1,60,-59
12850,12850,119,2022/4/15 22:40:00,0,66,-66
12851,12851,119,2022/4/15 22:50:00,0,62,-62
12852,12852,120,2022/4/15 5:00:00,0,1,-1
12853,12853,120,2022/4/15 5:10:00,0,1,-1
12854,12854,120,2022/4/15 5:20:00,3,1,2
12855,12855,120,2022/4/15 5:30:00,11,1,10
12856,12856,120,2022/4/15 5:40:00,20,6,14
12857,12857,120,2022/4/15 5:50:00,27,33,-6
12858,12858,120,2022/4/15 6:00:00,37,32,5
12859,12859,120,2022/4/15 6:10:00,45,23,22
12860,12860,120,2022/4/15 6:20:00,58,68,-10
12861,12861,120,2022/4/15 6:30:00,83,75,8
12862,12862,120,2022/4/15 6:40:00,109,108,1
12863,12863,120,2022/4/15 6:50:00,156,155,1
12864,12864,120,2022/4/15 7:00:00,195,181,14
12865,12865,120,2022/4/15 7:10:00,244,142,102
12866,12866,120,2022/4/15 7:20:00,254,115,139
12867,12867,120,2022/4/15 7:30:00,303,139,164
12868,12868,120,2022/4/15 7:40:00,573,133,440
12869,12869,120,2022/4/15 7:50:00,600,138,462
12870,12870,120,2022/4/15 8:00:00,627,196,431
12871,12871,120,2022/4/15 8:10:00,663,326,337
12872,12872,120,2022/4/15 8:20:00,632,221,411
12873,12873,120,2022/4/15 8:30:00,598,268,330
12874,12874,120,2022/4/15 8:40:00,474,206,268
12875,12875,120,2022/4/15 8:50:00,350,205,145
12876,12876,120,2022/4/15 9:00:00,273,121,152
12877,12877,120,2022/4/15 9:10:00,233,129,104
12878,12878,120,2022/4/15 9:20:00,213,121,92
12879,12879,120,2022/4/15 9:30:00,178,125,53
12880,12880,120,2022/4/15 9:40:00,120,126,-6
12881,12881,120,2022/4/15 9:50:00,90,110,-20
12882,12882,120,2022/4/15 10:00:00,69,92,-23
12883,12883,120,2022/4/15 10:10:00,67,106,-39
12884,12884,120,2022/4/15 10:20:00,59,99,-40
12885,12885,120,2022/4/15 10:30:00,47,91,-44
12886,12886,120,2022/4/15 10:40:00,57,68,-11
12887,12887,120,2022/4/15 10:50:00,47,105,-58
12888,12888,120,2022/4/15 11:00:00,50,101,-51
12889,12889,120,2022/4/15 11:10:00,55,96,-41
12890,12890,120,2022/4/15 11:20:00,45,75,-30
12891,12891,120,2022/4/15 11:30:00,44,84,-40
12892,12892,120,2022/4/15 11:40:00,55,80,-25
12893,12893,120,2022/4/15 11:50:00,46,103,-57
12894,12894,120,2022/4/15 12:00:00,58,102,-44
12895,12895,120,2022/4/15 12:10:00,59,99,-40
12896,12896,120,2022/4/15 12:20:00,63,84,-21
12897,12897,120,2022/4/15 12:30:00,60,90,-30
12898,12898,120,2022/4/15 12:40:00,57,81,-24
12899,12899,120,2022/4/15 12:50:00,59,105,-46
12900,12900,120,2022/4/15 13:00:00,60,109,-49
12901,12901,120,2022/4/15 13:10:00,62,100,-38
12902,12902,120,2022/4/15 13:20:00,62,80,-18
12903,12903,120,2022/4/15 13:30:00,45,84,-39
12904,12904,120,2022/4/15 13:40:00,44,87,-43
12905,12905,120,2022/4/15 13:50:00,50,102,-52
12906,12906,120,2022/4/15 14:00:00,44,109,-65
12907,12907,120,2022/4/15 14:10:00,45,97,-52
12908,12908,120,2022/4/15 14:20:00,44,90,-46
12909,12909,120,2022/4/15 14:30:00,46,73,-27
12910,12910,120,2022/4/15 14:40:00,45,101,-56
12911,12911,120,2022/4/15 14:50:00,41,99,-58
12912,12912,120,2022/4/15 15:00:00,51,100,-49
12913,12913,120,2022/4/15 15:10:00,55,99,-44
12914,12914,120,2022/4/15 15:20:00,53,110,-57
12915,12915,120,2022/4/15 15:30:00,57,94,-37
12916,12916,120,2022/4/15 15:40:00,58,105,-47
12917,12917,120,2022/4/15 15:50:00,51,99,-48
12918,12918,120,2022/4/15 16:00:00,74,104,-30
12919,12919,120,2022/4/15 16:10:00,72,104,-32
12920,12920,120,2022/4/15 16:20:00,73,109,-36
12921,12921,120,2022/4/15 16:30:00,75,97,-22
12922,12922,120,2022/4/15 16:40:00,100,109,-9
12923,12923,120,2022/4/15 16:50:00,130,117,13
12924,12924,120,2022/4/15 17:00:00,207,121,86
12925,12925,120,2022/4/15 17:10:00,313,137,176
12926,12926,120,2022/4/15 17:20:00,257,152,105
12927,12927,120,2022/4/15 17:30:00,292,283,9
12928,12928,120,2022/4/15 17:40:00,461,213,248
12929,12929,120,2022/4/15 17:50:00,289,182,107
12930,12930,120,2022/4/15 18:00:00,276,318,-42
12931,12931,120,2022/4/15 18:10:00,234,192,42
12932,12932,120,2022/4/15 18:20:00,207,321,-114
12933,12933,120,2022/4/15 18:30:00,170,365,-195
12934,12934,120,2022/4/15 18:40:00,114,321,-207
12935,12935,120,2022/4/15 18:50:00,73,140,-67
12936,12936,120,2022/4/15 19:00:00,76,316,-240
12937,12937,120,2022/4/15 19:10:00,55,106,-51
12938,12938,120,2022/4/15 19:20:00,54,179,-125
12939,12939,120,2022/4/15 19:30:00,44,111,-67
12940,12940,120,2022/4/15 19:40:00,44,121,-77
12941,12941,120,2022/4/15 19:50:00,42,108,-66
12942,12942,120,2022/4/15 20:00:00,41,121,-80
12943,12943,120,2022/4/15 20:10:00,44,98,-54
12944,12944,120,2022/4/15 20:20:00,41,91,-50
12945,12945,120,2022/4/15 20:30:00,35,122,-87
12946,12946,120,2022/4/15 20:40:00,36,125,-89
12947,12947,120,2022/4/15 20:50:00,34,111,-77
12948,12948,120,2022/4/15 21:00:00,35,116,-81
12949,12949,120,2022/4/15 21:10:00,31,104,-73
12950,12950,120,2022/4/15 21:20:00,35,110,-75
12951,12951,120,2022/4/15 21:30:00,27,104,-77
12952,12952,120,2022/4/15 21:40:00,25,108,-83
12953,12953,120,2022/4/15 21:50:00,29,107,-78
12954,12954,120,2022/4/15 22:00:00,28,105,-77
12955,12955,120,2022/4/15 22:10:00,26,103,-77
12956,12956,120,2022/4/15 22:20:00,21,97,-76
12957,12957,120,2022/4/15 22:30:00,16,106,-90
12958,12958,120,2022/4/15 22:40:00,13,79,-66
12959,12959,120,2022/4/15 22:50:00,8,73,-65
12960,12960,121,2022/4/15 5:00:00,0,1,-1
12961,12961,121,2022/4/15 5:10:00,2,1,1
12962,12962,121,2022/4/15 5:20:00,15,1,14
12963,12963,121,2022/4/15 5:30:00,24,1,23
12964,12964,121,2022/4/15 5:40:00,31,5,26
12965,12965,121,2022/4/15 5:50:00,35,16,19
12966,12966,121,2022/4/15 6:00:00,52,16,36
12967,12967,121,2022/4/15 6:10:00,60,11,49
12968,12968,121,2022/4/15 6:20:00,89,40,49
12969,12969,121,2022/4/15 6:30:00,183,32,151
12970,12970,121,2022/4/15 6:40:00,231,63,168
12971,12971,121,2022/4/15 6:50:00,277,73,204
12972,12972,121,2022/4/15 7:00:00,337,80,257
12973,12973,121,2022/4/15 7:10:00,325,83,242
12974,12974,121,2022/4/15 7:20:00,475,108,367
12975,12975,121,2022/4/15 7:30:00,682,127,555
12976,12976,121,2022/4/15 7:40:00,869,122,747
12977,12977,121,2022/4/15 7:50:00,1234,122,1112
12978,12978,121,2022/4/15 8:00:00,1577,110,1467
12979,12979,121,2022/4/15 8:10:00,1582,159,1423
12980,12980,121,2022/4/15 8:20:00,1389,222,1167
12981,12981,121,2022/4/15 8:30:00,1217,180,1037
12982,12982,121,2022/4/15 8:40:00,862,213,649
12983,12983,121,2022/4/15 8:50:00,705,178,527
12984,12984,121,2022/4/15 9:00:00,614,133,481
12985,12985,121,2022/4/15 9:10:00,434,109,325
12986,12986,121,2022/4/15 9:20:00,314,113,201
12987,12987,121,2022/4/15 9:30:00,229,121,108
12988,12988,121,2022/4/15 9:40:00,219,103,116
12989,12989,121,2022/4/15 9:50:00,181,104,77
12990,12990,121,2022/4/15 10:00:00,139,101,38
12991,12991,121,2022/4/15 10:10:00,96,108,-12
12992,12992,121,2022/4/15 10:20:00,86,92,-6
12993,12993,121,2022/4/15 10:30:00,70,98,-28
12994,12994,121,2022/4/15 10:40:00,62,96,-34
12995,12995,121,2022/4/15 10:50:00,58,93,-35
12996,12996,121,2022/4/15 11:00:00,57,90,-33
12997,12997,121,2022/4/15 11:10:00,53,96,-43
12998,12998,121,2022/4/15 11:20:00,60,93,-33
12999,12999,121,2022/4/15 11:30:00,54,93,-39
13000,13000,121,2022/4/15 11:40:00,51,98,-47
13001,13001,121,2022/4/15 11:50:00,55,111,-56
13002,13002,121,2022/4/15 12:00:00,69,101,-32
13003,13003,121,2022/4/15 12:10:00,62,109,-47
13004,13004,121,2022/4/15 12:20:00,72,105,-33
13005,13005,121,2022/4/15 12:30:00,77,108,-31
13006,13006,121,2022/4/15 12:40:00,70,109,-39
13007,13007,121,2022/4/15 12:50:00,76,99,-23
13008,13008,121,2022/4/15 13:00:00,76,106,-30
13009,13009,121,2022/4/15 13:10:00,70,111,-41
13010,13010,121,2022/4/15 13:20:00,62,102,-40
13011,13011,121,2022/4/15 13:30:00,62,101,-39
13012,13012,121,2022/4/15 13:40:00,59,103,-44
13013,13013,121,2022/4/15 13:50:00,56,102,-46
13014,13014,121,2022/4/15 14:00:00,46,105,-59
13015,13015,121,2022/4/15 14:10:00,48,106,-58
13016,13016,121,2022/4/15 14:20:00,47,103,-56
13017,13017,121,2022/4/15 14:30:00,48,106,-58
13018,13018,121,2022/4/15 14:40:00,46,116,-70
13019,13019,121,2022/4/15 14:50:00,46,103,-57
13020,13020,121,2022/4/15 15:00:00,45,104,-59
13021,13021,121,2022/4/15 15:10:00,48,107,-59
13022,13022,121,2022/4/15 15:20:00,45,119,-74
13023,13023,121,2022/4/15 15:30:00,49,104,-55
13024,13024,121,2022/4/15 15:40:00,44,109,-65
13025,13025,121,2022/4/15 15:50:00,45,129,-84
13026,13026,121,2022/4/15 16:00:00,60,125,-65
13027,13027,121,2022/4/15 16:10:00,71,114,-43
13028,13028,121,2022/4/15 16:20:00,65,121,-56
13029,13029,121,2022/4/15 16:30:00,76,133,-57
13030,13030,121,2022/4/15 16:40:00,96,159,-63
13031,13031,121,2022/4/15 16:50:00,79,170,-91
13032,13032,121,2022/4/15 17:00:00,219,155,64
13033,13033,121,2022/4/15 17:10:00,207,229,-22
13034,13034,121,2022/4/15 17:20:00,147,296,-149
13035,13035,121,2022/4/15 17:30:00,206,318,-112
13036,13036,121,2022/4/15 17:40:00,240,498,-258
13037,13037,121,2022/4/15 17:50:00,198,416,-218
13038,13038,121,2022/4/15 18:00:00,201,434,-233
13039,13039,121,2022/4/15 18:10:00,202,432,-230
13040,13040,121,2022/4/15 18:20:00,164,430,-266
13041,13041,121,2022/4/15 18:30:00,96,570,-474
13042,13042,121,2022/4/15 18:40:00,75,424,-349
13043,13043,121,2022/4/15 18:50:00,68,429,-361
13044,13044,121,2022/4/15 19:00:00,53,418,-365
13045,13045,121,2022/4/15 19:10:00,48,528,-480
13046,13046,121,2022/4/15 19:20:00,47,326,-279
13047,13047,121,2022/4/15 19:30:00,42,256,-214
13048,13048,121,2022/4/15 19:40:00,37,179,-142
13049,13049,121,2022/4/15 19:50:00,34,177,-143
13050,13050,121,2022/4/15 20:00:00,37,159,-122
13051,13051,121,2022/4/15 20:10:00,35,185,-150
13052,13052,121,2022/4/15 20:20:00,36,181,-145
13053,13053,121,2022/4/15 20:30:00,40,109,-69
13054,13054,121,2022/4/15 20:40:00,37,192,-155
13055,13055,121,2022/4/15 20:50:00,29,109,-80
13056,13056,121,2022/4/15 21:00:00,28,180,-152
13057,13057,121,2022/4/15 21:10:00,28,109,-81
13058,13058,121,2022/4/15 21:20:00,31,124,-93
13059,13059,121,2022/4/15 21:30:00,24,109,-85
13060,13060,121,2022/4/15 21:40:00,33,119,-86
13061,13061,121,2022/4/15 21:50:00,26,116,-90
13062,13062,121,2022/4/15 22:00:00,24,105,-81
13063,13063,121,2022/4/15 22:10:00,25,112,-87
13064,13064,121,2022/4/15 22:20:00,17,102,-85
13065,13065,121,2022/4/15 22:30:00,12,111,-99
13066,13066,121,2022/4/15 22:40:00,9,111,-102
13067,13067,121,2022/4/15 22:50:00,5,98,-93
13068,13068,122,2022/4/15 5:00:00,0,1,-1
13069,13069,122,2022/4/15 5:10:00,0,1,-1
13070,13070,122,2022/4/15 5:20:00,0,1,-1
13071,13071,122,2022/4/15 5:30:00,0,1,-1
13072,13072,122,2022/4/15 5:40:00,0,1,-1
13073,13073,122,2022/4/15 5:50:00,28,1,27
13074,13074,122,2022/4/15 6:00:00,55,2,53
13075,13075,122,2022/4/15 6:10:00,148,13,135
13076,13076,122,2022/4/15 6:20:00,152,8,144
13077,13077,122,2022/4/15 6:30:00,222,15,207
13078,13078,122,2022/4/15 6:40:00,227,66,161
13079,13079,122,2022/4/15 6:50:00,247,66,181
13080,13080,122,2022/4/15 7:00:00,346,108,238
13081,13081,122,2022/4/15 7:10:00,436,90,346
13082,13082,122,2022/4/15 7:20:00,722,100,622
13083,13083,122,2022/4/15 7:30:00,741,98,643
13084,13084,122,2022/4/15 7:40:00,1177,106,1071
13085,13085,122,2022/4/15 7:50:00,865,119,746
13086,13086,122,2022/4/15 8:00:00,732,93,639
13087,13087,122,2022/4/15 8:10:00,723,115,608
13088,13088,122,2022/4/15 8:20:00,589,101,488
13089,13089,122,2022/4/15 8:30:00,357,87,270
13090,13090,122,2022/4/15 8:40:00,278,114,164
13091,13091,122,2022/4/15 8:50:00,250,102,148
13092,13092,122,2022/4/15 9:00:00,206,93,113
13093,13093,122,2022/4/15 9:10:00,151,109,42
13094,13094,122,2022/4/15 9:20:00,115,105,10
13095,13095,122,2022/4/15 9:30:00,60,97,-37
13096,13096,122,2022/4/15 9:40:00,57,105,-48
13097,13097,122,2022/4/15 9:50:00,48,105,-57
13098,13098,122,2022/4/15 10:00:00,48,94,-46
13099,13099,122,2022/4/15 10:10:00,43,103,-60
13100,13100,122,2022/4/15 10:20:00,42,93,-51
13101,13101,122,2022/4/15 10:30:00,42,68,-26
13102,13102,122,2022/4/15 10:40:00,40,100,-60
13103,13103,122,2022/4/15 10:50:00,40,75,-35
13104,13104,122,2022/4/15 11:00:00,45,102,-57
13105,13105,122,2022/4/15 11:10:00,39,103,-64
13106,13106,122,2022/4/15 11:20:00,43,76,-33
13107,13107,122,2022/4/15 11:30:00,41,83,-42
13108,13108,122,2022/4/15 11:40:00,41,77,-36
13109,13109,122,2022/4/15 11:50:00,47,84,-37
13110,13110,122,2022/4/15 12:00:00,46,100,-54
13111,13111,122,2022/4/15 12:10:00,44,81,-37
13112,13112,122,2022/4/15 12:20:00,48,77,-29
13113,13113,122,2022/4/15 12:30:00,47,78,-31
13114,13114,122,2022/4/15 12:40:00,41,80,-39
13115,13115,122,2022/4/15 12:50:00,35,76,-41
13116,13116,122,2022/4/15 13:00:00,43,106,-63
13117,13117,122,2022/4/15 13:10:00,34,89,-55
13118,13118,122,2022/4/15 13:20:00,39,80,-41
13119,13119,122,2022/4/15 13:30:00,34,83,-49
13120,13120,122,2022/4/15 13:40:00,37,78,-41
13121,13121,122,2022/4/15 13:50:00,39,102,-63
13122,13122,122,2022/4/15 14:00:00,35,93,-58
13123,13123,122,2022/4/15 14:10:00,37,93,-56
13124,13124,122,2022/4/15 14:20:00,37,86,-49
13125,13125,122,2022/4/15 14:30:00,32,92,-60
13126,13126,122,2022/4/15 14:40:00,39,90,-51
13127,13127,122,2022/4/15 14:50:00,29,118,-89
13128,13128,122,2022/4/15 15:00:00,34,105,-71
13129,13129,122,2022/4/15 15:10:00,37,107,-70
13130,13130,122,2022/4/15 15:20:00,35,90,-55
13131,13131,122,2022/4/15 15:30:00,37,98,-61
13132,13132,122,2022/4/15 15:40:00,33,101,-68
13133,13133,122,2022/4/15 15:50:00,38,109,-71
13134,13134,122,2022/4/15 16:00:00,37,104,-67
13135,13135,122,2022/4/15 16:10:00,38,111,-73
13136,13136,122,2022/4/15 16:20:00,45,113,-68
13137,13137,122,2022/4/15 16:30:00,44,103,-59
13138,13138,122,2022/4/15 16:40:00,70,150,-80
13139,13139,122,2022/4/15 16:50:00,133,117,16
13140,13140,122,2022/4/15 17:00:00,74,110,-36
13141,13141,122,2022/4/15 17:10:00,49,145,-96
13142,13142,122,2022/4/15 17:20:00,47,110,-63
13143,13143,122,2022/4/15 17:30:00,42,268,-226
13144,13144,122,2022/4/15 17:40:00,41,108,-67
13145,13145,122,2022/4/15 17:50:00,42,324,-282
13146,13146,122,2022/4/15 18:00:00,45,232,-187
13147,13147,122,2022/4/15 18:10:00,40,341,-301
13148,13148,122,2022/4/15 18:20:00,37,379,-342
13149,13149,122,2022/4/15 18:30:00,28,217,-189
13150,13150,122,2022/4/15 18:40:00,27,428,-401
13151,13151,122,2022/4/15 18:50:00,28,229,-201
13152,13152,122,2022/4/15 19:00:00,27,439,-412
13153,13153,122,2022/4/15 19:10:00,27,231,-204
13154,13154,122,2022/4/15 19:20:00,25,300,-275
13155,13155,122,2022/4/15 19:30:00,26,285,-259
13156,13156,122,2022/4/15 19:40:00,25,118,-93
13157,13157,122,2022/4/15 19:50:00,25,213,-188
13158,13158,122,2022/4/15 20:00:00,29,101,-72
13159,13159,122,2022/4/15 20:10:00,28,150,-122
13160,13160,122,2022/4/15 20:20:00,22,111,-89
13161,13161,122,2022/4/15 20:30:00,28,106,-78
13162,13162,122,2022/4/15 20:40:00,23,110,-87
13163,13163,122,2022/4/15 20:50:00,24,107,-83
13164,13164,122,2022/4/15 21:00:00,24,110,-86
13165,13165,122,2022/4/15 21:10:00,22,104,-82
13166,13166,122,2022/4/15 21:20:00,18,111,-93
13167,13167,122,2022/4/15 21:30:00,17,132,-115
13168,13168,122,2022/4/15 21:40:00,16,94,-78
13169,13169,122,2022/4/15 21:50:00,11,111,-100
13170,13170,122,2022/4/15 22:00:00,7,89,-82
13171,13171,122,2022/4/15 22:10:00,5,104,-99
13172,13172,122,2022/4/15 22:20:00,2,78,-76
13173,13173,122,2022/4/15 22:30:00,0,66,-66
13174,13174,122,2022/4/15 22:40:00,0,56,-56
13175,13175,122,2022/4/15 22:50:00,0,3,-3
13176,13176,123,2022/4/15 5:00:00,0,1,-1
13177,13177,123,2022/4/15 5:10:00,0,1,-1
13178,13178,123,2022/4/15 5:20:00,0,1,-1
13179,13179,123,2022/4/15 5:30:00,0,1,-1
13180,13180,123,2022/4/15 5:40:00,0,1,-1
13181,13181,123,2022/4/15 5:50:00,1,1,0
13182,13182,123,2022/4/15 6:00:00,4,1,3
13183,13183,123,2022/4/15 6:10:00,16,1,15
13184,13184,123,2022/4/15 6:20:00,27,2,25
13185,13185,123,2022/4/15 6:30:00,19,6,13
13186,13186,123,2022/4/15 6:40:00,27,16,11
13187,13187,123,2022/4/15 6:50:00,29,8,21
13188,13188,123,2022/4/15 7:00:00,28,14,14
13189,13189,123,2022/4/15 7:10:00,34,33,1
13190,13190,123,2022/4/15 7:20:00,35,21,14
13191,13191,123,2022/4/15 7:30:00,41,50,-9
13192,13192,123,2022/4/15 7:40:00,59,34,25
13193,13193,123,2022/4/15 7:50:00,73,53,20
13194,13194,123,2022/4/15 8:00:00,57,48,9
13195,13195,123,2022/4/15 8:10:00,42,42,0
13196,13196,123,2022/4/15 8:20:00,31,56,-25
13197,13197,123,2022/4/15 8:30:00,28,47,-19
13198,13198,123,2022/4/15 8:40:00,21,32,-11
13199,13199,123,2022/4/15 8:50:00,16,44,-28
13200,13200,123,2022/4/15 9:00:00,12,33,-21
13201,13201,123,2022/4/15 9:10:00,11,22,-11
13202,13202,123,2022/4/15 9:20:00,9,23,-14
13203,13203,123,2022/4/15 9:30:00,10,22,-12
13204,13204,123,2022/4/15 9:40:00,11,19,-8
13205,13205,123,2022/4/15 9:50:00,8,30,-22
13206,13206,123,2022/4/15 10:00:00,7,23,-16
13207,13207,123,2022/4/15 10:10:00,8,11,-3
13208,13208,123,2022/4/15 10:20:00,6,21,-15
13209,13209,123,2022/4/15 10:30:00,5,19,-14
13210,13210,123,2022/4/15 10:40:00,5,16,-11
13211,13211,123,2022/4/15 10:50:00,6,11,-5
13212,13212,123,2022/4/15 11:00:00,5,19,-14
13213,13213,123,2022/4/15 11:10:00,7,23,-16
13214,13214,123,2022/4/15 11:20:00,6,12,-6
13215,13215,123,2022/4/15 11:30:00,7,19,-12
13216,13216,123,2022/4/15 11:40:00,8,19,-11
13217,13217,123,2022/4/15 11:50:00,5,16,-11
13218,13218,123,2022/4/15 12:00:00,9,19,-10
13219,13219,123,2022/4/15 12:10:00,8,21,-13
13220,13220,123,2022/4/15 12:20:00,8,19,-11
13221,13221,123,2022/4/15 12:30:00,9,16,-7
13222,13222,123,2022/4/15 12:40:00,7,14,-7
13223,13223,123,2022/4/15 12:50:00,7,19,-12
13224,13224,123,2022/4/15 13:00:00,7,23,-16
13225,13225,123,2022/4/15 13:10:00,7,23,-16
13226,13226,123,2022/4/15 13:20:00,6,14,-8
13227,13227,123,2022/4/15 13:30:00,7,18,-11
13228,13228,123,2022/4/15 13:40:00,6,21,-15
13229,13229,123,2022/4/15 13:50:00,8,19,-11
13230,13230,123,2022/4/15 14:00:00,6,25,-19
13231,13231,123,2022/4/15 14:10:00,6,23,-17
13232,13232,123,2022/4/15 14:20:00,6,19,-13
13233,13233,123,2022/4/15 14:30:00,4,23,-19
13234,13234,123,2022/4/15 14:40:00,6,21,-15
13235,13235,123,2022/4/15 14:50:00,6,31,-25
13236,13236,123,2022/4/15 15:00:00,6,19,-13
13237,13237,123,2022/4/15 15:10:00,5,23,-18
13238,13238,123,2022/4/15 15:20:00,6,21,-15
13239,13239,123,2022/4/15 15:30:00,6,21,-15
13240,13240,123,2022/4/15 15:40:00,5,21,-16
13241,13241,123,2022/4/15 15:50:00,6,25,-19
13242,13242,123,2022/4/15 16:00:00,7,23,-16
13243,13243,123,2022/4/15 16:10:00,8,21,-13
13244,13244,123,2022/4/15 16:20:00,9,25,-16
13245,13245,123,2022/4/15 16:30:00,11,23,-12
13246,13246,123,2022/4/15 16:40:00,21,23,-2
13247,13247,123,2022/4/15 16:50:00,14,42,-28
13248,13248,123,2022/4/15 17:00:00,14,23,-9
13249,13249,123,2022/4/15 17:10:00,18,38,-20
13250,13250,123,2022/4/15 17:20:00,15,25,-10
13251,13251,123,2022/4/15 17:30:00,12,46,-34
13252,13252,123,2022/4/15 17:40:00,16,50,-34
13253,13253,123,2022/4/15 17:50:00,19,42,-23
13254,13254,123,2022/4/15 18:00:00,14,51,-37
13255,13255,123,2022/4/15 18:10:00,9,38,-29
13256,13256,123,2022/4/15 18:20:00,10,73,-63
13257,13257,123,2022/4/15 18:30:00,7,50,-43
13258,13258,123,2022/4/15 18:40:00,6,69,-63
13259,13259,123,2022/4/15 18:50:00,7,75,-68
13260,13260,123,2022/4/15 19:00:00,8,50,-42
13261,13261,123,2022/4/15 19:10:00,5,67,-62
13262,13262,123,2022/4/15 19:20:00,5,39,-34
13263,13263,123,2022/4/15 19:30:00,5,60,-55
13264,13264,123,2022/4/15 19:40:00,3,38,-35
13265,13265,123,2022/4/15 19:50:00,3,40,-37
13266,13266,123,2022/4/15 20:00:00,3,40,-37
13267,13267,123,2022/4/15 20:10:00,2,25,-23
13268,13268,123,2022/4/15 20:20:00,2,33,-31
13269,13269,123,2022/4/15 20:30:00,2,25,-23
13270,13270,123,2022/4/15 20:40:00,2,40,-38
13271,13271,123,2022/4/15 20:50:00,1,25,-24
13272,13272,123,2022/4/15 21:00:00,1,39,-38
13273,13273,123,2022/4/15 21:10:00,2,31,-29
13274,13274,123,2022/4/15 21:20:00,1,32,-31
13275,13275,123,2022/4/15 21:30:00,2,36,-34
13276,13276,123,2022/4/15 21:40:00,1,21,-20
13277,13277,123,2022/4/15 21:50:00,1,35,-34
13278,13278,123,2022/4/15 22:00:00,0,32,-32
13279,13279,123,2022/4/15 22:10:00,0,21,-21
13280,13280,123,2022/4/15 22:20:00,0,18,-18
13281,13281,123,2022/4/15 22:30:00,0,21,-21
13282,13282,123,2022/4/15 22:40:00,0,3,-3
13283,13283,123,2022/4/15 22:50:00,0,3,-3
13284,13284,124,2022/4/15 5:00:00,1,1,0
13285,13285,124,2022/4/15 5:10:00,8,1,7
13286,13286,124,2022/4/15 5:20:00,20,1,19
13287,13287,124,2022/4/15 5:30:00,20,6,14
13288,13288,124,2022/4/15 5:40:00,23,1,22
13289,13289,124,2022/4/15 5:50:00,32,1,31
13290,13290,124,2022/4/15 6:00:00,33,21,12
13291,13291,124,2022/4/15 6:10:00,40,75,-35
13292,13292,124,2022/4/15 6:20:00,56,77,-21
13293,13293,124,2022/4/15 6:30:00,79,68,11
13294,13294,124,2022/4/15 6:40:00,108,105,3
13295,13295,124,2022/4/15 6:50:00,155,160,-5
13296,13296,124,2022/4/15 7:00:00,196,216,-20
13297,13297,124,2022/4/15 7:10:00,233,157,76
13298,13298,124,2022/4/15 7:20:00,280,190,90
13299,13299,124,2022/4/15 7:30:00,340,386,-46
13300,13300,124,2022/4/15 7:40:00,597,431,166
13301,13301,124,2022/4/15 7:50:00,722,580,142
13302,13302,124,2022/4/15 8:00:00,819,1870,-1051
13303,13303,124,2022/4/15 8:10:00,868,2581,-1713
13304,13304,124,2022/4/15 8:20:00,1183,2167,-984
13305,13305,124,2022/4/15 8:30:00,1054,6395,-5341
13306,13306,124,2022/4/15 8:40:00,734,7344,-6610
13307,13307,124,2022/4/15 8:50:00,715,6363,-5648
13308,13308,124,2022/4/15 9:00:00,579,2599,-2020
13309,13309,124,2022/4/15 9:10:00,434,1917,-1483
13310,13310,124,2022/4/15 9:20:00,340,571,-231
13311,13311,124,2022/4/15 9:30:00,269,557,-288
13312,13312,124,2022/4/15 9:40:00,252,414,-162
13313,13313,124,2022/4/15 9:50:00,219,320,-101
13314,13314,124,2022/4/15 10:00:00,204,255,-51
13315,13315,124,2022/4/15 10:10:00,212,214,-2
13316,13316,124,2022/4/15 10:20:00,190,154,36
13317,13317,124,2022/4/15 10:30:00,190,193,-3
13318,13318,124,2022/4/15 10:40:00,188,152,36
13319,13319,124,2022/4/15 10:50:00,161,112,49
13320,13320,124,2022/4/15 11:00:00,168,119,49
13321,13321,124,2022/4/15 11:10:00,173,119,54
13322,13322,124,2022/4/15 11:20:00,173,119,54
13323,13323,124,2022/4/15 11:30:00,200,112,88
13324,13324,124,2022/4/15 11:40:00,209,111,98
13325,13325,124,2022/4/15 11:50:00,203,121,82
13326,13326,124,2022/4/15 12:00:00,209,144,65
13327,13327,124,2022/4/15 12:10:00,226,119,107
13328,13328,124,2022/4/15 12:20:00,206,144,62
13329,13329,124,2022/4/15 12:30:00,209,144,65
13330,13330,124,2022/4/15 12:40:00,194,144,50
13331,13331,124,2022/4/15 12:50:00,226,153,73
13332,13332,124,2022/4/15 13:00:00,216,192,24
13333,13333,124,2022/4/15 13:10:00,227,145,82
13334,13334,124,2022/4/15 13:20:00,229,179,50
13335,13335,124,2022/4/15 13:30:00,217,178,39
13336,13336,124,2022/4/15 13:40:00,213,180,33
13337,13337,124,2022/4/15 13:50:00,191,151,40
13338,13338,124,2022/4/15 14:00:00,197,150,47
13339,13339,124,2022/4/15 14:10:00,208,146,62
13340,13340,124,2022/4/15 14:20:00,198,151,47
13341,13341,124,2022/4/15 14:30:00,204,181,23
13342,13342,124,2022/4/15 14:40:00,208,154,54
13343,13343,124,2022/4/15 14:50:00,203,127,76
13344,13344,124,2022/4/15 15:00:00,224,150,74
13345,13345,124,2022/4/15 15:10:00,261,117,144
13346,13346,124,2022/4/15 15:20:00,263,169,94
13347,13347,124,2022/4/15 15:30:00,260,143,117
13348,13348,124,2022/4/15 15:40:00,265,192,73
13349,13349,124,2022/4/15 15:50:00,224,138,86
13350,13350,124,2022/4/15 16:00:00,259,170,89
13351,13351,124,2022/4/15 16:10:00,307,181,126
13352,13352,124,2022/4/15 16:20:00,272,155,117
13353,13353,124,2022/4/15 16:30:00,343,138,205
13354,13354,124,2022/4/15 16:40:00,578,179,399
13355,13355,124,2022/4/15 16:50:00,638,198,440
13356,13356,124,2022/4/15 17:00:00,802,219,583
13357,13357,124,2022/4/15 17:10:00,1189,194,995
13358,13358,124,2022/4/15 17:20:00,1027,296,731
13359,13359,124,2022/4/15 17:30:00,1148,324,824
13360,13360,124,2022/4/15 17:40:00,1987,382,1605
13361,13361,124,2022/4/15 17:50:00,1988,503,1485
13362,13362,124,2022/4/15 18:00:00,1559,420,1139
13363,13363,124,2022/4/15 18:10:00,2541,505,2036
13364,13364,124,2022/4/15 18:20:00,2482,415,2067
13365,13365,124,2022/4/15 18:30:00,1350,493,857
13366,13366,124,2022/4/15 18:40:00,1355,437,918
13367,13367,124,2022/4/15 18:50:00,1035,510,525
13368,13368,124,2022/4/15 19:00:00,634,381,253
13369,13369,124,2022/4/15 19:10:00,694,286,408
13370,13370,124,2022/4/15 19:20:00,577,209,368
13371,13371,124,2022/4/15 19:30:00,333,191,142
13372,13372,124,2022/4/15 19:40:00,341,127,214
13373,13373,124,2022/4/15 19:50:00,270,109,161
13374,13374,124,2022/4/15 20:00:00,268,125,143
13375,13375,124,2022/4/15 20:10:00,292,113,179
13376,13376,124,2022/4/15 20:20:00,272,124,148
13377,13377,124,2022/4/15 20:30:00,228,121,107
13378,13378,124,2022/4/15 20:40:00,276,121,155
13379,13379,124,2022/4/15 20:50:00,227,109,118
13380,13380,124,2022/4/15 21:00:00,232,109,123
13381,13381,124,2022/4/15 21:10:00,224,109,115
13382,13382,124,2022/4/15 21:20:00,183,128,55
13383,13383,124,2022/4/15 21:30:00,175,133,42
13384,13384,124,2022/4/15 21:40:00,137,122,15
13385,13385,124,2022/4/15 21:50:00,82,119,-37
13386,13386,124,2022/4/15 22:00:00,67,112,-45
13387,13387,124,2022/4/15 22:10:00,75,124,-49
13388,13388,124,2022/4/15 22:20:00,42,111,-69
13389,13389,124,2022/4/15 22:30:00,28,122,-94
13390,13390,124,2022/4/15 22:40:00,29,112,-83
13391,13391,124,2022/4/15 22:50:00,18,96,-78
13392,13392,125,2022/4/15 5:00:00,0,1,-1
13393,13393,125,2022/4/15 5:10:00,19,1,18
13394,13394,125,2022/4/15 5:20:00,40,1,39
13395,13395,125,2022/4/15 5:30:00,32,1,31
13396,13396,125,2022/4/15 5:40:00,54,1,53
13397,13397,125,2022/4/15 5:50:00,77,1,76
13398,13398,125,2022/4/15 6:00:00,86,1,85
13399,13399,125,2022/4/15 6:10:00,108,1,107
13400,13400,125,2022/4/15 6:20:00,194,45,149
13401,13401,125,2022/4/15 6:30:00,185,50,135
13402,13402,125,2022/4/15 6:40:00,281,72,209
13403,13403,125,2022/4/15 6:50:00,347,63,284
13404,13404,125,2022/4/15 7:00:00,602,106,496
13405,13405,125,2022/4/15 7:10:00,684,92,592
13406,13406,125,2022/4/15 7:20:00,1158,177,981
13407,13407,125,2022/4/15 7:30:00,1982,268,1714
13408,13408,125,2022/4/15 7:40:00,2555,512,2043
13409,13409,125,2022/4/15 7:50:00,3279,441,2838
13410,13410,125,2022/4/15 8:00:00,3287,1075,2212
13411,13411,125,2022/4/15 8:10:00,3262,1489,1773
13412,13412,125,2022/4/15 8:20:00,2544,1493,1051
13413,13413,125,2022/4/15 8:30:00,1969,1717,252
13414,13414,125,2022/4/15 8:40:00,1553,1680,-127
13415,13415,125,2022/4/15 8:50:00,1047,1061,-14
13416,13416,125,2022/4/15 9:00:00,861,573,288
13417,13417,125,2022/4/15 9:10:00,690,573,117
13418,13418,125,2022/4/15 9:20:00,357,421,-64
13419,13419,125,2022/4/15 9:30:00,269,524,-255
13420,13420,125,2022/4/15 9:40:00,237,368,-131
13421,13421,125,2022/4/15 9:50:00,201,216,-15
13422,13422,125,2022/4/15 10:00:00,108,121,-13
13423,13423,125,2022/4/15 10:10:00,131,119,12
13424,13424,125,2022/4/15 10:20:00,75,108,-33
13425,13425,125,2022/4/15 10:30:00,65,100,-35
13426,13426,125,2022/4/15 10:40:00,73,104,-31
13427,13427,125,2022/4/15 10:50:00,71,101,-30
13428,13428,125,2022/4/15 11:00:00,58,112,-54
13429,13429,125,2022/4/15 11:10:00,79,93,-14
13430,13430,125,2022/4/15 11:20:00,66,113,-47
13431,13431,125,2022/4/15 11:30:00,72,108,-36
13432,13432,125,2022/4/15 11:40:00,75,113,-38
13433,13433,125,2022/4/15 11:50:00,89,103,-14
13434,13434,125,2022/4/15 12:00:00,86,105,-19
13435,13435,125,2022/4/15 12:10:00,128,110,18
13436,13436,125,2022/4/15 12:20:00,136,102,34
13437,13437,125,2022/4/15 12:30:00,95,104,-9
13438,13438,125,2022/4/15 12:40:00,94,114,-20
13439,13439,125,2022/4/15 12:50:00,110,103,7
13440,13440,125,2022/4/15 13:00:00,97,99,-2
13441,13441,125,2022/4/15 13:10:00,79,103,-24
13442,13442,125,2022/4/15 13:20:00,83,106,-23
13443,13443,125,2022/4/15 13:30:00,82,111,-29
13444,13444,125,2022/4/15 13:40:00,72,102,-30
13445,13445,125,2022/4/15 13:50:00,71,100,-29
13446,13446,125,2022/4/15 14:00:00,57,116,-59
13447,13447,125,2022/4/15 14:10:00,61,105,-44
13448,13448,125,2022/4/15 14:20:00,57,107,-50
13449,13449,125,2022/4/15 14:30:00,60,119,-59
13450,13450,125,2022/4/15 14:40:00,68,102,-34
13451,13451,125,2022/4/15 14:50:00,53,124,-71
13452,13452,125,2022/4/15 15:00:00,59,126,-67
13453,13453,125,2022/4/15 15:10:00,71,107,-36
13454,13454,125,2022/4/15 15:20:00,64,118,-54
13455,13455,125,2022/4/15 15:30:00,60,106,-46
13456,13456,125,2022/4/15 15:40:00,64,109,-45
13457,13457,125,2022/4/15 15:50:00,73,98,-25
13458,13458,125,2022/4/15 16:00:00,69,125,-56
13459,13459,125,2022/4/15 16:10:00,132,124,8
13460,13460,125,2022/4/15 16:20:00,114,133,-19
13461,13461,125,2022/4/15 16:30:00,130,133,-3
13462,13462,125,2022/4/15 16:40:00,225,144,81
13463,13463,125,2022/4/15 16:50:00,259,138,121
13464,13464,125,2022/4/15 17:00:00,349,175,174
13465,13465,125,2022/4/15 17:10:00,653,219,434
13466,13466,125,2022/4/15 17:20:00,1156,252,904
13467,13467,125,2022/4/15 17:30:00,1148,281,867
13468,13468,125,2022/4/15 17:40:00,1564,383,1181
13469,13469,125,2022/4/15 17:50:00,1589,424,1165
13470,13470,125,2022/4/15 18:00:00,1396,398,998
13471,13471,125,2022/4/15 18:10:00,1367,572,795
13472,13472,125,2022/4/15 18:20:00,1406,572,834
13473,13473,125,2022/4/15 18:30:00,833,1079,-246
13474,13474,125,2022/4/15 18:40:00,633,1498,-865
13475,13475,125,2022/4/15 18:50:00,587,1576,-989
13476,13476,125,2022/4/15 19:00:00,359,1533,-1174
13477,13477,125,2022/4/15 19:10:00,307,1510,-1203
13478,13478,125,2022/4/15 19:20:00,258,557,-299
13479,13479,125,2022/4/15 19:30:00,208,426,-218
13480,13480,125,2022/4/15 19:40:00,138,377,-239
13481,13481,125,2022/4/15 19:50:00,152,430,-278
13482,13482,125,2022/4/15 20:00:00,115,321,-206
13483,13483,125,2022/4/15 20:10:00,160,318,-158
13484,13484,125,2022/4/15 20:20:00,174,148,26
13485,13485,125,2022/4/15 20:30:00,92,378,-286
13486,13486,125,2022/4/15 20:40:00,93,321,-228
13487,13487,125,2022/4/15 20:50:00,79,256,-177
13488,13488,125,2022/4/15 21:00:00,70,225,-155
13489,13489,125,2022/4/15 21:10:00,98,277,-179
13490,13490,125,2022/4/15 21:20:00,63,233,-170
13491,13491,125,2022/4/15 21:30:00,48,197,-149
13492,13492,125,2022/4/15 21:40:00,35,257,-222
13493,13493,125,2022/4/15 21:50:00,33,196,-163
13494,13494,125,2022/4/15 22:00:00,24,186,-162
13495,13495,125,2022/4/15 22:10:00,23,186,-163
13496,13496,125,2022/4/15 22:20:00,22,186,-164
13497,13497,125,2022/4/15 22:30:00,13,240,-227
13498,13498,125,2022/4/15 22:40:00,2,221,-219
13499,13499,125,2022/4/15 22:50:00,0,124,-124
13500,13500,126,2022/4/15 5:00:00,0,1,-1
13501,13501,126,2022/4/15 5:10:00,0,1,-1
13502,13502,126,2022/4/15 5:20:00,0,1,-1
13503,13503,126,2022/4/15 5:30:00,0,1,-1
13504,13504,126,2022/4/15 5:40:00,3,1,2
13505,13505,126,2022/4/15 5:50:00,7,1,6
13506,13506,126,2022/4/15 6:00:00,4,1,3
13507,13507,126,2022/4/15 6:10:00,6,1,5
13508,13508,126,2022/4/15 6:20:00,7,1,6
13509,13509,126,2022/4/15 6:30:00,8,12,-4
13510,13510,126,2022/4/15 6:40:00,10,6,4
13511,13511,126,2022/4/15 6:50:00,6,14,-8
13512,13512,126,2022/4/15 7:00:00,10,31,-21
13513,13513,126,2022/4/15 7:10:00,9,42,-33
13514,13514,126,2022/4/15 7:20:00,7,51,-44
13515,13515,126,2022/4/15 7:30:00,13,50,-37
13516,13516,126,2022/4/15 7:40:00,12,75,-63
13517,13517,126,2022/4/15 7:50:00,13,68,-55
13518,13518,126,2022/4/15 8:00:00,13,113,-100
13519,13519,126,2022/4/15 8:10:00,16,98,-82
13520,13520,126,2022/4/15 8:20:00,14,114,-100
13521,13521,126,2022/4/15 8:30:00,18,102,-84
13522,13522,126,2022/4/15 8:40:00,17,71,-54
13523,13523,126,2022/4/15 8:50:00,14,88,-74
13524,13524,126,2022/4/15 9:00:00,12,72,-60
13525,13525,126,2022/4/15 9:10:00,12,48,-36
13526,13526,126,2022/4/15 9:20:00,9,61,-52
13527,13527,126,2022/4/15 9:30:00,15,51,-36
13528,13528,126,2022/4/15 9:40:00,8,33,-25
13529,13529,126,2022/4/15 9:50:00,10,45,-35
13530,13530,126,2022/4/15 10:00:00,7,33,-26
13531,13531,126,2022/4/15 10:10:00,10,25,-15
13532,13532,126,2022/4/15 10:20:00,5,24,-19
13533,13533,126,2022/4/15 10:30:00,13,31,-18
13534,13534,126,2022/4/15 10:40:00,9,7,2
13535,13535,126,2022/4/15 10:50:00,6,34,-28
13536,13536,126,2022/4/15 11:00:00,8,22,-14
13537,13537,126,2022/4/15 11:10:00,12,21,-9
13538,13538,126,2022/4/15 11:20:00,12,23,-11
13539,13539,126,2022/4/15 11:30:00,10,19,-9
13540,13540,126,2022/4/15 11:40:00,9,16,-7
13541,13541,126,2022/4/15 11:50:00,8,23,-15
13542,13542,126,2022/4/15 12:00:00,9,23,-14
13543,13543,126,2022/4/15 12:10:00,12,23,-11
13544,13544,126,2022/4/15 12:20:00,10,19,-9
13545,13545,126,2022/4/15 12:30:00,7,25,-18
13546,13546,126,2022/4/15 12:40:00,6,21,-15
13547,13547,126,2022/4/15 12:50:00,7,29,-22
13548,13548,126,2022/4/15 13:00:00,5,23,-18
13549,13549,126,2022/4/15 13:10:00,11,16,-5
13550,13550,126,2022/4/15 13:20:00,10,23,-13
13551,13551,126,2022/4/15 13:30:00,9,19,-10
13552,13552,126,2022/4/15 13:40:00,9,16,-7
13553,13553,126,2022/4/15 13:50:00,9,21,-12
13554,13554,126,2022/4/15 14:00:00,11,12,-1
13555,13555,126,2022/4/15 14:10:00,12,17,-5
13556,13556,126,2022/4/15 14:20:00,8,14,-6
13557,13557,126,2022/4/15 14:30:00,8,19,-11
13558,13558,126,2022/4/15 14:40:00,13,19,-6
13559,13559,126,2022/4/15 14:50:00,12,16,-4
13560,13560,126,2022/4/15 15:00:00,12,19,-7
13561,13561,126,2022/4/15 15:10:00,13,19,-6
13562,13562,126,2022/4/15 15:20:00,15,14,1
13563,13563,126,2022/4/15 15:30:00,17,19,-2
13564,13564,126,2022/4/15 15:40:00,21,23,-2
13565,13565,126,2022/4/15 15:50:00,24,18,6
13566,13566,126,2022/4/15 16:00:00,27,14,13
13567,13567,126,2022/4/15 16:10:00,27,19,8
13568,13568,126,2022/4/15 16:20:00,28,12,16
13569,13569,126,2022/4/15 16:30:00,37,21,16
13570,13570,126,2022/4/15 16:40:00,29,18,11
13571,13571,126,2022/4/15 16:50:00,16,12,4
13572,13572,126,2022/4/15 17:00:00,23,14,9
13573,13573,126,2022/4/15 17:10:00,23,12,11
13574,13574,126,2022/4/15 17:20:00,26,21,5
13575,13575,126,2022/4/15 17:30:00,23,7,16
13576,13576,126,2022/4/15 17:40:00,17,16,1
13577,13577,126,2022/4/15 17:50:00,11,12,-1
13578,13578,126,2022/4/15 18:00:00,9,25,-16
13579,13579,126,2022/4/15 18:10:00,8,23,-15
13580,13580,126,2022/4/15 18:20:00,7,21,-14
13581,13581,126,2022/4/15 18:30:00,12,21,-9
13582,13582,126,2022/4/15 18:40:00,3,15,-12
13583,13583,126,2022/4/15 18:50:00,5,22,-17
13584,13584,126,2022/4/15 19:00:00,6,15,-9
13585,13585,126,2022/4/15 19:10:00,4,25,-21
13586,13586,126,2022/4/15 19:20:00,7,32,-25
13587,13587,126,2022/4/15 19:30:00,5,25,-20
13588,13588,126,2022/4/15 19:40:00,4,24,-20
13589,13589,126,2022/4/15 19:50:00,4,15,-11
13590,13590,126,2022/4/15 20:00:00,6,30,-24
13591,13591,126,2022/4/15 20:10:00,7,31,-24
13592,13592,126,2022/4/15 20:20:00,7,25,-18
13593,13593,126,2022/4/15 20:30:00,8,23,-15
13594,13594,126,2022/4/15 20:40:00,5,13,-8
13595,13595,126,2022/4/15 20:50:00,5,22,-17
13596,13596,126,2022/4/15 21:00:00,2,15,-13
13597,13597,126,2022/4/15 21:10:00,4,21,-17
13598,13598,126,2022/4/15 21:20:00,2,21,-19
13599,13599,126,2022/4/15 21:30:00,2,16,-14
13600,13600,126,2022/4/15 21:40:00,1,23,-22
13601,13601,126,2022/4/15 21:50:00,2,18,-16
13602,13602,126,2022/4/15 22:00:00,1,21,-20
13603,13603,126,2022/4/15 22:10:00,0,10,-10
13604,13604,126,2022/4/15 22:20:00,0,13,-13
13605,13605,126,2022/4/15 22:30:00,0,8,-8
13606,13606,126,2022/4/15 22:40:00,0,3,-3
13607,13607,126,2022/4/15 22:50:00,0,3,-3
13608,13608,127,2022/4/15 5:00:00,2,1,1
13609,13609,127,2022/4/15 5:10:00,5,1,4
13610,13610,127,2022/4/15 5:20:00,8,1,7
13611,13611,127,2022/4/15 5:30:00,9,6,3
13612,13612,127,2022/4/15 5:40:00,20,5,15
13613,13613,127,2022/4/15 5:50:00,22,8,14
13614,13614,127,2022/4/15 6:00:00,26,83,-57
13615,13615,127,2022/4/15 6:10:00,31,69,-38
13616,13616,127,2022/4/15 6:20:00,29,85,-56
13617,13617,127,2022/4/15 6:30:00,45,118,-73
13618,13618,127,2022/4/15 6:40:00,51,101,-50
13619,13619,127,2022/4/15 6:50:00,68,119,-51
13620,13620,127,2022/4/15 7:00:00,87,105,-18
13621,13621,127,2022/4/15 7:10:00,146,128,18
13622,13622,127,2022/4/15 7:20:00,146,109,37
13623,13623,127,2022/4/15 7:30:00,185,151,34
13624,13624,127,2022/4/15 7:40:00,302,159,143
13625,13625,127,2022/4/15 7:50:00,326,335,-9
13626,13626,127,2022/4/15 8:00:00,601,510,91
13627,13627,127,2022/4/15 8:10:00,609,315,294
13628,13628,127,2022/4/15 8:20:00,475,492,-17
13629,13629,127,2022/4/15 8:30:00,321,327,-6
13630,13630,127,2022/4/15 8:40:00,327,176,151
13631,13631,127,2022/4/15 8:50:00,276,195,81
13632,13632,127,2022/4/15 9:00:00,203,119,84
13633,13633,127,2022/4/15 9:10:00,201,142,59
13634,13634,127,2022/4/15 9:20:00,179,113,66
13635,13635,127,2022/4/15 9:30:00,137,109,28
13636,13636,127,2022/4/15 9:40:00,79,108,-29
13637,13637,127,2022/4/15 9:50:00,72,108,-36
13638,13638,127,2022/4/15 10:00:00,54,113,-59
13639,13639,127,2022/4/15 10:10:00,62,121,-59
13640,13640,127,2022/4/15 10:20:00,44,121,-77
13641,13641,127,2022/4/15 10:30:00,51,123,-72
13642,13642,127,2022/4/15 10:40:00,48,124,-76
13643,13643,127,2022/4/15 10:50:00,50,119,-69
13644,13644,127,2022/4/15 11:00:00,54,119,-65
13645,13645,127,2022/4/15 11:10:00,53,108,-55
13646,13646,127,2022/4/15 11:20:00,58,110,-52
13647,13647,127,2022/4/15 11:30:00,63,124,-61
13648,13648,127,2022/4/15 11:40:00,59,110,-51
13649,13649,127,2022/4/15 11:50:00,58,107,-49
13650,13650,127,2022/4/15 12:00:00,70,99,-29
13651,13651,127,2022/4/15 12:10:00,110,123,-13
13652,13652,127,2022/4/15 12:20:00,86,112,-26
13653,13653,127,2022/4/15 12:30:00,59,106,-47
13654,13654,127,2022/4/15 12:40:00,59,104,-45
13655,13655,127,2022/4/15 12:50:00,63,123,-60
13656,13656,127,2022/4/15 13:00:00,55,103,-48
13657,13657,127,2022/4/15 13:10:00,52,105,-53
13658,13658,127,2022/4/15 13:20:00,52,100,-48
13659,13659,127,2022/4/15 13:30:00,59,122,-63
13660,13660,127,2022/4/15 13:40:00,55,114,-59
13661,13661,127,2022/4/15 13:50:00,67,102,-35
13662,13662,127,2022/4/15 14:00:00,53,102,-49
13663,13663,127,2022/4/15 14:10:00,57,104,-47
13664,13664,127,2022/4/15 14:20:00,56,113,-57
13665,13665,127,2022/4/15 14:30:00,64,99,-35
13666,13666,127,2022/4/15 14:40:00,56,102,-46
13667,13667,127,2022/4/15 14:50:00,50,126,-76
13668,13668,127,2022/4/15 15:00:00,65,100,-35
13669,13669,127,2022/4/15 15:10:00,70,102,-32
13670,13670,127,2022/4/15 15:20:00,64,107,-43
13671,13671,127,2022/4/15 15:30:00,69,101,-32
13672,13672,127,2022/4/15 15:40:00,72,120,-48
13673,13673,127,2022/4/15 15:50:00,87,101,-14
13674,13674,127,2022/4/15 16:00:00,105,101,4
13675,13675,127,2022/4/15 16:10:00,175,123,52
13676,13676,127,2022/4/15 16:20:00,136,104,32
13677,13677,127,2022/4/15 16:30:00,173,121,52
13678,13678,127,2022/4/15 16:40:00,161,96,65
13679,13679,127,2022/4/15 16:50:00,202,108,94
13680,13680,127,2022/4/15 17:00:00,330,115,215
13681,13681,127,2022/4/15 17:10:00,310,108,202
13682,13682,127,2022/4/15 17:20:00,304,122,182
13683,13683,127,2022/4/15 17:30:00,270,103,167
13684,13684,127,2022/4/15 17:40:00,273,183,90
13685,13685,127,2022/4/15 17:50:00,267,196,71
13686,13686,127,2022/4/15 18:00:00,264,235,29
13687,13687,127,2022/4/15 18:10:00,211,116,95
13688,13688,127,2022/4/15 18:20:00,203,271,-68
13689,13689,127,2022/4/15 18:30:00,211,198,13
13690,13690,127,2022/4/15 18:40:00,177,170,7
13691,13691,127,2022/4/15 18:50:00,173,209,-36
13692,13692,127,2022/4/15 19:00:00,150,118,32
13693,13693,127,2022/4/15 19:10:00,137,151,-14
13694,13694,127,2022/4/15 19:20:00,123,111,12
13695,13695,127,2022/4/15 19:30:00,120,112,8
13696,13696,127,2022/4/15 19:40:00,126,103,23
13697,13697,127,2022/4/15 19:50:00,74,112,-38
13698,13698,127,2022/4/15 20:00:00,96,103,-7
13699,13699,127,2022/4/15 20:10:00,110,77,33
13700,13700,127,2022/4/15 20:20:00,81,103,-22
13701,13701,127,2022/4/15 20:30:00,71,77,-6
13702,13702,127,2022/4/15 20:40:00,57,99,-42
13703,13703,127,2022/4/15 20:50:00,63,71,-8
13704,13704,127,2022/4/15 21:00:00,65,81,-16
13705,13705,127,2022/4/15 21:10:00,57,50,7
13706,13706,127,2022/4/15 21:20:00,47,77,-30
13707,13707,127,2022/4/15 21:30:00,46,79,-33
13708,13708,127,2022/4/15 21:40:00,43,62,-19
13709,13709,127,2022/4/15 21:50:00,44,71,-27
13710,13710,127,2022/4/15 22:00:00,42,63,-21
13711,13711,127,2022/4/15 22:10:00,42,71,-29
13712,13712,127,2022/4/15 22:20:00,34,68,-34
13713,13713,127,2022/4/15 22:30:00,29,66,-37
13714,13714,127,2022/4/15 22:40:00,23,49,-26
13715,13715,127,2022/4/15 22:50:00,20,51,-31
13716,13716,128,2022/4/15 5:00:00,0,1,-1
13717,13717,128,2022/4/15 5:10:00,4,1,3
13718,13718,128,2022/4/15 5:20:00,4,1,3
13719,13719,128,2022/4/15 5:30:00,6,21,-15
13720,13720,128,2022/4/15 5:40:00,14,15,-1
13721,13721,128,2022/4/15 5:50:00,13,23,-10
13722,13722,128,2022/4/15 6:00:00,24,106,-82
13723,13723,128,2022/4/15 6:10:00,21,103,-82
13724,13724,128,2022/4/15 6:20:00,31,259,-228
13725,13725,128,2022/4/15 6:30:00,39,378,-339
13726,13726,128,2022/4/15 6:40:00,45,491,-446
13727,13727,128,2022/4/15 6:50:00,59,490,-431
13728,13728,128,2022/4/15 7:00:00,82,410,-328
13729,13729,128,2022/4/15 7:10:00,182,516,-334
13730,13730,128,2022/4/15 7:20:00,196,411,-215
13731,13731,128,2022/4/15 7:30:00,250,590,-340
13732,13732,128,2022/4/15 7:40:00,302,1136,-834
13733,13733,128,2022/4/15 7:50:00,449,1123,-674
13734,13734,128,2022/4/15 8:00:00,367,560,-193
13735,13735,128,2022/4/15 8:10:00,650,1428,-778
13736,13736,128,2022/4/15 8:20:00,915,1475,-560
13737,13737,128,2022/4/15 8:30:00,347,1029,-682
13738,13738,128,2022/4/15 8:40:00,616,1478,-862
13739,13739,128,2022/4/15 8:50:00,281,551,-270
13740,13740,128,2022/4/15 9:00:00,280,568,-288
13741,13741,128,2022/4/15 9:10:00,587,466,121
13742,13742,128,2022/4/15 9:20:00,270,558,-288
13743,13743,128,2022/4/15 9:30:00,364,465,-101
13744,13744,128,2022/4/15 9:40:00,211,411,-200
13745,13745,128,2022/4/15 9:50:00,83,395,-312
13746,13746,128,2022/4/15 10:00:00,68,420,-352
13747,13747,128,2022/4/15 10:10:00,272,476,-204
13748,13748,128,2022/4/15 10:20:00,203,315,-112
13749,13749,128,2022/4/15 10:30:00,206,460,-254
13750,13750,128,2022/4/15 10:40:00,270,324,-54
13751,13751,128,2022/4/15 10:50:00,184,271,-87
13752,13752,128,2022/4/15 11:00:00,160,323,-163
13753,13753,128,2022/4/15 11:10:00,170,272,-102
13754,13754,128,2022/4/15 11:20:00,255,240,15
13755,13755,128,2022/4/15 11:30:00,195,212,-17
13756,13756,128,2022/4/15 11:40:00,230,276,-46
13757,13757,128,2022/4/15 11:50:00,200,288,-88
13758,13758,128,2022/4/15 12:00:00,160,232,-72
13759,13759,128,2022/4/15 12:10:00,130,172,-42
13760,13760,128,2022/4/15 12:20:00,195,297,-102
13761,13761,128,2022/4/15 12:30:00,143,319,-176
13762,13762,128,2022/4/15 12:40:00,265,290,-25
13763,13763,128,2022/4/15 12:50:00,238,280,-42
13764,13764,128,2022/4/15 13:00:00,256,469,-213
13765,13765,128,2022/4/15 13:10:00,607,437,170
13766,13766,128,2022/4/15 13:20:00,336,475,-139
13767,13767,128,2022/4/15 13:30:00,621,295,326
13768,13768,128,2022/4/15 13:40:00,336,360,-24
13769,13769,128,2022/4/15 13:50:00,636,367,269
13770,13770,128,2022/4/15 14:00:00,339,311,28
13771,13771,128,2022/4/15 14:10:00,367,290,77
13772,13772,128,2022/4/15 14:20:00,456,465,-9
13773,13773,128,2022/4/15 14:30:00,589,351,238
13774,13774,128,2022/4/15 14:40:00,564,328,236
13775,13775,128,2022/4/15 14:50:00,455,290,165
13776,13776,128,2022/4/15 15:00:00,679,472,207
13777,13777,128,2022/4/15 15:10:00,638,473,165
13778,13778,128,2022/4/15 15:20:00,572,367,205
13779,13779,128,2022/4/15 15:30:00,655,467,188
13780,13780,128,2022/4/15 15:40:00,583,360,223
13781,13781,128,2022/4/15 15:50:00,336,468,-132
13782,13782,128,2022/4/15 16:00:00,637,287,350
13783,13783,128,2022/4/15 16:10:00,839,456,383
13784,13784,128,2022/4/15 16:20:00,637,288,349
13785,13785,128,2022/4/15 16:30:00,820,456,364
13786,13786,128,2022/4/15 16:40:00,620,309,311
13787,13787,128,2022/4/15 16:50:00,428,315,113
13788,13788,128,2022/4/15 17:00:00,830,331,499
13789,13789,128,2022/4/15 17:10:00,834,284,550
13790,13790,128,2022/4/15 17:20:00,600,364,236
13791,13791,128,2022/4/15 17:30:00,1247,415,832
13792,13792,128,2022/4/15 17:40:00,1415,324,1091
13793,13793,128,2022/4/15 17:50:00,643,344,299
13794,13794,128,2022/4/15 18:00:00,457,371,86
13795,13795,128,2022/4/15 18:10:00,697,644,53
13796,13796,128,2022/4/15 18:20:00,735,418,317
13797,13797,128,2022/4/15 18:30:00,611,518,93
13798,13798,128,2022/4/15 18:40:00,336,734,-398
13799,13799,128,2022/4/15 18:50:00,828,376,452
13800,13800,128,2022/4/15 19:00:00,1204,371,833
13801,13801,128,2022/4/15 19:10:00,733,453,280
13802,13802,128,2022/4/15 19:20:00,649,344,305
13803,13803,128,2022/4/15 19:30:00,326,269,57
13804,13804,128,2022/4/15 19:40:00,721,272,449
13805,13805,128,2022/4/15 19:50:00,679,239,440
13806,13806,128,2022/4/15 20:00:00,801,220,581
13807,13807,128,2022/4/15 20:10:00,845,117,728
13808,13808,128,2022/4/15 20:20:00,813,116,697
13809,13809,128,2022/4/15 20:30:00,637,172,465
13810,13810,128,2022/4/15 20:40:00,817,110,707
13811,13811,128,2022/4/15 20:50:00,643,139,504
13812,13812,128,2022/4/15 21:00:00,615,112,503
13813,13813,128,2022/4/15 21:10:00,583,117,466
13814,13814,128,2022/4/15 21:20:00,812,100,712
13815,13815,128,2022/4/15 21:30:00,321,100,221
13816,13816,128,2022/4/15 21:40:00,582,101,481
13817,13817,128,2022/4/15 21:50:00,248,72,176
13818,13818,128,2022/4/15 22:00:00,193,92,101
13819,13819,128,2022/4/15 22:10:00,434,92,342
13820,13820,128,2022/4/15 22:20:00,326,88,238
13821,13821,128,2022/4/15 22:30:00,129,74,55
13822,13822,128,2022/4/15 22:40:00,78,73,5
13823,13823,128,2022/4/15 22:50:00,56,60,-4
13824,13824,129,2022/4/15 5:00:00,0,1,-1
13825,13825,129,2022/4/15 5:10:00,0,1,-1
13826,13826,129,2022/4/15 5:20:00,0,1,-1
13827,13827,129,2022/4/15 5:30:00,0,1,-1
13828,13828,129,2022/4/15 5:40:00,0,1,-1
13829,13829,129,2022/4/15 5:50:00,7,1,6
13830,13830,129,2022/4/15 6:00:00,23,1,22
13831,13831,129,2022/4/15 6:10:00,50,1,49
13832,13832,129,2022/4/15 6:20:00,79,8,71
13833,13833,129,2022/4/15 6:30:00,87,8,79
13834,13834,129,2022/4/15 6:40:00,168,50,118
13835,13835,129,2022/4/15 6:50:00,206,47,159
13836,13836,129,2022/4/15 7:00:00,245,62,183
13837,13837,129,2022/4/15 7:10:00,344,60,284
13838,13838,129,2022/4/15 7:20:00,590,73,517
13839,13839,129,2022/4/15 7:30:00,722,40,682
13840,13840,129,2022/4/15 7:40:00,830,75,755
13841,13841,129,2022/4/15 7:50:00,838,62,776
13842,13842,129,2022/4/15 8:00:00,735,84,651
13843,13843,129,2022/4/15 8:10:00,688,87,601
13844,13844,129,2022/4/15 8:20:00,593,51,542
13845,13845,129,2022/4/15 8:30:00,347,85,262
13846,13846,129,2022/4/15 8:40:00,236,75,161
13847,13847,129,2022/4/15 8:50:00,223,57,166
13848,13848,129,2022/4/15 9:00:00,149,68,81
13849,13849,129,2022/4/15 9:10:00,77,65,12
13850,13850,129,2022/4/15 9:20:00,60,54,6
13851,13851,129,2022/4/15 9:30:00,48,68,-20
13852,13852,129,2022/4/15 9:40:00,41,70,-29
13853,13853,129,2022/4/15 9:50:00,36,49,-13
13854,13854,129,2022/4/15 10:00:00,31,62,-31
13855,13855,129,2022/4/15 10:10:00,30,73,-43
13856,13856,129,2022/4/15 10:20:00,28,50,-22
13857,13857,129,2022/4/15 10:30:00,27,64,-37
13858,13858,129,2022/4/15 10:40:00,25,59,-34
13859,13859,129,2022/4/15 10:50:00,30,45,-15
13860,13860,129,2022/4/15 11:00:00,25,53,-28
13861,13861,129,2022/4/15 11:10:00,26,52,-26
13862,13862,129,2022/4/15 11:20:00,29,54,-25
13863,13863,129,2022/4/15 11:30:00,30,68,-38
13864,13864,129,2022/4/15 11:40:00,31,57,-26
13865,13865,129,2022/4/15 11:50:00,29,57,-28
13866,13866,129,2022/4/15 12:00:00,25,52,-27
13867,13867,129,2022/4/15 12:10:00,28,51,-23
13868,13868,129,2022/4/15 12:20:00,33,55,-22
13869,13869,129,2022/4/15 12:30:00,27,86,-59
13870,13870,129,2022/4/15 12:40:00,29,57,-28
13871,13871,129,2022/4/15 12:50:00,27,64,-37
13872,13872,129,2022/4/15 13:00:00,27,59,-32
13873,13873,129,2022/4/15 13:10:00,28,49,-21
13874,13874,129,2022/4/15 13:20:00,28,69,-41
13875,13875,129,2022/4/15 13:30:00,29,72,-43
13876,13876,129,2022/4/15 13:40:00,28,61,-33
13877,13877,129,2022/4/15 13:50:00,24,53,-29
13878,13878,129,2022/4/15 14:00:00,24,52,-28
13879,13879,129,2022/4/15 14:10:00,25,63,-38
13880,13880,129,2022/4/15 14:20:00,24,77,-53
13881,13881,129,2022/4/15 14:30:00,22,72,-50
13882,13882,129,2022/4/15 14:40:00,22,64,-42
13883,13883,129,2022/4/15 14:50:00,23,60,-37
13884,13884,129,2022/4/15 15:00:00,22,67,-45
13885,13885,129,2022/4/15 15:10:00,24,67,-43
13886,13886,129,2022/4/15 15:20:00,22,96,-74
13887,13887,129,2022/4/15 15:30:00,22,75,-53
13888,13888,129,2022/4/15 15:40:00,24,68,-44
13889,13889,129,2022/4/15 15:50:00,28,75,-47
13890,13890,129,2022/4/15 16:00:00,29,75,-46
13891,13891,129,2022/4/15 16:10:00,27,90,-63
13892,13892,129,2022/4/15 16:20:00,27,113,-86
13893,13893,129,2022/4/15 16:30:00,33,96,-63
13894,13894,129,2022/4/15 16:40:00,33,93,-60
13895,13895,129,2022/4/15 16:50:00,29,99,-70
13896,13896,129,2022/4/15 17:00:00,25,108,-83
13897,13897,129,2022/4/15 17:10:00,32,91,-59
13898,13898,129,2022/4/15 17:20:00,24,150,-126
13899,13899,129,2022/4/15 17:30:00,29,104,-75
13900,13900,129,2022/4/15 17:40:00,28,180,-152
13901,13901,129,2022/4/15 17:50:00,28,196,-168
13902,13902,129,2022/4/15 18:00:00,27,182,-155
13903,13903,129,2022/4/15 18:10:00,28,268,-240
13904,13904,129,2022/4/15 18:20:00,24,197,-173
13905,13905,129,2022/4/15 18:30:00,21,383,-362
13906,13906,129,2022/4/15 18:40:00,20,203,-183
13907,13907,129,2022/4/15 18:50:00,23,386,-363
13908,13908,129,2022/4/15 19:00:00,20,327,-307
13909,13909,129,2022/4/15 19:10:00,20,222,-202
13910,13910,129,2022/4/15 19:20:00,18,335,-317
13911,13911,129,2022/4/15 19:30:00,14,128,-114
13912,13912,129,2022/4/15 19:40:00,15,224,-209
13913,13913,129,2022/4/15 19:50:00,13,120,-107
13914,13914,129,2022/4/15 20:00:00,14,93,-79
13915,13915,129,2022/4/15 20:10:00,15,153,-138
13916,13916,129,2022/4/15 20:20:00,13,74,-61
13917,13917,129,2022/4/15 20:30:00,12,110,-98
13918,13918,129,2022/4/15 20:40:00,13,91,-78
13919,13919,129,2022/4/15 20:50:00,14,122,-108
13920,13920,129,2022/4/15 21:00:00,13,107,-94
13921,13921,129,2022/4/15 21:10:00,12,121,-109
13922,13922,129,2022/4/15 21:20:00,12,122,-110
13923,13923,129,2022/4/15 21:30:00,8,82,-74
13924,13924,129,2022/4/15 21:40:00,11,104,-93
13925,13925,129,2022/4/15 21:50:00,4,107,-103
13926,13926,129,2022/4/15 22:00:00,4,100,-96
13927,13927,129,2022/4/15 22:10:00,2,72,-70
13928,13928,129,2022/4/15 22:20:00,2,104,-102
13929,13929,129,2022/4/15 22:30:00,0,64,-64
13930,13930,129,2022/4/15 22:40:00,0,3,-3
13931,13931,129,2022/4/15 22:50:00,0,3,-3
13932,13932,130,2022/4/15 5:00:00,0,1,-1
13933,13933,130,2022/4/15 5:10:00,0,1,-1
13934,13934,130,2022/4/15 5:20:00,3,1,2
13935,13935,130,2022/4/15 5:30:00,11,1,10
13936,13936,130,2022/4/15 5:40:00,21,6,15
13937,13937,130,2022/4/15 5:50:00,26,21,5
13938,13938,130,2022/4/15 6:00:00,26,23,3
13939,13939,130,2022/4/15 6:10:00,34,49,-15
13940,13940,130,2022/4/15 6:20:00,40,48,-8
13941,13941,130,2022/4/15 6:30:00,54,72,-18
13942,13942,130,2022/4/15 6:40:00,69,76,-7
13943,13943,130,2022/4/15 6:50:00,85,96,-11
13944,13944,130,2022/4/15 7:00:00,102,102,0
13945,13945,130,2022/4/15 7:10:00,190,183,7
13946,13946,130,2022/4/15 7:20:00,215,224,-9
13947,13947,130,2022/4/15 7:30:00,242,232,10
13948,13948,130,2022/4/15 7:40:00,317,316,1
13949,13949,130,2022/4/15 7:50:00,367,505,-138
13950,13950,130,2022/4/15 8:00:00,571,584,-13
13951,13951,130,2022/4/15 8:10:00,598,1537,-939
13952,13952,130,2022/4/15 8:20:00,628,1757,-1129
13953,13953,130,2022/4/15 8:30:00,572,2665,-2093
13954,13954,130,2022/4/15 8:40:00,350,2349,-1999
13955,13955,130,2022/4/15 8:50:00,282,2742,-2460
13956,13956,130,2022/4/15 9:00:00,270,1537,-1267
13957,13957,130,2022/4/15 9:10:00,237,1124,-887
13958,13958,130,2022/4/15 9:20:00,216,561,-345
13959,13959,130,2022/4/15 9:30:00,190,405,-215
13960,13960,130,2022/4/15 9:40:00,187,376,-189
13961,13961,130,2022/4/15 9:50:00,156,254,-98
13962,13962,130,2022/4/15 10:00:00,108,233,-125
13963,13963,130,2022/4/15 10:10:00,89,183,-94
13964,13964,130,2022/4/15 10:20:00,95,181,-86
13965,13965,130,2022/4/15 10:30:00,91,117,-26
13966,13966,130,2022/4/15 10:40:00,84,122,-38
13967,13967,130,2022/4/15 10:50:00,101,108,-7
13968,13968,130,2022/4/15 11:00:00,81,124,-43
13969,13969,130,2022/4/15 11:10:00,98,108,-10
13970,13970,130,2022/4/15 11:20:00,123,125,-2
13971,13971,130,2022/4/15 11:30:00,131,122,9
13972,13972,130,2022/4/15 11:40:00,148,102,46
13973,13973,130,2022/4/15 11:50:00,131,104,27
13974,13974,130,2022/4/15 12:00:00,135,121,14
13975,13975,130,2022/4/15 12:10:00,131,106,25
13976,13976,130,2022/4/15 12:20:00,128,123,5
13977,13977,130,2022/4/15 12:30:00,132,108,24
13978,13978,130,2022/4/15 12:40:00,132,108,24
13979,13979,130,2022/4/15 12:50:00,109,119,-10
13980,13980,130,2022/4/15 13:00:00,132,129,3
13981,13981,130,2022/4/15 13:10:00,137,170,-33
13982,13982,130,2022/4/15 13:20:00,170,139,31
13983,13983,130,2022/4/15 13:30:00,144,128,16
13984,13984,130,2022/4/15 13:40:00,148,126,22
13985,13985,130,2022/4/15 13:50:00,153,117,36
13986,13986,130,2022/4/15 14:00:00,156,111,45
13987,13987,130,2022/4/15 14:10:00,156,108,48
13988,13988,130,2022/4/15 14:20:00,173,109,64
13989,13989,130,2022/4/15 14:30:00,169,106,63
13990,13990,130,2022/4/15 14:40:00,171,120,51
13991,13991,130,2022/4/15 14:50:00,164,109,55
13992,13992,130,2022/4/15 15:00:00,206,114,92
13993,13993,130,2022/4/15 15:10:00,192,121,71
13994,13994,130,2022/4/15 15:20:00,196,109,87
13995,13995,130,2022/4/15 15:30:00,216,108,108
13996,13996,130,2022/4/15 15:40:00,207,105,102
13997,13997,130,2022/4/15 15:50:00,218,109,109
13998,13998,130,2022/4/15 16:00:00,216,122,94
13999,13999,130,2022/4/15 16:10:00,221,109,112
14000,14000,130,2022/4/15 16:20:00,224,121,103
14001,14001,130,2022/4/15 16:30:00,265,108,157
14002,14002,130,2022/4/15 16:40:00,329,125,204
14003,14003,130,2022/4/15 16:50:00,336,128,208
14004,14004,130,2022/4/15 17:00:00,697,138,559
14005,14005,130,2022/4/15 17:10:00,1044,142,902
14006,14006,130,2022/4/15 17:20:00,696,145,551
14007,14007,130,2022/4/15 17:30:00,713,196,517
14008,14008,130,2022/4/15 17:40:00,1594,298,1296
14009,14009,130,2022/4/15 17:50:00,1206,298,908
14010,14010,130,2022/4/15 18:00:00,1033,301,732
14011,14011,130,2022/4/15 18:10:00,1992,284,1708
14012,14012,130,2022/4/15 18:20:00,1568,300,1268
14013,14013,130,2022/4/15 18:30:00,1035,301,734
14014,14014,130,2022/4/15 18:40:00,698,301,397
14015,14015,130,2022/4/15 18:50:00,575,300,275
14016,14016,130,2022/4/15 19:00:00,310,224,86
14017,14017,130,2022/4/15 19:10:00,347,179,168
14018,14018,130,2022/4/15 19:20:00,270,111,159
14019,14019,130,2022/4/15 19:30:00,220,107,113
14020,14020,130,2022/4/15 19:40:00,218,125,93
14021,14021,130,2022/4/15 19:50:00,173,117,56
14022,14022,130,2022/4/15 20:00:00,174,88,86
14023,14023,130,2022/4/15 20:10:00,175,108,67
14024,14024,130,2022/4/15 20:20:00,137,103,34
14025,14025,130,2022/4/15 20:30:00,137,114,23
14026,14026,130,2022/4/15 20:40:00,114,107,7
14027,14027,130,2022/4/15 20:50:00,96,104,-8
14028,14028,130,2022/4/15 21:00:00,101,106,-5
14029,14029,130,2022/4/15 21:10:00,133,108,25
14030,14030,130,2022/4/15 21:20:00,77,121,-44
14031,14031,130,2022/4/15 21:30:00,66,112,-46
14032,14032,130,2022/4/15 21:40:00,49,110,-61
14033,14033,130,2022/4/15 21:50:00,42,111,-69
14034,14034,130,2022/4/15 22:00:00,39,103,-64
14035,14035,130,2022/4/15 22:10:00,41,105,-64
14036,14036,130,2022/4/15 22:20:00,28,112,-84
14037,14037,130,2022/4/15 22:30:00,27,98,-71
14038,14038,130,2022/4/15 22:40:00,23,79,-56
14039,14039,130,2022/4/15 22:50:00,14,73,-59
14040,14040,131,2022/4/15 5:00:00,0,1,-1
14041,14041,131,2022/4/15 5:10:00,3,1,2
14042,14042,131,2022/4/15 5:20:00,17,1,16
14043,14043,131,2022/4/15 5:30:00,10,1,9
14044,14044,131,2022/4/15 5:40:00,18,1,17
14045,14045,131,2022/4/15 5:50:00,19,2,17
14046,14046,131,2022/4/15 6:00:00,31,2,29
14047,14047,131,2022/4/15 6:10:00,30,1,29
14048,14048,131,2022/4/15 6:20:00,55,47,8
14049,14049,131,2022/4/15 6:30:00,46,68,-22
14050,14050,131,2022/4/15 6:40:00,88,77,11
14051,14051,131,2022/4/15 6:50:00,87,100,-13
14052,14052,131,2022/4/15 7:00:00,170,105,65
14053,14053,131,2022/4/15 7:10:00,233,122,111
14054,14054,131,2022/4/15 7:20:00,352,297,55
14055,14055,131,2022/4/15 7:30:00,662,536,126
14056,14056,131,2022/4/15 7:40:00,680,477,203
14057,14057,131,2022/4/15 7:50:00,1181,1532,-351
14058,14058,131,2022/4/15 8:00:00,1165,2378,-1213
14059,14059,131,2022/4/15 8:10:00,1062,3335,-2273
14060,14060,131,2022/4/15 8:20:00,691,2896,-2205
14061,14061,131,2022/4/15 8:30:00,591,4883,-4292
14062,14062,131,2022/4/15 8:40:00,371,6126,-5755
14063,14063,131,2022/4/15 8:50:00,365,4759,-4394
14064,14064,131,2022/4/15 9:00:00,271,2353,-2082
14065,14065,131,2022/4/15 9:10:00,273,3085,-2812
14066,14066,131,2022/4/15 9:20:00,215,2861,-2646
14067,14067,131,2022/4/15 9:30:00,145,2091,-1946
14068,14068,131,2022/4/15 9:40:00,79,1637,-1558
14069,14069,131,2022/4/15 9:50:00,59,699,-640
14070,14070,131,2022/4/15 10:00:00,58,432,-374
14071,14071,131,2022/4/15 10:10:00,53,268,-215
14072,14072,131,2022/4/15 10:20:00,41,208,-167
14073,14073,131,2022/4/15 10:30:00,44,115,-71
14074,14074,131,2022/4/15 10:40:00,45,150,-105
14075,14075,131,2022/4/15 10:50:00,46,109,-63
14076,14076,131,2022/4/15 11:00:00,48,115,-67
14077,14077,131,2022/4/15 11:10:00,51,115,-64
14078,14078,131,2022/4/15 11:20:00,48,123,-75
14079,14079,131,2022/4/15 11:30:00,64,117,-53
14080,14080,131,2022/4/15 11:40:00,65,123,-58
14081,14081,131,2022/4/15 11:50:00,75,119,-44
14082,14082,131,2022/4/15 12:00:00,86,106,-20
14083,14083,131,2022/4/15 12:10:00,109,121,-12
14084,14084,131,2022/4/15 12:20:00,130,96,34
14085,14085,131,2022/4/15 12:30:00,84,103,-19
14086,14086,131,2022/4/15 12:40:00,84,130,-46
14087,14087,131,2022/4/15 12:50:00,137,117,20
14088,14088,131,2022/4/15 13:00:00,91,108,-17
14089,14089,131,2022/4/15 13:10:00,91,114,-23
14090,14090,131,2022/4/15 13:20:00,125,114,11
14091,14091,131,2022/4/15 13:30:00,71,108,-37
14092,14092,131,2022/4/15 13:40:00,70,108,-38
14093,14093,131,2022/4/15 13:50:00,72,87,-15
14094,14094,131,2022/4/15 14:00:00,64,123,-59
14095,14095,131,2022/4/15 14:10:00,72,127,-55
14096,14096,131,2022/4/15 14:20:00,71,117,-46
14097,14097,131,2022/4/15 14:30:00,66,103,-37
14098,14098,131,2022/4/15 14:40:00,81,118,-37
14099,14099,131,2022/4/15 14:50:00,80,86,-6
14100,14100,131,2022/4/15 15:00:00,82,106,-24
14101,14101,131,2022/4/15 15:10:00,126,105,21
14102,14102,131,2022/4/15 15:20:00,133,104,29
14103,14103,131,2022/4/15 15:30:00,125,107,18
14104,14104,131,2022/4/15 15:40:00,127,104,23
14105,14105,131,2022/4/15 15:50:00,124,104,20
14106,14106,131,2022/4/15 16:00:00,196,114,82
14107,14107,131,2022/4/15 16:10:00,211,105,106
14108,14108,131,2022/4/15 16:20:00,214,99,115
14109,14109,131,2022/4/15 16:30:00,275,98,177
14110,14110,131,2022/4/15 16:40:00,696,103,593
14111,14111,131,2022/4/15 16:50:00,575,122,453
14112,14112,131,2022/4/15 17:00:00,803,111,692
14113,14113,131,2022/4/15 17:10:00,1587,116,1471
14114,14114,131,2022/4/15 17:20:00,1349,182,1167
14115,14115,131,2022/4/15 17:30:00,1587,158,1429
14116,14116,131,2022/4/15 17:40:00,2555,212,2343
14117,14117,131,2022/4/15 17:50:00,1990,268,1722
14118,14118,131,2022/4/15 18:00:00,1618,334,1284
14119,14119,131,2022/4/15 18:10:00,3061,377,2684
14120,14120,131,2022/4/15 18:20:00,2558,382,2176
14121,14121,131,2022/4/15 18:30:00,1989,435,1554
14122,14122,131,2022/4/15 18:40:00,1591,378,1213
14123,14123,131,2022/4/15 18:50:00,1194,532,662
14124,14124,131,2022/4/15 19:00:00,809,383,426
14125,14125,131,2022/4/15 19:10:00,703,336,367
14126,14126,131,2022/4/15 19:20:00,574,269,305
14127,14127,131,2022/4/15 19:30:00,574,219,355
14128,14128,131,2022/4/15 19:40:00,577,118,459
14129,14129,131,2022/4/15 19:50:00,318,212,106
14130,14130,131,2022/4/15 20:00:00,429,115,314
14131,14131,131,2022/4/15 20:10:00,324,117,207
14132,14132,131,2022/4/15 20:20:00,271,125,146
14133,14133,131,2022/4/15 20:30:00,271,110,161
14134,14134,131,2022/4/15 20:40:00,268,109,159
14135,14135,131,2022/4/15 20:50:00,277,103,174
14136,14136,131,2022/4/15 21:00:00,267,97,170
14137,14137,131,2022/4/15 21:10:00,274,90,184
14138,14138,131,2022/4/15 21:20:00,239,102,137
14139,14139,131,2022/4/15 21:30:00,187,85,102
14140,14140,131,2022/4/15 21:40:00,165,104,61
14141,14141,131,2022/4/15 21:50:00,81,104,-23
14142,14142,131,2022/4/15 22:00:00,169,103,66
14143,14143,131,2022/4/15 22:10:00,46,109,-63
14144,14144,131,2022/4/15 22:20:00,24,104,-80
14145,14145,131,2022/4/15 22:30:00,25,100,-75
14146,14146,131,2022/4/15 22:40:00,12,80,-68
14147,14147,131,2022/4/15 22:50:00,5,75,-70
14148,14148,132,2022/4/15 5:00:00,0,1,-1
14149,14149,132,2022/4/15 5:10:00,4,1,3
14150,14150,132,2022/4/15 5:20:00,7,1,6
14151,14151,132,2022/4/15 5:30:00,15,1,14
14152,14152,132,2022/4/15 5:40:00,22,15,7
14153,14153,132,2022/4/15 5:50:00,25,30,-5
14154,14154,132,2022/4/15 6:00:00,31,53,-22
14155,14155,132,2022/4/15 6:10:00,36,65,-29
14156,14156,132,2022/4/15 6:20:00,31,107,-76
14157,14157,132,2022/4/15 6:30:00,42,109,-67
14158,14158,132,2022/4/15 6:40:00,54,108,-54
14159,14159,132,2022/4/15 6:50:00,72,121,-49
14160,14160,132,2022/4/15 7:00:00,99,266,-167
14161,14161,132,2022/4/15 7:10:00,148,313,-165
14162,14162,132,2022/4/15 7:20:00,190,439,-249
14163,14163,132,2022/4/15 7:30:00,227,426,-199
14164,14164,132,2022/4/15 7:40:00,274,572,-298
14165,14165,132,2022/4/15 7:50:00,343,1120,-777
14166,14166,132,2022/4/15 8:00:00,436,2063,-1627
14167,14167,132,2022/4/15 8:10:00,468,2811,-2343
14168,14168,132,2022/4/15 8:20:00,571,2437,-1866
14169,14169,132,2022/4/15 8:30:00,383,4184,-3801
14170,14170,132,2022/4/15 8:40:00,339,6572,-6233
14171,14171,132,2022/4/15 8:50:00,303,5902,-5599
14172,14172,132,2022/4/15 9:00:00,275,4439,-4164
14173,14173,132,2022/4/15 9:10:00,271,6273,-6002
14174,14174,132,2022/4/15 9:20:00,275,4112,-3837
14175,14175,132,2022/4/15 9:30:00,229,2394,-2165
14176,14176,132,2022/4/15 9:40:00,237,2506,-2269
14177,14177,132,2022/4/15 9:50:00,228,1497,-1269
14178,14178,132,2022/4/15 10:00:00,212,601,-389
14179,14179,132,2022/4/15 10:10:00,221,482,-261
14180,14180,132,2022/4/15 10:20:00,233,415,-182
14181,14181,132,2022/4/15 10:30:00,237,499,-262
14182,14182,132,2022/4/15 10:40:00,244,427,-183
14183,14183,132,2022/4/15 10:50:00,263,324,-61
14184,14184,132,2022/4/15 11:00:00,268,379,-111
14185,14185,132,2022/4/15 11:10:00,266,336,-70
14186,14186,132,2022/4/15 11:20:00,267,378,-111
14187,14187,132,2022/4/15 11:30:00,263,334,-71
14188,14188,132,2022/4/15 11:40:00,298,432,-134
14189,14189,132,2022/4/15 11:50:00,298,317,-19
14190,14190,132,2022/4/15 12:00:00,335,433,-98
14191,14191,132,2022/4/15 12:10:00,327,378,-51
14192,14192,132,2022/4/15 12:20:00,328,424,-96
14193,14193,132,2022/4/15 12:30:00,332,419,-87
14194,14194,132,2022/4/15 12:40:00,333,499,-166
14195,14195,132,2022/4/15 12:50:00,327,344,-17
14196,14196,132,2022/4/15 13:00:00,327,500,-173
14197,14197,132,2022/4/15 13:10:00,310,417,-107
14198,14198,132,2022/4/15 13:20:00,349,516,-167
14199,14199,132,2022/4/15 13:30:00,312,380,-68
14200,14200,132,2022/4/15 13:40:00,421,499,-78
14201,14201,132,2022/4/15 13:50:00,370,338,32
14202,14202,132,2022/4/15 14:00:00,463,433,30
14203,14203,132,2022/4/15 14:10:00,547,337,210
14204,14204,132,2022/4/15 14:20:00,544,376,168
14205,14205,132,2022/4/15 14:30:00,590,316,274
14206,14206,132,2022/4/15 14:40:00,455,332,123
14207,14207,132,2022/4/15 14:50:00,573,267,306
14208,14208,132,2022/4/15 15:00:00,580,332,248
14209,14209,132,2022/4/15 15:10:00,581,282,299
14210,14210,132,2022/4/15 15:20:00,588,318,270
14211,14211,132,2022/4/15 15:30:00,678,254,424
14212,14212,132,2022/4/15 15:40:00,679,338,341
14213,14213,132,2022/4/15 15:50:00,622,298,324
14214,14214,132,2022/4/15 16:00:00,678,318,360
14215,14215,132,2022/4/15 16:10:00,655,282,373
14216,14216,132,2022/4/15 16:20:00,659,298,361
14217,14217,132,2022/4/15 16:30:00,703,233,470
14218,14218,132,2022/4/15 16:40:00,804,298,506
14219,14219,132,2022/4/15 16:50:00,829,319,510
14220,14220,132,2022/4/15 17:00:00,1344,313,1031
14221,14221,132,2022/4/15 17:10:00,1971,312,1659
14222,14222,132,2022/4/15 17:20:00,1557,489,1068
14223,14223,132,2022/4/15 17:30:00,1977,409,1568
14224,14224,132,2022/4/15 17:40:00,2555,472,2083
14225,14225,132,2022/4/15 17:50:00,1986,472,1514
14226,14226,132,2022/4/15 18:00:00,1993,565,1428
14227,14227,132,2022/4/15 18:10:00,3368,561,2807
14228,14228,132,2022/4/15 18:20:00,3030,560,2470
14229,14229,132,2022/4/15 18:30:00,1986,565,1421
14230,14230,132,2022/4/15 18:40:00,1974,558,1416
14231,14231,132,2022/4/15 18:50:00,1584,561,1023
14232,14232,132,2022/4/15 19:00:00,1353,418,935
14233,14233,132,2022/4/15 19:10:00,1199,374,825
14234,14234,132,2022/4/15 19:20:00,1036,321,715
14235,14235,132,2022/4/15 19:30:00,798,232,566
14236,14236,132,2022/4/15 19:40:00,668,179,489
14237,14237,132,2022/4/15 19:50:00,653,158,495
14238,14238,132,2022/4/15 20:00:00,657,115,542
14239,14239,132,2022/4/15 20:10:00,668,116,552
14240,14240,132,2022/4/15 20:20:00,678,104,574
14241,14241,132,2022/4/15 20:30:00,694,124,570
14242,14242,132,2022/4/15 20:40:00,647,124,523
14243,14243,132,2022/4/15 20:50:00,675,122,553
14244,14244,132,2022/4/15 21:00:00,682,120,562
14245,14245,132,2022/4/15 21:10:00,672,100,572
14246,14246,132,2022/4/15 21:20:00,623,114,509
14247,14247,132,2022/4/15 21:30:00,574,102,472
14248,14248,132,2022/4/15 21:40:00,685,115,570
14249,14249,132,2022/4/15 21:50:00,561,111,450
14250,14250,132,2022/4/15 22:00:00,607,110,497
14251,14251,132,2022/4/15 22:10:00,729,103,626
14252,14252,132,2022/4/15 22:20:00,306,103,203
14253,14253,132,2022/4/15 22:30:00,132,92,40
14254,14254,132,2022/4/15 22:40:00,54,79,-25
14255,14255,132,2022/4/15 22:50:00,26,77,-51
14256,14256,133,2022/4/15 5:00:00,0,1,-1
14257,14257,133,2022/4/15 5:10:00,0,1,-1
14258,14258,133,2022/4/15 5:20:00,0,1,-1
14259,14259,133,2022/4/15 5:30:00,0,1,-1
14260,14260,133,2022/4/15 5:40:00,0,1,-1
14261,14261,133,2022/4/15 5:50:00,14,1,13
14262,14262,133,2022/4/15 6:00:00,29,1,28
14263,14263,133,2022/4/15 6:10:00,47,1,46
14264,14264,133,2022/4/15 6:20:00,31,1,30
14265,14265,133,2022/4/15 6:30:00,51,1,50
14266,14266,133,2022/4/15 6:40:00,48,5,43
14267,14267,133,2022/4/15 6:50:00,48,19,29
14268,14268,133,2022/4/15 7:00:00,57,6,51
14269,14269,133,2022/4/15 7:10:00,76,19,57
14270,14270,133,2022/4/15 7:20:00,147,14,133
14271,14271,133,2022/4/15 7:30:00,156,23,133
14272,14272,133,2022/4/15 7:40:00,148,25,123
14273,14273,133,2022/4/15 7:50:00,150,23,127
14274,14274,133,2022/4/15 8:00:00,144,40,104
14275,14275,133,2022/4/15 8:10:00,82,21,61
14276,14276,133,2022/4/15 8:20:00,62,47,15
14277,14277,133,2022/4/15 8:30:00,44,31,13
14278,14278,133,2022/4/15 8:40:00,35,19,16
14279,14279,133,2022/4/15 8:50:00,32,38,-6
14280,14280,133,2022/4/15 9:00:00,27,37,-10
14281,14281,133,2022/4/15 9:10:00,25,23,2
14282,14282,133,2022/4/15 9:20:00,12,39,-27
14283,14283,133,2022/4/15 9:30:00,20,23,-3
14284,14284,133,2022/4/15 9:40:00,16,23,-7
14285,14285,133,2022/4/15 9:50:00,14,30,-16
14286,14286,133,2022/4/15 10:00:00,16,33,-17
14287,14287,133,2022/4/15 10:10:00,16,17,-1
14288,14288,133,2022/4/15 10:20:00,9,30,-21
14289,14289,133,2022/4/15 10:30:00,13,24,-11
14290,14290,133,2022/4/15 10:40:00,7,21,-14
14291,14291,133,2022/4/15 10:50:00,15,25,-10
14292,14292,133,2022/4/15 11:00:00,9,19,-10
14293,14293,133,2022/4/15 11:10:00,11,25,-14
14294,14294,133,2022/4/15 11:20:00,10,22,-12
14295,14295,133,2022/4/15 11:30:00,12,34,-22
14296,14296,133,2022/4/15 11:40:00,14,23,-9
14297,14297,133,2022/4/15 11:50:00,11,25,-14
14298,14298,133,2022/4/15 12:00:00,10,23,-13
14299,14299,133,2022/4/15 12:10:00,15,23,-8
14300,14300,133,2022/4/15 12:20:00,12,23,-11
14301,14301,133,2022/4/15 12:30:00,19,32,-13
14302,14302,133,2022/4/15 12:40:00,6,23,-17
14303,14303,133,2022/4/15 12:50:00,13,23,-10
14304,14304,133,2022/4/15 13:00:00,10,23,-13
14305,14305,133,2022/4/15 13:10:00,9,23,-14
14306,14306,133,2022/4/15 13:20:00,10,37,-27
14307,14307,133,2022/4/15 13:30:00,10,33,-23
14308,14308,133,2022/4/15 13:40:00,7,23,-16
14309,14309,133,2022/4/15 13:50:00,12,23,-11
14310,14310,133,2022/4/15 14:00:00,9,23,-14
14311,14311,133,2022/4/15 14:10:00,10,30,-20
14312,14312,133,2022/4/15 14:20:00,8,40,-32
14313,14313,133,2022/4/15 14:30:00,9,25,-16
14314,14314,133,2022/4/15 14:40:00,6,32,-26
14315,14315,133,2022/4/15 14:50:00,10,30,-20
14316,14316,133,2022/4/15 15:00:00,7,31,-24
14317,14317,133,2022/4/15 15:10:00,9,32,-23
14318,14318,133,2022/4/15 15:20:00,10,59,-49
14319,14319,133,2022/4/15 15:30:00,11,39,-28
14320,14320,133,2022/4/15 15:40:00,9,37,-28
14321,14321,133,2022/4/15 15:50:00,7,39,-32
14322,14322,133,2022/4/15 16:00:00,6,44,-38
14323,14323,133,2022/4/15 16:10:00,11,65,-54
14324,14324,133,2022/4/15 16:20:00,10,38,-28
14325,14325,133,2022/4/15 16:30:00,12,44,-32
14326,14326,133,2022/4/15 16:40:00,11,48,-37
14327,14327,133,2022/4/15 16:50:00,10,46,-36
14328,14328,133,2022/4/15 17:00:00,7,54,-47
14329,14329,133,2022/4/15 17:10:00,16,68,-52
14330,14330,133,2022/4/15 17:20:00,12,62,-50
14331,14331,133,2022/4/15 17:30:00,11,60,-49
14332,14332,133,2022/4/15 17:40:00,11,73,-62
14333,14333,133,2022/4/15 17:50:00,12,65,-53
14334,14334,133,2022/4/15 18:00:00,11,93,-82
14335,14335,133,2022/4/15 18:10:00,12,71,-59
14336,14336,133,2022/4/15 18:20:00,10,92,-82
14337,14337,133,2022/4/15 18:30:00,8,102,-94
14338,14338,133,2022/4/15 18:40:00,8,79,-71
14339,14339,133,2022/4/15 18:50:00,9,107,-98
14340,14340,133,2022/4/15 19:00:00,6,75,-69
14341,14341,133,2022/4/15 19:10:00,9,108,-99
14342,14342,133,2022/4/15 19:20:00,3,73,-70
14343,14343,133,2022/4/15 19:30:00,9,95,-86
14344,14344,133,2022/4/15 19:40:00,4,80,-76
14345,14345,133,2022/4/15 19:50:00,6,51,-45
14346,14346,133,2022/4/15 20:00:00,4,73,-69
14347,14347,133,2022/4/15 20:10:00,5,39,-34
14348,14348,133,2022/4/15 20:20:00,3,71,-68
14349,14349,133,2022/4/15 20:30:00,3,51,-48
14350,14350,133,2022/4/15 20:40:00,3,53,-50
14351,14351,133,2022/4/15 20:50:00,2,63,-61
14352,14352,133,2022/4/15 21:00:00,2,41,-39
14353,14353,133,2022/4/15 21:10:00,1,67,-66
14354,14354,133,2022/4/15 21:20:00,2,51,-49
14355,14355,133,2022/4/15 21:30:00,1,45,-44
14356,14356,133,2022/4/15 21:40:00,2,55,-53
14357,14357,133,2022/4/15 21:50:00,1,39,-38
14358,14358,133,2022/4/15 22:00:00,1,62,-61
14359,14359,133,2022/4/15 22:10:00,0,30,-30
14360,14360,133,2022/4/15 22:20:00,0,46,-46
14361,14361,133,2022/4/15 22:30:00,0,20,-20
14362,14362,133,2022/4/15 22:40:00,0,18,-18
14363,14363,133,2022/4/15 22:50:00,0,3,-3
14364,14364,134,2022/4/15 5:00:00,10,1,9
14365,14365,134,2022/4/15 5:10:00,17,1,16
14366,14366,134,2022/4/15 5:20:00,19,1,18
14367,14367,134,2022/4/15 5:30:00,26,1,25
14368,14368,134,2022/4/15 5:40:00,31,2,29
14369,14369,134,2022/4/15 5:50:00,55,1,54
14370,14370,134,2022/4/15 6:00:00,54,6,48
14371,14371,134,2022/4/15 6:10:00,143,23,120
14372,14372,134,2022/4/15 6:20:00,87,95,-8
14373,14373,134,2022/4/15 6:30:00,256,88,168
14374,14374,134,2022/4/15 6:40:00,277,112,165
14375,14375,134,2022/4/15 6:50:00,302,110,192
14376,14376,134,2022/4/15 7:00:00,345,104,241
14377,14377,134,2022/4/15 7:10:00,639,217,422
14378,14378,134,2022/4/15 7:20:00,663,298,365
14379,14379,134,2022/4/15 7:30:00,869,299,570
14380,14380,134,2022/4/15 7:40:00,1215,269,946
14381,14381,134,2022/4/15 7:50:00,1632,327,1305
14382,14382,134,2022/4/15 8:00:00,1980,331,1649
14383,14383,134,2022/4/15 8:10:00,1976,333,1643
14384,14384,134,2022/4/15 8:20:00,1977,298,1679
14385,14385,134,2022/4/15 8:30:00,1583,233,1350
14386,14386,134,2022/4/15 8:40:00,1201,221,980
14387,14387,134,2022/4/15 8:50:00,1167,196,971
14388,14388,134,2022/4/15 9:00:00,678,192,486
14389,14389,134,2022/4/15 9:10:00,653,153,500
14390,14390,134,2022/4/15 9:20:00,580,112,468
14391,14391,134,2022/4/15 9:30:00,338,151,187
14392,14392,134,2022/4/15 9:40:00,270,117,153
14393,14393,134,2022/4/15 9:50:00,209,105,104
14394,14394,134,2022/4/15 10:00:00,165,109,56
14395,14395,134,2022/4/15 10:10:00,142,113,29
14396,14396,134,2022/4/15 10:20:00,100,123,-23
14397,14397,134,2022/4/15 10:30:00,76,110,-34
14398,14398,134,2022/4/15 10:40:00,75,111,-36
14399,14399,134,2022/4/15 10:50:00,70,118,-48
14400,14400,134,2022/4/15 11:00:00,73,123,-50
14401,14401,134,2022/4/15 11:10:00,71,106,-35
14402,14402,134,2022/4/15 11:20:00,72,108,-36
14403,14403,134,2022/4/15 11:30:00,56,123,-67
14404,14404,134,2022/4/15 11:40:00,78,118,-40
14405,14405,134,2022/4/15 11:50:00,108,111,-3
14406,14406,134,2022/4/15 12:00:00,82,109,-27
14407,14407,134,2022/4/15 12:10:00,136,110,26
14408,14408,134,2022/4/15 12:20:00,162,127,35
14409,14409,134,2022/4/15 12:30:00,135,115,20
14410,14410,134,2022/4/15 12:40:00,163,122,41
14411,14411,134,2022/4/15 12:50:00,155,108,47
14412,14412,134,2022/4/15 13:00:00,137,111,26
14413,14413,134,2022/4/15 13:10:00,119,109,10
14414,14414,134,2022/4/15 13:20:00,126,112,14
14415,14415,134,2022/4/15 13:30:00,137,114,23
14416,14416,134,2022/4/15 13:40:00,125,117,8
14417,14417,134,2022/4/15 13:50:00,85,121,-36
14418,14418,134,2022/4/15 14:00:00,71,106,-35
14419,14419,134,2022/4/15 14:10:00,84,111,-27
14420,14420,134,2022/4/15 14:20:00,109,107,2
14421,14421,134,2022/4/15 14:30:00,68,124,-56
14422,14422,134,2022/4/15 14:40:00,69,116,-47
14423,14423,134,2022/4/15 14:50:00,64,127,-63
14424,14424,134,2022/4/15 15:00:00,78,111,-33
14425,14425,134,2022/4/15 15:10:00,89,110,-21
14426,14426,134,2022/4/15 15:20:00,81,181,-100
14427,14427,134,2022/4/15 15:30:00,71,181,-110
14428,14428,134,2022/4/15 15:40:00,124,185,-61
14429,14429,134,2022/4/15 15:50:00,118,159,-41
14430,14430,134,2022/4/15 16:00:00,132,178,-46
14431,14431,134,2022/4/15 16:10:00,176,185,-9
14432,14432,134,2022/4/15 16:20:00,174,197,-23
14433,14433,134,2022/4/15 16:30:00,148,180,-32
14434,14434,134,2022/4/15 16:40:00,195,197,-2
14435,14435,134,2022/4/15 16:50:00,197,285,-88
14436,14436,134,2022/4/15 17:00:00,273,296,-23
14437,14437,134,2022/4/15 17:10:00,297,320,-23
14438,14438,134,2022/4/15 17:20:00,341,377,-36
14439,14439,134,2022/4/15 17:30:00,305,415,-110
14440,14440,134,2022/4/15 17:40:00,455,421,34
14441,14441,134,2022/4/15 17:50:00,370,603,-233
14442,14442,134,2022/4/15 18:00:00,263,559,-296
14443,14443,134,2022/4/15 18:10:00,285,1477,-1192
14444,14444,134,2022/4/15 18:20:00,267,1097,-830
14445,14445,134,2022/4/15 18:30:00,196,1539,-1343
14446,14446,134,2022/4/15 18:40:00,183,1485,-1302
14447,14447,134,2022/4/15 18:50:00,174,1094,-920
14448,14448,134,2022/4/15 19:00:00,168,597,-429
14449,14449,134,2022/4/15 19:10:00,138,422,-284
14450,14450,134,2022/4/15 19:20:00,89,508,-419
14451,14451,134,2022/4/15 19:30:00,137,381,-244
14452,14452,134,2022/4/15 19:40:00,58,329,-271
14453,14453,134,2022/4/15 19:50:00,127,284,-157
14454,14454,134,2022/4/15 20:00:00,70,257,-187
14455,14455,134,2022/4/15 20:10:00,89,180,-91
14456,14456,134,2022/4/15 20:20:00,64,224,-160
14457,14457,134,2022/4/15 20:30:00,93,159,-66
14458,14458,134,2022/4/15 20:40:00,54,224,-170
14459,14459,134,2022/4/15 20:50:00,83,146,-63
14460,14460,134,2022/4/15 21:00:00,69,185,-116
14461,14461,134,2022/4/15 21:10:00,76,139,-63
14462,14462,134,2022/4/15 21:20:00,63,184,-121
14463,14463,134,2022/4/15 21:30:00,68,169,-101
14464,14464,134,2022/4/15 21:40:00,42,169,-127
14465,14465,134,2022/4/15 21:50:00,43,119,-76
14466,14466,134,2022/4/15 22:00:00,30,153,-123
14467,14467,134,2022/4/15 22:10:00,25,121,-96
14468,14468,134,2022/4/15 22:20:00,27,134,-107
14469,14469,134,2022/4/15 22:30:00,15,120,-105
14470,14470,134,2022/4/15 22:40:00,9,111,-102
14471,14471,134,2022/4/15 22:50:00,14,107,-93
14472,14472,135,2022/4/15 5:00:00,0,1,-1
14473,14473,135,2022/4/15 5:10:00,5,1,4
14474,14474,135,2022/4/15 5:20:00,8,1,7
14475,14475,135,2022/4/15 5:30:00,19,1,18
14476,14476,135,2022/4/15 5:40:00,34,2,32
14477,14477,135,2022/4/15 5:50:00,35,33,2
14478,14478,135,2022/4/15 6:00:00,53,19,34
14479,14479,135,2022/4/15 6:10:00,66,41,25
14480,14480,135,2022/4/15 6:20:00,85,40,45
14481,14481,135,2022/4/15 6:30:00,155,68,87
14482,14482,135,2022/4/15 6:40:00,216,92,124
14483,14483,135,2022/4/15 6:50:00,273,103,170
14484,14484,135,2022/4/15 7:00:00,348,121,227
14485,14485,135,2022/4/15 7:10:00,443,114,329
14486,14486,135,2022/4/15 7:20:00,597,206,391
14487,14487,135,2022/4/15 7:30:00,629,343,286
14488,14488,135,2022/4/15 7:40:00,821,441,380
14489,14489,135,2022/4/15 7:50:00,1177,1156,21
14490,14490,135,2022/4/15 8:00:00,1216,2741,-1525
14491,14491,135,2022/4/15 8:10:00,1363,2566,-1203
14492,14492,135,2022/4/15 8:20:00,1387,2504,-1117
14493,14493,135,2022/4/15 8:30:00,1216,3899,-2683
14494,14494,135,2022/4/15 8:40:00,870,5928,-5058
14495,14495,135,2022/4/15 8:50:00,695,5126,-4431
14496,14496,135,2022/4/15 9:00:00,709,2882,-2173
14497,14497,135,2022/4/15 9:10:00,582,2032,-1450
14498,14498,135,2022/4/15 9:20:00,374,1084,-710
14499,14499,135,2022/4/15 9:30:00,344,551,-207
14500,14500,135,2022/4/15 9:40:00,274,410,-136
14501,14501,135,2022/4/15 9:50:00,217,379,-162
14502,14502,135,2022/4/15 10:00:00,211,327,-116
14503,14503,135,2022/4/15 10:10:00,208,209,-1
14504,14504,135,2022/4/15 10:20:00,184,180,4
14505,14505,135,2022/4/15 10:30:00,208,179,29
14506,14506,135,2022/4/15 10:40:00,187,214,-27
14507,14507,135,2022/4/15 10:50:00,174,140,34
14508,14508,135,2022/4/15 11:00:00,184,198,-14
14509,14509,135,2022/4/15 11:10:00,185,115,70
14510,14510,135,2022/4/15 11:20:00,178,179,-1
14511,14511,135,2022/4/15 11:30:00,185,146,39
14512,14512,135,2022/4/15 11:40:00,204,198,6
14513,14513,135,2022/4/15 11:50:00,181,146,35
14514,14514,135,2022/4/15 12:00:00,202,192,10
14515,14515,135,2022/4/15 12:10:00,214,160,54
14516,14516,135,2022/4/15 12:20:00,241,223,18
14517,14517,135,2022/4/15 12:30:00,238,154,84
14518,14518,135,2022/4/15 12:40:00,257,198,59
14519,14519,135,2022/4/15 12:50:00,246,213,33
14520,14520,135,2022/4/15 13:00:00,272,223,49
14521,14521,135,2022/4/15 13:10:00,264,181,83
14522,14522,135,2022/4/15 13:20:00,257,218,39
14523,14523,135,2022/4/15 13:30:00,224,181,43
14524,14524,135,2022/4/15 13:40:00,234,233,1
14525,14525,135,2022/4/15 13:50:00,224,180,44
14526,14526,135,2022/4/15 14:00:00,235,197,38
14527,14527,135,2022/4/15 14:10:00,228,192,36
14528,14528,135,2022/4/15 14:20:00,226,180,46
14529,14529,135,2022/4/15 14:30:00,225,185,40
14530,14530,135,2022/4/15 14:40:00,226,198,28
14531,14531,135,2022/4/15 14:50:00,265,159,106
14532,14532,135,2022/4/15 15:00:00,241,180,61
14533,14533,135,2022/4/15 15:10:00,258,192,66
14534,14534,135,2022/4/15 15:20:00,239,214,25
14535,14535,135,2022/4/15 15:30:00,240,214,26
14536,14536,135,2022/4/15 15:40:00,266,197,69
14537,14537,135,2022/4/15 15:50:00,243,198,45
14538,14538,135,2022/4/15 16:00:00,272,207,65
14539,14539,135,2022/4/15 16:10:00,306,212,94
14540,14540,135,2022/4/15 16:20:00,304,216,88
14541,14541,135,2022/4/15 16:30:00,345,218,127
14542,14542,135,2022/4/15 16:40:00,371,284,87
14543,14543,135,2022/4/15 16:50:00,556,255,301
14544,14544,135,2022/4/15 17:00:00,670,314,356
14545,14545,135,2022/4/15 17:10:00,1205,381,824
14546,14546,135,2022/4/15 17:20:00,1140,503,637
14547,14547,135,2022/4/15 17:30:00,1149,426,723
14548,14548,135,2022/4/15 17:40:00,2484,426,2058
14549,14549,135,2022/4/15 17:50:00,2057,568,1489
14550,14550,135,2022/4/15 18:00:00,1987,575,1412
14551,14551,135,2022/4/15 18:10:00,2551,575,1976
14552,14552,135,2022/4/15 18:20:00,2004,574,1430
14553,14553,135,2022/4/15 18:30:00,1590,1093,497
14554,14554,135,2022/4/15 18:40:00,1149,570,579
14555,14555,135,2022/4/15 18:50:00,815,577,238
14556,14556,135,2022/4/15 19:00:00,638,421,217
14557,14557,135,2022/4/15 19:10:00,636,417,219
14558,14558,135,2022/4/15 19:20:00,587,519,68
14559,14559,135,2022/4/15 19:30:00,456,379,77
14560,14560,135,2022/4/15 19:40:00,353,299,54
14561,14561,135,2022/4/15 19:50:00,332,257,75
14562,14562,135,2022/4/15 20:00:00,324,223,101
14563,14563,135,2022/4/15 20:10:00,327,184,143
14564,14564,135,2022/4/15 20:20:00,336,169,167
14565,14565,135,2022/4/15 20:30:00,301,199,102
14566,14566,135,2022/4/15 20:40:00,275,120,155
14567,14567,135,2022/4/15 20:50:00,269,191,78
14568,14568,135,2022/4/15 21:00:00,292,180,112
14569,14569,135,2022/4/15 21:10:00,317,137,180
14570,14570,135,2022/4/15 21:20:00,236,181,55
14571,14571,135,2022/4/15 21:30:00,225,137,88
14572,14572,135,2022/4/15 21:40:00,215,150,65
14573,14573,135,2022/4/15 21:50:00,189,116,73
14574,14574,135,2022/4/15 22:00:00,274,109,165
14575,14575,135,2022/4/15 22:10:00,314,120,194
14576,14576,135,2022/4/15 22:20:00,150,109,41
14577,14577,135,2022/4/15 22:30:00,40,126,-86
14578,14578,135,2022/4/15 22:40:00,24,112,-88
14579,14579,135,2022/4/15 22:50:00,24,101,-77
14580,14580,136,2022/4/15 5:00:00,4,1,3
14581,14581,136,2022/4/15 5:10:00,6,1,5
14582,14582,136,2022/4/15 5:20:00,26,1,25
14583,14583,136,2022/4/15 5:30:00,19,1,18
14584,14584,136,2022/4/15 5:40:00,32,6,26
14585,14585,136,2022/4/15 5:50:00,31,14,17
14586,14586,136,2022/4/15 6:00:00,42,82,-40
14587,14587,136,2022/4/15 6:10:00,42,76,-34
14588,14588,136,2022/4/15 6:20:00,30,105,-75
14589,14589,136,2022/4/15 6:30:00,45,112,-67
14590,14590,136,2022/4/15 6:40:00,53,105,-52
14591,14591,136,2022/4/15 6:50:00,58,192,-134
14592,14592,136,2022/4/15 7:00:00,77,281,-204
14593,14593,136,2022/4/15 7:10:00,95,287,-192
14594,14594,136,2022/4/15 7:20:00,99,376,-277
14595,14595,136,2022/4/15 7:30:00,156,1528,-1372
14596,14596,136,2022/4/15 7:40:00,182,2801,-2619
14597,14597,136,2022/4/15 7:50:00,216,5057,-4841
14598,14598,136,2022/4/15 8:00:00,275,4121,-3846
14599,14599,136,2022/4/15 8:10:00,274,14814,-14540
14600,14600,136,2022/4/15 8:20:00,274,12876,-12602
14601,14601,136,2022/4/15 8:30:00,280,11749,-11469
14602,14602,136,2022/4/15 8:40:00,278,14995,-14717
14603,14603,136,2022/4/15 8:50:00,227,8814,-8587
14604,14604,136,2022/4/15 9:00:00,267,13667,-13400
14605,14605,136,2022/4/15 9:10:00,267,6907,-6640
14606,14606,136,2022/4/15 9:20:00,220,4308,-4088
14607,14607,136,2022/4/15 9:30:00,220,3506,-3286
14608,14608,136,2022/4/15 9:40:00,205,4116,-3911
14609,14609,136,2022/4/15 9:50:00,198,2125,-1927
14610,14610,136,2022/4/15 10:00:00,211,599,-388
14611,14611,136,2022/4/15 10:10:00,213,422,-209
14612,14612,136,2022/4/15 10:20:00,215,430,-215
14613,14613,136,2022/4/15 10:30:00,259,428,-169
14614,14614,136,2022/4/15 10:40:00,257,491,-234
14615,14615,136,2022/4/15 10:50:00,242,518,-276
14616,14616,136,2022/4/15 11:00:00,269,376,-107
14617,14617,136,2022/4/15 11:10:00,270,375,-105
14618,14618,136,2022/4/15 11:20:00,289,379,-90
14619,14619,136,2022/4/15 11:30:00,332,379,-47
14620,14620,136,2022/4/15 11:40:00,366,380,-14
14621,14621,136,2022/4/15 11:50:00,347,315,32
14622,14622,136,2022/4/15 12:00:00,310,325,-15
14623,14623,136,2022/4/15 12:10:00,425,337,88
14624,14624,136,2022/4/15 12:20:00,368,332,36
14625,14625,136,2022/4/15 12:30:00,325,516,-191
14626,14626,136,2022/4/15 12:40:00,333,501,-168
14627,14627,136,2022/4/15 12:50:00,308,508,-200
14628,14628,136,2022/4/15 13:00:00,308,490,-182
14629,14629,136,2022/4/15 13:10:00,422,425,-3
14630,14630,136,2022/4/15 13:20:00,426,427,-1
14631,14631,136,2022/4/15 13:30:00,422,417,5
14632,14632,136,2022/4/15 13:40:00,422,427,-5
14633,14633,136,2022/4/15 13:50:00,461,497,-36
14634,14634,136,2022/4/15 14:00:00,423,428,-5
14635,14635,136,2022/4/15 14:10:00,457,431,26
14636,14636,136,2022/4/15 14:20:00,463,383,80
14637,14637,136,2022/4/15 14:30:00,554,381,173
14638,14638,136,2022/4/15 14:40:00,460,339,121
14639,14639,136,2022/4/15 14:50:00,454,345,109
14640,14640,136,2022/4/15 15:00:00,568,317,251
14641,14641,136,2022/4/15 15:10:00,639,317,322
14642,14642,136,2022/4/15 15:20:00,610,322,288
14643,14643,136,2022/4/15 15:30:00,618,322,296
14644,14644,136,2022/4/15 15:40:00,637,324,313
14645,14645,136,2022/4/15 15:50:00,616,318,298
14646,14646,136,2022/4/15 16:00:00,693,331,362
14647,14647,136,2022/4/15 16:10:00,709,317,392
14648,14648,136,2022/4/15 16:20:00,714,289,425
14649,14649,136,2022/4/15 16:30:00,800,333,467
14650,14650,136,2022/4/15 16:40:00,1163,326,837
14651,14651,136,2022/4/15 16:50:00,1164,324,840
14652,14652,136,2022/4/15 17:00:00,1659,324,1335
14653,14653,136,2022/4/15 17:10:00,3407,316,3091
14654,14654,136,2022/4/15 17:20:00,3328,485,2843
14655,14655,136,2022/4/15 17:30:00,3332,398,2934
14656,14656,136,2022/4/15 17:40:00,3705,410,3295
14657,14657,136,2022/4/15 17:50:00,3670,412,3258
14658,14658,136,2022/4/15 18:00:00,3488,454,3034
14659,14659,136,2022/4/15 18:10:00,3730,468,3262
14660,14660,136,2022/4/15 18:20:00,3669,407,3262
14661,14661,136,2022/4/15 18:30:00,3466,470,2996
14662,14662,136,2022/4/15 18:40:00,3413,471,2942
14663,14663,136,2022/4/15 18:50:00,3468,393,3075
14664,14664,136,2022/4/15 19:00:00,2551,471,2080
14665,14665,136,2022/4/15 19:10:00,2549,319,2230
14666,14666,136,2022/4/15 19:20:00,1982,249,1733
14667,14667,136,2022/4/15 19:30:00,1583,227,1356
14668,14668,136,2022/4/15 19:40:00,1340,225,1115
14669,14669,136,2022/4/15 19:50:00,1191,106,1085
14670,14670,136,2022/4/15 20:00:00,1197,119,1078
14671,14671,136,2022/4/15 20:10:00,1192,120,1072
14672,14672,136,2022/4/15 20:20:00,1151,120,1031
14673,14673,136,2022/4/15 20:30:00,1012,121,891
14674,14674,136,2022/4/15 20:40:00,1016,128,888
14675,14675,136,2022/4/15 20:50:00,1010,100,910
14676,14676,136,2022/4/15 21:00:00,1021,121,900
14677,14677,136,2022/4/15 21:10:00,1180,119,1061
14678,14678,136,2022/4/15 21:20:00,1013,116,897
14679,14679,136,2022/4/15 21:30:00,889,127,762
14680,14680,136,2022/4/15 21:40:00,836,104,732
14681,14681,136,2022/4/15 21:50:00,668,117,551
14682,14682,136,2022/4/15 22:00:00,1258,105,1153
14683,14683,136,2022/4/15 22:10:00,802,105,697
14684,14684,136,2022/4/15 22:20:00,363,86,277
14685,14685,136,2022/4/15 22:30:00,201,104,97
14686,14686,136,2022/4/15 22:40:00,119,82,37
14687,14687,136,2022/4/15 22:50:00,34,73,-39
14688,14688,137,2022/4/15 5:00:00,0,1,-1
14689,14689,137,2022/4/15 5:10:00,2,1,1
14690,14690,137,2022/4/15 5:20:00,10,1,9
14691,14691,137,2022/4/15 5:30:00,14,8,6
14692,14692,137,2022/4/15 5:40:00,18,6,12
14693,14693,137,2022/4/15 5:50:00,23,11,12
14694,14694,137,2022/4/15 6:00:00,22,40,-18
14695,14695,137,2022/4/15 6:10:00,27,64,-37
14696,14696,137,2022/4/15 6:20:00,31,62,-31
14697,14697,137,2022/4/15 6:30:00,38,74,-36
14698,14698,137,2022/4/15 6:40:00,41,111,-70
14699,14699,137,2022/4/15 6:50:00,40,105,-65
14700,14700,137,2022/4/15 7:00:00,47,120,-73
14701,14701,137,2022/4/15 7:10:00,56,126,-70
14702,14702,137,2022/4/15 7:20:00,74,212,-138
14703,14703,137,2022/4/15 7:30:00,76,323,-247
14704,14704,137,2022/4/15 7:40:00,94,508,-414
14705,14705,137,2022/4/15 7:50:00,169,484,-315
14706,14706,137,2022/4/15 8:00:00,183,1810,-1627
14707,14707,137,2022/4/15 8:10:00,226,2426,-2200
14708,14708,137,2022/4/15 8:20:00,224,2142,-1918
14709,14709,137,2022/4/15 8:30:00,216,2545,-2329
14710,14710,137,2022/4/15 8:40:00,184,8977,-8793
14711,14711,137,2022/4/15 8:50:00,157,4543,-4386
14712,14712,137,2022/4/15 9:00:00,145,2814,-2669
14713,14713,137,2022/4/15 9:10:00,142,2158,-2016
14714,14714,137,2022/4/15 9:20:00,137,1555,-1418
14715,14715,137,2022/4/15 9:30:00,155,1098,-943
14716,14716,137,2022/4/15 9:40:00,136,571,-435
14717,14717,137,2022/4/15 9:50:00,100,475,-375
14718,14718,137,2022/4/15 10:00:00,137,427,-290
14719,14719,137,2022/4/15 10:10:00,153,433,-280
14720,14720,137,2022/4/15 10:20:00,147,374,-227
14721,14721,137,2022/4/15 10:30:00,172,347,-175
14722,14722,137,2022/4/15 10:40:00,174,324,-150
14723,14723,137,2022/4/15 10:50:00,162,318,-156
14724,14724,137,2022/4/15 11:00:00,180,297,-117
14725,14725,137,2022/4/15 11:10:00,205,232,-27
14726,14726,137,2022/4/15 11:20:00,218,298,-80
14727,14727,137,2022/4/15 11:30:00,211,298,-87
14728,14728,137,2022/4/15 11:40:00,221,299,-78
14729,14729,137,2022/4/15 11:50:00,225,318,-93
14730,14730,137,2022/4/15 12:00:00,243,268,-25
14731,14731,137,2022/4/15 12:10:00,254,267,-13
14732,14732,137,2022/4/15 12:20:00,258,318,-60
14733,14733,137,2022/4/15 12:30:00,267,298,-31
14734,14734,137,2022/4/15 12:40:00,276,326,-50
14735,14735,137,2022/4/15 12:50:00,272,333,-61
14736,14736,137,2022/4/15 13:00:00,287,326,-39
14737,14737,137,2022/4/15 13:10:00,309,326,-17
14738,14738,137,2022/4/15 13:20:00,315,318,-3
14739,14739,137,2022/4/15 13:30:00,333,326,7
14740,14740,137,2022/4/15 13:40:00,330,298,32
14741,14741,137,2022/4/15 13:50:00,344,326,18
14742,14742,137,2022/4/15 14:00:00,332,325,7
14743,14743,137,2022/4/15 14:10:00,348,232,116
14744,14744,137,2022/4/15 14:20:00,333,325,8
14745,14745,137,2022/4/15 14:30:00,343,254,89
14746,14746,137,2022/4/15 14:40:00,330,233,97
14747,14747,137,2022/4/15 14:50:00,332,269,63
14748,14748,137,2022/4/15 15:00:00,371,226,145
14749,14749,137,2022/4/15 15:10:00,372,218,154
14750,14750,137,2022/4/15 15:20:00,349,226,123
14751,14751,137,2022/4/15 15:30:00,352,219,133
14752,14752,137,2022/4/15 15:40:00,369,208,161
14753,14753,137,2022/4/15 15:50:00,461,223,238
14754,14754,137,2022/4/15 16:00:00,576,178,398
14755,14755,137,2022/4/15 16:10:00,570,180,390
14756,14756,137,2022/4/15 16:20:00,579,198,381
14757,14757,137,2022/4/15 16:30:00,621,180,441
14758,14758,137,2022/4/15 16:40:00,687,214,473
14759,14759,137,2022/4/15 16:50:00,696,198,498
14760,14760,137,2022/4/15 17:00:00,1193,178,1015
14761,14761,137,2022/4/15 17:10:00,1555,228,1327
14762,14762,137,2022/4/15 17:20:00,1202,316,886
14763,14763,137,2022/4/15 17:30:00,1586,325,1261
14764,14764,137,2022/4/15 17:40:00,2008,326,1682
14765,14765,137,2022/4/15 17:50:00,1562,339,1223
14766,14766,137,2022/4/15 18:00:00,1583,521,1062
14767,14767,137,2022/4/15 18:10:00,1978,522,1456
14768,14768,137,2022/4/15 18:20:00,1534,366,1168
14769,14769,137,2022/4/15 18:30:00,1143,523,620
14770,14770,137,2022/4/15 18:40:00,1146,482,664
14771,14771,137,2022/4/15 18:50:00,798,325,473
14772,14772,137,2022/4/15 19:00:00,670,256,414
14773,14773,137,2022/4/15 19:10:00,655,229,426
14774,14774,137,2022/4/15 19:20:00,575,148,427
14775,14775,137,2022/4/15 19:30:00,565,108,457
14776,14776,137,2022/4/15 19:40:00,588,113,475
14777,14777,137,2022/4/15 19:50:00,548,109,439
14778,14778,137,2022/4/15 20:00:00,559,116,443
14779,14779,137,2022/4/15 20:10:00,582,102,480
14780,14780,137,2022/4/15 20:20:00,551,105,446
14781,14781,137,2022/4/15 20:30:00,553,104,449
14782,14782,137,2022/4/15 20:40:00,571,104,467
14783,14783,137,2022/4/15 20:50:00,465,106,359
14784,14784,137,2022/4/15 21:00:00,588,89,499
14785,14785,137,2022/4/15 21:10:00,590,102,488
14786,14786,137,2022/4/15 21:20:00,582,95,487
14787,14787,137,2022/4/15 21:30:00,593,95,498
14788,14788,137,2022/4/15 21:40:00,353,91,262
14789,14789,137,2022/4/15 21:50:00,339,85,254
14790,14790,137,2022/4/15 22:00:00,714,93,621
14791,14791,137,2022/4/15 22:10:00,267,78,189
14792,14792,137,2022/4/15 22:20:00,116,93,23
14793,14793,137,2022/4/15 22:30:00,101,75,26
14794,14794,137,2022/4/15 22:40:00,33,84,-51
14795,14795,137,2022/4/15 22:50:00,24,70,-46
14796,14796,138,2022/4/15 5:00:00,0,1,-1
14797,14797,138,2022/4/15 5:10:00,3,1,2
14798,14798,138,2022/4/15 5:20:00,7,1,6
14799,14799,138,2022/4/15 5:30:00,15,1,14
14800,14800,138,2022/4/15 5:40:00,19,21,-2
14801,14801,138,2022/4/15 5:50:00,29,14,15
14802,14802,138,2022/4/15 6:00:00,28,50,-22
14803,14803,138,2022/4/15 6:10:00,33,73,-40
14804,14804,138,2022/4/15 6:20:00,37,75,-38
14805,14805,138,2022/4/15 6:30:00,51,110,-59
14806,14806,138,2022/4/15 6:40:00,59,121,-62
14807,14807,138,2022/4/15 6:50:00,91,133,-42
14808,14808,138,2022/4/15 7:00:00,123,183,-60
14809,14809,138,2022/4/15 7:10:00,169,331,-162
14810,14810,138,2022/4/15 7:20:00,185,435,-250
14811,14811,138,2022/4/15 7:30:00,232,509,-277
14812,14812,138,2022/4/15 7:40:00,278,492,-214
14813,14813,138,2022/4/15 7:50:00,367,1152,-785
14814,14814,138,2022/4/15 8:00:00,596,1926,-1330
14815,14815,138,2022/4/15 8:10:00,589,4236,-3647
14816,14816,138,2022/4/15 8:20:00,598,4076,-3478
14817,14817,138,2022/4/15 8:30:00,475,5453,-4978
14818,14818,138,2022/4/15 8:40:00,354,5392,-5038
14819,14819,138,2022/4/15 8:50:00,346,5351,-5005
14820,14820,138,2022/4/15 9:00:00,274,6341,-6067
14821,14821,138,2022/4/15 9:10:00,260,5964,-5704
14822,14822,138,2022/4/15 9:20:00,225,4214,-3989
14823,14823,138,2022/4/15 9:30:00,232,2729,-2497
14824,14824,138,2022/4/15 9:40:00,226,2301,-2075
14825,14825,138,2022/4/15 9:50:00,200,1777,-1577
14826,14826,138,2022/4/15 10:00:00,211,610,-399
14827,14827,138,2022/4/15 10:10:00,226,421,-195
14828,14828,138,2022/4/15 10:20:00,218,425,-207
14829,14829,138,2022/4/15 10:30:00,225,524,-299
14830,14830,138,2022/4/15 10:40:00,227,502,-275
14831,14831,138,2022/4/15 10:50:00,226,314,-88
14832,14832,138,2022/4/15 11:00:00,238,316,-78
14833,14833,138,2022/4/15 11:10:00,266,332,-66
14834,14834,138,2022/4/15 11:20:00,270,331,-61
14835,14835,138,2022/4/15 11:30:00,271,318,-47
14836,14836,138,2022/4/15 11:40:00,273,333,-60
14837,14837,138,2022/4/15 11:50:00,268,333,-65
14838,14838,138,2022/4/15 12:00:00,291,322,-31
14839,14839,138,2022/4/15 12:10:00,333,332,1
14840,14840,138,2022/4/15 12:20:00,304,317,-13
14841,14841,138,2022/4/15 12:30:00,299,428,-129
14842,14842,138,2022/4/15 12:40:00,311,339,-28
14843,14843,138,2022/4/15 12:50:00,311,492,-181
14844,14844,138,2022/4/15 13:00:00,330,319,11
14845,14845,138,2022/4/15 13:10:00,343,486,-143
14846,14846,138,2022/4/15 13:20:00,348,377,-29
14847,14847,138,2022/4/15 13:30:00,326,373,-47
14848,14848,138,2022/4/15 13:40:00,333,432,-99
14849,14849,138,2022/4/15 13:50:00,325,318,7
14850,14850,138,2022/4/15 14:00:00,326,316,10
14851,14851,138,2022/4/15 14:10:00,422,317,105
14852,14852,138,2022/4/15 14:20:00,309,332,-23
14853,14853,138,2022/4/15 14:30:00,352,325,27
14854,14854,138,2022/4/15 14:40:00,367,326,41
14855,14855,138,2022/4/15 14:50:00,370,232,138
14856,14856,138,2022/4/15 15:00:00,426,253,173
14857,14857,138,2022/4/15 15:10:00,552,297,255
14858,14858,138,2022/4/15 15:20:00,544,232,312
14859,14859,138,2022/4/15 15:30:00,579,233,346
14860,14860,138,2022/4/15 15:40:00,584,268,316
14861,14861,138,2022/4/15 15:50:00,590,195,395
14862,14862,138,2022/4/15 16:00:00,636,195,441
14863,14863,138,2022/4/15 16:10:00,686,216,470
14864,14864,138,2022/4/15 16:20:00,627,282,345
14865,14865,138,2022/4/15 16:30:00,709,207,502
14866,14866,138,2022/4/15 16:40:00,823,255,568
14867,14867,138,2022/4/15 16:50:00,1023,327,696
14868,14868,138,2022/4/15 17:00:00,1571,330,1241
14869,14869,138,2022/4/15 17:10:00,1988,315,1673
14870,14870,138,2022/4/15 17:20:00,1634,368,1266
14871,14871,138,2022/4/15 17:30:00,1986,427,1559
14872,14872,138,2022/4/15 17:40:00,3338,423,2915
14873,14873,138,2022/4/15 17:50:00,2558,410,2148
14874,14874,138,2022/4/15 18:00:00,2487,426,2061
14875,14875,138,2022/4/15 18:10:00,3391,482,2909
14876,14876,138,2022/4/15 18:20:00,3342,412,2930
14877,14877,138,2022/4/15 18:30:00,2071,417,1654
14878,14878,138,2022/4/15 18:40:00,1994,481,1513
14879,14879,138,2022/4/15 18:50:00,1645,424,1221
14880,14880,138,2022/4/15 19:00:00,1350,514,836
14881,14881,138,2022/4/15 19:10:00,1150,318,832
14882,14882,138,2022/4/15 19:20:00,839,270,569
14883,14883,138,2022/4/15 19:30:00,650,226,424
14884,14884,138,2022/4/15 19:40:00,654,179,475
14885,14885,138,2022/4/15 19:50:00,692,136,556
14886,14886,138,2022/4/15 20:00:00,637,128,509
14887,14887,138,2022/4/15 20:10:00,694,109,585
14888,14888,138,2022/4/15 20:20:00,615,100,515
14889,14889,138,2022/4/15 20:30:00,585,123,462
14890,14890,138,2022/4/15 20:40:00,617,119,498
14891,14891,138,2022/4/15 20:50:00,589,107,482
14892,14892,138,2022/4/15 21:00:00,682,107,575
14893,14893,138,2022/4/15 21:10:00,648,102,546
14894,14894,138,2022/4/15 21:20:00,594,122,472
14895,14895,138,2022/4/15 21:30:00,601,112,489
14896,14896,138,2022/4/15 21:40:00,648,104,544
14897,14897,138,2022/4/15 21:50:00,595,104,491
14898,14898,138,2022/4/15 22:00:00,628,100,528
14899,14899,138,2022/4/15 22:10:00,372,106,266
14900,14900,138,2022/4/15 22:20:00,203,95,108
14901,14901,138,2022/4/15 22:30:00,119,85,34
14902,14902,138,2022/4/15 22:40:00,41,69,-28
14903,14903,138,2022/4/15 22:50:00,24,69,-45
14904,14904,139,2022/4/15 5:00:00,0,1,-1
14905,14905,139,2022/4/15 5:10:00,0,1,-1
14906,14906,139,2022/4/15 5:20:00,0,1,-1
14907,14907,139,2022/4/15 5:30:00,0,1,-1
14908,14908,139,2022/4/15 5:40:00,47,1,46
14909,14909,139,2022/4/15 5:50:00,29,1,28
14910,14910,139,2022/4/15 6:00:00,27,1,26
14911,14911,139,2022/4/15 6:10:00,24,1,23
14912,14912,139,2022/4/15 6:20:00,20,1,19
14913,14913,139,2022/4/15 6:30:00,23,80,-57
14914,14914,139,2022/4/15 6:40:00,25,70,-45
14915,14915,139,2022/4/15 6:50:00,25,45,-20
14916,14916,139,2022/4/15 7:00:00,23,108,-85
14917,14917,139,2022/4/15 7:10:00,27,102,-75
14918,14918,139,2022/4/15 7:20:00,27,110,-83
14919,14919,139,2022/4/15 7:30:00,29,120,-91
14920,14920,139,2022/4/15 7:40:00,30,110,-80
14921,14921,139,2022/4/15 7:50:00,28,110,-82
14922,14922,139,2022/4/15 8:00:00,26,110,-84
14923,14923,139,2022/4/15 8:10:00,41,213,-172
14924,14924,139,2022/4/15 8:20:00,41,126,-85
14925,14925,139,2022/4/15 8:30:00,45,152,-107
14926,14926,139,2022/4/15 8:40:00,54,117,-63
14927,14927,139,2022/4/15 8:50:00,59,108,-49
14928,14928,139,2022/4/15 9:00:00,61,111,-50
14929,14929,139,2022/4/15 9:10:00,47,103,-56
14930,14930,139,2022/4/15 9:20:00,37,109,-72
14931,14931,139,2022/4/15 9:30:00,35,122,-87
14932,14932,139,2022/4/15 9:40:00,28,110,-82
14933,14933,139,2022/4/15 9:50:00,25,110,-85
14934,14934,139,2022/4/15 10:00:00,29,107,-78
14935,14935,139,2022/4/15 10:10:00,30,142,-112
14936,14936,139,2022/4/15 10:20:00,32,54,-22
14937,14937,139,2022/4/15 10:30:00,38,108,-70
14938,14938,139,2022/4/15 10:40:00,40,77,-37
14939,14939,139,2022/4/15 10:50:00,39,102,-63
14940,14940,139,2022/4/15 11:00:00,34,107,-73
14941,14941,139,2022/4/15 11:10:00,41,76,-35
14942,14942,139,2022/4/15 11:20:00,43,112,-69
14943,14943,139,2022/4/15 11:30:00,36,103,-67
14944,14944,139,2022/4/15 11:40:00,42,91,-49
14945,14945,139,2022/4/15 11:50:00,37,83,-46
14946,14946,139,2022/4/15 12:00:00,37,93,-56
14947,14947,139,2022/4/15 12:10:00,39,93,-54
14948,14948,139,2022/4/15 12:20:00,35,103,-68
14949,14949,139,2022/4/15 12:30:00,34,98,-64
14950,14950,139,2022/4/15 12:40:00,33,77,-44
14951,14951,139,2022/4/15 12:50:00,24,77,-53
14952,14952,139,2022/4/15 13:00:00,27,77,-50
14953,14953,139,2022/4/15 13:10:00,31,73,-42
14954,14954,139,2022/4/15 13:20:00,31,106,-75
14955,14955,139,2022/4/15 13:30:00,35,98,-63
14956,14956,139,2022/4/15 13:40:00,28,98,-70
14957,14957,139,2022/4/15 13:50:00,29,90,-61
14958,14958,139,2022/4/15 14:00:00,29,93,-64
14959,14959,139,2022/4/15 14:10:00,32,120,-88
14960,14960,139,2022/4/15 14:20:00,34,102,-68
14961,14961,139,2022/4/15 14:30:00,38,110,-72
14962,14962,139,2022/4/15 14:40:00,38,97,-59
14963,14963,139,2022/4/15 14:50:00,35,101,-66
14964,14964,139,2022/4/15 15:00:00,46,106,-60
14965,14965,139,2022/4/15 15:10:00,47,119,-72
14966,14966,139,2022/4/15 15:20:00,58,105,-47
14967,14967,139,2022/4/15 15:30:00,47,108,-61
14968,14968,139,2022/4/15 15:40:00,56,93,-37
14969,14969,139,2022/4/15 15:50:00,66,94,-28
14970,14970,139,2022/4/15 16:00:00,66,100,-34
14971,14971,139,2022/4/15 16:10:00,62,103,-41
14972,14972,139,2022/4/15 16:20:00,58,103,-45
14973,14973,139,2022/4/15 16:30:00,66,83,-17
14974,14974,139,2022/4/15 16:40:00,44,95,-51
14975,14975,139,2022/4/15 16:50:00,52,90,-38
14976,14976,139,2022/4/15 17:00:00,59,110,-51
14977,14977,139,2022/4/15 17:10:00,73,98,-25
14978,14978,139,2022/4/15 17:20:00,42,94,-52
14979,14979,139,2022/4/15 17:30:00,46,107,-61
14980,14980,139,2022/4/15 17:40:00,45,74,-29
14981,14981,139,2022/4/15 17:50:00,44,103,-59
14982,14982,139,2022/4/15 18:00:00,47,77,-30
14983,14983,139,2022/4/15 18:10:00,45,106,-61
14984,14984,139,2022/4/15 18:20:00,40,89,-49
14985,14985,139,2022/4/15 18:30:00,44,99,-55
14986,14986,139,2022/4/15 18:40:00,45,102,-57
14987,14987,139,2022/4/15 18:50:00,35,87,-52
14988,14988,139,2022/4/15 19:00:00,41,95,-54
14989,14989,139,2022/4/15 19:10:00,34,97,-63
14990,14990,139,2022/4/15 19:20:00,37,122,-85
14991,14991,139,2022/4/15 19:30:00,42,84,-42
14992,14992,139,2022/4/15 19:40:00,35,100,-65
14993,14993,139,2022/4/15 19:50:00,40,119,-79
14994,14994,139,2022/4/15 20:00:00,44,88,-44
14995,14995,139,2022/4/15 20:10:00,49,124,-75
14996,14996,139,2022/4/15 20:20:00,57,70,-13
14997,14997,139,2022/4/15 20:30:00,71,106,-35
14998,14998,139,2022/4/15 20:40:00,63,92,-29
14999,14999,139,2022/4/15 20:50:00,62,76,-14
15000,15000,139,2022/4/15 21:00:00,44,75,-31
15001,15001,139,2022/4/15 21:10:00,49,60,-11
15002,15002,139,2022/4/15 21:20:00,40,72,-32
15003,15003,139,2022/4/15 21:30:00,51,72,-21
15004,15004,139,2022/4/15 21:40:00,39,60,-21
15005,15005,139,2022/4/15 21:50:00,21,69,-48
15006,15006,139,2022/4/15 22:00:00,0,50,-50
15007,15007,139,2022/4/15 22:10:00,0,69,-69
15008,15008,139,2022/4/15 22:20:00,0,57,-57
15009,15009,139,2022/4/15 22:30:00,0,58,-58
15010,15010,139,2022/4/15 22:40:00,0,3,-3
15011,15011,139,2022/4/15 22:50:00,0,3,-3
15012,15012,140,2022/4/15 5:00:00,1,1,0
15013,15013,140,2022/4/15 5:10:00,3,1,2
15014,15014,140,2022/4/15 5:20:00,4,1,3
15015,15015,140,2022/4/15 5:30:00,6,1,5
15016,15016,140,2022/4/15 5:40:00,7,2,5
15017,15017,140,2022/4/15 5:50:00,7,1,6
15018,15018,140,2022/4/15 6:00:00,12,19,-7
15019,15019,140,2022/4/15 6:10:00,15,62,-47
15020,15020,140,2022/4/15 6:20:00,17,53,-36
15021,15021,140,2022/4/15 6:30:00,30,34,-4
15022,15022,140,2022/4/15 6:40:00,32,72,-40
15023,15023,140,2022/4/15 6:50:00,43,90,-47
15024,15024,140,2022/4/15 7:00:00,47,105,-58
15025,15025,140,2022/4/15 7:10:00,70,105,-35
15026,15026,140,2022/4/15 7:20:00,138,122,16
15027,15027,140,2022/4/15 7:30:00,156,128,28
15028,15028,140,2022/4/15 7:40:00,249,197,52
15029,15029,140,2022/4/15 7:50:00,251,233,18
15030,15030,140,2022/4/15 8:00:00,303,319,-16
15031,15031,140,2022/4/15 8:10:00,280,500,-220
15032,15032,140,2022/4/15 8:20:00,277,437,-160
15033,15033,140,2022/4/15 8:30:00,278,428,-150
15034,15034,140,2022/4/15 8:40:00,232,426,-194
15035,15035,140,2022/4/15 8:50:00,217,486,-269
15036,15036,140,2022/4/15 9:00:00,163,284,-121
15037,15037,140,2022/4/15 9:10:00,143,178,-35
15038,15038,140,2022/4/15 9:20:00,140,161,-21
15039,15039,140,2022/4/15 9:30:00,89,154,-65
15040,15040,140,2022/4/15 9:40:00,64,125,-61
15041,15041,140,2022/4/15 9:50:00,48,125,-77
15042,15042,140,2022/4/15 10:00:00,44,114,-70
15043,15043,140,2022/4/15 10:10:00,46,126,-80
15044,15044,140,2022/4/15 10:20:00,50,123,-73
15045,15045,140,2022/4/15 10:30:00,47,105,-58
15046,15046,140,2022/4/15 10:40:00,44,109,-65
15047,15047,140,2022/4/15 10:50:00,46,104,-58
15048,15048,140,2022/4/15 11:00:00,55,109,-54
15049,15049,140,2022/4/15 11:10:00,43,112,-69
15050,15050,140,2022/4/15 11:20:00,49,99,-50
15051,15051,140,2022/4/15 11:30:00,55,108,-53
15052,15052,140,2022/4/15 11:40:00,53,102,-49
15053,15053,140,2022/4/15 11:50:00,57,105,-48
15054,15054,140,2022/4/15 12:00:00,53,106,-53
15055,15055,140,2022/4/15 12:10:00,65,106,-41
15056,15056,140,2022/4/15 12:20:00,45,105,-60
15057,15057,140,2022/4/15 12:30:00,53,116,-63
15058,15058,140,2022/4/15 12:40:00,52,102,-50
15059,15059,140,2022/4/15 12:50:00,44,110,-66
15060,15060,140,2022/4/15 13:00:00,55,123,-68
15061,15061,140,2022/4/15 13:10:00,45,109,-64
15062,15062,140,2022/4/15 13:20:00,53,122,-69
15063,15063,140,2022/4/15 13:30:00,55,109,-54
15064,15064,140,2022/4/15 13:40:00,57,97,-40
15065,15065,140,2022/4/15 13:50:00,60,118,-58
15066,15066,140,2022/4/15 14:00:00,62,123,-61
15067,15067,140,2022/4/15 14:10:00,63,117,-54
15068,15068,140,2022/4/15 14:20:00,61,100,-39
15069,15069,140,2022/4/15 14:30:00,76,120,-44
15070,15070,140,2022/4/15 14:40:00,68,95,-27
15071,15071,140,2022/4/15 14:50:00,87,123,-36
15072,15072,140,2022/4/15 15:00:00,70,98,-28
15073,15073,140,2022/4/15 15:10:00,119,104,15
15074,15074,140,2022/4/15 15:20:00,127,103,24
15075,15075,140,2022/4/15 15:30:00,104,95,9
15076,15076,140,2022/4/15 15:40:00,129,104,25
15077,15077,140,2022/4/15 15:50:00,85,126,-41
15078,15078,140,2022/4/15 16:00:00,149,98,51
15079,15079,140,2022/4/15 16:10:00,155,102,53
15080,15080,140,2022/4/15 16:20:00,158,105,53
15081,15081,140,2022/4/15 16:30:00,172,103,69
15082,15082,140,2022/4/15 16:40:00,228,105,123
15083,15083,140,2022/4/15 16:50:00,197,103,94
15084,15084,140,2022/4/15 17:00:00,210,119,91
15085,15085,140,2022/4/15 17:10:00,268,107,161
15086,15086,140,2022/4/15 17:20:00,305,130,175
15087,15087,140,2022/4/15 17:30:00,374,119,255
15088,15088,140,2022/4/15 17:40:00,578,108,470
15089,15089,140,2022/4/15 17:50:00,337,149,188
15090,15090,140,2022/4/15 18:00:00,305,192,113
15091,15091,140,2022/4/15 18:10:00,319,182,137
15092,15092,140,2022/4/15 18:20:00,337,180,157
15093,15093,140,2022/4/15 18:30:00,265,192,73
15094,15094,140,2022/4/15 18:40:00,209,180,29
15095,15095,140,2022/4/15 18:50:00,176,151,25
15096,15096,140,2022/4/15 19:00:00,132,117,15
15097,15097,140,2022/4/15 19:10:00,84,121,-37
15098,15098,140,2022/4/15 19:20:00,82,121,-39
15099,15099,140,2022/4/15 19:30:00,60,103,-43
15100,15100,140,2022/4/15 19:40:00,65,106,-41
15101,15101,140,2022/4/15 19:50:00,50,91,-41
15102,15102,140,2022/4/15 20:00:00,45,88,-43
15103,15103,140,2022/4/15 20:10:00,44,78,-34
15104,15104,140,2022/4/15 20:20:00,38,72,-34
15105,15105,140,2022/4/15 20:30:00,38,77,-39
15106,15106,140,2022/4/15 20:40:00,29,66,-37
15107,15107,140,2022/4/15 20:50:00,30,65,-35
15108,15108,140,2022/4/15 21:00:00,25,70,-45
15109,15109,140,2022/4/15 21:10:00,26,67,-41
15110,15110,140,2022/4/15 21:20:00,22,70,-48
15111,15111,140,2022/4/15 21:30:00,27,70,-43
15112,15112,140,2022/4/15 21:40:00,41,61,-20
15113,15113,140,2022/4/15 21:50:00,18,60,-42
15114,15114,140,2022/4/15 22:00:00,21,66,-45
15115,15115,140,2022/4/15 22:10:00,17,71,-54
15116,15116,140,2022/4/15 22:20:00,13,53,-40
15117,15117,140,2022/4/15 22:30:00,8,49,-41
15118,15118,140,2022/4/15 22:40:00,7,44,-37
15119,15119,140,2022/4/15 22:50:00,4,40,-36
15120,15120,141,2022/4/15 5:00:00,2,1,1
15121,15121,141,2022/4/15 5:10:00,8,1,7
15122,15122,141,2022/4/15 5:20:00,7,1,6
15123,15123,141,2022/4/15 5:30:00,10,1,9
15124,15124,141,2022/4/15 5:40:00,13,1,12
15125,15125,141,2022/4/15 5:50:00,18,1,17
15126,15126,141,2022/4/15 6:00:00,29,1,28
15127,15127,141,2022/4/15 6:10:00,35,22,13
15128,15128,141,2022/4/15 6:20:00,43,23,20
15129,15129,141,2022/4/15 6:30:00,59,40,19
15130,15130,141,2022/4/15 6:40:00,62,62,0
15131,15131,141,2022/4/15 6:50:00,122,73,49
15132,15132,141,2022/4/15 7:00:00,176,88,88
15133,15133,141,2022/4/15 7:10:00,234,103,131
15134,15134,141,2022/4/15 7:20:00,343,124,219
15135,15135,141,2022/4/15 7:30:00,598,110,488
15136,15136,141,2022/4/15 7:40:00,825,108,717
15137,15137,141,2022/4/15 7:50:00,1050,144,906
15138,15138,141,2022/4/15 8:00:00,1361,110,1251
15139,15139,141,2022/4/15 8:10:00,1361,111,1250
15140,15140,141,2022/4/15 8:20:00,1214,153,1061
15141,15141,141,2022/4/15 8:30:00,1054,111,943
15142,15142,141,2022/4/15 8:40:00,738,150,588
15143,15143,141,2022/4/15 8:50:00,650,119,531
15144,15144,141,2022/4/15 9:00:00,575,103,472
15145,15145,141,2022/4/15 9:10:00,325,104,221
15146,15146,141,2022/4/15 9:20:00,271,93,178
15147,15147,141,2022/4/15 9:30:00,200,99,101
15148,15148,141,2022/4/15 9:40:00,156,90,66
15149,15149,141,2022/4/15 9:50:00,72,92,-20
15150,15150,141,2022/4/15 10:00:00,52,79,-27
15151,15151,141,2022/4/15 10:10:00,44,83,-39
15152,15152,141,2022/4/15 10:20:00,42,78,-36
15153,15153,141,2022/4/15 10:30:00,37,74,-37
15154,15154,141,2022/4/15 10:40:00,39,82,-43
15155,15155,141,2022/4/15 10:50:00,34,84,-50
15156,15156,141,2022/4/15 11:00:00,31,82,-51
15157,15157,141,2022/4/15 11:10:00,32,80,-48
15158,15158,141,2022/4/15 11:20:00,35,75,-40
15159,15159,141,2022/4/15 11:30:00,29,77,-48
15160,15160,141,2022/4/15 11:40:00,33,84,-51
15161,15161,141,2022/4/15 11:50:00,37,91,-54
15162,15162,141,2022/4/15 12:00:00,37,77,-40
15163,15163,141,2022/4/15 12:10:00,34,76,-42
15164,15164,141,2022/4/15 12:20:00,41,79,-38
15165,15165,141,2022/4/15 12:30:00,41,93,-52
15166,15166,141,2022/4/15 12:40:00,37,87,-50
15167,15167,141,2022/4/15 12:50:00,38,90,-52
15168,15168,141,2022/4/15 13:00:00,38,93,-55
15169,15169,141,2022/4/15 13:10:00,36,94,-58
15170,15170,141,2022/4/15 13:20:00,40,88,-48
15171,15171,141,2022/4/15 13:30:00,36,92,-56
15172,15172,141,2022/4/15 13:40:00,37,95,-58
15173,15173,141,2022/4/15 13:50:00,35,97,-62
15174,15174,141,2022/4/15 14:00:00,38,90,-52
15175,15175,141,2022/4/15 14:10:00,33,93,-60
15176,15176,141,2022/4/15 14:20:00,30,102,-72
15177,15177,141,2022/4/15 14:30:00,35,99,-64
15178,15178,141,2022/4/15 14:40:00,32,93,-61
15179,15179,141,2022/4/15 14:50:00,32,93,-61
15180,15180,141,2022/4/15 15:00:00,34,101,-67
15181,15181,141,2022/4/15 15:10:00,37,97,-60
15182,15182,141,2022/4/15 15:20:00,42,101,-59
15183,15183,141,2022/4/15 15:30:00,41,105,-64
15184,15184,141,2022/4/15 15:40:00,37,100,-63
15185,15185,141,2022/4/15 15:50:00,38,102,-64
15186,15186,141,2022/4/15 16:00:00,43,111,-68
15187,15187,141,2022/4/15 16:10:00,42,101,-59
15188,15188,141,2022/4/15 16:20:00,42,103,-61
15189,15189,141,2022/4/15 16:30:00,52,99,-47
15190,15190,141,2022/4/15 16:40:00,86,124,-38
15191,15191,141,2022/4/15 16:50:00,81,114,-33
15192,15192,141,2022/4/15 17:00:00,110,108,2
15193,15193,141,2022/4/15 17:10:00,147,114,33
15194,15194,141,2022/4/15 17:20:00,174,230,-56
15195,15195,141,2022/4/15 17:30:00,222,324,-102
15196,15196,141,2022/4/15 17:40:00,181,332,-151
15197,15197,141,2022/4/15 17:50:00,132,334,-202
15198,15198,141,2022/4/15 18:00:00,161,502,-341
15199,15199,141,2022/4/15 18:10:00,128,507,-379
15200,15200,141,2022/4/15 18:20:00,66,496,-430
15201,15201,141,2022/4/15 18:30:00,50,421,-371
15202,15202,141,2022/4/15 18:40:00,44,421,-377
15203,15203,141,2022/4/15 18:50:00,38,508,-470
15204,15204,141,2022/4/15 19:00:00,40,497,-457
15205,15205,141,2022/4/15 19:10:00,28,320,-292
15206,15206,141,2022/4/15 19:20:00,31,232,-201
15207,15207,141,2022/4/15 19:30:00,32,179,-147
15208,15208,141,2022/4/15 19:40:00,25,183,-158
15209,15209,141,2022/4/15 19:50:00,29,183,-154
15210,15210,141,2022/4/15 20:00:00,28,111,-83
15211,15211,141,2022/4/15 20:10:00,27,117,-90
15212,15212,141,2022/4/15 20:20:00,26,119,-93
15213,15213,141,2022/4/15 20:30:00,23,111,-88
15214,15214,141,2022/4/15 20:40:00,28,121,-93
15215,15215,141,2022/4/15 20:50:00,26,110,-84
15216,15216,141,2022/4/15 21:00:00,27,104,-77
15217,15217,141,2022/4/15 21:10:00,30,107,-77
15218,15218,141,2022/4/15 21:20:00,26,104,-78
15219,15219,141,2022/4/15 21:30:00,25,110,-85
15220,15220,141,2022/4/15 21:40:00,23,111,-88
15221,15221,141,2022/4/15 21:50:00,22,104,-82
15222,15222,141,2022/4/15 22:00:00,19,123,-104
15223,15223,141,2022/4/15 22:10:00,20,125,-105
15224,15224,141,2022/4/15 22:20:00,10,110,-100
15225,15225,141,2022/4/15 22:30:00,7,111,-104
15226,15226,141,2022/4/15 22:40:00,7,97,-90
15227,15227,141,2022/4/15 22:50:00,4,74,-70
15228,15228,142,2022/4/15 5:00:00,1,1,0
15229,15229,142,2022/4/15 5:10:00,5,1,4
15230,15230,142,2022/4/15 5:20:00,20,1,19
15231,15231,142,2022/4/15 5:30:00,36,1,35
15232,15232,142,2022/4/15 5:40:00,38,6,32
15233,15233,142,2022/4/15 5:50:00,57,25,32
15234,15234,142,2022/4/15 6:00:00,124,21,103
15235,15235,142,2022/4/15 6:10:00,151,47,104
15236,15236,142,2022/4/15 6:20:00,227,62,165
15237,15237,142,2022/4/15 6:30:00,350,99,251
15238,15238,142,2022/4/15 6:40:00,662,113,549
15239,15239,142,2022/4/15 6:50:00,722,93,629
15240,15240,142,2022/4/15 7:00:00,829,100,729
15241,15241,142,2022/4/15 7:10:00,1206,110,1096
15242,15242,142,2022/4/15 7:20:00,1380,115,1265
15243,15243,142,2022/4/15 7:30:00,1977,323,1654
15244,15244,142,2022/4/15 7:40:00,2071,537,1534
15245,15245,142,2022/4/15 7:50:00,2559,493,2066
15246,15246,142,2022/4/15 8:00:00,3341,732,2609
15247,15247,142,2022/4/15 8:10:00,3326,1875,1451
15248,15248,142,2022/4/15 8:20:00,3237,2194,1043
15249,15249,142,2022/4/15 8:30:00,1978,6106,-4128
15250,15250,142,2022/4/15 8:40:00,1578,6142,-4564
15251,15251,142,2022/4/15 8:50:00,1357,4332,-2975
15252,15252,142,2022/4/15 9:00:00,1028,1875,-847
15253,15253,142,2022/4/15 9:10:00,720,1099,-379
15254,15254,142,2022/4/15 9:20:00,649,581,68
15255,15255,142,2022/4/15 9:30:00,553,427,126
15256,15256,142,2022/4/15 9:40:00,351,515,-164
15257,15257,142,2022/4/15 9:50:00,276,386,-110
15258,15258,142,2022/4/15 10:00:00,220,276,-56
15259,15259,142,2022/4/15 10:10:00,221,197,24
15260,15260,142,2022/4/15 10:20:00,189,181,8
15261,15261,142,2022/4/15 10:30:00,212,119,93
15262,15262,142,2022/4/15 10:40:00,175,116,59
15263,15263,142,2022/4/15 10:50:00,174,118,56
15264,15264,142,2022/4/15 11:00:00,174,108,66
15265,15265,142,2022/4/15 11:10:00,174,122,52
15266,15266,142,2022/4/15 11:20:00,180,105,75
15267,15267,142,2022/4/15 11:30:00,182,116,66
15268,15268,142,2022/4/15 11:40:00,216,109,107
15269,15269,142,2022/4/15 11:50:00,214,118,96
15270,15270,142,2022/4/15 12:00:00,209,108,101
15271,15271,142,2022/4/15 12:10:00,272,114,158
15272,15272,142,2022/4/15 12:20:00,199,116,83
15273,15273,142,2022/4/15 12:30:00,214,110,104
15274,15274,142,2022/4/15 12:40:00,209,150,59
15275,15275,142,2022/4/15 12:50:00,205,128,77
15276,15276,142,2022/4/15 13:00:00,197,184,13
15277,15277,142,2022/4/15 13:10:00,196,130,66
15278,15278,142,2022/4/15 13:20:00,174,184,-10
15279,15279,142,2022/4/15 13:30:00,174,117,57
15280,15280,142,2022/4/15 13:40:00,150,184,-34
15281,15281,142,2022/4/15 13:50:00,148,126,22
15282,15282,142,2022/4/15 14:00:00,114,152,-38
15283,15283,142,2022/4/15 14:10:00,173,122,51
15284,15284,142,2022/4/15 14:20:00,143,146,-3
15285,15285,142,2022/4/15 14:30:00,134,127,7
15286,15286,142,2022/4/15 14:40:00,147,150,-3
15287,15287,142,2022/4/15 14:50:00,144,115,29
15288,15288,142,2022/4/15 15:00:00,137,150,-13
15289,15289,142,2022/4/15 15:10:00,173,138,35
15290,15290,142,2022/4/15 15:20:00,173,185,-12
15291,15291,142,2022/4/15 15:30:00,165,185,-20
15292,15292,142,2022/4/15 15:40:00,214,181,33
15293,15293,142,2022/4/15 15:50:00,166,192,-26
15294,15294,142,2022/4/15 16:00:00,182,207,-25
15295,15295,142,2022/4/15 16:10:00,201,145,56
15296,15296,142,2022/4/15 16:20:00,224,231,-7
15297,15297,142,2022/4/15 16:30:00,235,196,39
15298,15298,142,2022/4/15 16:40:00,269,296,-27
15299,15299,142,2022/4/15 16:50:00,270,298,-28
15300,15300,142,2022/4/15 17:00:00,456,331,125
15301,15301,142,2022/4/15 17:10:00,703,376,327
15302,15302,142,2022/4/15 17:20:00,633,424,209
15303,15303,142,2022/4/15 17:30:00,802,492,310
15304,15304,142,2022/4/15 17:40:00,1592,569,1023
15305,15305,142,2022/4/15 17:50:00,1561,593,968
15306,15306,142,2022/4/15 18:00:00,1589,1074,515
15307,15307,142,2022/4/15 18:10:00,3331,1084,2247
15308,15308,142,2022/4/15 18:20:00,3213,557,2656
15309,15309,142,2022/4/15 18:30:00,1982,1479,503
15310,15310,142,2022/4/15 18:40:00,1361,1471,-110
15311,15311,142,2022/4/15 18:50:00,828,1013,-185
15312,15312,142,2022/4/15 19:00:00,696,1078,-382
15313,15313,142,2022/4/15 19:10:00,575,593,-18
15314,15314,142,2022/4/15 19:20:00,423,428,-5
15315,15315,142,2022/4/15 19:30:00,294,430,-136
15316,15316,142,2022/4/15 19:40:00,277,534,-257
15317,15317,142,2022/4/15 19:50:00,223,328,-105
15318,15318,142,2022/4/15 20:00:00,217,328,-111
15319,15319,142,2022/4/15 20:10:00,234,322,-88
15320,15320,142,2022/4/15 20:20:00,207,334,-127
15321,15321,142,2022/4/15 20:30:00,142,336,-194
15322,15322,142,2022/4/15 20:40:00,137,207,-70
15323,15323,142,2022/4/15 20:50:00,87,329,-242
15324,15324,142,2022/4/15 21:00:00,70,231,-161
15325,15325,142,2022/4/15 21:10:00,148,207,-59
15326,15326,142,2022/4/15 21:20:00,78,298,-220
15327,15327,142,2022/4/15 21:30:00,47,270,-223
15328,15328,142,2022/4/15 21:40:00,47,328,-281
15329,15329,142,2022/4/15 21:50:00,36,300,-264
15330,15330,142,2022/4/15 22:00:00,29,237,-208
15331,15331,142,2022/4/15 22:10:00,31,224,-193
15332,15332,142,2022/4/15 22:20:00,26,232,-206
15333,15333,142,2022/4/15 22:30:00,20,276,-256
15334,15334,142,2022/4/15 22:40:00,13,185,-172
15335,15335,142,2022/4/15 22:50:00,9,133,-124
15336,15336,143,2022/4/15 5:00:00,0,1,-1
15337,15337,143,2022/4/15 5:10:00,0,1,-1
15338,15338,143,2022/4/15 5:20:00,0,1,-1
15339,15339,143,2022/4/15 5:30:00,0,1,-1
15340,15340,143,2022/4/15 5:40:00,1,1,0
15341,15341,143,2022/4/15 5:50:00,13,1,12
15342,15342,143,2022/4/15 6:00:00,14,2,12
15343,15343,143,2022/4/15 6:10:00,30,2,28
15344,15344,143,2022/4/15 6:20:00,59,6,53
15345,15345,143,2022/4/15 6:30:00,112,47,65
15346,15346,143,2022/4/15 6:40:00,162,51,111
15347,15347,143,2022/4/15 6:50:00,213,44,169
15348,15348,143,2022/4/15 7:00:00,283,73,210
15349,15349,143,2022/4/15 7:10:00,442,68,374
15350,15350,143,2022/4/15 7:20:00,705,108,597
15351,15351,143,2022/4/15 7:30:00,1216,100,1116
15352,15352,143,2022/4/15 7:40:00,1366,150,1216
15353,15353,143,2022/4/15 7:50:00,1367,114,1253
15354,15354,143,2022/4/15 8:00:00,1177,193,984
15355,15355,143,2022/4/15 8:10:00,734,222,512
15356,15356,143,2022/4/15 8:20:00,740,115,625
15357,15357,143,2022/4/15 8:30:00,720,153,567
15358,15358,143,2022/4/15 8:40:00,594,153,441
15359,15359,143,2022/4/15 8:50:00,457,102,355
15360,15360,143,2022/4/15 9:00:00,340,95,245
15361,15361,143,2022/4/15 9:10:00,227,105,122
15362,15362,143,2022/4/15 9:20:00,177,73,104
15363,15363,143,2022/4/15 9:30:00,122,93,29
15364,15364,143,2022/4/15 9:40:00,72,97,-25
15365,15365,143,2022/4/15 9:50:00,44,70,-26
15366,15366,143,2022/4/15 10:00:00,52,75,-23
15367,15367,143,2022/4/15 10:10:00,36,82,-46
15368,15368,143,2022/4/15 10:20:00,29,45,-16
15369,15369,143,2022/4/15 10:30:00,32,75,-43
15370,15370,143,2022/4/15 10:40:00,36,68,-32
15371,15371,143,2022/4/15 10:50:00,28,75,-47
15372,15372,143,2022/4/15 11:00:00,29,62,-33
15373,15373,143,2022/4/15 11:10:00,36,69,-33
15374,15374,143,2022/4/15 11:20:00,40,64,-24
15375,15375,143,2022/4/15 11:30:00,37,69,-32
15376,15376,143,2022/4/15 11:40:00,35,76,-41
15377,15377,143,2022/4/15 11:50:00,40,110,-70
15378,15378,143,2022/4/15 12:00:00,54,72,-18
15379,15379,143,2022/4/15 12:10:00,40,72,-32
15380,15380,143,2022/4/15 12:20:00,47,72,-25
15381,15381,143,2022/4/15 12:30:00,59,71,-12
15382,15382,143,2022/4/15 12:40:00,44,92,-48
15383,15383,143,2022/4/15 12:50:00,40,93,-53
15384,15384,143,2022/4/15 13:00:00,43,72,-29
15385,15385,143,2022/4/15 13:10:00,36,69,-33
15386,15386,143,2022/4/15 13:20:00,44,72,-28
15387,15387,143,2022/4/15 13:30:00,32,69,-37
15388,15388,143,2022/4/15 13:40:00,26,109,-83
15389,15389,143,2022/4/15 13:50:00,40,72,-32
15390,15390,143,2022/4/15 14:00:00,32,73,-41
15391,15391,143,2022/4/15 14:10:00,26,68,-42
15392,15392,143,2022/4/15 14:20:00,24,81,-57
15393,15393,143,2022/4/15 14:30:00,33,76,-43
15394,15394,143,2022/4/15 14:40:00,26,99,-73
15395,15395,143,2022/4/15 14:50:00,23,72,-49
15396,15396,143,2022/4/15 15:00:00,22,90,-68
15397,15397,143,2022/4/15 15:10:00,31,78,-47
15398,15398,143,2022/4/15 15:20:00,25,76,-51
15399,15399,143,2022/4/15 15:30:00,33,121,-88
15400,15400,143,2022/4/15 15:40:00,25,87,-62
15401,15401,143,2022/4/15 15:50:00,28,91,-63
15402,15402,143,2022/4/15 16:00:00,33,88,-55
15403,15403,143,2022/4/15 16:10:00,30,109,-79
15404,15404,143,2022/4/15 16:20:00,41,108,-67
15405,15405,143,2022/4/15 16:30:00,30,110,-80
15406,15406,143,2022/4/15 16:40:00,41,105,-64
15407,15407,143,2022/4/15 16:50:00,39,105,-66
15408,15408,143,2022/4/15 17:00:00,38,123,-85
15409,15409,143,2022/4/15 17:10:00,73,106,-33
15410,15410,143,2022/4/15 17:20:00,82,190,-108
15411,15411,143,2022/4/15 17:30:00,156,111,45
15412,15412,143,2022/4/15 17:40:00,140,195,-55
15413,15413,143,2022/4/15 17:50:00,126,297,-171
15414,15414,143,2022/4/15 18:00:00,63,224,-161
15415,15415,143,2022/4/15 18:10:00,58,508,-450
15416,15416,143,2022/4/15 18:20:00,64,268,-204
15417,15417,143,2022/4/15 18:30:00,57,492,-435
15418,15418,143,2022/4/15 18:40:00,44,484,-440
15419,15419,143,2022/4/15 18:50:00,38,429,-391
15420,15420,143,2022/4/15 19:00:00,33,433,-400
15421,15421,143,2022/4/15 19:10:00,29,364,-335
15422,15422,143,2022/4/15 19:20:00,30,434,-404
15423,15423,143,2022/4/15 19:30:00,22,224,-202
15424,15424,143,2022/4/15 19:40:00,26,340,-314
15425,15425,143,2022/4/15 19:50:00,25,191,-166
15426,15426,143,2022/4/15 20:00:00,25,215,-190
15427,15427,143,2022/4/15 20:10:00,27,191,-164
15428,15428,143,2022/4/15 20:20:00,24,110,-86
15429,15429,143,2022/4/15 20:30:00,25,169,-144
15430,15430,143,2022/4/15 20:40:00,23,122,-99
15431,15431,143,2022/4/15 20:50:00,22,119,-97
15432,15432,143,2022/4/15 21:00:00,17,191,-174
15433,15433,143,2022/4/15 21:10:00,17,91,-74
15434,15434,143,2022/4/15 21:20:00,18,178,-160
15435,15435,143,2022/4/15 21:30:00,16,106,-90
15436,15436,143,2022/4/15 21:40:00,12,151,-139
15437,15437,143,2022/4/15 21:50:00,12,115,-103
15438,15438,143,2022/4/15 22:00:00,6,104,-98
15439,15439,143,2022/4/15 22:10:00,4,105,-101
15440,15440,143,2022/4/15 22:20:00,2,107,-105
15441,15441,143,2022/4/15 22:30:00,1,47,-46
15442,15442,143,2022/4/15 22:40:00,0,3,-3
15443,15443,143,2022/4/15 22:50:00,0,3,-3
15444,15444,144,2022/4/15 5:00:00,0,1,-1
15445,15445,144,2022/4/15 5:10:00,0,1,-1
15446,15446,144,2022/4/15 5:20:00,6,1,5
15447,15447,144,2022/4/15 5:30:00,13,1,12
15448,15448,144,2022/4/15 5:40:00,20,2,18
15449,15449,144,2022/4/15 5:50:00,21,19,2
15450,15450,144,2022/4/15 6:00:00,32,11,21
15451,15451,144,2022/4/15 6:10:00,36,16,20
15452,15452,144,2022/4/15 6:20:00,48,47,1
15453,15453,144,2022/4/15 6:30:00,56,60,-4
15454,15454,144,2022/4/15 6:40:00,94,68,26
15455,15455,144,2022/4/15 6:50:00,184,99,85
15456,15456,144,2022/4/15 7:00:00,248,102,146
15457,15457,144,2022/4/15 7:10:00,282,128,154
15458,15458,144,2022/4/15 7:20:00,346,120,226
15459,15459,144,2022/4/15 7:30:00,590,116,474
15460,15460,144,2022/4/15 7:40:00,686,128,558
15461,15461,144,2022/4/15 7:50:00,861,198,663
15462,15462,144,2022/4/15 8:00:00,864,267,597
15463,15463,144,2022/4/15 8:10:00,1055,321,734
15464,15464,144,2022/4/15 8:20:00,859,431,428
15465,15465,144,2022/4/15 8:30:00,740,579,161
15466,15466,144,2022/4/15 8:40:00,627,482,145
15467,15467,144,2022/4/15 8:50:00,572,520,52
15468,15468,144,2022/4/15 9:00:00,340,299,41
15469,15469,144,2022/4/15 9:10:00,271,198,73
15470,15470,144,2022/4/15 9:20:00,219,139,80
15471,15471,144,2022/4/15 9:30:00,183,117,66
15472,15472,144,2022/4/15 9:40:00,143,110,33
15473,15473,144,2022/4/15 9:50:00,93,119,-26
15474,15474,144,2022/4/15 10:00:00,80,105,-25
15475,15475,144,2022/4/15 10:10:00,69,105,-36
15476,15476,144,2022/4/15 10:20:00,60,105,-45
15477,15477,144,2022/4/15 10:30:00,44,98,-54
15478,15478,144,2022/4/15 10:40:00,44,93,-49
15479,15479,144,2022/4/15 10:50:00,46,104,-58
15480,15480,144,2022/4/15 11:00:00,47,93,-46
15481,15481,144,2022/4/15 11:10:00,47,93,-46
15482,15482,144,2022/4/15 11:20:00,46,93,-47
15483,15483,144,2022/4/15 11:30:00,47,106,-59
15484,15484,144,2022/4/15 11:40:00,48,105,-57
15485,15485,144,2022/4/15 11:50:00,48,104,-56
15486,15486,144,2022/4/15 12:00:00,55,105,-50
15487,15487,144,2022/4/15 12:10:00,57,106,-49
15488,15488,144,2022/4/15 12:20:00,55,104,-49
15489,15489,144,2022/4/15 12:30:00,62,104,-42
15490,15490,144,2022/4/15 12:40:00,64,108,-44
15491,15491,144,2022/4/15 12:50:00,53,104,-51
15492,15492,144,2022/4/15 13:00:00,61,105,-44
15493,15493,144,2022/4/15 13:10:00,67,113,-46
15494,15494,144,2022/4/15 13:20:00,60,105,-45
15495,15495,144,2022/4/15 13:30:00,56,107,-51
15496,15496,144,2022/4/15 13:40:00,58,104,-46
15497,15497,144,2022/4/15 13:50:00,56,112,-56
15498,15498,144,2022/4/15 14:00:00,52,101,-49
15499,15499,144,2022/4/15 14:10:00,48,98,-50
15500,15500,144,2022/4/15 14:20:00,56,105,-49
15501,15501,144,2022/4/15 14:30:00,49,108,-59
15502,15502,144,2022/4/15 14:40:00,55,108,-53
15503,15503,144,2022/4/15 14:50:00,58,126,-68
15504,15504,144,2022/4/15 15:00:00,63,108,-45
15505,15505,144,2022/4/15 15:10:00,77,124,-47
15506,15506,144,2022/4/15 15:20:00,68,100,-32
15507,15507,144,2022/4/15 15:30:00,57,116,-59
15508,15508,144,2022/4/15 15:40:00,60,123,-63
15509,15509,144,2022/4/15 15:50:00,65,117,-52
15510,15510,144,2022/4/15 16:00:00,64,104,-40
15511,15511,144,2022/4/15 16:10:00,83,105,-22
15512,15512,144,2022/4/15 16:20:00,82,110,-28
15513,15513,144,2022/4/15 16:30:00,144,127,17
15514,15514,144,2022/4/15 16:40:00,224,110,114
15515,15515,144,2022/4/15 16:50:00,212,159,53
15516,15516,144,2022/4/15 17:00:00,223,117,106
15517,15517,144,2022/4/15 17:10:00,331,195,136
15518,15518,144,2022/4/15 17:20:00,272,194,78
15519,15519,144,2022/4/15 17:30:00,272,297,-25
15520,15520,144,2022/4/15 17:40:00,579,329,250
15521,15521,144,2022/4/15 17:50:00,371,315,56
15522,15522,144,2022/4/15 18:00:00,316,326,-10
15523,15523,144,2022/4/15 18:10:00,576,380,196
15524,15524,144,2022/4/15 18:20:00,616,506,110
15525,15525,144,2022/4/15 18:30:00,291,510,-219
15526,15526,144,2022/4/15 18:40:00,230,535,-305
15527,15527,144,2022/4/15 18:50:00,188,320,-132
15528,15528,144,2022/4/15 19:00:00,128,351,-223
15529,15529,144,2022/4/15 19:10:00,92,257,-165
15530,15530,144,2022/4/15 19:20:00,72,158,-86
15531,15531,144,2022/4/15 19:30:00,55,158,-103
15532,15532,144,2022/4/15 19:40:00,47,108,-61
15533,15533,144,2022/4/15 19:50:00,44,116,-72
15534,15534,144,2022/4/15 20:00:00,44,107,-63
15535,15535,144,2022/4/15 20:10:00,57,110,-53
15536,15536,144,2022/4/15 20:20:00,57,118,-61
15537,15537,144,2022/4/15 20:30:00,46,105,-59
15538,15538,144,2022/4/15 20:40:00,45,109,-64
15539,15539,144,2022/4/15 20:50:00,43,122,-79
15540,15540,144,2022/4/15 21:00:00,43,106,-63
15541,15541,144,2022/4/15 21:10:00,45,104,-59
15542,15542,144,2022/4/15 21:20:00,37,98,-61
15543,15543,144,2022/4/15 21:30:00,32,109,-77
15544,15544,144,2022/4/15 21:40:00,28,101,-73
15545,15545,144,2022/4/15 21:50:00,29,84,-55
15546,15546,144,2022/4/15 22:00:00,35,89,-54
15547,15547,144,2022/4/15 22:10:00,25,111,-86
15548,15548,144,2022/4/15 22:20:00,22,107,-85
15549,15549,144,2022/4/15 22:30:00,13,113,-100
15550,15550,144,2022/4/15 22:40:00,13,82,-69
15551,15551,144,2022/4/15 22:50:00,9,70,-61
15552,15552,145,2022/4/15 5:00:00,2,1,1
15553,15553,145,2022/4/15 5:10:00,15,1,14
15554,15554,145,2022/4/15 5:20:00,32,1,31
15555,15555,145,2022/4/15 5:30:00,36,1,35
15556,15556,145,2022/4/15 5:40:00,44,1,43
15557,15557,145,2022/4/15 5:50:00,51,1,50
15558,15558,145,2022/4/15 6:00:00,142,5,137
15559,15559,145,2022/4/15 6:10:00,128,66,62
15560,15560,145,2022/4/15 6:20:00,246,57,189
15561,15561,145,2022/4/15 6:30:00,301,62,239
15562,15562,145,2022/4/15 6:40:00,385,105,280
15563,15563,145,2022/4/15 6:50:00,652,92,560
15564,15564,145,2022/4/15 7:00:00,681,121,560
15565,15565,145,2022/4/15 7:10:00,1201,128,1073
15566,15566,145,2022/4/15 7:20:00,1357,136,1221
15567,15567,145,2022/4/15 7:30:00,1968,178,1790
15568,15568,145,2022/4/15 7:40:00,1982,268,1714
15569,15569,145,2022/4/15 7:50:00,2049,305,1744
15570,15570,145,2022/4/15 8:00:00,2554,418,2136
15571,15571,145,2022/4/15 8:10:00,2551,287,2264
15572,15572,145,2022/4/15 8:20:00,1979,383,1596
15573,15573,145,2022/4/15 8:30:00,1406,417,989
15574,15574,145,2022/4/15 8:40:00,1019,262,757
15575,15575,145,2022/4/15 8:50:00,679,460,219
15576,15576,145,2022/4/15 9:00:00,694,309,385
15577,15577,145,2022/4/15 9:10:00,481,278,203
15578,15578,145,2022/4/15 9:20:00,314,260,54
15579,15579,145,2022/4/15 9:30:00,293,314,-21
15580,15580,145,2022/4/15 9:40:00,271,265,6
15581,15581,145,2022/4/15 9:50:00,218,173,45
15582,15582,145,2022/4/15 10:00:00,225,213,12
15583,15583,145,2022/4/15 10:10:00,211,178,33
15584,15584,145,2022/4/15 10:20:00,215,172,43
15585,15585,145,2022/4/15 10:30:00,213,214,-1
15586,15586,145,2022/4/15 10:40:00,159,118,41
15587,15587,145,2022/4/15 10:50:00,201,168,33
15588,15588,145,2022/4/15 11:00:00,135,110,25
15589,15589,145,2022/4/15 11:10:00,217,108,109
15590,15590,145,2022/4/15 11:20:00,180,169,11
15591,15591,145,2022/4/15 11:30:00,171,118,53
15592,15592,145,2022/4/15 11:40:00,186,124,62
15593,15593,145,2022/4/15 11:50:00,229,120,109
15594,15594,145,2022/4/15 12:00:00,231,139,92
15595,15595,145,2022/4/15 12:10:00,183,104,79
15596,15596,145,2022/4/15 12:20:00,262,124,138
15597,15597,145,2022/4/15 12:30:00,265,115,150
15598,15598,145,2022/4/15 12:40:00,231,180,51
15599,15599,145,2022/4/15 12:50:00,247,111,136
15600,15600,145,2022/4/15 13:00:00,197,110,87
15601,15601,145,2022/4/15 13:10:00,248,126,122
15602,15602,145,2022/4/15 13:20:00,181,158,23
15603,15603,145,2022/4/15 13:30:00,266,129,137
15604,15604,145,2022/4/15 13:40:00,142,120,22
15605,15605,145,2022/4/15 13:50:00,164,142,22
15606,15606,145,2022/4/15 14:00:00,128,193,-65
15607,15607,145,2022/4/15 14:10:00,137,119,18
15608,15608,145,2022/4/15 14:20:00,177,108,69
15609,15609,145,2022/4/15 14:30:00,143,154,-11
15610,15610,145,2022/4/15 14:40:00,121,193,-72
15611,15611,145,2022/4/15 14:50:00,203,109,94
15612,15612,145,2022/4/15 15:00:00,118,110,8
15613,15613,145,2022/4/15 15:10:00,166,233,-67
15614,15614,145,2022/4/15 15:20:00,176,159,17
15615,15615,145,2022/4/15 15:30:00,175,181,-6
15616,15616,145,2022/4/15 15:40:00,163,151,12
15617,15617,145,2022/4/15 15:50:00,163,223,-60
15618,15618,145,2022/4/15 16:00:00,158,224,-66
15619,15619,145,2022/4/15 16:10:00,188,217,-29
15620,15620,145,2022/4/15 16:20:00,188,216,-28
15621,15621,145,2022/4/15 16:30:00,255,206,49
15622,15622,145,2022/4/15 16:40:00,272,268,4
15623,15623,145,2022/4/15 16:50:00,317,283,34
15624,15624,145,2022/4/15 17:00:00,261,204,57
15625,15625,145,2022/4/15 17:10:00,336,228,108
15626,15626,145,2022/4/15 17:20:00,442,214,228
15627,15627,145,2022/4/15 17:30:00,443,429,14
15628,15628,145,2022/4/15 17:40:00,301,281,20
15629,15629,145,2022/4/15 17:50:00,327,486,-159
15630,15630,145,2022/4/15 18:00:00,308,484,-176
15631,15631,145,2022/4/15 18:10:00,308,419,-111
15632,15632,145,2022/4/15 18:20:00,227,2058,-1831
15633,15633,145,2022/4/15 18:30:00,192,416,-224
15634,15634,145,2022/4/15 18:40:00,162,1957,-1795
15635,15635,145,2022/4/15 18:50:00,109,1583,-1474
15636,15636,145,2022/4/15 19:00:00,65,1570,-1505
15637,15637,145,2022/4/15 19:10:00,57,600,-543
15638,15638,145,2022/4/15 19:20:00,62,476,-414
15639,15639,145,2022/4/15 19:30:00,45,406,-361
15640,15640,145,2022/4/15 19:40:00,37,300,-263
15641,15641,145,2022/4/15 19:50:00,41,466,-425
15642,15642,145,2022/4/15 20:00:00,35,232,-197
15643,15643,145,2022/4/15 20:10:00,39,528,-489
15644,15644,145,2022/4/15 20:20:00,37,197,-160
15645,15645,145,2022/4/15 20:30:00,28,336,-308
15646,15646,145,2022/4/15 20:40:00,38,271,-233
15647,15647,145,2022/4/15 20:50:00,35,189,-154
15648,15648,145,2022/4/15 21:00:00,27,218,-191
15649,15649,145,2022/4/15 21:10:00,35,382,-347
15650,15650,145,2022/4/15 21:20:00,28,196,-168
15651,15651,145,2022/4/15 21:30:00,24,226,-202
15652,15652,145,2022/4/15 21:40:00,25,198,-173
15653,15653,145,2022/4/15 21:50:00,23,207,-184
15654,15654,145,2022/4/15 22:00:00,21,149,-128
15655,15655,145,2022/4/15 22:10:00,14,132,-118
15656,15656,145,2022/4/15 22:20:00,17,184,-167
15657,15657,145,2022/4/15 22:30:00,11,224,-213
15658,15658,145,2022/4/15 22:40:00,4,105,-101
15659,15659,145,2022/4/15 22:50:00,1,119,-118
15660,15660,146,2022/4/15 5:00:00,0,1,-1
15661,15661,146,2022/4/15 5:10:00,0,1,-1
15662,15662,146,2022/4/15 5:20:00,0,1,-1
15663,15663,146,2022/4/15 5:30:00,0,1,-1
15664,15664,146,2022/4/15 5:40:00,0,1,-1
15665,15665,146,2022/4/15 5:50:00,9,1,8
15666,15666,146,2022/4/15 6:00:00,20,1,19
15667,15667,146,2022/4/15 6:10:00,20,1,19
15668,15668,146,2022/4/15 6:20:00,27,1,26
15669,15669,146,2022/4/15 6:30:00,23,1,22
15670,15670,146,2022/4/15 6:40:00,27,1,26
15671,15671,146,2022/4/15 6:50:00,29,19,10
15672,15672,146,2022/4/15 7:00:00,30,8,22
15673,15673,146,2022/4/15 7:10:00,32,11,21
15674,15674,146,2022/4/15 7:20:00,30,8,22
15675,15675,146,2022/4/15 7:30:00,32,11,21
15676,15676,146,2022/4/15 7:40:00,32,33,-1
15677,15677,146,2022/4/15 7:50:00,32,16,16
15678,15678,146,2022/4/15 8:00:00,29,31,-2
15679,15679,146,2022/4/15 8:10:00,23,31,-8
15680,15680,146,2022/4/15 8:20:00,17,23,-6
15681,15681,146,2022/4/15 8:30:00,19,45,-26
15682,15682,146,2022/4/15 8:40:00,14,63,-49
15683,15683,146,2022/4/15 8:50:00,11,40,-29
15684,15684,146,2022/4/15 9:00:00,10,60,-50
15685,15685,146,2022/4/15 9:10:00,9,67,-58
15686,15686,146,2022/4/15 9:20:00,8,38,-30
15687,15687,146,2022/4/15 9:30:00,5,46,-41
15688,15688,146,2022/4/15 9:40:00,6,48,-42
15689,15689,146,2022/4/15 9:50:00,4,28,-24
15690,15690,146,2022/4/15 10:00:00,7,46,-39
15691,15691,146,2022/4/15 10:10:00,5,39,-34
15692,15692,146,2022/4/15 10:20:00,5,31,-26
15693,15693,146,2022/4/15 10:30:00,7,38,-31
15694,15694,146,2022/4/15 10:40:00,6,33,-27
15695,15695,146,2022/4/15 10:50:00,6,23,-17
15696,15696,146,2022/4/15 11:00:00,4,32,-28
15697,15697,146,2022/4/15 11:10:00,4,23,-19
15698,15698,146,2022/4/15 11:20:00,7,19,-12
15699,15699,146,2022/4/15 11:30:00,7,29,-22
15700,15700,146,2022/4/15 11:40:00,8,21,-13
15701,15701,146,2022/4/15 11:50:00,7,19,-12
15702,15702,146,2022/4/15 12:00:00,7,38,-31
15703,15703,146,2022/4/15 12:10:00,9,23,-14
15704,15704,146,2022/4/15 12:20:00,6,23,-17
15705,15705,146,2022/4/15 12:30:00,10,21,-11
15706,15706,146,2022/4/15 12:40:00,9,14,-5
15707,15707,146,2022/4/15 12:50:00,6,32,-26
15708,15708,146,2022/4/15 13:00:00,8,23,-15
15709,15709,146,2022/4/15 13:10:00,6,25,-19
15710,15710,146,2022/4/15 13:20:00,7,23,-16
15711,15711,146,2022/4/15 13:30:00,7,19,-12
15712,15712,146,2022/4/15 13:40:00,9,21,-12
15713,15713,146,2022/4/15 13:50:00,5,29,-24
15714,15714,146,2022/4/15 14:00:00,8,23,-15
15715,15715,146,2022/4/15 14:10:00,8,21,-13
15716,15716,146,2022/4/15 14:20:00,5,23,-18
15717,15717,146,2022/4/15 14:30:00,5,23,-18
15718,15718,146,2022/4/15 14:40:00,8,21,-13
15719,15719,146,2022/4/15 14:50:00,6,23,-17
15720,15720,146,2022/4/15 15:00:00,8,23,-15
15721,15721,146,2022/4/15 15:10:00,10,19,-9
15722,15722,146,2022/4/15 15:20:00,7,19,-12
15723,15723,146,2022/4/15 15:30:00,10,21,-11
15724,15724,146,2022/4/15 15:40:00,9,21,-12
15725,15725,146,2022/4/15 15:50:00,8,31,-23
15726,15726,146,2022/4/15 16:00:00,9,19,-10
15727,15727,146,2022/4/15 16:10:00,12,25,-13
15728,15728,146,2022/4/15 16:20:00,10,23,-13
15729,15729,146,2022/4/15 16:30:00,10,28,-18
15730,15730,146,2022/4/15 16:40:00,10,38,-28
15731,15731,146,2022/4/15 16:50:00,14,37,-23
15732,15732,146,2022/4/15 17:00:00,12,33,-21
15733,15733,146,2022/4/15 17:10:00,16,35,-19
15734,15734,146,2022/4/15 17:20:00,10,38,-28
15735,15735,146,2022/4/15 17:30:00,14,24,-10
15736,15736,146,2022/4/15 17:40:00,14,50,-36
15737,15737,146,2022/4/15 17:50:00,10,49,-39
15738,15738,146,2022/4/15 18:00:00,17,43,-26
15739,15739,146,2022/4/15 18:10:00,14,65,-51
15740,15740,146,2022/4/15 18:20:00,11,43,-32
15741,15741,146,2022/4/15 18:30:00,8,63,-55
15742,15742,146,2022/4/15 18:40:00,8,43,-35
15743,15743,146,2022/4/15 18:50:00,5,58,-53
15744,15744,146,2022/4/15 19:00:00,8,47,-39
15745,15745,146,2022/4/15 19:10:00,7,40,-33
15746,15746,146,2022/4/15 19:20:00,5,52,-47
15747,15747,146,2022/4/15 19:30:00,3,32,-29
15748,15748,146,2022/4/15 19:40:00,3,41,-38
15749,15749,146,2022/4/15 19:50:00,3,40,-37
15750,15750,146,2022/4/15 20:00:00,6,32,-26
15751,15751,146,2022/4/15 20:10:00,4,33,-29
15752,15752,146,2022/4/15 20:20:00,4,23,-19
15753,15753,146,2022/4/15 20:30:00,4,30,-26
15754,15754,146,2022/4/15 20:40:00,4,25,-21
15755,15755,146,2022/4/15 20:50:00,4,27,-23
15756,15756,146,2022/4/15 21:00:00,17,25,-8
15757,15757,146,2022/4/15 21:10:00,29,25,4
15758,15758,146,2022/4/15 21:20:00,13,40,-27
15759,15759,146,2022/4/15 21:30:00,4,21,-17
15760,15760,146,2022/4/15 21:40:00,2,31,-29
15761,15761,146,2022/4/15 21:50:00,2,26,-24
15762,15762,146,2022/4/15 22:00:00,1,21,-20
15763,15763,146,2022/4/15 22:10:00,0,25,-25
15764,15764,146,2022/4/15 22:20:00,0,13,-13
15765,15765,146,2022/4/15 22:30:00,0,34,-34
15766,15766,146,2022/4/15 22:40:00,0,22,-22
15767,15767,146,2022/4/15 22:50:00,0,21,-21
15768,15768,147,2022/4/15 5:00:00,0,1,-1
15769,15769,147,2022/4/15 5:10:00,2,1,1
15770,15770,147,2022/4/15 5:20:00,10,1,9
15771,15771,147,2022/4/15 5:30:00,21,1,20
15772,15772,147,2022/4/15 5:40:00,16,1,15
15773,15773,147,2022/4/15 5:50:00,25,1,24
15774,15774,147,2022/4/15 6:00:00,26,1,25
15775,15775,147,2022/4/15 6:10:00,29,1,28
15776,15776,147,2022/4/15 6:20:00,44,59,-15
15777,15777,147,2022/4/15 6:30:00,77,73,4
15778,15778,147,2022/4/15 6:40:00,59,109,-50
15779,15779,147,2022/4/15 6:50:00,81,104,-23
15780,15780,147,2022/4/15 7:00:00,149,175,-26
15781,15781,147,2022/4/15 7:10:00,188,229,-41
15782,15782,147,2022/4/15 7:20:00,190,501,-311
15783,15783,147,2022/4/15 7:30:00,282,558,-276
15784,15784,147,2022/4/15 7:40:00,320,1521,-1201
15785,15785,147,2022/4/15 7:50:00,436,2526,-2090
15786,15786,147,2022/4/15 8:00:00,467,3161,-2694
15787,15787,147,2022/4/15 8:10:00,443,4070,-3627
15788,15788,147,2022/4/15 8:20:00,324,5045,-4721
15789,15789,147,2022/4/15 8:30:00,280,4302,-4022
15790,15790,147,2022/4/15 8:40:00,267,3560,-3293
15791,15791,147,2022/4/15 8:50:00,231,3243,-3012
15792,15792,147,2022/4/15 9:00:00,215,3274,-3059
15793,15793,147,2022/4/15 9:10:00,168,2827,-2659
15794,15794,147,2022/4/15 9:20:00,162,2520,-2358
15795,15795,147,2022/4/15 9:30:00,92,1684,-1592
15796,15796,147,2022/4/15 9:40:00,116,624,-508
15797,15797,147,2022/4/15 9:50:00,76,499,-423
15798,15798,147,2022/4/15 10:00:00,65,363,-298
15799,15799,147,2022/4/15 10:10:00,67,196,-129
15800,15800,147,2022/4/15 10:20:00,63,179,-116
15801,15801,147,2022/4/15 10:30:00,65,137,-72
15802,15802,147,2022/4/15 10:40:00,58,107,-49
15803,15803,147,2022/4/15 10:50:00,69,104,-35
15804,15804,147,2022/4/15 11:00:00,69,109,-40
15805,15805,147,2022/4/15 11:10:00,81,124,-43
15806,15806,147,2022/4/15 11:20:00,88,111,-23
15807,15807,147,2022/4/15 11:30:00,132,110,22
15808,15808,147,2022/4/15 11:40:00,147,105,42
15809,15809,147,2022/4/15 11:50:00,149,111,38
15810,15810,147,2022/4/15 12:00:00,169,108,61
15811,15811,147,2022/4/15 12:10:00,186,133,53
15812,15812,147,2022/4/15 12:20:00,157,125,32
15813,15813,147,2022/4/15 12:30:00,175,109,66
15814,15814,147,2022/4/15 12:40:00,148,117,31
15815,15815,147,2022/4/15 12:50:00,162,152,10
15816,15816,147,2022/4/15 13:00:00,125,108,17
15817,15817,147,2022/4/15 13:10:00,137,111,26
15818,15818,147,2022/4/15 13:20:00,136,107,29
15819,15819,147,2022/4/15 13:30:00,139,129,10
15820,15820,147,2022/4/15 13:40:00,145,125,20
15821,15821,147,2022/4/15 13:50:00,137,110,27
15822,15822,147,2022/4/15 14:00:00,136,108,28
15823,15823,147,2022/4/15 14:10:00,120,109,11
15824,15824,147,2022/4/15 14:20:00,129,121,8
15825,15825,147,2022/4/15 14:30:00,161,102,59
15826,15826,147,2022/4/15 14:40:00,124,111,13
15827,15827,147,2022/4/15 14:50:00,113,119,-6
15828,15828,147,2022/4/15 15:00:00,141,126,15
15829,15829,147,2022/4/15 15:10:00,184,122,62
15830,15830,147,2022/4/15 15:20:00,197,121,76
15831,15831,147,2022/4/15 15:30:00,265,104,161
15832,15832,147,2022/4/15 15:40:00,230,116,114
15833,15833,147,2022/4/15 15:50:00,215,129,86
15834,15834,147,2022/4/15 16:00:00,271,116,155
15835,15835,147,2022/4/15 16:10:00,338,109,229
15836,15836,147,2022/4/15 16:20:00,272,122,150
15837,15837,147,2022/4/15 16:30:00,568,105,463
15838,15838,147,2022/4/15 16:40:00,637,108,529
15839,15839,147,2022/4/15 16:50:00,638,133,505
15840,15840,147,2022/4/15 17:00:00,814,152,662
15841,15841,147,2022/4/15 17:10:00,1558,150,1408
15842,15842,147,2022/4/15 17:20:00,1620,183,1437
15843,15843,147,2022/4/15 17:30:00,1354,231,1123
15844,15844,147,2022/4/15 17:40:00,2546,255,2291
15845,15845,147,2022/4/15 17:50:00,2534,268,2266
15846,15846,147,2022/4/15 18:00:00,1557,323,1234
15847,15847,147,2022/4/15 18:10:00,2534,329,2205
15848,15848,147,2022/4/15 18:20:00,2530,319,2211
15849,15849,147,2022/4/15 18:30:00,1610,319,1291
15850,15850,147,2022/4/15 18:40:00,1641,494,1147
15851,15851,147,2022/4/15 18:50:00,1191,318,873
15852,15852,147,2022/4/15 19:00:00,825,377,448
15853,15853,147,2022/4/15 19:10:00,805,319,486
15854,15854,147,2022/4/15 19:20:00,655,222,433
15855,15855,147,2022/4/15 19:30:00,587,222,365
15856,15856,147,2022/4/15 19:40:00,583,98,485
15857,15857,147,2022/4/15 19:50:00,309,177,132
15858,15858,147,2022/4/15 20:00:00,318,109,209
15859,15859,147,2022/4/15 20:10:00,315,150,165
15860,15860,147,2022/4/15 20:20:00,268,111,157
15861,15861,147,2022/4/15 20:30:00,258,120,138
15862,15862,147,2022/4/15 20:40:00,276,104,172
15863,15863,147,2022/4/15 20:50:00,202,114,88
15864,15864,147,2022/4/15 21:00:00,203,123,80
15865,15865,147,2022/4/15 21:10:00,237,105,132
15866,15866,147,2022/4/15 21:20:00,178,109,69
15867,15867,147,2022/4/15 21:30:00,77,111,-34
15868,15868,147,2022/4/15 21:40:00,66,121,-55
15869,15869,147,2022/4/15 21:50:00,44,122,-78
15870,15870,147,2022/4/15 22:00:00,42,123,-81
15871,15871,147,2022/4/15 22:10:00,35,96,-61
15872,15872,147,2022/4/15 22:20:00,30,126,-96
15873,15873,147,2022/4/15 22:30:00,19,105,-86
15874,15874,147,2022/4/15 22:40:00,13,70,-57
15875,15875,147,2022/4/15 22:50:00,4,105,-101
15876,15876,148,2022/4/15 5:00:00,0,1,-1
15877,15877,148,2022/4/15 5:10:00,1,1,0
15878,15878,148,2022/4/15 5:20:00,9,1,8
15879,15879,148,2022/4/15 5:30:00,16,1,15
15880,15880,148,2022/4/15 5:40:00,30,8,22
15881,15881,148,2022/4/15 5:50:00,29,23,6
15882,15882,148,2022/4/15 6:00:00,38,30,8
15883,15883,148,2022/4/15 6:10:00,51,39,12
15884,15884,148,2022/4/15 6:20:00,60,64,-4
15885,15885,148,2022/4/15 6:30:00,74,77,-3
15886,15886,148,2022/4/15 6:40:00,147,110,37
15887,15887,148,2022/4/15 6:50:00,227,112,115
15888,15888,148,2022/4/15 7:00:00,284,126,158
15889,15889,148,2022/4/15 7:10:00,275,112,163
15890,15890,148,2022/4/15 7:20:00,383,159,224
15891,15891,148,2022/4/15 7:30:00,596,197,399
15892,15892,148,2022/4/15 7:40:00,678,269,409
15893,15893,148,2022/4/15 7:50:00,871,329,542
15894,15894,148,2022/4/15 8:00:00,1170,420,750
15895,15895,148,2022/4/15 8:10:00,1208,553,655
15896,15896,148,2022/4/15 8:20:00,1213,1089,124
15897,15897,148,2022/4/15 8:30:00,1184,1117,67
15898,15898,148,2022/4/15 8:40:00,868,2006,-1138
15899,15899,148,2022/4/15 8:50:00,678,1582,-904
15900,15900,148,2022/4/15 9:00:00,615,1124,-509
15901,15901,148,2022/4/15 9:10:00,586,1127,-541
15902,15902,148,2022/4/15 9:20:00,330,589,-259
15903,15903,148,2022/4/15 9:30:00,309,417,-108
15904,15904,148,2022/4/15 9:40:00,246,426,-180
15905,15905,148,2022/4/15 9:50:00,217,436,-219
15906,15906,148,2022/4/15 10:00:00,215,334,-119
15907,15907,148,2022/4/15 10:10:00,190,297,-107
15908,15908,148,2022/4/15 10:20:00,196,221,-25
15909,15909,148,2022/4/15 10:30:00,184,197,-13
15910,15910,148,2022/4/15 10:40:00,174,222,-48
15911,15911,148,2022/4/15 10:50:00,168,207,-39
15912,15912,148,2022/4/15 11:00:00,175,222,-47
15913,15913,148,2022/4/15 11:10:00,185,223,-38
15914,15914,148,2022/4/15 11:20:00,187,180,7
15915,15915,148,2022/4/15 11:30:00,206,233,-27
15916,15916,148,2022/4/15 11:40:00,212,218,-6
15917,15917,148,2022/4/15 11:50:00,208,234,-26
15918,15918,148,2022/4/15 12:00:00,236,232,4
15919,15919,148,2022/4/15 12:10:00,257,196,61
15920,15920,148,2022/4/15 12:20:00,264,232,32
15921,15921,148,2022/4/15 12:30:00,274,255,19
15922,15922,148,2022/4/15 12:40:00,269,283,-14
15923,15923,148,2022/4/15 12:50:00,273,283,-10
15924,15924,148,2022/4/15 13:00:00,271,216,55
15925,15925,148,2022/4/15 13:10:00,262,232,30
15926,15926,148,2022/4/15 13:20:00,270,217,53
15927,15927,148,2022/4/15 13:30:00,265,232,33
15928,15928,148,2022/4/15 13:40:00,286,233,53
15929,15929,148,2022/4/15 13:50:00,267,269,-2
15930,15930,148,2022/4/15 14:00:00,269,232,37
15931,15931,148,2022/4/15 14:10:00,265,196,69
15932,15932,148,2022/4/15 14:20:00,268,233,35
15933,15933,148,2022/4/15 14:30:00,268,196,72
15934,15934,148,2022/4/15 14:40:00,264,218,46
15935,15935,148,2022/4/15 14:50:00,260,218,42
15936,15936,148,2022/4/15 15:00:00,262,232,30
15937,15937,148,2022/4/15 15:10:00,317,267,50
15938,15938,148,2022/4/15 15:20:00,261,216,45
15939,15939,148,2022/4/15 15:30:00,288,297,-9
15940,15940,148,2022/4/15 15:40:00,316,290,26
15941,15941,148,2022/4/15 15:50:00,291,320,-29
15942,15942,148,2022/4/15 16:00:00,312,318,-6
15943,15943,148,2022/4/15 16:10:00,329,297,32
15944,15944,148,2022/4/15 16:20:00,310,339,-29
15945,15945,148,2022/4/15 16:30:00,309,311,-2
15946,15946,148,2022/4/15 16:40:00,368,316,52
15947,15947,148,2022/4/15 16:50:00,350,318,32
15948,15948,148,2022/4/15 17:00:00,634,500,134
15949,15949,148,2022/4/15 17:10:00,794,498,296
15950,15950,148,2022/4/15 17:20:00,637,419,218
15951,15951,148,2022/4/15 17:30:00,836,560,276
15952,15952,148,2022/4/15 17:40:00,1156,561,595
15953,15953,148,2022/4/15 17:50:00,832,1115,-283
15954,15954,148,2022/4/15 18:00:00,1025,1784,-759
15955,15955,148,2022/4/15 18:10:00,1352,1110,242
15956,15956,148,2022/4/15 18:20:00,1163,1694,-531
15957,15957,148,2022/4/15 18:30:00,831,1519,-688
15958,15958,148,2022/4/15 18:40:00,706,1752,-1046
15959,15959,148,2022/4/15 18:50:00,646,1479,-833
15960,15960,148,2022/4/15 19:00:00,615,606,9
15961,15961,148,2022/4/15 19:10:00,587,469,118
15962,15962,148,2022/4/15 19:20:00,542,415,127
15963,15963,148,2022/4/15 19:30:00,422,494,-72
15964,15964,148,2022/4/15 19:40:00,425,341,84
15965,15965,148,2022/4/15 19:50:00,314,327,-13
15966,15966,148,2022/4/15 20:00:00,429,236,193
15967,15967,148,2022/4/15 20:10:00,549,218,331
15968,15968,148,2022/4/15 20:20:00,369,234,135
15969,15969,148,2022/4/15 20:30:00,550,221,329
15970,15970,148,2022/4/15 20:40:00,585,179,406
15971,15971,148,2022/4/15 20:50:00,571,150,421
15972,15972,148,2022/4/15 21:00:00,591,192,399
15973,15973,148,2022/4/15 21:10:00,614,191,423
15974,15974,148,2022/4/15 21:20:00,558,142,416
15975,15975,148,2022/4/15 21:30:00,585,192,393
15976,15976,148,2022/4/15 21:40:00,466,110,356
15977,15977,148,2022/4/15 21:50:00,322,115,207
15978,15978,148,2022/4/15 22:00:00,576,128,448
15979,15979,148,2022/4/15 22:10:00,258,133,125
15980,15980,148,2022/4/15 22:20:00,124,110,14
15981,15981,148,2022/4/15 22:30:00,44,112,-68
15982,15982,148,2022/4/15 22:40:00,26,103,-77
15983,15983,148,2022/4/15 22:50:00,23,94,-71
15984,15984,149,2022/4/15 5:00:00,0,1,-1
15985,15985,149,2022/4/15 5:10:00,0,1,-1
15986,15986,149,2022/4/15 5:20:00,2,1,1
15987,15987,149,2022/4/15 5:30:00,7,1,6
15988,15988,149,2022/4/15 5:40:00,22,1,21
15989,15989,149,2022/4/15 5:50:00,32,23,9
15990,15990,149,2022/4/15 6:00:00,27,51,-24
15991,15991,149,2022/4/15 6:10:00,34,38,-4
15992,15992,149,2022/4/15 6:20:00,37,50,-13
15993,15993,149,2022/4/15 6:30:00,48,62,-14
15994,15994,149,2022/4/15 6:40:00,59,73,-14
15995,15995,149,2022/4/15 6:50:00,86,99,-13
15996,15996,149,2022/4/15 7:00:00,92,113,-21
15997,15997,149,2022/4/15 7:10:00,124,105,19
15998,15998,149,2022/4/15 7:20:00,166,120,46
15999,15999,149,2022/4/15 7:30:00,217,197,20
16000,16000,149,2022/4/15 7:40:00,242,256,-14
16001,16001,149,2022/4/15 7:50:00,276,299,-23
16002,16002,149,2022/4/15 8:00:00,277,230,47
16003,16003,149,2022/4/15 8:10:00,332,317,15
16004,16004,149,2022/4/15 8:20:00,279,297,-18
16005,16005,149,2022/4/15 8:30:00,253,334,-81
16006,16006,149,2022/4/15 8:40:00,221,346,-125
16007,16007,149,2022/4/15 8:50:00,187,298,-111
16008,16008,149,2022/4/15 9:00:00,105,198,-93
16009,16009,149,2022/4/15 9:10:00,79,128,-49
16010,16010,149,2022/4/15 9:20:00,68,127,-59
16011,16011,149,2022/4/15 9:30:00,56,109,-53
16012,16012,149,2022/4/15 9:40:00,51,114,-63
16013,16013,149,2022/4/15 9:50:00,48,108,-60
16014,16014,149,2022/4/15 10:00:00,45,106,-61
16015,16015,149,2022/4/15 10:10:00,44,117,-73
16016,16016,149,2022/4/15 10:20:00,46,105,-59
16017,16017,149,2022/4/15 10:30:00,42,104,-62
16018,16018,149,2022/4/15 10:40:00,43,103,-60
16019,16019,149,2022/4/15 10:50:00,43,105,-62
16020,16020,149,2022/4/15 11:00:00,43,110,-67
16021,16021,149,2022/4/15 11:10:00,46,99,-53
16022,16022,149,2022/4/15 11:20:00,45,105,-60
16023,16023,149,2022/4/15 11:30:00,44,98,-54
16024,16024,149,2022/4/15 11:40:00,41,101,-60
16025,16025,149,2022/4/15 11:50:00,47,92,-45
16026,16026,149,2022/4/15 12:00:00,48,100,-52
16027,16027,149,2022/4/15 12:10:00,49,99,-50
16028,16028,149,2022/4/15 12:20:00,47,105,-58
16029,16029,149,2022/4/15 12:30:00,48,112,-64
16030,16030,149,2022/4/15 12:40:00,54,101,-47
16031,16031,149,2022/4/15 12:50:00,47,106,-59
16032,16032,149,2022/4/15 13:00:00,45,110,-65
16033,16033,149,2022/4/15 13:10:00,52,108,-56
16034,16034,149,2022/4/15 13:20:00,49,105,-56
16035,16035,149,2022/4/15 13:30:00,51,104,-53
16036,16036,149,2022/4/15 13:40:00,56,88,-32
16037,16037,149,2022/4/15 13:50:00,51,99,-48
16038,16038,149,2022/4/15 14:00:00,55,110,-55
16039,16039,149,2022/4/15 14:10:00,47,101,-54
16040,16040,149,2022/4/15 14:20:00,57,106,-49
16041,16041,149,2022/4/15 14:30:00,56,104,-48
16042,16042,149,2022/4/15 14:40:00,54,112,-58
16043,16043,149,2022/4/15 14:50:00,54,112,-58
16044,16044,149,2022/4/15 15:00:00,59,96,-37
16045,16045,149,2022/4/15 15:10:00,70,111,-41
16046,16046,149,2022/4/15 15:20:00,62,99,-37
16047,16047,149,2022/4/15 15:30:00,75,110,-35
16048,16048,149,2022/4/15 15:40:00,73,105,-32
16049,16049,149,2022/4/15 15:50:00,68,97,-29
16050,16050,149,2022/4/15 16:00:00,76,102,-26
16051,16051,149,2022/4/15 16:10:00,77,112,-35
16052,16052,149,2022/4/15 16:20:00,74,103,-29
16053,16053,149,2022/4/15 16:30:00,91,112,-21
16054,16054,149,2022/4/15 16:40:00,179,108,71
16055,16055,149,2022/4/15 16:50:00,197,105,92
16056,16056,149,2022/4/15 17:00:00,269,109,160
16057,16057,149,2022/4/15 17:10:00,330,102,228
16058,16058,149,2022/4/15 17:20:00,269,123,146
16059,16059,149,2022/4/15 17:30:00,232,120,112
16060,16060,149,2022/4/15 17:40:00,270,108,162
16061,16061,149,2022/4/15 17:50:00,272,118,154
16062,16062,149,2022/4/15 18:00:00,235,151,84
16063,16063,149,2022/4/15 18:10:00,243,182,61
16064,16064,149,2022/4/15 18:20:00,215,116,99
16065,16065,149,2022/4/15 18:30:00,143,119,24
16066,16066,149,2022/4/15 18:40:00,97,128,-31
16067,16067,149,2022/4/15 18:50:00,77,125,-48
16068,16068,149,2022/4/15 19:00:00,49,100,-51
16069,16069,149,2022/4/15 19:10:00,55,107,-52
16070,16070,149,2022/4/15 19:20:00,41,100,-59
16071,16071,149,2022/4/15 19:30:00,43,101,-58
16072,16072,149,2022/4/15 19:40:00,38,91,-53
16073,16073,149,2022/4/15 19:50:00,38,89,-51
16074,16074,149,2022/4/15 20:00:00,35,78,-43
16075,16075,149,2022/4/15 20:10:00,36,74,-38
16076,16076,149,2022/4/15 20:20:00,33,72,-39
16077,16077,149,2022/4/15 20:30:00,28,78,-50
16078,16078,149,2022/4/15 20:40:00,27,87,-60
16079,16079,149,2022/4/15 20:50:00,25,77,-52
16080,16080,149,2022/4/15 21:00:00,26,76,-50
16081,16081,149,2022/4/15 21:10:00,28,79,-51
16082,16082,149,2022/4/15 21:20:00,27,79,-52
16083,16083,149,2022/4/15 21:30:00,26,79,-53
16084,16084,149,2022/4/15 21:40:00,27,75,-48
16085,16085,149,2022/4/15 21:50:00,22,75,-53
16086,16086,149,2022/4/15 22:00:00,22,70,-48
16087,16087,149,2022/4/15 22:10:00,16,73,-57
16088,16088,149,2022/4/15 22:20:00,15,53,-38
16089,16089,149,2022/4/15 22:30:00,11,71,-60
16090,16090,149,2022/4/15 22:40:00,10,62,-52
16091,16091,149,2022/4/15 22:50:00,6,40,-34
16092,16092,150,2022/4/15 5:00:00,0,1,-1
16093,16093,150,2022/4/15 5:10:00,7,1,6
16094,16094,150,2022/4/15 5:20:00,12,1,11
16095,16095,150,2022/4/15 5:30:00,7,1,6
16096,16096,150,2022/4/15 5:40:00,13,1,12
16097,16097,150,2022/4/15 5:50:00,22,1,21
16098,16098,150,2022/4/15 6:00:00,27,1,26
16099,16099,150,2022/4/15 6:10:00,41,1,40
16100,16100,150,2022/4/15 6:20:00,43,21,22
16101,16101,150,2022/4/15 6:30:00,37,21,16
16102,16102,150,2022/4/15 6:40:00,58,6,52
16103,16103,150,2022/4/15 6:50:00,79,38,41
16104,16104,150,2022/4/15 7:00:00,83,47,36
16105,16105,150,2022/4/15 7:10:00,147,23,124
16106,16106,150,2022/4/15 7:20:00,193,68,125
16107,16107,150,2022/4/15 7:30:00,145,58,87
16108,16108,150,2022/4/15 7:40:00,108,69,39
16109,16109,150,2022/4/15 7:50:00,155,93,62
16110,16110,150,2022/4/15 8:00:00,80,94,-14
16111,16111,150,2022/4/15 8:10:00,72,72,0
16112,16112,150,2022/4/15 8:20:00,68,105,-37
16113,16113,150,2022/4/15 8:30:00,44,55,-11
16114,16114,150,2022/4/15 8:40:00,35,75,-40
16115,16115,150,2022/4/15 8:50:00,45,76,-31
16116,16116,150,2022/4/15 9:00:00,20,16,4
16117,16117,150,2022/4/15 9:10:00,25,66,-41
16118,16118,150,2022/4/15 9:20:00,21,62,-41
16119,16119,150,2022/4/15 9:30:00,23,35,-12
16120,16120,150,2022/4/15 9:40:00,24,60,-36
16121,16121,150,2022/4/15 9:50:00,21,61,-40
16122,16122,150,2022/4/15 10:00:00,24,40,-16
16123,16123,150,2022/4/15 10:10:00,19,51,-32
16124,16124,150,2022/4/15 10:20:00,22,38,-16
16125,16125,150,2022/4/15 10:30:00,23,62,-39
16126,16126,150,2022/4/15 10:40:00,20,57,-37
16127,16127,150,2022/4/15 10:50:00,25,47,-22
16128,16128,150,2022/4/15 11:00:00,23,10,13
16129,16129,150,2022/4/15 11:10:00,23,57,-34
16130,16130,150,2022/4/15 11:20:00,24,50,-26
16131,16131,150,2022/4/15 11:30:00,25,18,7
16132,16132,150,2022/4/15 11:40:00,23,60,-37
16133,16133,150,2022/4/15 11:50:00,26,48,-22
16134,16134,150,2022/4/15 12:00:00,21,47,-26
16135,16135,150,2022/4/15 12:10:00,25,18,7
16136,16136,150,2022/4/15 12:20:00,22,58,-36
16137,16137,150,2022/4/15 12:30:00,21,62,-41
16138,16138,150,2022/4/15 12:40:00,18,12,6
16139,16139,150,2022/4/15 12:50:00,24,65,-41
16140,16140,150,2022/4/15 13:00:00,24,71,-47
16141,16141,150,2022/4/15 13:10:00,22,51,-29
16142,16142,150,2022/4/15 13:20:00,17,37,-20
16143,16143,150,2022/4/15 13:30:00,16,64,-48
16144,16144,150,2022/4/15 13:40:00,22,64,-42
16145,16145,150,2022/4/15 13:50:00,24,14,10
16146,16146,150,2022/4/15 14:00:00,23,57,-34
16147,16147,150,2022/4/15 14:10:00,22,63,-41
16148,16148,150,2022/4/15 14:20:00,21,59,-38
16149,16149,150,2022/4/15 14:30:00,23,19,4
16150,16150,150,2022/4/15 14:40:00,18,68,-50
16151,16151,150,2022/4/15 14:50:00,26,60,-34
16152,16152,150,2022/4/15 15:00:00,24,8,16
16153,16153,150,2022/4/15 15:10:00,26,70,-44
16154,16154,150,2022/4/15 15:20:00,25,69,-44
16155,16155,150,2022/4/15 15:30:00,28,61,-33
16156,16156,150,2022/4/15 15:40:00,26,33,-7
16157,16157,150,2022/4/15 15:50:00,31,68,-37
16158,16158,150,2022/4/15 16:00:00,24,64,-40
16159,16159,150,2022/4/15 16:10:00,30,11,19
16160,16160,150,2022/4/15 16:20:00,33,72,-39
16161,16161,150,2022/4/15 16:30:00,39,63,-24
16162,16162,150,2022/4/15 16:40:00,35,70,-35
16163,16163,150,2022/4/15 16:50:00,38,22,16
16164,16164,150,2022/4/15 17:00:00,39,64,-25
16165,16165,150,2022/4/15 17:10:00,43,91,-48
16166,16166,150,2022/4/15 17:20:00,28,63,-35
16167,16167,150,2022/4/15 17:30:00,26,58,-32
16168,16168,150,2022/4/15 17:40:00,23,105,-82
16169,16169,150,2022/4/15 17:50:00,25,42,-17
16170,16170,150,2022/4/15 18:00:00,22,97,-75
16171,16171,150,2022/4/15 18:10:00,22,127,-105
16172,16172,150,2022/4/15 18:20:00,20,27,-7
16173,16173,150,2022/4/15 18:30:00,18,105,-87
16174,16174,150,2022/4/15 18:40:00,16,106,-90
16175,16175,150,2022/4/15 18:50:00,13,36,-23
16176,16176,150,2022/4/15 19:00:00,12,110,-98
16177,16177,150,2022/4/15 19:10:00,13,105,-92
16178,16178,150,2022/4/15 19:20:00,8,39,-31
16179,16179,150,2022/4/15 19:30:00,10,95,-85
16180,16180,150,2022/4/15 19:40:00,10,77,-67
16181,16181,150,2022/4/15 19:50:00,11,60,-49
16182,16182,150,2022/4/15 20:00:00,8,78,-70
16183,16183,150,2022/4/15 20:10:00,12,50,-38
16184,16184,150,2022/4/15 20:20:00,8,33,-25
16185,16185,150,2022/4/15 20:30:00,9,67,-58
16186,16186,150,2022/4/15 20:40:00,8,64,-56
16187,16187,150,2022/4/15 20:50:00,9,8,1
16188,16188,150,2022/4/15 21:00:00,8,69,-61
16189,16189,150,2022/4/15 21:10:00,7,61,-54
16190,16190,150,2022/4/15 21:20:00,6,8,-2
16191,16191,150,2022/4/15 21:30:00,5,62,-57
16192,16192,150,2022/4/15 21:40:00,2,59,-57
16193,16193,150,2022/4/15 21:50:00,4,10,-6
16194,16194,150,2022/4/15 22:00:00,4,63,-59
16195,16195,150,2022/4/15 22:10:00,3,53,-50
16196,16196,150,2022/4/15 22:20:00,2,8,-6
16197,16197,150,2022/4/15 22:30:00,2,49,-47
16198,16198,150,2022/4/15 22:40:00,0,40,-40
16199,16199,150,2022/4/15 22:50:00,0,36,-36
16200,16200,151,2022/4/15 5:00:00,0,1,-1
16201,16201,151,2022/4/15 5:10:00,1,1,0
16202,16202,151,2022/4/15 5:20:00,13,1,12
16203,16203,151,2022/4/15 5:30:00,25,1,24
16204,16204,151,2022/4/15 5:40:00,20,16,4
16205,16205,151,2022/4/15 5:50:00,40,12,28
16206,16206,151,2022/4/15 6:00:00,53,11,42
16207,16207,151,2022/4/15 6:10:00,58,60,-2
16208,16208,151,2022/4/15 6:20:00,93,48,45
16209,16209,151,2022/4/15 6:30:00,162,72,90
16210,16210,151,2022/4/15 6:40:00,225,109,116
16211,16211,151,2022/4/15 6:50:00,266,108,158
16212,16212,151,2022/4/15 7:00:00,318,106,212
16213,16213,151,2022/4/15 7:10:00,365,107,258
16214,16214,151,2022/4/15 7:20:00,393,144,249
16215,16215,151,2022/4/15 7:30:00,597,192,405
16216,16216,151,2022/4/15 7:40:00,693,284,409
16217,16217,151,2022/4/15 7:50:00,827,331,496
16218,16218,151,2022/4/15 8:00:00,1041,413,628
16219,16219,151,2022/4/15 8:10:00,1213,572,641
16220,16220,151,2022/4/15 8:20:00,1049,1102,-53
16221,16221,151,2022/4/15 8:30:00,862,1115,-253
16222,16222,151,2022/4/15 8:40:00,666,1543,-877
16223,16223,151,2022/4/15 8:50:00,588,558,30
16224,16224,151,2022/4/15 9:00:00,359,501,-142
16225,16225,151,2022/4/15 9:10:00,339,532,-193
16226,16226,151,2022/4/15 9:20:00,269,330,-61
16227,16227,151,2022/4/15 9:30:00,230,195,35
16228,16228,151,2022/4/15 9:40:00,212,254,-42
16229,16229,151,2022/4/15 9:50:00,170,190,-20
16230,16230,151,2022/4/15 10:00:00,162,144,18
16231,16231,151,2022/4/15 10:10:00,114,111,3
16232,16232,151,2022/4/15 10:20:00,101,110,-9
16233,16233,151,2022/4/15 10:30:00,77,127,-50
16234,16234,151,2022/4/15 10:40:00,76,123,-47
16235,16235,151,2022/4/15 10:50:00,80,123,-43
16236,16236,151,2022/4/15 11:00:00,73,104,-31
16237,16237,151,2022/4/15 11:10:00,72,119,-47
16238,16238,151,2022/4/15 11:20:00,74,125,-51
16239,16239,151,2022/4/15 11:30:00,76,116,-40
16240,16240,151,2022/4/15 11:40:00,80,108,-28
16241,16241,151,2022/4/15 11:50:00,76,123,-47
16242,16242,151,2022/4/15 12:00:00,90,120,-30
16243,16243,151,2022/4/15 12:10:00,113,117,-4
16244,16244,151,2022/4/15 12:20:00,129,115,14
16245,16245,151,2022/4/15 12:30:00,110,122,-12
16246,16246,151,2022/4/15 12:40:00,104,110,-6
16247,16247,151,2022/4/15 12:50:00,92,124,-32
16248,16248,151,2022/4/15 13:00:00,112,125,-13
16249,16249,151,2022/4/15 13:10:00,140,120,20
16250,16250,151,2022/4/15 13:20:00,128,111,17
16251,16251,151,2022/4/15 13:30:00,96,123,-27
16252,16252,151,2022/4/15 13:40:00,93,104,-11
16253,16253,151,2022/4/15 13:50:00,84,105,-21
16254,16254,151,2022/4/15 14:00:00,113,123,-10
16255,16255,151,2022/4/15 14:10:00,102,121,-19
16256,16256,151,2022/4/15 14:20:00,82,111,-29
16257,16257,151,2022/4/15 14:30:00,77,109,-32
16258,16258,151,2022/4/15 14:40:00,92,122,-30
16259,16259,151,2022/4/15 14:50:00,82,110,-28
16260,16260,151,2022/4/15 15:00:00,130,104,26
16261,16261,151,2022/4/15 15:10:00,118,118,0
16262,16262,151,2022/4/15 15:20:00,126,108,18
16263,16263,151,2022/4/15 15:30:00,138,125,13
16264,16264,151,2022/4/15 15:40:00,137,133,4
16265,16265,151,2022/4/15 15:50:00,174,117,57
16266,16266,151,2022/4/15 16:00:00,176,128,48
16267,16267,151,2022/4/15 16:10:00,199,125,74
16268,16268,151,2022/4/15 16:20:00,201,119,82
16269,16269,151,2022/4/15 16:30:00,229,153,76
16270,16270,151,2022/4/15 16:40:00,262,181,81
16271,16271,151,2022/4/15 16:50:00,330,159,171
16272,16272,151,2022/4/15 17:00:00,576,176,400
16273,16273,151,2022/4/15 17:10:00,697,214,483
16274,16274,151,2022/4/15 17:20:00,569,322,247
16275,16275,151,2022/4/15 17:30:00,614,377,237
16276,16276,151,2022/4/15 17:40:00,658,431,227
16277,16277,151,2022/4/15 17:50:00,618,500,118
16278,16278,151,2022/4/15 18:00:00,608,501,107
16279,16279,151,2022/4/15 18:10:00,671,431,240
16280,16280,151,2022/4/15 18:20:00,579,503,76
16281,16281,151,2022/4/15 18:30:00,338,502,-164
16282,16282,151,2022/4/15 18:40:00,294,502,-208
16283,16283,151,2022/4/15 18:50:00,274,434,-160
16284,16284,151,2022/4/15 19:00:00,237,336,-99
16285,16285,151,2022/4/15 19:10:00,195,209,-14
16286,16286,151,2022/4/15 19:20:00,180,191,-11
16287,16287,151,2022/4/15 19:30:00,138,137,1
16288,16288,151,2022/4/15 19:40:00,114,107,7
16289,16289,151,2022/4/15 19:50:00,78,111,-33
16290,16290,151,2022/4/15 20:00:00,74,122,-48
16291,16291,151,2022/4/15 20:10:00,79,124,-45
16292,16292,151,2022/4/15 20:20:00,74,119,-45
16293,16293,151,2022/4/15 20:30:00,72,107,-35
16294,16294,151,2022/4/15 20:40:00,64,123,-59
16295,16295,151,2022/4/15 20:50:00,74,110,-36
16296,16296,151,2022/4/15 21:00:00,85,129,-44
16297,16297,151,2022/4/15 21:10:00,115,122,-7
16298,16298,151,2022/4/15 21:20:00,71,123,-52
16299,16299,151,2022/4/15 21:30:00,74,123,-49
16300,16300,151,2022/4/15 21:40:00,56,101,-45
16301,16301,151,2022/4/15 21:50:00,42,103,-61
16302,16302,151,2022/4/15 22:00:00,41,109,-68
16303,16303,151,2022/4/15 22:10:00,37,110,-73
16304,16304,151,2022/4/15 22:20:00,24,105,-81
16305,16305,151,2022/4/15 22:30:00,22,99,-77
16306,16306,151,2022/4/15 22:40:00,16,77,-61
16307,16307,151,2022/4/15 22:50:00,11,76,-65
16308,16308,152,2022/4/15 5:00:00,0,1,-1
16309,16309,152,2022/4/15 5:10:00,1,1,0
16310,16310,152,2022/4/15 5:20:00,4,1,3
16311,16311,152,2022/4/15 5:30:00,2,1,1
16312,16312,152,2022/4/15 5:40:00,5,1,4
16313,16313,152,2022/4/15 5:50:00,8,1,7
16314,16314,152,2022/4/15 6:00:00,9,2,7
16315,16315,152,2022/4/15 6:10:00,21,1,20
16316,16316,152,2022/4/15 6:20:00,20,38,-18
16317,16317,152,2022/4/15 6:30:00,23,6,17
16318,16318,152,2022/4/15 6:40:00,24,67,-43
16319,16319,152,2022/4/15 6:50:00,34,69,-35
16320,16320,152,2022/4/15 7:00:00,36,69,-33
16321,16321,152,2022/4/15 7:10:00,38,76,-38
16322,16322,152,2022/4/15 7:20:00,52,71,-19
16323,16323,152,2022/4/15 7:30:00,55,93,-38
16324,16324,152,2022/4/15 7:40:00,76,90,-14
16325,16325,152,2022/4/15 7:50:00,95,120,-25
16326,16326,152,2022/4/15 8:00:00,151,119,32
16327,16327,152,2022/4/15 8:10:00,156,144,12
16328,16328,152,2022/4/15 8:20:00,149,282,-133
16329,16329,152,2022/4/15 8:30:00,103,317,-214
16330,16330,152,2022/4/15 8:40:00,80,490,-410
16331,16331,152,2022/4/15 8:50:00,65,334,-269
16332,16332,152,2022/4/15 9:00:00,49,191,-142
16333,16333,152,2022/4/15 9:10:00,48,180,-132
16334,16334,152,2022/4/15 9:20:00,35,115,-80
16335,16335,152,2022/4/15 9:30:00,35,104,-69
16336,16336,152,2022/4/15 9:40:00,29,108,-79
16337,16337,152,2022/4/15 9:50:00,34,105,-71
16338,16338,152,2022/4/15 10:00:00,26,97,-71
16339,16339,152,2022/4/15 10:10:00,27,80,-53
16340,16340,152,2022/4/15 10:20:00,27,71,-44
16341,16341,152,2022/4/15 10:30:00,27,72,-45
16342,16342,152,2022/4/15 10:40:00,24,69,-45
16343,16343,152,2022/4/15 10:50:00,28,65,-37
16344,16344,152,2022/4/15 11:00:00,28,75,-47
16345,16345,152,2022/4/15 11:10:00,29,52,-23
16346,16346,152,2022/4/15 11:20:00,28,76,-48
16347,16347,152,2022/4/15 11:30:00,27,59,-32
16348,16348,152,2022/4/15 11:40:00,30,65,-35
16349,16349,152,2022/4/15 11:50:00,30,71,-41
16350,16350,152,2022/4/15 12:00:00,28,57,-29
16351,16351,152,2022/4/15 12:10:00,31,77,-46
16352,16352,152,2022/4/15 12:20:00,32,62,-30
16353,16353,152,2022/4/15 12:30:00,25,81,-56
16354,16354,152,2022/4/15 12:40:00,35,68,-33
16355,16355,152,2022/4/15 12:50:00,29,69,-40
16356,16356,152,2022/4/15 13:00:00,26,75,-49
16357,16357,152,2022/4/15 13:10:00,29,71,-42
16358,16358,152,2022/4/15 13:20:00,35,77,-42
16359,16359,152,2022/4/15 13:30:00,32,68,-36
16360,16360,152,2022/4/15 13:40:00,25,93,-68
16361,16361,152,2022/4/15 13:50:00,26,60,-34
16362,16362,152,2022/4/15 14:00:00,26,62,-36
16363,16363,152,2022/4/15 14:10:00,25,77,-52
16364,16364,152,2022/4/15 14:20:00,24,71,-47
16365,16365,152,2022/4/15 14:30:00,28,75,-47
16366,16366,152,2022/4/15 14:40:00,31,64,-33
16367,16367,152,2022/4/15 14:50:00,28,76,-48
16368,16368,152,2022/4/15 15:00:00,29,62,-33
16369,16369,152,2022/4/15 15:10:00,35,69,-34
16370,16370,152,2022/4/15 15:20:00,27,84,-57
16371,16371,152,2022/4/15 15:30:00,29,69,-40
16372,16372,152,2022/4/15 15:40:00,37,80,-43
16373,16373,152,2022/4/15 15:50:00,33,64,-31
16374,16374,152,2022/4/15 16:00:00,37,91,-54
16375,16375,152,2022/4/15 16:10:00,47,64,-17
16376,16376,152,2022/4/15 16:20:00,38,72,-34
16377,16377,152,2022/4/15 16:30:00,44,77,-33
16378,16378,152,2022/4/15 16:40:00,45,81,-36
16379,16379,152,2022/4/15 16:50:00,44,87,-43
16380,16380,152,2022/4/15 17:00:00,64,87,-23
16381,16381,152,2022/4/15 17:10:00,215,93,122
16382,16382,152,2022/4/15 17:20:00,130,93,37
16383,16383,152,2022/4/15 17:30:00,140,108,32
16384,16384,152,2022/4/15 17:40:00,233,103,130
16385,16385,152,2022/4/15 17:50:00,198,106,92
16386,16386,152,2022/4/15 18:00:00,177,125,52
16387,16387,152,2022/4/15 18:10:00,552,100,452
16388,16388,152,2022/4/15 18:20:00,270,107,163
16389,16389,152,2022/4/15 18:30:00,213,111,102
16390,16390,152,2022/4/15 18:40:00,187,126,61
16391,16391,152,2022/4/15 18:50:00,94,122,-28
16392,16392,152,2022/4/15 19:00:00,61,105,-44
16393,16393,152,2022/4/15 19:10:00,54,112,-58
16394,16394,152,2022/4/15 19:20:00,41,92,-51
16395,16395,152,2022/4/15 19:30:00,38,92,-54
16396,16396,152,2022/4/15 19:40:00,33,71,-38
16397,16397,152,2022/4/15 19:50:00,30,69,-39
16398,16398,152,2022/4/15 20:00:00,29,74,-45
16399,16399,152,2022/4/15 20:10:00,39,62,-23
16400,16400,152,2022/4/15 20:20:00,31,63,-32
16401,16401,152,2022/4/15 20:30:00,29,72,-43
16402,16402,152,2022/4/15 20:40:00,29,46,-17
16403,16403,152,2022/4/15 20:50:00,26,67,-41
16404,16404,152,2022/4/15 21:00:00,29,65,-36
16405,16405,152,2022/4/15 21:10:00,40,52,-12
16406,16406,152,2022/4/15 21:20:00,28,75,-47
16407,16407,152,2022/4/15 21:30:00,28,55,-27
16408,16408,152,2022/4/15 21:40:00,28,55,-27
16409,16409,152,2022/4/15 21:50:00,19,62,-43
16410,16410,152,2022/4/15 22:00:00,29,49,-20
16411,16411,152,2022/4/15 22:10:00,28,52,-24
16412,16412,152,2022/4/15 22:20:00,12,47,-35
16413,16413,152,2022/4/15 22:30:00,6,38,-32
16414,16414,152,2022/4/15 22:40:00,2,41,-39
16415,16415,152,2022/4/15 22:50:00,0,38,-38
16416,16416,153,2022/4/15 5:00:00,0,1,-1
16417,16417,153,2022/4/15 5:10:00,0,1,-1
16418,16418,153,2022/4/15 5:20:00,0,1,-1
16419,16419,153,2022/4/15 5:30:00,5,1,4
16420,16420,153,2022/4/15 5:40:00,18,1,17
16421,16421,153,2022/4/15 5:50:00,24,19,5
16422,16422,153,2022/4/15 6:00:00,32,25,7
16423,16423,153,2022/4/15 6:10:00,40,23,17
16424,16424,153,2022/4/15 6:20:00,43,38,5
16425,16425,153,2022/4/15 6:30:00,61,63,-2
16426,16426,153,2022/4/15 6:40:00,154,90,64
16427,16427,153,2022/4/15 6:50:00,186,127,59
16428,16428,153,2022/4/15 7:00:00,217,106,111
16429,16429,153,2022/4/15 7:10:00,271,117,154
16430,16430,153,2022/4/15 7:20:00,328,121,207
16431,16431,153,2022/4/15 7:30:00,351,152,199
16432,16432,153,2022/4/15 7:40:00,361,192,169
16433,16433,153,2022/4/15 7:50:00,361,213,148
16434,16434,153,2022/4/15 8:00:00,277,154,123
16435,16435,153,2022/4/15 8:10:00,280,197,83
16436,16436,153,2022/4/15 8:20:00,277,197,80
16437,16437,153,2022/4/15 8:30:00,239,208,31
16438,16438,153,2022/4/15 8:40:00,237,214,23
16439,16439,153,2022/4/15 8:50:00,222,150,72
16440,16440,153,2022/4/15 9:00:00,187,129,58
16441,16441,153,2022/4/15 9:10:00,174,121,53
16442,16442,153,2022/4/15 9:20:00,100,107,-7
16443,16443,153,2022/4/15 9:30:00,75,104,-29
16444,16444,153,2022/4/15 9:40:00,68,104,-36
16445,16445,153,2022/4/15 9:50:00,57,112,-55
16446,16446,153,2022/4/15 10:00:00,46,76,-30
16447,16447,153,2022/4/15 10:10:00,44,98,-54
16448,16448,153,2022/4/15 10:20:00,43,87,-44
16449,16449,153,2022/4/15 10:30:00,43,75,-32
16450,16450,153,2022/4/15 10:40:00,41,81,-40
16451,16451,153,2022/4/15 10:50:00,38,92,-54
16452,16452,153,2022/4/15 11:00:00,40,61,-21
16453,16453,153,2022/4/15 11:10:00,42,87,-45
16454,16454,153,2022/4/15 11:20:00,44,77,-33
16455,16455,153,2022/4/15 11:30:00,56,76,-20
16456,16456,153,2022/4/15 11:40:00,53,93,-40
16457,16457,153,2022/4/15 11:50:00,47,62,-15
16458,16458,153,2022/4/15 12:00:00,54,101,-47
16459,16459,153,2022/4/15 12:10:00,52,70,-18
16460,16460,153,2022/4/15 12:20:00,53,100,-47
16461,16461,153,2022/4/15 12:30:00,52,74,-22
16462,16462,153,2022/4/15 12:40:00,47,97,-50
16463,16463,153,2022/4/15 12:50:00,56,105,-49
16464,16464,153,2022/4/15 13:00:00,47,80,-33
16465,16465,153,2022/4/15 13:10:00,43,100,-57
16466,16466,153,2022/4/15 13:20:00,40,78,-38
16467,16467,153,2022/4/15 13:30:00,46,103,-57
16468,16468,153,2022/4/15 13:40:00,42,84,-42
16469,16469,153,2022/4/15 13:50:00,42,102,-60
16470,16470,153,2022/4/15 14:00:00,41,90,-49
16471,16471,153,2022/4/15 14:10:00,41,75,-34
16472,16472,153,2022/4/15 14:20:00,45,102,-57
16473,16473,153,2022/4/15 14:30:00,40,94,-54
16474,16474,153,2022/4/15 14:40:00,42,104,-62
16475,16475,153,2022/4/15 14:50:00,52,90,-38
16476,16476,153,2022/4/15 15:00:00,53,108,-55
16477,16477,153,2022/4/15 15:10:00,65,104,-39
16478,16478,153,2022/4/15 15:20:00,64,92,-28
16479,16479,153,2022/4/15 15:30:00,60,123,-63
16480,16480,153,2022/4/15 15:40:00,59,108,-49
16481,16481,153,2022/4/15 15:50:00,61,110,-49
16482,16482,153,2022/4/15 16:00:00,157,98,59
16483,16483,153,2022/4/15 16:10:00,273,106,167
16484,16484,153,2022/4/15 16:20:00,180,108,72
16485,16485,153,2022/4/15 16:30:00,183,122,61
16486,16486,153,2022/4/15 16:40:00,196,98,98
16487,16487,153,2022/4/15 16:50:00,213,123,90
16488,16488,153,2022/4/15 17:00:00,264,138,126
16489,16489,153,2022/4/15 17:10:00,315,118,197
16490,16490,153,2022/4/15 17:20:00,272,153,119
16491,16491,153,2022/4/15 17:30:00,213,212,1
16492,16492,153,2022/4/15 17:40:00,270,283,-13
16493,16493,153,2022/4/15 17:50:00,244,196,48
16494,16494,153,2022/4/15 18:00:00,205,283,-78
16495,16495,153,2022/4/15 18:10:00,174,300,-126
16496,16496,153,2022/4/15 18:20:00,154,294,-140
16497,16497,153,2022/4/15 18:30:00,89,213,-124
16498,16498,153,2022/4/15 18:40:00,71,285,-214
16499,16499,153,2022/4/15 18:50:00,69,279,-210
16500,16500,153,2022/4/15 19:00:00,53,214,-161
16501,16501,153,2022/4/15 19:10:00,52,191,-139
16502,16502,153,2022/4/15 19:20:00,45,111,-66
16503,16503,153,2022/4/15 19:30:00,42,105,-63
16504,16504,153,2022/4/15 19:40:00,39,104,-65
16505,16505,153,2022/4/15 19:50:00,39,124,-85
16506,16506,153,2022/4/15 20:00:00,35,108,-73
16507,16507,153,2022/4/15 20:10:00,33,103,-70
16508,16508,153,2022/4/15 20:20:00,38,124,-86
16509,16509,153,2022/4/15 20:30:00,48,98,-50
16510,16510,153,2022/4/15 20:40:00,57,85,-28
16511,16511,153,2022/4/15 20:50:00,46,106,-60
16512,16512,153,2022/4/15 21:00:00,35,106,-71
16513,16513,153,2022/4/15 21:10:00,35,104,-69
16514,16514,153,2022/4/15 21:20:00,34,114,-80
16515,16515,153,2022/4/15 21:30:00,29,100,-71
16516,16516,153,2022/4/15 21:40:00,29,100,-71
16517,16517,153,2022/4/15 21:50:00,24,108,-84
16518,16518,153,2022/4/15 22:00:00,27,98,-71
16519,16519,153,2022/4/15 22:10:00,24,85,-61
16520,16520,153,2022/4/15 22:20:00,21,97,-76
16521,16521,153,2022/4/15 22:30:00,14,85,-71
16522,16522,153,2022/4/15 22:40:00,12,82,-70
16523,16523,153,2022/4/15 22:50:00,8,99,-91
16524,16524,154,2022/4/15 5:00:00,0,1,-1
16525,16525,154,2022/4/15 5:10:00,0,1,-1
16526,16526,154,2022/4/15 5:20:00,0,1,-1
16527,16527,154,2022/4/15 5:30:00,14,1,13
16528,16528,154,2022/4/15 5:40:00,30,1,29
16529,16529,154,2022/4/15 5:50:00,31,8,23
16530,16530,154,2022/4/15 6:00:00,33,38,-5
16531,16531,154,2022/4/15 6:10:00,54,23,31
16532,16532,154,2022/4/15 6:20:00,77,33,44
16533,16533,154,2022/4/15 6:30:00,150,60,90
16534,16534,154,2022/4/15 6:40:00,244,97,147
16535,16535,154,2022/4/15 6:50:00,299,100,199
16536,16536,154,2022/4/15 7:00:00,367,110,257
16537,16537,154,2022/4/15 7:10:00,633,122,511
16538,16538,154,2022/4/15 7:20:00,688,111,577
16539,16539,154,2022/4/15 7:30:00,689,184,505
16540,16540,154,2022/4/15 7:40:00,733,179,554
16541,16541,154,2022/4/15 7:50:00,699,292,407
16542,16542,154,2022/4/15 8:00:00,702,320,382
16543,16543,154,2022/4/15 8:10:00,687,338,349
16544,16544,154,2022/4/15 8:20:00,631,474,157
16545,16545,154,2022/4/15 8:30:00,475,497,-22
16546,16546,154,2022/4/15 8:40:00,393,563,-170
16547,16547,154,2022/4/15 8:50:00,327,476,-149
16548,16548,154,2022/4/15 9:00:00,271,425,-154
16549,16549,154,2022/4/15 9:10:00,231,297,-66
16550,16550,154,2022/4/15 9:20:00,177,268,-91
16551,16551,154,2022/4/15 9:30:00,149,169,-20
16552,16552,154,2022/4/15 9:40:00,100,117,-17
16553,16553,154,2022/4/15 9:50:00,78,99,-21
16554,16554,154,2022/4/15 10:00:00,76,111,-35
16555,16555,154,2022/4/15 10:10:00,56,121,-65
16556,16556,154,2022/4/15 10:20:00,59,112,-53
16557,16557,154,2022/4/15 10:30:00,43,105,-62
16558,16558,154,2022/4/15 10:40:00,45,73,-28
16559,16559,154,2022/4/15 10:50:00,48,105,-57
16560,16560,154,2022/4/15 11:00:00,50,93,-43
16561,16561,154,2022/4/15 11:10:00,45,93,-48
16562,16562,154,2022/4/15 11:20:00,58,91,-33
16563,16563,154,2022/4/15 11:30:00,55,71,-16
16564,16564,154,2022/4/15 11:40:00,55,106,-51
16565,16565,154,2022/4/15 11:50:00,58,80,-22
16566,16566,154,2022/4/15 12:00:00,70,98,-28
16567,16567,154,2022/4/15 12:10:00,76,97,-21
16568,16568,154,2022/4/15 12:20:00,67,87,-20
16569,16569,154,2022/4/15 12:30:00,67,107,-40
16570,16570,154,2022/4/15 12:40:00,63,114,-51
16571,16571,154,2022/4/15 12:50:00,58,123,-65
16572,16572,154,2022/4/15 13:00:00,54,111,-57
16573,16573,154,2022/4/15 13:10:00,65,106,-41
16574,16574,154,2022/4/15 13:20:00,54,102,-48
16575,16575,154,2022/4/15 13:30:00,53,96,-43
16576,16576,154,2022/4/15 13:40:00,46,114,-68
16577,16577,154,2022/4/15 13:50:00,45,93,-48
16578,16578,154,2022/4/15 14:00:00,49,124,-75
16579,16579,154,2022/4/15 14:10:00,54,98,-44
16580,16580,154,2022/4/15 14:20:00,47,103,-56
16581,16581,154,2022/4/15 14:30:00,51,103,-52
16582,16582,154,2022/4/15 14:40:00,65,91,-26
16583,16583,154,2022/4/15 14:50:00,69,121,-52
16584,16584,154,2022/4/15 15:00:00,128,94,34
16585,16585,154,2022/4/15 15:10:00,113,117,-4
16586,16586,154,2022/4/15 15:20:00,69,102,-33
16587,16587,154,2022/4/15 15:30:00,72,108,-36
16588,16588,154,2022/4/15 15:40:00,73,114,-41
16589,16589,154,2022/4/15 15:50:00,72,108,-36
16590,16590,154,2022/4/15 16:00:00,82,108,-26
16591,16591,154,2022/4/15 16:10:00,111,114,-3
16592,16592,154,2022/4/15 16:20:00,113,102,11
16593,16593,154,2022/4/15 16:30:00,175,123,52
16594,16594,154,2022/4/15 16:40:00,206,126,80
16595,16595,154,2022/4/15 16:50:00,212,125,87
16596,16596,154,2022/4/15 17:00:00,271,189,82
16597,16597,154,2022/4/15 17:10:00,429,105,324
16598,16598,154,2022/4/15 17:20:00,342,295,47
16599,16599,154,2022/4/15 17:30:00,456,266,190
16600,16600,154,2022/4/15 17:40:00,569,323,246
16601,16601,154,2022/4/15 17:50:00,334,364,-30
16602,16602,154,2022/4/15 18:00:00,268,320,-52
16603,16603,154,2022/4/15 18:10:00,350,370,-20
16604,16604,154,2022/4/15 18:20:00,264,315,-51
16605,16605,154,2022/4/15 18:30:00,222,319,-97
16606,16606,154,2022/4/15 18:40:00,216,316,-100
16607,16607,154,2022/4/15 18:50:00,158,341,-183
16608,16608,154,2022/4/15 19:00:00,79,342,-263
16609,16609,154,2022/4/15 19:10:00,73,257,-184
16610,16610,154,2022/4/15 19:20:00,57,227,-170
16611,16611,154,2022/4/15 19:30:00,42,149,-107
16612,16612,154,2022/4/15 19:40:00,45,126,-81
16613,16613,154,2022/4/15 19:50:00,40,120,-80
16614,16614,154,2022/4/15 20:00:00,41,123,-82
16615,16615,154,2022/4/15 20:10:00,45,106,-61
16616,16616,154,2022/4/15 20:20:00,35,110,-75
16617,16617,154,2022/4/15 20:30:00,41,106,-65
16618,16618,154,2022/4/15 20:40:00,44,106,-62
16619,16619,154,2022/4/15 20:50:00,38,111,-73
16620,16620,154,2022/4/15 21:00:00,37,112,-75
16621,16621,154,2022/4/15 21:10:00,35,92,-57
16622,16622,154,2022/4/15 21:20:00,36,110,-74
16623,16623,154,2022/4/15 21:30:00,38,101,-63
16624,16624,154,2022/4/15 21:40:00,31,97,-66
16625,16625,154,2022/4/15 21:50:00,28,111,-83
16626,16626,154,2022/4/15 22:00:00,35,107,-72
16627,16627,154,2022/4/15 22:10:00,26,78,-52
16628,16628,154,2022/4/15 22:20:00,24,95,-71
16629,16629,154,2022/4/15 22:30:00,15,92,-77
16630,16630,154,2022/4/15 22:40:00,12,83,-71
16631,16631,154,2022/4/15 22:50:00,10,105,-95
16632,16632,155,2022/4/15 5:00:00,0,1,-1
16633,16633,155,2022/4/15 5:10:00,0,1,-1
16634,16634,155,2022/4/15 5:20:00,0,1,-1
16635,16635,155,2022/4/15 5:30:00,1,1,0
16636,16636,155,2022/4/15 5:40:00,9,1,8
16637,16637,155,2022/4/15 5:50:00,28,8,20
16638,16638,155,2022/4/15 6:00:00,27,15,12
16639,16639,155,2022/4/15 6:10:00,27,21,6
16640,16640,155,2022/4/15 6:20:00,36,39,-3
16641,16641,155,2022/4/15 6:30:00,53,49,4
16642,16642,155,2022/4/15 6:40:00,57,86,-29
16643,16643,155,2022/4/15 6:50:00,79,89,-10
16644,16644,155,2022/4/15 7:00:00,101,108,-7
16645,16645,155,2022/4/15 7:10:00,92,123,-31
16646,16646,155,2022/4/15 7:20:00,169,129,40
16647,16647,155,2022/4/15 7:30:00,180,133,47
16648,16648,155,2022/4/15 7:40:00,191,169,22
16649,16649,155,2022/4/15 7:50:00,215,144,71
16650,16650,155,2022/4/15 8:00:00,238,179,59
16651,16651,155,2022/4/15 8:10:00,246,253,-7
16652,16652,155,2022/4/15 8:20:00,224,324,-100
16653,16653,155,2022/4/15 8:30:00,191,382,-191
16654,16654,155,2022/4/15 8:40:00,185,428,-243
16655,16655,155,2022/4/15 8:50:00,151,422,-271
16656,16656,155,2022/4/15 9:00:00,89,314,-225
16657,16657,155,2022/4/15 9:10:00,77,297,-220
16658,16658,155,2022/4/15 9:20:00,58,232,-174
16659,16659,155,2022/4/15 9:30:00,47,133,-86
16660,16660,155,2022/4/15 9:40:00,40,97,-57
16661,16661,155,2022/4/15 9:50:00,38,108,-70
16662,16662,155,2022/4/15 10:00:00,37,104,-67
16663,16663,155,2022/4/15 10:10:00,36,108,-72
16664,16664,155,2022/4/15 10:20:00,36,77,-41
16665,16665,155,2022/4/15 10:30:00,35,92,-57
16666,16666,155,2022/4/15 10:40:00,28,91,-63
16667,16667,155,2022/4/15 10:50:00,36,92,-56
16668,16668,155,2022/4/15 11:00:00,29,68,-39
16669,16669,155,2022/4/15 11:10:00,36,93,-57
16670,16670,155,2022/4/15 11:20:00,35,93,-58
16671,16671,155,2022/4/15 11:30:00,29,84,-55
16672,16672,155,2022/4/15 11:40:00,35,79,-44
16673,16673,155,2022/4/15 11:50:00,37,79,-42
16674,16674,155,2022/4/15 12:00:00,31,73,-42
16675,16675,155,2022/4/15 12:10:00,35,90,-55
16676,16676,155,2022/4/15 12:20:00,38,69,-31
16677,16677,155,2022/4/15 12:30:00,39,101,-62
16678,16678,155,2022/4/15 12:40:00,38,83,-45
16679,16679,155,2022/4/15 12:50:00,40,91,-51
16680,16680,155,2022/4/15 13:00:00,40,91,-51
16681,16681,155,2022/4/15 13:10:00,43,97,-54
16682,16682,155,2022/4/15 13:20:00,38,98,-60
16683,16683,155,2022/4/15 13:30:00,38,83,-45
16684,16684,155,2022/4/15 13:40:00,37,110,-73
16685,16685,155,2022/4/15 13:50:00,38,74,-36
16686,16686,155,2022/4/15 14:00:00,35,83,-48
16687,16687,155,2022/4/15 14:10:00,41,90,-49
16688,16688,155,2022/4/15 14:20:00,45,76,-31
16689,16689,155,2022/4/15 14:30:00,43,97,-54
16690,16690,155,2022/4/15 14:40:00,34,76,-42
16691,16691,155,2022/4/15 14:50:00,43,109,-66
16692,16692,155,2022/4/15 15:00:00,43,76,-33
16693,16693,155,2022/4/15 15:10:00,54,91,-37
16694,16694,155,2022/4/15 15:20:00,52,87,-35
16695,16695,155,2022/4/15 15:30:00,47,91,-44
16696,16696,155,2022/4/15 15:40:00,47,97,-50
16697,16697,155,2022/4/15 15:50:00,57,81,-24
16698,16698,155,2022/4/15 16:00:00,59,105,-46
16699,16699,155,2022/4/15 16:10:00,94,90,4
16700,16700,155,2022/4/15 16:20:00,133,89,44
16701,16701,155,2022/4/15 16:30:00,136,103,33
16702,16702,155,2022/4/15 16:40:00,194,92,102
16703,16703,155,2022/4/15 16:50:00,141,102,39
16704,16704,155,2022/4/15 17:00:00,338,97,241
16705,16705,155,2022/4/15 17:10:00,286,123,163
16706,16706,155,2022/4/15 17:20:00,234,113,121
16707,16707,155,2022/4/15 17:30:00,336,110,226
16708,16708,155,2022/4/15 17:40:00,576,118,458
16709,16709,155,2022/4/15 17:50:00,291,115,176
16710,16710,155,2022/4/15 18:00:00,267,111,156
16711,16711,155,2022/4/15 18:10:00,378,116,262
16712,16712,155,2022/4/15 18:20:00,257,150,107
16713,16713,155,2022/4/15 18:30:00,177,133,44
16714,16714,155,2022/4/15 18:40:00,138,104,34
16715,16715,155,2022/4/15 18:50:00,101,137,-36
16716,16716,155,2022/4/15 19:00:00,72,121,-49
16717,16717,155,2022/4/15 19:10:00,67,107,-40
16718,16718,155,2022/4/15 19:20:00,57,104,-47
16719,16719,155,2022/4/15 19:30:00,46,111,-65
16720,16720,155,2022/4/15 19:40:00,48,85,-37
16721,16721,155,2022/4/15 19:50:00,42,83,-41
16722,16722,155,2022/4/15 20:00:00,45,75,-30
16723,16723,155,2022/4/15 20:10:00,47,71,-24
16724,16724,155,2022/4/15 20:20:00,44,71,-27
16725,16725,155,2022/4/15 20:30:00,49,82,-33
16726,16726,155,2022/4/15 20:40:00,45,74,-29
16727,16727,155,2022/4/15 20:50:00,44,78,-34
16728,16728,155,2022/4/15 21:00:00,48,72,-24
16729,16729,155,2022/4/15 21:10:00,46,62,-16
16730,16730,155,2022/4/15 21:20:00,43,71,-28
16731,16731,155,2022/4/15 21:30:00,37,85,-48
16732,16732,155,2022/4/15 21:40:00,35,72,-37
16733,16733,155,2022/4/15 21:50:00,38,72,-34
16734,16734,155,2022/4/15 22:00:00,41,71,-30
16735,16735,155,2022/4/15 22:10:00,38,69,-31
16736,16736,155,2022/4/15 22:20:00,22,63,-41
16737,16737,155,2022/4/15 22:30:00,22,67,-45
16738,16738,155,2022/4/15 22:40:00,15,62,-47
16739,16739,155,2022/4/15 22:50:00,8,33,-25
16740,16740,156,2022/4/15 5:00:00,0,1,-1
16741,16741,156,2022/4/15 5:10:00,0,1,-1
16742,16742,156,2022/4/15 5:20:00,0,1,-1
16743,16743,156,2022/4/15 5:30:00,4,1,3
16744,16744,156,2022/4/15 5:40:00,12,1,11
16745,16745,156,2022/4/15 5:50:00,19,14,5
16746,16746,156,2022/4/15 6:00:00,17,21,-4
16747,16747,156,2022/4/15 6:10:00,19,27,-8
16748,16748,156,2022/4/15 6:20:00,27,49,-22
16749,16749,156,2022/4/15 6:30:00,32,63,-31
16750,16750,156,2022/4/15 6:40:00,35,66,-31
16751,16751,156,2022/4/15 6:50:00,47,67,-20
16752,16752,156,2022/4/15 7:00:00,58,76,-18
16753,16753,156,2022/4/15 7:10:00,62,106,-44
16754,16754,156,2022/4/15 7:20:00,65,101,-36
16755,16755,156,2022/4/15 7:30:00,87,110,-23
16756,16756,156,2022/4/15 7:40:00,153,114,39
16757,16757,156,2022/4/15 7:50:00,181,120,61
16758,16758,156,2022/4/15 8:00:00,186,168,18
16759,16759,156,2022/4/15 8:10:00,183,206,-23
16760,16760,156,2022/4/15 8:20:00,155,295,-140
16761,16761,156,2022/4/15 8:30:00,111,317,-206
16762,16762,156,2022/4/15 8:40:00,88,494,-406
16763,16763,156,2022/4/15 8:50:00,68,324,-256
16764,16764,156,2022/4/15 9:00:00,48,290,-242
16765,16765,156,2022/4/15 9:10:00,47,268,-221
16766,16766,156,2022/4/15 9:20:00,42,169,-127
16767,16767,156,2022/4/15 9:30:00,36,128,-92
16768,16768,156,2022/4/15 9:40:00,28,108,-80
16769,16769,156,2022/4/15 9:50:00,30,126,-96
16770,16770,156,2022/4/15 10:00:00,31,90,-59
16771,16771,156,2022/4/15 10:10:00,28,97,-69
16772,16772,156,2022/4/15 10:20:00,30,96,-66
16773,16773,156,2022/4/15 10:30:00,31,76,-45
16774,16774,156,2022/4/15 10:40:00,29,74,-45
16775,16775,156,2022/4/15 10:50:00,32,91,-59
16776,16776,156,2022/4/15 11:00:00,28,65,-37
16777,16777,156,2022/4/15 11:10:00,29,74,-45
16778,16778,156,2022/4/15 11:20:00,28,76,-48
16779,16779,156,2022/4/15 11:30:00,29,76,-47
16780,16780,156,2022/4/15 11:40:00,29,69,-40
16781,16781,156,2022/4/15 11:50:00,28,78,-50
16782,16782,156,2022/4/15 12:00:00,27,69,-42
16783,16783,156,2022/4/15 12:10:00,32,93,-61
16784,16784,156,2022/4/15 12:20:00,28,62,-34
16785,16785,156,2022/4/15 12:30:00,36,68,-32
16786,16786,156,2022/4/15 12:40:00,35,93,-58
16787,16787,156,2022/4/15 12:50:00,33,77,-44
16788,16788,156,2022/4/15 13:00:00,31,101,-70
16789,16789,156,2022/4/15 13:10:00,33,77,-44
16790,16790,156,2022/4/15 13:20:00,35,90,-55
16791,16791,156,2022/4/15 13:30:00,30,71,-41
16792,16792,156,2022/4/15 13:40:00,32,90,-58
16793,16793,156,2022/4/15 13:50:00,31,92,-61
16794,16794,156,2022/4/15 14:00:00,30,69,-39
16795,16795,156,2022/4/15 14:10:00,33,76,-43
16796,16796,156,2022/4/15 14:20:00,31,73,-42
16797,16797,156,2022/4/15 14:30:00,36,80,-44
16798,16798,156,2022/4/15 14:40:00,38,70,-32
16799,16799,156,2022/4/15 14:50:00,38,75,-37
16800,16800,156,2022/4/15 15:00:00,35,78,-43
16801,16801,156,2022/4/15 15:10:00,38,68,-30
16802,16802,156,2022/4/15 15:20:00,35,80,-45
16803,16803,156,2022/4/15 15:30:00,34,85,-51
16804,16804,156,2022/4/15 15:40:00,40,75,-35
16805,16805,156,2022/4/15 15:50:00,41,72,-31
16806,16806,156,2022/4/15 16:00:00,41,80,-39
16807,16807,156,2022/4/15 16:10:00,45,72,-27
16808,16808,156,2022/4/15 16:20:00,41,91,-50
16809,16809,156,2022/4/15 16:30:00,45,84,-39
16810,16810,156,2022/4/15 16:40:00,50,75,-25
16811,16811,156,2022/4/15 16:50:00,47,101,-54
16812,16812,156,2022/4/15 17:00:00,68,89,-21
16813,16813,156,2022/4/15 17:10:00,128,105,23
16814,16814,156,2022/4/15 17:20:00,77,104,-27
16815,16815,156,2022/4/15 17:30:00,109,100,9
16816,16816,156,2022/4/15 17:40:00,149,99,50
16817,16817,156,2022/4/15 17:50:00,86,109,-23
16818,16818,156,2022/4/15 18:00:00,132,111,21
16819,16819,156,2022/4/15 18:10:00,176,111,65
16820,16820,156,2022/4/15 18:20:00,136,119,17
16821,16821,156,2022/4/15 18:30:00,66,121,-55
16822,16822,156,2022/4/15 18:40:00,76,115,-39
16823,16823,156,2022/4/15 18:50:00,52,111,-59
16824,16824,156,2022/4/15 19:00:00,49,107,-58
16825,16825,156,2022/4/15 19:10:00,43,104,-61
16826,16826,156,2022/4/15 19:20:00,43,101,-58
16827,16827,156,2022/4/15 19:30:00,42,80,-38
16828,16828,156,2022/4/15 19:40:00,43,69,-26
16829,16829,156,2022/4/15 19:50:00,37,83,-46
16830,16830,156,2022/4/15 20:00:00,39,71,-32
16831,16831,156,2022/4/15 20:10:00,47,66,-19
16832,16832,156,2022/4/15 20:20:00,41,49,-8
16833,16833,156,2022/4/15 20:30:00,43,76,-33
16834,16834,156,2022/4/15 20:40:00,51,68,-17
16835,16835,156,2022/4/15 20:50:00,42,52,-10
16836,16836,156,2022/4/15 21:00:00,42,65,-23
16837,16837,156,2022/4/15 21:10:00,55,62,-7
16838,16838,156,2022/4/15 21:20:00,39,47,-8
16839,16839,156,2022/4/15 21:30:00,36,61,-25
16840,16840,156,2022/4/15 21:40:00,34,49,-15
16841,16841,156,2022/4/15 21:50:00,29,52,-23
16842,16842,156,2022/4/15 22:00:00,51,66,-15
16843,16843,156,2022/4/15 22:10:00,44,61,-17
16844,16844,156,2022/4/15 22:20:00,25,66,-41
16845,16845,156,2022/4/15 22:30:00,23,58,-35
16846,16846,156,2022/4/15 22:40:00,16,47,-31
16847,16847,156,2022/4/15 22:50:00,11,45,-34
16848,16848,157,2022/4/15 5:00:00,0,1,-1
16849,16849,157,2022/4/15 5:10:00,2,1,1
16850,16850,157,2022/4/15 5:20:00,10,1,9
16851,16851,157,2022/4/15 5:30:00,5,5,0
16852,16852,157,2022/4/15 5:40:00,10,1,9
16853,16853,157,2022/4/15 5:50:00,13,5,8
16854,16854,157,2022/4/15 6:00:00,20,2,18
16855,16855,157,2022/4/15 6:10:00,25,5,20
16856,16856,157,2022/4/15 6:20:00,35,59,-24
16857,16857,157,2022/4/15 6:30:00,47,61,-14
16858,16858,157,2022/4/15 6:40:00,62,75,-13
16859,16859,157,2022/4/15 6:50:00,61,90,-29
16860,16860,157,2022/4/15 7:00:00,80,111,-31
16861,16861,157,2022/4/15 7:10:00,129,107,22
16862,16862,157,2022/4/15 7:20:00,152,130,22
16863,16863,157,2022/4/15 7:30:00,175,178,-3
16864,16864,157,2022/4/15 7:40:00,226,298,-72
16865,16865,157,2022/4/15 7:50:00,266,381,-115
16866,16866,157,2022/4/15 8:00:00,276,429,-153
16867,16867,157,2022/4/15 8:10:00,330,580,-250
16868,16868,157,2022/4/15 8:20:00,279,577,-298
16869,16869,157,2022/4/15 8:30:00,275,1558,-1283
16870,16870,157,2022/4/15 8:40:00,240,1983,-1743
16871,16871,157,2022/4/15 8:50:00,206,1588,-1382
16872,16872,157,2022/4/15 9:00:00,178,489,-311
16873,16873,157,2022/4/15 9:10:00,162,492,-330
16874,16874,157,2022/4/15 9:20:00,91,332,-241
16875,16875,157,2022/4/15 9:30:00,72,231,-159
16876,16876,157,2022/4/15 9:40:00,58,177,-119
16877,16877,157,2022/4/15 9:50:00,50,138,-88
16878,16878,157,2022/4/15 10:00:00,46,104,-58
16879,16879,157,2022/4/15 10:10:00,44,127,-83
16880,16880,157,2022/4/15 10:20:00,42,87,-45
16881,16881,157,2022/4/15 10:30:00,44,106,-62
16882,16882,157,2022/4/15 10:40:00,41,105,-64
16883,16883,157,2022/4/15 10:50:00,36,101,-65
16884,16884,157,2022/4/15 11:00:00,40,108,-68
16885,16885,157,2022/4/15 11:10:00,41,90,-49
16886,16886,157,2022/4/15 11:20:00,35,93,-58
16887,16887,157,2022/4/15 11:30:00,35,108,-73
16888,16888,157,2022/4/15 11:40:00,44,96,-52
16889,16889,157,2022/4/15 11:50:00,46,109,-63
16890,16890,157,2022/4/15 12:00:00,45,113,-68
16891,16891,157,2022/4/15 12:10:00,65,94,-29
16892,16892,157,2022/4/15 12:20:00,58,112,-54
16893,16893,157,2022/4/15 12:30:00,54,99,-45
16894,16894,157,2022/4/15 12:40:00,53,109,-56
16895,16895,157,2022/4/15 12:50:00,50,106,-56
16896,16896,157,2022/4/15 13:00:00,47,100,-53
16897,16897,157,2022/4/15 13:10:00,63,109,-46
16898,16898,157,2022/4/15 13:20:00,60,111,-51
16899,16899,157,2022/4/15 13:30:00,44,112,-68
16900,16900,157,2022/4/15 13:40:00,43,92,-49
16901,16901,157,2022/4/15 13:50:00,45,105,-60
16902,16902,157,2022/4/15 14:00:00,45,100,-55
16903,16903,157,2022/4/15 14:10:00,56,93,-37
16904,16904,157,2022/4/15 14:20:00,53,111,-58
16905,16905,157,2022/4/15 14:30:00,46,90,-44
16906,16906,157,2022/4/15 14:40:00,47,106,-59
16907,16907,157,2022/4/15 14:50:00,60,93,-33
16908,16908,157,2022/4/15 15:00:00,68,104,-36
16909,16909,157,2022/4/15 15:10:00,98,93,5
16910,16910,157,2022/4/15 15:20:00,73,102,-29
16911,16911,157,2022/4/15 15:30:00,59,109,-50
16912,16912,157,2022/4/15 15:40:00,63,100,-37
16913,16913,157,2022/4/15 15:50:00,68,103,-35
16914,16914,157,2022/4/15 16:00:00,77,108,-31
16915,16915,157,2022/4/15 16:10:00,109,100,9
16916,16916,157,2022/4/15 16:20:00,97,100,-3
16917,16917,157,2022/4/15 16:30:00,132,97,35
16918,16918,157,2022/4/15 16:40:00,205,112,93
16919,16919,157,2022/4/15 16:50:00,222,124,98
16920,16920,157,2022/4/15 17:00:00,269,121,148
16921,16921,157,2022/4/15 17:10:00,610,100,510
16922,16922,157,2022/4/15 17:20:00,428,122,306
16923,16923,157,2022/4/15 17:30:00,462,144,318
16924,16924,157,2022/4/15 17:40:00,1039,149,890
16925,16925,157,2022/4/15 17:50:00,715,159,556
16926,16926,157,2022/4/15 18:00:00,658,192,466
16927,16927,157,2022/4/15 18:10:00,1200,198,1002
16928,16928,157,2022/4/15 18:20:00,1030,178,852
16929,16929,157,2022/4/15 18:30:00,608,178,430
16930,16930,157,2022/4/15 18:40:00,349,184,165
16931,16931,157,2022/4/15 18:50:00,305,184,121
16932,16932,157,2022/4/15 19:00:00,222,128,94
16933,16933,157,2022/4/15 19:10:00,185,110,75
16934,16934,157,2022/4/15 19:20:00,151,105,46
16935,16935,157,2022/4/15 19:30:00,111,112,-1
16936,16936,157,2022/4/15 19:40:00,76,114,-38
16937,16937,157,2022/4/15 19:50:00,65,95,-30
16938,16938,157,2022/4/15 20:00:00,64,95,-31
16939,16939,157,2022/4/15 20:10:00,68,97,-29
16940,16940,157,2022/4/15 20:20:00,64,88,-24
16941,16941,157,2022/4/15 20:30:00,45,90,-45
16942,16942,157,2022/4/15 20:40:00,61,95,-34
16943,16943,157,2022/4/15 20:50:00,46,99,-53
16944,16944,157,2022/4/15 21:00:00,47,92,-45
16945,16945,157,2022/4/15 21:10:00,67,95,-28
16946,16946,157,2022/4/15 21:20:00,43,95,-52
16947,16947,157,2022/4/15 21:30:00,41,93,-52
16948,16948,157,2022/4/15 21:40:00,35,92,-57
16949,16949,157,2022/4/15 21:50:00,36,75,-39
16950,16950,157,2022/4/15 22:00:00,27,72,-45
16951,16951,157,2022/4/15 22:10:00,33,92,-59
16952,16952,157,2022/4/15 22:20:00,27,75,-48
16953,16953,157,2022/4/15 22:30:00,17,70,-53
16954,16954,157,2022/4/15 22:40:00,10,71,-61
16955,16955,157,2022/4/15 22:50:00,3,48,-45
16956,16956,158,2022/4/15 5:00:00,0,1,-1
16957,16957,158,2022/4/15 5:10:00,0,1,-1
16958,16958,158,2022/4/15 5:20:00,1,1,0
16959,16959,158,2022/4/15 5:30:00,29,1,28
16960,16960,158,2022/4/15 5:40:00,45,1,44
16961,16961,158,2022/4/15 5:50:00,45,16,29
16962,16962,158,2022/4/15 6:00:00,54,47,7
16963,16963,158,2022/4/15 6:10:00,85,32,53
16964,16964,158,2022/4/15 6:20:00,185,50,135
16965,16965,158,2022/4/15 6:30:00,226,66,160
16966,16966,158,2022/4/15 6:40:00,324,77,247
16967,16967,158,2022/4/15 6:50:00,590,107,483
16968,16968,158,2022/4/15 7:00:00,685,110,575
16969,16969,158,2022/4/15 7:10:00,860,108,752
16970,16970,158,2022/4/15 7:20:00,1223,159,1064
16971,16971,158,2022/4/15 7:30:00,1360,111,1249
16972,16972,158,2022/4/15 7:40:00,1362,125,1237
16973,16973,158,2022/4/15 7:50:00,1206,150,1056
16974,16974,158,2022/4/15 8:00:00,1170,180,990
16975,16975,158,2022/4/15 8:10:00,1178,116,1062
16976,16976,158,2022/4/15 8:20:00,1152,169,983
16977,16977,158,2022/4/15 8:30:00,833,153,680
16978,16978,158,2022/4/15 8:40:00,717,108,609
16979,16979,158,2022/4/15 8:50:00,592,129,463
16980,16980,158,2022/4/15 9:00:00,434,108,326
16981,16981,158,2022/4/15 9:10:00,324,100,224
16982,16982,158,2022/4/15 9:20:00,263,83,180
16983,16983,158,2022/4/15 9:30:00,217,103,114
16984,16984,158,2022/4/15 9:40:00,157,105,52
16985,16985,158,2022/4/15 9:50:00,136,75,61
16986,16986,158,2022/4/15 10:00:00,101,120,-19
16987,16987,158,2022/4/15 10:10:00,74,89,-15
16988,16988,158,2022/4/15 10:20:00,69,106,-37
16989,16989,158,2022/4/15 10:30:00,58,87,-29
16990,16990,158,2022/4/15 10:40:00,55,94,-39
16991,16991,158,2022/4/15 10:50:00,60,96,-36
16992,16992,158,2022/4/15 11:00:00,59,92,-33
16993,16993,158,2022/4/15 11:10:00,55,67,-12
16994,16994,158,2022/4/15 11:20:00,47,107,-60
16995,16995,158,2022/4/15 11:30:00,59,99,-40
16996,16996,158,2022/4/15 11:40:00,63,92,-29
16997,16997,158,2022/4/15 11:50:00,68,112,-44
16998,16998,158,2022/4/15 12:00:00,73,77,-4
16999,16999,158,2022/4/15 12:10:00,75,108,-33
17000,17000,158,2022/4/15 12:20:00,76,98,-22
17001,17001,158,2022/4/15 12:30:00,70,112,-42
17002,17002,158,2022/4/15 12:40:00,73,100,-27
17003,17003,158,2022/4/15 12:50:00,68,114,-46
17004,17004,158,2022/4/15 13:00:00,64,106,-42
17005,17005,158,2022/4/15 13:10:00,59,109,-50
17006,17006,158,2022/4/15 13:20:00,62,123,-61
17007,17007,158,2022/4/15 13:30:00,54,93,-39
17008,17008,158,2022/4/15 13:40:00,47,109,-62
17009,17009,158,2022/4/15 13:50:00,48,107,-59
17010,17010,158,2022/4/15 14:00:00,49,105,-56
17011,17011,158,2022/4/15 14:10:00,53,120,-67
17012,17012,158,2022/4/15 14:20:00,41,96,-55
17013,17013,158,2022/4/15 14:30:00,60,111,-51
17014,17014,158,2022/4/15 14:40:00,77,102,-25
17015,17015,158,2022/4/15 14:50:00,59,102,-43
17016,17016,158,2022/4/15 15:00:00,58,124,-66
17017,17017,158,2022/4/15 15:10:00,88,100,-12
17018,17018,158,2022/4/15 15:20:00,85,109,-24
17019,17019,158,2022/4/15 15:30:00,74,100,-26
17020,17020,158,2022/4/15 15:40:00,93,142,-49
17021,17021,158,2022/4/15 15:50:00,91,121,-30
17022,17022,158,2022/4/15 16:00:00,77,133,-56
17023,17023,158,2022/4/15 16:10:00,84,118,-34
17024,17024,158,2022/4/15 16:20:00,83,144,-61
17025,17025,158,2022/4/15 16:30:00,140,109,31
17026,17026,158,2022/4/15 16:40:00,167,269,-102
17027,17027,158,2022/4/15 16:50:00,135,183,-48
17028,17028,158,2022/4/15 17:00:00,204,182,22
17029,17029,158,2022/4/15 17:10:00,214,214,0
17030,17030,158,2022/4/15 17:20:00,213,489,-276
17031,17031,158,2022/4/15 17:30:00,194,376,-182
17032,17032,158,2022/4/15 17:40:00,231,423,-192
17033,17033,158,2022/4/15 17:50:00,219,484,-265
17034,17034,158,2022/4/15 18:00:00,150,417,-267
17035,17035,158,2022/4/15 18:10:00,168,425,-257
17036,17036,158,2022/4/15 18:20:00,128,414,-286
17037,17037,158,2022/4/15 18:30:00,90,581,-491
17038,17038,158,2022/4/15 18:40:00,70,417,-347
17039,17039,158,2022/4/15 18:50:00,53,400,-347
17040,17040,158,2022/4/15 19:00:00,49,577,-528
17041,17041,158,2022/4/15 19:10:00,46,489,-443
17042,17042,158,2022/4/15 19:20:00,44,319,-275
17043,17043,158,2022/4/15 19:30:00,38,314,-276
17044,17044,158,2022/4/15 19:40:00,40,219,-179
17045,17045,158,2022/4/15 19:50:00,34,190,-156
17046,17046,158,2022/4/15 20:00:00,41,178,-137
17047,17047,158,2022/4/15 20:10:00,38,112,-74
17048,17048,158,2022/4/15 20:20:00,36,117,-81
17049,17049,158,2022/4/15 20:30:00,37,137,-100
17050,17050,158,2022/4/15 20:40:00,33,109,-76
17051,17051,158,2022/4/15 20:50:00,33,107,-74
17052,17052,158,2022/4/15 21:00:00,29,192,-163
17053,17053,158,2022/4/15 21:10:00,27,114,-87
17054,17054,158,2022/4/15 21:20:00,27,115,-88
17055,17055,158,2022/4/15 21:30:00,26,150,-124
17056,17056,158,2022/4/15 21:40:00,25,120,-95
17057,17057,158,2022/4/15 21:50:00,25,124,-99
17058,17058,158,2022/4/15 22:00:00,25,109,-84
17059,17059,158,2022/4/15 22:10:00,21,108,-87
17060,17060,158,2022/4/15 22:20:00,16,109,-93
17061,17061,158,2022/4/15 22:30:00,13,103,-90
17062,17062,158,2022/4/15 22:40:00,13,106,-93
17063,17063,158,2022/4/15 22:50:00,11,106,-95
17064,17064,159,2022/4/15 5:00:00,0,1,-1
17065,17065,159,2022/4/15 5:10:00,19,1,18
17066,17066,159,2022/4/15 5:20:00,18,1,17
17067,17067,159,2022/4/15 5:30:00,20,1,19
17068,17068,159,2022/4/15 5:40:00,26,1,25
17069,17069,159,2022/4/15 5:50:00,34,1,33
17070,17070,159,2022/4/15 6:00:00,47,1,46
17071,17071,159,2022/4/15 6:10:00,57,1,56
17072,17072,159,2022/4/15 6:20:00,86,1,85
17073,17073,159,2022/4/15 6:30:00,149,65,84
17074,17074,159,2022/4/15 6:40:00,216,70,146
17075,17075,159,2022/4/15 6:50:00,232,6,226
17076,17076,159,2022/4/15 7:00:00,280,79,201
17077,17077,159,2022/4/15 7:10:00,282,96,186
17078,17078,159,2022/4/15 7:20:00,283,13,270
17079,17079,159,2022/4/15 7:30:00,280,109,171
17080,17080,159,2022/4/15 7:40:00,302,100,202
17081,17081,159,2022/4/15 7:50:00,253,19,234
17082,17082,159,2022/4/15 8:00:00,270,90,180
17083,17083,159,2022/4/15 8:10:00,227,69,158
17084,17084,159,2022/4/15 8:20:00,144,16,128
17085,17085,159,2022/4/15 8:30:00,143,67,76
17086,17086,159,2022/4/15 8:40:00,60,60,0
17087,17087,159,2022/4/15 8:50:00,53,21,32
17088,17088,159,2022/4/15 9:00:00,41,65,-24
17089,17089,159,2022/4/15 9:10:00,29,48,-19
17090,17090,159,2022/4/15 9:20:00,28,25,3
17091,17091,159,2022/4/15 9:30:00,32,64,-32
17092,17092,159,2022/4/15 9:40:00,28,50,-22
17093,17093,159,2022/4/15 9:50:00,29,19,10
17094,17094,159,2022/4/15 10:00:00,28,61,-33
17095,17095,159,2022/4/15 10:10:00,23,58,-35
17096,17096,159,2022/4/15 10:20:00,24,47,-23
17097,17097,159,2022/4/15 10:30:00,21,22,-1
17098,17098,159,2022/4/15 10:40:00,28,49,-21
17099,17099,159,2022/4/15 10:50:00,26,55,-29
17100,17100,159,2022/4/15 11:00:00,25,50,-25
17101,17101,159,2022/4/15 11:10:00,24,24,0
17102,17102,159,2022/4/15 11:20:00,27,48,-21
17103,17103,159,2022/4/15 11:30:00,25,61,-36
17104,17104,159,2022/4/15 11:40:00,25,7,18
17105,17105,159,2022/4/15 11:50:00,28,57,-29
17106,17106,159,2022/4/15 12:00:00,25,51,-26
17107,17107,159,2022/4/15 12:10:00,27,54,-27
17108,17108,159,2022/4/15 12:20:00,27,7,20
17109,17109,159,2022/4/15 12:30:00,26,60,-34
17110,17110,159,2022/4/15 12:40:00,28,60,-32
17111,17111,159,2022/4/15 12:50:00,26,44,-18
17112,17112,159,2022/4/15 13:00:00,23,34,-11
17113,17113,159,2022/4/15 13:10:00,25,68,-43
17114,17114,159,2022/4/15 13:20:00,22,62,-40
17115,17115,159,2022/4/15 13:30:00,22,5,17
17116,17116,159,2022/4/15 13:40:00,22,62,-40
17117,17117,159,2022/4/15 13:50:00,16,64,-48
17118,17118,159,2022/4/15 14:00:00,22,68,-46
17119,17119,159,2022/4/15 14:10:00,23,17,6
17120,17120,159,2022/4/15 14:20:00,22,67,-45
17121,17121,159,2022/4/15 14:30:00,17,68,-51
17122,17122,159,2022/4/15 14:40:00,20,5,15
17123,17123,159,2022/4/15 14:50:00,18,63,-45
17124,17124,159,2022/4/15 15:00:00,18,71,-53
17125,17125,159,2022/4/15 15:10:00,24,57,-33
17126,17126,159,2022/4/15 15:20:00,27,43,-16
17127,17127,159,2022/4/15 15:30:00,28,84,-56
17128,17128,159,2022/4/15 15:40:00,21,87,-66
17129,17129,159,2022/4/15 15:50:00,21,47,-26
17130,17130,159,2022/4/15 16:00:00,27,75,-48
17131,17131,159,2022/4/15 16:10:00,28,109,-81
17132,17132,159,2022/4/15 16:20:00,26,93,-67
17133,17133,159,2022/4/15 16:30:00,27,42,-15
17134,17134,159,2022/4/15 16:40:00,27,105,-78
17135,17135,159,2022/4/15 16:50:00,27,105,-78
17136,17136,159,2022/4/15 17:00:00,33,102,-69
17137,17137,159,2022/4/15 17:10:00,38,33,5
17138,17138,159,2022/4/15 17:20:00,32,123,-91
17139,17139,159,2022/4/15 17:30:00,28,109,-81
17140,17140,159,2022/4/15 17:40:00,28,14,14
17141,17141,159,2022/4/15 17:50:00,25,143,-118
17142,17142,159,2022/4/15 18:00:00,17,138,-121
17143,17143,159,2022/4/15 18:10:00,19,49,-30
17144,17144,159,2022/4/15 18:20:00,15,197,-182
17145,17145,159,2022/4/15 18:30:00,13,107,-94
17146,17146,159,2022/4/15 18:40:00,15,97,-82
17147,17147,159,2022/4/15 18:50:00,12,198,-186
17148,17148,159,2022/4/15 19:00:00,9,81,-72
17149,17149,159,2022/4/15 19:10:00,10,105,-95
17150,17150,159,2022/4/15 19:20:00,10,179,-169
17151,17151,159,2022/4/15 19:30:00,11,99,-88
17152,17152,159,2022/4/15 19:40:00,9,80,-71
17153,17153,159,2022/4/15 19:50:00,7,123,-116
17154,17154,159,2022/4/15 20:00:00,9,115,-106
17155,17155,159,2022/4/15 20:10:00,12,92,-80
17156,17156,159,2022/4/15 20:20:00,12,92,-80
17157,17157,159,2022/4/15 20:30:00,12,8,4
17158,17158,159,2022/4/15 20:40:00,12,98,-86
17159,17159,159,2022/4/15 20:50:00,8,97,-89
17160,17160,159,2022/4/15 21:00:00,6,4,2
17161,17161,159,2022/4/15 21:10:00,6,98,-92
17162,17162,159,2022/4/15 21:20:00,7,103,-96
17163,17163,159,2022/4/15 21:30:00,8,3,5
17164,17164,159,2022/4/15 21:40:00,7,91,-84
17165,17165,159,2022/4/15 21:50:00,4,95,-91
17166,17166,159,2022/4/15 22:00:00,2,3,-1
17167,17167,159,2022/4/15 22:10:00,3,95,-92
17168,17168,159,2022/4/15 22:20:00,2,80,-78
17169,17169,159,2022/4/15 22:30:00,0,3,-3
17170,17170,159,2022/4/15 22:40:00,0,86,-86
17171,17171,159,2022/4/15 22:50:00,0,61,-61
17172,17172,160,2022/4/15 5:00:00,0,1,-1
17173,17173,160,2022/4/15 5:10:00,0,1,-1
17174,17174,160,2022/4/15 5:20:00,6,1,5
17175,17175,160,2022/4/15 5:30:00,19,1,18
17176,17176,160,2022/4/15 5:40:00,20,6,14
17177,17177,160,2022/4/15 5:50:00,20,5,15
17178,17178,160,2022/4/15 6:00:00,32,5,27
17179,17179,160,2022/4/15 6:10:00,36,33,3
17180,17180,160,2022/4/15 6:20:00,54,38,16
17181,17181,160,2022/4/15 6:30:00,62,38,24
17182,17182,160,2022/4/15 6:40:00,126,73,53
17183,17183,160,2022/4/15 6:50:00,149,69,80
17184,17184,160,2022/4/15 7:00:00,229,77,152
17185,17185,160,2022/4/15 7:10:00,255,69,186
17186,17186,160,2022/4/15 7:20:00,332,84,248
17187,17187,160,2022/4/15 7:30:00,327,95,232
17188,17188,160,2022/4/15 7:40:00,678,108,570
17189,17189,160,2022/4/15 7:50:00,664,108,556
17190,17190,160,2022/4/15 8:00:00,864,126,738
17191,17191,160,2022/4/15 8:10:00,824,109,715
17192,17192,160,2022/4/15 8:20:00,826,128,698
17193,17193,160,2022/4/15 8:30:00,628,150,478
17194,17194,160,2022/4/15 8:40:00,597,226,371
17195,17195,160,2022/4/15 8:50:00,328,171,157
17196,17196,160,2022/4/15 9:00:00,275,130,145
17197,17197,160,2022/4/15 9:10:00,236,129,107
17198,17198,160,2022/4/15 9:20:00,190,122,68
17199,17199,160,2022/4/15 9:30:00,92,106,-14
17200,17200,160,2022/4/15 9:40:00,71,110,-39
17201,17201,160,2022/4/15 9:50:00,50,105,-55
17202,17202,160,2022/4/15 10:00:00,49,92,-43
17203,17203,160,2022/4/15 10:10:00,43,90,-47
17204,17204,160,2022/4/15 10:20:00,38,84,-46
17205,17205,160,2022/4/15 10:30:00,35,76,-41
17206,17206,160,2022/4/15 10:40:00,35,92,-57
17207,17207,160,2022/4/15 10:50:00,29,75,-46
17208,17208,160,2022/4/15 11:00:00,31,86,-55
17209,17209,160,2022/4/15 11:10:00,29,85,-56
17210,17210,160,2022/4/15 11:20:00,31,75,-44
17211,17211,160,2022/4/15 11:30:00,33,84,-51
17212,17212,160,2022/4/15 11:40:00,34,83,-49
17213,17213,160,2022/4/15 11:50:00,34,75,-41
17214,17214,160,2022/4/15 12:00:00,37,91,-54
17215,17215,160,2022/4/15 12:10:00,37,83,-46
17216,17216,160,2022/4/15 12:20:00,43,90,-47
17217,17217,160,2022/4/15 12:30:00,40,77,-37
17218,17218,160,2022/4/15 12:40:00,42,93,-51
17219,17219,160,2022/4/15 12:50:00,40,99,-59
17220,17220,160,2022/4/15 13:00:00,43,96,-53
17221,17221,160,2022/4/15 13:10:00,43,87,-44
17222,17222,160,2022/4/15 13:20:00,43,77,-34
17223,17223,160,2022/4/15 13:30:00,39,76,-37
17224,17224,160,2022/4/15 13:40:00,40,76,-36
17225,17225,160,2022/4/15 13:50:00,34,81,-47
17226,17226,160,2022/4/15 14:00:00,36,90,-54
17227,17227,160,2022/4/15 14:10:00,37,92,-55
17228,17228,160,2022/4/15 14:20:00,38,98,-60
17229,17229,160,2022/4/15 14:30:00,36,78,-42
17230,17230,160,2022/4/15 14:40:00,39,87,-48
17231,17231,160,2022/4/15 14:50:00,33,87,-54
17232,17232,160,2022/4/15 15:00:00,35,107,-72
17233,17233,160,2022/4/15 15:10:00,37,96,-59
17234,17234,160,2022/4/15 15:20:00,37,102,-65
17235,17235,160,2022/4/15 15:30:00,39,103,-64
17236,17236,160,2022/4/15 15:40:00,37,93,-56
17237,17237,160,2022/4/15 15:50:00,31,106,-75
17238,17238,160,2022/4/15 16:00:00,45,102,-57
17239,17239,160,2022/4/15 16:10:00,45,104,-59
17240,17240,160,2022/4/15 16:20:00,43,105,-62
17241,17241,160,2022/4/15 16:30:00,47,87,-40
17242,17242,160,2022/4/15 16:40:00,72,118,-46
17243,17243,160,2022/4/15 16:50:00,73,115,-42
17244,17244,160,2022/4/15 17:00:00,175,112,63
17245,17245,160,2022/4/15 17:10:00,163,151,12
17246,17246,160,2022/4/15 17:20:00,102,168,-66
17247,17247,160,2022/4/15 17:30:00,131,225,-94
17248,17248,160,2022/4/15 17:40:00,183,269,-86
17249,17249,160,2022/4/15 17:50:00,73,298,-225
17250,17250,160,2022/4/15 18:00:00,92,334,-242
17251,17251,160,2022/4/15 18:10:00,129,323,-194
17252,17252,160,2022/4/15 18:20:00,97,333,-236
17253,17253,160,2022/4/15 18:30:00,73,319,-246
17254,17254,160,2022/4/15 18:40:00,67,334,-267
17255,17255,160,2022/4/15 18:50:00,45,299,-254
17256,17256,160,2022/4/15 19:00:00,45,223,-178
17257,17257,160,2022/4/15 19:10:00,40,147,-107
17258,17258,160,2022/4/15 19:20:00,37,109,-72
17259,17259,160,2022/4/15 19:30:00,34,105,-71
17260,17260,160,2022/4/15 19:40:00,27,124,-97
17261,17261,160,2022/4/15 19:50:00,27,104,-77
17262,17262,160,2022/4/15 20:00:00,33,104,-71
17263,17263,160,2022/4/15 20:10:00,32,114,-82
17264,17264,160,2022/4/15 20:20:00,30,107,-77
17265,17265,160,2022/4/15 20:30:00,35,103,-68
17266,17266,160,2022/4/15 20:40:00,37,114,-77
17267,17267,160,2022/4/15 20:50:00,32,101,-69
17268,17268,160,2022/4/15 21:00:00,32,112,-80
17269,17269,160,2022/4/15 21:10:00,42,108,-66
17270,17270,160,2022/4/15 21:20:00,34,102,-68
17271,17271,160,2022/4/15 21:30:00,34,102,-68
17272,17272,160,2022/4/15 21:40:00,35,106,-71
17273,17273,160,2022/4/15 21:50:00,29,94,-65
17274,17274,160,2022/4/15 22:00:00,31,95,-64
17275,17275,160,2022/4/15 22:10:00,40,93,-53
17276,17276,160,2022/4/15 22:20:00,26,94,-68
17277,17277,160,2022/4/15 22:30:00,16,94,-78
17278,17278,160,2022/4/15 22:40:00,17,96,-79
17279,17279,160,2022/4/15 22:50:00,10,73,-63
17280,17280,161,2022/4/15 5:00:00,0,1,-1
17281,17281,161,2022/4/15 5:10:00,8,1,7
17282,17282,161,2022/4/15 5:20:00,14,1,13
17283,17283,161,2022/4/15 5:30:00,18,5,13
17284,17284,161,2022/4/15 5:40:00,20,1,19
17285,17285,161,2022/4/15 5:50:00,28,1,27
17286,17286,161,2022/4/15 6:00:00,31,1,30
17287,17287,161,2022/4/15 6:10:00,34,1,33
17288,17288,161,2022/4/15 6:20:00,45,69,-24
17289,17289,161,2022/4/15 6:30:00,68,20,48
17290,17290,161,2022/4/15 6:40:00,75,110,-35
17291,17291,161,2022/4/15 6:50:00,140,125,15
17292,17292,161,2022/4/15 7:00:00,199,124,75
17293,17293,161,2022/4/15 7:10:00,205,179,26
17294,17294,161,2022/4/15 7:20:00,278,152,126
17295,17295,161,2022/4/15 7:30:00,360,208,152
17296,17296,161,2022/4/15 7:40:00,389,222,167
17297,17297,161,2022/4/15 7:50:00,642,269,373
17298,17298,161,2022/4/15 8:00:00,704,253,451
17299,17299,161,2022/4/15 8:10:00,613,313,300
17300,17300,161,2022/4/15 8:20:00,661,316,345
17301,17301,161,2022/4/15 8:30:00,599,253,346
17302,17302,161,2022/4/15 8:40:00,565,418,147
17303,17303,161,2022/4/15 8:50:00,357,321,36
17304,17304,161,2022/4/15 9:00:00,278,181,97
17305,17305,161,2022/4/15 9:10:00,214,122,92
17306,17306,161,2022/4/15 9:20:00,212,150,62
17307,17307,161,2022/4/15 9:30:00,140,105,35
17308,17308,161,2022/4/15 9:40:00,86,104,-18
17309,17309,161,2022/4/15 9:50:00,76,108,-32
17310,17310,161,2022/4/15 10:00:00,67,98,-31
17311,17311,161,2022/4/15 10:10:00,59,90,-31
17312,17312,161,2022/4/15 10:20:00,50,93,-43
17313,17313,161,2022/4/15 10:30:00,43,77,-34
17314,17314,161,2022/4/15 10:40:00,44,93,-49
17315,17315,161,2022/4/15 10:50:00,44,70,-26
17316,17316,161,2022/4/15 11:00:00,37,65,-28
17317,17317,161,2022/4/15 11:10:00,41,76,-35
17318,17318,161,2022/4/15 11:20:00,38,83,-45
17319,17319,161,2022/4/15 11:30:00,43,78,-35
17320,17320,161,2022/4/15 11:40:00,42,69,-27
17321,17321,161,2022/4/15 11:50:00,38,94,-56
17322,17322,161,2022/4/15 12:00:00,45,72,-27
17323,17323,161,2022/4/15 12:10:00,49,83,-34
17324,17324,161,2022/4/15 12:20:00,54,96,-42
17325,17325,161,2022/4/15 12:30:00,54,75,-21
17326,17326,161,2022/4/15 12:40:00,49,105,-56
17327,17327,161,2022/4/15 12:50:00,45,78,-33
17328,17328,161,2022/4/15 13:00:00,44,108,-64
17329,17329,161,2022/4/15 13:10:00,45,97,-52
17330,17330,161,2022/4/15 13:20:00,43,81,-38
17331,17331,161,2022/4/15 13:30:00,43,93,-50
17332,17332,161,2022/4/15 13:40:00,37,78,-41
17333,17333,161,2022/4/15 13:50:00,40,105,-65
17334,17334,161,2022/4/15 14:00:00,42,75,-33
17335,17335,161,2022/4/15 14:10:00,40,103,-63
17336,17336,161,2022/4/15 14:20:00,42,81,-39
17337,17337,161,2022/4/15 14:30:00,45,73,-28
17338,17338,161,2022/4/15 14:40:00,47,102,-55
17339,17339,161,2022/4/15 14:50:00,43,82,-39
17340,17340,161,2022/4/15 15:00:00,47,93,-46
17341,17341,161,2022/4/15 15:10:00,45,94,-49
17342,17342,161,2022/4/15 15:20:00,45,87,-42
17343,17343,161,2022/4/15 15:30:00,49,98,-49
17344,17344,161,2022/4/15 15:40:00,66,104,-38
17345,17345,161,2022/4/15 15:50:00,69,93,-24
17346,17346,161,2022/4/15 16:00:00,70,110,-40
17347,17347,161,2022/4/15 16:10:00,75,122,-47
17348,17348,161,2022/4/15 16:20:00,74,93,-19
17349,17349,161,2022/4/15 16:30:00,136,112,24
17350,17350,161,2022/4/15 16:40:00,140,112,28
17351,17351,161,2022/4/15 16:50:00,135,105,30
17352,17352,161,2022/4/15 17:00:00,199,127,72
17353,17353,161,2022/4/15 17:10:00,230,143,87
17354,17354,161,2022/4/15 17:20:00,164,145,19
17355,17355,161,2022/4/15 17:30:00,204,232,-28
17356,17356,161,2022/4/15 17:40:00,217,207,10
17357,17357,161,2022/4/15 17:50:00,138,333,-195
17358,17358,161,2022/4/15 18:00:00,211,333,-122
17359,17359,161,2022/4/15 18:10:00,271,318,-47
17360,17360,161,2022/4/15 18:20:00,217,380,-163
17361,17361,161,2022/4/15 18:30:00,175,323,-148
17362,17362,161,2022/4/15 18:40:00,110,323,-213
17363,17363,161,2022/4/15 18:50:00,58,319,-261
17364,17364,161,2022/4/15 19:00:00,43,256,-213
17365,17365,161,2022/4/15 19:10:00,48,179,-131
17366,17366,161,2022/4/15 19:20:00,36,192,-156
17367,17367,161,2022/4/15 19:30:00,35,151,-116
17368,17368,161,2022/4/15 19:40:00,27,119,-92
17369,17369,161,2022/4/15 19:50:00,33,124,-91
17370,17370,161,2022/4/15 20:00:00,33,114,-81
17371,17371,161,2022/4/15 20:10:00,33,124,-91
17372,17372,161,2022/4/15 20:20:00,29,121,-92
17373,17373,161,2022/4/15 20:30:00,38,105,-67
17374,17374,161,2022/4/15 20:40:00,35,88,-53
17375,17375,161,2022/4/15 20:50:00,28,113,-85
17376,17376,161,2022/4/15 21:00:00,30,121,-91
17377,17377,161,2022/4/15 21:10:00,29,105,-76
17378,17378,161,2022/4/15 21:20:00,27,122,-95
17379,17379,161,2022/4/15 21:30:00,26,125,-99
17380,17380,161,2022/4/15 21:40:00,22,114,-92
17381,17381,161,2022/4/15 21:50:00,19,107,-88
17382,17382,161,2022/4/15 22:00:00,25,125,-100
17383,17383,161,2022/4/15 22:10:00,20,106,-86
17384,17384,161,2022/4/15 22:20:00,12,77,-65
17385,17385,161,2022/4/15 22:30:00,2,115,-113
17386,17386,161,2022/4/15 22:40:00,1,88,-87
17387,17387,161,2022/4/15 22:50:00,0,66,-66
17388,17388,162,2022/4/15 5:00:00,0,1,-1
17389,17389,162,2022/4/15 5:10:00,0,1,-1
17390,17390,162,2022/4/15 5:20:00,0,1,-1
17391,17391,162,2022/4/15 5:30:00,64,1,63
17392,17392,162,2022/4/15 5:40:00,53,37,16
17393,17393,162,2022/4/15 5:50:00,32,31,1
17394,17394,162,2022/4/15 6:00:00,54,97,-43
17395,17395,162,2022/4/15 6:10:00,54,121,-67
17396,17396,162,2022/4/15 6:20:00,67,100,-33
17397,17397,162,2022/4/15 6:30:00,147,182,-35
17398,17398,162,2022/4/15 6:40:00,175,282,-107
17399,17399,162,2022/4/15 6:50:00,247,312,-65
17400,17400,162,2022/4/15 7:00:00,288,376,-88
17401,17401,162,2022/4/15 7:10:00,326,441,-115
17402,17402,162,2022/4/15 7:20:00,655,464,191
17403,17403,162,2022/4/15 7:30:00,732,582,150
17404,17404,162,2022/4/15 7:40:00,1469,1124,345
17405,17405,162,2022/4/15 7:50:00,2011,1555,456
17406,17406,162,2022/4/15 8:00:00,1968,1822,146
17407,17407,162,2022/4/15 8:10:00,1981,2548,-567
17408,17408,162,2022/4/15 8:20:00,2006,2185,-179
17409,17409,162,2022/4/15 8:30:00,1999,2370,-371
17410,17410,162,2022/4/15 8:40:00,1645,2157,-512
17411,17411,162,2022/4/15 8:50:00,1220,2487,-1267
17412,17412,162,2022/4/15 9:00:00,1145,1651,-506
17413,17413,162,2022/4/15 9:10:00,672,1108,-436
17414,17414,162,2022/4/15 9:20:00,668,587,81
17415,17415,162,2022/4/15 9:30:00,579,404,175
17416,17416,162,2022/4/15 9:40:00,587,411,176
17417,17417,162,2022/4/15 9:50:00,381,522,-141
17418,17418,162,2022/4/15 10:00:00,335,487,-152
17419,17419,162,2022/4/15 10:10:00,315,368,-53
17420,17420,162,2022/4/15 10:20:00,434,336,98
17421,17421,162,2022/4/15 10:30:00,370,325,45
17422,17422,162,2022/4/15 10:40:00,343,337,6
17423,17423,162,2022/4/15 10:50:00,311,260,51
17424,17424,162,2022/4/15 11:00:00,348,324,24
17425,17425,162,2022/4/15 11:10:00,264,321,-57
17426,17426,162,2022/4/15 11:20:00,267,290,-23
17427,17427,162,2022/4/15 11:30:00,267,274,-7
17428,17428,162,2022/4/15 11:40:00,343,232,111
17429,17429,162,2022/4/15 11:50:00,334,275,59
17430,17430,162,2022/4/15 12:00:00,291,268,23
17431,17431,162,2022/4/15 12:10:00,327,296,31
17432,17432,162,2022/4/15 12:20:00,325,311,14
17433,17433,162,2022/4/15 12:30:00,306,307,-1
17434,17434,162,2022/4/15 12:40:00,357,469,-112
17435,17435,162,2022/4/15 12:50:00,312,292,20
17436,17436,162,2022/4/15 13:00:00,261,367,-106
17437,17437,162,2022/4/15 13:10:00,307,304,3
17438,17438,162,2022/4/15 13:20:00,318,273,45
17439,17439,162,2022/4/15 13:30:00,270,313,-43
17440,17440,162,2022/4/15 13:40:00,300,304,-4
17441,17441,162,2022/4/15 13:50:00,461,274,187
17442,17442,162,2022/4/15 14:00:00,290,276,14
17443,17443,162,2022/4/15 14:10:00,265,297,-32
17444,17444,162,2022/4/15 14:20:00,329,291,38
17445,17445,162,2022/4/15 14:30:00,272,300,-28
17446,17446,162,2022/4/15 14:40:00,313,289,24
17447,17447,162,2022/4/15 14:50:00,333,293,40
17448,17448,162,2022/4/15 15:00:00,269,296,-27
17449,17449,162,2022/4/15 15:10:00,334,288,46
17450,17450,162,2022/4/15 15:20:00,550,359,191
17451,17451,162,2022/4/15 15:30:00,368,291,77
17452,17452,162,2022/4/15 15:40:00,458,273,185
17453,17453,162,2022/4/15 15:50:00,589,468,121
17454,17454,162,2022/4/15 16:00:00,546,307,239
17455,17455,162,2022/4/15 16:10:00,455,315,140
17456,17456,162,2022/4/15 16:20:00,462,463,-1
17457,17457,162,2022/4/15 16:30:00,591,469,122
17458,17458,162,2022/4/15 16:40:00,656,478,178
17459,17459,162,2022/4/15 16:50:00,663,460,203
17460,17460,162,2022/4/15 17:00:00,708,479,229
17461,17461,162,2022/4/15 17:10:00,1139,480,659
17462,17462,162,2022/4/15 17:20:00,1195,570,625
17463,17463,162,2022/4/15 17:30:00,1152,1365,-213
17464,17464,162,2022/4/15 17:40:00,1364,1368,-4
17465,17465,162,2022/4/15 17:50:00,1591,1467,124
17466,17466,162,2022/4/15 18:00:00,1360,1847,-487
17467,17467,162,2022/4/15 18:10:00,1564,1839,-275
17468,17468,162,2022/4/15 18:20:00,1360,1683,-323
17469,17469,162,2022/4/15 18:30:00,1560,1806,-246
17470,17470,162,2022/4/15 18:40:00,1210,1759,-549
17471,17471,162,2022/4/15 18:50:00,1019,931,88
17472,17472,162,2022/4/15 19:00:00,638,568,70
17473,17473,162,2022/4/15 19:10:00,661,415,246
17474,17474,162,2022/4/15 19:20:00,577,474,103
17475,17475,162,2022/4/15 19:30:00,573,322,251
17476,17476,162,2022/4/15 19:40:00,350,320,30
17477,17477,162,2022/4/15 19:50:00,570,242,328
17478,17478,162,2022/4/15 20:00:00,267,214,53
17479,17479,162,2022/4/15 20:10:00,248,292,-44
17480,17480,162,2022/4/15 20:20:00,205,176,29
17481,17481,162,2022/4/15 20:30:00,263,198,65
17482,17482,162,2022/4/15 20:40:00,254,198,56
17483,17483,162,2022/4/15 20:50:00,267,181,86
17484,17484,162,2022/4/15 21:00:00,170,186,-16
17485,17485,162,2022/4/15 21:10:00,212,234,-22
17486,17486,162,2022/4/15 21:20:00,172,208,-36
17487,17487,162,2022/4/15 21:30:00,167,155,12
17488,17488,162,2022/4/15 21:40:00,145,234,-89
17489,17489,162,2022/4/15 21:50:00,167,147,20
17490,17490,162,2022/4/15 22:00:00,120,108,12
17491,17491,162,2022/4/15 22:10:00,77,146,-69
17492,17492,162,2022/4/15 22:20:00,62,149,-87
17493,17493,162,2022/4/15 22:30:00,49,119,-70
17494,17494,162,2022/4/15 22:40:00,34,98,-64
17495,17495,162,2022/4/15 22:50:00,25,72,-47
17496,17496,163,2022/4/15 5:00:00,16,1,15
17497,17497,163,2022/4/15 5:10:00,31,1,30
17498,17498,163,2022/4/15 5:20:00,26,1,25
17499,17499,163,2022/4/15 5:30:00,28,1,27
17500,17500,163,2022/4/15 5:40:00,31,6,25
17501,17501,163,2022/4/15 5:50:00,29,23,6
17502,17502,163,2022/4/15 6:00:00,41,23,18
17503,17503,163,2022/4/15 6:10:00,57,34,23
17504,17504,163,2022/4/15 6:20:00,155,64,91
17505,17505,163,2022/4/15 6:30:00,201,114,87
17506,17506,163,2022/4/15 6:40:00,278,120,158
17507,17507,163,2022/4/15 6:50:00,276,111,165
17508,17508,163,2022/4/15 7:00:00,661,182,479
17509,17509,163,2022/4/15 7:10:00,602,111,491
17510,17510,163,2022/4/15 7:20:00,1382,208,1174
17511,17511,163,2022/4/15 7:30:00,1574,300,1274
17512,17512,163,2022/4/15 7:40:00,1981,233,1748
17513,17513,163,2022/4/15 7:50:00,2000,198,1802
17514,17514,163,2022/4/15 8:00:00,2058,196,1862
17515,17515,163,2022/4/15 8:10:00,1984,208,1776
17516,17516,163,2022/4/15 8:20:00,1975,198,1777
17517,17517,163,2022/4/15 8:30:00,2059,181,1878
17518,17518,163,2022/4/15 8:40:00,1175,197,978
17519,17519,163,2022/4/15 8:50:00,822,214,608
17520,17520,163,2022/4/15 9:00:00,1155,178,977
17521,17521,163,2022/4/15 9:10:00,585,181,404
17522,17522,163,2022/4/15 9:20:00,653,150,503
17523,17523,163,2022/4/15 9:30:00,349,151,198
17524,17524,163,2022/4/15 9:40:00,234,119,115
17525,17525,163,2022/4/15 9:50:00,209,118,91
17526,17526,163,2022/4/15 10:00:00,160,123,37
17527,17527,163,2022/4/15 10:10:00,316,110,206
17528,17528,163,2022/4/15 10:20:00,165,108,57
17529,17529,163,2022/4/15 10:30:00,164,107,57
17530,17530,163,2022/4/15 10:40:00,172,118,54
17531,17531,163,2022/4/15 10:50:00,172,122,50
17532,17532,163,2022/4/15 11:00:00,212,120,92
17533,17533,163,2022/4/15 11:10:00,141,121,20
17534,17534,163,2022/4/15 11:20:00,136,120,16
17535,17535,163,2022/4/15 11:30:00,129,117,12
17536,17536,163,2022/4/15 11:40:00,126,110,16
17537,17537,163,2022/4/15 11:50:00,207,106,101
17538,17538,163,2022/4/15 12:00:00,177,118,59
17539,17539,163,2022/4/15 12:10:00,158,117,41
17540,17540,163,2022/4/15 12:20:00,220,114,106
17541,17541,163,2022/4/15 12:30:00,267,152,115
17542,17542,163,2022/4/15 12:40:00,173,140,33
17543,17543,163,2022/4/15 12:50:00,206,149,57
17544,17544,163,2022/4/15 13:00:00,194,126,68
17545,17545,163,2022/4/15 13:10:00,173,103,70
17546,17546,163,2022/4/15 13:20:00,151,166,-15
17547,17547,163,2022/4/15 13:30:00,198,120,78
17548,17548,163,2022/4/15 13:40:00,110,185,-75
17549,17549,163,2022/4/15 13:50:00,184,124,60
17550,17550,163,2022/4/15 14:00:00,158,151,7
17551,17551,163,2022/4/15 14:10:00,146,143,3
17552,17552,163,2022/4/15 14:20:00,125,118,7
17553,17553,163,2022/4/15 14:30:00,142,194,-52
17554,17554,163,2022/4/15 14:40:00,82,149,-67
17555,17555,163,2022/4/15 14:50:00,125,191,-66
17556,17556,163,2022/4/15 15:00:00,144,145,-1
17557,17557,163,2022/4/15 15:10:00,142,206,-64
17558,17558,163,2022/4/15 15:20:00,130,172,-42
17559,17559,163,2022/4/15 15:30:00,266,152,114
17560,17560,163,2022/4/15 15:40:00,118,295,-177
17561,17561,163,2022/4/15 15:50:00,258,197,61
17562,17562,163,2022/4/15 16:00:00,214,263,-49
17563,17563,163,2022/4/15 16:10:00,253,275,-22
17564,17564,163,2022/4/15 16:20:00,183,296,-113
17565,17565,163,2022/4/15 16:30:00,195,303,-108
17566,17566,163,2022/4/15 16:40:00,268,261,7
17567,17567,163,2022/4/15 16:50:00,267,470,-203
17568,17568,163,2022/4/15 17:00:00,270,307,-37
17569,17569,163,2022/4/15 17:10:00,333,484,-151
17570,17570,163,2022/4/15 17:20:00,264,411,-147
17571,17571,163,2022/4/15 17:30:00,327,473,-146
17572,17572,163,2022/4/15 17:40:00,255,582,-327
17573,17573,163,2022/4/15 17:50:00,237,1142,-905
17574,17574,163,2022/4/15 18:00:00,274,1567,-1293
17575,17575,163,2022/4/15 18:10:00,216,1061,-845
17576,17576,163,2022/4/15 18:20:00,191,1070,-879
17577,17577,163,2022/4/15 18:30:00,225,1996,-1771
17578,17578,163,2022/4/15 18:40:00,231,1530,-1299
17579,17579,163,2022/4/15 18:50:00,146,1071,-925
17580,17580,163,2022/4/15 19:00:00,149,480,-331
17581,17581,163,2022/4/15 19:10:00,119,432,-313
17582,17582,163,2022/4/15 19:20:00,64,432,-368
17583,17583,163,2022/4/15 19:30:00,79,522,-443
17584,17584,163,2022/4/15 19:40:00,56,341,-285
17585,17585,163,2022/4/15 19:50:00,68,327,-259
17586,17586,163,2022/4/15 20:00:00,54,209,-155
17587,17587,163,2022/4/15 20:10:00,45,209,-164
17588,17588,163,2022/4/15 20:20:00,82,198,-116
17589,17589,163,2022/4/15 20:30:00,57,146,-89
17590,17590,163,2022/4/15 20:40:00,57,191,-134
17591,17591,163,2022/4/15 20:50:00,57,178,-121
17592,17592,163,2022/4/15 21:00:00,97,153,-56
17593,17593,163,2022/4/15 21:10:00,62,192,-130
17594,17594,163,2022/4/15 21:20:00,45,128,-83
17595,17595,163,2022/4/15 21:30:00,37,117,-80
17596,17596,163,2022/4/15 21:40:00,28,193,-165
17597,17597,163,2022/4/15 21:50:00,25,117,-92
17598,17598,163,2022/4/15 22:00:00,25,126,-101
17599,17599,163,2022/4/15 22:10:00,25,125,-100
17600,17600,163,2022/4/15 22:20:00,21,115,-94
17601,17601,163,2022/4/15 22:30:00,13,122,-109
17602,17602,163,2022/4/15 22:40:00,1,103,-102
17603,17603,163,2022/4/15 22:50:00,1,111,-110
17604,17604,164,2022/4/15 5:00:00,0,1,-1
17605,17605,164,2022/4/15 5:10:00,3,1,2
17606,17606,164,2022/4/15 5:20:00,10,1,9
17607,17607,164,2022/4/15 5:30:00,13,1,12
17608,17608,164,2022/4/15 5:40:00,16,1,15
17609,17609,164,2022/4/15 5:50:00,19,1,18
17610,17610,164,2022/4/15 6:00:00,29,1,28
17611,17611,164,2022/4/15 6:10:00,30,6,24
17612,17612,164,2022/4/15 6:20:00,57,12,45
17613,17613,164,2022/4/15 6:30:00,55,51,4
17614,17614,164,2022/4/15 6:40:00,88,84,4
17615,17615,164,2022/4/15 6:50:00,143,88,55
17616,17616,164,2022/4/15 7:00:00,171,91,80
17617,17617,164,2022/4/15 7:10:00,187,134,53
17618,17618,164,2022/4/15 7:20:00,182,109,73
17619,17619,164,2022/4/15 7:30:00,227,111,116
17620,17620,164,2022/4/15 7:40:00,276,100,176
17621,17621,164,2022/4/15 7:50:00,332,102,230
17622,17622,164,2022/4/15 8:00:00,435,110,325
17623,17623,164,2022/4/15 8:10:00,392,169,223
17624,17624,164,2022/4/15 8:20:00,324,104,220
17625,17625,164,2022/4/15 8:30:00,317,110,207
17626,17626,164,2022/4/15 8:40:00,280,110,170
17627,17627,164,2022/4/15 8:50:00,226,109,117
17628,17628,164,2022/4/15 9:00:00,188,121,67
17629,17629,164,2022/4/15 9:10:00,138,104,34
17630,17630,164,2022/4/15 9:20:00,100,102,-2
17631,17631,164,2022/4/15 9:30:00,68,96,-28
17632,17632,164,2022/4/15 9:40:00,45,87,-42
17633,17633,164,2022/4/15 9:50:00,38,94,-56
17634,17634,164,2022/4/15 10:00:00,37,73,-36
17635,17635,164,2022/4/15 10:10:00,36,57,-21
17636,17636,164,2022/4/15 10:20:00,35,80,-45
17637,17637,164,2022/4/15 10:30:00,29,71,-42
17638,17638,164,2022/4/15 10:40:00,36,65,-29
17639,17639,164,2022/4/15 10:50:00,29,65,-36
17640,17640,164,2022/4/15 11:00:00,33,62,-29
17641,17641,164,2022/4/15 11:10:00,32,77,-45
17642,17642,164,2022/4/15 11:20:00,27,70,-43
17643,17643,164,2022/4/15 11:30:00,30,72,-42
17644,17644,164,2022/4/15 11:40:00,25,60,-35
17645,17645,164,2022/4/15 11:50:00,28,67,-39
17646,17646,164,2022/4/15 12:00:00,32,68,-36
17647,17647,164,2022/4/15 12:10:00,39,62,-23
17648,17648,164,2022/4/15 12:20:00,32,84,-52
17649,17649,164,2022/4/15 12:30:00,34,66,-32
17650,17650,164,2022/4/15 12:40:00,30,65,-35
17651,17651,164,2022/4/15 12:50:00,30,81,-51
17652,17652,164,2022/4/15 13:00:00,32,71,-39
17653,17653,164,2022/4/15 13:10:00,31,88,-57
17654,17654,164,2022/4/15 13:20:00,34,59,-25
17655,17655,164,2022/4/15 13:30:00,31,76,-45
17656,17656,164,2022/4/15 13:40:00,27,73,-46
17657,17657,164,2022/4/15 13:50:00,32,77,-45
17658,17658,164,2022/4/15 14:00:00,25,72,-47
17659,17659,164,2022/4/15 14:10:00,35,71,-36
17660,17660,164,2022/4/15 14:20:00,32,77,-45
17661,17661,164,2022/4/15 14:30:00,41,68,-27
17662,17662,164,2022/4/15 14:40:00,44,78,-34
17663,17663,164,2022/4/15 14:50:00,44,69,-25
17664,17664,164,2022/4/15 15:00:00,44,64,-20
17665,17665,164,2022/4/15 15:10:00,42,77,-35
17666,17666,164,2022/4/15 15:20:00,44,65,-21
17667,17667,164,2022/4/15 15:30:00,60,82,-22
17668,17668,164,2022/4/15 15:40:00,43,70,-27
17669,17669,164,2022/4/15 15:50:00,42,97,-55
17670,17670,164,2022/4/15 16:00:00,43,75,-32
17671,17671,164,2022/4/15 16:10:00,43,77,-34
17672,17672,164,2022/4/15 16:20:00,52,101,-49
17673,17673,164,2022/4/15 16:30:00,72,92,-20
17674,17674,164,2022/4/15 16:40:00,73,91,-18
17675,17675,164,2022/4/15 16:50:00,67,97,-30
17676,17676,164,2022/4/15 17:00:00,77,108,-31
17677,17677,164,2022/4/15 17:10:00,132,111,21
17678,17678,164,2022/4/15 17:20:00,90,114,-24
17679,17679,164,2022/4/15 17:30:00,74,123,-49
17680,17680,164,2022/4/15 17:40:00,102,136,-34
17681,17681,164,2022/4/15 17:50:00,85,129,-44
17682,17682,164,2022/4/15 18:00:00,59,214,-155
17683,17683,164,2022/4/15 18:10:00,127,184,-57
17684,17684,164,2022/4/15 18:20:00,89,227,-138
17685,17685,164,2022/4/15 18:30:00,66,180,-114
17686,17686,164,2022/4/15 18:40:00,45,215,-170
17687,17687,164,2022/4/15 18:50:00,33,153,-120
17688,17688,164,2022/4/15 19:00:00,33,133,-100
17689,17689,164,2022/4/15 19:10:00,32,121,-89
17690,17690,164,2022/4/15 19:20:00,25,126,-101
17691,17691,164,2022/4/15 19:30:00,26,114,-88
17692,17692,164,2022/4/15 19:40:00,24,114,-90
17693,17693,164,2022/4/15 19:50:00,23,95,-72
17694,17694,164,2022/4/15 20:00:00,23,95,-72
17695,17695,164,2022/4/15 20:10:00,21,93,-72
17696,17696,164,2022/4/15 20:20:00,20,77,-57
17697,17697,164,2022/4/15 20:30:00,19,78,-59
17698,17698,164,2022/4/15 20:40:00,20,95,-75
17699,17699,164,2022/4/15 20:50:00,22,79,-57
17700,17700,164,2022/4/15 21:00:00,18,92,-74
17701,17701,164,2022/4/15 21:10:00,21,88,-67
17702,17702,164,2022/4/15 21:20:00,20,66,-46
17703,17703,164,2022/4/15 21:30:00,15,83,-68
17704,17704,164,2022/4/15 21:40:00,13,99,-86
17705,17705,164,2022/4/15 21:50:00,12,73,-61
17706,17706,164,2022/4/15 22:00:00,10,81,-71
17707,17707,164,2022/4/15 22:10:00,13,73,-60
17708,17708,164,2022/4/15 22:20:00,9,69,-60
17709,17709,164,2022/4/15 22:30:00,2,70,-68
17710,17710,164,2022/4/15 22:40:00,0,66,-66
17711,17711,164,2022/4/15 22:50:00,0,35,-35
17712,17712,165,2022/4/15 5:00:00,0,1,-1
17713,17713,165,2022/4/15 5:10:00,0,1,-1
17714,17714,165,2022/4/15 5:20:00,22,1,21
17715,17715,165,2022/4/15 5:30:00,16,1,15
17716,17716,165,2022/4/15 5:40:00,27,1,26
17717,17717,165,2022/4/15 5:50:00,30,1,29
17718,17718,165,2022/4/15 6:00:00,32,1,31
17719,17719,165,2022/4/15 6:10:00,36,6,30
17720,17720,165,2022/4/15 6:20:00,49,45,4
17721,17721,165,2022/4/15 6:30:00,47,40,7
17722,17722,165,2022/4/15 6:40:00,87,2,85
17723,17723,165,2022/4/15 6:50:00,106,61,45
17724,17724,165,2022/4/15 7:00:00,106,72,34
17725,17725,165,2022/4/15 7:10:00,254,13,241
17726,17726,165,2022/4/15 7:20:00,215,87,128
17727,17727,165,2022/4/15 7:30:00,222,100,122
17728,17728,165,2022/4/15 7:40:00,254,35,219
17729,17729,165,2022/4/15 7:50:00,233,112,121
17730,17730,165,2022/4/15 8:00:00,103,112,-9
17731,17731,165,2022/4/15 8:10:00,151,48,103
17732,17732,165,2022/4/15 8:20:00,73,120,-47
17733,17733,165,2022/4/15 8:30:00,48,105,-57
17734,17734,165,2022/4/15 8:40:00,56,15,41
17735,17735,165,2022/4/15 8:50:00,31,82,-51
17736,17736,165,2022/4/15 9:00:00,28,70,-42
17737,17737,165,2022/4/15 9:10:00,31,32,-1
17738,17738,165,2022/4/15 9:20:00,25,84,-59
17739,17739,165,2022/4/15 9:30:00,28,70,-42
17740,17740,165,2022/4/15 9:40:00,28,12,16
17741,17741,165,2022/4/15 9:50:00,20,74,-54
17742,17742,165,2022/4/15 10:00:00,23,59,-36
17743,17743,165,2022/4/15 10:10:00,22,60,-38
17744,17744,165,2022/4/15 10:20:00,20,27,-7
17745,17745,165,2022/4/15 10:30:00,21,34,-13
17746,17746,165,2022/4/15 10:40:00,21,57,-36
17747,17747,165,2022/4/15 10:50:00,17,48,-31
17748,17748,165,2022/4/15 11:00:00,19,44,-25
17749,17749,165,2022/4/15 11:10:00,21,31,-10
17750,17750,165,2022/4/15 11:20:00,24,52,-28
17751,17751,165,2022/4/15 11:30:00,22,31,-9
17752,17752,165,2022/4/15 11:40:00,22,36,-14
17753,17753,165,2022/4/15 11:50:00,28,51,-23
17754,17754,165,2022/4/15 12:00:00,26,57,-31
17755,17755,165,2022/4/15 12:10:00,23,22,1
17756,17756,165,2022/4/15 12:20:00,27,50,-23
17757,17757,165,2022/4/15 12:30:00,24,61,-37
17758,17758,165,2022/4/15 12:40:00,25,59,-34
17759,17759,165,2022/4/15 12:50:00,24,18,6
17760,17760,165,2022/4/15 13:00:00,23,65,-42
17761,17761,165,2022/4/15 13:10:00,22,61,-39
17762,17762,165,2022/4/15 13:20:00,26,23,3
17763,17763,165,2022/4/15 13:30:00,21,53,-32
17764,17764,165,2022/4/15 13:40:00,21,62,-41
17765,17765,165,2022/4/15 13:50:00,21,68,-47
17766,17766,165,2022/4/15 14:00:00,19,12,7
17767,17767,165,2022/4/15 14:10:00,19,68,-49
17768,17768,165,2022/4/15 14:20:00,21,70,-49
17769,17769,165,2022/4/15 14:30:00,25,19,6
17770,17770,165,2022/4/15 14:40:00,22,63,-41
17771,17771,165,2022/4/15 14:50:00,25,66,-41
17772,17772,165,2022/4/15 15:00:00,24,60,-36
17773,17773,165,2022/4/15 15:10:00,25,20,5
17774,17774,165,2022/4/15 15:20:00,26,69,-43
17775,17775,165,2022/4/15 15:30:00,21,77,-56
17776,17776,165,2022/4/15 15:40:00,23,62,-39
17777,17777,165,2022/4/15 15:50:00,25,47,-22
17778,17778,165,2022/4/15 16:00:00,26,78,-52
17779,17779,165,2022/4/15 16:10:00,27,81,-54
17780,17780,165,2022/4/15 16:20:00,30,19,11
17781,17781,165,2022/4/15 16:30:00,40,82,-42
17782,17782,165,2022/4/15 16:40:00,34,77,-43
17783,17783,165,2022/4/15 16:50:00,36,87,-51
17784,17784,165,2022/4/15 17:00:00,105,25,80
17785,17785,165,2022/4/15 17:10:00,38,108,-70
17786,17786,165,2022/4/15 17:20:00,46,109,-63
17787,17787,165,2022/4/15 17:30:00,32,7,25
17788,17788,165,2022/4/15 17:40:00,29,119,-90
17789,17789,165,2022/4/15 17:50:00,28,100,-72
17790,17790,165,2022/4/15 18:00:00,26,30,-4
17791,17791,165,2022/4/15 18:10:00,25,119,-94
17792,17792,165,2022/4/15 18:20:00,22,103,-81
17793,17793,165,2022/4/15 18:30:00,18,53,-35
17794,17794,165,2022/4/15 18:40:00,17,143,-126
17795,17795,165,2022/4/15 18:50:00,20,103,-83
17796,17796,165,2022/4/15 19:00:00,13,66,-53
17797,17797,165,2022/4/15 19:10:00,14,116,-102
17798,17798,165,2022/4/15 19:20:00,12,102,-90
17799,17799,165,2022/4/15 19:30:00,11,51,-40
17800,17800,165,2022/4/15 19:40:00,13,107,-94
17801,17801,165,2022/4/15 19:50:00,13,92,-79
17802,17802,165,2022/4/15 20:00:00,13,83,-70
17803,17803,165,2022/4/15 20:10:00,10,73,-63
17804,17804,165,2022/4/15 20:20:00,14,10,4
17805,17805,165,2022/4/15 20:30:00,11,79,-68
17806,17806,165,2022/4/15 20:40:00,14,87,-73
17807,17807,165,2022/4/15 20:50:00,13,6,7
17808,17808,165,2022/4/15 21:00:00,10,80,-70
17809,17809,165,2022/4/15 21:10:00,11,77,-66
17810,17810,165,2022/4/15 21:20:00,9,13,-4
17811,17811,165,2022/4/15 21:30:00,9,72,-63
17812,17812,165,2022/4/15 21:40:00,11,69,-58
17813,17813,165,2022/4/15 21:50:00,19,7,12
17814,17814,165,2022/4/15 22:00:00,12,75,-63
17815,17815,165,2022/4/15 22:10:00,8,71,-63
17816,17816,165,2022/4/15 22:20:00,6,4,2
17817,17817,165,2022/4/15 22:30:00,3,67,-64
17818,17818,165,2022/4/15 22:40:00,2,55,-53
17819,17819,165,2022/4/15 22:50:00,0,35,-35
17820,17820,166,2022/4/15 5:00:00,0,1,-1
17821,17821,166,2022/4/15 5:10:00,0,1,-1
17822,17822,166,2022/4/15 5:20:00,21,1,20
17823,17823,166,2022/4/15 5:30:00,21,2,19
17824,17824,166,2022/4/15 5:40:00,27,1,26
17825,17825,166,2022/4/15 5:50:00,27,1,26
17826,17826,166,2022/4/15 6:00:00,33,5,28
17827,17827,166,2022/4/15 6:10:00,32,5,27
17828,17828,166,2022/4/15 6:20:00,54,41,13
17829,17829,166,2022/4/15 6:30:00,67,42,25
17830,17830,166,2022/4/15 6:40:00,79,47,32
17831,17831,166,2022/4/15 6:50:00,98,38,60
17832,17832,166,2022/4/15 7:00:00,215,93,122
17833,17833,166,2022/4/15 7:10:00,247,55,192
17834,17834,166,2022/4/15 7:20:00,199,75,124
17835,17835,166,2022/4/15 7:30:00,236,107,129
17836,17836,166,2022/4/15 7:40:00,285,88,197
17837,17837,166,2022/4/15 7:50:00,222,57,165
17838,17838,166,2022/4/15 8:00:00,176,117,59
17839,17839,166,2022/4/15 8:10:00,188,81,107
17840,17840,166,2022/4/15 8:20:00,79,105,-26
17841,17841,166,2022/4/15 8:30:00,80,119,-39
17842,17842,166,2022/4/15 8:40:00,61,71,-10
17843,17843,166,2022/4/15 8:50:00,45,102,-57
17844,17844,166,2022/4/15 9:00:00,46,111,-65
17845,17845,166,2022/4/15 9:10:00,29,59,-30
17846,17846,166,2022/4/15 9:20:00,36,93,-57
17847,17847,166,2022/4/15 9:30:00,27,91,-64
17848,17848,166,2022/4/15 9:40:00,32,58,-26
17849,17849,166,2022/4/15 9:50:00,26,74,-48
17850,17850,166,2022/4/15 10:00:00,32,75,-43
17851,17851,166,2022/4/15 10:10:00,27,73,-46
17852,17852,166,2022/4/15 10:20:00,27,71,-44
17853,17853,166,2022/4/15 10:30:00,27,21,6
17854,17854,166,2022/4/15 10:40:00,28,85,-57
17855,17855,166,2022/4/15 10:50:00,27,67,-40
17856,17856,166,2022/4/15 11:00:00,30,77,-47
17857,17857,166,2022/4/15 11:10:00,27,15,12
17858,17858,166,2022/4/15 11:20:00,25,85,-60
17859,17859,166,2022/4/15 11:30:00,30,71,-41
17860,17860,166,2022/4/15 11:40:00,32,51,-19
17861,17861,166,2022/4/15 11:50:00,29,48,-19
17862,17862,166,2022/4/15 12:00:00,29,65,-36
17863,17863,166,2022/4/15 12:10:00,31,69,-38
17864,17864,166,2022/4/15 12:20:00,25,19,6
17865,17865,166,2022/4/15 12:30:00,29,82,-53
17866,17866,166,2022/4/15 12:40:00,24,77,-53
17867,17867,166,2022/4/15 12:50:00,25,39,-14
17868,17868,166,2022/4/15 13:00:00,24,84,-60
17869,17869,166,2022/4/15 13:10:00,27,77,-50
17870,17870,166,2022/4/15 13:20:00,30,78,-48
17871,17871,166,2022/4/15 13:30:00,28,21,7
17872,17872,166,2022/4/15 13:40:00,28,79,-51
17873,17873,166,2022/4/15 13:50:00,27,80,-53
17874,17874,166,2022/4/15 14:00:00,32,39,-7
17875,17875,166,2022/4/15 14:10:00,27,81,-54
17876,17876,166,2022/4/15 14:20:00,27,97,-70
17877,17877,166,2022/4/15 14:30:00,25,76,-51
17878,17878,166,2022/4/15 14:40:00,24,27,-3
17879,17879,166,2022/4/15 14:50:00,26,90,-64
17880,17880,166,2022/4/15 15:00:00,29,75,-46
17881,17881,166,2022/4/15 15:10:00,22,37,-15
17882,17882,166,2022/4/15 15:20:00,25,75,-50
17883,17883,166,2022/4/15 15:30:00,35,90,-55
17884,17884,166,2022/4/15 15:40:00,28,96,-68
17885,17885,166,2022/4/15 15:50:00,26,19,7
17886,17886,166,2022/4/15 16:00:00,36,99,-63
17887,17887,166,2022/4/15 16:10:00,35,108,-73
17888,17888,166,2022/4/15 16:20:00,38,72,-34
17889,17889,166,2022/4/15 16:30:00,41,45,-4
17890,17890,166,2022/4/15 16:40:00,45,101,-56
17891,17891,166,2022/4/15 16:50:00,40,104,-64
17892,17892,166,2022/4/15 17:00:00,48,67,-19
17893,17893,166,2022/4/15 17:10:00,44,107,-63
17894,17894,166,2022/4/15 17:20:00,47,118,-71
17895,17895,166,2022/4/15 17:30:00,42,68,-26
17896,17896,166,2022/4/15 17:40:00,38,124,-86
17897,17897,166,2022/4/15 17:50:00,36,110,-74
17898,17898,166,2022/4/15 18:00:00,34,68,-34
17899,17899,166,2022/4/15 18:10:00,31,180,-149
17900,17900,166,2022/4/15 18:20:00,32,215,-183
17901,17901,166,2022/4/15 18:30:00,24,31,-7
17902,17902,166,2022/4/15 18:40:00,26,219,-193
17903,17903,166,2022/4/15 18:50:00,27,209,-182
17904,17904,166,2022/4/15 19:00:00,23,23,0
17905,17905,166,2022/4/15 19:10:00,23,234,-211
17906,17906,166,2022/4/15 19:20:00,21,128,-107
17907,17907,166,2022/4/15 19:30:00,17,67,-50
17908,17908,166,2022/4/15 19:40:00,16,122,-106
17909,17909,166,2022/4/15 19:50:00,17,125,-108
17910,17910,166,2022/4/15 20:00:00,19,83,-64
17911,17911,166,2022/4/15 20:10:00,17,94,-77
17912,17912,166,2022/4/15 20:20:00,17,78,-61
17913,17913,166,2022/4/15 20:30:00,14,46,-32
17914,17914,166,2022/4/15 20:40:00,17,100,-83
17915,17915,166,2022/4/15 20:50:00,16,95,-79
17916,17916,166,2022/4/15 21:00:00,16,13,3
17917,17917,166,2022/4/15 21:10:00,16,100,-84
17918,17918,166,2022/4/15 21:20:00,15,76,-61
17919,17919,166,2022/4/15 21:30:00,15,14,1
17920,17920,166,2022/4/15 21:40:00,12,97,-85
17921,17921,166,2022/4/15 21:50:00,10,76,-66
17922,17922,166,2022/4/15 22:00:00,12,33,-21
17923,17923,166,2022/4/15 22:10:00,10,93,-83
17924,17924,166,2022/4/15 22:20:00,7,75,-68
17925,17925,166,2022/4/15 22:30:00,3,62,-59
17926,17926,166,2022/4/15 22:40:00,2,70,-68
17927,17927,166,2022/4/15 22:50:00,0,70,-70
17928,17928,167,2022/4/15 5:00:00,0,1,-1
17929,17929,167,2022/4/15 5:10:00,0,1,-1
17930,17930,167,2022/4/15 5:20:00,6,1,5
17931,17931,167,2022/4/15 5:30:00,24,1,23
17932,17932,167,2022/4/15 5:40:00,16,1,15
17933,17933,167,2022/4/15 5:50:00,20,5,15
17934,17934,167,2022/4/15 6:00:00,29,1,28
17935,17935,167,2022/4/15 6:10:00,32,19,13
17936,17936,167,2022/4/15 6:20:00,53,14,39
17937,17937,167,2022/4/15 6:30:00,55,19,36
17938,17938,167,2022/4/15 6:40:00,52,32,20
17939,17939,167,2022/4/15 6:50:00,101,14,87
17940,17940,167,2022/4/15 7:00:00,156,46,110
17941,17941,167,2022/4/15 7:10:00,87,84,3
17942,17942,167,2022/4/15 7:20:00,180,64,116
17943,17943,167,2022/4/15 7:30:00,199,39,160
17944,17944,167,2022/4/15 7:40:00,146,77,69
17945,17945,167,2022/4/15 7:50:00,149,61,88
17946,17946,167,2022/4/15 8:00:00,162,20,142
17947,17947,167,2022/4/15 8:10:00,69,66,3
17948,17948,167,2022/4/15 8:20:00,71,48,23
17949,17949,167,2022/4/15 8:30:00,57,68,-11
17950,17950,167,2022/4/15 8:40:00,32,77,-45
17951,17951,167,2022/4/15 8:50:00,40,29,11
17952,17952,167,2022/4/15 9:00:00,30,66,-36
17953,17953,167,2022/4/15 9:10:00,26,63,-37
17954,17954,167,2022/4/15 9:20:00,26,16,10
17955,17955,167,2022/4/15 9:30:00,19,50,-31
17956,17956,167,2022/4/15 9:40:00,21,46,-25
17957,17957,167,2022/4/15 9:50:00,18,19,-1
17958,17958,167,2022/4/15 10:00:00,16,45,-29
17959,17959,167,2022/4/15 10:10:00,14,32,-18
17960,17960,167,2022/4/15 10:20:00,15,38,-23
17961,17961,167,2022/4/15 10:30:00,16,38,-22
17962,17962,167,2022/4/15 10:40:00,14,25,-11
17963,17963,167,2022/4/15 10:50:00,16,12,4
17964,17964,167,2022/4/15 11:00:00,15,38,-23
17965,17965,167,2022/4/15 11:10:00,16,35,-19
17966,17966,167,2022/4/15 11:20:00,13,10,3
17967,17967,167,2022/4/15 11:30:00,15,38,-23
17968,17968,167,2022/4/15 11:40:00,17,33,-16
17969,17969,167,2022/4/15 11:50:00,15,29,-14
17970,17970,167,2022/4/15 12:00:00,15,18,-3
17971,17971,167,2022/4/15 12:10:00,18,38,-20
17972,17972,167,2022/4/15 12:20:00,17,37,-20
17973,17973,167,2022/4/15 12:30:00,16,7,9
17974,17974,167,2022/4/15 12:40:00,15,38,-23
17975,17975,167,2022/4/15 12:50:00,15,44,-29
17976,17976,167,2022/4/15 13:00:00,15,31,-16
17977,17977,167,2022/4/15 13:10:00,15,20,-5
17978,17978,167,2022/4/15 13:20:00,14,44,-30
17979,17979,167,2022/4/15 13:30:00,12,40,-28
17980,17980,167,2022/4/15 13:40:00,18,8,10
17981,17981,167,2022/4/15 13:50:00,19,47,-28
17982,17982,167,2022/4/15 14:00:00,18,44,-26
17983,17983,167,2022/4/15 14:10:00,13,33,-20
17984,17984,167,2022/4/15 14:20:00,12,21,-9
17985,17985,167,2022/4/15 14:30:00,13,45,-32
17986,17986,167,2022/4/15 14:40:00,13,44,-31
17987,17987,167,2022/4/15 14:50:00,11,17,-6
17988,17988,167,2022/4/15 15:00:00,12,45,-33
17989,17989,167,2022/4/15 15:10:00,15,50,-35
17990,17990,167,2022/4/15 15:20:00,25,32,-7
17991,17991,167,2022/4/15 15:30:00,28,35,-7
17992,17992,167,2022/4/15 15:40:00,21,69,-48
17993,17993,167,2022/4/15 15:50:00,17,65,-48
17994,17994,167,2022/4/15 16:00:00,22,5,17
17995,17995,167,2022/4/15 16:10:00,22,73,-51
17996,17996,167,2022/4/15 16:20:00,21,71,-50
17997,17997,167,2022/4/15 16:30:00,22,71,-49
17998,17998,167,2022/4/15 16:40:00,16,31,-15
17999,17999,167,2022/4/15 16:50:00,18,69,-51
18000,18000,167,2022/4/15 17:00:00,20,76,-56
18001,18001,167,2022/4/15 17:10:00,20,40,-20
18002,18002,167,2022/4/15 17:20:00,24,76,-52
18003,18003,167,2022/4/15 17:30:00,17,99,-82
18004,18004,167,2022/4/15 17:40:00,26,20,6
18005,18005,167,2022/4/15 17:50:00,24,103,-79
18006,18006,167,2022/4/15 18:00:00,15,122,-107
18007,18007,167,2022/4/15 18:10:00,20,19,1
18008,18008,167,2022/4/15 18:20:00,28,105,-77
18009,18009,167,2022/4/15 18:30:00,16,110,-94
18010,18010,167,2022/4/15 18:40:00,17,25,-8
18011,18011,167,2022/4/15 18:50:00,17,110,-93
18012,18012,167,2022/4/15 19:00:00,11,111,-100
18013,18013,167,2022/4/15 19:10:00,10,27,-17
18014,18014,167,2022/4/15 19:20:00,9,114,-105
18015,18015,167,2022/4/15 19:30:00,11,110,-99
18016,18016,167,2022/4/15 19:40:00,6,43,-37
18017,18017,167,2022/4/15 19:50:00,9,78,-69
18018,18018,167,2022/4/15 20:00:00,7,71,-64
18019,18019,167,2022/4/15 20:10:00,7,59,-52
18020,18020,167,2022/4/15 20:20:00,7,77,-70
18021,18021,167,2022/4/15 20:30:00,7,69,-62
18022,18022,167,2022/4/15 20:40:00,6,21,-15
18023,18023,167,2022/4/15 20:50:00,5,85,-80
18024,18024,167,2022/4/15 21:00:00,6,73,-67
18025,18025,167,2022/4/15 21:10:00,6,13,-7
18026,18026,167,2022/4/15 21:20:00,5,71,-66
18027,18027,167,2022/4/15 21:30:00,5,67,-62
18028,18028,167,2022/4/15 21:40:00,6,15,-9
18029,18029,167,2022/4/15 21:50:00,5,74,-69
18030,18030,167,2022/4/15 22:00:00,5,66,-61
18031,18031,167,2022/4/15 22:10:00,2,13,-11
18032,18032,167,2022/4/15 22:20:00,3,70,-67
18033,18033,167,2022/4/15 22:30:00,1,48,-47
18034,18034,167,2022/4/15 22:40:00,1,50,-49
18035,18035,167,2022/4/15 22:50:00,0,66,-66
18036,18036,168,2022/4/15 5:00:00,0,1,-1
18037,18037,168,2022/4/15 5:10:00,3,1,2
18038,18038,168,2022/4/15 5:20:00,4,1,3
18039,18039,168,2022/4/15 5:30:00,5,1,4
18040,18040,168,2022/4/15 5:40:00,4,1,3
18041,18041,168,2022/4/15 5:50:00,6,1,5
18042,18042,168,2022/4/15 6:00:00,5,1,4
18043,18043,168,2022/4/15 6:10:00,16,1,15
18044,18044,168,2022/4/15 6:20:00,17,5,12
18045,18045,168,2022/4/15 6:30:00,20,55,-35
18046,18046,168,2022/4/15 6:40:00,27,69,-42
18047,18047,168,2022/4/15 6:50:00,34,101,-67
18048,18048,168,2022/4/15 7:00:00,39,18,21
18049,18049,168,2022/4/15 7:10:00,29,87,-58
18050,18050,168,2022/4/15 7:20:00,36,102,-66
18051,18051,168,2022/4/15 7:30:00,36,102,-66
18052,18052,168,2022/4/15 7:40:00,28,198,-170
18053,18053,168,2022/4/15 7:50:00,32,106,-74
18054,18054,168,2022/4/15 8:00:00,32,94,-62
18055,18055,168,2022/4/15 8:10:00,24,299,-275
18056,18056,168,2022/4/15 8:20:00,29,105,-76
18057,18057,168,2022/4/15 8:30:00,24,52,-28
18058,18058,168,2022/4/15 8:40:00,21,93,-72
18059,18059,168,2022/4/15 8:50:00,22,58,-36
18060,18060,168,2022/4/15 9:00:00,14,18,-4
18061,18061,168,2022/4/15 9:10:00,15,65,-50
18062,18062,168,2022/4/15 9:20:00,14,31,-17
18063,18063,168,2022/4/15 9:30:00,13,27,-14
18064,18064,168,2022/4/15 9:40:00,13,46,-33
18065,18065,168,2022/4/15 9:50:00,11,33,-22
18066,18066,168,2022/4/15 10:00:00,10,15,-5
18067,18067,168,2022/4/15 10:10:00,14,29,-15
18068,18068,168,2022/4/15 10:20:00,10,32,-22
18069,18069,168,2022/4/15 10:30:00,15,28,-13
18070,18070,168,2022/4/15 10:40:00,13,1,12
18071,18071,168,2022/4/15 10:50:00,12,25,-13
18072,18072,168,2022/4/15 11:00:00,15,23,-8
18073,18073,168,2022/4/15 11:10:00,20,33,-13
18074,18074,168,2022/4/15 11:20:00,20,1,19
18075,18075,168,2022/4/15 11:30:00,19,34,-15
18076,18076,168,2022/4/15 11:40:00,19,37,-18
18077,18077,168,2022/4/15 11:50:00,18,23,-5
18078,18078,168,2022/4/15 12:00:00,17,1,16
18079,18079,168,2022/4/15 12:10:00,18,36,-18
18080,18080,168,2022/4/15 12:20:00,17,35,-18
18081,18081,168,2022/4/15 12:30:00,16,1,15
18082,18082,168,2022/4/15 12:40:00,19,35,-16
18083,18083,168,2022/4/15 12:50:00,17,29,-12
18084,18084,168,2022/4/15 13:00:00,16,30,-14
18085,18085,168,2022/4/15 13:10:00,17,5,12
18086,18086,168,2022/4/15 13:20:00,12,34,-22
18087,18087,168,2022/4/15 13:30:00,13,33,-20
18088,18088,168,2022/4/15 13:40:00,11,1,10
18089,18089,168,2022/4/15 13:50:00,15,29,-14
18090,18090,168,2022/4/15 14:00:00,12,25,-13
18091,18091,168,2022/4/15 14:10:00,12,25,-13
18092,18092,168,2022/4/15 14:20:00,12,2,10
18093,18093,168,2022/4/15 14:30:00,16,23,-7
18094,18094,168,2022/4/15 14:40:00,20,31,-11
18095,18095,168,2022/4/15 14:50:00,20,1,19
18096,18096,168,2022/4/15 15:00:00,18,29,-11
18097,18097,168,2022/4/15 15:10:00,16,30,-14
18098,18098,168,2022/4/15 15:20:00,19,23,-4
18099,18099,168,2022/4/15 15:30:00,22,12,10
18100,18100,168,2022/4/15 15:40:00,23,32,-9
18101,18101,168,2022/4/15 15:50:00,26,38,-12
18102,18102,168,2022/4/15 16:00:00,32,2,30
18103,18103,168,2022/4/15 16:10:00,32,33,-1
18104,18104,168,2022/4/15 16:20:00,31,35,-4
18105,18105,168,2022/4/15 16:30:00,33,35,-2
18106,18106,168,2022/4/15 16:40:00,70,10,60
18107,18107,168,2022/4/15 16:50:00,179,33,146
18108,18108,168,2022/4/15 17:00:00,268,38,230
18109,18109,168,2022/4/15 17:10:00,243,42,201
18110,18110,168,2022/4/15 17:20:00,49,10,39
18111,18111,168,2022/4/15 17:30:00,43,46,-3
18112,18112,168,2022/4/15 17:40:00,31,49,-18
18113,18113,168,2022/4/15 17:50:00,25,10,15
18114,18114,168,2022/4/15 18:00:00,23,55,-32
18115,18115,168,2022/4/15 18:10:00,22,44,-22
18116,18116,168,2022/4/15 18:20:00,18,46,-28
18117,18117,168,2022/4/15 18:30:00,17,73,-56
18118,18118,168,2022/4/15 18:40:00,17,14,3
18119,18119,168,2022/4/15 18:50:00,14,68,-54
18120,18120,168,2022/4/15 19:00:00,12,83,-71
18121,18121,168,2022/4/15 19:10:00,11,6,5
18122,18122,168,2022/4/15 19:20:00,9,75,-66
18123,18123,168,2022/4/15 19:30:00,8,56,-48
18124,18124,168,2022/4/15 19:40:00,8,40,-32
18125,18125,168,2022/4/15 19:50:00,11,19,-8
18126,18126,168,2022/4/15 20:00:00,19,40,-21
18127,18127,168,2022/4/15 20:10:00,21,36,-15
18128,18128,168,2022/4/15 20:20:00,23,33,-10
18129,18129,168,2022/4/15 20:30:00,15,36,-21
18130,18130,168,2022/4/15 20:40:00,13,3,10
18131,18131,168,2022/4/15 20:50:00,8,41,-33
18132,18132,168,2022/4/15 21:00:00,4,34,-30
18133,18133,168,2022/4/15 21:10:00,4,3,1
18134,18134,168,2022/4/15 21:20:00,2,39,-37
18135,18135,168,2022/4/15 21:30:00,1,27,-26
18136,18136,168,2022/4/15 21:40:00,4,7,-3
18137,18137,168,2022/4/15 21:50:00,2,40,-38
18138,18138,168,2022/4/15 22:00:00,2,34,-32
18139,18139,168,2022/4/15 22:10:00,2,7,-5
18140,18140,168,2022/4/15 22:20:00,2,34,-32
18141,18141,168,2022/4/15 22:30:00,0,30,-30
18142,18142,168,2022/4/15 22:40:00,0,21,-21
18143,18143,168,2022/4/15 22:50:00,0,21,-21
18144,18144,169,2022/4/15 5:00:00,0,1,-1
18145,18145,169,2022/4/15 5:10:00,1,1,0
18146,18146,169,2022/4/15 5:20:00,8,1,7
18147,18147,169,2022/4/15 5:30:00,10,5,5
18148,18148,169,2022/4/15 5:40:00,13,6,7
18149,18149,169,2022/4/15 5:50:00,14,2,12
18150,18150,169,2022/4/15 6:00:00,26,16,10
18151,18151,169,2022/4/15 6:10:00,32,22,10
18152,18152,169,2022/4/15 6:20:00,45,69,-24
18153,18153,169,2022/4/15 6:30:00,55,105,-50
18154,18154,169,2022/4/15 6:40:00,65,110,-45
18155,18155,169,2022/4/15 6:50:00,84,109,-25
18156,18156,169,2022/4/15 7:00:00,164,107,57
18157,18157,169,2022/4/15 7:10:00,208,108,100
18158,18158,169,2022/4/15 7:20:00,217,220,-3
18159,18159,169,2022/4/15 7:30:00,227,254,-27
18160,18160,169,2022/4/15 7:40:00,281,504,-223
18161,18161,169,2022/4/15 7:50:00,325,438,-113
18162,18162,169,2022/4/15 8:00:00,475,1164,-689
18163,18163,169,2022/4/15 8:10:00,597,1924,-1327
18164,18164,169,2022/4/15 8:20:00,574,2038,-1464
18165,18165,169,2022/4/15 8:30:00,392,2233,-1841
18166,18166,169,2022/4/15 8:40:00,345,3834,-3489
18167,18167,169,2022/4/15 8:50:00,282,1898,-1616
18168,18168,169,2022/4/15 9:00:00,239,1993,-1754
18169,18169,169,2022/4/15 9:10:00,220,1571,-1351
18170,18170,169,2022/4/15 9:20:00,206,586,-380
18171,18171,169,2022/4/15 9:30:00,172,415,-243
18172,18172,169,2022/4/15 9:40:00,140,493,-353
18173,18173,169,2022/4/15 9:50:00,122,348,-226
18174,18174,169,2022/4/15 10:00:00,82,256,-174
18175,18175,169,2022/4/15 10:10:00,94,180,-86
18176,18176,169,2022/4/15 10:20:00,82,180,-98
18177,18177,169,2022/4/15 10:30:00,89,128,-39
18178,18178,169,2022/4/15 10:40:00,74,105,-31
18179,18179,169,2022/4/15 10:50:00,73,121,-48
18180,18180,169,2022/4/15 11:00:00,71,129,-58
18181,18181,169,2022/4/15 11:10:00,67,122,-55
18182,18182,169,2022/4/15 11:20:00,72,122,-50
18183,18183,169,2022/4/15 11:30:00,84,107,-23
18184,18184,169,2022/4/15 11:40:00,83,100,-17
18185,18185,169,2022/4/15 11:50:00,93,117,-24
18186,18186,169,2022/4/15 12:00:00,102,118,-16
18187,18187,169,2022/4/15 12:10:00,156,125,31
18188,18188,169,2022/4/15 12:20:00,142,113,29
18189,18189,169,2022/4/15 12:30:00,137,121,16
18190,18190,169,2022/4/15 12:40:00,113,131,-18
18191,18191,169,2022/4/15 12:50:00,96,108,-12
18192,18192,169,2022/4/15 13:00:00,131,121,10
18193,18193,169,2022/4/15 13:10:00,132,108,24
18194,18194,169,2022/4/15 13:20:00,174,108,66
18195,18195,169,2022/4/15 13:30:00,128,125,3
18196,18196,169,2022/4/15 13:40:00,113,108,5
18197,18197,169,2022/4/15 13:50:00,94,119,-25
18198,18198,169,2022/4/15 14:00:00,110,109,1
18199,18199,169,2022/4/15 14:10:00,139,110,29
18200,18200,169,2022/4/15 14:20:00,149,102,47
18201,18201,169,2022/4/15 14:30:00,133,113,20
18202,18202,169,2022/4/15 14:40:00,140,121,19
18203,18203,169,2022/4/15 14:50:00,156,116,40
18204,18204,169,2022/4/15 15:00:00,170,118,52
18205,18205,169,2022/4/15 15:10:00,216,124,92
18206,18206,169,2022/4/15 15:20:00,179,116,63
18207,18207,169,2022/4/15 15:30:00,195,116,79
18208,18208,169,2022/4/15 15:40:00,198,112,86
18209,18209,169,2022/4/15 15:50:00,204,118,86
18210,18210,169,2022/4/15 16:00:00,216,103,113
18211,18211,169,2022/4/15 16:10:00,263,109,154
18212,18212,169,2022/4/15 16:20:00,223,110,113
18213,18213,169,2022/4/15 16:30:00,270,125,145
18214,18214,169,2022/4/15 16:40:00,336,122,214
18215,18215,169,2022/4/15 16:50:00,343,139,204
18216,18216,169,2022/4/15 17:00:00,692,108,584
18217,18217,169,2022/4/15 17:10:00,1033,149,884
18218,18218,169,2022/4/15 17:20:00,790,190,600
18219,18219,169,2022/4/15 17:30:00,787,217,570
18220,18220,169,2022/4/15 17:40:00,1626,233,1393
18221,18221,169,2022/4/15 17:50:00,1588,268,1320
18222,18222,169,2022/4/15 18:00:00,1202,301,901
18223,18223,169,2022/4/15 18:10:00,1997,328,1669
18224,18224,169,2022/4/15 18:20:00,1998,299,1699
18225,18225,169,2022/4/15 18:30:00,1155,329,826
18226,18226,169,2022/4/15 18:40:00,710,327,383
18227,18227,169,2022/4/15 18:50:00,608,286,322
18228,18228,169,2022/4/15 19:00:00,375,180,195
18229,18229,169,2022/4/15 19:10:00,336,145,191
18230,18230,169,2022/4/15 19:20:00,271,116,155
18231,18231,169,2022/4/15 19:30:00,244,111,133
18232,18232,169,2022/4/15 19:40:00,217,89,128
18233,18233,169,2022/4/15 19:50:00,199,115,84
18234,18234,169,2022/4/15 20:00:00,187,99,88
18235,18235,169,2022/4/15 20:10:00,203,104,99
18236,18236,169,2022/4/15 20:20:00,205,102,103
18237,18237,169,2022/4/15 20:30:00,190,107,83
18238,18238,169,2022/4/15 20:40:00,161,108,53
18239,18239,169,2022/4/15 20:50:00,157,116,41
18240,18240,169,2022/4/15 21:00:00,175,108,67
18241,18241,169,2022/4/15 21:10:00,207,112,95
18242,18242,169,2022/4/15 21:20:00,110,110,0
18243,18243,169,2022/4/15 21:30:00,127,104,23
18244,18244,169,2022/4/15 21:40:00,65,110,-45
18245,18245,169,2022/4/15 21:50:00,61,110,-49
18246,18246,169,2022/4/15 22:00:00,44,92,-48
18247,18247,169,2022/4/15 22:10:00,46,105,-59
18248,18248,169,2022/4/15 22:20:00,33,92,-59
18249,18249,169,2022/4/15 22:30:00,31,78,-47
18250,18250,169,2022/4/15 22:40:00,22,61,-39
18251,18251,169,2022/4/15 22:50:00,4,47,-43
18252,18252,170,2022/4/15 5:00:00,0,1,-1
18253,18253,170,2022/4/15 5:10:00,0,1,-1
18254,18254,170,2022/4/15 5:20:00,4,1,3
18255,18255,170,2022/4/15 5:30:00,5,2,3
18256,18256,170,2022/4/15 5:40:00,6,1,5
18257,18257,170,2022/4/15 5:50:00,7,2,5
18258,18258,170,2022/4/15 6:00:00,9,5,4
18259,18259,170,2022/4/15 6:10:00,15,2,13
18260,18260,170,2022/4/15 6:20:00,20,58,-38
18261,18261,170,2022/4/15 6:30:00,25,48,-23
18262,18262,170,2022/4/15 6:40:00,29,66,-37
18263,18263,170,2022/4/15 6:50:00,30,79,-49
18264,18264,170,2022/4/15 7:00:00,39,90,-51
18265,18265,170,2022/4/15 7:10:00,32,112,-80
18266,18266,170,2022/4/15 7:20:00,37,119,-82
18267,18267,170,2022/4/15 7:30:00,39,109,-70
18268,18268,170,2022/4/15 7:40:00,47,170,-123
18269,18269,170,2022/4/15 7:50:00,53,197,-144
18270,18270,170,2022/4/15 8:00:00,60,297,-237
18271,18271,170,2022/4/15 8:10:00,55,316,-261
18272,18272,170,2022/4/15 8:20:00,54,318,-264
18273,18273,170,2022/4/15 8:30:00,54,504,-450
18274,18274,170,2022/4/15 8:40:00,50,481,-431
18275,18275,170,2022/4/15 8:50:00,42,426,-384
18276,18276,170,2022/4/15 9:00:00,37,327,-290
18277,18277,170,2022/4/15 9:10:00,35,218,-183
18278,18278,170,2022/4/15 9:20:00,29,214,-185
18279,18279,170,2022/4/15 9:30:00,32,105,-73
18280,18280,170,2022/4/15 9:40:00,30,152,-122
18281,18281,170,2022/4/15 9:50:00,30,124,-94
18282,18282,170,2022/4/15 10:00:00,26,105,-79
18283,18283,170,2022/4/15 10:10:00,27,104,-77
18284,18284,170,2022/4/15 10:20:00,27,106,-79
18285,18285,170,2022/4/15 10:30:00,26,91,-65
18286,18286,170,2022/4/15 10:40:00,28,69,-41
18287,18287,170,2022/4/15 10:50:00,28,93,-65
18288,18288,170,2022/4/15 11:00:00,28,68,-40
18289,18289,170,2022/4/15 11:10:00,28,71,-43
18290,18290,170,2022/4/15 11:20:00,30,87,-57
18291,18291,170,2022/4/15 11:30:00,29,67,-38
18292,18292,170,2022/4/15 11:40:00,35,81,-46
18293,18293,170,2022/4/15 11:50:00,33,73,-40
18294,18294,170,2022/4/15 12:00:00,27,72,-45
18295,18295,170,2022/4/15 12:10:00,40,83,-43
18296,18296,170,2022/4/15 12:20:00,36,77,-41
18297,18297,170,2022/4/15 12:30:00,34,100,-66
18298,18298,170,2022/4/15 12:40:00,33,92,-59
18299,18299,170,2022/4/15 12:50:00,33,93,-60
18300,18300,170,2022/4/15 13:00:00,31,73,-42
18301,18301,170,2022/4/15 13:10:00,29,94,-65
18302,18302,170,2022/4/15 13:20:00,27,87,-60
18303,18303,170,2022/4/15 13:30:00,31,80,-49
18304,18304,170,2022/4/15 13:40:00,29,82,-53
18305,18305,170,2022/4/15 13:50:00,30,75,-45
18306,18306,170,2022/4/15 14:00:00,30,76,-46
18307,18307,170,2022/4/15 14:10:00,31,74,-43
18308,18308,170,2022/4/15 14:20:00,39,91,-52
18309,18309,170,2022/4/15 14:30:00,31,76,-45
18310,18310,170,2022/4/15 14:40:00,33,70,-37
18311,18311,170,2022/4/15 14:50:00,34,83,-49
18312,18312,170,2022/4/15 15:00:00,46,65,-19
18313,18313,170,2022/4/15 15:10:00,52,79,-27
18314,18314,170,2022/4/15 15:20:00,44,70,-26
18315,18315,170,2022/4/15 15:30:00,38,81,-43
18316,18316,170,2022/4/15 15:40:00,42,73,-31
18317,18317,170,2022/4/15 15:50:00,46,69,-23
18318,18318,170,2022/4/15 16:00:00,44,80,-36
18319,18319,170,2022/4/15 16:10:00,45,69,-24
18320,18320,170,2022/4/15 16:20:00,47,92,-45
18321,18321,170,2022/4/15 16:30:00,47,60,-13
18322,18322,170,2022/4/15 16:40:00,57,83,-26
18323,18323,170,2022/4/15 16:50:00,64,69,-5
18324,18324,170,2022/4/15 17:00:00,114,93,21
18325,18325,170,2022/4/15 17:10:00,188,105,83
18326,18326,170,2022/4/15 17:20:00,168,103,65
18327,18327,170,2022/4/15 17:30:00,214,105,109
18328,18328,170,2022/4/15 17:40:00,428,105,323
18329,18329,170,2022/4/15 17:50:00,223,106,117
18330,18330,170,2022/4/15 18:00:00,234,111,123
18331,18331,170,2022/4/15 18:10:00,361,112,249
18332,18332,170,2022/4/15 18:20:00,274,120,154
18333,18333,170,2022/4/15 18:30:00,205,110,95
18334,18334,170,2022/4/15 18:40:00,162,107,55
18335,18335,170,2022/4/15 18:50:00,87,104,-17
18336,18336,170,2022/4/15 19:00:00,59,82,-23
18337,18337,170,2022/4/15 19:10:00,58,76,-18
18338,18338,170,2022/4/15 19:20:00,47,72,-25
18339,18339,170,2022/4/15 19:30:00,41,70,-29
18340,18340,170,2022/4/15 19:40:00,43,64,-21
18341,18341,170,2022/4/15 19:50:00,36,67,-31
18342,18342,170,2022/4/15 20:00:00,31,58,-27
18343,18343,170,2022/4/15 20:10:00,35,62,-27
18344,18344,170,2022/4/15 20:20:00,33,62,-29
18345,18345,170,2022/4/15 20:30:00,29,51,-22
18346,18346,170,2022/4/15 20:40:00,27,60,-33
18347,18347,170,2022/4/15 20:50:00,27,63,-36
18348,18348,170,2022/4/15 21:00:00,28,40,-12
18349,18349,170,2022/4/15 21:10:00,37,62,-25
18350,18350,170,2022/4/15 21:20:00,30,52,-22
18351,18351,170,2022/4/15 21:30:00,31,51,-20
18352,18352,170,2022/4/15 21:40:00,30,63,-33
18353,18353,170,2022/4/15 21:50:00,25,51,-26
18354,18354,170,2022/4/15 22:00:00,23,43,-20
18355,18355,170,2022/4/15 22:10:00,22,50,-28
18356,18356,170,2022/4/15 22:20:00,22,46,-24
18357,18357,170,2022/4/15 22:30:00,14,36,-22
18358,18358,170,2022/4/15 22:40:00,3,71,-68
18359,18359,170,2022/4/15 22:50:00,1,38,-37
18360,18360,171,2022/4/15 5:00:00,0,1,-1
18361,18361,171,2022/4/15 5:10:00,0,1,-1
18362,18362,171,2022/4/15 5:20:00,0,1,-1
18363,18363,171,2022/4/15 5:30:00,33,1,32
18364,18364,171,2022/4/15 5:40:00,32,5,27
18365,18365,171,2022/4/15 5:50:00,54,1,53
18366,18366,171,2022/4/15 6:00:00,54,6,48
18367,18367,171,2022/4/15 6:10:00,73,30,43
18368,18368,171,2022/4/15 6:20:00,185,23,162
18369,18369,171,2022/4/15 6:30:00,267,65,202
18370,18370,171,2022/4/15 6:40:00,348,63,285
18371,18371,171,2022/4/15 6:50:00,596,91,505
18372,18372,171,2022/4/15 7:00:00,685,109,576
18373,18373,171,2022/4/15 7:10:00,863,98,765
18374,18374,171,2022/4/15 7:20:00,841,75,766
18375,18375,171,2022/4/15 7:30:00,862,79,783
18376,18376,171,2022/4/15 7:40:00,1055,93,962
18377,18377,171,2022/4/15 7:50:00,1049,79,970
18378,18378,171,2022/4/15 8:00:00,869,105,764
18379,18379,171,2022/4/15 8:10:00,851,107,744
18380,18380,171,2022/4/15 8:20:00,826,108,718
18381,18381,171,2022/4/15 8:30:00,740,115,625
18382,18382,171,2022/4/15 8:40:00,599,96,503
18383,18383,171,2022/4/15 8:50:00,323,110,213
18384,18384,171,2022/4/15 9:00:00,340,112,228
18385,18385,171,2022/4/15 9:10:00,227,85,142
18386,18386,171,2022/4/15 9:20:00,199,97,102
18387,18387,171,2022/4/15 9:30:00,143,96,47
18388,18388,171,2022/4/15 9:40:00,97,76,21
18389,18389,171,2022/4/15 9:50:00,67,81,-14
18390,18390,171,2022/4/15 10:00:00,45,90,-45
18391,18391,171,2022/4/15 10:10:00,47,68,-21
18392,18392,171,2022/4/15 10:20:00,44,72,-28
18393,18393,171,2022/4/15 10:30:00,41,77,-36
18394,18394,171,2022/4/15 10:40:00,39,77,-38
18395,18395,171,2022/4/15 10:50:00,43,72,-29
18396,18396,171,2022/4/15 11:00:00,40,72,-32
18397,18397,171,2022/4/15 11:10:00,43,62,-19
18398,18398,171,2022/4/15 11:20:00,42,92,-50
18399,18399,171,2022/4/15 11:30:00,42,85,-43
18400,18400,171,2022/4/15 11:40:00,43,73,-30
18401,18401,171,2022/4/15 11:50:00,43,72,-29
18402,18402,171,2022/4/15 12:00:00,48,92,-44
18403,18403,171,2022/4/15 12:10:00,42,65,-23
18404,18404,171,2022/4/15 12:20:00,45,98,-53
18405,18405,171,2022/4/15 12:30:00,44,77,-33
18406,18406,171,2022/4/15 12:40:00,42,90,-48
18407,18407,171,2022/4/15 12:50:00,45,75,-30
18408,18408,171,2022/4/15 13:00:00,44,68,-24
18409,18409,171,2022/4/15 13:10:00,37,104,-67
18410,18410,171,2022/4/15 13:20:00,45,70,-25
18411,18411,171,2022/4/15 13:30:00,37,96,-59
18412,18412,171,2022/4/15 13:40:00,39,83,-44
18413,18413,171,2022/4/15 13:50:00,35,87,-52
18414,18414,171,2022/4/15 14:00:00,41,76,-35
18415,18415,171,2022/4/15 14:10:00,34,78,-44
18416,18416,171,2022/4/15 14:20:00,39,106,-67
18417,18417,171,2022/4/15 14:30:00,28,79,-51
18418,18418,171,2022/4/15 14:40:00,30,107,-77
18419,18419,171,2022/4/15 14:50:00,41,92,-51
18420,18420,171,2022/4/15 15:00:00,39,101,-62
18421,18421,171,2022/4/15 15:10:00,44,94,-50
18422,18422,171,2022/4/15 15:20:00,32,93,-61
18423,18423,171,2022/4/15 15:30:00,35,118,-83
18424,18424,171,2022/4/15 15:40:00,34,87,-53
18425,18425,171,2022/4/15 15:50:00,40,104,-64
18426,18426,171,2022/4/15 16:00:00,42,102,-60
18427,18427,171,2022/4/15 16:10:00,45,118,-73
18428,18428,171,2022/4/15 16:20:00,38,83,-45
18429,18429,171,2022/4/15 16:30:00,46,125,-79
18430,18430,171,2022/4/15 16:40:00,67,121,-54
18431,18431,171,2022/4/15 16:50:00,66,111,-45
18432,18432,171,2022/4/15 17:00:00,77,112,-35
18433,18433,171,2022/4/15 17:10:00,89,204,-115
18434,18434,171,2022/4/15 17:20:00,70,227,-157
18435,18435,171,2022/4/15 17:30:00,71,279,-208
18436,18436,171,2022/4/15 17:40:00,129,327,-198
18437,18437,171,2022/4/15 17:50:00,57,418,-361
18438,18438,171,2022/4/15 18:00:00,51,426,-375
18439,18439,171,2022/4/15 18:10:00,54,504,-450
18440,18440,171,2022/4/15 18:20:00,41,431,-390
18441,18441,171,2022/4/15 18:30:00,36,415,-379
18442,18442,171,2022/4/15 18:40:00,30,494,-464
18443,18443,171,2022/4/15 18:50:00,27,423,-396
18444,18444,171,2022/4/15 19:00:00,24,434,-410
18445,18445,171,2022/4/15 19:10:00,28,324,-296
18446,18446,171,2022/4/15 19:20:00,26,330,-304
18447,18447,171,2022/4/15 19:30:00,22,219,-197
18448,18448,171,2022/4/15 19:40:00,27,178,-151
18449,18449,171,2022/4/15 19:50:00,22,125,-103
18450,18450,171,2022/4/15 20:00:00,21,116,-95
18451,18451,171,2022/4/15 20:10:00,23,112,-89
18452,18452,171,2022/4/15 20:20:00,23,121,-98
18453,18453,171,2022/4/15 20:30:00,22,109,-87
18454,18454,171,2022/4/15 20:40:00,20,182,-162
18455,18455,171,2022/4/15 20:50:00,21,116,-95
18456,18456,171,2022/4/15 21:00:00,20,87,-67
18457,18457,171,2022/4/15 21:10:00,23,116,-93
18458,18458,171,2022/4/15 21:20:00,22,100,-78
18459,18459,171,2022/4/15 21:30:00,20,111,-91
18460,18460,171,2022/4/15 21:40:00,15,104,-89
18461,18461,171,2022/4/15 21:50:00,16,102,-86
18462,18462,171,2022/4/15 22:00:00,13,107,-94
18463,18463,171,2022/4/15 22:10:00,12,112,-100
18464,18464,171,2022/4/15 22:20:00,9,97,-88
18465,18465,171,2022/4/15 22:30:00,9,107,-98
18466,18466,171,2022/4/15 22:40:00,4,114,-110
18467,18467,171,2022/4/15 22:50:00,2,99,-97
18468,18468,172,2022/4/15 5:00:00,0,1,-1
18469,18469,172,2022/4/15 5:10:00,10,1,9
18470,18470,172,2022/4/15 5:20:00,19,1,18
18471,18471,172,2022/4/15 5:30:00,12,1,11
18472,18472,172,2022/4/15 5:40:00,19,1,18
18473,18473,172,2022/4/15 5:50:00,32,1,31
18474,18474,172,2022/4/15 6:00:00,32,1,31
18475,18475,172,2022/4/15 6:10:00,49,1,48
18476,18476,172,2022/4/15 6:20:00,80,36,44
18477,18477,172,2022/4/15 6:30:00,54,5,49
18478,18478,172,2022/4/15 6:40:00,87,47,40
18479,18479,172,2022/4/15 6:50:00,157,64,93
18480,18480,172,2022/4/15 7:00:00,156,19,137
18481,18481,172,2022/4/15 7:10:00,215,75,140
18482,18482,172,2022/4/15 7:20:00,274,121,153
18483,18483,172,2022/4/15 7:30:00,254,17,237
18484,18484,172,2022/4/15 7:40:00,174,104,70
18485,18485,172,2022/4/15 7:50:00,225,117,108
18486,18486,172,2022/4/15 8:00:00,158,46,112
18487,18487,172,2022/4/15 8:10:00,82,178,-96
18488,18488,172,2022/4/15 8:20:00,90,117,-27
18489,18489,172,2022/4/15 8:30:00,56,25,31
18490,18490,172,2022/4/15 8:40:00,54,133,-79
18491,18491,172,2022/4/15 8:50:00,46,108,-62
18492,18492,172,2022/4/15 9:00:00,32,13,19
18493,18493,172,2022/4/15 9:10:00,32,105,-73
18494,18494,172,2022/4/15 9:20:00,32,73,-41
18495,18495,172,2022/4/15 9:30:00,27,30,-3
18496,18496,172,2022/4/15 9:40:00,27,76,-49
18497,18497,172,2022/4/15 9:50:00,27,68,-41
18498,18498,172,2022/4/15 10:00:00,27,12,15
18499,18499,172,2022/4/15 10:10:00,25,76,-51
18500,18500,172,2022/4/15 10:20:00,26,65,-39
18501,18501,172,2022/4/15 10:30:00,27,63,-36
18502,18502,172,2022/4/15 10:40:00,25,69,-44
18503,18503,172,2022/4/15 10:50:00,29,47,-18
18504,18504,172,2022/4/15 11:00:00,26,39,-13
18505,18505,172,2022/4/15 11:10:00,24,71,-47
18506,18506,172,2022/4/15 11:20:00,26,46,-20
18507,18507,172,2022/4/15 11:30:00,28,37,-9
18508,18508,172,2022/4/15 11:40:00,27,71,-44
18509,18509,172,2022/4/15 11:50:00,31,67,-36
18510,18510,172,2022/4/15 12:00:00,28,28,0
18511,18511,172,2022/4/15 12:10:00,28,50,-22
18512,18512,172,2022/4/15 12:20:00,27,64,-37
18513,18513,172,2022/4/15 12:30:00,26,62,-36
18514,18514,172,2022/4/15 12:40:00,28,28,0
18515,18515,172,2022/4/15 12:50:00,29,62,-33
18516,18516,172,2022/4/15 13:00:00,26,82,-56
18517,18517,172,2022/4/15 13:10:00,27,15,12
18518,18518,172,2022/4/15 13:20:00,22,83,-61
18519,18519,172,2022/4/15 13:30:00,26,82,-56
18520,18520,172,2022/4/15 13:40:00,24,71,-47
18521,18521,172,2022/4/15 13:50:00,26,19,7
18522,18522,172,2022/4/15 14:00:00,22,72,-50
18523,18523,172,2022/4/15 14:10:00,28,81,-53
18524,18524,172,2022/4/15 14:20:00,26,15,11
18525,18525,172,2022/4/15 14:30:00,28,70,-42
18526,18526,172,2022/4/15 14:40:00,25,72,-47
18527,18527,172,2022/4/15 14:50:00,28,62,-34
18528,18528,172,2022/4/15 15:00:00,25,33,-8
18529,18529,172,2022/4/15 15:10:00,29,78,-49
18530,18530,172,2022/4/15 15:20:00,27,72,-45
18531,18531,172,2022/4/15 15:30:00,27,14,13
18532,18532,172,2022/4/15 15:40:00,29,81,-52
18533,18533,172,2022/4/15 15:50:00,32,79,-47
18534,18534,172,2022/4/15 16:00:00,33,68,-35
18535,18535,172,2022/4/15 16:10:00,40,33,7
18536,18536,172,2022/4/15 16:20:00,45,92,-47
18537,18537,172,2022/4/15 16:30:00,46,73,-27
18538,18538,172,2022/4/15 16:40:00,45,85,-40
18539,18539,172,2022/4/15 16:50:00,61,35,26
18540,18540,172,2022/4/15 17:00:00,74,108,-34
18541,18541,172,2022/4/15 17:10:00,137,105,32
18542,18542,172,2022/4/15 17:20:00,62,25,37
18543,18543,172,2022/4/15 17:30:00,47,99,-52
18544,18544,172,2022/4/15 17:40:00,37,111,-74
18545,18545,172,2022/4/15 17:50:00,30,23,7
18546,18546,172,2022/4/15 18:00:00,26,109,-83
18547,18547,172,2022/4/15 18:10:00,27,147,-120
18548,18548,172,2022/4/15 18:20:00,22,29,-7
18549,18549,172,2022/4/15 18:30:00,22,192,-170
18550,18550,172,2022/4/15 18:40:00,18,121,-103
18551,18551,172,2022/4/15 18:50:00,18,88,-70
18552,18552,172,2022/4/15 19:00:00,16,154,-138
18553,18553,172,2022/4/15 19:10:00,17,98,-81
18554,18554,172,2022/4/15 19:20:00,16,98,-82
18555,18555,172,2022/4/15 19:30:00,13,110,-97
18556,18556,172,2022/4/15 19:40:00,13,123,-110
18557,18557,172,2022/4/15 19:50:00,13,22,-9
18558,18558,172,2022/4/15 20:00:00,14,113,-99
18559,18559,172,2022/4/15 20:10:00,19,79,-60
18560,18560,172,2022/4/15 20:20:00,17,82,-65
18561,18561,172,2022/4/15 20:30:00,14,80,-66
18562,18562,172,2022/4/15 20:40:00,14,31,-17
18563,18563,172,2022/4/15 20:50:00,11,70,-59
18564,18564,172,2022/4/15 21:00:00,13,78,-65
18565,18565,172,2022/4/15 21:10:00,13,21,-8
18566,18566,172,2022/4/15 21:20:00,8,87,-79
18567,18567,172,2022/4/15 21:30:00,7,86,-79
18568,18568,172,2022/4/15 21:40:00,8,13,-5
18569,18569,172,2022/4/15 21:50:00,9,79,-70
18570,18570,172,2022/4/15 22:00:00,5,78,-73
18571,18571,172,2022/4/15 22:10:00,5,21,-16
18572,18572,172,2022/4/15 22:20:00,4,70,-66
18573,18573,172,2022/4/15 22:30:00,1,75,-74
18574,18574,172,2022/4/15 22:40:00,0,55,-55
18575,18575,172,2022/4/15 22:50:00,0,53,-53
18576,18576,173,2022/4/15 5:00:00,0,1,-1
18577,18577,173,2022/4/15 5:10:00,0,1,-1
18578,18578,173,2022/4/15 5:20:00,0,1,-1
18579,18579,173,2022/4/15 5:30:00,7,1,6
18580,18580,173,2022/4/15 5:40:00,6,5,1
18581,18581,173,2022/4/15 5:50:00,9,1,8
18582,18582,173,2022/4/15 6:00:00,11,1,10
18583,18583,173,2022/4/15 6:10:00,10,23,-13
18584,18584,173,2022/4/15 6:20:00,17,5,12
18585,18585,173,2022/4/15 6:30:00,16,19,-3
18586,18586,173,2022/4/15 6:40:00,18,33,-15
18587,18587,173,2022/4/15 6:50:00,27,8,19
18588,18588,173,2022/4/15 7:00:00,26,38,-12
18589,18589,173,2022/4/15 7:10:00,32,62,-30
18590,18590,173,2022/4/15 7:20:00,32,23,9
18591,18591,173,2022/4/15 7:30:00,29,72,-43
18592,18592,173,2022/4/15 7:40:00,33,68,-35
18593,18593,173,2022/4/15 7:50:00,31,19,12
18594,18594,173,2022/4/15 8:00:00,35,70,-35
18595,18595,173,2022/4/15 8:10:00,24,66,-42
18596,18596,173,2022/4/15 8:20:00,21,30,-9
18597,18597,173,2022/4/15 8:30:00,24,62,-38
18598,18598,173,2022/4/15 8:40:00,15,50,-35
18599,18599,173,2022/4/15 8:50:00,15,16,-1
18600,18600,173,2022/4/15 9:00:00,13,46,-33
18601,18601,173,2022/4/15 9:10:00,9,25,-16
18602,18602,173,2022/4/15 9:20:00,11,16,-5
18603,18603,173,2022/4/15 9:30:00,7,25,-18
18604,18604,173,2022/4/15 9:40:00,8,25,-17
18605,18605,173,2022/4/15 9:50:00,7,7,0
18606,18606,173,2022/4/15 10:00:00,6,23,-17
18607,18607,173,2022/4/15 10:10:00,5,19,-14
18608,18608,173,2022/4/15 10:20:00,6,23,-17
18609,18609,173,2022/4/15 10:30:00,8,12,-4
18610,18610,173,2022/4/15 10:40:00,6,22,-16
18611,18611,173,2022/4/15 10:50:00,6,14,-8
18612,18612,173,2022/4/15 11:00:00,6,19,-13
18613,18613,173,2022/4/15 11:10:00,6,14,-8
18614,18614,173,2022/4/15 11:20:00,6,8,-2
18615,18615,173,2022/4/15 11:30:00,6,23,-17
18616,18616,173,2022/4/15 11:40:00,7,19,-12
18617,18617,173,2022/4/15 11:50:00,9,7,2
18618,18618,173,2022/4/15 12:00:00,8,16,-8
18619,18619,173,2022/4/15 12:10:00,7,23,-16
18620,18620,173,2022/4/15 12:20:00,8,19,-11
18621,18621,173,2022/4/15 12:30:00,8,8,0
18622,18622,173,2022/4/15 12:40:00,8,23,-15
18623,18623,173,2022/4/15 12:50:00,7,21,-14
18624,18624,173,2022/4/15 13:00:00,8,2,6
18625,18625,173,2022/4/15 13:10:00,9,19,-10
18626,18626,173,2022/4/15 13:20:00,7,21,-14
18627,18627,173,2022/4/15 13:30:00,9,21,-12
18628,18628,173,2022/4/15 13:40:00,8,7,1
18629,18629,173,2022/4/15 13:50:00,7,23,-16
18630,18630,173,2022/4/15 14:00:00,7,21,-14
18631,18631,173,2022/4/15 14:10:00,7,2,5
18632,18632,173,2022/4/15 14:20:00,7,21,-14
18633,18633,173,2022/4/15 14:30:00,7,21,-14
18634,18634,173,2022/4/15 14:40:00,7,18,-11
18635,18635,173,2022/4/15 14:50:00,9,12,-3
18636,18636,173,2022/4/15 15:00:00,7,21,-14
18637,18637,173,2022/4/15 15:10:00,12,19,-7
18638,18638,173,2022/4/15 15:20:00,9,6,3
18639,18639,173,2022/4/15 15:30:00,12,19,-7
18640,18640,173,2022/4/15 15:40:00,10,23,-13
18641,18641,173,2022/4/15 15:50:00,11,23,-12
18642,18642,173,2022/4/15 16:00:00,11,15,-4
18643,18643,173,2022/4/15 16:10:00,14,23,-9
18644,18644,173,2022/4/15 16:20:00,18,30,-12
18645,18645,173,2022/4/15 16:30:00,29,32,-3
18646,18646,173,2022/4/15 16:40:00,22,18,4
18647,18647,173,2022/4/15 16:50:00,15,23,-8
18648,18648,173,2022/4/15 17:00:00,29,46,-17
18649,18649,173,2022/4/15 17:10:00,16,31,-15
18650,18650,173,2022/4/15 17:20:00,18,29,-11
18651,18651,173,2022/4/15 17:30:00,12,62,-50
18652,18652,173,2022/4/15 17:40:00,12,30,-18
18653,18653,173,2022/4/15 17:50:00,12,37,-25
18654,18654,173,2022/4/15 18:00:00,11,63,-52
18655,18655,173,2022/4/15 18:10:00,11,21,-10
18656,18656,173,2022/4/15 18:20:00,10,56,-46
18657,18657,173,2022/4/15 18:30:00,7,46,-39
18658,18658,173,2022/4/15 18:40:00,6,21,-15
18659,18659,173,2022/4/15 18:50:00,7,56,-49
18660,18660,173,2022/4/15 19:00:00,6,38,-32
18661,18661,173,2022/4/15 19:10:00,7,41,-34
18662,18662,173,2022/4/15 19:20:00,6,68,-62
18663,18663,173,2022/4/15 19:30:00,5,56,-51
18664,18664,173,2022/4/15 19:40:00,5,16,-11
18665,18665,173,2022/4/15 19:50:00,3,49,-46
18666,18666,173,2022/4/15 20:00:00,4,36,-32
18667,18667,173,2022/4/15 20:10:00,3,34,-31
18668,18668,173,2022/4/15 20:20:00,5,36,-31
18669,18669,173,2022/4/15 20:30:00,2,7,-5
18670,18670,173,2022/4/15 20:40:00,3,34,-31
18671,18671,173,2022/4/15 20:50:00,3,34,-31
18672,18672,173,2022/4/15 21:00:00,2,7,-5
18673,18673,173,2022/4/15 21:10:00,2,25,-23
18674,18674,173,2022/4/15 21:20:00,1,33,-32
18675,18675,173,2022/4/15 21:30:00,2,4,-2
18676,18676,173,2022/4/15 21:40:00,2,25,-23
18677,18677,173,2022/4/15 21:50:00,1,31,-30
18678,18678,173,2022/4/15 22:00:00,1,7,-6
18679,18679,173,2022/4/15 22:10:00,1,32,-31
18680,18680,173,2022/4/15 22:20:00,1,24,-23
18681,18681,173,2022/4/15 22:30:00,1,21,-20
18682,18682,173,2022/4/15 22:40:00,0,21,-21
18683,18683,173,2022/4/15 22:50:00,0,18,-18
18684,18684,174,2022/4/15 5:00:00,0,1,-1
18685,18685,174,2022/4/15 5:10:00,0,1,-1
18686,18686,174,2022/4/15 5:20:00,0,1,-1
18687,18687,174,2022/4/15 5:30:00,38,1,37
18688,18688,174,2022/4/15 5:40:00,29,6,23
18689,18689,174,2022/4/15 5:50:00,45,2,43
18690,18690,174,2022/4/15 6:00:00,53,2,51
18691,18691,174,2022/4/15 6:10:00,80,23,57
18692,18692,174,2022/4/15 6:20:00,185,23,162
18693,18693,174,2022/4/15 6:30:00,280,38,242
18694,18694,174,2022/4/15 6:40:00,346,46,300
18695,18695,174,2022/4/15 6:50:00,654,47,607
18696,18696,174,2022/4/15 7:00:00,823,77,746
18697,18697,174,2022/4/15 7:10:00,854,75,779
18698,18698,174,2022/4/15 7:20:00,850,73,777
18699,18699,174,2022/4/15 7:30:00,858,93,765
18700,18700,174,2022/4/15 7:40:00,869,90,779
18701,18701,174,2022/4/15 7:50:00,850,76,774
18702,18702,174,2022/4/15 8:00:00,834,108,726
18703,18703,174,2022/4/15 8:10:00,825,120,705
18704,18704,174,2022/4/15 8:20:00,730,128,602
18705,18705,174,2022/4/15 8:30:00,617,152,465
18706,18706,174,2022/4/15 8:40:00,442,197,245
18707,18707,174,2022/4/15 8:50:00,346,108,238
18708,18708,174,2022/4/15 9:00:00,273,117,156
18709,18709,174,2022/4/15 9:10:00,184,109,75
18710,18710,174,2022/4/15 9:20:00,148,101,47
18711,18711,174,2022/4/15 9:30:00,76,103,-27
18712,18712,174,2022/4/15 9:40:00,64,90,-26
18713,18713,174,2022/4/15 9:50:00,51,76,-25
18714,18714,174,2022/4/15 10:00:00,47,70,-23
18715,18715,174,2022/4/15 10:10:00,43,65,-22
18716,18716,174,2022/4/15 10:20:00,38,75,-37
18717,18717,174,2022/4/15 10:30:00,36,71,-35
18718,18718,174,2022/4/15 10:40:00,37,64,-27
18719,18719,174,2022/4/15 10:50:00,34,69,-35
18720,18720,174,2022/4/15 11:00:00,33,75,-42
18721,18721,174,2022/4/15 11:10:00,28,58,-30
18722,18722,174,2022/4/15 11:20:00,31,69,-38
18723,18723,174,2022/4/15 11:30:00,37,70,-33
18724,18724,174,2022/4/15 11:40:00,33,63,-30
18725,18725,174,2022/4/15 11:50:00,39,65,-26
18726,18726,174,2022/4/15 12:00:00,37,64,-27
18727,18727,174,2022/4/15 12:10:00,37,87,-50
18728,18728,174,2022/4/15 12:20:00,42,59,-17
18729,18729,174,2022/4/15 12:30:00,38,79,-41
18730,18730,174,2022/4/15 12:40:00,43,74,-31
18731,18731,174,2022/4/15 12:50:00,38,79,-41
18732,18732,174,2022/4/15 13:00:00,39,72,-33
18733,18733,174,2022/4/15 13:10:00,36,62,-26
18734,18734,174,2022/4/15 13:20:00,34,92,-58
18735,18735,174,2022/4/15 13:30:00,36,66,-30
18736,18736,174,2022/4/15 13:40:00,28,97,-69
18737,18737,174,2022/4/15 13:50:00,29,69,-40
18738,18738,174,2022/4/15 14:00:00,29,84,-55
18739,18739,174,2022/4/15 14:10:00,27,81,-54
18740,18740,174,2022/4/15 14:20:00,29,63,-34
18741,18741,174,2022/4/15 14:30:00,33,90,-57
18742,18742,174,2022/4/15 14:40:00,28,77,-49
18743,18743,174,2022/4/15 14:50:00,27,97,-70
18744,18744,174,2022/4/15 15:00:00,26,75,-49
18745,18745,174,2022/4/15 15:10:00,29,81,-52
18746,18746,174,2022/4/15 15:20:00,33,99,-66
18747,18747,174,2022/4/15 15:30:00,31,93,-62
18748,18748,174,2022/4/15 15:40:00,33,101,-68
18749,18749,174,2022/4/15 15:50:00,26,76,-50
18750,18750,174,2022/4/15 16:00:00,32,117,-85
18751,18751,174,2022/4/15 16:10:00,38,98,-60
18752,18752,174,2022/4/15 16:20:00,41,123,-82
18753,18753,174,2022/4/15 16:30:00,37,110,-73
18754,18754,174,2022/4/15 16:40:00,43,110,-67
18755,18755,174,2022/4/15 16:50:00,41,106,-65
18756,18756,174,2022/4/15 17:00:00,55,118,-63
18757,18757,174,2022/4/15 17:10:00,77,230,-153
18758,18758,174,2022/4/15 17:20:00,49,178,-129
18759,18759,174,2022/4/15 17:30:00,77,254,-177
18760,18760,174,2022/4/15 17:40:00,153,254,-101
18761,18761,174,2022/4/15 17:50:00,71,332,-261
18762,18762,174,2022/4/15 18:00:00,58,375,-317
18763,18763,174,2022/4/15 18:10:00,208,364,-156
18764,18764,174,2022/4/15 18:20:00,132,489,-357
18765,18765,174,2022/4/15 18:30:00,66,425,-359
18766,18766,174,2022/4/15 18:40:00,58,315,-257
18767,18767,174,2022/4/15 18:50:00,43,495,-452
18768,18768,174,2022/4/15 19:00:00,36,518,-482
18769,18769,174,2022/4/15 19:10:00,34,330,-296
18770,18770,174,2022/4/15 19:20:00,33,314,-281
18771,18771,174,2022/4/15 19:30:00,25,213,-188
18772,18772,174,2022/4/15 19:40:00,29,180,-151
18773,18773,174,2022/4/15 19:50:00,25,117,-92
18774,18774,174,2022/4/15 20:00:00,24,129,-105
18775,18775,174,2022/4/15 20:10:00,26,108,-82
18776,18776,174,2022/4/15 20:20:00,22,98,-76
18777,18777,174,2022/4/15 20:30:00,22,110,-88
18778,18778,174,2022/4/15 20:40:00,19,104,-85
18779,18779,174,2022/4/15 20:50:00,22,103,-81
18780,18780,174,2022/4/15 21:00:00,20,122,-102
18781,18781,174,2022/4/15 21:10:00,26,114,-88
18782,18782,174,2022/4/15 21:20:00,27,109,-82
18783,18783,174,2022/4/15 21:30:00,20,110,-90
18784,18784,174,2022/4/15 21:40:00,16,112,-96
18785,18785,174,2022/4/15 21:50:00,12,123,-111
18786,18786,174,2022/4/15 22:00:00,14,106,-92
18787,18787,174,2022/4/15 22:10:00,13,100,-87
18788,18788,174,2022/4/15 22:20:00,10,77,-67
18789,18789,174,2022/4/15 22:30:00,8,99,-91
18790,18790,174,2022/4/15 22:40:00,3,92,-89
18791,18791,174,2022/4/15 22:50:00,1,107,-106
18792,18792,175,2022/4/15 5:00:00,0,1,-1
18793,18793,175,2022/4/15 5:10:00,0,1,-1
18794,18794,175,2022/4/15 5:20:00,0,1,-1
18795,18795,175,2022/4/15 5:30:00,20,1,19
18796,18796,175,2022/4/15 5:40:00,25,6,19
18797,18797,175,2022/4/15 5:50:00,31,6,25
18798,18798,175,2022/4/15 6:00:00,43,11,32
18799,18799,175,2022/4/15 6:10:00,57,40,17
18800,18800,175,2022/4/15 6:20:00,71,45,26
18801,18801,175,2022/4/15 6:30:00,147,55,92
18802,18802,175,2022/4/15 6:40:00,213,74,139
18803,18803,175,2022/4/15 6:50:00,243,67,176
18804,18804,175,2022/4/15 7:00:00,278,67,211
18805,18805,175,2022/4/15 7:10:00,337,76,261
18806,18806,175,2022/4/15 7:20:00,574,90,484
18807,18807,175,2022/4/15 7:30:00,723,88,635
18808,18808,175,2022/4/15 7:40:00,818,104,714
18809,18809,175,2022/4/15 7:50:00,1059,107,952
18810,18810,175,2022/4/15 8:00:00,1207,224,983
18811,18811,175,2022/4/15 8:10:00,1361,326,1035
18812,18812,175,2022/4/15 8:20:00,1213,375,838
18813,18813,175,2022/4/15 8:30:00,1053,533,520
18814,18814,175,2022/4/15 8:40:00,677,507,170
18815,18815,175,2022/4/15 8:50:00,590,318,272
18816,18816,175,2022/4/15 9:00:00,560,197,363
18817,18817,175,2022/4/15 9:10:00,326,159,167
18818,18818,175,2022/4/15 9:20:00,280,121,159
18819,18819,175,2022/4/15 9:30:00,219,122,97
18820,18820,175,2022/4/15 9:40:00,177,123,54
18821,18821,175,2022/4/15 9:50:00,145,88,57
18822,18822,175,2022/4/15 10:00:00,94,109,-15
18823,18823,175,2022/4/15 10:10:00,76,105,-29
18824,18824,175,2022/4/15 10:20:00,69,109,-40
18825,18825,175,2022/4/15 10:30:00,69,106,-37
18826,18826,175,2022/4/15 10:40:00,49,100,-51
18827,18827,175,2022/4/15 10:50:00,43,101,-58
18828,18828,175,2022/4/15 11:00:00,45,108,-63
18829,18829,175,2022/4/15 11:10:00,50,96,-46
18830,18830,175,2022/4/15 11:20:00,58,105,-47
18831,18831,175,2022/4/15 11:30:00,59,101,-42
18832,18832,175,2022/4/15 11:40:00,62,111,-49
18833,18833,175,2022/4/15 11:50:00,63,105,-42
18834,18834,175,2022/4/15 12:00:00,74,105,-31
18835,18835,175,2022/4/15 12:10:00,74,103,-29
18836,18836,175,2022/4/15 12:20:00,85,111,-26
18837,18837,175,2022/4/15 12:30:00,74,105,-31
18838,18838,175,2022/4/15 12:40:00,73,111,-38
18839,18839,175,2022/4/15 12:50:00,70,108,-38
18840,18840,175,2022/4/15 13:00:00,81,108,-27
18841,18841,175,2022/4/15 13:10:00,75,106,-31
18842,18842,175,2022/4/15 13:20:00,69,105,-36
18843,18843,175,2022/4/15 13:30:00,74,111,-37
18844,18844,175,2022/4/15 13:40:00,60,108,-48
18845,18845,175,2022/4/15 13:50:00,62,105,-43
18846,18846,175,2022/4/15 14:00:00,53,108,-55
18847,18847,175,2022/4/15 14:10:00,51,107,-56
18848,18848,175,2022/4/15 14:20:00,50,104,-54
18849,18849,175,2022/4/15 14:30:00,57,106,-49
18850,18850,175,2022/4/15 14:40:00,47,106,-59
18851,18851,175,2022/4/15 14:50:00,43,106,-63
18852,18852,175,2022/4/15 15:00:00,67,108,-41
18853,18853,175,2022/4/15 15:10:00,71,122,-51
18854,18854,175,2022/4/15 15:20:00,64,102,-38
18855,18855,175,2022/4/15 15:30:00,66,127,-61
18856,18856,175,2022/4/15 15:40:00,76,109,-33
18857,18857,175,2022/4/15 15:50:00,69,124,-55
18858,18858,175,2022/4/15 16:00:00,76,110,-34
18859,18859,175,2022/4/15 16:10:00,92,123,-31
18860,18860,175,2022/4/15 16:20:00,83,105,-22
18861,18861,175,2022/4/15 16:30:00,133,110,23
18862,18862,175,2022/4/15 16:40:00,174,110,64
18863,18863,175,2022/4/15 16:50:00,148,159,-11
18864,18864,175,2022/4/15 17:00:00,258,189,69
18865,18865,175,2022/4/15 17:10:00,344,210,134
18866,18866,175,2022/4/15 17:20:00,244,295,-51
18867,18867,175,2022/4/15 17:30:00,268,322,-54
18868,18868,175,2022/4/15 17:40:00,568,531,37
18869,18869,175,2022/4/15 17:50:00,310,434,-124
18870,18870,175,2022/4/15 18:00:00,269,418,-149
18871,18871,175,2022/4/15 18:10:00,349,420,-71
18872,18872,175,2022/4/15 18:20:00,263,440,-177
18873,18873,175,2022/4/15 18:30:00,220,420,-200
18874,18874,175,2022/4/15 18:40:00,191,436,-245
18875,18875,175,2022/4/15 18:50:00,155,534,-379
18876,18876,175,2022/4/15 19:00:00,129,349,-220
18877,18877,175,2022/4/15 19:10:00,131,322,-191
18878,18878,175,2022/4/15 19:20:00,77,198,-121
18879,18879,175,2022/4/15 19:30:00,65,184,-119
18880,18880,175,2022/4/15 19:40:00,60,143,-83
18881,18881,175,2022/4/15 19:50:00,54,111,-57
18882,18882,175,2022/4/15 20:00:00,53,110,-57
18883,18883,175,2022/4/15 20:10:00,58,110,-52
18884,18884,175,2022/4/15 20:20:00,46,121,-75
18885,18885,175,2022/4/15 20:30:00,47,113,-66
18886,18886,175,2022/4/15 20:40:00,43,114,-71
18887,18887,175,2022/4/15 20:50:00,46,103,-57
18888,18888,175,2022/4/15 21:00:00,44,125,-81
18889,18889,175,2022/4/15 21:10:00,42,126,-84
18890,18890,175,2022/4/15 21:20:00,38,110,-72
18891,18891,175,2022/4/15 21:30:00,34,122,-88
18892,18892,175,2022/4/15 21:40:00,30,122,-92
18893,18893,175,2022/4/15 21:50:00,27,109,-82
18894,18894,175,2022/4/15 22:00:00,29,122,-93
18895,18895,175,2022/4/15 22:10:00,26,102,-76
18896,18896,175,2022/4/15 22:20:00,24,120,-96
18897,18897,175,2022/4/15 22:30:00,20,108,-88
18898,18898,175,2022/4/15 22:40:00,13,93,-80
18899,18899,175,2022/4/15 22:50:00,8,87,-79
18900,18900,176,2022/4/15 5:00:00,0,1,-1
18901,18901,176,2022/4/15 5:10:00,1,1,0
18902,18902,176,2022/4/15 5:20:00,2,1,1
18903,18903,176,2022/4/15 5:30:00,8,1,7
18904,18904,176,2022/4/15 5:40:00,11,8,3
18905,18905,176,2022/4/15 5:50:00,16,6,10
18906,18906,176,2022/4/15 6:00:00,29,11,18
18907,18907,176,2022/4/15 6:10:00,40,59,-19
18908,18908,176,2022/4/15 6:20:00,32,41,-9
18909,18909,176,2022/4/15 6:30:00,50,108,-58
18910,18910,176,2022/4/15 6:40:00,85,102,-17
18911,18911,176,2022/4/15 6:50:00,150,124,26
18912,18912,176,2022/4/15 7:00:00,181,105,76
18913,18913,176,2022/4/15 7:10:00,231,181,50
18914,18914,176,2022/4/15 7:20:00,254,226,28
18915,18915,176,2022/4/15 7:30:00,275,196,79
18916,18916,176,2022/4/15 7:40:00,340,320,20
18917,18917,176,2022/4/15 7:50:00,469,341,128
18918,18918,176,2022/4/15 8:00:00,594,404,190
18919,18919,176,2022/4/15 8:10:00,720,557,163
18920,18920,176,2022/4/15 8:20:00,589,565,24
18921,18921,176,2022/4/15 8:30:00,573,1080,-507
18922,18922,176,2022/4/15 8:40:00,346,1784,-1438
18923,18923,176,2022/4/15 8:50:00,282,1479,-1197
18924,18924,176,2022/4/15 9:00:00,239,1129,-890
18925,18925,176,2022/4/15 9:10:00,208,590,-382
18926,18926,176,2022/4/15 9:20:00,187,593,-406
18927,18927,176,2022/4/15 9:30:00,169,427,-258
18928,18928,176,2022/4/15 9:40:00,95,427,-332
18929,18929,176,2022/4/15 9:50:00,80,377,-297
18930,18930,176,2022/4/15 10:00:00,76,256,-180
18931,18931,176,2022/4/15 10:10:00,64,227,-163
18932,18932,176,2022/4/15 10:20:00,63,185,-122
18933,18933,176,2022/4/15 10:30:00,67,181,-114
18934,18934,176,2022/4/15 10:40:00,58,117,-59
18935,18935,176,2022/4/15 10:50:00,59,146,-87
18936,18936,176,2022/4/15 11:00:00,55,127,-72
18937,18937,176,2022/4/15 11:10:00,58,144,-86
18938,18938,176,2022/4/15 11:20:00,63,144,-81
18939,18939,176,2022/4/15 11:30:00,65,119,-54
18940,18940,176,2022/4/15 11:40:00,73,170,-97
18941,18941,176,2022/4/15 11:50:00,74,109,-35
18942,18942,176,2022/4/15 12:00:00,83,128,-45
18943,18943,176,2022/4/15 12:10:00,129,119,10
18944,18944,176,2022/4/15 12:20:00,109,110,-1
18945,18945,176,2022/4/15 12:30:00,109,181,-72
18946,18946,176,2022/4/15 12:40:00,133,111,22
18947,18947,176,2022/4/15 12:50:00,132,192,-60
18948,18948,176,2022/4/15 13:00:00,147,117,30
18949,18949,176,2022/4/15 13:10:00,149,128,21
18950,18950,176,2022/4/15 13:20:00,174,170,4
18951,18951,176,2022/4/15 13:30:00,174,128,46
18952,18952,176,2022/4/15 13:40:00,175,170,5
18953,18953,176,2022/4/15 13:50:00,175,109,66
18954,18954,176,2022/4/15 14:00:00,149,128,21
18955,18955,176,2022/4/15 14:10:00,156,121,35
18956,18956,176,2022/4/15 14:20:00,174,110,64
18957,18957,176,2022/4/15 14:30:00,174,117,57
18958,18958,176,2022/4/15 14:40:00,174,115,59
18959,18959,176,2022/4/15 14:50:00,174,129,45
18960,18960,176,2022/4/15 15:00:00,207,111,96
18961,18961,176,2022/4/15 15:10:00,197,110,87
18962,18962,176,2022/4/15 15:20:00,204,134,70
18963,18963,176,2022/4/15 15:30:00,208,108,100
18964,18964,176,2022/4/15 15:40:00,202,170,32
18965,18965,176,2022/4/15 15:50:00,206,119,87
18966,18966,176,2022/4/15 16:00:00,224,138,86
18967,18967,176,2022/4/15 16:10:00,204,127,77
18968,18968,176,2022/4/15 16:20:00,223,181,42
18969,18969,176,2022/4/15 16:30:00,268,179,89
18970,18970,176,2022/4/15 16:40:00,287,145,142
18971,18971,176,2022/4/15 16:50:00,291,234,57
18972,18972,176,2022/4/15 17:00:00,575,177,398
18973,18973,176,2022/4/15 17:10:00,713,296,417
18974,18974,176,2022/4/15 17:20:00,696,316,380
18975,18975,176,2022/4/15 17:30:00,704,374,330
18976,18976,176,2022/4/15 17:40:00,1158,491,667
18977,18977,176,2022/4/15 17:50:00,805,427,378
18978,18978,176,2022/4/15 18:00:00,836,420,416
18979,18979,176,2022/4/15 18:10:00,1352,421,931
18980,18980,176,2022/4/15 18:20:00,1154,431,723
18981,18981,176,2022/4/15 18:30:00,793,433,360
18982,18982,176,2022/4/15 18:40:00,670,502,168
18983,18983,176,2022/4/15 18:50:00,575,521,54
18984,18984,176,2022/4/15 19:00:00,542,329,213
18985,18985,176,2022/4/15 19:10:00,422,220,202
18986,18986,176,2022/4/15 19:20:00,346,179,167
18987,18987,176,2022/4/15 19:30:00,302,126,176
18988,18988,176,2022/4/15 19:40:00,310,111,199
18989,18989,176,2022/4/15 19:50:00,300,110,190
18990,18990,176,2022/4/15 20:00:00,336,108,228
18991,18991,176,2022/4/15 20:10:00,345,104,241
18992,18992,176,2022/4/15 20:20:00,335,88,247
18993,18993,176,2022/4/15 20:30:00,344,107,237
18994,18994,176,2022/4/15 20:40:00,336,108,228
18995,18995,176,2022/4/15 20:50:00,328,104,224
18996,18996,176,2022/4/15 21:00:00,318,105,213
18997,18997,176,2022/4/15 21:10:00,428,111,317
18998,18998,176,2022/4/15 21:20:00,353,97,256
18999,18999,176,2022/4/15 21:30:00,338,114,224
19000,19000,176,2022/4/15 21:40:00,305,100,205
19001,19001,176,2022/4/15 21:50:00,314,92,222
19002,19002,176,2022/4/15 22:00:00,432,80,352
19003,19003,176,2022/4/15 22:10:00,205,93,112
19004,19004,176,2022/4/15 22:20:00,52,79,-27
19005,19005,176,2022/4/15 22:30:00,28,87,-59
19006,19006,176,2022/4/15 22:40:00,24,67,-43
19007,19007,176,2022/4/15 22:50:00,8,70,-62
19008,19008,177,2022/4/15 5:00:00,0,1,-1
19009,19009,177,2022/4/15 5:10:00,1,1,0
19010,19010,177,2022/4/15 5:20:00,4,1,3
19011,19011,177,2022/4/15 5:30:00,13,1,12
19012,19012,177,2022/4/15 5:40:00,18,8,10
19013,19013,177,2022/4/15 5:50:00,25,12,13
19014,19014,177,2022/4/15 6:00:00,31,23,8
19015,19015,177,2022/4/15 6:10:00,45,31,14
19016,19016,177,2022/4/15 6:20:00,61,38,23
19017,19017,177,2022/4/15 6:30:00,98,54,44
19018,19018,177,2022/4/15 6:40:00,194,61,133
19019,19019,177,2022/4/15 6:50:00,234,62,172
19020,19020,177,2022/4/15 7:00:00,278,93,185
19021,19021,177,2022/4/15 7:10:00,340,105,235
19022,19022,177,2022/4/15 7:20:00,600,108,492
19023,19023,177,2022/4/15 7:30:00,698,108,590
19024,19024,177,2022/4/15 7:40:00,1059,126,933
19025,19025,177,2022/4/15 7:50:00,1219,110,1109
19026,19026,177,2022/4/15 8:00:00,1365,112,1253
19027,19027,177,2022/4/15 8:10:00,1573,128,1445
19028,19028,177,2022/4/15 8:20:00,1361,184,1177
19029,19029,177,2022/4/15 8:30:00,1177,256,921
19030,19030,177,2022/4/15 8:40:00,815,327,488
19031,19031,177,2022/4/15 8:50:00,720,208,512
19032,19032,177,2022/4/15 9:00:00,583,185,398
19033,19033,177,2022/4/15 9:10:00,317,144,173
19034,19034,177,2022/4/15 9:20:00,277,121,156
19035,19035,177,2022/4/15 9:30:00,239,126,113
19036,19036,177,2022/4/15 9:40:00,186,122,64
19037,19037,177,2022/4/15 9:50:00,156,109,47
19038,19038,177,2022/4/15 10:00:00,95,111,-16
19039,19039,177,2022/4/15 10:10:00,76,105,-29
19040,19040,177,2022/4/15 10:20:00,69,93,-24
19041,19041,177,2022/4/15 10:30:00,52,93,-41
19042,19042,177,2022/4/15 10:40:00,48,80,-32
19043,19043,177,2022/4/15 10:50:00,47,84,-37
19044,19044,177,2022/4/15 11:00:00,47,101,-54
19045,19045,177,2022/4/15 11:10:00,48,91,-43
19046,19046,177,2022/4/15 11:20:00,45,87,-42
19047,19047,177,2022/4/15 11:30:00,45,75,-30
19048,19048,177,2022/4/15 11:40:00,45,93,-48
19049,19049,177,2022/4/15 11:50:00,45,87,-42
19050,19050,177,2022/4/15 12:00:00,48,96,-48
19051,19051,177,2022/4/15 12:10:00,55,88,-33
19052,19052,177,2022/4/15 12:20:00,70,93,-23
19053,19053,177,2022/4/15 12:30:00,46,96,-50
19054,19054,177,2022/4/15 12:40:00,55,91,-36
19055,19055,177,2022/4/15 12:50:00,56,104,-48
19056,19056,177,2022/4/15 13:00:00,57,91,-34
19057,19057,177,2022/4/15 13:10:00,58,106,-48
19058,19058,177,2022/4/15 13:20:00,48,104,-56
19059,19059,177,2022/4/15 13:30:00,43,99,-56
19060,19060,177,2022/4/15 13:40:00,46,99,-53
19061,19061,177,2022/4/15 13:50:00,45,93,-48
19062,19062,177,2022/4/15 14:00:00,45,105,-60
19063,19063,177,2022/4/15 14:10:00,44,97,-53
19064,19064,177,2022/4/15 14:20:00,44,102,-58
19065,19065,177,2022/4/15 14:30:00,44,114,-70
19066,19066,177,2022/4/15 14:40:00,52,108,-56
19067,19067,177,2022/4/15 14:50:00,54,105,-51
19068,19068,177,2022/4/15 15:00:00,45,108,-63
19069,19069,177,2022/4/15 15:10:00,50,87,-37
19070,19070,177,2022/4/15 15:20:00,47,102,-55
19071,19071,177,2022/4/15 15:30:00,58,122,-64
19072,19072,177,2022/4/15 15:40:00,46,125,-79
19073,19073,177,2022/4/15 15:50:00,47,122,-75
19074,19074,177,2022/4/15 16:00:00,49,123,-74
19075,19075,177,2022/4/15 16:10:00,76,106,-30
19076,19076,177,2022/4/15 16:20:00,67,125,-58
19077,19077,177,2022/4/15 16:30:00,70,110,-40
19078,19078,177,2022/4/15 16:40:00,97,154,-57
19079,19079,177,2022/4/15 16:50:00,74,110,-36
19080,19080,177,2022/4/15 17:00:00,181,229,-48
19081,19081,177,2022/4/15 17:10:00,244,220,24
19082,19082,177,2022/4/15 17:20:00,220,316,-96
19083,19083,177,2022/4/15 17:30:00,216,376,-160
19084,19084,177,2022/4/15 17:40:00,268,534,-266
19085,19085,177,2022/4/15 17:50:00,237,499,-262
19086,19086,177,2022/4/15 18:00:00,197,430,-233
19087,19087,177,2022/4/15 18:10:00,234,434,-200
19088,19088,177,2022/4/15 18:20:00,179,432,-253
19089,19089,177,2022/4/15 18:30:00,157,435,-278
19090,19090,177,2022/4/15 18:40:00,176,428,-252
19091,19091,177,2022/4/15 18:50:00,131,429,-298
19092,19092,177,2022/4/15 19:00:00,72,380,-308
19093,19093,177,2022/4/15 19:10:00,68,326,-258
19094,19094,177,2022/4/15 19:20:00,46,232,-186
19095,19095,177,2022/4/15 19:30:00,44,178,-134
19096,19096,177,2022/4/15 19:40:00,41,184,-143
19097,19097,177,2022/4/15 19:50:00,39,115,-76
19098,19098,177,2022/4/15 20:00:00,39,116,-77
19099,19099,177,2022/4/15 20:10:00,39,111,-72
19100,19100,177,2022/4/15 20:20:00,38,121,-83
19101,19101,177,2022/4/15 20:30:00,32,111,-79
19102,19102,177,2022/4/15 20:40:00,35,124,-89
19103,19103,177,2022/4/15 20:50:00,39,119,-80
19104,19104,177,2022/4/15 21:00:00,38,104,-66
19105,19105,177,2022/4/15 21:10:00,33,113,-80
19106,19106,177,2022/4/15 21:20:00,35,134,-99
19107,19107,177,2022/4/15 21:30:00,32,124,-92
19108,19108,177,2022/4/15 21:40:00,33,116,-83
19109,19109,177,2022/4/15 21:50:00,24,123,-99
19110,19110,177,2022/4/15 22:00:00,27,113,-86
19111,19111,177,2022/4/15 22:10:00,25,106,-81
19112,19112,177,2022/4/15 22:20:00,19,121,-102
19113,19113,177,2022/4/15 22:30:00,18,105,-87
19114,19114,177,2022/4/15 22:40:00,14,93,-79
19115,19115,177,2022/4/15 22:50:00,8,72,-64
19116,19116,178,2022/4/15 5:00:00,0,1,-1
19117,19117,178,2022/4/15 5:10:00,0,1,-1
19118,19118,178,2022/4/15 5:20:00,0,1,-1
19119,19119,178,2022/4/15 5:30:00,10,1,9
19120,19120,178,2022/4/15 5:40:00,23,1,22
19121,19121,178,2022/4/15 5:50:00,42,5,37
19122,19122,178,2022/4/15 6:00:00,33,29,4
19123,19123,178,2022/4/15 6:10:00,53,25,28
19124,19124,178,2022/4/15 6:20:00,53,45,8
19125,19125,178,2022/4/15 6:30:00,65,64,1
19126,19126,178,2022/4/15 6:40:00,101,77,24
19127,19127,178,2022/4/15 6:50:00,176,102,74
19128,19128,178,2022/4/15 7:00:00,215,101,114
19129,19129,178,2022/4/15 7:10:00,244,118,126
19130,19130,178,2022/4/15 7:20:00,300,110,190
19131,19131,178,2022/4/15 7:30:00,347,192,155
19132,19132,178,2022/4/15 7:40:00,598,298,300
19133,19133,178,2022/4/15 7:50:00,596,327,269
19134,19134,178,2022/4/15 8:00:00,663,424,239
19135,19135,178,2022/4/15 8:10:00,664,470,194
19136,19136,178,2022/4/15 8:20:00,664,564,100
19137,19137,178,2022/4/15 8:30:00,474,1085,-611
19138,19138,178,2022/4/15 8:40:00,367,1507,-1140
19139,19139,178,2022/4/15 8:50:00,361,1671,-1310
19140,19140,178,2022/4/15 9:00:00,273,1136,-863
19141,19141,178,2022/4/15 9:10:00,220,571,-351
19142,19142,178,2022/4/15 9:20:00,200,479,-279
19143,19143,178,2022/4/15 9:30:00,179,498,-319
19144,19144,178,2022/4/15 9:40:00,136,431,-295
19145,19145,178,2022/4/15 9:50:00,108,254,-146
19146,19146,178,2022/4/15 10:00:00,76,146,-70
19147,19147,178,2022/4/15 10:10:00,75,124,-49
19148,19148,178,2022/4/15 10:20:00,72,108,-36
19149,19149,178,2022/4/15 10:30:00,63,116,-53
19150,19150,178,2022/4/15 10:40:00,60,112,-52
19151,19151,178,2022/4/15 10:50:00,52,124,-72
19152,19152,178,2022/4/15 11:00:00,66,114,-48
19153,19153,178,2022/4/15 11:10:00,66,99,-33
19154,19154,178,2022/4/15 11:20:00,68,100,-32
19155,19155,178,2022/4/15 11:30:00,71,105,-34
19156,19156,178,2022/4/15 11:40:00,69,114,-45
19157,19157,178,2022/4/15 11:50:00,76,102,-26
19158,19158,178,2022/4/15 12:00:00,92,108,-16
19159,19159,178,2022/4/15 12:10:00,86,121,-35
19160,19160,178,2022/4/15 12:20:00,92,105,-13
19161,19161,178,2022/4/15 12:30:00,74,119,-45
19162,19162,178,2022/4/15 12:40:00,78,125,-47
19163,19163,178,2022/4/15 12:50:00,71,115,-44
19164,19164,178,2022/4/15 13:00:00,76,123,-47
19165,19165,178,2022/4/15 13:10:00,77,116,-39
19166,19166,178,2022/4/15 13:20:00,77,124,-47
19167,19167,178,2022/4/15 13:30:00,86,103,-17
19168,19168,178,2022/4/15 13:40:00,78,112,-34
19169,19169,178,2022/4/15 13:50:00,76,106,-30
19170,19170,178,2022/4/15 14:00:00,75,114,-39
19171,19171,178,2022/4/15 14:10:00,89,123,-34
19172,19172,178,2022/4/15 14:20:00,77,113,-36
19173,19173,178,2022/4/15 14:30:00,75,122,-47
19174,19174,178,2022/4/15 14:40:00,75,108,-33
19175,19175,178,2022/4/15 14:50:00,73,124,-51
19176,19176,178,2022/4/15 15:00:00,103,106,-3
19177,19177,178,2022/4/15 15:10:00,128,125,3
19178,19178,178,2022/4/15 15:20:00,126,120,6
19179,19179,178,2022/4/15 15:30:00,113,124,-11
19180,19180,178,2022/4/15 15:40:00,138,126,12
19181,19181,178,2022/4/15 15:50:00,132,123,9
19182,19182,178,2022/4/15 16:00:00,175,126,49
19183,19183,178,2022/4/15 16:10:00,194,107,87
19184,19184,178,2022/4/15 16:20:00,200,105,95
19185,19185,178,2022/4/15 16:30:00,235,107,128
19186,19186,178,2022/4/15 16:40:00,221,109,112
19187,19187,178,2022/4/15 16:50:00,289,144,145
19188,19188,178,2022/4/15 17:00:00,674,137,537
19189,19189,178,2022/4/15 17:10:00,713,151,562
19190,19190,178,2022/4/15 17:20:00,637,216,421
19191,19191,178,2022/4/15 17:30:00,837,195,642
19192,19192,178,2022/4/15 17:40:00,1158,254,904
19193,19193,178,2022/4/15 17:50:00,667,322,345
19194,19194,178,2022/4/15 18:00:00,668,336,332
19195,19195,178,2022/4/15 18:10:00,1158,336,822
19196,19196,178,2022/4/15 18:20:00,711,328,383
19197,19197,178,2022/4/15 18:30:00,577,335,242
19198,19198,178,2022/4/15 18:40:00,422,301,121
19199,19199,178,2022/4/15 18:50:00,314,301,13
19200,19200,178,2022/4/15 19:00:00,273,209,64
19201,19201,178,2022/4/15 19:10:00,226,184,42
19202,19202,178,2022/4/15 19:20:00,209,144,65
19203,19203,178,2022/4/15 19:30:00,175,111,64
19204,19204,178,2022/4/15 19:40:00,149,117,32
19205,19205,178,2022/4/15 19:50:00,129,124,5
19206,19206,178,2022/4/15 20:00:00,102,108,-6
19207,19207,178,2022/4/15 20:10:00,129,102,27
19208,19208,178,2022/4/15 20:20:00,73,112,-39
19209,19209,178,2022/4/15 20:30:00,75,124,-49
19210,19210,178,2022/4/15 20:40:00,74,102,-28
19211,19211,178,2022/4/15 20:50:00,73,106,-33
19212,19212,178,2022/4/15 21:00:00,69,124,-55
19213,19213,178,2022/4/15 21:10:00,86,106,-20
19214,19214,178,2022/4/15 21:20:00,63,107,-44
19215,19215,178,2022/4/15 21:30:00,48,124,-76
19216,19216,178,2022/4/15 21:40:00,47,112,-65
19217,19217,178,2022/4/15 21:50:00,39,99,-60
19218,19218,178,2022/4/15 22:00:00,40,107,-67
19219,19219,178,2022/4/15 22:10:00,35,91,-56
19220,19220,178,2022/4/15 22:20:00,31,92,-61
19221,19221,178,2022/4/15 22:30:00,24,123,-99
19222,19222,178,2022/4/15 22:40:00,15,103,-88
19223,19223,178,2022/4/15 22:50:00,11,70,-59
19224,19224,179,2022/4/15 5:00:00,0,1,-1
19225,19225,179,2022/4/15 5:10:00,1,1,0
19226,19226,179,2022/4/15 5:20:00,6,1,5
19227,19227,179,2022/4/15 5:30:00,10,1,9
19228,19228,179,2022/4/15 5:40:00,7,1,6
19229,19229,179,2022/4/15 5:50:00,12,5,7
19230,19230,179,2022/4/15 6:00:00,21,5,16
19231,19231,179,2022/4/15 6:10:00,38,11,27
19232,19232,179,2022/4/15 6:20:00,43,46,-3
19233,19233,179,2022/4/15 6:30:00,59,54,5
19234,19234,179,2022/4/15 6:40:00,78,75,3
19235,19235,179,2022/4/15 6:50:00,146,100,46
19236,19236,179,2022/4/15 7:00:00,152,118,34
19237,19237,179,2022/4/15 7:10:00,170,103,67
19238,19238,179,2022/4/15 7:20:00,234,89,145
19239,19239,179,2022/4/15 7:30:00,273,124,149
19240,19240,179,2022/4/15 7:40:00,281,127,154
19241,19241,179,2022/4/15 7:50:00,324,197,127
19242,19242,179,2022/4/15 8:00:00,339,331,8
19243,19243,179,2022/4/15 8:10:00,392,435,-43
19244,19244,179,2022/4/15 8:20:00,385,432,-47
19245,19245,179,2022/4/15 8:30:00,349,362,-13
19246,19246,179,2022/4/15 8:40:00,270,339,-69
19247,19247,179,2022/4/15 8:50:00,239,280,-41
19248,19248,179,2022/4/15 9:00:00,199,233,-34
19249,19249,179,2022/4/15 9:10:00,167,152,15
19250,19250,179,2022/4/15 9:20:00,120,117,3
19251,19251,179,2022/4/15 9:30:00,82,102,-20
19252,19252,179,2022/4/15 9:40:00,67,126,-59
19253,19253,179,2022/4/15 9:50:00,49,86,-37
19254,19254,179,2022/4/15 10:00:00,57,95,-38
19255,19255,179,2022/4/15 10:10:00,47,96,-49
19256,19256,179,2022/4/15 10:20:00,48,101,-53
19257,19257,179,2022/4/15 10:30:00,44,75,-31
19258,19258,179,2022/4/15 10:40:00,46,101,-55
19259,19259,179,2022/4/15 10:50:00,44,66,-22
19260,19260,179,2022/4/15 11:00:00,43,69,-26
19261,19261,179,2022/4/15 11:10:00,41,82,-41
19262,19262,179,2022/4/15 11:20:00,42,67,-25
19263,19263,179,2022/4/15 11:30:00,43,93,-50
19264,19264,179,2022/4/15 11:40:00,43,74,-31
19265,19265,179,2022/4/15 11:50:00,46,75,-29
19266,19266,179,2022/4/15 12:00:00,46,87,-41
19267,19267,179,2022/4/15 12:10:00,43,62,-19
19268,19268,179,2022/4/15 12:20:00,44,112,-68
19269,19269,179,2022/4/15 12:30:00,47,77,-30
19270,19270,179,2022/4/15 12:40:00,45,124,-79
19271,19271,179,2022/4/15 12:50:00,45,91,-46
19272,19272,179,2022/4/15 13:00:00,42,101,-59
19273,19273,179,2022/4/15 13:10:00,45,104,-59
19274,19274,179,2022/4/15 13:20:00,43,77,-34
19275,19275,179,2022/4/15 13:30:00,43,109,-66
19276,19276,179,2022/4/15 13:40:00,43,77,-34
19277,19277,179,2022/4/15 13:50:00,45,102,-57
19278,19278,179,2022/4/15 14:00:00,45,76,-31
19279,19279,179,2022/4/15 14:10:00,47,97,-50
19280,19280,179,2022/4/15 14:20:00,43,105,-62
19281,19281,179,2022/4/15 14:30:00,48,76,-28
19282,19282,179,2022/4/15 14:40:00,45,88,-43
19283,19283,179,2022/4/15 14:50:00,48,72,-24
19284,19284,179,2022/4/15 15:00:00,57,111,-54
19285,19285,179,2022/4/15 15:10:00,70,73,-3
19286,19286,179,2022/4/15 15:20:00,52,91,-39
19287,19287,179,2022/4/15 15:30:00,58,103,-45
19288,19288,179,2022/4/15 15:40:00,63,87,-24
19289,19289,179,2022/4/15 15:50:00,64,102,-38
19290,19290,179,2022/4/15 16:00:00,73,81,-8
19291,19291,179,2022/4/15 16:10:00,75,112,-37
19292,19292,179,2022/4/15 16:20:00,78,92,-14
19293,19293,179,2022/4/15 16:30:00,163,114,49
19294,19294,179,2022/4/15 16:40:00,208,105,103
19295,19295,179,2022/4/15 16:50:00,206,100,106
19296,19296,179,2022/4/15 17:00:00,278,100,178
19297,19297,179,2022/4/15 17:10:00,312,127,185
19298,19298,179,2022/4/15 17:20:00,216,108,108
19299,19299,179,2022/4/15 17:30:00,204,190,14
19300,19300,179,2022/4/15 17:40:00,334,221,113
19301,19301,179,2022/4/15 17:50:00,224,177,47
19302,19302,179,2022/4/15 18:00:00,178,218,-40
19303,19303,179,2022/4/15 18:10:00,264,214,50
19304,19304,179,2022/4/15 18:20:00,233,193,40
19305,19305,179,2022/4/15 18:30:00,170,198,-28
19306,19306,179,2022/4/15 18:40:00,114,180,-66
19307,19307,179,2022/4/15 18:50:00,73,150,-77
19308,19308,179,2022/4/15 19:00:00,55,126,-71
19309,19309,179,2022/4/15 19:10:00,49,112,-63
19310,19310,179,2022/4/15 19:20:00,43,104,-61
19311,19311,179,2022/4/15 19:30:00,45,122,-77
19312,19312,179,2022/4/15 19:40:00,44,99,-55
19313,19313,179,2022/4/15 19:50:00,39,95,-56
19314,19314,179,2022/4/15 20:00:00,37,114,-77
19315,19315,179,2022/4/15 20:10:00,36,85,-49
19316,19316,179,2022/4/15 20:20:00,36,92,-56
19317,19317,179,2022/4/15 20:30:00,35,103,-68
19318,19318,179,2022/4/15 20:40:00,39,83,-44
19319,19319,179,2022/4/15 20:50:00,35,102,-67
19320,19320,179,2022/4/15 21:00:00,35,103,-68
19321,19321,179,2022/4/15 21:10:00,38,82,-44
19322,19322,179,2022/4/15 21:20:00,29,107,-78
19323,19323,179,2022/4/15 21:30:00,30,104,-74
19324,19324,179,2022/4/15 21:40:00,27,94,-67
19325,19325,179,2022/4/15 21:50:00,25,95,-70
19326,19326,179,2022/4/15 22:00:00,21,97,-76
19327,19327,179,2022/4/15 22:10:00,16,86,-70
19328,19328,179,2022/4/15 22:20:00,13,89,-76
19329,19329,179,2022/4/15 22:30:00,5,83,-78
19330,19330,179,2022/4/15 22:40:00,2,7,-5
19331,19331,179,2022/4/15 22:50:00,1,31,-30
19332,19332,180,2022/4/15 5:00:00,0,1,-1
19333,19333,180,2022/4/15 5:10:00,0,1,-1
19334,19334,180,2022/4/15 5:20:00,4,1,3
19335,19335,180,2022/4/15 5:30:00,5,1,4
19336,19336,180,2022/4/15 5:40:00,11,1,10
19337,19337,180,2022/4/15 5:50:00,15,22,-7
19338,19338,180,2022/4/15 6:00:00,22,36,-14
19339,19339,180,2022/4/15 6:10:00,31,41,-10
19340,19340,180,2022/4/15 6:20:00,33,74,-41
19341,19341,180,2022/4/15 6:30:00,45,76,-31
19342,19342,180,2022/4/15 6:40:00,57,123,-66
19343,19343,180,2022/4/15 6:50:00,60,111,-51
19344,19344,180,2022/4/15 7:00:00,84,297,-213
19345,19345,180,2022/4/15 7:10:00,99,342,-243
19346,19346,180,2022/4/15 7:20:00,108,298,-190
19347,19347,180,2022/4/15 7:30:00,191,323,-132
19348,19348,180,2022/4/15 7:40:00,217,328,-111
19349,19349,180,2022/4/15 7:50:00,238,318,-80
19350,19350,180,2022/4/15 8:00:00,284,267,17
19351,19351,180,2022/4/15 8:10:00,329,318,11
19352,19352,180,2022/4/15 8:20:00,315,298,17
19353,19353,180,2022/4/15 8:30:00,276,283,-7
19354,19354,180,2022/4/15 8:40:00,274,268,6
19355,19355,180,2022/4/15 8:50:00,243,217,26
19356,19356,180,2022/4/15 9:00:00,220,208,12
19357,19357,180,2022/4/15 9:10:00,211,178,33
19358,19358,180,2022/4/15 9:20:00,183,161,22
19359,19359,180,2022/4/15 9:30:00,177,159,18
19360,19360,180,2022/4/15 9:40:00,146,117,29
19361,19361,180,2022/4/15 9:50:00,105,110,-5
19362,19362,180,2022/4/15 10:00:00,82,120,-38
19363,19363,180,2022/4/15 10:10:00,80,109,-29
19364,19364,180,2022/4/15 10:20:00,76,105,-29
19365,19365,180,2022/4/15 10:30:00,81,109,-28
19366,19366,180,2022/4/15 10:40:00,69,109,-40
19367,19367,180,2022/4/15 10:50:00,74,98,-24
19368,19368,180,2022/4/15 11:00:00,77,96,-19
19369,19369,180,2022/4/15 11:10:00,75,90,-15
19370,19370,180,2022/4/15 11:20:00,69,93,-24
19371,19371,180,2022/4/15 11:30:00,70,97,-27
19372,19372,180,2022/4/15 11:40:00,76,79,-3
19373,19373,180,2022/4/15 11:50:00,65,96,-31
19374,19374,180,2022/4/15 12:00:00,63,91,-28
19375,19375,180,2022/4/15 12:10:00,63,110,-47
19376,19376,180,2022/4/15 12:20:00,53,108,-55
19377,19377,180,2022/4/15 12:30:00,54,100,-46
19378,19378,180,2022/4/15 12:40:00,52,121,-69
19379,19379,180,2022/4/15 12:50:00,44,125,-81
19380,19380,180,2022/4/15 13:00:00,46,121,-75
19381,19381,180,2022/4/15 13:10:00,50,105,-55
19382,19382,180,2022/4/15 13:20:00,52,118,-66
19383,19383,180,2022/4/15 13:30:00,65,106,-41
19384,19384,180,2022/4/15 13:40:00,66,106,-40
19385,19385,180,2022/4/15 13:50:00,64,102,-38
19386,19386,180,2022/4/15 14:00:00,77,103,-26
19387,19387,180,2022/4/15 14:10:00,77,105,-28
19388,19388,180,2022/4/15 14:20:00,78,102,-24
19389,19389,180,2022/4/15 14:30:00,74,103,-29
19390,19390,180,2022/4/15 14:40:00,73,100,-27
19391,19391,180,2022/4/15 14:50:00,77,109,-32
19392,19392,180,2022/4/15 15:00:00,109,111,-2
19393,19393,180,2022/4/15 15:10:00,132,105,27
19394,19394,180,2022/4/15 15:20:00,128,110,18
19395,19395,180,2022/4/15 15:30:00,110,112,-2
19396,19396,180,2022/4/15 15:40:00,117,102,15
19397,19397,180,2022/4/15 15:50:00,125,106,19
19398,19398,180,2022/4/15 16:00:00,171,110,61
19399,19399,180,2022/4/15 16:10:00,182,99,83
19400,19400,180,2022/4/15 16:20:00,168,101,67
19401,19401,180,2022/4/15 16:30:00,235,106,129
19402,19402,180,2022/4/15 16:40:00,310,114,196
19403,19403,180,2022/4/15 16:50:00,265,103,162
19404,19404,180,2022/4/15 17:00:00,334,112,222
19405,19405,180,2022/4/15 17:10:00,310,127,183
19406,19406,180,2022/4/15 17:20:00,291,116,175
19407,19407,180,2022/4/15 17:30:00,263,109,154
19408,19408,180,2022/4/15 17:40:00,228,142,86
19409,19409,180,2022/4/15 17:50:00,186,115,71
19410,19410,180,2022/4/15 18:00:00,182,117,65
19411,19411,180,2022/4/15 18:10:00,216,143,73
19412,19412,180,2022/4/15 18:20:00,137,111,26
19413,19413,180,2022/4/15 18:30:00,70,117,-47
19414,19414,180,2022/4/15 18:40:00,73,171,-98
19415,19415,180,2022/4/15 18:50:00,60,109,-49
19416,19416,180,2022/4/15 19:00:00,48,122,-74
19417,19417,180,2022/4/15 19:10:00,47,104,-57
19418,19418,180,2022/4/15 19:20:00,48,105,-57
19419,19419,180,2022/4/15 19:30:00,40,107,-67
19420,19420,180,2022/4/15 19:40:00,39,95,-56
19421,19421,180,2022/4/15 19:50:00,35,102,-67
19422,19422,180,2022/4/15 20:00:00,35,76,-41
19423,19423,180,2022/4/15 20:10:00,40,86,-46
19424,19424,180,2022/4/15 20:20:00,32,76,-44
19425,19425,180,2022/4/15 20:30:00,30,78,-48
19426,19426,180,2022/4/15 20:40:00,33,87,-54
19427,19427,180,2022/4/15 20:50:00,37,90,-53
19428,19428,180,2022/4/15 21:00:00,28,76,-48
19429,19429,180,2022/4/15 21:10:00,29,71,-42
19430,19430,180,2022/4/15 21:20:00,29,94,-65
19431,19431,180,2022/4/15 21:30:00,27,94,-67
19432,19432,180,2022/4/15 21:40:00,28,87,-59
19433,19433,180,2022/4/15 21:50:00,23,78,-55
19434,19434,180,2022/4/15 22:00:00,21,87,-66
19435,19435,180,2022/4/15 22:10:00,21,72,-51
19436,19436,180,2022/4/15 22:20:00,14,71,-57
19437,19437,180,2022/4/15 22:30:00,8,87,-79
19438,19438,180,2022/4/15 22:40:00,10,57,-47
19439,19439,180,2022/4/15 22:50:00,4,43,-39
19440,19440,181,2022/4/15 5:00:00,0,1,-1
19441,19441,181,2022/4/15 5:10:00,0,1,-1
19442,19442,181,2022/4/15 5:20:00,0,1,-1
19443,19443,181,2022/4/15 5:30:00,1,1,0
19444,19444,181,2022/4/15 5:40:00,15,1,14
19445,19445,181,2022/4/15 5:50:00,21,12,9
19446,19446,181,2022/4/15 6:00:00,27,6,21
19447,19447,181,2022/4/15 6:10:00,26,17,9
19448,19448,181,2022/4/15 6:20:00,37,29,8
19449,19449,181,2022/4/15 6:30:00,47,38,9
19450,19450,181,2022/4/15 6:40:00,55,29,26
19451,19451,181,2022/4/15 6:50:00,59,51,8
19452,19452,181,2022/4/15 7:00:00,72,67,5
19453,19453,181,2022/4/15 7:10:00,103,72,31
19454,19454,181,2022/4/15 7:20:00,96,84,12
19455,19455,181,2022/4/15 7:30:00,123,95,28
19456,19456,181,2022/4/15 7:40:00,180,103,77
19457,19457,181,2022/4/15 7:50:00,234,101,133
19458,19458,181,2022/4/15 8:00:00,243,86,157
19459,19459,181,2022/4/15 8:10:00,254,110,144
19460,19460,181,2022/4/15 8:20:00,244,111,133
19461,19461,181,2022/4/15 8:30:00,214,146,68
19462,19462,181,2022/4/15 8:40:00,187,297,-110
19463,19463,181,2022/4/15 8:50:00,151,180,-29
19464,19464,181,2022/4/15 9:00:00,76,116,-40
19465,19465,181,2022/4/15 9:10:00,57,110,-53
19466,19466,181,2022/4/15 9:20:00,50,133,-83
19467,19467,181,2022/4/15 9:30:00,41,123,-82
19468,19468,181,2022/4/15 9:40:00,31,99,-68
19469,19469,181,2022/4/15 9:50:00,28,112,-84
19470,19470,181,2022/4/15 10:00:00,29,99,-70
19471,19471,181,2022/4/15 10:10:00,39,73,-34
19472,19472,181,2022/4/15 10:20:00,30,84,-54
19473,19473,181,2022/4/15 10:30:00,30,73,-43
19474,19474,181,2022/4/15 10:40:00,28,73,-45
19475,19475,181,2022/4/15 10:50:00,28,69,-41
19476,19476,181,2022/4/15 11:00:00,28,71,-43
19477,19477,181,2022/4/15 11:10:00,29,66,-37
19478,19478,181,2022/4/15 11:20:00,27,59,-32
19479,19479,181,2022/4/15 11:30:00,27,73,-46
19480,19480,181,2022/4/15 11:40:00,29,66,-37
19481,19481,181,2022/4/15 11:50:00,27,72,-45
19482,19482,181,2022/4/15 12:00:00,30,67,-37
19483,19483,181,2022/4/15 12:10:00,32,55,-23
19484,19484,181,2022/4/15 12:20:00,27,77,-50
19485,19485,181,2022/4/15 12:30:00,28,58,-30
19486,19486,181,2022/4/15 12:40:00,33,79,-46
19487,19487,181,2022/4/15 12:50:00,30,73,-43
19488,19488,181,2022/4/15 13:00:00,24,71,-47
19489,19489,181,2022/4/15 13:10:00,29,78,-49
19490,19490,181,2022/4/15 13:20:00,27,70,-43
19491,19491,181,2022/4/15 13:30:00,30,93,-63
19492,19492,181,2022/4/15 13:40:00,28,67,-39
19493,19493,181,2022/4/15 13:50:00,28,77,-49
19494,19494,181,2022/4/15 14:00:00,28,72,-44
19495,19495,181,2022/4/15 14:10:00,31,70,-39
19496,19496,181,2022/4/15 14:20:00,28,69,-41
19497,19497,181,2022/4/15 14:30:00,23,67,-44
19498,19498,181,2022/4/15 14:40:00,24,83,-59
19499,19499,181,2022/4/15 14:50:00,26,67,-41
19500,19500,181,2022/4/15 15:00:00,31,77,-46
19501,19501,181,2022/4/15 15:10:00,29,72,-43
19502,19502,181,2022/4/15 15:20:00,28,69,-41
19503,19503,181,2022/4/15 15:30:00,32,88,-56
19504,19504,181,2022/4/15 15:40:00,26,71,-45
19505,19505,181,2022/4/15 15:50:00,30,81,-51
19506,19506,181,2022/4/15 16:00:00,37,66,-29
19507,19507,181,2022/4/15 16:10:00,45,77,-32
19508,19508,181,2022/4/15 16:20:00,42,91,-49
19509,19509,181,2022/4/15 16:30:00,46,85,-39
19510,19510,181,2022/4/15 16:40:00,45,87,-42
19511,19511,181,2022/4/15 16:50:00,42,105,-63
19512,19512,181,2022/4/15 17:00:00,167,113,54
19513,19513,181,2022/4/15 17:10:00,186,105,81
19514,19514,181,2022/4/15 17:20:00,93,99,-6
19515,19515,181,2022/4/15 17:30:00,96,123,-27
19516,19516,181,2022/4/15 17:40:00,224,117,107
19517,19517,181,2022/4/15 17:50:00,156,109,47
19518,19518,181,2022/4/15 18:00:00,143,119,24
19519,19519,181,2022/4/15 18:10:00,223,111,112
19520,19520,181,2022/4/15 18:20:00,174,111,63
19521,19521,181,2022/4/15 18:30:00,102,124,-22
19522,19522,181,2022/4/15 18:40:00,77,128,-51
19523,19523,181,2022/4/15 18:50:00,49,111,-62
19524,19524,181,2022/4/15 19:00:00,46,125,-79
19525,19525,181,2022/4/15 19:10:00,50,107,-57
19526,19526,181,2022/4/15 19:20:00,39,115,-76
19527,19527,181,2022/4/15 19:30:00,32,95,-63
19528,19528,181,2022/4/15 19:40:00,29,78,-49
19529,19529,181,2022/4/15 19:50:00,28,77,-49
19530,19530,181,2022/4/15 20:00:00,29,71,-42
19531,19531,181,2022/4/15 20:10:00,25,87,-62
19532,19532,181,2022/4/15 20:20:00,27,66,-39
19533,19533,181,2022/4/15 20:30:00,27,74,-47
19534,19534,181,2022/4/15 20:40:00,29,78,-49
19535,19535,181,2022/4/15 20:50:00,29,77,-48
19536,19536,181,2022/4/15 21:00:00,25,74,-49
19537,19537,181,2022/4/15 21:10:00,27,78,-51
19538,19538,181,2022/4/15 21:20:00,21,68,-47
19539,19539,181,2022/4/15 21:30:00,22,83,-61
19540,19540,181,2022/4/15 21:40:00,22,78,-56
19541,19541,181,2022/4/15 21:50:00,23,70,-47
19542,19542,181,2022/4/15 22:00:00,23,76,-53
19543,19543,181,2022/4/15 22:10:00,19,67,-48
19544,19544,181,2022/4/15 22:20:00,10,66,-56
19545,19545,181,2022/4/15 22:30:00,11,67,-56
19546,19546,181,2022/4/15 22:40:00,8,56,-48
19547,19547,181,2022/4/15 22:50:00,5,62,-57
19548,19548,182,2022/4/15 5:00:00,0,1,-1
19549,19549,182,2022/4/15 5:10:00,0,1,-1
19550,19550,182,2022/4/15 5:20:00,0,1,-1
19551,19551,182,2022/4/15 5:30:00,7,1,6
19552,19552,182,2022/4/15 5:40:00,11,1,10
19553,19553,182,2022/4/15 5:50:00,20,16,4
19554,19554,182,2022/4/15 6:00:00,24,11,13
19555,19555,182,2022/4/15 6:10:00,31,38,-7
19556,19556,182,2022/4/15 6:20:00,31,32,-1
19557,19557,182,2022/4/15 6:30:00,54,38,16
19558,19558,182,2022/4/15 6:40:00,87,58,29
19559,19559,182,2022/4/15 6:50:00,89,75,14
19560,19560,182,2022/4/15 7:00:00,105,87,18
19561,19561,182,2022/4/15 7:10:00,196,111,85
19562,19562,182,2022/4/15 7:20:00,222,110,112
19563,19563,182,2022/4/15 7:30:00,281,155,126
19564,19564,182,2022/4/15 7:40:00,327,112,215
19565,19565,182,2022/4/15 7:50:00,573,179,394
19566,19566,182,2022/4/15 8:00:00,589,214,375
19567,19567,182,2022/4/15 8:10:00,629,504,125
19568,19568,182,2022/4/15 8:20:00,594,430,164
19569,19569,182,2022/4/15 8:30:00,356,1143,-787
19570,19570,182,2022/4/15 8:40:00,325,1143,-818
19571,19571,182,2022/4/15 8:50:00,283,596,-313
19572,19572,182,2022/4/15 9:00:00,239,425,-186
19573,19573,182,2022/4/15 9:10:00,177,490,-313
19574,19574,182,2022/4/15 9:20:00,155,330,-175
19575,19575,182,2022/4/15 9:30:00,85,221,-136
19576,19576,182,2022/4/15 9:40:00,66,169,-103
19577,19577,182,2022/4/15 9:50:00,68,131,-63
19578,19578,182,2022/4/15 10:00:00,46,103,-57
19579,19579,182,2022/4/15 10:10:00,47,103,-56
19580,19580,182,2022/4/15 10:20:00,46,97,-51
19581,19581,182,2022/4/15 10:30:00,38,104,-66
19582,19582,182,2022/4/15 10:40:00,42,92,-50
19583,19583,182,2022/4/15 10:50:00,36,93,-57
19584,19584,182,2022/4/15 11:00:00,41,76,-35
19585,19585,182,2022/4/15 11:10:00,42,93,-51
19586,19586,182,2022/4/15 11:20:00,44,83,-39
19587,19587,182,2022/4/15 11:30:00,38,96,-58
19588,19588,182,2022/4/15 11:40:00,41,96,-55
19589,19589,182,2022/4/15 11:50:00,42,87,-45
19590,19590,182,2022/4/15 12:00:00,43,92,-49
19591,19591,182,2022/4/15 12:10:00,43,87,-44
19592,19592,182,2022/4/15 12:20:00,43,93,-50
19593,19593,182,2022/4/15 12:30:00,46,99,-53
19594,19594,182,2022/4/15 12:40:00,47,110,-63
19595,19595,182,2022/4/15 12:50:00,44,106,-62
19596,19596,182,2022/4/15 13:00:00,46,93,-47
19597,19597,182,2022/4/15 13:10:00,49,106,-57
19598,19598,182,2022/4/15 13:20:00,46,106,-60
19599,19599,182,2022/4/15 13:30:00,41,101,-60
19600,19600,182,2022/4/15 13:40:00,40,102,-62
19601,19601,182,2022/4/15 13:50:00,46,101,-55
19602,19602,182,2022/4/15 14:00:00,46,109,-63
19603,19603,182,2022/4/15 14:10:00,56,101,-45
19604,19604,182,2022/4/15 14:20:00,44,100,-56
19605,19605,182,2022/4/15 14:30:00,45,93,-48
19606,19606,182,2022/4/15 14:40:00,43,96,-53
19607,19607,182,2022/4/15 14:50:00,47,108,-61
19608,19608,182,2022/4/15 15:00:00,46,93,-47
19609,19609,182,2022/4/15 15:10:00,48,111,-63
19610,19610,182,2022/4/15 15:20:00,55,97,-42
19611,19611,182,2022/4/15 15:30:00,55,112,-57
19612,19612,182,2022/4/15 15:40:00,55,102,-47
19613,19613,182,2022/4/15 15:50:00,54,109,-55
19614,19614,182,2022/4/15 16:00:00,68,106,-38
19615,19615,182,2022/4/15 16:10:00,91,97,-6
19616,19616,182,2022/4/15 16:20:00,76,110,-34
19617,19617,182,2022/4/15 16:30:00,86,85,1
19618,19618,182,2022/4/15 16:40:00,132,103,29
19619,19619,182,2022/4/15 16:50:00,109,122,-13
19620,19620,182,2022/4/15 17:00:00,237,118,119
19621,19621,182,2022/4/15 17:10:00,319,115,204
19622,19622,182,2022/4/15 17:20:00,257,125,132
19623,19623,182,2022/4/15 17:30:00,291,181,110
19624,19624,182,2022/4/15 17:40:00,682,190,492
19625,19625,182,2022/4/15 17:50:00,576,177,399
19626,19626,182,2022/4/15 18:00:00,426,227,199
19627,19627,182,2022/4/15 18:10:00,655,213,442
19628,19628,182,2022/4/15 18:20:00,668,213,455
19629,19629,182,2022/4/15 18:30:00,551,180,371
19630,19630,182,2022/4/15 18:40:00,350,215,135
19631,19631,182,2022/4/15 18:50:00,275,146,129
19632,19632,182,2022/4/15 19:00:00,214,111,103
19633,19633,182,2022/4/15 19:10:00,176,123,53
19634,19634,182,2022/4/15 19:20:00,103,119,-16
19635,19635,182,2022/4/15 19:30:00,69,102,-33
19636,19636,182,2022/4/15 19:40:00,66,106,-40
19637,19637,182,2022/4/15 19:50:00,55,106,-51
19638,19638,182,2022/4/15 20:00:00,46,92,-46
19639,19639,182,2022/4/15 20:10:00,54,95,-41
19640,19640,182,2022/4/15 20:20:00,42,82,-40
19641,19641,182,2022/4/15 20:30:00,45,86,-41
19642,19642,182,2022/4/15 20:40:00,47,95,-48
19643,19643,182,2022/4/15 20:50:00,44,99,-55
19644,19644,182,2022/4/15 21:00:00,43,71,-28
19645,19645,182,2022/4/15 21:10:00,48,95,-47
19646,19646,182,2022/4/15 21:20:00,38,96,-58
19647,19647,182,2022/4/15 21:30:00,34,75,-41
19648,19648,182,2022/4/15 21:40:00,31,93,-62
19649,19649,182,2022/4/15 21:50:00,30,83,-53
19650,19650,182,2022/4/15 22:00:00,25,79,-54
19651,19651,182,2022/4/15 22:10:00,27,78,-51
19652,19652,182,2022/4/15 22:20:00,17,73,-56
19653,19653,182,2022/4/15 22:30:00,16,65,-49
19654,19654,182,2022/4/15 22:40:00,12,52,-40
19655,19655,182,2022/4/15 22:50:00,4,54,-50
19656,19656,183,2022/4/15 5:00:00,0,1,-1
19657,19657,183,2022/4/15 5:10:00,0,1,-1
19658,19658,183,2022/4/15 5:20:00,0,1,-1
19659,19659,183,2022/4/15 5:30:00,5,1,4
19660,19660,183,2022/4/15 5:40:00,22,1,21
19661,19661,183,2022/4/15 5:50:00,44,8,36
19662,19662,183,2022/4/15 6:00:00,38,11,27
19663,19663,183,2022/4/15 6:10:00,51,23,28
19664,19664,183,2022/4/15 6:20:00,58,38,20
19665,19665,183,2022/4/15 6:30:00,84,45,39
19666,19666,183,2022/4/15 6:40:00,87,40,47
19667,19667,183,2022/4/15 6:50:00,226,82,144
19668,19668,183,2022/4/15 7:00:00,240,75,165
19669,19669,183,2022/4/15 7:10:00,281,110,171
19670,19670,183,2022/4/15 7:20:00,317,113,204
19671,19671,183,2022/4/15 7:30:00,567,106,461
19672,19672,183,2022/4/15 7:40:00,654,122,532
19673,19673,183,2022/4/15 7:50:00,685,133,552
19674,19674,183,2022/4/15 8:00:00,740,152,588
19675,19675,183,2022/4/15 8:10:00,741,267,474
19676,19676,183,2022/4/15 8:20:00,699,215,484
19677,19677,183,2022/4/15 8:30:00,631,231,400
19678,19678,183,2022/4/15 8:40:00,598,378,220
19679,19679,183,2022/4/15 8:50:00,349,321,28
19680,19680,183,2022/4/15 9:00:00,275,192,83
19681,19681,183,2022/4/15 9:10:00,236,146,90
19682,19682,183,2022/4/15 9:20:00,215,111,104
19683,19683,183,2022/4/15 9:30:00,166,109,57
19684,19684,183,2022/4/15 9:40:00,115,108,7
19685,19685,183,2022/4/15 9:50:00,71,122,-51
19686,19686,183,2022/4/15 10:00:00,62,93,-31
19687,19687,183,2022/4/15 10:10:00,54,108,-54
19688,19688,183,2022/4/15 10:20:00,53,81,-28
19689,19689,183,2022/4/15 10:30:00,47,92,-45
19690,19690,183,2022/4/15 10:40:00,44,84,-40
19691,19691,183,2022/4/15 10:50:00,45,91,-46
19692,19692,183,2022/4/15 11:00:00,45,99,-54
19693,19693,183,2022/4/15 11:10:00,43,69,-26
19694,19694,183,2022/4/15 11:20:00,44,110,-66
19695,19695,183,2022/4/15 11:30:00,43,76,-33
19696,19696,183,2022/4/15 11:40:00,41,102,-61
19697,19697,183,2022/4/15 11:50:00,41,99,-58
19698,19698,183,2022/4/15 12:00:00,46,88,-42
19699,19699,183,2022/4/15 12:10:00,45,106,-61
19700,19700,183,2022/4/15 12:20:00,48,75,-27
19701,19701,183,2022/4/15 12:30:00,48,112,-64
19702,19702,183,2022/4/15 12:40:00,49,93,-44
19703,19703,183,2022/4/15 12:50:00,48,106,-58
19704,19704,183,2022/4/15 13:00:00,54,105,-51
19705,19705,183,2022/4/15 13:10:00,48,93,-45
19706,19706,183,2022/4/15 13:20:00,44,108,-64
19707,19707,183,2022/4/15 13:30:00,47,84,-37
19708,19708,183,2022/4/15 13:40:00,43,97,-54
19709,19709,183,2022/4/15 13:50:00,42,93,-51
19710,19710,183,2022/4/15 14:00:00,45,104,-59
19711,19711,183,2022/4/15 14:10:00,42,105,-63
19712,19712,183,2022/4/15 14:20:00,44,93,-49
19713,19713,183,2022/4/15 14:30:00,46,105,-59
19714,19714,183,2022/4/15 14:40:00,44,87,-43
19715,19715,183,2022/4/15 14:50:00,43,100,-57
19716,19716,183,2022/4/15 15:00:00,46,100,-54
19717,19717,183,2022/4/15 15:10:00,60,104,-44
19718,19718,183,2022/4/15 15:20:00,59,107,-48
19719,19719,183,2022/4/15 15:30:00,53,106,-53
19720,19720,183,2022/4/15 15:40:00,57,118,-61
19721,19721,183,2022/4/15 15:50:00,55,103,-48
19722,19722,183,2022/4/15 16:00:00,76,121,-45
19723,19723,183,2022/4/15 16:10:00,64,121,-57
19724,19724,183,2022/4/15 16:20:00,67,118,-51
19725,19725,183,2022/4/15 16:30:00,74,108,-34
19726,19726,183,2022/4/15 16:40:00,133,107,26
19727,19727,183,2022/4/15 16:50:00,160,154,6
19728,19728,183,2022/4/15 17:00:00,207,115,92
19729,19729,183,2022/4/15 17:10:00,269,182,87
19730,19730,183,2022/4/15 17:20:00,216,221,-5
19731,19731,183,2022/4/15 17:30:00,224,296,-72
19732,19732,183,2022/4/15 17:40:00,375,317,58
19733,19733,183,2022/4/15 17:50:00,273,330,-57
19734,19734,183,2022/4/15 18:00:00,214,378,-164
19735,19735,183,2022/4/15 18:10:00,293,380,-87
19736,19736,183,2022/4/15 18:20:00,243,429,-186
19737,19737,183,2022/4/15 18:30:00,177,381,-204
19738,19738,183,2022/4/15 18:40:00,157,319,-162
19739,19739,183,2022/4/15 18:50:00,138,319,-181
19740,19740,183,2022/4/15 19:00:00,77,198,-121
19741,19741,183,2022/4/15 19:10:00,55,223,-168
19742,19742,183,2022/4/15 19:20:00,47,146,-99
19743,19743,183,2022/4/15 19:30:00,42,119,-77
19744,19744,183,2022/4/15 19:40:00,44,111,-67
19745,19745,183,2022/4/15 19:50:00,39,126,-87
19746,19746,183,2022/4/15 20:00:00,41,113,-72
19747,19747,183,2022/4/15 20:10:00,43,113,-70
19748,19748,183,2022/4/15 20:20:00,37,129,-92
19749,19749,183,2022/4/15 20:30:00,41,104,-63
19750,19750,183,2022/4/15 20:40:00,36,126,-90
19751,19751,183,2022/4/15 20:50:00,38,110,-72
19752,19752,183,2022/4/15 21:00:00,37,111,-74
19753,19753,183,2022/4/15 21:10:00,42,109,-67
19754,19754,183,2022/4/15 21:20:00,35,122,-87
19755,19755,183,2022/4/15 21:30:00,33,106,-73
19756,19756,183,2022/4/15 21:40:00,31,113,-82
19757,19757,183,2022/4/15 21:50:00,31,115,-84
19758,19758,183,2022/4/15 22:00:00,28,106,-78
19759,19759,183,2022/4/15 22:10:00,24,110,-86
19760,19760,183,2022/4/15 22:20:00,22,94,-72
19761,19761,183,2022/4/15 22:30:00,13,108,-95
19762,19762,183,2022/4/15 22:40:00,10,90,-80
19763,19763,183,2022/4/15 22:50:00,4,67,-63
19764,19764,184,2022/4/15 5:00:00,0,1,-1
19765,19765,184,2022/4/15 5:10:00,0,1,-1
19766,19766,184,2022/4/15 5:20:00,3,1,2
19767,19767,184,2022/4/15 5:30:00,11,1,10
19768,19768,184,2022/4/15 5:40:00,13,2,11
19769,19769,184,2022/4/15 5:50:00,19,2,17
19770,19770,184,2022/4/15 6:00:00,26,11,15
19771,19771,184,2022/4/15 6:10:00,38,20,18
19772,19772,184,2022/4/15 6:20:00,50,46,4
19773,19773,184,2022/4/15 6:30:00,63,63,0
19774,19774,184,2022/4/15 6:40:00,87,62,25
19775,19775,184,2022/4/15 6:50:00,157,87,70
19776,19776,184,2022/4/15 7:00:00,186,105,81
19777,19777,184,2022/4/15 7:10:00,207,150,57
19778,19778,184,2022/4/15 7:20:00,244,217,27
19779,19779,184,2022/4/15 7:30:00,275,325,-50
19780,19780,184,2022/4/15 7:40:00,359,324,35
19781,19781,184,2022/4/15 7:50:00,437,298,139
19782,19782,184,2022/4/15 8:00:00,475,523,-48
19783,19783,184,2022/4/15 8:10:00,598,431,167
19784,19784,184,2022/4/15 8:20:00,598,472,126
19785,19785,184,2022/4/15 8:30:00,390,1092,-702
19786,19786,184,2022/4/15 8:40:00,299,1131,-832
19787,19787,184,2022/4/15 8:50:00,246,418,-172
19788,19788,184,2022/4/15 9:00:00,216,479,-263
19789,19789,184,2022/4/15 9:10:00,177,414,-237
19790,19790,184,2022/4/15 9:20:00,167,434,-267
19791,19791,184,2022/4/15 9:30:00,104,326,-222
19792,19792,184,2022/4/15 9:40:00,77,298,-221
19793,19793,184,2022/4/15 9:50:00,65,191,-126
19794,19794,184,2022/4/15 10:00:00,65,159,-94
19795,19795,184,2022/4/15 10:10:00,59,128,-69
19796,19796,184,2022/4/15 10:20:00,53,116,-63
19797,19797,184,2022/4/15 10:30:00,53,108,-55
19798,19798,184,2022/4/15 10:40:00,49,123,-74
19799,19799,184,2022/4/15 10:50:00,47,104,-57
19800,19800,184,2022/4/15 11:00:00,44,112,-68
19801,19801,184,2022/4/15 11:10:00,48,101,-53
19802,19802,184,2022/4/15 11:20:00,54,87,-33
19803,19803,184,2022/4/15 11:30:00,50,98,-48
19804,19804,184,2022/4/15 11:40:00,54,122,-68
19805,19805,184,2022/4/15 11:50:00,56,112,-56
19806,19806,184,2022/4/15 12:00:00,66,107,-41
19807,19807,184,2022/4/15 12:10:00,68,109,-41
19808,19808,184,2022/4/15 12:20:00,66,108,-42
19809,19809,184,2022/4/15 12:30:00,73,116,-43
19810,19810,184,2022/4/15 12:40:00,68,126,-58
19811,19811,184,2022/4/15 12:50:00,58,117,-59
19812,19812,184,2022/4/15 13:00:00,67,88,-21
19813,19813,184,2022/4/15 13:10:00,66,118,-52
19814,19814,184,2022/4/15 13:20:00,57,116,-59
19815,19815,184,2022/4/15 13:30:00,72,102,-30
19816,19816,184,2022/4/15 13:40:00,67,125,-58
19817,19817,184,2022/4/15 13:50:00,62,125,-63
19818,19818,184,2022/4/15 14:00:00,64,119,-55
19819,19819,184,2022/4/15 14:10:00,67,120,-53
19820,19820,184,2022/4/15 14:20:00,64,102,-38
19821,19821,184,2022/4/15 14:30:00,97,121,-24
19822,19822,184,2022/4/15 14:40:00,96,109,-13
19823,19823,184,2022/4/15 14:50:00,88,96,-8
19824,19824,184,2022/4/15 15:00:00,109,126,-17
19825,19825,184,2022/4/15 15:10:00,132,121,11
19826,19826,184,2022/4/15 15:20:00,128,121,7
19827,19827,184,2022/4/15 15:30:00,110,116,-6
19828,19828,184,2022/4/15 15:40:00,110,126,-16
19829,19829,184,2022/4/15 15:50:00,109,124,-15
19830,19830,184,2022/4/15 16:00:00,190,123,67
19831,19831,184,2022/4/15 16:10:00,268,119,149
19832,19832,184,2022/4/15 16:20:00,275,121,154
19833,19833,184,2022/4/15 16:30:00,289,119,170
19834,19834,184,2022/4/15 16:40:00,329,117,212
19835,19835,184,2022/4/15 16:50:00,271,110,161
19836,19836,184,2022/4/15 17:00:00,552,127,425
19837,19837,184,2022/4/15 17:10:00,621,213,408
19838,19838,184,2022/4/15 17:20:00,353,169,184
19839,19839,184,2022/4/15 17:30:00,590,283,307
19840,19840,184,2022/4/15 17:40:00,659,283,376
19841,19841,184,2022/4/15 17:50:00,579,298,281
19842,19842,184,2022/4/15 18:00:00,422,300,122
19843,19843,184,2022/4/15 18:10:00,692,319,373
19844,19844,184,2022/4/15 18:20:00,584,300,284
19845,19845,184,2022/4/15 18:30:00,349,335,14
19846,19846,184,2022/4/15 18:40:00,270,285,-15
19847,19847,184,2022/4/15 18:50:00,229,222,7
19848,19848,184,2022/4/15 19:00:00,224,191,33
19849,19849,184,2022/4/15 19:10:00,185,180,5
19850,19850,184,2022/4/15 19:20:00,154,111,43
19851,19851,184,2022/4/15 19:30:00,129,120,9
19852,19852,184,2022/4/15 19:40:00,80,126,-46
19853,19853,184,2022/4/15 19:50:00,73,110,-37
19854,19854,184,2022/4/15 20:00:00,72,103,-31
19855,19855,184,2022/4/15 20:10:00,70,109,-39
19856,19856,184,2022/4/15 20:20:00,64,114,-50
19857,19857,184,2022/4/15 20:30:00,68,77,-9
19858,19858,184,2022/4/15 20:40:00,63,111,-48
19859,19859,184,2022/4/15 20:50:00,62,115,-53
19860,19860,184,2022/4/15 21:00:00,58,95,-37
19861,19861,184,2022/4/15 21:10:00,56,106,-50
19862,19862,184,2022/4/15 21:20:00,59,109,-50
19863,19863,184,2022/4/15 21:30:00,43,92,-49
19864,19864,184,2022/4/15 21:40:00,48,112,-64
19865,19865,184,2022/4/15 21:50:00,43,101,-58
19866,19866,184,2022/4/15 22:00:00,35,79,-44
19867,19867,184,2022/4/15 22:10:00,31,84,-53
19868,19868,184,2022/4/15 22:20:00,22,112,-90
19869,19869,184,2022/4/15 22:30:00,16,77,-61
19870,19870,184,2022/4/15 22:40:00,4,86,-82
19871,19871,184,2022/4/15 22:50:00,2,3,-1
19872,19872,185,2022/4/15 5:00:00,0,1,-1
19873,19873,185,2022/4/15 5:10:00,0,1,-1
19874,19874,185,2022/4/15 5:20:00,2,1,1
19875,19875,185,2022/4/15 5:30:00,7,1,6
19876,19876,185,2022/4/15 5:40:00,8,1,7
19877,19877,185,2022/4/15 5:50:00,13,1,12
19878,19878,185,2022/4/15 6:00:00,22,21,1
19879,19879,185,2022/4/15 6:10:00,25,40,-15
19880,19880,185,2022/4/15 6:20:00,32,45,-13
19881,19881,185,2022/4/15 6:30:00,39,69,-30
19882,19882,185,2022/4/15 6:40:00,46,83,-37
19883,19883,185,2022/4/15 6:50:00,57,90,-33
19884,19884,185,2022/4/15 7:00:00,51,90,-39
19885,19885,185,2022/4/15 7:10:00,72,93,-21
19886,19886,185,2022/4/15 7:20:00,79,105,-26
19887,19887,185,2022/4/15 7:30:00,98,119,-21
19888,19888,185,2022/4/15 7:40:00,183,111,72
19889,19889,185,2022/4/15 7:50:00,232,139,93
19890,19890,185,2022/4/15 8:00:00,234,267,-33
19891,19891,185,2022/4/15 8:10:00,243,334,-91
19892,19892,185,2022/4/15 8:20:00,244,381,-137
19893,19893,185,2022/4/15 8:30:00,206,433,-227
19894,19894,185,2022/4/15 8:40:00,155,432,-277
19895,19895,185,2022/4/15 8:50:00,92,379,-287
19896,19896,185,2022/4/15 9:00:00,70,255,-185
19897,19897,185,2022/4/15 9:10:00,70,207,-137
19898,19898,185,2022/4/15 9:20:00,58,154,-96
19899,19899,185,2022/4/15 9:30:00,46,119,-73
19900,19900,185,2022/4/15 9:40:00,41,108,-67
19901,19901,185,2022/4/15 9:50:00,38,104,-66
19902,19902,185,2022/4/15 10:00:00,38,111,-73
19903,19903,185,2022/4/15 10:10:00,33,98,-65
19904,19904,185,2022/4/15 10:20:00,35,97,-62
19905,19905,185,2022/4/15 10:30:00,37,92,-55
19906,19906,185,2022/4/15 10:40:00,32,97,-65
19907,19907,185,2022/4/15 10:50:00,35,90,-55
19908,19908,185,2022/4/15 11:00:00,38,76,-38
19909,19909,185,2022/4/15 11:10:00,34,92,-58
19910,19910,185,2022/4/15 11:20:00,37,68,-31
19911,19911,185,2022/4/15 11:30:00,37,87,-50
19912,19912,185,2022/4/15 11:40:00,36,70,-34
19913,19913,185,2022/4/15 11:50:00,38,76,-38
19914,19914,185,2022/4/15 12:00:00,38,76,-38
19915,19915,185,2022/4/15 12:10:00,38,68,-30
19916,19916,185,2022/4/15 12:20:00,37,110,-73
19917,19917,185,2022/4/15 12:30:00,38,72,-34
19918,19918,185,2022/4/15 12:40:00,37,105,-68
19919,19919,185,2022/4/15 12:50:00,37,74,-37
19920,19920,185,2022/4/15 13:00:00,38,93,-55
19921,19921,185,2022/4/15 13:10:00,41,103,-62
19922,19922,185,2022/4/15 13:20:00,36,74,-38
19923,19923,185,2022/4/15 13:30:00,37,96,-59
19924,19924,185,2022/4/15 13:40:00,44,84,-40
19925,19925,185,2022/4/15 13:50:00,39,106,-67
19926,19926,185,2022/4/15 14:00:00,39,81,-42
19927,19927,185,2022/4/15 14:10:00,45,83,-38
19928,19928,185,2022/4/15 14:20:00,40,100,-60
19929,19929,185,2022/4/15 14:30:00,38,76,-38
19930,19930,185,2022/4/15 14:40:00,45,102,-57
19931,19931,185,2022/4/15 14:50:00,43,78,-35
19932,19932,185,2022/4/15 15:00:00,44,103,-59
19933,19933,185,2022/4/15 15:10:00,53,84,-31
19934,19934,185,2022/4/15 15:20:00,49,82,-33
19935,19935,185,2022/4/15 15:30:00,50,94,-44
19936,19936,185,2022/4/15 15:40:00,67,91,-24
19937,19937,185,2022/4/15 15:50:00,57,100,-43
19938,19938,185,2022/4/15 16:00:00,83,76,7
19939,19939,185,2022/4/15 16:10:00,96,101,-5
19940,19940,185,2022/4/15 16:20:00,74,77,-3
19941,19941,185,2022/4/15 16:30:00,114,90,24
19942,19942,185,2022/4/15 16:40:00,148,103,45
19943,19943,185,2022/4/15 16:50:00,169,81,88
19944,19944,185,2022/4/15 17:00:00,277,103,174
19945,19945,185,2022/4/15 17:10:00,273,107,166
19946,19946,185,2022/4/15 17:20:00,217,123,94
19947,19947,185,2022/4/15 17:30:00,319,111,208
19948,19948,185,2022/4/15 17:40:00,607,102,505
19949,19949,185,2022/4/15 17:50:00,265,106,159
19950,19950,185,2022/4/15 18:00:00,218,126,92
19951,19951,185,2022/4/15 18:10:00,291,107,184
19952,19952,185,2022/4/15 18:20:00,221,112,109
19953,19953,185,2022/4/15 18:30:00,170,128,42
19954,19954,185,2022/4/15 18:40:00,167,126,41
19955,19955,185,2022/4/15 18:50:00,75,123,-48
19956,19956,185,2022/4/15 19:00:00,57,109,-52
19957,19957,185,2022/4/15 19:10:00,46,107,-61
19958,19958,185,2022/4/15 19:20:00,46,110,-64
19959,19959,185,2022/4/15 19:30:00,34,90,-56
19960,19960,185,2022/4/15 19:40:00,31,87,-56
19961,19961,185,2022/4/15 19:50:00,31,74,-43
19962,19962,185,2022/4/15 20:00:00,30,79,-49
19963,19963,185,2022/4/15 20:10:00,27,69,-42
19964,19964,185,2022/4/15 20:20:00,29,69,-40
19965,19965,185,2022/4/15 20:30:00,25,95,-70
19966,19966,185,2022/4/15 20:40:00,28,67,-39
19967,19967,185,2022/4/15 20:50:00,29,72,-43
19968,19968,185,2022/4/15 21:00:00,26,95,-69
19969,19969,185,2022/4/15 21:10:00,23,73,-50
19970,19970,185,2022/4/15 21:20:00,29,68,-39
19971,19971,185,2022/4/15 21:30:00,27,100,-73
19972,19972,185,2022/4/15 21:40:00,23,73,-50
19973,19973,185,2022/4/15 21:50:00,22,67,-45
19974,19974,185,2022/4/15 22:00:00,22,85,-63
19975,19975,185,2022/4/15 22:10:00,18,62,-44
19976,19976,185,2022/4/15 22:20:00,11,69,-58
19977,19977,185,2022/4/15 22:30:00,8,68,-60
19978,19978,185,2022/4/15 22:40:00,1,48,-47
19979,19979,185,2022/4/15 22:50:00,1,25,-24
19980,19980,186,2022/4/15 5:00:00,0,1,-1
19981,19981,186,2022/4/15 5:10:00,0,1,-1
19982,19982,186,2022/4/15 5:20:00,0,1,-1
19983,19983,186,2022/4/15 5:30:00,2,1,1
19984,19984,186,2022/4/15 5:40:00,7,1,6
19985,19985,186,2022/4/15 5:50:00,9,14,-5
19986,19986,186,2022/4/15 6:00:00,8,33,-25
19987,19987,186,2022/4/15 6:10:00,11,46,-35
19988,19988,186,2022/4/15 6:20:00,15,47,-32
19989,19989,186,2022/4/15 6:30:00,18,71,-53
19990,19990,186,2022/4/15 6:40:00,20,73,-53
19991,19991,186,2022/4/15 6:50:00,24,70,-46
19992,19992,186,2022/4/15 7:00:00,26,107,-81
19993,19993,186,2022/4/15 7:10:00,29,122,-93
19994,19994,186,2022/4/15 7:20:00,32,158,-126
19995,19995,186,2022/4/15 7:30:00,47,297,-250
19996,19996,186,2022/4/15 7:40:00,56,415,-359
19997,19997,186,2022/4/15 7:50:00,59,1635,-1576
19998,19998,186,2022/4/15 8:00:00,83,2125,-2042
19999,19999,186,2022/4/15 8:10:00,91,4412,-4321
20000,20000,186,2022/4/15 8:20:00,77,4257,-4180
20001,20001,186,2022/4/15 8:30:00,75,5743,-5668
20002,20002,186,2022/4/15 8:40:00,69,3843,-3774
20003,20003,186,2022/4/15 8:50:00,66,4893,-4827
20004,20004,186,2022/4/15 9:00:00,44,4317,-4273
20005,20005,186,2022/4/15 9:10:00,56,3276,-3220
20006,20006,186,2022/4/15 9:20:00,64,1447,-1383
20007,20007,186,2022/4/15 9:30:00,51,632,-581
20008,20008,186,2022/4/15 9:40:00,47,518,-471
20009,20009,186,2022/4/15 9:50:00,51,373,-322
20010,20010,186,2022/4/15 10:00:00,48,299,-251
20011,20011,186,2022/4/15 10:10:00,60,109,-49
20012,20012,186,2022/4/15 10:20:00,54,198,-144
20013,20013,186,2022/4/15 10:30:00,59,109,-50
20014,20014,186,2022/4/15 10:40:00,59,142,-83
20015,20015,186,2022/4/15 10:50:00,71,122,-51
20016,20016,186,2022/4/15 11:00:00,75,105,-30
20017,20017,186,2022/4/15 11:10:00,67,128,-61
20018,20018,186,2022/4/15 11:20:00,69,93,-24
20019,20019,186,2022/4/15 11:30:00,86,120,-34
20020,20020,186,2022/4/15 11:40:00,107,111,-4
20021,20021,186,2022/4/15 11:50:00,76,107,-31
20022,20022,186,2022/4/15 12:00:00,82,112,-30
20023,20023,186,2022/4/15 12:10:00,89,99,-10
20024,20024,186,2022/4/15 12:20:00,69,125,-56
20025,20025,186,2022/4/15 12:30:00,69,109,-40
20026,20026,186,2022/4/15 12:40:00,67,170,-103
20027,20027,186,2022/4/15 12:50:00,70,107,-37
20028,20028,186,2022/4/15 13:00:00,75,135,-60
20029,20029,186,2022/4/15 13:10:00,84,121,-37
20030,20030,186,2022/4/15 13:20:00,88,104,-16
20031,20031,186,2022/4/15 13:30:00,97,180,-83
20032,20032,186,2022/4/15 13:40:00,91,121,-30
20033,20033,186,2022/4/15 13:50:00,85,146,-61
20034,20034,186,2022/4/15 14:00:00,88,106,-18
20035,20035,186,2022/4/15 14:10:00,132,105,27
20036,20036,186,2022/4/15 14:20:00,92,99,-7
20037,20037,186,2022/4/15 14:30:00,110,106,4
20038,20038,186,2022/4/15 14:40:00,129,120,9
20039,20039,186,2022/4/15 14:50:00,133,106,27
20040,20040,186,2022/4/15 15:00:00,155,121,34
20041,20041,186,2022/4/15 15:10:00,194,101,93
20042,20042,186,2022/4/15 15:20:00,179,121,58
20043,20043,186,2022/4/15 15:30:00,173,107,66
20044,20044,186,2022/4/15 15:40:00,144,105,39
20045,20045,186,2022/4/15 15:50:00,179,112,67
20046,20046,186,2022/4/15 16:00:00,207,95,112
20047,20047,186,2022/4/15 16:10:00,216,118,98
20048,20048,186,2022/4/15 16:20:00,225,97,128
20049,20049,186,2022/4/15 16:30:00,270,93,177
20050,20050,186,2022/4/15 16:40:00,345,105,240
20051,20051,186,2022/4/15 16:50:00,338,101,237
20052,20052,186,2022/4/15 17:00:00,1021,112,909
20053,20053,186,2022/4/15 17:10:00,1605,105,1500
20054,20054,186,2022/4/15 17:20:00,1198,109,1089
20055,20055,186,2022/4/15 17:30:00,1606,120,1486
20056,20056,186,2022/4/15 17:40:00,2550,127,2423
20057,20057,186,2022/4/15 17:50:00,1974,107,1867
20058,20058,186,2022/4/15 18:00:00,2004,123,1881
20059,20059,186,2022/4/15 18:10:00,3328,122,3206
20060,20060,186,2022/4/15 18:20:00,2472,124,2348
20061,20061,186,2022/4/15 18:30:00,1560,110,1450
20062,20062,186,2022/4/15 18:40:00,1146,105,1041
20063,20063,186,2022/4/15 18:50:00,799,109,690
20064,20064,186,2022/4/15 19:00:00,686,104,582
20065,20065,186,2022/4/15 19:10:00,569,80,489
20066,20066,186,2022/4/15 19:20:00,326,78,248
20067,20067,186,2022/4/15 19:30:00,277,73,204
20068,20068,186,2022/4/15 19:40:00,235,74,161
20069,20069,186,2022/4/15 19:50:00,197,62,135
20070,20070,186,2022/4/15 20:00:00,205,67,138
20071,20071,186,2022/4/15 20:10:00,193,53,140
20072,20072,186,2022/4/15 20:20:00,175,51,124
20073,20073,186,2022/4/15 20:30:00,174,62,112
20074,20074,186,2022/4/15 20:40:00,149,42,107
20075,20075,186,2022/4/15 20:50:00,102,46,56
20076,20076,186,2022/4/15 21:00:00,96,60,36
20077,20077,186,2022/4/15 21:10:00,175,47,128
20078,20078,186,2022/4/15 21:20:00,116,39,77
20079,20079,186,2022/4/15 21:30:00,65,63,2
20080,20080,186,2022/4/15 21:40:00,50,39,11
20081,20081,186,2022/4/15 21:50:00,37,40,-3
20082,20082,186,2022/4/15 22:00:00,35,59,-24
20083,20083,186,2022/4/15 22:10:00,36,37,-1
20084,20084,186,2022/4/15 22:20:00,28,34,-6
20085,20085,186,2022/4/15 22:30:00,18,35,-17
20086,20086,186,2022/4/15 22:40:00,17,35,-18
20087,20087,186,2022/4/15 22:50:00,3,23,-20
20088,20088,187,2022/4/15 5:00:00,0,1,-1
20089,20089,187,2022/4/15 5:10:00,0,1,-1
20090,20090,187,2022/4/15 5:20:00,0,1,-1
20091,20091,187,2022/4/15 5:30:00,7,1,6
20092,20092,187,2022/4/15 5:40:00,23,1,22
20093,20093,187,2022/4/15 5:50:00,32,16,16
20094,20094,187,2022/4/15 6:00:00,31,38,-7
20095,20095,187,2022/4/15 6:10:00,35,38,-3
20096,20096,187,2022/4/15 6:20:00,45,59,-14
20097,20097,187,2022/4/15 6:30:00,54,70,-16
20098,20098,187,2022/4/15 6:40:00,76,126,-50
20099,20099,187,2022/4/15 6:50:00,108,110,-2
20100,20100,187,2022/4/15 7:00:00,182,143,39
20101,20101,187,2022/4/15 7:10:00,191,144,47
20102,20102,187,2022/4/15 7:20:00,226,158,68
20103,20103,187,2022/4/15 7:30:00,280,196,84
20104,20104,187,2022/4/15 7:40:00,324,324,0
20105,20105,187,2022/4/15 7:50:00,475,426,49
20106,20106,187,2022/4/15 8:00:00,630,1038,-408
20107,20107,187,2022/4/15 8:10:00,598,1429,-831
20108,20108,187,2022/4/15 8:20:00,600,1570,-970
20109,20109,187,2022/4/15 8:30:00,475,1569,-1094
20110,20110,187,2022/4/15 8:40:00,315,1408,-1093
20111,20111,187,2022/4/15 8:50:00,318,1912,-1594
20112,20112,187,2022/4/15 9:00:00,292,1558,-1266
20113,20113,187,2022/4/15 9:10:00,240,617,-377
20114,20114,187,2022/4/15 9:20:00,210,394,-184
20115,20115,187,2022/4/15 9:30:00,144,333,-189
20116,20116,187,2022/4/15 9:40:00,148,252,-104
20117,20117,187,2022/4/15 9:50:00,106,190,-84
20118,20118,187,2022/4/15 10:00:00,66,99,-33
20119,20119,187,2022/4/15 10:10:00,64,110,-46
20120,20120,187,2022/4/15 10:20:00,67,109,-42
20121,20121,187,2022/4/15 10:30:00,58,100,-42
20122,20122,187,2022/4/15 10:40:00,55,105,-50
20123,20123,187,2022/4/15 10:50:00,58,112,-54
20124,20124,187,2022/4/15 11:00:00,51,105,-54
20125,20125,187,2022/4/15 11:10:00,64,105,-41
20126,20126,187,2022/4/15 11:20:00,60,98,-38
20127,20127,187,2022/4/15 11:30:00,62,108,-46
20128,20128,187,2022/4/15 11:40:00,65,103,-38
20129,20129,187,2022/4/15 11:50:00,68,106,-38
20130,20130,187,2022/4/15 12:00:00,62,111,-49
20131,20131,187,2022/4/15 12:10:00,74,105,-31
20132,20132,187,2022/4/15 12:20:00,77,106,-29
20133,20133,187,2022/4/15 12:30:00,72,108,-36
20134,20134,187,2022/4/15 12:40:00,65,105,-40
20135,20135,187,2022/4/15 12:50:00,72,120,-48
20136,20136,187,2022/4/15 13:00:00,68,104,-36
20137,20137,187,2022/4/15 13:10:00,68,97,-29
20138,20138,187,2022/4/15 13:20:00,65,126,-61
20139,20139,187,2022/4/15 13:30:00,64,105,-41
20140,20140,187,2022/4/15 13:40:00,70,104,-34
20141,20141,187,2022/4/15 13:50:00,62,106,-44
20142,20142,187,2022/4/15 14:00:00,66,108,-42
20143,20143,187,2022/4/15 14:10:00,62,118,-56
20144,20144,187,2022/4/15 14:20:00,65,108,-43
20145,20145,187,2022/4/15 14:30:00,58,109,-51
20146,20146,187,2022/4/15 14:40:00,65,108,-43
20147,20147,187,2022/4/15 14:50:00,72,103,-31
20148,20148,187,2022/4/15 15:00:00,74,105,-31
20149,20149,187,2022/4/15 15:10:00,113,113,0
20150,20150,187,2022/4/15 15:20:00,94,109,-15
20151,20151,187,2022/4/15 15:30:00,99,108,-9
20152,20152,187,2022/4/15 15:40:00,79,124,-45
20153,20153,187,2022/4/15 15:50:00,85,105,-20
20154,20154,187,2022/4/15 16:00:00,111,101,10
20155,20155,187,2022/4/15 16:10:00,133,108,25
20156,20156,187,2022/4/15 16:20:00,170,103,67
20157,20157,187,2022/4/15 16:30:00,206,111,95
20158,20158,187,2022/4/15 16:40:00,238,106,132
20159,20159,187,2022/4/15 16:50:00,262,113,149
20160,20160,187,2022/4/15 17:00:00,423,115,308
20161,20161,187,2022/4/15 17:10:00,804,124,680
20162,20162,187,2022/4/15 17:20:00,788,152,636
20163,20163,187,2022/4/15 17:30:00,842,178,664
20164,20164,187,2022/4/15 17:40:00,1353,190,1163
20165,20165,187,2022/4/15 17:50:00,1156,207,949
20166,20166,187,2022/4/15 18:00:00,813,255,558
20167,20167,187,2022/4/15 18:10:00,1198,226,972
20168,20168,187,2022/4/15 18:20:00,837,285,552
20169,20169,187,2022/4/15 18:30:00,639,257,382
20170,20170,187,2022/4/15 18:40:00,568,218,350
20171,20171,187,2022/4/15 18:50:00,311,208,103
20172,20172,187,2022/4/15 19:00:00,269,224,45
20173,20173,187,2022/4/15 19:10:00,265,127,138
20174,20174,187,2022/4/15 19:20:00,208,116,92
20175,20175,187,2022/4/15 19:30:00,162,111,51
20176,20176,187,2022/4/15 19:40:00,177,126,51
20177,20177,187,2022/4/15 19:50:00,133,100,33
20178,20178,187,2022/4/15 20:00:00,109,78,31
20179,20179,187,2022/4/15 20:10:00,109,106,3
20180,20180,187,2022/4/15 20:20:00,80,103,-23
20181,20181,187,2022/4/15 20:30:00,80,82,-2
20182,20182,187,2022/4/15 20:40:00,84,123,-39
20183,20183,187,2022/4/15 20:50:00,77,110,-33
20184,20184,187,2022/4/15 21:00:00,71,102,-31
20185,20185,187,2022/4/15 21:10:00,74,104,-30
20186,20186,187,2022/4/15 21:20:00,56,107,-51
20187,20187,187,2022/4/15 21:30:00,53,101,-48
20188,20188,187,2022/4/15 21:40:00,43,123,-80
20189,20189,187,2022/4/15 21:50:00,39,102,-63
20190,20190,187,2022/4/15 22:00:00,39,93,-54
20191,20191,187,2022/4/15 22:10:00,25,113,-88
20192,20192,187,2022/4/15 22:20:00,26,102,-76
20193,20193,187,2022/4/15 22:30:00,25,79,-54
20194,20194,187,2022/4/15 22:40:00,19,78,-59
20195,20195,187,2022/4/15 22:50:00,8,66,-58
20196,20196,188,2022/4/15 5:00:00,0,1,-1
20197,20197,188,2022/4/15 5:10:00,1,1,0
20198,20198,188,2022/4/15 5:20:00,7,1,6
20199,20199,188,2022/4/15 5:30:00,7,1,6
20200,20200,188,2022/4/15 5:40:00,8,1,7
20201,20201,188,2022/4/15 5:50:00,14,5,9
20202,20202,188,2022/4/15 6:00:00,16,13,3
20203,20203,188,2022/4/15 6:10:00,28,8,20
20204,20204,188,2022/4/15 6:20:00,32,60,-28
20205,20205,188,2022/4/15 6:30:00,33,69,-36
20206,20206,188,2022/4/15 6:40:00,57,83,-26
20207,20207,188,2022/4/15 6:50:00,71,113,-42
20208,20208,188,2022/4/15 7:00:00,145,102,43
20209,20209,188,2022/4/15 7:10:00,157,103,54
20210,20210,188,2022/4/15 7:20:00,196,120,76
20211,20211,188,2022/4/15 7:30:00,239,160,79
20212,20212,188,2022/4/15 7:40:00,282,179,103
20213,20213,188,2022/4/15 7:50:00,328,319,9
20214,20214,188,2022/4/15 8:00:00,339,323,16
20215,20215,188,2022/4/15 8:10:00,367,430,-63
20216,20216,188,2022/4/15 8:20:00,375,430,-55
20217,20217,188,2022/4/15 8:30:00,357,577,-220
20218,20218,188,2022/4/15 8:40:00,282,1162,-880
20219,20219,188,2022/4/15 8:50:00,223,612,-389
20220,20220,188,2022/4/15 9:00:00,217,490,-273
20221,20221,188,2022/4/15 9:10:00,182,424,-242
20222,20222,188,2022/4/15 9:20:00,155,491,-336
20223,20223,188,2022/4/15 9:30:00,105,317,-212
20224,20224,188,2022/4/15 9:40:00,77,318,-241
20225,20225,188,2022/4/15 9:50:00,75,223,-148
20226,20226,188,2022/4/15 10:00:00,65,111,-46
20227,20227,188,2022/4/15 10:10:00,63,214,-151
20228,20228,188,2022/4/15 10:20:00,57,109,-52
20229,20229,188,2022/4/15 10:30:00,52,119,-67
20230,20230,188,2022/4/15 10:40:00,52,118,-66
20231,20231,188,2022/4/15 10:50:00,48,111,-63
20232,20232,188,2022/4/15 11:00:00,50,104,-54
20233,20233,188,2022/4/15 11:10:00,48,100,-52
20234,20234,188,2022/4/15 11:20:00,45,108,-63
20235,20235,188,2022/4/15 11:30:00,50,93,-43
20236,20236,188,2022/4/15 11:40:00,52,114,-62
20237,20237,188,2022/4/15 11:50:00,59,124,-65
20238,20238,188,2022/4/15 12:00:00,59,88,-29
20239,20239,188,2022/4/15 12:10:00,69,122,-53
20240,20240,188,2022/4/15 12:20:00,71,96,-25
20241,20241,188,2022/4/15 12:30:00,75,128,-53
20242,20242,188,2022/4/15 12:40:00,74,106,-32
20243,20243,188,2022/4/15 12:50:00,70,110,-40
20244,20244,188,2022/4/15 13:00:00,83,125,-42
20245,20245,188,2022/4/15 13:10:00,76,104,-28
20246,20246,188,2022/4/15 13:20:00,88,108,-20
20247,20247,188,2022/4/15 13:30:00,78,106,-28
20248,20248,188,2022/4/15 13:40:00,72,117,-45
20249,20249,188,2022/4/15 13:50:00,75,101,-26
20250,20250,188,2022/4/15 14:00:00,77,122,-45
20251,20251,188,2022/4/15 14:10:00,72,113,-41
20252,20252,188,2022/4/15 14:20:00,73,119,-46
20253,20253,188,2022/4/15 14:30:00,76,121,-45
20254,20254,188,2022/4/15 14:40:00,67,112,-45
20255,20255,188,2022/4/15 14:50:00,74,108,-34
20256,20256,188,2022/4/15 15:00:00,98,104,-6
20257,20257,188,2022/4/15 15:10:00,130,121,9
20258,20258,188,2022/4/15 15:20:00,131,122,9
20259,20259,188,2022/4/15 15:30:00,119,123,-4
20260,20260,188,2022/4/15 15:40:00,135,109,26
20261,20261,188,2022/4/15 15:50:00,109,113,-4
20262,20262,188,2022/4/15 16:00:00,134,123,11
20263,20263,188,2022/4/15 16:10:00,164,108,56
20264,20264,188,2022/4/15 16:20:00,170,130,40
20265,20265,188,2022/4/15 16:30:00,214,113,101
20266,20266,188,2022/4/15 16:40:00,236,121,115
20267,20267,188,2022/4/15 16:50:00,223,192,31
20268,20268,188,2022/4/15 17:00:00,344,127,217
20269,20269,188,2022/4/15 17:10:00,578,170,408
20270,20270,188,2022/4/15 17:20:00,325,212,113
20271,20271,188,2022/4/15 17:30:00,620,212,408
20272,20272,188,2022/4/15 17:40:00,703,333,370
20273,20273,188,2022/4/15 17:50:00,576,298,278
20274,20274,188,2022/4/15 18:00:00,607,337,270
20275,20275,188,2022/4/15 18:10:00,813,381,432
20276,20276,188,2022/4/15 18:20:00,579,378,201
20277,20277,188,2022/4/15 18:30:00,332,342,-10
20278,20278,188,2022/4/15 18:40:00,339,327,12
20279,20279,188,2022/4/15 18:50:00,269,321,-52
20280,20280,188,2022/4/15 19:00:00,240,257,-17
20281,20281,188,2022/4/15 19:10:00,215,184,31
20282,20282,188,2022/4/15 19:20:00,190,138,52
20283,20283,188,2022/4/15 19:30:00,175,111,64
20284,20284,188,2022/4/15 19:40:00,137,105,32
20285,20285,188,2022/4/15 19:50:00,135,104,31
20286,20286,188,2022/4/15 20:00:00,136,103,33
20287,20287,188,2022/4/15 20:10:00,161,112,49
20288,20288,188,2022/4/15 20:20:00,135,100,35
20289,20289,188,2022/4/15 20:30:00,138,97,41
20290,20290,188,2022/4/15 20:40:00,174,129,45
20291,20291,188,2022/4/15 20:50:00,138,94,44
20292,20292,188,2022/4/15 21:00:00,177,95,82
20293,20293,188,2022/4/15 21:10:00,176,103,73
20294,20294,188,2022/4/15 21:20:00,130,105,25
20295,20295,188,2022/4/15 21:30:00,129,80,49
20296,20296,188,2022/4/15 21:40:00,160,104,56
20297,20297,188,2022/4/15 21:50:00,71,95,-24
20298,20298,188,2022/4/15 22:00:00,56,79,-23
20299,20299,188,2022/4/15 22:10:00,35,101,-66
20300,20300,188,2022/4/15 22:20:00,25,84,-59
20301,20301,188,2022/4/15 22:30:00,13,86,-73
20302,20302,188,2022/4/15 22:40:00,0,48,-48
20303,20303,188,2022/4/15 22:50:00,1,40,-39
20304,20304,189,2022/4/15 5:00:00,0,1,-1
20305,20305,189,2022/4/15 5:10:00,2,1,1
20306,20306,189,2022/4/15 5:20:00,7,1,6
20307,20307,189,2022/4/15 5:30:00,9,1,8
20308,20308,189,2022/4/15 5:40:00,13,5,8
20309,20309,189,2022/4/15 5:50:00,15,1,14
20310,20310,189,2022/4/15 6:00:00,21,5,16
20311,20311,189,2022/4/15 6:10:00,33,2,31
20312,20312,189,2022/4/15 6:20:00,35,30,5
20313,20313,189,2022/4/15 6:30:00,46,39,7
20314,20314,189,2022/4/15 6:40:00,53,51,2
20315,20315,189,2022/4/15 6:50:00,77,52,25
20316,20316,189,2022/4/15 7:00:00,88,70,18
20317,20317,189,2022/4/15 7:10:00,105,68,37
20318,20318,189,2022/4/15 7:20:00,105,88,17
20319,20319,189,2022/4/15 7:30:00,169,93,76
20320,20320,189,2022/4/15 7:40:00,215,101,114
20321,20321,189,2022/4/15 7:50:00,251,104,147
20322,20322,189,2022/4/15 8:00:00,280,103,177
20323,20323,189,2022/4/15 8:10:00,281,224,57
20324,20324,189,2022/4/15 8:20:00,276,178,98
20325,20325,189,2022/4/15 8:30:00,235,253,-18
20326,20326,189,2022/4/15 8:40:00,220,328,-108
20327,20327,189,2022/4/15 8:50:00,197,373,-176
20328,20328,189,2022/4/15 9:00:00,167,233,-66
20329,20329,189,2022/4/15 9:10:00,180,231,-51
20330,20330,189,2022/4/15 9:20:00,116,185,-69
20331,20331,189,2022/4/15 9:30:00,91,108,-17
20332,20332,189,2022/4/15 9:40:00,76,125,-49
20333,20333,189,2022/4/15 9:50:00,68,124,-56
20334,20334,189,2022/4/15 10:00:00,61,104,-43
20335,20335,189,2022/4/15 10:10:00,62,101,-39
20336,20336,189,2022/4/15 10:20:00,56,101,-45
20337,20337,189,2022/4/15 10:30:00,54,75,-21
20338,20338,189,2022/4/15 10:40:00,44,87,-43
20339,20339,189,2022/4/15 10:50:00,47,83,-36
20340,20340,189,2022/4/15 11:00:00,42,75,-33
20341,20341,189,2022/4/15 11:10:00,44,79,-35
20342,20342,189,2022/4/15 11:20:00,45,80,-35
20343,20343,189,2022/4/15 11:30:00,46,84,-38
20344,20344,189,2022/4/15 11:40:00,55,73,-18
20345,20345,189,2022/4/15 11:50:00,57,87,-30
20346,20346,189,2022/4/15 12:00:00,57,77,-20
20347,20347,189,2022/4/15 12:10:00,71,72,-1
20348,20348,189,2022/4/15 12:20:00,77,93,-16
20349,20349,189,2022/4/15 12:30:00,73,77,-4
20350,20350,189,2022/4/15 12:40:00,77,91,-14
20351,20351,189,2022/4/15 12:50:00,76,80,-4
20352,20352,189,2022/4/15 13:00:00,90,73,17
20353,20353,189,2022/4/15 13:10:00,72,91,-19
20354,20354,189,2022/4/15 13:20:00,74,73,1
20355,20355,189,2022/4/15 13:30:00,73,101,-28
20356,20356,189,2022/4/15 13:40:00,75,85,-10
20357,20357,189,2022/4/15 13:50:00,75,98,-23
20358,20358,189,2022/4/15 14:00:00,67,74,-7
20359,20359,189,2022/4/15 14:10:00,76,74,2
20360,20360,189,2022/4/15 14:20:00,82,87,-5
20361,20361,189,2022/4/15 14:30:00,74,70,4
20362,20362,189,2022/4/15 14:40:00,79,92,-13
20363,20363,189,2022/4/15 14:50:00,76,69,7
20364,20364,189,2022/4/15 15:00:00,103,76,27
20365,20365,189,2022/4/15 15:10:00,113,82,31
20366,20366,189,2022/4/15 15:20:00,111,76,35
20367,20367,189,2022/4/15 15:30:00,141,76,65
20368,20368,189,2022/4/15 15:40:00,171,78,93
20369,20369,189,2022/4/15 15:50:00,136,93,43
20370,20370,189,2022/4/15 16:00:00,157,77,80
20371,20371,189,2022/4/15 16:10:00,153,78,75
20372,20372,189,2022/4/15 16:20:00,175,76,99
20373,20373,189,2022/4/15 16:30:00,214,76,138
20374,20374,189,2022/4/15 16:40:00,264,87,177
20375,20375,189,2022/4/15 16:50:00,223,87,136
20376,20376,189,2022/4/15 17:00:00,379,111,268
20377,20377,189,2022/4/15 17:10:00,552,93,459
20378,20378,189,2022/4/15 17:20:00,331,108,223
20379,20379,189,2022/4/15 17:30:00,552,111,441
20380,20380,189,2022/4/15 17:40:00,676,122,554
20381,20381,189,2022/4/15 17:50:00,376,126,250
20382,20382,189,2022/4/15 18:00:00,577,122,455
20383,20383,189,2022/4/15 18:10:00,715,116,599
20384,20384,189,2022/4/15 18:20:00,578,108,470
20385,20385,189,2022/4/15 18:30:00,328,110,218
20386,20386,189,2022/4/15 18:40:00,272,126,146
20387,20387,189,2022/4/15 18:50:00,265,106,159
20388,20388,189,2022/4/15 19:00:00,212,100,112
20389,20389,189,2022/4/15 19:10:00,216,98,118
20390,20390,189,2022/4/15 19:20:00,157,87,70
20391,20391,189,2022/4/15 19:30:00,151,75,76
20392,20392,189,2022/4/15 19:40:00,129,72,57
20393,20393,189,2022/4/15 19:50:00,129,64,65
20394,20394,189,2022/4/15 20:00:00,143,66,77
20395,20395,189,2022/4/15 20:10:00,130,68,62
20396,20396,189,2022/4/15 20:20:00,114,51,63
20397,20397,189,2022/4/15 20:30:00,134,56,78
20398,20398,189,2022/4/15 20:40:00,131,62,69
20399,20399,189,2022/4/15 20:50:00,68,63,5
20400,20400,189,2022/4/15 21:00:00,85,51,34
20401,20401,189,2022/4/15 21:10:00,102,51,51
20402,20402,189,2022/4/15 21:20:00,74,56,18
20403,20403,189,2022/4/15 21:30:00,68,48,20
20404,20404,189,2022/4/15 21:40:00,64,52,12
20405,20405,189,2022/4/15 21:50:00,58,49,9
20406,20406,189,2022/4/15 22:00:00,271,42,229
20407,20407,189,2022/4/15 22:10:00,40,40,0
20408,20408,189,2022/4/15 22:20:00,23,39,-16
20409,20409,189,2022/4/15 22:30:00,21,40,-19
20410,20410,189,2022/4/15 22:40:00,13,26,-13
20411,20411,189,2022/4/15 22:50:00,5,23,-18
20412,20412,190,2022/4/15 5:00:00,5,1,4
20413,20413,190,2022/4/15 5:10:00,11,1,10
20414,20414,190,2022/4/15 5:20:00,20,1,19
20415,20415,190,2022/4/15 5:30:00,24,2,22
20416,20416,190,2022/4/15 5:40:00,30,11,19
20417,20417,190,2022/4/15 5:50:00,36,16,20
20418,20418,190,2022/4/15 6:00:00,45,48,-3
20419,20419,190,2022/4/15 6:10:00,53,74,-21
20420,20420,190,2022/4/15 6:20:00,66,98,-32
20421,20421,190,2022/4/15 6:30:00,112,107,5
20422,20422,190,2022/4/15 6:40:00,184,110,74
20423,20423,190,2022/4/15 6:50:00,231,197,34
20424,20424,190,2022/4/15 7:00:00,281,342,-61
20425,20425,190,2022/4/15 7:10:00,319,378,-59
20426,20426,190,2022/4/15 7:20:00,566,436,130
20427,20427,190,2022/4/15 7:30:00,686,557,129
20428,20428,190,2022/4/15 7:40:00,1059,1590,-531
20429,20429,190,2022/4/15 7:50:00,1366,1821,-455
20430,20430,190,2022/4/15 8:00:00,1577,2818,-1241
20431,20431,190,2022/4/15 8:10:00,1979,4730,-2751
20432,20432,190,2022/4/15 8:20:00,1577,3610,-2033
20433,20433,190,2022/4/15 8:30:00,1572,6277,-4705
20434,20434,190,2022/4/15 8:40:00,1213,6301,-5088
20435,20435,190,2022/4/15 8:50:00,865,3497,-2632
20436,20436,190,2022/4/15 9:00:00,726,2594,-1868
20437,20437,190,2022/4/15 9:10:00,673,1504,-831
20438,20438,190,2022/4/15 9:20:00,582,554,28
20439,20439,190,2022/4/15 9:30:00,467,428,39
20440,20440,190,2022/4/15 9:40:00,330,374,-44
20441,20441,190,2022/4/15 9:50:00,320,322,-2
20442,20442,190,2022/4/15 10:00:00,269,268,1
20443,20443,190,2022/4/15 10:10:00,253,227,26
20444,20444,190,2022/4/15 10:20:00,240,181,59
20445,20445,190,2022/4/15 10:30:00,240,179,61
20446,20446,190,2022/4/15 10:40:00,216,192,24
20447,20447,190,2022/4/15 10:50:00,212,147,65
20448,20448,190,2022/4/15 11:00:00,216,192,24
20449,20449,190,2022/4/15 11:10:00,225,150,75
20450,20450,190,2022/4/15 11:20:00,224,192,32
20451,20451,190,2022/4/15 11:30:00,223,192,31
20452,20452,190,2022/4/15 11:40:00,238,214,24
20453,20453,190,2022/4/15 11:50:00,232,192,40
20454,20454,190,2022/4/15 12:00:00,227,154,73
20455,20455,190,2022/4/15 12:10:00,242,192,50
20456,20456,190,2022/4/15 12:20:00,222,180,42
20457,20457,190,2022/4/15 12:30:00,260,178,82
20458,20458,190,2022/4/15 12:40:00,257,214,43
20459,20459,190,2022/4/15 12:50:00,269,179,90
20460,20460,190,2022/4/15 13:00:00,271,198,73
20461,20461,190,2022/4/15 13:10:00,272,213,59
20462,20462,190,2022/4/15 13:20:00,269,233,36
20463,20463,190,2022/4/15 13:30:00,274,180,94
20464,20464,190,2022/4/15 13:40:00,272,219,53
20465,20465,190,2022/4/15 13:50:00,275,180,95
20466,20466,190,2022/4/15 14:00:00,270,198,72
20467,20467,190,2022/4/15 14:10:00,272,226,46
20468,20468,190,2022/4/15 14:20:00,267,180,87
20469,20469,190,2022/4/15 14:30:00,267,213,54
20470,20470,190,2022/4/15 14:40:00,271,214,57
20471,20471,190,2022/4/15 14:50:00,274,197,77
20472,20472,190,2022/4/15 15:00:00,267,198,69
20473,20473,190,2022/4/15 15:10:00,330,180,150
20474,20474,190,2022/4/15 15:20:00,331,208,123
20475,20475,190,2022/4/15 15:30:00,343,179,164
20476,20476,190,2022/4/15 15:40:00,428,198,230
20477,20477,190,2022/4/15 15:50:00,335,214,121
20478,20478,190,2022/4/15 16:00:00,309,232,77
20479,20479,190,2022/4/15 16:10:00,350,180,170
20480,20480,190,2022/4/15 16:20:00,351,231,120
20481,20481,190,2022/4/15 16:30:00,554,218,336
20482,20482,190,2022/4/15 16:40:00,648,196,452
20483,20483,190,2022/4/15 16:50:00,661,300,361
20484,20484,190,2022/4/15 17:00:00,1147,330,817
20485,20485,190,2022/4/15 17:10:00,1977,376,1601
20486,20486,190,2022/4/15 17:20:00,1341,415,926
20487,20487,190,2022/4/15 17:30:00,1583,423,1160
20488,20488,190,2022/4/15 17:40:00,3341,484,2857
20489,20489,190,2022/4/15 17:50:00,2528,622,1906
20490,20490,190,2022/4/15 18:00:00,1979,1126,853
20491,20491,190,2022/4/15 18:10:00,3311,1138,2173
20492,20492,190,2022/4/15 18:20:00,2513,1130,1383
20493,20493,190,2022/4/15 18:30:00,1560,1134,426
20494,20494,190,2022/4/15 18:40:00,1190,1140,50
20495,20495,190,2022/4/15 18:50:00,822,568,254
20496,20496,190,2022/4/15 19:00:00,702,430,272
20497,20497,190,2022/4/15 19:10:00,637,501,136
20498,20498,190,2022/4/15 19:20:00,575,320,255
20499,20499,190,2022/4/15 19:30:00,462,321,141
20500,20500,190,2022/4/15 19:40:00,369,256,113
20501,20501,190,2022/4/15 19:50:00,376,207,169
20502,20502,190,2022/4/15 20:00:00,358,184,174
20503,20503,190,2022/4/15 20:10:00,320,159,161
20504,20504,190,2022/4/15 20:20:00,354,154,200
20505,20505,190,2022/4/15 20:30:00,350,152,198
20506,20506,190,2022/4/15 20:40:00,427,150,277
20507,20507,190,2022/4/15 20:50:00,554,153,401
20508,20508,190,2022/4/15 21:00:00,558,117,441
20509,20509,190,2022/4/15 21:10:00,579,153,426
20510,20510,190,2022/4/15 21:20:00,434,141,293
20511,20511,190,2022/4/15 21:30:00,357,184,173
20512,20512,190,2022/4/15 21:40:00,265,169,96
20513,20513,190,2022/4/15 21:50:00,223,126,97
20514,20514,190,2022/4/15 22:00:00,200,119,81
20515,20515,190,2022/4/15 22:10:00,130,123,7
20516,20516,190,2022/4/15 22:20:00,62,113,-51
20517,20517,190,2022/4/15 22:30:00,43,112,-69
20518,20518,190,2022/4/15 22:40:00,26,99,-73
20519,20519,190,2022/4/15 22:50:00,26,100,-74
20520,20520,191,2022/4/15 5:00:00,0,1,-1
20521,20521,191,2022/4/15 5:10:00,0,1,-1
20522,20522,191,2022/4/15 5:20:00,3,1,2
20523,20523,191,2022/4/15 5:30:00,13,1,12
20524,20524,191,2022/4/15 5:40:00,16,16,0
20525,20525,191,2022/4/15 5:50:00,22,2,20
20526,20526,191,2022/4/15 6:00:00,32,8,24
20527,20527,191,2022/4/15 6:10:00,36,60,-24
20528,20528,191,2022/4/15 6:20:00,48,41,7
20529,20529,191,2022/4/15 6:30:00,65,76,-11
20530,20530,191,2022/4/15 6:40:00,85,85,0
20531,20531,191,2022/4/15 6:50:00,153,121,32
20532,20532,191,2022/4/15 7:00:00,156,133,23
20533,20533,191,2022/4/15 7:10:00,207,192,15
20534,20534,191,2022/4/15 7:20:00,250,209,41
20535,20535,191,2022/4/15 7:30:00,302,234,68
20536,20536,191,2022/4/15 7:40:00,599,298,301
20537,20537,191,2022/4/15 7:50:00,596,300,296
20538,20538,191,2022/4/15 8:00:00,703,318,385
20539,20539,191,2022/4/15 8:10:00,736,492,244
20540,20540,191,2022/4/15 8:20:00,690,425,265
20541,20541,191,2022/4/15 8:30:00,721,426,295
20542,20542,191,2022/4/15 8:40:00,573,582,-9
20543,20543,191,2022/4/15 8:50:00,324,482,-158
20544,20544,191,2022/4/15 9:00:00,312,413,-101
20545,20545,191,2022/4/15 9:10:00,275,313,-38
20546,20546,191,2022/4/15 9:20:00,227,316,-89
20547,20547,191,2022/4/15 9:30:00,209,231,-22
20548,20548,191,2022/4/15 9:40:00,173,190,-17
20549,20549,191,2022/4/15 9:50:00,141,179,-38
20550,20550,191,2022/4/15 10:00:00,131,109,22
20551,20551,191,2022/4/15 10:10:00,108,121,-13
20552,20552,191,2022/4/15 10:20:00,89,124,-35
20553,20553,191,2022/4/15 10:30:00,91,120,-29
20554,20554,191,2022/4/15 10:40:00,80,121,-41
20555,20555,191,2022/4/15 10:50:00,76,120,-44
20556,20556,191,2022/4/15 11:00:00,83,86,-3
20557,20557,191,2022/4/15 11:10:00,76,108,-32
20558,20558,191,2022/4/15 11:20:00,81,103,-22
20559,20559,191,2022/4/15 11:30:00,74,111,-37
20560,20560,191,2022/4/15 11:40:00,71,121,-50
20561,20561,191,2022/4/15 11:50:00,76,101,-25
20562,20562,191,2022/4/15 12:00:00,85,114,-29
20563,20563,191,2022/4/15 12:10:00,134,113,21
20564,20564,191,2022/4/15 12:20:00,114,114,0
20565,20565,191,2022/4/15 12:30:00,101,117,-16
20566,20566,191,2022/4/15 12:40:00,103,103,0
20567,20567,191,2022/4/15 12:50:00,103,112,-9
20568,20568,191,2022/4/15 13:00:00,88,126,-38
20569,20569,191,2022/4/15 13:10:00,110,86,24
20570,20570,191,2022/4/15 13:20:00,101,111,-10
20571,20571,191,2022/4/15 13:30:00,84,102,-18
20572,20572,191,2022/4/15 13:40:00,88,181,-93
20573,20573,191,2022/4/15 13:50:00,88,114,-26
20574,20574,191,2022/4/15 14:00:00,123,128,-5
20575,20575,191,2022/4/15 14:10:00,134,104,30
20576,20576,191,2022/4/15 14:20:00,116,105,11
20577,20577,191,2022/4/15 14:30:00,96,105,-9
20578,20578,191,2022/4/15 14:40:00,102,98,4
20579,20579,191,2022/4/15 14:50:00,128,128,0
20580,20580,191,2022/4/15 15:00:00,132,105,27
20581,20581,191,2022/4/15 15:10:00,143,128,15
20582,20582,191,2022/4/15 15:20:00,136,120,16
20583,20583,191,2022/4/15 15:30:00,154,121,33
20584,20584,191,2022/4/15 15:40:00,156,125,31
20585,20585,191,2022/4/15 15:50:00,133,125,8
20586,20586,191,2022/4/15 16:00:00,177,144,33
20587,20587,191,2022/4/15 16:10:00,210,107,103
20588,20588,191,2022/4/15 16:20:00,205,121,84
20589,20589,191,2022/4/15 16:30:00,269,108,161
20590,20590,191,2022/4/15 16:40:00,269,111,158
20591,20591,191,2022/4/15 16:50:00,262,153,109
20592,20592,191,2022/4/15 17:00:00,326,108,218
20593,20593,191,2022/4/15 17:10:00,459,210,249
20594,20594,191,2022/4/15 17:20:00,347,280,67
20595,20595,191,2022/4/15 17:30:00,336,296,40
20596,20596,191,2022/4/15 17:40:00,571,337,234
20597,20597,191,2022/4/15 17:50:00,348,378,-30
20598,20598,191,2022/4/15 18:00:00,334,322,12
20599,20599,191,2022/4/15 18:10:00,609,494,115
20600,20600,191,2022/4/15 18:20:00,335,377,-42
20601,20601,191,2022/4/15 18:30:00,266,507,-241
20602,20602,191,2022/4/15 18:40:00,223,434,-211
20603,20603,191,2022/4/15 18:50:00,176,325,-149
20604,20604,191,2022/4/15 19:00:00,156,301,-145
20605,20605,191,2022/4/15 19:10:00,161,209,-48
20606,20606,191,2022/4/15 19:20:00,77,192,-115
20607,20607,191,2022/4/15 19:30:00,74,151,-77
20608,20608,191,2022/4/15 19:40:00,70,110,-40
20609,20609,191,2022/4/15 19:50:00,61,127,-66
20610,20610,191,2022/4/15 20:00:00,60,125,-65
20611,20611,191,2022/4/15 20:10:00,66,115,-49
20612,20612,191,2022/4/15 20:20:00,61,105,-44
20613,20613,191,2022/4/15 20:30:00,62,110,-48
20614,20614,191,2022/4/15 20:40:00,57,122,-65
20615,20615,191,2022/4/15 20:50:00,56,106,-50
20616,20616,191,2022/4/15 21:00:00,68,107,-39
20617,20617,191,2022/4/15 21:10:00,62,103,-41
20618,20618,191,2022/4/15 21:20:00,45,111,-66
20619,20619,191,2022/4/15 21:30:00,42,111,-69
20620,20620,191,2022/4/15 21:40:00,38,124,-86
20621,20621,191,2022/4/15 21:50:00,31,110,-79
20622,20622,191,2022/4/15 22:00:00,37,100,-63
20623,20623,191,2022/4/15 22:10:00,44,107,-63
20624,20624,191,2022/4/15 22:20:00,22,105,-83
20625,20625,191,2022/4/15 22:30:00,16,92,-76
20626,20626,191,2022/4/15 22:40:00,8,59,-51
20627,20627,191,2022/4/15 22:50:00,6,55,-49
20628,20628,192,2022/4/15 5:00:00,0,1,-1
20629,20629,192,2022/4/15 5:10:00,0,1,-1
20630,20630,192,2022/4/15 5:20:00,0,1,-1
20631,20631,192,2022/4/15 5:30:00,1,1,0
20632,20632,192,2022/4/15 5:40:00,36,1,35
20633,20633,192,2022/4/15 5:50:00,54,21,33
20634,20634,192,2022/4/15 6:00:00,47,19,28
20635,20635,192,2022/4/15 6:10:00,66,33,33
20636,20636,192,2022/4/15 6:20:00,87,64,23
20637,20637,192,2022/4/15 6:30:00,120,59,61
20638,20638,192,2022/4/15 6:40:00,186,76,110
20639,20639,192,2022/4/15 6:50:00,215,105,110
20640,20640,192,2022/4/15 7:00:00,268,115,153
20641,20641,192,2022/4/15 7:10:00,346,122,224
20642,20642,192,2022/4/15 7:20:00,383,133,250
20643,20643,192,2022/4/15 7:30:00,593,178,415
20644,20644,192,2022/4/15 7:40:00,662,219,443
20645,20645,192,2022/4/15 7:50:00,741,346,395
20646,20646,192,2022/4/15 8:00:00,1043,419,624
20647,20647,192,2022/4/15 8:10:00,859,478,381
20648,20648,192,2022/4/15 8:20:00,862,577,285
20649,20649,192,2022/4/15 8:30:00,678,422,256
20650,20650,192,2022/4/15 8:40:00,599,420,179
20651,20651,192,2022/4/15 8:50:00,435,421,14
20652,20652,192,2022/4/15 9:00:00,347,364,-17
20653,20653,192,2022/4/15 9:10:00,261,207,54
20654,20654,192,2022/4/15 9:20:00,222,191,31
20655,20655,192,2022/4/15 9:30:00,182,133,49
20656,20656,192,2022/4/15 9:40:00,103,109,-6
20657,20657,192,2022/4/15 9:50:00,104,118,-14
20658,20658,192,2022/4/15 10:00:00,73,98,-25
20659,20659,192,2022/4/15 10:10:00,63,87,-24
20660,20660,192,2022/4/15 10:20:00,67,117,-50
20661,20661,192,2022/4/15 10:30:00,62,92,-30
20662,20662,192,2022/4/15 10:40:00,44,97,-53
20663,20663,192,2022/4/15 10:50:00,47,104,-57
20664,20664,192,2022/4/15 11:00:00,45,97,-52
20665,20665,192,2022/4/15 11:10:00,43,105,-62
20666,20666,192,2022/4/15 11:20:00,54,82,-28
20667,20667,192,2022/4/15 11:30:00,54,103,-49
20668,20668,192,2022/4/15 11:40:00,51,85,-34
20669,20669,192,2022/4/15 11:50:00,62,88,-26
20670,20670,192,2022/4/15 12:00:00,59,105,-46
20671,20671,192,2022/4/15 12:10:00,70,77,-7
20672,20672,192,2022/4/15 12:20:00,63,108,-45
20673,20673,192,2022/4/15 12:30:00,64,93,-29
20674,20674,192,2022/4/15 12:40:00,65,100,-35
20675,20675,192,2022/4/15 12:50:00,48,91,-43
20676,20676,192,2022/4/15 13:00:00,47,109,-62
20677,20677,192,2022/4/15 13:10:00,50,97,-47
20678,20678,192,2022/4/15 13:20:00,59,88,-29
20679,20679,192,2022/4/15 13:30:00,45,102,-57
20680,20680,192,2022/4/15 13:40:00,57,88,-31
20681,20681,192,2022/4/15 13:50:00,41,123,-82
20682,20682,192,2022/4/15 14:00:00,52,76,-24
20683,20683,192,2022/4/15 14:10:00,47,106,-59
20684,20684,192,2022/4/15 14:20:00,45,105,-60
20685,20685,192,2022/4/15 14:30:00,47,90,-43
20686,20686,192,2022/4/15 14:40:00,44,104,-60
20687,20687,192,2022/4/15 14:50:00,52,87,-35
20688,20688,192,2022/4/15 15:00:00,59,106,-47
20689,20689,192,2022/4/15 15:10:00,64,94,-30
20690,20690,192,2022/4/15 15:20:00,64,110,-46
20691,20691,192,2022/4/15 15:30:00,64,118,-54
20692,20692,192,2022/4/15 15:40:00,64,97,-33
20693,20693,192,2022/4/15 15:50:00,83,121,-38
20694,20694,192,2022/4/15 16:00:00,83,95,-12
20695,20695,192,2022/4/15 16:10:00,175,124,51
20696,20696,192,2022/4/15 16:20:00,197,102,95
20697,20697,192,2022/4/15 16:30:00,198,108,90
20698,20698,192,2022/4/15 16:40:00,238,103,135
20699,20699,192,2022/4/15 16:50:00,237,121,116
20700,20700,192,2022/4/15 17:00:00,315,138,177
20701,20701,192,2022/4/15 17:10:00,352,138,214
20702,20702,192,2022/4/15 17:20:00,347,212,135
20703,20703,192,2022/4/15 17:30:00,577,233,344
20704,20704,192,2022/4/15 17:40:00,1032,197,835
20705,20705,192,2022/4/15 17:50:00,621,326,295
20706,20706,192,2022/4/15 18:00:00,335,327,8
20707,20707,192,2022/4/15 18:10:00,462,347,115
20708,20708,192,2022/4/15 18:20:00,271,348,-77
20709,20709,192,2022/4/15 18:30:00,224,348,-124
20710,20710,192,2022/4/15 18:40:00,181,326,-145
20711,20711,192,2022/4/15 18:50:00,144,322,-178
20712,20712,192,2022/4/15 19:00:00,74,234,-160
20713,20713,192,2022/4/15 19:10:00,67,199,-132
20714,20714,192,2022/4/15 19:20:00,59,137,-78
20715,20715,192,2022/4/15 19:30:00,46,116,-70
20716,20716,192,2022/4/15 19:40:00,45,110,-65
20717,20717,192,2022/4/15 19:50:00,40,110,-70
20718,20718,192,2022/4/15 20:00:00,40,123,-83
20719,20719,192,2022/4/15 20:10:00,33,113,-80
20720,20720,192,2022/4/15 20:20:00,34,115,-81
20721,20721,192,2022/4/15 20:30:00,37,121,-84
20722,20722,192,2022/4/15 20:40:00,32,111,-79
20723,20723,192,2022/4/15 20:50:00,26,108,-82
20724,20724,192,2022/4/15 21:00:00,27,118,-91
20725,20725,192,2022/4/15 21:10:00,29,103,-74
20726,20726,192,2022/4/15 21:20:00,25,125,-100
20727,20727,192,2022/4/15 21:30:00,24,122,-98
20728,20728,192,2022/4/15 21:40:00,25,108,-83
20729,20729,192,2022/4/15 21:50:00,21,102,-81
20730,20730,192,2022/4/15 22:00:00,20,120,-100
20731,20731,192,2022/4/15 22:10:00,17,103,-86
20732,20732,192,2022/4/15 22:20:00,15,85,-70
20733,20733,192,2022/4/15 22:30:00,9,122,-113
20734,20734,192,2022/4/15 22:40:00,6,102,-96
20735,20735,192,2022/4/15 22:50:00,3,77,-74
20736,20736,193,2022/4/15 5:00:00,0,1,-1
20737,20737,193,2022/4/15 5:10:00,4,1,3
20738,20738,193,2022/4/15 5:20:00,5,1,4
20739,20739,193,2022/4/15 5:30:00,7,1,6
20740,20740,193,2022/4/15 5:40:00,7,1,6
20741,20741,193,2022/4/15 5:50:00,12,1,11
20742,20742,193,2022/4/15 6:00:00,18,1,17
20743,20743,193,2022/4/15 6:10:00,17,1,16
20744,20744,193,2022/4/15 6:20:00,25,20,5
20745,20745,193,2022/4/15 6:30:00,31,65,-34
20746,20746,193,2022/4/15 6:40:00,39,70,-31
20747,20747,193,2022/4/15 6:50:00,44,76,-32
20748,20748,193,2022/4/15 7:00:00,58,99,-41
20749,20749,193,2022/4/15 7:10:00,56,105,-49
20750,20750,193,2022/4/15 7:20:00,84,101,-17
20751,20751,193,2022/4/15 7:30:00,87,109,-22
20752,20752,193,2022/4/15 7:40:00,187,180,7
20753,20753,193,2022/4/15 7:50:00,224,218,6
20754,20754,193,2022/4/15 8:00:00,243,380,-137
20755,20755,193,2022/4/15 8:10:00,274,405,-131
20756,20756,193,2022/4/15 8:20:00,259,593,-334
20757,20757,193,2022/4/15 8:30:00,222,1932,-1710
20758,20758,193,2022/4/15 8:40:00,150,1936,-1786
20759,20759,193,2022/4/15 8:50:00,100,1537,-1437
20760,20760,193,2022/4/15 9:00:00,75,483,-408
20761,20761,193,2022/4/15 9:10:00,77,489,-412
20762,20762,193,2022/4/15 9:20:00,65,378,-313
20763,20763,193,2022/4/15 9:30:00,51,324,-273
20764,20764,193,2022/4/15 9:40:00,47,231,-184
20765,20765,193,2022/4/15 9:50:00,48,157,-109
20766,20766,193,2022/4/15 10:00:00,44,105,-61
20767,20767,193,2022/4/15 10:10:00,43,123,-80
20768,20768,193,2022/4/15 10:20:00,42,114,-72
20769,20769,193,2022/4/15 10:30:00,38,88,-50
20770,20770,193,2022/4/15 10:40:00,46,101,-55
20771,20771,193,2022/4/15 10:50:00,43,112,-69
20772,20772,193,2022/4/15 11:00:00,35,90,-55
20773,20773,193,2022/4/15 11:10:00,41,96,-55
20774,20774,193,2022/4/15 11:20:00,38,93,-55
20775,20775,193,2022/4/15 11:30:00,35,75,-40
20776,20776,193,2022/4/15 11:40:00,41,93,-52
20777,20777,193,2022/4/15 11:50:00,45,97,-52
20778,20778,193,2022/4/15 12:00:00,44,91,-47
20779,20779,193,2022/4/15 12:10:00,44,95,-51
20780,20780,193,2022/4/15 12:20:00,48,77,-29
20781,20781,193,2022/4/15 12:30:00,46,112,-66
20782,20782,193,2022/4/15 12:40:00,48,90,-42
20783,20783,193,2022/4/15 12:50:00,46,105,-59
20784,20784,193,2022/4/15 13:00:00,46,112,-66
20785,20785,193,2022/4/15 13:10:00,50,93,-43
20786,20786,193,2022/4/15 13:20:00,40,103,-63
20787,20787,193,2022/4/15 13:30:00,45,90,-45
20788,20788,193,2022/4/15 13:40:00,47,111,-64
20789,20789,193,2022/4/15 13:50:00,46,97,-51
20790,20790,193,2022/4/15 14:00:00,45,105,-60
20791,20791,193,2022/4/15 14:10:00,48,101,-53
20792,20792,193,2022/4/15 14:20:00,46,93,-47
20793,20793,193,2022/4/15 14:30:00,47,105,-58
20794,20794,193,2022/4/15 14:40:00,49,78,-29
20795,20795,193,2022/4/15 14:50:00,53,108,-55
20796,20796,193,2022/4/15 15:00:00,69,76,-7
20797,20797,193,2022/4/15 15:10:00,94,103,-9
20798,20798,193,2022/4/15 15:20:00,75,104,-29
20799,20799,193,2022/4/15 15:30:00,62,76,-14
20800,20800,193,2022/4/15 15:40:00,72,103,-31
20801,20801,193,2022/4/15 15:50:00,70,82,-12
20802,20802,193,2022/4/15 16:00:00,75,105,-30
20803,20803,193,2022/4/15 16:10:00,95,91,4
20804,20804,193,2022/4/15 16:20:00,92,114,-22
20805,20805,193,2022/4/15 16:30:00,137,97,40
20806,20806,193,2022/4/15 16:40:00,187,102,85
20807,20807,193,2022/4/15 16:50:00,185,123,62
20808,20808,193,2022/4/15 17:00:00,262,102,160
20809,20809,193,2022/4/15 17:10:00,324,102,222
20810,20810,193,2022/4/15 17:20:00,314,110,204
20811,20811,193,2022/4/15 17:30:00,462,125,337
20812,20812,193,2022/4/15 17:40:00,1158,106,1052
20813,20813,193,2022/4/15 17:50:00,653,138,515
20814,20814,193,2022/4/15 18:00:00,645,143,502
20815,20815,193,2022/4/15 18:10:00,1561,150,1411
20816,20816,193,2022/4/15 18:20:00,821,184,637
20817,20817,193,2022/4/15 18:30:00,570,151,419
20818,20818,193,2022/4/15 18:40:00,354,181,173
20819,20819,193,2022/4/15 18:50:00,256,130,126
20820,20820,193,2022/4/15 19:00:00,210,103,107
20821,20821,193,2022/4/15 19:10:00,211,125,86
20822,20822,193,2022/4/15 19:20:00,148,104,44
20823,20823,193,2022/4/15 19:30:00,96,92,4
20824,20824,193,2022/4/15 19:40:00,163,92,71
20825,20825,193,2022/4/15 19:50:00,81,84,-3
20826,20826,193,2022/4/15 20:00:00,67,76,-9
20827,20827,193,2022/4/15 20:10:00,71,82,-11
20828,20828,193,2022/4/15 20:20:00,57,67,-10
20829,20829,193,2022/4/15 20:30:00,55,77,-22
20830,20830,193,2022/4/15 20:40:00,59,73,-14
20831,20831,193,2022/4/15 20:50:00,45,70,-25
20832,20832,193,2022/4/15 21:00:00,73,88,-15
20833,20833,193,2022/4/15 21:10:00,97,67,30
20834,20834,193,2022/4/15 21:20:00,44,63,-19
20835,20835,193,2022/4/15 21:30:00,42,88,-46
20836,20836,193,2022/4/15 21:40:00,37,70,-33
20837,20837,193,2022/4/15 21:50:00,33,65,-32
20838,20838,193,2022/4/15 22:00:00,33,78,-45
20839,20839,193,2022/4/15 22:10:00,29,67,-38
20840,20840,193,2022/4/15 22:20:00,17,62,-45
20841,20841,193,2022/4/15 22:30:00,0,74,-74
20842,20842,193,2022/4/15 22:40:00,0,79,-79
20843,20843,193,2022/4/15 22:50:00,0,50,-50
20844,20844,194,2022/4/15 5:00:00,0,1,-1
20845,20845,194,2022/4/15 5:10:00,0,1,-1
20846,20846,194,2022/4/15 5:20:00,0,1,-1
20847,20847,194,2022/4/15 5:30:00,0,1,-1
20848,20848,194,2022/4/15 5:40:00,0,1,-1
20849,20849,194,2022/4/15 5:50:00,17,1,16
20850,20850,194,2022/4/15 6:00:00,33,1,32
20851,20851,194,2022/4/15 6:10:00,57,23,34
20852,20852,194,2022/4/15 6:20:00,77,33,44
20853,20853,194,2022/4/15 6:30:00,127,36,91
20854,20854,194,2022/4/15 6:40:00,183,43,140
20855,20855,194,2022/4/15 6:50:00,201,63,138
20856,20856,194,2022/4/15 7:00:00,280,65,215
20857,20857,194,2022/4/15 7:10:00,300,77,223
20858,20858,194,2022/4/15 7:20:00,365,104,261
20859,20859,194,2022/4/15 7:30:00,390,105,285
20860,20860,194,2022/4/15 7:40:00,365,108,257
20861,20861,194,2022/4/15 7:50:00,364,97,267
20862,20862,194,2022/4/15 8:00:00,336,122,214
20863,20863,194,2022/4/15 8:10:00,343,126,217
20864,20864,194,2022/4/15 8:20:00,317,125,192
20865,20865,194,2022/4/15 8:30:00,269,111,158
20866,20866,194,2022/4/15 8:40:00,187,105,82
20867,20867,194,2022/4/15 8:50:00,106,105,1
20868,20868,194,2022/4/15 9:00:00,100,77,23
20869,20869,194,2022/4/15 9:10:00,67,76,-9
20870,20870,194,2022/4/15 9:20:00,48,63,-15
20871,20871,194,2022/4/15 9:30:00,48,61,-13
20872,20872,194,2022/4/15 9:40:00,40,72,-32
20873,20873,194,2022/4/15 9:50:00,39,64,-25
20874,20874,194,2022/4/15 10:00:00,33,60,-27
20875,20875,194,2022/4/15 10:10:00,37,63,-26
20876,20876,194,2022/4/15 10:20:00,31,62,-31
20877,20877,194,2022/4/15 10:30:00,30,65,-35
20878,20878,194,2022/4/15 10:40:00,27,64,-37
20879,20879,194,2022/4/15 10:50:00,29,46,-17
20880,20880,194,2022/4/15 11:00:00,26,67,-41
20881,20881,194,2022/4/15 11:10:00,31,66,-35
20882,20882,194,2022/4/15 11:20:00,31,54,-23
20883,20883,194,2022/4/15 11:30:00,26,70,-44
20884,20884,194,2022/4/15 11:40:00,26,63,-37
20885,20885,194,2022/4/15 11:50:00,36,48,-12
20886,20886,194,2022/4/15 12:00:00,32,63,-31
20887,20887,194,2022/4/15 12:10:00,35,63,-28
20888,20888,194,2022/4/15 12:20:00,29,49,-20
20889,20889,194,2022/4/15 12:30:00,35,60,-25
20890,20890,194,2022/4/15 12:40:00,26,61,-35
20891,20891,194,2022/4/15 12:50:00,35,47,-12
20892,20892,194,2022/4/15 13:00:00,26,64,-38
20893,20893,194,2022/4/15 13:10:00,23,64,-41
20894,20894,194,2022/4/15 13:20:00,28,54,-26
20895,20895,194,2022/4/15 13:30:00,26,71,-45
20896,20896,194,2022/4/15 13:40:00,25,61,-36
20897,20897,194,2022/4/15 13:50:00,26,49,-23
20898,20898,194,2022/4/15 14:00:00,27,70,-43
20899,20899,194,2022/4/15 14:10:00,25,69,-44
20900,20900,194,2022/4/15 14:20:00,31,50,-19
20901,20901,194,2022/4/15 14:30:00,24,63,-39
20902,20902,194,2022/4/15 14:40:00,25,66,-41
20903,20903,194,2022/4/15 14:50:00,29,58,-29
20904,20904,194,2022/4/15 15:00:00,23,74,-51
20905,20905,194,2022/4/15 15:10:00,26,64,-38
20906,20906,194,2022/4/15 15:20:00,24,60,-36
20907,20907,194,2022/4/15 15:30:00,31,75,-44
20908,20908,194,2022/4/15 15:40:00,28,73,-45
20909,20909,194,2022/4/15 15:50:00,31,61,-30
20910,20910,194,2022/4/15 16:00:00,28,76,-48
20911,20911,194,2022/4/15 16:10:00,30,93,-63
20912,20912,194,2022/4/15 16:20:00,36,78,-42
20913,20913,194,2022/4/15 16:30:00,42,91,-49
20914,20914,194,2022/4/15 16:40:00,47,105,-58
20915,20915,194,2022/4/15 16:50:00,40,93,-53
20916,20916,194,2022/4/15 17:00:00,44,103,-59
20917,20917,194,2022/4/15 17:10:00,74,101,-27
20918,20918,194,2022/4/15 17:20:00,67,121,-54
20919,20919,194,2022/4/15 17:30:00,88,123,-35
20920,20920,194,2022/4/15 17:40:00,169,127,42
20921,20921,194,2022/4/15 17:50:00,71,118,-47
20922,20922,194,2022/4/15 18:00:00,51,145,-94
20923,20923,194,2022/4/15 18:10:00,48,144,-96
20924,20924,194,2022/4/15 18:20:00,40,182,-142
20925,20925,194,2022/4/15 18:30:00,28,139,-111
20926,20926,194,2022/4/15 18:40:00,26,169,-143
20927,20927,194,2022/4/15 18:50:00,27,181,-154
20928,20928,194,2022/4/15 19:00:00,26,147,-121
20929,20929,194,2022/4/15 19:10:00,27,144,-117
20930,20930,194,2022/4/15 19:20:00,25,116,-91
20931,20931,194,2022/4/15 19:30:00,27,105,-78
20932,20932,194,2022/4/15 19:40:00,23,109,-86
20933,20933,194,2022/4/15 19:50:00,20,109,-89
20934,20934,194,2022/4/15 20:00:00,22,107,-85
20935,20935,194,2022/4/15 20:10:00,21,100,-79
20936,20936,194,2022/4/15 20:20:00,15,102,-87
20937,20937,194,2022/4/15 20:30:00,20,95,-75
20938,20938,194,2022/4/15 20:40:00,17,82,-65
20939,20939,194,2022/4/15 20:50:00,13,94,-81
20940,20940,194,2022/4/15 21:00:00,22,74,-52
20941,20941,194,2022/4/15 21:10:00,13,99,-86
20942,20942,194,2022/4/15 21:20:00,16,85,-69
20943,20943,194,2022/4/15 21:30:00,10,75,-65
20944,20944,194,2022/4/15 21:40:00,10,77,-67
20945,20945,194,2022/4/15 21:50:00,10,77,-67
20946,20946,194,2022/4/15 22:00:00,6,64,-58
20947,20947,194,2022/4/15 22:10:00,2,94,-92
20948,20948,194,2022/4/15 22:20:00,1,67,-66
20949,20949,194,2022/4/15 22:30:00,1,69,-68
20950,20950,194,2022/4/15 22:40:00,0,38,-38
20951,20951,194,2022/4/15 22:50:00,0,3,-3
20952,20952,195,2022/4/15 5:00:00,0,1,-1
20953,20953,195,2022/4/15 5:10:00,0,1,-1
20954,20954,195,2022/4/15 5:20:00,0,1,-1
20955,20955,195,2022/4/15 5:30:00,0,1,-1
20956,20956,195,2022/4/15 5:40:00,1,1,0
20957,20957,195,2022/4/15 5:50:00,3,1,2
20958,20958,195,2022/4/15 6:00:00,8,1,7
20959,20959,195,2022/4/15 6:10:00,19,5,14
20960,20960,195,2022/4/15 6:20:00,32,29,3
20961,20961,195,2022/4/15 6:30:00,42,41,1
20962,20962,195,2022/4/15 6:40:00,46,29,17
20963,20963,195,2022/4/15 6:50:00,56,51,5
20964,20964,195,2022/4/15 7:00:00,77,63,14
20965,20965,195,2022/4/15 7:10:00,100,63,37
20966,20966,195,2022/4/15 7:20:00,168,61,107
20967,20967,195,2022/4/15 7:30:00,215,62,153
20968,20968,195,2022/4/15 7:40:00,223,69,154
20969,20969,195,2022/4/15 7:50:00,224,72,152
20970,20970,195,2022/4/15 8:00:00,183,76,107
20971,20971,195,2022/4/15 8:10:00,190,105,85
20972,20972,195,2022/4/15 8:20:00,175,91,84
20973,20973,195,2022/4/15 8:30:00,110,80,30
20974,20974,195,2022/4/15 8:40:00,84,83,1
20975,20975,195,2022/4/15 8:50:00,63,76,-13
20976,20976,195,2022/4/15 9:00:00,46,67,-21
20977,20977,195,2022/4/15 9:10:00,33,51,-18
20978,20978,195,2022/4/15 9:20:00,30,50,-20
20979,20979,195,2022/4/15 9:30:00,28,48,-20
20980,20980,195,2022/4/15 9:40:00,28,41,-13
20981,20981,195,2022/4/15 9:50:00,23,33,-10
20982,20982,195,2022/4/15 10:00:00,22,31,-9
20983,20983,195,2022/4/15 10:10:00,21,34,-13
20984,20984,195,2022/4/15 10:20:00,19,34,-15
20985,20985,195,2022/4/15 10:30:00,18,37,-19
20986,20986,195,2022/4/15 10:40:00,16,23,-7
20987,20987,195,2022/4/15 10:50:00,17,32,-15
20988,20988,195,2022/4/15 11:00:00,15,33,-18
20989,20989,195,2022/4/15 11:10:00,18,23,-5
20990,20990,195,2022/4/15 11:20:00,19,39,-20
20991,20991,195,2022/4/15 11:30:00,14,33,-19
20992,20992,195,2022/4/15 11:40:00,17,23,-6
20993,20993,195,2022/4/15 11:50:00,17,40,-23
20994,20994,195,2022/4/15 12:00:00,17,37,-20
20995,20995,195,2022/4/15 12:10:00,16,25,-9
20996,20996,195,2022/4/15 12:20:00,17,41,-24
20997,20997,195,2022/4/15 12:30:00,16,41,-25
20998,20998,195,2022/4/15 12:40:00,16,31,-15
20999,20999,195,2022/4/15 12:50:00,18,46,-28
21000,21000,195,2022/4/15 13:00:00,17,42,-25
21001,21001,195,2022/4/15 13:10:00,20,32,-12
21002,21002,195,2022/4/15 13:20:00,15,51,-36
21003,21003,195,2022/4/15 13:30:00,16,38,-22
21004,21004,195,2022/4/15 13:40:00,19,32,-13
21005,21005,195,2022/4/15 13:50:00,16,45,-29
21006,21006,195,2022/4/15 14:00:00,15,38,-23
21007,21007,195,2022/4/15 14:10:00,18,33,-15
21008,21008,195,2022/4/15 14:20:00,15,38,-23
21009,21009,195,2022/4/15 14:30:00,16,44,-28
21010,21010,195,2022/4/15 14:40:00,17,29,-12
21011,21011,195,2022/4/15 14:50:00,16,48,-32
21012,21012,195,2022/4/15 15:00:00,15,40,-25
21013,21013,195,2022/4/15 15:10:00,21,35,-14
21014,21014,195,2022/4/15 15:20:00,16,47,-31
21015,21015,195,2022/4/15 15:30:00,22,51,-29
21016,21016,195,2022/4/15 15:40:00,21,35,-14
21017,21017,195,2022/4/15 15:50:00,19,54,-35
21018,21018,195,2022/4/15 16:00:00,19,51,-32
21019,21019,195,2022/4/15 16:10:00,25,41,-16
21020,21020,195,2022/4/15 16:20:00,24,62,-38
21021,21021,195,2022/4/15 16:30:00,28,71,-43
21022,21022,195,2022/4/15 16:40:00,35,53,-18
21023,21023,195,2022/4/15 16:50:00,36,79,-43
21024,21024,195,2022/4/15 17:00:00,27,79,-52
21025,21025,195,2022/4/15 17:10:00,35,83,-48
21026,21026,195,2022/4/15 17:20:00,47,90,-43
21027,21027,195,2022/4/15 17:30:00,41,102,-61
21028,21028,195,2022/4/15 17:40:00,39,105,-66
21029,21029,195,2022/4/15 17:50:00,37,102,-65
21030,21030,195,2022/4/15 18:00:00,30,121,-91
21031,21031,195,2022/4/15 18:10:00,34,108,-74
21032,21032,195,2022/4/15 18:20:00,28,112,-84
21033,21033,195,2022/4/15 18:30:00,22,89,-67
21034,21034,195,2022/4/15 18:40:00,25,111,-86
21035,21035,195,2022/4/15 18:50:00,22,104,-82
21036,21036,195,2022/4/15 19:00:00,17,113,-96
21037,21037,195,2022/4/15 19:10:00,18,107,-89
21038,21038,195,2022/4/15 19:20:00,13,101,-88
21039,21039,195,2022/4/15 19:30:00,12,99,-87
21040,21040,195,2022/4/15 19:40:00,16,77,-61
21041,21041,195,2022/4/15 19:50:00,10,80,-70
21042,21042,195,2022/4/15 20:00:00,11,64,-53
21043,21043,195,2022/4/15 20:10:00,13,68,-55
21044,21044,195,2022/4/15 20:20:00,12,70,-58
21045,21045,195,2022/4/15 20:30:00,12,62,-50
21046,21046,195,2022/4/15 20:40:00,11,61,-50
21047,21047,195,2022/4/15 20:50:00,9,46,-37
21048,21048,195,2022/4/15 21:00:00,11,64,-53
21049,21049,195,2022/4/15 21:10:00,11,67,-56
21050,21050,195,2022/4/15 21:20:00,11,46,-35
21051,21051,195,2022/4/15 21:30:00,10,62,-52
21052,21052,195,2022/4/15 21:40:00,5,66,-61
21053,21053,195,2022/4/15 21:50:00,7,40,-33
21054,21054,195,2022/4/15 22:00:00,4,59,-55
21055,21055,195,2022/4/15 22:10:00,4,43,-39
21056,21056,195,2022/4/15 22:20:00,2,52,-50
21057,21057,195,2022/4/15 22:30:00,0,32,-32
21058,21058,195,2022/4/15 22:40:00,0,3,-3
21059,21059,195,2022/4/15 22:50:00,0,3,-3
21060,21060,196,2022/4/15 5:00:00,0,1,-1
21061,21061,196,2022/4/15 5:10:00,0,1,-1
21062,21062,196,2022/4/15 5:20:00,0,1,-1
21063,21063,196,2022/4/15 5:30:00,0,1,-1
21064,21064,196,2022/4/15 5:40:00,0,1,-1
21065,21065,196,2022/4/15 5:50:00,25,1,24
21066,21066,196,2022/4/15 6:00:00,53,5,48
21067,21067,196,2022/4/15 6:10:00,58,33,25
21068,21068,196,2022/4/15 6:20:00,91,38,53
21069,21069,196,2022/4/15 6:30:00,147,76,71
21070,21070,196,2022/4/15 6:40:00,225,77,148
21071,21071,196,2022/4/15 6:50:00,281,108,173
21072,21072,196,2022/4/15 7:00:00,348,93,255
21073,21073,196,2022/4/15 7:10:00,596,114,482
21074,21074,196,2022/4/15 7:20:00,629,123,506
21075,21075,196,2022/4/15 7:30:00,722,146,576
21076,21076,196,2022/4/15 7:40:00,722,184,538
21077,21077,196,2022/4/15 7:50:00,722,145,577
21078,21078,196,2022/4/15 8:00:00,599,144,455
21079,21079,196,2022/4/15 8:10:00,601,179,422
21080,21080,196,2022/4/15 8:20:00,376,153,223
21081,21081,196,2022/4/15 8:30:00,279,153,126
21082,21082,196,2022/4/15 8:40:00,227,121,106
21083,21083,196,2022/4/15 8:50:00,177,116,61
21084,21084,196,2022/4/15 9:00:00,142,87,55
21085,21085,196,2022/4/15 9:10:00,72,103,-31
21086,21086,196,2022/4/15 9:20:00,63,100,-37
21087,21087,196,2022/4/15 9:30:00,55,93,-38
21088,21088,196,2022/4/15 9:40:00,40,90,-50
21089,21089,196,2022/4/15 9:50:00,39,72,-33
21090,21090,196,2022/4/15 10:00:00,41,96,-55
21091,21091,196,2022/4/15 10:10:00,27,92,-65
21092,21092,196,2022/4/15 10:20:00,35,76,-41
21093,21093,196,2022/4/15 10:30:00,28,75,-47
21094,21094,196,2022/4/15 10:40:00,35,90,-55
21095,21095,196,2022/4/15 10:50:00,26,78,-52
21096,21096,196,2022/4/15 11:00:00,37,72,-35
21097,21097,196,2022/4/15 11:10:00,36,87,-51
21098,21098,196,2022/4/15 11:20:00,38,77,-39
21099,21099,196,2022/4/15 11:30:00,36,84,-48
21100,21100,196,2022/4/15 11:40:00,41,91,-50
21101,21101,196,2022/4/15 11:50:00,43,76,-33
21102,21102,196,2022/4/15 12:00:00,48,77,-29
21103,21103,196,2022/4/15 12:10:00,40,90,-50
21104,21104,196,2022/4/15 12:20:00,51,75,-24
21105,21105,196,2022/4/15 12:30:00,52,73,-21
21106,21106,196,2022/4/15 12:40:00,40,96,-56
21107,21107,196,2022/4/15 12:50:00,42,77,-35
21108,21108,196,2022/4/15 13:00:00,42,73,-31
21109,21109,196,2022/4/15 13:10:00,41,98,-57
21110,21110,196,2022/4/15 13:20:00,38,84,-46
21111,21111,196,2022/4/15 13:30:00,34,81,-47
21112,21112,196,2022/4/15 13:40:00,42,101,-59
21113,21113,196,2022/4/15 13:50:00,29,81,-52
21114,21114,196,2022/4/15 14:00:00,32,75,-43
21115,21115,196,2022/4/15 14:10:00,28,101,-73
21116,21116,196,2022/4/15 14:20:00,31,79,-48
21117,21117,196,2022/4/15 14:30:00,33,76,-43
21118,21118,196,2022/4/15 14:40:00,26,106,-80
21119,21119,196,2022/4/15 14:50:00,33,79,-46
21120,21120,196,2022/4/15 15:00:00,37,92,-55
21121,21121,196,2022/4/15 15:10:00,32,110,-78
21122,21122,196,2022/4/15 15:20:00,43,86,-43
21123,21123,196,2022/4/15 15:30:00,40,97,-57
21124,21124,196,2022/4/15 15:40:00,43,109,-66
21125,21125,196,2022/4/15 15:50:00,42,109,-67
21126,21126,196,2022/4/15 16:00:00,47,98,-51
21127,21127,196,2022/4/15 16:10:00,53,122,-69
21128,21128,196,2022/4/15 16:20:00,78,99,-21
21129,21129,196,2022/4/15 16:30:00,106,99,7
21130,21130,196,2022/4/15 16:40:00,195,108,87
21131,21131,196,2022/4/15 16:50:00,123,129,-6
21132,21132,196,2022/4/15 17:00:00,183,149,34
21133,21133,196,2022/4/15 17:10:00,211,143,68
21134,21134,196,2022/4/15 17:20:00,261,178,83
21135,21135,196,2022/4/15 17:30:00,208,213,-5
21136,21136,196,2022/4/15 17:40:00,205,197,8
21137,21137,196,2022/4/15 17:50:00,198,232,-34
21138,21138,196,2022/4/15 18:00:00,157,208,-51
21139,21139,196,2022/4/15 18:10:00,206,218,-12
21140,21140,196,2022/4/15 18:20:00,170,217,-47
21141,21141,196,2022/4/15 18:30:00,103,234,-131
21142,21142,196,2022/4/15 18:40:00,76,233,-157
21143,21143,196,2022/4/15 18:50:00,45,256,-211
21144,21144,196,2022/4/15 19:00:00,35,219,-184
21145,21145,196,2022/4/15 19:10:00,36,198,-162
21146,21146,196,2022/4/15 19:20:00,27,208,-181
21147,21147,196,2022/4/15 19:30:00,31,179,-148
21148,21148,196,2022/4/15 19:40:00,25,158,-133
21149,21149,196,2022/4/15 19:50:00,33,128,-95
21150,21150,196,2022/4/15 20:00:00,29,111,-82
21151,21151,196,2022/4/15 20:10:00,29,100,-71
21152,21152,196,2022/4/15 20:20:00,28,127,-99
21153,21153,196,2022/4/15 20:30:00,27,104,-77
21154,21154,196,2022/4/15 20:40:00,25,107,-82
21155,21155,196,2022/4/15 20:50:00,30,106,-76
21156,21156,196,2022/4/15 21:00:00,24,104,-80
21157,21157,196,2022/4/15 21:10:00,23,114,-91
21158,21158,196,2022/4/15 21:20:00,22,123,-101
21159,21159,196,2022/4/15 21:30:00,24,108,-84
21160,21160,196,2022/4/15 21:40:00,18,99,-81
21161,21161,196,2022/4/15 21:50:00,14,124,-110
21162,21162,196,2022/4/15 22:00:00,12,103,-91
21163,21163,196,2022/4/15 22:10:00,7,96,-89
21164,21164,196,2022/4/15 22:20:00,2,108,-106
21165,21165,196,2022/4/15 22:30:00,1,63,-62
21166,21166,196,2022/4/15 22:40:00,0,102,-102
21167,21167,196,2022/4/15 22:50:00,0,3,-3
21168,21168,197,2022/4/15 5:00:00,0,1,-1
21169,21169,197,2022/4/15 5:10:00,0,1,-1
21170,21170,197,2022/4/15 5:20:00,0,1,-1
21171,21171,197,2022/4/15 5:30:00,0,1,-1
21172,21172,197,2022/4/15 5:40:00,5,1,4
21173,21173,197,2022/4/15 5:50:00,29,1,28
21174,21174,197,2022/4/15 6:00:00,58,1,57
21175,21175,197,2022/4/15 6:10:00,45,1,44
21176,21176,197,2022/4/15 6:20:00,75,19,56
21177,21177,197,2022/4/15 6:30:00,81,21,60
21178,21178,197,2022/4/15 6:40:00,168,21,147
21179,21179,197,2022/4/15 6:50:00,185,48,137
21180,21180,197,2022/4/15 7:00:00,218,64,154
21181,21181,197,2022/4/15 7:10:00,274,99,175
21182,21182,197,2022/4/15 7:20:00,305,106,199
21183,21183,197,2022/4/15 7:30:00,281,109,172
21184,21184,197,2022/4/15 7:40:00,276,198,78
21185,21185,197,2022/4/15 7:50:00,273,138,135
21186,21186,197,2022/4/15 8:00:00,226,122,104
21187,21187,197,2022/4/15 8:10:00,212,93,119
21188,21188,197,2022/4/15 8:20:00,149,76,73
21189,21189,197,2022/4/15 8:30:00,78,60,18
21190,21190,197,2022/4/15 8:40:00,57,65,-8
21191,21191,197,2022/4/15 8:50:00,54,56,-2
21192,21192,197,2022/4/15 9:00:00,32,49,-17
21193,21193,197,2022/4/15 9:10:00,28,47,-19
21194,21194,197,2022/4/15 9:20:00,27,51,-24
21195,21195,197,2022/4/15 9:30:00,28,49,-21
21196,21196,197,2022/4/15 9:40:00,24,50,-26
21197,21197,197,2022/4/15 9:50:00,26,51,-25
21198,21198,197,2022/4/15 10:00:00,25,38,-13
21199,21199,197,2022/4/15 10:10:00,21,40,-19
21200,21200,197,2022/4/15 10:20:00,18,50,-32
21201,21201,197,2022/4/15 10:30:00,22,31,-9
21202,21202,197,2022/4/15 10:40:00,15,40,-25
21203,21203,197,2022/4/15 10:50:00,20,46,-26
21204,21204,197,2022/4/15 11:00:00,19,32,-13
21205,21205,197,2022/4/15 11:10:00,17,48,-31
21206,21206,197,2022/4/15 11:20:00,28,48,-20
21207,21207,197,2022/4/15 11:30:00,23,38,-15
21208,21208,197,2022/4/15 11:40:00,27,50,-23
21209,21209,197,2022/4/15 11:50:00,25,48,-23
21210,21210,197,2022/4/15 12:00:00,25,29,-4
21211,21211,197,2022/4/15 12:10:00,23,45,-22
21212,21212,197,2022/4/15 12:20:00,25,42,-17
21213,21213,197,2022/4/15 12:30:00,23,35,-12
21214,21214,197,2022/4/15 12:40:00,24,45,-21
21215,21215,197,2022/4/15 12:50:00,21,49,-28
21216,21216,197,2022/4/15 13:00:00,24,38,-14
21217,21217,197,2022/4/15 13:10:00,20,41,-21
21218,21218,197,2022/4/15 13:20:00,21,46,-25
21219,21219,197,2022/4/15 13:30:00,22,37,-15
21220,21220,197,2022/4/15 13:40:00,19,50,-31
21221,21221,197,2022/4/15 13:50:00,22,49,-27
21222,21222,197,2022/4/15 14:00:00,21,38,-17
21223,21223,197,2022/4/15 14:10:00,20,45,-25
21224,21224,197,2022/4/15 14:20:00,23,45,-22
21225,21225,197,2022/4/15 14:30:00,22,37,-15
21226,21226,197,2022/4/15 14:40:00,24,54,-30
21227,21227,197,2022/4/15 14:50:00,22,54,-32
21228,21228,197,2022/4/15 15:00:00,23,45,-22
21229,21229,197,2022/4/15 15:10:00,24,65,-41
21230,21230,197,2022/4/15 15:20:00,26,65,-39
21231,21231,197,2022/4/15 15:30:00,25,48,-23
21232,21232,197,2022/4/15 15:40:00,25,62,-37
21233,21233,197,2022/4/15 15:50:00,62,62,0
21234,21234,197,2022/4/15 16:00:00,76,57,19
21235,21235,197,2022/4/15 16:10:00,33,65,-32
21236,21236,197,2022/4/15 16:20:00,28,84,-56
21237,21237,197,2022/4/15 16:30:00,53,62,-9
21238,21238,197,2022/4/15 16:40:00,149,63,86
21239,21239,197,2022/4/15 16:50:00,75,77,-2
21240,21240,197,2022/4/15 17:00:00,46,80,-34
21241,21241,197,2022/4/15 17:10:00,44,93,-49
21242,21242,197,2022/4/15 17:20:00,41,100,-59
21243,21243,197,2022/4/15 17:30:00,44,102,-58
21244,21244,197,2022/4/15 17:40:00,40,108,-68
21245,21245,197,2022/4/15 17:50:00,27,112,-85
21246,21246,197,2022/4/15 18:00:00,30,90,-60
21247,21247,197,2022/4/15 18:10:00,34,101,-67
21248,21248,197,2022/4/15 18:20:00,24,108,-84
21249,21249,197,2022/4/15 18:30:00,26,123,-97
21250,21250,197,2022/4/15 18:40:00,23,122,-99
21251,21251,197,2022/4/15 18:50:00,20,128,-108
21252,21252,197,2022/4/15 19:00:00,22,124,-102
21253,21253,197,2022/4/15 19:10:00,16,89,-73
21254,21254,197,2022/4/15 19:20:00,16,124,-108
21255,21255,197,2022/4/15 19:30:00,14,105,-91
21256,21256,197,2022/4/15 19:40:00,16,103,-87
21257,21257,197,2022/4/15 19:50:00,14,97,-83
21258,21258,197,2022/4/15 20:00:00,16,88,-72
21259,21259,197,2022/4/15 20:10:00,16,77,-61
21260,21260,197,2022/4/15 20:20:00,11,79,-68
21261,21261,197,2022/4/15 20:30:00,16,71,-55
21262,21262,197,2022/4/15 20:40:00,10,66,-56
21263,21263,197,2022/4/15 20:50:00,9,70,-61
21264,21264,197,2022/4/15 21:00:00,8,71,-63
21265,21265,197,2022/4/15 21:10:00,7,50,-43
21266,21266,197,2022/4/15 21:20:00,9,76,-67
21267,21267,197,2022/4/15 21:30:00,5,69,-64
21268,21268,197,2022/4/15 21:40:00,7,68,-61
21269,21269,197,2022/4/15 21:50:00,4,63,-59
21270,21270,197,2022/4/15 22:00:00,1,72,-71
21271,21271,197,2022/4/15 22:10:00,0,49,-49
21272,21272,197,2022/4/15 22:20:00,0,68,-68
21273,21273,197,2022/4/15 22:30:00,0,64,-64
21274,21274,197,2022/4/15 22:40:00,0,49,-49
21275,21275,197,2022/4/15 22:50:00,0,25,-25
21276,21276,198,2022/4/15 5:00:00,0,1,-1
21277,21277,198,2022/4/15 5:10:00,0,1,-1
21278,21278,198,2022/4/15 5:20:00,0,1,-1
21279,21279,198,2022/4/15 5:30:00,0,1,-1
21280,21280,198,2022/4/15 5:40:00,0,1,-1
21281,21281,198,2022/4/15 5:50:00,13,1,12
21282,21282,198,2022/4/15 6:00:00,29,1,28
21283,21283,198,2022/4/15 6:10:00,31,21,10
21284,21284,198,2022/4/15 6:20:00,36,28,8
21285,21285,198,2022/4/15 6:30:00,53,37,16
21286,21286,198,2022/4/15 6:40:00,86,41,45
21287,21287,198,2022/4/15 6:50:00,113,62,51
21288,21288,198,2022/4/15 7:00:00,149,72,77
21289,21289,198,2022/4/15 7:10:00,224,87,137
21290,21290,198,2022/4/15 7:20:00,232,104,128
21291,21291,198,2022/4/15 7:30:00,283,102,181
21292,21292,198,2022/4/15 7:40:00,286,120,166
21293,21293,198,2022/4/15 7:50:00,235,123,112
21294,21294,198,2022/4/15 8:00:00,220,127,93
21295,21295,198,2022/4/15 8:10:00,207,118,89
21296,21296,198,2022/4/15 8:20:00,166,107,59
21297,21297,198,2022/4/15 8:30:00,123,105,18
21298,21298,198,2022/4/15 8:40:00,67,95,-28
21299,21299,198,2022/4/15 8:50:00,51,106,-55
21300,21300,198,2022/4/15 9:00:00,39,75,-36
21301,21301,198,2022/4/15 9:10:00,32,49,-17
21302,21302,198,2022/4/15 9:20:00,34,74,-40
21303,21303,198,2022/4/15 9:30:00,27,61,-34
21304,21304,198,2022/4/15 9:40:00,26,69,-43
21305,21305,198,2022/4/15 9:50:00,25,72,-47
21306,21306,198,2022/4/15 10:00:00,24,60,-36
21307,21307,198,2022/4/15 10:10:00,23,49,-26
21308,21308,198,2022/4/15 10:20:00,22,65,-43
21309,21309,198,2022/4/15 10:30:00,21,46,-25
21310,21310,198,2022/4/15 10:40:00,22,51,-29
21311,21311,198,2022/4/15 10:50:00,19,65,-46
21312,21312,198,2022/4/15 11:00:00,17,61,-44
21313,21313,198,2022/4/15 11:10:00,21,50,-29
21314,21314,198,2022/4/15 11:20:00,19,63,-44
21315,21315,198,2022/4/15 11:30:00,22,45,-23
21316,21316,198,2022/4/15 11:40:00,24,61,-37
21317,21317,198,2022/4/15 11:50:00,19,62,-43
21318,21318,198,2022/4/15 12:00:00,22,59,-37
21319,21319,198,2022/4/15 12:10:00,21,48,-27
21320,21320,198,2022/4/15 12:20:00,21,62,-41
21321,21321,198,2022/4/15 12:30:00,22,51,-29
21322,21322,198,2022/4/15 12:40:00,22,61,-39
21323,21323,198,2022/4/15 12:50:00,19,62,-43
21324,21324,198,2022/4/15 13:00:00,21,52,-31
21325,21325,198,2022/4/15 13:10:00,22,64,-42
21326,21326,198,2022/4/15 13:20:00,26,68,-42
21327,21327,198,2022/4/15 13:30:00,22,51,-29
21328,21328,198,2022/4/15 13:40:00,22,54,-32
21329,21329,198,2022/4/15 13:50:00,24,61,-37
21330,21330,198,2022/4/15 14:00:00,22,51,-29
21331,21331,198,2022/4/15 14:10:00,23,52,-29
21332,21332,198,2022/4/15 14:20:00,22,73,-51
21333,21333,198,2022/4/15 14:30:00,21,53,-32
21334,21334,198,2022/4/15 14:40:00,23,66,-43
21335,21335,198,2022/4/15 14:50:00,21,67,-46
21336,21336,198,2022/4/15 15:00:00,22,55,-33
21337,21337,198,2022/4/15 15:10:00,24,65,-41
21338,21338,198,2022/4/15 15:20:00,20,70,-50
21339,21339,198,2022/4/15 15:30:00,22,60,-38
21340,21340,198,2022/4/15 15:40:00,23,60,-37
21341,21341,198,2022/4/15 15:50:00,25,82,-57
21342,21342,198,2022/4/15 16:00:00,35,63,-28
21343,21343,198,2022/4/15 16:10:00,32,71,-39
21344,21344,198,2022/4/15 16:20:00,24,93,-69
21345,21345,198,2022/4/15 16:30:00,28,77,-49
21346,21346,198,2022/4/15 16:40:00,34,76,-42
21347,21347,198,2022/4/15 16:50:00,27,93,-66
21348,21348,198,2022/4/15 17:00:00,35,105,-70
21349,21349,198,2022/4/15 17:10:00,67,108,-41
21350,21350,198,2022/4/15 17:20:00,54,105,-51
21351,21351,198,2022/4/15 17:30:00,40,107,-67
21352,21352,198,2022/4/15 17:40:00,53,109,-56
21353,21353,198,2022/4/15 17:50:00,41,97,-56
21354,21354,198,2022/4/15 18:00:00,36,121,-85
21355,21355,198,2022/4/15 18:10:00,35,111,-76
21356,21356,198,2022/4/15 18:20:00,26,110,-84
21357,21357,198,2022/4/15 18:30:00,27,109,-82
21358,21358,198,2022/4/15 18:40:00,26,121,-95
21359,21359,198,2022/4/15 18:50:00,23,124,-101
21360,21360,198,2022/4/15 19:00:00,25,119,-94
21361,21361,198,2022/4/15 19:10:00,18,133,-115
21362,21362,198,2022/4/15 19:20:00,21,107,-86
21363,21363,198,2022/4/15 19:30:00,14,122,-108
21364,21364,198,2022/4/15 19:40:00,20,126,-106
21365,21365,198,2022/4/15 19:50:00,15,102,-87
21366,21366,198,2022/4/15 20:00:00,13,99,-86
21367,21367,198,2022/4/15 20:10:00,16,100,-84
21368,21368,198,2022/4/15 20:20:00,14,98,-84
21369,21369,198,2022/4/15 20:30:00,14,76,-62
21370,21370,198,2022/4/15 20:40:00,15,79,-64
21371,21371,198,2022/4/15 20:50:00,14,64,-50
21372,21372,198,2022/4/15 21:00:00,16,95,-79
21373,21373,198,2022/4/15 21:10:00,12,79,-67
21374,21374,198,2022/4/15 21:20:00,10,67,-57
21375,21375,198,2022/4/15 21:30:00,8,92,-84
21376,21376,198,2022/4/15 21:40:00,8,63,-55
21377,21377,198,2022/4/15 21:50:00,7,62,-55
21378,21378,198,2022/4/15 22:00:00,4,77,-73
21379,21379,198,2022/4/15 22:10:00,2,71,-69
21380,21380,198,2022/4/15 22:20:00,1,72,-71
21381,21381,198,2022/4/15 22:30:00,1,72,-71
21382,21382,198,2022/4/15 22:40:00,0,49,-49
21383,21383,198,2022/4/15 22:50:00,0,3,-3
21384,21384,199,2022/4/15 5:00:00,0,1,-1
21385,21385,199,2022/4/15 5:10:00,0,1,-1
21386,21386,199,2022/4/15 5:20:00,0,1,-1
21387,21387,199,2022/4/15 5:30:00,0,1,-1
21388,21388,199,2022/4/15 5:40:00,0,1,-1
21389,21389,199,2022/4/15 5:50:00,32,1,31
21390,21390,199,2022/4/15 6:00:00,55,1,54
21391,21391,199,2022/4/15 6:10:00,83,6,77
21392,21392,199,2022/4/15 6:20:00,78,25,53
21393,21393,199,2022/4/15 6:30:00,106,21,85
21394,21394,199,2022/4/15 6:40:00,187,52,135
21395,21395,199,2022/4/15 6:50:00,226,49,177
21396,21396,199,2022/4/15 7:00:00,267,81,186
21397,21397,199,2022/4/15 7:10:00,358,102,256
21398,21398,199,2022/4/15 7:20:00,328,106,222
21399,21399,199,2022/4/15 7:30:00,567,102,465
21400,21400,199,2022/4/15 7:40:00,447,70,377
21401,21401,199,2022/4/15 7:50:00,324,68,256
21402,21402,199,2022/4/15 8:00:00,317,57,260
21403,21403,199,2022/4/15 8:10:00,280,69,211
21404,21404,199,2022/4/15 8:20:00,246,63,183
21405,21405,199,2022/4/15 8:30:00,207,72,135
21406,21406,199,2022/4/15 8:40:00,146,66,80
21407,21407,199,2022/4/15 8:50:00,83,68,15
21408,21408,199,2022/4/15 9:00:00,61,59,2
21409,21409,199,2022/4/15 9:10:00,48,57,-9
21410,21410,199,2022/4/15 9:20:00,43,52,-9
21411,21411,199,2022/4/15 9:30:00,33,65,-32
21412,21412,199,2022/4/15 9:40:00,30,57,-27
21413,21413,199,2022/4/15 9:50:00,32,60,-28
21414,21414,199,2022/4/15 10:00:00,30,62,-32
21415,21415,199,2022/4/15 10:10:00,27,50,-23
21416,21416,199,2022/4/15 10:20:00,28,62,-34
21417,21417,199,2022/4/15 10:30:00,27,64,-37
21418,21418,199,2022/4/15 10:40:00,28,54,-26
21419,21419,199,2022/4/15 10:50:00,26,52,-26
21420,21420,199,2022/4/15 11:00:00,28,66,-38
21421,21421,199,2022/4/15 11:10:00,29,58,-29
21422,21422,199,2022/4/15 11:20:00,28,51,-23
21423,21423,199,2022/4/15 11:30:00,26,65,-39
21424,21424,199,2022/4/15 11:40:00,28,51,-23
21425,21425,199,2022/4/15 11:50:00,29,53,-24
21426,21426,199,2022/4/15 12:00:00,31,62,-31
21427,21427,199,2022/4/15 12:10:00,31,53,-22
21428,21428,199,2022/4/15 12:20:00,33,45,-12
21429,21429,199,2022/4/15 12:30:00,31,65,-34
21430,21430,199,2022/4/15 12:40:00,26,50,-24
21431,21431,199,2022/4/15 12:50:00,25,60,-35
21432,21432,199,2022/4/15 13:00:00,26,63,-37
21433,21433,199,2022/4/15 13:10:00,29,50,-21
21434,21434,199,2022/4/15 13:20:00,29,61,-32
21435,21435,199,2022/4/15 13:30:00,27,66,-39
21436,21436,199,2022/4/15 13:40:00,27,59,-32
21437,21437,199,2022/4/15 13:50:00,24,64,-40
21438,21438,199,2022/4/15 14:00:00,22,63,-41
21439,21439,199,2022/4/15 14:10:00,27,61,-34
21440,21440,199,2022/4/15 14:20:00,22,64,-42
21441,21441,199,2022/4/15 14:30:00,25,72,-47
21442,21442,199,2022/4/15 14:40:00,22,53,-31
21443,21443,199,2022/4/15 14:50:00,27,66,-39
21444,21444,199,2022/4/15 15:00:00,28,75,-47
21445,21445,199,2022/4/15 15:10:00,28,64,-36
21446,21446,199,2022/4/15 15:20:00,29,65,-36
21447,21447,199,2022/4/15 15:30:00,24,74,-50
21448,21448,199,2022/4/15 15:40:00,24,78,-54
21449,21449,199,2022/4/15 15:50:00,25,76,-51
21450,21450,199,2022/4/15 16:00:00,29,87,-58
21451,21451,199,2022/4/15 16:10:00,28,83,-55
21452,21452,199,2022/4/15 16:20:00,26,80,-54
21453,21453,199,2022/4/15 16:30:00,41,99,-58
21454,21454,199,2022/4/15 16:40:00,163,112,51
21455,21455,199,2022/4/15 16:50:00,41,100,-59
21456,21456,199,2022/4/15 17:00:00,43,108,-65
21457,21457,199,2022/4/15 17:10:00,41,127,-86
21458,21458,199,2022/4/15 17:20:00,37,110,-73
21459,21459,199,2022/4/15 17:30:00,30,118,-88
21460,21460,199,2022/4/15 17:40:00,31,118,-87
21461,21461,199,2022/4/15 17:50:00,29,132,-103
21462,21462,199,2022/4/15 18:00:00,24,107,-83
21463,21463,199,2022/4/15 18:10:00,24,149,-125
21464,21464,199,2022/4/15 18:20:00,26,128,-102
21465,21465,199,2022/4/15 18:30:00,24,119,-95
21466,21466,199,2022/4/15 18:40:00,22,146,-124
21467,21467,199,2022/4/15 18:50:00,21,112,-91
21468,21468,199,2022/4/15 19:00:00,19,109,-90
21469,21469,199,2022/4/15 19:10:00,23,109,-86
21470,21470,199,2022/4/15 19:20:00,19,121,-102
21471,21471,199,2022/4/15 19:30:00,22,120,-98
21472,21472,199,2022/4/15 19:40:00,21,114,-93
21473,21473,199,2022/4/15 19:50:00,19,113,-94
21474,21474,199,2022/4/15 20:00:00,21,90,-69
21475,21475,199,2022/4/15 20:10:00,20,91,-71
21476,21476,199,2022/4/15 20:20:00,20,82,-62
21477,21477,199,2022/4/15 20:30:00,26,77,-51
21478,21478,199,2022/4/15 20:40:00,20,78,-58
21479,21479,199,2022/4/15 20:50:00,19,73,-54
21480,21480,199,2022/4/15 21:00:00,20,69,-49
21481,21481,199,2022/4/15 21:10:00,18,91,-73
21482,21482,199,2022/4/15 21:20:00,18,73,-55
21483,21483,199,2022/4/15 21:30:00,16,69,-53
21484,21484,199,2022/4/15 21:40:00,12,77,-65
21485,21485,199,2022/4/15 21:50:00,9,77,-68
21486,21486,199,2022/4/15 22:00:00,7,63,-56
21487,21487,199,2022/4/15 22:10:00,2,78,-76
21488,21488,199,2022/4/15 22:20:00,1,55,-54
21489,21489,199,2022/4/15 22:30:00,2,71,-69
21490,21490,199,2022/4/15 22:40:00,0,67,-67
21491,21491,199,2022/4/15 22:50:00,0,17,-17
21492,21492,200,2022/4/15 5:00:00,0,1,-1
21493,21493,200,2022/4/15 5:10:00,0,1,-1
21494,21494,200,2022/4/15 5:20:00,0,1,-1
21495,21495,200,2022/4/15 5:30:00,0,1,-1
21496,21496,200,2022/4/15 5:40:00,19,1,18
21497,21497,200,2022/4/15 5:50:00,37,1,36
21498,21498,200,2022/4/15 6:00:00,26,1,25
21499,21499,200,2022/4/15 6:10:00,32,1,31
21500,21500,200,2022/4/15 6:20:00,34,21,13
21501,21501,200,2022/4/15 6:30:00,38,23,15
21502,21502,200,2022/4/15 6:40:00,47,49,-2
21503,21503,200,2022/4/15 6:50:00,59,61,-2
21504,21504,200,2022/4/15 7:00:00,79,108,-29
21505,21505,200,2022/4/15 7:10:00,145,69,76
21506,21506,200,2022/4/15 7:20:00,149,93,56
21507,21507,200,2022/4/15 7:30:00,128,121,7
21508,21508,200,2022/4/15 7:40:00,128,96,32
21509,21509,200,2022/4/15 7:50:00,83,105,-22
21510,21510,200,2022/4/15 8:00:00,86,124,-38
21511,21511,200,2022/4/15 8:10:00,60,105,-45
21512,21512,200,2022/4/15 8:20:00,55,110,-55
21513,21513,200,2022/4/15 8:30:00,44,108,-64
21514,21514,200,2022/4/15 8:40:00,31,120,-89
21515,21515,200,2022/4/15 8:50:00,25,97,-72
21516,21516,200,2022/4/15 9:00:00,27,87,-60
21517,21517,200,2022/4/15 9:10:00,24,83,-59
21518,21518,200,2022/4/15 9:20:00,26,70,-44
21519,21519,200,2022/4/15 9:30:00,23,78,-55
21520,21520,200,2022/4/15 9:40:00,23,69,-46
21521,21521,200,2022/4/15 9:50:00,20,67,-47
21522,21522,200,2022/4/15 10:00:00,20,67,-47
21523,21523,200,2022/4/15 10:10:00,22,55,-33
21524,21524,200,2022/4/15 10:20:00,25,65,-40
21525,21525,200,2022/4/15 10:30:00,17,54,-37
21526,21526,200,2022/4/15 10:40:00,23,42,-19
21527,21527,200,2022/4/15 10:50:00,22,54,-32
21528,21528,200,2022/4/15 11:00:00,22,49,-27
21529,21529,200,2022/4/15 11:10:00,20,33,-13
21530,21530,200,2022/4/15 11:20:00,21,46,-25
21531,21531,200,2022/4/15 11:30:00,22,41,-19
21532,21532,200,2022/4/15 11:40:00,21,32,-11
21533,21533,200,2022/4/15 11:50:00,23,47,-24
21534,21534,200,2022/4/15 12:00:00,21,47,-26
21535,21535,200,2022/4/15 12:10:00,24,25,-1
21536,21536,200,2022/4/15 12:20:00,24,45,-21
21537,21537,200,2022/4/15 12:30:00,20,42,-22
21538,21538,200,2022/4/15 12:40:00,25,31,-6
21539,21539,200,2022/4/15 12:50:00,21,45,-24
21540,21540,200,2022/4/15 13:00:00,22,41,-19
21541,21541,200,2022/4/15 13:10:00,20,28,-8
21542,21542,200,2022/4/15 13:20:00,20,41,-21
21543,21543,200,2022/4/15 13:30:00,15,44,-29
21544,21544,200,2022/4/15 13:40:00,17,29,-12
21545,21545,200,2022/4/15 13:50:00,16,41,-25
21546,21546,200,2022/4/15 14:00:00,15,38,-23
21547,21547,200,2022/4/15 14:10:00,16,31,-15
21548,21548,200,2022/4/15 14:20:00,18,42,-24
21549,21549,200,2022/4/15 14:30:00,15,40,-25
21550,21550,200,2022/4/15 14:40:00,14,23,-9
21551,21551,200,2022/4/15 14:50:00,18,47,-29
21552,21552,200,2022/4/15 15:00:00,16,46,-30
21553,21553,200,2022/4/15 15:10:00,17,35,-18
21554,21554,200,2022/4/15 15:20:00,20,44,-24
21555,21555,200,2022/4/15 15:30:00,23,44,-21
21556,21556,200,2022/4/15 15:40:00,21,31,-10
21557,21557,200,2022/4/15 15:50:00,25,51,-26
21558,21558,200,2022/4/15 16:00:00,68,61,7
21559,21559,200,2022/4/15 16:10:00,32,47,-15
21560,21560,200,2022/4/15 16:20:00,35,62,-27
21561,21561,200,2022/4/15 16:30:00,35,42,-7
21562,21562,200,2022/4/15 16:40:00,46,74,-28
21563,21563,200,2022/4/15 16:50:00,64,62,2
21564,21564,200,2022/4/15 17:00:00,45,68,-23
21565,21565,200,2022/4/15 17:10:00,47,73,-26
21566,21566,200,2022/4/15 17:20:00,37,73,-36
21567,21567,200,2022/4/15 17:30:00,53,76,-23
21568,21568,200,2022/4/15 17:40:00,42,80,-38
21569,21569,200,2022/4/15 17:50:00,26,81,-55
21570,21570,200,2022/4/15 18:00:00,29,92,-63
21571,21571,200,2022/4/15 18:10:00,29,95,-66
21572,21572,200,2022/4/15 18:20:00,24,95,-71
21573,21573,200,2022/4/15 18:30:00,20,80,-60
21574,21574,200,2022/4/15 18:40:00,17,91,-74
21575,21575,200,2022/4/15 18:50:00,13,93,-80
21576,21576,200,2022/4/15 19:00:00,17,78,-61
21577,21577,200,2022/4/15 19:10:00,13,99,-86
21578,21578,200,2022/4/15 19:20:00,13,81,-68
21579,21579,200,2022/4/15 19:30:00,12,76,-64
21580,21580,200,2022/4/15 19:40:00,8,77,-69
21581,21581,200,2022/4/15 19:50:00,9,75,-66
21582,21582,200,2022/4/15 20:00:00,9,73,-64
21583,21583,200,2022/4/15 20:10:00,11,67,-56
21584,21584,200,2022/4/15 20:20:00,8,67,-59
21585,21585,200,2022/4/15 20:30:00,13,55,-42
21586,21586,200,2022/4/15 20:40:00,7,59,-52
21587,21587,200,2022/4/15 20:50:00,4,64,-60
21588,21588,200,2022/4/15 21:00:00,12,64,-52
21589,21589,200,2022/4/15 21:10:00,7,63,-56
21590,21590,200,2022/4/15 21:20:00,5,50,-45
21591,21591,200,2022/4/15 21:30:00,4,62,-58
21592,21592,200,2022/4/15 21:40:00,4,64,-60
21593,21593,200,2022/4/15 21:50:00,2,39,-37
21594,21594,200,2022/4/15 22:00:00,0,51,-51
21595,21595,200,2022/4/15 22:10:00,0,63,-63
21596,21596,200,2022/4/15 22:20:00,0,47,-47
21597,21597,200,2022/4/15 22:30:00,0,52,-52
21598,21598,200,2022/4/15 22:40:00,0,39,-39
21599,21599,200,2022/4/15 22:50:00,0,49,-49
21600,21600,201,2022/4/15 5:00:00,0,1,-1
21601,21601,201,2022/4/15 5:10:00,0,1,-1
21602,21602,201,2022/4/15 5:20:00,0,1,-1
21603,21603,201,2022/4/15 5:30:00,0,1,-1
21604,21604,201,2022/4/15 5:40:00,1,1,0
21605,21605,201,2022/4/15 5:50:00,8,1,7
21606,21606,201,2022/4/15 6:00:00,5,1,4
21607,21607,201,2022/4/15 6:10:00,7,1,6
21608,21608,201,2022/4/15 6:20:00,8,23,-15
21609,21609,201,2022/4/15 6:30:00,14,35,-21
21610,21610,201,2022/4/15 6:40:00,17,21,-4
21611,21611,201,2022/4/15 6:50:00,14,38,-24
21612,21612,201,2022/4/15 7:00:00,20,41,-21
21613,21613,201,2022/4/15 7:10:00,27,76,-49
21614,21614,201,2022/4/15 7:20:00,29,76,-47
21615,21615,201,2022/4/15 7:30:00,30,111,-81
21616,21616,201,2022/4/15 7:40:00,26,115,-89
21617,21617,201,2022/4/15 7:50:00,26,108,-82
21618,21618,201,2022/4/15 8:00:00,24,120,-96
21619,21619,201,2022/4/15 8:10:00,17,150,-133
21620,21620,201,2022/4/15 8:20:00,15,109,-94
21621,21621,201,2022/4/15 8:30:00,13,106,-93
21622,21622,201,2022/4/15 8:40:00,17,104,-87
21623,21623,201,2022/4/15 8:50:00,10,103,-93
21624,21624,201,2022/4/15 9:00:00,6,93,-87
21625,21625,201,2022/4/15 9:10:00,5,74,-69
21626,21626,201,2022/4/15 9:20:00,5,70,-65
21627,21627,201,2022/4/15 9:30:00,5,77,-72
21628,21628,201,2022/4/15 9:40:00,6,51,-45
21629,21629,201,2022/4/15 9:50:00,9,42,-33
21630,21630,201,2022/4/15 10:00:00,7,45,-38
21631,21631,201,2022/4/15 10:10:00,9,38,-29
21632,21632,201,2022/4/15 10:20:00,8,23,-15
21633,21633,201,2022/4/15 10:30:00,9,37,-28
21634,21634,201,2022/4/15 10:40:00,10,31,-21
21635,21635,201,2022/4/15 10:50:00,10,19,-9
21636,21636,201,2022/4/15 11:00:00,9,25,-16
21637,21637,201,2022/4/15 11:10:00,13,31,-18
21638,21638,201,2022/4/15 11:20:00,9,23,-14
21639,21639,201,2022/4/15 11:30:00,11,23,-12
21640,21640,201,2022/4/15 11:40:00,13,23,-10
21641,21641,201,2022/4/15 11:50:00,16,21,-5
21642,21642,201,2022/4/15 12:00:00,14,24,-10
21643,21643,201,2022/4/15 12:10:00,14,32,-18
21644,21644,201,2022/4/15 12:20:00,15,21,-6
21645,21645,201,2022/4/15 12:30:00,15,25,-10
21646,21646,201,2022/4/15 12:40:00,15,29,-14
21647,21647,201,2022/4/15 12:50:00,11,21,-10
21648,21648,201,2022/4/15 13:00:00,13,32,-19
21649,21649,201,2022/4/15 13:10:00,11,28,-17
21650,21650,201,2022/4/15 13:20:00,10,21,-11
21651,21651,201,2022/4/15 13:30:00,13,23,-10
21652,21652,201,2022/4/15 13:40:00,13,33,-20
21653,21653,201,2022/4/15 13:50:00,11,23,-12
21654,21654,201,2022/4/15 14:00:00,13,23,-10
21655,21655,201,2022/4/15 14:10:00,13,30,-17
21656,21656,201,2022/4/15 14:20:00,10,13,-3
21657,21657,201,2022/4/15 14:30:00,13,23,-10
21658,21658,201,2022/4/15 14:40:00,15,23,-8
21659,21659,201,2022/4/15 14:50:00,12,19,-7
21660,21660,201,2022/4/15 15:00:00,14,23,-9
21661,21661,201,2022/4/15 15:10:00,17,21,-4
21662,21662,201,2022/4/15 15:20:00,14,15,-1
21663,21663,201,2022/4/15 15:30:00,16,21,-5
21664,21664,201,2022/4/15 15:40:00,14,23,-9
21665,21665,201,2022/4/15 15:50:00,19,14,5
21666,21666,201,2022/4/15 16:00:00,26,23,3
21667,21667,201,2022/4/15 16:10:00,33,21,12
21668,21668,201,2022/4/15 16:20:00,22,14,8
21669,21669,201,2022/4/15 16:30:00,45,21,24
21670,21670,201,2022/4/15 16:40:00,46,23,23
21671,21671,201,2022/4/15 16:50:00,49,23,26
21672,21672,201,2022/4/15 17:00:00,141,19,122
21673,21673,201,2022/4/15 17:10:00,174,23,151
21674,21674,201,2022/4/15 17:20:00,198,23,175
21675,21675,201,2022/4/15 17:30:00,69,29,40
21676,21676,201,2022/4/15 17:40:00,43,23,20
21677,21677,201,2022/4/15 17:50:00,31,33,-2
21678,21678,201,2022/4/15 18:00:00,26,27,-1
21679,21679,201,2022/4/15 18:10:00,22,38,-16
21680,21680,201,2022/4/15 18:20:00,20,36,-16
21681,21681,201,2022/4/15 18:30:00,20,33,-13
21682,21682,201,2022/4/15 18:40:00,18,32,-14
21683,21683,201,2022/4/15 18:50:00,14,31,-17
21684,21684,201,2022/4/15 19:00:00,15,33,-18
21685,21685,201,2022/4/15 19:10:00,15,45,-30
21686,21686,201,2022/4/15 19:20:00,14,33,-19
21687,21687,201,2022/4/15 19:30:00,12,33,-21
21688,21688,201,2022/4/15 19:40:00,12,33,-21
21689,21689,201,2022/4/15 19:50:00,11,31,-20
21690,21690,201,2022/4/15 20:00:00,18,32,-14
21691,21691,201,2022/4/15 20:10:00,25,22,3
21692,21692,201,2022/4/15 20:20:00,10,21,-11
21693,21693,201,2022/4/15 20:30:00,7,23,-16
21694,21694,201,2022/4/15 20:40:00,6,21,-15
21695,21695,201,2022/4/15 20:50:00,7,23,-16
21696,21696,201,2022/4/15 21:00:00,11,10,1
21697,21697,201,2022/4/15 21:10:00,6,23,-17
21698,21698,201,2022/4/15 21:20:00,3,22,-19
21699,21699,201,2022/4/15 21:30:00,2,15,-13
21700,21700,201,2022/4/15 21:40:00,1,23,-22
21701,21701,201,2022/4/15 21:50:00,1,23,-22
21702,21702,201,2022/4/15 22:00:00,1,13,-12
21703,21703,201,2022/4/15 22:10:00,0,19,-19
21704,21704,201,2022/4/15 22:20:00,0,25,-25
21705,21705,201,2022/4/15 22:30:00,0,18,-18
21706,21706,201,2022/4/15 22:40:00,0,23,-23
21707,21707,201,2022/4/15 22:50:00,0,7,-7
21708,21708,202,2022/4/15 5:00:00,0,1,-1
21709,21709,202,2022/4/15 5:10:00,0,1,-1
21710,21710,202,2022/4/15 5:20:00,0,1,-1
21711,21711,202,2022/4/15 5:30:00,0,1,-1
21712,21712,202,2022/4/15 5:40:00,0,1,-1
21713,21713,202,2022/4/15 5:50:00,4,1,3
21714,21714,202,2022/4/15 6:00:00,4,1,3
21715,21715,202,2022/4/15 6:10:00,18,6,12
21716,21716,202,2022/4/15 6:20:00,32,21,11
21717,21717,202,2022/4/15 6:30:00,41,21,20
21718,21718,202,2022/4/15 6:40:00,56,23,33
21719,21719,202,2022/4/15 6:50:00,59,45,14
21720,21720,202,2022/4/15 7:00:00,56,62,-6
21721,21721,202,2022/4/15 7:10:00,91,85,6
21722,21722,202,2022/4/15 7:20:00,156,93,63
21723,21723,202,2022/4/15 7:30:00,163,108,55
21724,21724,202,2022/4/15 7:40:00,217,126,91
21725,21725,202,2022/4/15 7:50:00,189,139,50
21726,21726,202,2022/4/15 8:00:00,205,267,-62
21727,21727,202,2022/4/15 8:10:00,183,332,-149
21728,21728,202,2022/4/15 8:20:00,145,268,-123
21729,21729,202,2022/4/15 8:30:00,83,197,-114
21730,21730,202,2022/4/15 8:40:00,75,268,-193
21731,21731,202,2022/4/15 8:50:00,53,116,-63
21732,21732,202,2022/4/15 9:00:00,39,76,-37
21733,21733,202,2022/4/15 9:10:00,35,105,-70
21734,21734,202,2022/4/15 9:20:00,29,84,-55
21735,21735,202,2022/4/15 9:30:00,28,81,-53
21736,21736,202,2022/4/15 9:40:00,28,76,-48
21737,21737,202,2022/4/15 9:50:00,26,67,-41
21738,21738,202,2022/4/15 10:00:00,23,63,-40
21739,21739,202,2022/4/15 10:10:00,26,69,-43
21740,21740,202,2022/4/15 10:20:00,23,36,-13
21741,21741,202,2022/4/15 10:30:00,24,67,-43
21742,21742,202,2022/4/15 10:40:00,25,48,-23
21743,21743,202,2022/4/15 10:50:00,23,41,-18
21744,21744,202,2022/4/15 11:00:00,24,55,-31
21745,21745,202,2022/4/15 11:10:00,24,45,-21
21746,21746,202,2022/4/15 11:20:00,28,32,-4
21747,21747,202,2022/4/15 11:30:00,28,45,-17
21748,21748,202,2022/4/15 11:40:00,25,43,-18
21749,21749,202,2022/4/15 11:50:00,26,38,-12
21750,21750,202,2022/4/15 12:00:00,27,48,-21
21751,21751,202,2022/4/15 12:10:00,26,45,-19
21752,21752,202,2022/4/15 12:20:00,21,38,-17
21753,21753,202,2022/4/15 12:30:00,27,61,-34
21754,21754,202,2022/4/15 12:40:00,21,49,-28
21755,21755,202,2022/4/15 12:50:00,22,42,-20
21756,21756,202,2022/4/15 13:00:00,20,65,-45
21757,21757,202,2022/4/15 13:10:00,21,49,-28
21758,21758,202,2022/4/15 13:20:00,22,38,-16
21759,21759,202,2022/4/15 13:30:00,18,64,-46
21760,21760,202,2022/4/15 13:40:00,18,51,-33
21761,21761,202,2022/4/15 13:50:00,20,45,-25
21762,21762,202,2022/4/15 14:00:00,23,64,-41
21763,21763,202,2022/4/15 14:10:00,20,54,-34
21764,21764,202,2022/4/15 14:20:00,20,37,-17
21765,21765,202,2022/4/15 14:30:00,20,52,-32
21766,21766,202,2022/4/15 14:40:00,23,49,-26
21767,21767,202,2022/4/15 14:50:00,22,37,-15
21768,21768,202,2022/4/15 15:00:00,22,51,-29
21769,21769,202,2022/4/15 15:10:00,21,50,-29
21770,21770,202,2022/4/15 15:20:00,25,41,-16
21771,21771,202,2022/4/15 15:30:00,21,57,-36
21772,21772,202,2022/4/15 15:40:00,24,67,-43
21773,21773,202,2022/4/15 15:50:00,26,45,-19
21774,21774,202,2022/4/15 16:00:00,27,61,-34
21775,21775,202,2022/4/15 16:10:00,25,69,-44
21776,21776,202,2022/4/15 16:20:00,29,63,-34
21777,21777,202,2022/4/15 16:30:00,33,70,-37
21778,21778,202,2022/4/15 16:40:00,58,62,-4
21779,21779,202,2022/4/15 16:50:00,88,71,17
21780,21780,202,2022/4/15 17:00:00,132,76,56
21781,21781,202,2022/4/15 17:10:00,175,75,100
21782,21782,202,2022/4/15 17:20:00,175,87,88
21783,21783,202,2022/4/15 17:30:00,175,103,72
21784,21784,202,2022/4/15 17:40:00,227,105,122
21785,21785,202,2022/4/15 17:50:00,206,105,101
21786,21786,202,2022/4/15 18:00:00,129,110,19
21787,21787,202,2022/4/15 18:10:00,174,101,73
21788,21788,202,2022/4/15 18:20:00,72,110,-38
21789,21789,202,2022/4/15 18:30:00,46,107,-61
21790,21790,202,2022/4/15 18:40:00,30,89,-59
21791,21791,202,2022/4/15 18:50:00,33,109,-76
21792,21792,202,2022/4/15 19:00:00,28,106,-78
21793,21793,202,2022/4/15 19:10:00,28,105,-77
21794,21794,202,2022/4/15 19:20:00,23,111,-88
21795,21795,202,2022/4/15 19:30:00,22,95,-73
21796,21796,202,2022/4/15 19:40:00,17,77,-60
21797,21797,202,2022/4/15 19:50:00,17,71,-54
21798,21798,202,2022/4/15 20:00:00,15,74,-59
21799,21799,202,2022/4/15 20:10:00,21,63,-42
21800,21800,202,2022/4/15 20:20:00,20,62,-42
21801,21801,202,2022/4/15 20:30:00,18,66,-48
21802,21802,202,2022/4/15 20:40:00,17,53,-36
21803,21803,202,2022/4/15 20:50:00,14,64,-50
21804,21804,202,2022/4/15 21:00:00,11,48,-37
21805,21805,202,2022/4/15 21:10:00,15,61,-46
21806,21806,202,2022/4/15 21:20:00,13,65,-52
21807,21807,202,2022/4/15 21:30:00,13,45,-32
21808,21808,202,2022/4/15 21:40:00,10,48,-38
21809,21809,202,2022/4/15 21:50:00,7,47,-40
21810,21810,202,2022/4/15 22:00:00,9,40,-31
21811,21811,202,2022/4/15 22:10:00,4,51,-47
21812,21812,202,2022/4/15 22:20:00,2,40,-38
21813,21813,202,2022/4/15 22:30:00,0,40,-40
21814,21814,202,2022/4/15 22:40:00,0,3,-3
21815,21815,202,2022/4/15 22:50:00,0,3,-3
21816,21816,203,2022/4/15 5:00:00,0,1,-1
21817,21817,203,2022/4/15 5:10:00,0,1,-1
21818,21818,203,2022/4/15 5:20:00,0,1,-1
21819,21819,203,2022/4/15 5:30:00,0,1,-1
21820,21820,203,2022/4/15 5:40:00,0,1,-1
21821,21821,203,2022/4/15 5:50:00,9,1,8
21822,21822,203,2022/4/15 6:00:00,26,1,25
21823,21823,203,2022/4/15 6:10:00,47,32,15
21824,21824,203,2022/4/15 6:20:00,62,41,21
21825,21825,203,2022/4/15 6:30:00,147,53,94
21826,21826,203,2022/4/15 6:40:00,199,64,135
21827,21827,203,2022/4/15 6:50:00,253,87,166
21828,21828,203,2022/4/15 7:00:00,279,116,163
21829,21829,203,2022/4/15 7:10:00,349,178,171
21830,21830,203,2022/4/15 7:20:00,576,267,309
21831,21831,203,2022/4/15 7:30:00,598,332,266
21832,21832,203,2022/4/15 7:40:00,598,333,265
21833,21833,203,2022/4/15 7:50:00,390,196,194
21834,21834,203,2022/4/15 8:00:00,436,318,118
21835,21835,203,2022/4/15 8:10:00,357,195,162
21836,21836,203,2022/4/15 8:20:00,330,216,114
21837,21837,203,2022/4/15 8:30:00,280,318,-38
21838,21838,203,2022/4/15 8:40:00,215,207,8
21839,21839,203,2022/4/15 8:50:00,174,107,67
21840,21840,203,2022/4/15 9:00:00,100,105,-5
21841,21841,203,2022/4/15 9:10:00,74,108,-34
21842,21842,203,2022/4/15 9:20:00,62,108,-46
21843,21843,203,2022/4/15 9:30:00,47,97,-50
21844,21844,203,2022/4/15 9:40:00,44,72,-28
21845,21845,203,2022/4/15 9:50:00,36,93,-57
21846,21846,203,2022/4/15 10:00:00,35,73,-38
21847,21847,203,2022/4/15 10:10:00,35,70,-35
21848,21848,203,2022/4/15 10:20:00,35,77,-42
21849,21849,203,2022/4/15 10:30:00,37,68,-31
21850,21850,203,2022/4/15 10:40:00,32,66,-34
21851,21851,203,2022/4/15 10:50:00,30,76,-46
21852,21852,203,2022/4/15 11:00:00,30,66,-36
21853,21853,203,2022/4/15 11:10:00,36,66,-30
21854,21854,203,2022/4/15 11:20:00,33,72,-39
21855,21855,203,2022/4/15 11:30:00,30,69,-39
21856,21856,203,2022/4/15 11:40:00,35,68,-33
21857,21857,203,2022/4/15 11:50:00,34,75,-41
21858,21858,203,2022/4/15 12:00:00,36,67,-31
21859,21859,203,2022/4/15 12:10:00,33,64,-31
21860,21860,203,2022/4/15 12:20:00,38,84,-46
21861,21861,203,2022/4/15 12:30:00,32,73,-41
21862,21862,203,2022/4/15 12:40:00,35,70,-35
21863,21863,203,2022/4/15 12:50:00,31,82,-51
21864,21864,203,2022/4/15 13:00:00,28,68,-40
21865,21865,203,2022/4/15 13:10:00,33,60,-27
21866,21866,203,2022/4/15 13:20:00,33,87,-54
21867,21867,203,2022/4/15 13:30:00,29,74,-45
21868,21868,203,2022/4/15 13:40:00,32,67,-35
21869,21869,203,2022/4/15 13:50:00,26,85,-59
21870,21870,203,2022/4/15 14:00:00,35,84,-49
21871,21871,203,2022/4/15 14:10:00,28,63,-35
21872,21872,203,2022/4/15 14:20:00,29,83,-54
21873,21873,203,2022/4/15 14:30:00,32,82,-50
21874,21874,203,2022/4/15 14:40:00,32,67,-35
21875,21875,203,2022/4/15 14:50:00,27,91,-64
21876,21876,203,2022/4/15 15:00:00,31,77,-46
21877,21877,203,2022/4/15 15:10:00,28,67,-39
21878,21878,203,2022/4/15 15:20:00,35,93,-58
21879,21879,203,2022/4/15 15:30:00,35,79,-44
21880,21880,203,2022/4/15 15:40:00,35,84,-49
21881,21881,203,2022/4/15 15:50:00,34,106,-72
21882,21882,203,2022/4/15 16:00:00,43,96,-53
21883,21883,203,2022/4/15 16:10:00,61,87,-26
21884,21884,203,2022/4/15 16:20:00,45,108,-63
21885,21885,203,2022/4/15 16:30:00,93,105,-12
21886,21886,203,2022/4/15 16:40:00,316,108,208
21887,21887,203,2022/4/15 16:50:00,334,102,232
21888,21888,203,2022/4/15 17:00:00,165,125,40
21889,21889,203,2022/4/15 17:10:00,274,122,152
21890,21890,203,2022/4/15 17:20:00,234,118,116
21891,21891,203,2022/4/15 17:30:00,198,127,71
21892,21892,203,2022/4/15 17:40:00,268,149,119
21893,21893,203,2022/4/15 17:50:00,276,190,86
21894,21894,203,2022/4/15 18:00:00,208,178,30
21895,21895,203,2022/4/15 18:10:00,105,198,-93
21896,21896,203,2022/4/15 18:20:00,76,214,-138
21897,21897,203,2022/4/15 18:30:00,50,223,-173
21898,21898,203,2022/4/15 18:40:00,48,215,-167
21899,21899,203,2022/4/15 18:50:00,40,228,-188
21900,21900,203,2022/4/15 19:00:00,29,223,-194
21901,21901,203,2022/4/15 19:10:00,35,178,-143
21902,21902,203,2022/4/15 19:20:00,30,192,-162
21903,21903,203,2022/4/15 19:30:00,25,109,-84
21904,21904,203,2022/4/15 19:40:00,35,121,-86
21905,21905,203,2022/4/15 19:50:00,24,125,-101
21906,21906,203,2022/4/15 20:00:00,26,102,-76
21907,21907,203,2022/4/15 20:10:00,27,106,-79
21908,21908,203,2022/4/15 20:20:00,25,107,-82
21909,21909,203,2022/4/15 20:30:00,25,98,-73
21910,21910,203,2022/4/15 20:40:00,27,94,-67
21911,21911,203,2022/4/15 20:50:00,20,92,-72
21912,21912,203,2022/4/15 21:00:00,23,106,-83
21913,21913,203,2022/4/15 21:10:00,23,103,-80
21914,21914,203,2022/4/15 21:20:00,17,75,-58
21915,21915,203,2022/4/15 21:30:00,19,100,-81
21916,21916,203,2022/4/15 21:40:00,18,91,-73
21917,21917,203,2022/4/15 21:50:00,11,71,-60
21918,21918,203,2022/4/15 22:00:00,10,110,-100
21919,21919,203,2022/4/15 22:10:00,6,79,-73
21920,21920,203,2022/4/15 22:20:00,4,84,-80
21921,21921,203,2022/4/15 22:30:00,1,77,-76
21922,21922,203,2022/4/15 22:40:00,0,10,-10
21923,21923,203,2022/4/15 22:50:00,0,3,-3
21924,21924,204,2022/4/15 5:00:00,0,1,-1
21925,21925,204,2022/4/15 5:10:00,0,1,-1
21926,21926,204,2022/4/15 5:20:00,0,1,-1
21927,21927,204,2022/4/15 5:30:00,0,1,-1
21928,21928,204,2022/4/15 5:40:00,7,1,6
21929,21929,204,2022/4/15 5:50:00,16,1,15
21930,21930,204,2022/4/15 6:00:00,19,16,3
21931,21931,204,2022/4/15 6:10:00,24,19,5
21932,21932,204,2022/4/15 6:20:00,29,25,4
21933,21933,204,2022/4/15 6:30:00,38,46,-8
21934,21934,204,2022/4/15 6:40:00,45,74,-29
21935,21935,204,2022/4/15 6:50:00,55,76,-21
21936,21936,204,2022/4/15 7:00:00,57,93,-36
21937,21937,204,2022/4/15 7:10:00,62,99,-37
21938,21938,204,2022/4/15 7:20:00,83,83,0
21939,21939,204,2022/4/15 7:30:00,180,112,68
21940,21940,204,2022/4/15 7:40:00,224,105,119
21941,21941,204,2022/4/15 7:50:00,226,90,136
21942,21942,204,2022/4/15 8:00:00,205,93,112
21943,21943,204,2022/4/15 8:10:00,188,97,91
21944,21944,204,2022/4/15 8:20:00,150,104,46
21945,21945,204,2022/4/15 8:30:00,90,92,-2
21946,21946,204,2022/4/15 8:40:00,78,113,-35
21947,21947,204,2022/4/15 8:50:00,66,93,-27
21948,21948,204,2022/4/15 9:00:00,50,77,-27
21949,21949,204,2022/4/15 9:10:00,48,77,-29
21950,21950,204,2022/4/15 9:20:00,38,61,-23
21951,21951,204,2022/4/15 9:30:00,39,69,-30
21952,21952,204,2022/4/15 9:40:00,28,65,-37
21953,21953,204,2022/4/15 9:50:00,31,69,-38
21954,21954,204,2022/4/15 10:00:00,25,68,-43
21955,21955,204,2022/4/15 10:10:00,30,65,-35
21956,21956,204,2022/4/15 10:20:00,32,58,-26
21957,21957,204,2022/4/15 10:30:00,26,67,-41
21958,21958,204,2022/4/15 10:40:00,25,64,-39
21959,21959,204,2022/4/15 10:50:00,27,60,-33
21960,21960,204,2022/4/15 11:00:00,25,52,-27
21961,21961,204,2022/4/15 11:10:00,28,57,-29
21962,21962,204,2022/4/15 11:20:00,28,51,-23
21963,21963,204,2022/4/15 11:30:00,26,64,-38
21964,21964,204,2022/4/15 11:40:00,25,48,-23
21965,21965,204,2022/4/15 11:50:00,25,48,-23
21966,21966,204,2022/4/15 12:00:00,24,47,-23
21967,21967,204,2022/4/15 12:10:00,28,54,-26
21968,21968,204,2022/4/15 12:20:00,27,62,-35
21969,21969,204,2022/4/15 12:30:00,29,57,-28
21970,21970,204,2022/4/15 12:40:00,24,62,-38
21971,21971,204,2022/4/15 12:50:00,27,62,-35
21972,21972,204,2022/4/15 13:00:00,28,66,-38
21973,21973,204,2022/4/15 13:10:00,29,61,-32
21974,21974,204,2022/4/15 13:20:00,27,63,-36
21975,21975,204,2022/4/15 13:30:00,27,60,-33
21976,21976,204,2022/4/15 13:40:00,26,73,-47
21977,21977,204,2022/4/15 13:50:00,26,72,-46
21978,21978,204,2022/4/15 14:00:00,27,64,-37
21979,21979,204,2022/4/15 14:10:00,26,57,-31
21980,21980,204,2022/4/15 14:20:00,27,57,-30
21981,21981,204,2022/4/15 14:30:00,26,71,-45
21982,21982,204,2022/4/15 14:40:00,24,69,-45
21983,21983,204,2022/4/15 14:50:00,28,74,-46
21984,21984,204,2022/4/15 15:00:00,23,59,-36
21985,21985,204,2022/4/15 15:10:00,30,74,-44
21986,21986,204,2022/4/15 15:20:00,32,72,-40
21987,21987,204,2022/4/15 15:30:00,26,72,-46
21988,21988,204,2022/4/15 15:40:00,33,73,-40
21989,21989,204,2022/4/15 15:50:00,26,69,-43
21990,21990,204,2022/4/15 16:00:00,31,77,-46
21991,21991,204,2022/4/15 16:10:00,28,64,-36
21992,21992,204,2022/4/15 16:20:00,29,72,-43
21993,21993,204,2022/4/15 16:30:00,38,82,-44
21994,21994,204,2022/4/15 16:40:00,77,80,-3
21995,21995,204,2022/4/15 16:50:00,65,93,-28
21996,21996,204,2022/4/15 17:00:00,108,92,16
21997,21997,204,2022/4/15 17:10:00,63,100,-37
21998,21998,204,2022/4/15 17:20:00,49,121,-72
21999,21999,204,2022/4/15 17:30:00,43,123,-80
22000,22000,204,2022/4/15 17:40:00,41,114,-73
22001,22001,204,2022/4/15 17:50:00,31,119,-88
22002,22002,204,2022/4/15 18:00:00,33,106,-73
22003,22003,204,2022/4/15 18:10:00,30,115,-85
22004,22004,204,2022/4/15 18:20:00,31,111,-80
22005,22005,204,2022/4/15 18:30:00,24,110,-86
22006,22006,204,2022/4/15 18:40:00,26,123,-97
22007,22007,204,2022/4/15 18:50:00,24,124,-100
22008,22008,204,2022/4/15 19:00:00,21,125,-104
22009,22009,204,2022/4/15 19:10:00,21,106,-85
22010,22010,204,2022/4/15 19:20:00,20,113,-93
22011,22011,204,2022/4/15 19:30:00,22,92,-70
22012,22012,204,2022/4/15 19:40:00,18,80,-62
22013,22013,204,2022/4/15 19:50:00,15,79,-64
22014,22014,204,2022/4/15 20:00:00,18,63,-45
22015,22015,204,2022/4/15 20:10:00,23,72,-49
22016,22016,204,2022/4/15 20:20:00,19,73,-54
22017,22017,204,2022/4/15 20:30:00,15,69,-54
22018,22018,204,2022/4/15 20:40:00,19,71,-52
22019,22019,204,2022/4/15 20:50:00,14,76,-62
22020,22020,204,2022/4/15 21:00:00,16,72,-56
22021,22021,204,2022/4/15 21:10:00,18,70,-52
22022,22022,204,2022/4/15 21:20:00,12,67,-55
22023,22023,204,2022/4/15 21:30:00,11,73,-62
22024,22024,204,2022/4/15 21:40:00,12,66,-54
22025,22025,204,2022/4/15 21:50:00,10,70,-60
22026,22026,204,2022/4/15 22:00:00,9,60,-51
22027,22027,204,2022/4/15 22:10:00,8,68,-60
22028,22028,204,2022/4/15 22:20:00,5,51,-46
22029,22029,204,2022/4/15 22:30:00,3,59,-56
22030,22030,204,2022/4/15 22:40:00,2,51,-49
22031,22031,204,2022/4/15 22:50:00,2,38,-36
22032,22032,205,2022/4/15 5:00:00,0,1,-1
22033,22033,205,2022/4/15 5:10:00,0,1,-1
22034,22034,205,2022/4/15 5:20:00,1,1,0
22035,22035,205,2022/4/15 5:30:00,11,1,10
22036,22036,205,2022/4/15 5:40:00,31,1,30
22037,22037,205,2022/4/15 5:50:00,32,1,31
22038,22038,205,2022/4/15 6:00:00,54,2,52
22039,22039,205,2022/4/15 6:10:00,59,14,45
22040,22040,205,2022/4/15 6:20:00,89,19,70
22041,22041,205,2022/4/15 6:30:00,189,40,149
22042,22042,205,2022/4/15 6:40:00,243,50,193
22043,22043,205,2022/4/15 6:50:00,266,62,204
22044,22044,205,2022/4/15 7:00:00,301,72,229
22045,22045,205,2022/4/15 7:10:00,436,69,367
22046,22046,205,2022/4/15 7:20:00,655,79,576
22047,22047,205,2022/4/15 7:30:00,867,93,774
22048,22048,205,2022/4/15 7:40:00,1170,83,1087
22049,22049,205,2022/4/15 7:50:00,1216,75,1141
22050,22050,205,2022/4/15 8:00:00,1227,99,1128
22051,22051,205,2022/4/15 8:10:00,1051,73,978
22052,22052,205,2022/4/15 8:20:00,702,93,609
22053,22053,205,2022/4/15 8:30:00,596,98,498
22054,22054,205,2022/4/15 8:40:00,374,77,297
22055,22055,205,2022/4/15 8:50:00,280,81,199
22056,22056,205,2022/4/15 9:00:00,231,62,169
22057,22057,205,2022/4/15 9:10:00,182,66,116
22058,22058,205,2022/4/15 9:20:00,90,69,21
22059,22059,205,2022/4/15 9:30:00,71,66,5
22060,22060,205,2022/4/15 9:40:00,51,60,-9
22061,22061,205,2022/4/15 9:50:00,46,47,-1
22062,22062,205,2022/4/15 10:00:00,36,66,-30
22063,22063,205,2022/4/15 10:10:00,33,54,-21
22064,22064,205,2022/4/15 10:20:00,31,54,-23
22065,22065,205,2022/4/15 10:30:00,32,54,-22
22066,22066,205,2022/4/15 10:40:00,31,52,-21
22067,22067,205,2022/4/15 10:50:00,30,64,-34
22068,22068,205,2022/4/15 11:00:00,26,57,-31
22069,22069,205,2022/4/15 11:10:00,32,54,-22
22070,22070,205,2022/4/15 11:20:00,27,57,-30
22071,22071,205,2022/4/15 11:30:00,28,66,-38
22072,22072,205,2022/4/15 11:40:00,28,71,-43
22073,22073,205,2022/4/15 11:50:00,29,65,-36
22074,22074,205,2022/4/15 12:00:00,31,59,-28
22075,22075,205,2022/4/15 12:10:00,30,62,-32
22076,22076,205,2022/4/15 12:20:00,31,71,-40
22077,22077,205,2022/4/15 12:30:00,29,70,-41
22078,22078,205,2022/4/15 12:40:00,30,62,-32
22079,22079,205,2022/4/15 12:50:00,28,66,-38
22080,22080,205,2022/4/15 13:00:00,33,67,-34
22081,22081,205,2022/4/15 13:10:00,29,63,-34
22082,22082,205,2022/4/15 13:20:00,26,71,-45
22083,22083,205,2022/4/15 13:30:00,26,58,-32
22084,22084,205,2022/4/15 13:40:00,29,69,-40
22085,22085,205,2022/4/15 13:50:00,25,65,-40
22086,22086,205,2022/4/15 14:00:00,29,70,-41
22087,22087,205,2022/4/15 14:10:00,25,70,-45
22088,22088,205,2022/4/15 14:20:00,28,71,-43
22089,22089,205,2022/4/15 14:30:00,27,77,-50
22090,22090,205,2022/4/15 14:40:00,24,76,-52
22091,22091,205,2022/4/15 14:50:00,21,76,-55
22092,22092,205,2022/4/15 15:00:00,27,74,-47
22093,22093,205,2022/4/15 15:10:00,25,78,-53
22094,22094,205,2022/4/15 15:20:00,23,93,-70
22095,22095,205,2022/4/15 15:30:00,24,97,-73
22096,22096,205,2022/4/15 15:40:00,27,92,-65
22097,22097,205,2022/4/15 15:50:00,24,90,-66
22098,22098,205,2022/4/15 16:00:00,29,102,-73
22099,22099,205,2022/4/15 16:10:00,33,112,-79
22100,22100,205,2022/4/15 16:20:00,29,104,-75
22101,22101,205,2022/4/15 16:30:00,37,112,-75
22102,22102,205,2022/4/15 16:40:00,33,122,-89
22103,22103,205,2022/4/15 16:50:00,28,110,-82
22104,22104,205,2022/4/15 17:00:00,43,116,-73
22105,22105,205,2022/4/15 17:10:00,42,127,-85
22106,22106,205,2022/4/15 17:20:00,43,212,-169
22107,22107,205,2022/4/15 17:30:00,42,196,-154
22108,22108,205,2022/4/15 17:40:00,46,268,-222
22109,22109,205,2022/4/15 17:50:00,51,333,-282
22110,22110,205,2022/4/15 18:00:00,45,381,-336
22111,22111,205,2022/4/15 18:10:00,43,385,-342
22112,22112,205,2022/4/15 18:20:00,39,510,-471
22113,22113,205,2022/4/15 18:30:00,30,382,-352
22114,22114,205,2022/4/15 18:40:00,29,373,-344
22115,22115,205,2022/4/15 18:50:00,32,535,-503
22116,22116,205,2022/4/15 19:00:00,24,350,-326
22117,22117,205,2022/4/15 19:10:00,26,269,-243
22118,22118,205,2022/4/15 19:20:00,25,234,-209
22119,22119,205,2022/4/15 19:30:00,21,145,-124
22120,22120,205,2022/4/15 19:40:00,23,117,-94
22121,22121,205,2022/4/15 19:50:00,20,104,-84
22122,22122,205,2022/4/15 20:00:00,25,125,-100
22123,22123,205,2022/4/15 20:10:00,20,123,-103
22124,22124,205,2022/4/15 20:20:00,18,110,-92
22125,22125,205,2022/4/15 20:30:00,20,89,-69
22126,22126,205,2022/4/15 20:40:00,20,105,-85
22127,22127,205,2022/4/15 20:50:00,18,103,-85
22128,22128,205,2022/4/15 21:00:00,22,107,-85
22129,22129,205,2022/4/15 21:10:00,17,107,-90
22130,22130,205,2022/4/15 21:20:00,18,112,-94
22131,22131,205,2022/4/15 21:30:00,12,107,-95
22132,22132,205,2022/4/15 21:40:00,11,110,-99
22133,22133,205,2022/4/15 21:50:00,12,112,-100
22134,22134,205,2022/4/15 22:00:00,8,113,-105
22135,22135,205,2022/4/15 22:10:00,9,93,-84
22136,22136,205,2022/4/15 22:20:00,5,104,-99
22137,22137,205,2022/4/15 22:30:00,3,98,-95
22138,22138,205,2022/4/15 22:40:00,4,76,-72
22139,22139,205,2022/4/15 22:50:00,0,85,-85
22140,22140,206,2022/4/15 5:00:00,0,1,-1
22141,22141,206,2022/4/15 5:10:00,0,1,-1
22142,22142,206,2022/4/15 5:20:00,0,1,-1
22143,22143,206,2022/4/15 5:30:00,2,1,1
22144,22144,206,2022/4/15 5:40:00,16,1,15
22145,22145,206,2022/4/15 5:50:00,28,6,22
22146,22146,206,2022/4/15 6:00:00,33,13,20
22147,22147,206,2022/4/15 6:10:00,45,19,26
22148,22148,206,2022/4/15 6:20:00,45,23,22
22149,22149,206,2022/4/15 6:30:00,82,46,36
22150,22150,206,2022/4/15 6:40:00,115,74,41
22151,22151,206,2022/4/15 6:50:00,156,75,81
22152,22152,206,2022/4/15 7:00:00,192,93,99
22153,22153,206,2022/4/15 7:10:00,245,113,132
22154,22154,206,2022/4/15 7:20:00,281,96,185
22155,22155,206,2022/4/15 7:30:00,384,106,278
22156,22156,206,2022/4/15 7:40:00,721,90,631
22157,22157,206,2022/4/15 7:50:00,630,100,530
22158,22158,206,2022/4/15 8:00:00,589,111,478
22159,22159,206,2022/4/15 8:10:00,442,96,346
22160,22160,206,2022/4/15 8:20:00,361,102,259
22161,22161,206,2022/4/15 8:30:00,275,107,168
22162,22162,206,2022/4/15 8:40:00,266,104,162
22163,22163,206,2022/4/15 8:50:00,227,133,94
22164,22164,206,2022/4/15 9:00:00,193,109,84
22165,22165,206,2022/4/15 9:10:00,149,103,46
22166,22166,206,2022/4/15 9:20:00,93,93,0
22167,22167,206,2022/4/15 9:30:00,65,76,-11
22168,22168,206,2022/4/15 9:40:00,54,88,-34
22169,22169,206,2022/4/15 9:50:00,45,92,-47
22170,22170,206,2022/4/15 10:00:00,46,73,-27
22171,22171,206,2022/4/15 10:10:00,40,70,-30
22172,22172,206,2022/4/15 10:20:00,37,72,-35
22173,22173,206,2022/4/15 10:30:00,41,74,-33
22174,22174,206,2022/4/15 10:40:00,35,72,-37
22175,22175,206,2022/4/15 10:50:00,37,60,-23
22176,22176,206,2022/4/15 11:00:00,37,62,-25
22177,22177,206,2022/4/15 11:10:00,39,69,-30
22178,22178,206,2022/4/15 11:20:00,38,66,-28
22179,22179,206,2022/4/15 11:30:00,37,66,-29
22180,22180,206,2022/4/15 11:40:00,33,66,-33
22181,22181,206,2022/4/15 11:50:00,34,68,-34
22182,22182,206,2022/4/15 12:00:00,37,66,-29
22183,22183,206,2022/4/15 12:10:00,35,65,-30
22184,22184,206,2022/4/15 12:20:00,33,76,-43
22185,22185,206,2022/4/15 12:30:00,36,69,-33
22186,22186,206,2022/4/15 12:40:00,32,87,-55
22187,22187,206,2022/4/15 12:50:00,32,95,-63
22188,22188,206,2022/4/15 13:00:00,33,90,-57
22189,22189,206,2022/4/15 13:10:00,27,73,-46
22190,22190,206,2022/4/15 13:20:00,30,78,-48
22191,22191,206,2022/4/15 13:30:00,35,75,-40
22192,22192,206,2022/4/15 13:40:00,37,76,-39
22193,22193,206,2022/4/15 13:50:00,31,74,-43
22194,22194,206,2022/4/15 14:00:00,36,76,-40
22195,22195,206,2022/4/15 14:10:00,35,77,-42
22196,22196,206,2022/4/15 14:20:00,37,83,-46
22197,22197,206,2022/4/15 14:30:00,37,80,-43
22198,22198,206,2022/4/15 14:40:00,35,77,-42
22199,22199,206,2022/4/15 14:50:00,33,76,-43
22200,22200,206,2022/4/15 15:00:00,40,76,-36
22201,22201,206,2022/4/15 15:10:00,31,83,-52
22202,22202,206,2022/4/15 15:20:00,40,74,-34
22203,22203,206,2022/4/15 15:30:00,43,75,-32
22204,22204,206,2022/4/15 15:40:00,44,97,-53
22205,22205,206,2022/4/15 15:50:00,48,109,-61
22206,22206,206,2022/4/15 16:00:00,45,104,-59
22207,22207,206,2022/4/15 16:10:00,45,93,-48
22208,22208,206,2022/4/15 16:20:00,44,102,-58
22209,22209,206,2022/4/15 16:30:00,47,116,-69
22210,22210,206,2022/4/15 16:40:00,77,104,-27
22211,22211,206,2022/4/15 16:50:00,72,123,-51
22212,22212,206,2022/4/15 17:00:00,92,116,-24
22213,22213,206,2022/4/15 17:10:00,70,132,-62
22214,22214,206,2022/4/15 17:20:00,67,168,-101
22215,22215,206,2022/4/15 17:30:00,52,192,-140
22216,22216,206,2022/4/15 17:40:00,45,179,-134
22217,22217,206,2022/4/15 17:50:00,42,255,-213
22218,22218,206,2022/4/15 18:00:00,77,218,-141
22219,22219,206,2022/4/15 18:10:00,76,217,-141
22220,22220,206,2022/4/15 18:20:00,45,300,-255
22221,22221,206,2022/4/15 18:30:00,43,218,-175
22222,22222,206,2022/4/15 18:40:00,36,235,-199
22223,22223,206,2022/4/15 18:50:00,31,256,-225
22224,22224,206,2022/4/15 19:00:00,24,224,-200
22225,22225,206,2022/4/15 19:10:00,24,184,-160
22226,22226,206,2022/4/15 19:20:00,24,144,-120
22227,22227,206,2022/4/15 19:30:00,25,116,-91
22228,22228,206,2022/4/15 19:40:00,25,109,-84
22229,22229,206,2022/4/15 19:50:00,23,108,-85
22230,22230,206,2022/4/15 20:00:00,28,109,-81
22231,22231,206,2022/4/15 20:10:00,24,113,-89
22232,22232,206,2022/4/15 20:20:00,22,106,-84
22233,22233,206,2022/4/15 20:30:00,22,107,-85
22234,22234,206,2022/4/15 20:40:00,22,105,-83
22235,22235,206,2022/4/15 20:50:00,22,109,-87
22236,22236,206,2022/4/15 21:00:00,21,100,-79
22237,22237,206,2022/4/15 21:10:00,23,107,-84
22238,22238,206,2022/4/15 21:20:00,19,106,-87
22239,22239,206,2022/4/15 21:30:00,14,105,-91
22240,22240,206,2022/4/15 21:40:00,16,97,-81
22241,22241,206,2022/4/15 21:50:00,11,92,-81
22242,22242,206,2022/4/15 22:00:00,12,106,-94
22243,22243,206,2022/4/15 22:10:00,8,78,-70
22244,22244,206,2022/4/15 22:20:00,6,98,-92
22245,22245,206,2022/4/15 22:30:00,6,91,-85
22246,22246,206,2022/4/15 22:40:00,4,66,-62
22247,22247,206,2022/4/15 22:50:00,2,71,-69
22248,22248,207,2022/4/15 5:00:00,0,1,-1
22249,22249,207,2022/4/15 5:10:00,1,1,0
22250,22250,207,2022/4/15 5:20:00,3,1,2
22251,22251,207,2022/4/15 5:30:00,5,1,4
22252,22252,207,2022/4/15 5:40:00,10,1,9
22253,22253,207,2022/4/15 5:50:00,12,1,11
22254,22254,207,2022/4/15 6:00:00,16,1,15
22255,22255,207,2022/4/15 6:10:00,18,2,16
22256,22256,207,2022/4/15 6:20:00,23,11,12
22257,22257,207,2022/4/15 6:30:00,33,14,19
22258,22258,207,2022/4/15 6:40:00,31,33,-2
22259,22259,207,2022/4/15 6:50:00,37,49,-12
22260,22260,207,2022/4/15 7:00:00,44,62,-18
22261,22261,207,2022/4/15 7:10:00,53,60,-7
22262,22262,207,2022/4/15 7:20:00,66,65,1
22263,22263,207,2022/4/15 7:30:00,78,68,10
22264,22264,207,2022/4/15 7:40:00,91,77,14
22265,22265,207,2022/4/15 7:50:00,122,97,25
22266,22266,207,2022/4/15 8:00:00,158,116,42
22267,22267,207,2022/4/15 8:10:00,144,109,35
22268,22268,207,2022/4/15 8:20:00,144,124,20
22269,22269,207,2022/4/15 8:30:00,71,102,-31
22270,22270,207,2022/4/15 8:40:00,53,76,-23
22271,22271,207,2022/4/15 8:50:00,50,67,-17
22272,22272,207,2022/4/15 9:00:00,31,49,-18
22273,22273,207,2022/4/15 9:10:00,33,46,-13
22274,22274,207,2022/4/15 9:20:00,27,44,-17
22275,22275,207,2022/4/15 9:30:00,21,32,-11
22276,22276,207,2022/4/15 9:40:00,20,35,-15
22277,22277,207,2022/4/15 9:50:00,14,32,-18
22278,22278,207,2022/4/15 10:00:00,12,30,-18
22279,22279,207,2022/4/15 10:10:00,13,29,-16
22280,22280,207,2022/4/15 10:20:00,12,23,-11
22281,22281,207,2022/4/15 10:30:00,11,23,-12
22282,22282,207,2022/4/15 10:40:00,13,31,-18
22283,22283,207,2022/4/15 10:50:00,11,23,-12
22284,22284,207,2022/4/15 11:00:00,14,21,-7
22285,22285,207,2022/4/15 11:10:00,12,23,-11
22286,22286,207,2022/4/15 11:20:00,11,25,-14
22287,22287,207,2022/4/15 11:30:00,11,23,-12
22288,22288,207,2022/4/15 11:40:00,9,23,-14
22289,22289,207,2022/4/15 11:50:00,13,24,-11
22290,22290,207,2022/4/15 12:00:00,12,30,-18
22291,22291,207,2022/4/15 12:10:00,11,32,-21
22292,22292,207,2022/4/15 12:20:00,13,31,-18
22293,22293,207,2022/4/15 12:30:00,14,23,-9
22294,22294,207,2022/4/15 12:40:00,10,38,-28
22295,22295,207,2022/4/15 12:50:00,13,32,-19
22296,22296,207,2022/4/15 13:00:00,11,37,-26
22297,22297,207,2022/4/15 13:10:00,9,36,-27
22298,22298,207,2022/4/15 13:20:00,9,38,-29
22299,22299,207,2022/4/15 13:30:00,11,33,-22
22300,22300,207,2022/4/15 13:40:00,11,37,-26
22301,22301,207,2022/4/15 13:50:00,10,38,-28
22302,22302,207,2022/4/15 14:00:00,11,33,-22
22303,22303,207,2022/4/15 14:10:00,10,32,-22
22304,22304,207,2022/4/15 14:20:00,12,36,-24
22305,22305,207,2022/4/15 14:30:00,10,37,-27
22306,22306,207,2022/4/15 14:40:00,12,38,-26
22307,22307,207,2022/4/15 14:50:00,12,30,-18
22308,22308,207,2022/4/15 15:00:00,17,38,-21
22309,22309,207,2022/4/15 15:10:00,16,36,-20
22310,22310,207,2022/4/15 15:20:00,14,45,-31
22311,22311,207,2022/4/15 15:30:00,14,36,-22
22312,22312,207,2022/4/15 15:40:00,21,46,-25
22313,22313,207,2022/4/15 15:50:00,15,45,-30
22314,22314,207,2022/4/15 16:00:00,18,62,-44
22315,22315,207,2022/4/15 16:10:00,17,65,-48
22316,22316,207,2022/4/15 16:20:00,25,52,-27
22317,22317,207,2022/4/15 16:30:00,21,57,-36
22318,22318,207,2022/4/15 16:40:00,33,61,-28
22319,22319,207,2022/4/15 16:50:00,24,52,-28
22320,22320,207,2022/4/15 17:00:00,37,59,-22
22321,22321,207,2022/4/15 17:10:00,53,60,-7
22322,22322,207,2022/4/15 17:20:00,27,72,-45
22323,22323,207,2022/4/15 17:30:00,24,84,-60
22324,22324,207,2022/4/15 17:40:00,50,81,-31
22325,22325,207,2022/4/15 17:50:00,40,92,-52
22326,22326,207,2022/4/15 18:00:00,27,110,-83
22327,22327,207,2022/4/15 18:10:00,45,106,-61
22328,22328,207,2022/4/15 18:20:00,43,115,-72
22329,22329,207,2022/4/15 18:30:00,32,102,-70
22330,22330,207,2022/4/15 18:40:00,47,107,-60
22331,22331,207,2022/4/15 18:50:00,28,95,-67
22332,22332,207,2022/4/15 19:00:00,19,92,-73
22333,22333,207,2022/4/15 19:10:00,24,78,-54
22334,22334,207,2022/4/15 19:20:00,15,73,-58
22335,22335,207,2022/4/15 19:30:00,14,66,-52
22336,22336,207,2022/4/15 19:40:00,17,66,-49
22337,22337,207,2022/4/15 19:50:00,12,52,-40
22338,22338,207,2022/4/15 20:00:00,10,49,-39
22339,22339,207,2022/4/15 20:10:00,18,40,-22
22340,22340,207,2022/4/15 20:20:00,15,47,-32
22341,22341,207,2022/4/15 20:30:00,15,40,-25
22342,22342,207,2022/4/15 20:40:00,24,47,-23
22343,22343,207,2022/4/15 20:50:00,16,42,-26
22344,22344,207,2022/4/15 21:00:00,16,47,-31
22345,22345,207,2022/4/15 21:10:00,11,37,-26
22346,22346,207,2022/4/15 21:20:00,13,34,-21
22347,22347,207,2022/4/15 21:30:00,6,40,-34
22348,22348,207,2022/4/15 21:40:00,6,37,-31
22349,22349,207,2022/4/15 21:50:00,4,39,-35
22350,22350,207,2022/4/15 22:00:00,4,41,-37
22351,22351,207,2022/4/15 22:10:00,5,40,-35
22352,22352,207,2022/4/15 22:20:00,2,40,-38
22353,22353,207,2022/4/15 22:30:00,1,41,-40
22354,22354,207,2022/4/15 22:40:00,0,52,-52
22355,22355,207,2022/4/15 22:50:00,0,44,-44
22356,22356,208,2022/4/15 5:00:00,0,1,-1
22357,22357,208,2022/4/15 5:10:00,0,1,-1
22358,22358,208,2022/4/15 5:20:00,1,1,0
22359,22359,208,2022/4/15 5:30:00,15,1,14
22360,22360,208,2022/4/15 5:40:00,20,1,19
22361,22361,208,2022/4/15 5:50:00,23,1,22
22362,22362,208,2022/4/15 6:00:00,26,1,25
22363,22363,208,2022/4/15 6:10:00,33,1,32
22364,22364,208,2022/4/15 6:20:00,37,14,23
22365,22365,208,2022/4/15 6:30:00,57,23,34
22366,22366,208,2022/4/15 6:40:00,66,23,43
22367,22367,208,2022/4/15 6:50:00,78,38,40
22368,22368,208,2022/4/15 7:00:00,93,50,43
22369,22369,208,2022/4/15 7:10:00,187,64,123
22370,22370,208,2022/4/15 7:20:00,226,63,163
22371,22371,208,2022/4/15 7:30:00,280,63,217
22372,22372,208,2022/4/15 7:40:00,375,50,325
22373,22373,208,2022/4/15 7:50:00,573,51,522
22374,22374,208,2022/4/15 8:00:00,599,47,552
22375,22375,208,2022/4/15 8:10:00,375,63,312
22376,22376,208,2022/4/15 8:20:00,279,51,228
22377,22377,208,2022/4/15 8:30:00,223,50,173
22378,22378,208,2022/4/15 8:40:00,152,52,100
22379,22379,208,2022/4/15 8:50:00,87,51,36
22380,22380,208,2022/4/15 9:00:00,52,52,0
22381,22381,208,2022/4/15 9:10:00,36,38,-2
22382,22382,208,2022/4/15 9:20:00,30,33,-3
22383,22383,208,2022/4/15 9:30:00,31,35,-4
22384,22384,208,2022/4/15 9:40:00,26,32,-6
22385,22385,208,2022/4/15 9:50:00,28,34,-6
22386,22386,208,2022/4/15 10:00:00,23,35,-12
22387,22387,208,2022/4/15 10:10:00,24,38,-14
22388,22388,208,2022/4/15 10:20:00,22,34,-12
22389,22389,208,2022/4/15 10:30:00,22,37,-15
22390,22390,208,2022/4/15 10:40:00,20,46,-26
22391,22391,208,2022/4/15 10:50:00,22,37,-15
22392,22392,208,2022/4/15 11:00:00,19,36,-17
22393,22393,208,2022/4/15 11:10:00,21,32,-11
22394,22394,208,2022/4/15 11:20:00,19,36,-17
22395,22395,208,2022/4/15 11:30:00,24,39,-15
22396,22396,208,2022/4/15 11:40:00,22,38,-16
22397,22397,208,2022/4/15 11:50:00,19,35,-16
22398,22398,208,2022/4/15 12:00:00,21,42,-21
22399,22399,208,2022/4/15 12:10:00,26,47,-21
22400,22400,208,2022/4/15 12:20:00,25,36,-11
22401,22401,208,2022/4/15 12:30:00,21,40,-19
22402,22402,208,2022/4/15 12:40:00,25,38,-13
22403,22403,208,2022/4/15 12:50:00,23,37,-14
22404,22404,208,2022/4/15 13:00:00,22,38,-16
22405,22405,208,2022/4/15 13:10:00,20,38,-18
22406,22406,208,2022/4/15 13:20:00,22,40,-18
22407,22407,208,2022/4/15 13:30:00,20,46,-26
22408,22408,208,2022/4/15 13:40:00,23,44,-21
22409,22409,208,2022/4/15 13:50:00,22,47,-25
22410,22410,208,2022/4/15 14:00:00,20,38,-18
22411,22411,208,2022/4/15 14:10:00,21,42,-21
22412,22412,208,2022/4/15 14:20:00,16,41,-25
22413,22413,208,2022/4/15 14:30:00,14,42,-28
22414,22414,208,2022/4/15 14:40:00,19,40,-21
22415,22415,208,2022/4/15 14:50:00,17,47,-30
22416,22416,208,2022/4/15 15:00:00,16,51,-35
22417,22417,208,2022/4/15 15:10:00,17,66,-49
22418,22418,208,2022/4/15 15:20:00,20,53,-33
22419,22419,208,2022/4/15 15:30:00,16,50,-34
22420,22420,208,2022/4/15 15:40:00,16,54,-38
22421,22421,208,2022/4/15 15:50:00,14,67,-53
22422,22422,208,2022/4/15 16:00:00,17,63,-46
22423,22423,208,2022/4/15 16:10:00,19,66,-47
22424,22424,208,2022/4/15 16:20:00,18,68,-50
22425,22425,208,2022/4/15 16:30:00,26,77,-51
22426,22426,208,2022/4/15 16:40:00,27,75,-48
22427,22427,208,2022/4/15 16:50:00,27,82,-55
22428,22428,208,2022/4/15 17:00:00,28,74,-46
22429,22429,208,2022/4/15 17:10:00,23,75,-52
22430,22430,208,2022/4/15 17:20:00,27,93,-66
22431,22431,208,2022/4/15 17:30:00,26,107,-81
22432,22432,208,2022/4/15 17:40:00,21,108,-87
22433,22433,208,2022/4/15 17:50:00,18,110,-92
22434,22434,208,2022/4/15 18:00:00,21,117,-96
22435,22435,208,2022/4/15 18:10:00,22,114,-92
22436,22436,208,2022/4/15 18:20:00,19,110,-91
22437,22437,208,2022/4/15 18:30:00,15,128,-113
22438,22438,208,2022/4/15 18:40:00,16,104,-88
22439,22439,208,2022/4/15 18:50:00,15,119,-104
22440,22440,208,2022/4/15 19:00:00,12,109,-97
22441,22441,208,2022/4/15 19:10:00,12,161,-149
22442,22442,208,2022/4/15 19:20:00,14,150,-136
22443,22443,208,2022/4/15 19:30:00,10,123,-113
22444,22444,208,2022/4/15 19:40:00,11,106,-95
22445,22445,208,2022/4/15 19:50:00,10,107,-97
22446,22446,208,2022/4/15 20:00:00,12,106,-94
22447,22447,208,2022/4/15 20:10:00,12,89,-77
22448,22448,208,2022/4/15 20:20:00,9,94,-85
22449,22449,208,2022/4/15 20:30:00,8,98,-90
22450,22450,208,2022/4/15 20:40:00,6,99,-93
22451,22451,208,2022/4/15 20:50:00,6,95,-89
22452,22452,208,2022/4/15 21:00:00,8,84,-76
22453,22453,208,2022/4/15 21:10:00,7,89,-82
22454,22454,208,2022/4/15 21:20:00,7,78,-71
22455,22455,208,2022/4/15 21:30:00,6,77,-71
22456,22456,208,2022/4/15 21:40:00,5,78,-73
22457,22457,208,2022/4/15 21:50:00,2,88,-86
22458,22458,208,2022/4/15 22:00:00,1,72,-71
22459,22459,208,2022/4/15 22:10:00,2,89,-87
22460,22460,208,2022/4/15 22:20:00,2,78,-76
22461,22461,208,2022/4/15 22:30:00,2,62,-60
22462,22462,208,2022/4/15 22:40:00,0,78,-78
22463,22463,208,2022/4/15 22:50:00,0,65,-65
22464,22464,209,2022/4/15 5:00:00,0,1,-1
22465,22465,209,2022/4/15 5:10:00,0,1,-1
22466,22466,209,2022/4/15 5:20:00,5,1,4
22467,22467,209,2022/4/15 5:30:00,13,1,12
22468,22468,209,2022/4/15 5:40:00,14,1,13
22469,22469,209,2022/4/15 5:50:00,20,1,19
22470,22470,209,2022/4/15 6:00:00,26,1,25
22471,22471,209,2022/4/15 6:10:00,32,1,31
22472,22472,209,2022/4/15 6:20:00,39,19,20
22473,22473,209,2022/4/15 6:30:00,59,33,26
22474,22474,209,2022/4/15 6:40:00,81,31,50
22475,22475,209,2022/4/15 6:50:00,81,41,40
22476,22476,209,2022/4/15 7:00:00,150,48,102
22477,22477,209,2022/4/15 7:10:00,187,55,132
22478,22478,209,2022/4/15 7:20:00,231,50,181
22479,22479,209,2022/4/15 7:30:00,275,60,215
22480,22480,209,2022/4/15 7:40:00,336,63,273
22481,22481,209,2022/4/15 7:50:00,360,79,281
22482,22482,209,2022/4/15 8:00:00,375,77,298
22483,22483,209,2022/4/15 8:10:00,474,76,398
22484,22484,209,2022/4/15 8:20:00,392,90,302
22485,22485,209,2022/4/15 8:30:00,326,113,213
22486,22486,209,2022/4/15 8:40:00,243,103,140
22487,22487,209,2022/4/15 8:50:00,195,105,90
22488,22488,209,2022/4/15 9:00:00,139,75,64
22489,22489,209,2022/4/15 9:10:00,86,72,14
22490,22490,209,2022/4/15 9:20:00,64,50,14
22491,22491,209,2022/4/15 9:30:00,44,69,-25
22492,22492,209,2022/4/15 9:40:00,38,60,-22
22493,22493,209,2022/4/15 9:50:00,29,52,-23
22494,22494,209,2022/4/15 10:00:00,31,49,-18
22495,22495,209,2022/4/15 10:10:00,27,52,-25
22496,22496,209,2022/4/15 10:20:00,28,65,-37
22497,22497,209,2022/4/15 10:30:00,29,48,-19
22498,22498,209,2022/4/15 10:40:00,28,48,-20
22499,22499,209,2022/4/15 10:50:00,24,51,-27
22500,22500,209,2022/4/15 11:00:00,25,57,-32
22501,22501,209,2022/4/15 11:10:00,24,50,-26
22502,22502,209,2022/4/15 11:20:00,25,45,-20
22503,22503,209,2022/4/15 11:30:00,23,47,-24
22504,22504,209,2022/4/15 11:40:00,24,52,-28
22505,22505,209,2022/4/15 11:50:00,27,53,-26
22506,22506,209,2022/4/15 12:00:00,26,51,-25
22507,22507,209,2022/4/15 12:10:00,28,50,-22
22508,22508,209,2022/4/15 12:20:00,31,50,-19
22509,22509,209,2022/4/15 12:30:00,28,55,-27
22510,22510,209,2022/4/15 12:40:00,25,60,-35
22511,22511,209,2022/4/15 12:50:00,27,51,-24
22512,22512,209,2022/4/15 13:00:00,26,51,-25
22513,22513,209,2022/4/15 13:10:00,27,57,-30
22514,22514,209,2022/4/15 13:20:00,29,60,-31
22515,22515,209,2022/4/15 13:30:00,27,50,-23
22516,22516,209,2022/4/15 13:40:00,22,49,-27
22517,22517,209,2022/4/15 13:50:00,22,57,-35
22518,22518,209,2022/4/15 14:00:00,24,67,-43
22519,22519,209,2022/4/15 14:10:00,27,60,-33
22520,22520,209,2022/4/15 14:20:00,22,57,-35
22521,22521,209,2022/4/15 14:30:00,22,61,-39
22522,22522,209,2022/4/15 14:40:00,23,62,-39
22523,22523,209,2022/4/15 14:50:00,22,69,-47
22524,22524,209,2022/4/15 15:00:00,22,58,-36
22525,22525,209,2022/4/15 15:10:00,28,64,-36
22526,22526,209,2022/4/15 15:20:00,25,67,-42
22527,22527,209,2022/4/15 15:30:00,25,75,-50
22528,22528,209,2022/4/15 15:40:00,27,78,-51
22529,22529,209,2022/4/15 15:50:00,25,76,-51
22530,22530,209,2022/4/15 16:00:00,28,72,-44
22531,22531,209,2022/4/15 16:10:00,26,79,-53
22532,22532,209,2022/4/15 16:20:00,29,75,-46
22533,22533,209,2022/4/15 16:30:00,28,76,-48
22534,22534,209,2022/4/15 16:40:00,28,98,-70
22535,22535,209,2022/4/15 16:50:00,30,96,-66
22536,22536,209,2022/4/15 17:00:00,43,106,-63
22537,22537,209,2022/4/15 17:10:00,48,100,-52
22538,22538,209,2022/4/15 17:20:00,31,106,-75
22539,22539,209,2022/4/15 17:30:00,31,110,-79
22540,22540,209,2022/4/15 17:40:00,36,118,-82
22541,22541,209,2022/4/15 17:50:00,32,151,-119
22542,22542,209,2022/4/15 18:00:00,25,144,-119
22543,22543,209,2022/4/15 18:10:00,32,181,-149
22544,22544,209,2022/4/15 18:20:00,27,227,-200
22545,22545,209,2022/4/15 18:30:00,26,153,-127
22546,22546,209,2022/4/15 18:40:00,23,180,-157
22547,22547,209,2022/4/15 18:50:00,22,184,-162
22548,22548,209,2022/4/15 19:00:00,20,107,-87
22549,22549,209,2022/4/15 19:10:00,17,104,-87
22550,22550,209,2022/4/15 19:20:00,15,109,-94
22551,22551,209,2022/4/15 19:30:00,15,114,-99
22552,22552,209,2022/4/15 19:40:00,17,106,-89
22553,22553,209,2022/4/15 19:50:00,16,94,-78
22554,22554,209,2022/4/15 20:00:00,14,89,-75
22555,22555,209,2022/4/15 20:10:00,14,93,-79
22556,22556,209,2022/4/15 20:20:00,15,86,-71
22557,22557,209,2022/4/15 20:30:00,14,84,-70
22558,22558,209,2022/4/15 20:40:00,16,92,-76
22559,22559,209,2022/4/15 20:50:00,14,79,-65
22560,22560,209,2022/4/15 21:00:00,14,77,-63
22561,22561,209,2022/4/15 21:10:00,15,89,-74
22562,22562,209,2022/4/15 21:20:00,10,80,-70
22563,22563,209,2022/4/15 21:30:00,11,79,-68
22564,22564,209,2022/4/15 21:40:00,12,79,-67
22565,22565,209,2022/4/15 21:50:00,9,76,-67
22566,22566,209,2022/4/15 22:00:00,10,72,-62
22567,22567,209,2022/4/15 22:10:00,7,74,-67
22568,22568,209,2022/4/15 22:20:00,4,70,-66
22569,22569,209,2022/4/15 22:30:00,2,64,-62
22570,22570,209,2022/4/15 22:40:00,0,71,-71
22571,22571,209,2022/4/15 22:50:00,0,51,-51
22572,22572,210,2022/4/15 5:00:00,0,1,-1
22573,22573,210,2022/4/15 5:10:00,7,1,6
22574,22574,210,2022/4/15 5:20:00,16,1,15
22575,22575,210,2022/4/15 5:30:00,16,1,15
22576,22576,210,2022/4/15 5:40:00,17,1,16
22577,22577,210,2022/4/15 5:50:00,24,1,23
22578,22578,210,2022/4/15 6:00:00,30,1,29
22579,22579,210,2022/4/15 6:10:00,34,1,33
22580,22580,210,2022/4/15 6:20:00,40,1,39
22581,22581,210,2022/4/15 6:30:00,47,13,34
22582,22582,210,2022/4/15 6:40:00,56,13,43
22583,22583,210,2022/4/15 6:50:00,55,19,36
22584,22584,210,2022/4/15 7:00:00,76,23,53
22585,22585,210,2022/4/15 7:10:00,93,21,72
22586,22586,210,2022/4/15 7:20:00,180,29,151
22587,22587,210,2022/4/15 7:30:00,224,23,201
22588,22588,210,2022/4/15 7:40:00,222,51,171
22589,22589,210,2022/4/15 7:50:00,216,35,181
22590,22590,210,2022/4/15 8:00:00,180,49,131
22591,22591,210,2022/4/15 8:10:00,83,68,15
22592,22592,210,2022/4/15 8:20:00,58,48,10
22593,22593,210,2022/4/15 8:30:00,45,67,-22
22594,22594,210,2022/4/15 8:40:00,32,49,-17
22595,22595,210,2022/4/15 8:50:00,30,38,-8
22596,22596,210,2022/4/15 9:00:00,26,49,-23
22597,22597,210,2022/4/15 9:10:00,24,47,-23
22598,22598,210,2022/4/15 9:20:00,20,38,-18
22599,22599,210,2022/4/15 9:30:00,19,46,-27
22600,22600,210,2022/4/15 9:40:00,16,38,-22
22601,22601,210,2022/4/15 9:50:00,16,46,-30
22602,22602,210,2022/4/15 10:00:00,18,30,-12
22603,22603,210,2022/4/15 10:10:00,12,35,-23
22604,22604,210,2022/4/15 10:20:00,18,33,-15
22605,22605,210,2022/4/15 10:30:00,15,35,-20
22606,22606,210,2022/4/15 10:40:00,16,41,-25
22607,22607,210,2022/4/15 10:50:00,16,38,-22
22608,22608,210,2022/4/15 11:00:00,17,30,-13
22609,22609,210,2022/4/15 11:10:00,16,34,-18
22610,22610,210,2022/4/15 11:20:00,16,32,-16
22611,22611,210,2022/4/15 11:30:00,17,25,-8
22612,22612,210,2022/4/15 11:40:00,16,23,-7
22613,22613,210,2022/4/15 11:50:00,16,30,-14
22614,22614,210,2022/4/15 12:00:00,14,32,-18
22615,22615,210,2022/4/15 12:10:00,16,48,-32
22616,22616,210,2022/4/15 12:20:00,16,38,-22
22617,22617,210,2022/4/15 12:30:00,15,32,-17
22618,22618,210,2022/4/15 12:40:00,16,34,-18
22619,22619,210,2022/4/15 12:50:00,13,37,-24
22620,22620,210,2022/4/15 13:00:00,12,32,-20
22621,22621,210,2022/4/15 13:10:00,14,34,-20
22622,22622,210,2022/4/15 13:20:00,14,35,-21
22623,22623,210,2022/4/15 13:30:00,14,39,-25
22624,22624,210,2022/4/15 13:40:00,15,44,-29
22625,22625,210,2022/4/15 13:50:00,12,38,-26
22626,22626,210,2022/4/15 14:00:00,14,33,-19
22627,22627,210,2022/4/15 14:10:00,14,38,-24
22628,22628,210,2022/4/15 14:20:00,13,38,-25
22629,22629,210,2022/4/15 14:30:00,13,32,-19
22630,22630,210,2022/4/15 14:40:00,15,38,-23
22631,22631,210,2022/4/15 14:50:00,11,31,-20
22632,22632,210,2022/4/15 15:00:00,15,38,-23
22633,22633,210,2022/4/15 15:10:00,16,64,-48
22634,22634,210,2022/4/15 15:20:00,13,48,-35
22635,22635,210,2022/4/15 15:30:00,12,45,-33
22636,22636,210,2022/4/15 15:40:00,19,38,-19
22637,22637,210,2022/4/15 15:50:00,15,38,-23
22638,22638,210,2022/4/15 16:00:00,17,40,-23
22639,22639,210,2022/4/15 16:10:00,19,47,-28
22640,22640,210,2022/4/15 16:20:00,20,47,-27
22641,22641,210,2022/4/15 16:30:00,19,58,-39
22642,22642,210,2022/4/15 16:40:00,19,82,-63
22643,22643,210,2022/4/15 16:50:00,20,55,-35
22644,22644,210,2022/4/15 17:00:00,17,56,-39
22645,22645,210,2022/4/15 17:10:00,29,58,-29
22646,22646,210,2022/4/15 17:20:00,20,70,-50
22647,22647,210,2022/4/15 17:30:00,16,76,-60
22648,22648,210,2022/4/15 17:40:00,24,93,-69
22649,22649,210,2022/4/15 17:50:00,20,77,-57
22650,22650,210,2022/4/15 18:00:00,13,95,-82
22651,22651,210,2022/4/15 18:10:00,12,77,-65
22652,22652,210,2022/4/15 18:20:00,11,78,-67
22653,22653,210,2022/4/15 18:30:00,10,78,-68
22654,22654,210,2022/4/15 18:40:00,11,99,-88
22655,22655,210,2022/4/15 18:50:00,10,101,-91
22656,22656,210,2022/4/15 19:00:00,9,94,-85
22657,22657,210,2022/4/15 19:10:00,7,124,-117
22658,22658,210,2022/4/15 19:20:00,7,89,-82
22659,22659,210,2022/4/15 19:30:00,6,78,-72
22660,22660,210,2022/4/15 19:40:00,7,81,-74
22661,22661,210,2022/4/15 19:50:00,4,78,-74
22662,22662,210,2022/4/15 20:00:00,7,71,-64
22663,22663,210,2022/4/15 20:10:00,4,69,-65
22664,22664,210,2022/4/15 20:20:00,4,64,-60
22665,22665,210,2022/4/15 20:30:00,5,72,-67
22666,22666,210,2022/4/15 20:40:00,5,62,-57
22667,22667,210,2022/4/15 20:50:00,4,53,-49
22668,22668,210,2022/4/15 21:00:00,5,49,-44
22669,22669,210,2022/4/15 21:10:00,4,49,-45
22670,22670,210,2022/4/15 21:20:00,4,56,-52
22671,22671,210,2022/4/15 21:30:00,4,51,-47
22672,22672,210,2022/4/15 21:40:00,2,66,-64
22673,22673,210,2022/4/15 21:50:00,2,47,-45
22674,22674,210,2022/4/15 22:00:00,1,56,-55
22675,22675,210,2022/4/15 22:10:00,1,34,-33
22676,22676,210,2022/4/15 22:20:00,2,52,-50
22677,22677,210,2022/4/15 22:30:00,0,49,-49
22678,22678,210,2022/4/15 22:40:00,0,33,-33
22679,22679,210,2022/4/15 22:50:00,0,46,-46
22680,22680,211,2022/4/15 5:00:00,0,1,-1
22681,22681,211,2022/4/15 5:10:00,0,1,-1
22682,22682,211,2022/4/15 5:20:00,6,1,5
22683,22683,211,2022/4/15 5:30:00,15,1,14
22684,22684,211,2022/4/15 5:40:00,10,2,8
22685,22685,211,2022/4/15 5:50:00,16,1,15
22686,22686,211,2022/4/15 6:00:00,24,2,22
22687,22687,211,2022/4/15 6:10:00,35,2,33
22688,22688,211,2022/4/15 6:20:00,47,32,15
22689,22689,211,2022/4/15 6:30:00,57,24,33
22690,22690,211,2022/4/15 6:40:00,70,49,21
22691,22691,211,2022/4/15 6:50:00,88,74,14
22692,22692,211,2022/4/15 7:00:00,163,104,59
22693,22693,211,2022/4/15 7:10:00,177,122,55
22694,22694,211,2022/4/15 7:20:00,213,126,87
22695,22695,211,2022/4/15 7:30:00,282,119,163
22696,22696,211,2022/4/15 7:40:00,348,91,257
22697,22697,211,2022/4/15 7:50:00,444,98,346
22698,22698,211,2022/4/15 8:00:00,468,105,363
22699,22699,211,2022/4/15 8:10:00,572,104,468
22700,22700,211,2022/4/15 8:20:00,390,151,239
22701,22701,211,2022/4/15 8:30:00,318,326,-8
22702,22702,211,2022/4/15 8:40:00,282,321,-39
22703,22703,211,2022/4/15 8:50:00,231,324,-93
22704,22704,211,2022/4/15 9:00:00,148,213,-65
22705,22705,211,2022/4/15 9:10:00,86,128,-42
22706,22706,211,2022/4/15 9:20:00,67,106,-39
22707,22707,211,2022/4/15 9:30:00,49,109,-60
22708,22708,211,2022/4/15 9:40:00,37,97,-60
22709,22709,211,2022/4/15 9:50:00,31,83,-52
22710,22710,211,2022/4/15 10:00:00,32,70,-38
22711,22711,211,2022/4/15 10:10:00,28,65,-37
22712,22712,211,2022/4/15 10:20:00,29,60,-31
22713,22713,211,2022/4/15 10:30:00,29,54,-25
22714,22714,211,2022/4/15 10:40:00,27,55,-28
22715,22715,211,2022/4/15 10:50:00,26,50,-24
22716,22716,211,2022/4/15 11:00:00,27,55,-28
22717,22717,211,2022/4/15 11:10:00,24,54,-30
22718,22718,211,2022/4/15 11:20:00,29,51,-22
22719,22719,211,2022/4/15 11:30:00,28,51,-23
22720,22720,211,2022/4/15 11:40:00,29,54,-25
22721,22721,211,2022/4/15 11:50:00,28,54,-26
22722,22722,211,2022/4/15 12:00:00,29,61,-32
22723,22723,211,2022/4/15 12:10:00,27,60,-33
22724,22724,211,2022/4/15 12:20:00,29,60,-31
22725,22725,211,2022/4/15 12:30:00,29,60,-31
22726,22726,211,2022/4/15 12:40:00,23,70,-47
22727,22727,211,2022/4/15 12:50:00,25,68,-43
22728,22728,211,2022/4/15 13:00:00,28,64,-36
22729,22729,211,2022/4/15 13:10:00,25,68,-43
22730,22730,211,2022/4/15 13:20:00,28,69,-41
22731,22731,211,2022/4/15 13:30:00,29,61,-32
22732,22732,211,2022/4/15 13:40:00,26,61,-35
22733,22733,211,2022/4/15 13:50:00,28,67,-39
22734,22734,211,2022/4/15 14:00:00,28,61,-33
22735,22735,211,2022/4/15 14:10:00,23,65,-42
22736,22736,211,2022/4/15 14:20:00,28,59,-31
22737,22737,211,2022/4/15 14:30:00,28,62,-34
22738,22738,211,2022/4/15 14:40:00,28,71,-43
22739,22739,211,2022/4/15 14:50:00,27,67,-40
22740,22740,211,2022/4/15 15:00:00,27,70,-43
22741,22741,211,2022/4/15 15:10:00,29,68,-39
22742,22742,211,2022/4/15 15:20:00,29,68,-39
22743,22743,211,2022/4/15 15:30:00,25,76,-51
22744,22744,211,2022/4/15 15:40:00,26,74,-48
22745,22745,211,2022/4/15 15:50:00,28,78,-50
22746,22746,211,2022/4/15 16:00:00,32,77,-45
22747,22747,211,2022/4/15 16:10:00,32,77,-45
22748,22748,211,2022/4/15 16:20:00,39,93,-54
22749,22749,211,2022/4/15 16:30:00,61,92,-31
22750,22750,211,2022/4/15 16:40:00,85,96,-11
22751,22751,211,2022/4/15 16:50:00,177,105,72
22752,22752,211,2022/4/15 17:00:00,207,109,98
22753,22753,211,2022/4/15 17:10:00,198,115,83
22754,22754,211,2022/4/15 17:20:00,106,110,-4
22755,22755,211,2022/4/15 17:30:00,77,118,-41
22756,22756,211,2022/4/15 17:40:00,213,127,86
22757,22757,211,2022/4/15 17:50:00,77,177,-100
22758,22758,211,2022/4/15 18:00:00,98,152,-54
22759,22759,211,2022/4/15 18:10:00,275,226,49
22760,22760,211,2022/4/15 18:20:00,174,158,16
22761,22761,211,2022/4/15 18:30:00,77,224,-147
22762,22762,211,2022/4/15 18:40:00,136,224,-88
22763,22763,211,2022/4/15 18:50:00,72,171,-99
22764,22764,211,2022/4/15 19:00:00,44,119,-75
22765,22765,211,2022/4/15 19:10:00,37,122,-85
22766,22766,211,2022/4/15 19:20:00,35,88,-53
22767,22767,211,2022/4/15 19:30:00,29,110,-81
22768,22768,211,2022/4/15 19:40:00,24,110,-86
22769,22769,211,2022/4/15 19:50:00,23,92,-69
22770,22770,211,2022/4/15 20:00:00,29,78,-49
22771,22771,211,2022/4/15 20:10:00,35,95,-60
22772,22772,211,2022/4/15 20:20:00,25,82,-57
22773,22773,211,2022/4/15 20:30:00,28,82,-54
22774,22774,211,2022/4/15 20:40:00,28,90,-62
22775,22775,211,2022/4/15 20:50:00,25,88,-63
22776,22776,211,2022/4/15 21:00:00,26,76,-50
22777,22777,211,2022/4/15 21:10:00,32,94,-62
22778,22778,211,2022/4/15 21:20:00,29,79,-50
22779,22779,211,2022/4/15 21:30:00,28,83,-55
22780,22780,211,2022/4/15 21:40:00,28,78,-50
22781,22781,211,2022/4/15 21:50:00,28,76,-48
22782,22782,211,2022/4/15 22:00:00,17,68,-51
22783,22783,211,2022/4/15 22:10:00,21,83,-62
22784,22784,211,2022/4/15 22:20:00,13,75,-62
22785,22785,211,2022/4/15 22:30:00,11,67,-56
22786,22786,211,2022/4/15 22:40:00,4,62,-58
22787,22787,211,2022/4/15 22:50:00,2,59,-57
22788,22788,212,2022/4/15 5:00:00,0,1,-1
22789,22789,212,2022/4/15 5:10:00,0,1,-1
22790,22790,212,2022/4/15 5:20:00,4,1,3
22791,22791,212,2022/4/15 5:30:00,14,1,13
22792,22792,212,2022/4/15 5:40:00,16,1,15
22793,22793,212,2022/4/15 5:50:00,18,1,17
22794,22794,212,2022/4/15 6:00:00,23,1,22
22795,22795,212,2022/4/15 6:10:00,31,1,30
22796,22796,212,2022/4/15 6:20:00,41,21,20
22797,22797,212,2022/4/15 6:30:00,58,16,42
22798,22798,212,2022/4/15 6:40:00,78,23,55
22799,22799,212,2022/4/15 6:50:00,124,23,101
22800,22800,212,2022/4/15 7:00:00,163,23,140
22801,22801,212,2022/4/15 7:10:00,222,38,184
22802,22802,212,2022/4/15 7:20:00,267,48,219
22803,22803,212,2022/4/15 7:30:00,346,55,291
22804,22804,212,2022/4/15 7:40:00,598,66,532
22805,22805,212,2022/4/15 7:50:00,590,69,521
22806,22806,212,2022/4/15 8:00:00,716,69,647
22807,22807,212,2022/4/15 8:10:00,688,82,606
22808,22808,212,2022/4/15 8:20:00,721,79,642
22809,22809,212,2022/4/15 8:30:00,474,90,384
22810,22810,212,2022/4/15 8:40:00,347,96,251
22811,22811,212,2022/4/15 8:50:00,245,86,159
22812,22812,212,2022/4/15 9:00:00,191,76,115
22813,22813,212,2022/4/15 9:10:00,116,83,33
22814,22814,212,2022/4/15 9:20:00,60,65,-5
22815,22815,212,2022/4/15 9:30:00,43,66,-23
22816,22816,212,2022/4/15 9:40:00,37,62,-25
22817,22817,212,2022/4/15 9:50:00,27,66,-39
22818,22818,212,2022/4/15 10:00:00,33,67,-34
22819,22819,212,2022/4/15 10:10:00,27,54,-27
22820,22820,212,2022/4/15 10:20:00,29,51,-22
22821,22821,212,2022/4/15 10:30:00,25,54,-29
22822,22822,212,2022/4/15 10:40:00,28,50,-22
22823,22823,212,2022/4/15 10:50:00,25,58,-33
22824,22824,212,2022/4/15 11:00:00,21,52,-31
22825,22825,212,2022/4/15 11:10:00,28,54,-26
22826,22826,212,2022/4/15 11:20:00,27,52,-25
22827,22827,212,2022/4/15 11:30:00,23,51,-28
22828,22828,212,2022/4/15 11:40:00,24,55,-31
22829,22829,212,2022/4/15 11:50:00,27,48,-21
22830,22830,212,2022/4/15 12:00:00,28,50,-22
22831,22831,212,2022/4/15 12:10:00,27,49,-22
22832,22832,212,2022/4/15 12:20:00,27,53,-26
22833,22833,212,2022/4/15 12:30:00,28,57,-29
22834,22834,212,2022/4/15 12:40:00,27,65,-38
22835,22835,212,2022/4/15 12:50:00,28,48,-20
22836,22836,212,2022/4/15 13:00:00,27,61,-34
22837,22837,212,2022/4/15 13:10:00,26,61,-35
22838,22838,212,2022/4/15 13:20:00,27,52,-25
22839,22839,212,2022/4/15 13:30:00,22,52,-30
22840,22840,212,2022/4/15 13:40:00,26,54,-28
22841,22841,212,2022/4/15 13:50:00,23,64,-41
22842,22842,212,2022/4/15 14:00:00,21,54,-33
22843,22843,212,2022/4/15 14:10:00,26,67,-41
22844,22844,212,2022/4/15 14:20:00,23,62,-39
22845,22845,212,2022/4/15 14:30:00,22,63,-41
22846,22846,212,2022/4/15 14:40:00,21,69,-48
22847,22847,212,2022/4/15 14:50:00,22,61,-39
22848,22848,212,2022/4/15 15:00:00,21,65,-44
22849,22849,212,2022/4/15 15:10:00,24,67,-43
22850,22850,212,2022/4/15 15:20:00,23,71,-48
22851,22851,212,2022/4/15 15:30:00,22,65,-43
22852,22852,212,2022/4/15 15:40:00,22,77,-55
22853,22853,212,2022/4/15 15:50:00,23,77,-54
22854,22854,212,2022/4/15 16:00:00,24,91,-67
22855,22855,212,2022/4/15 16:10:00,24,76,-52
22856,22856,212,2022/4/15 16:20:00,27,69,-42
22857,22857,212,2022/4/15 16:30:00,24,74,-50
22858,22858,212,2022/4/15 16:40:00,27,114,-87
22859,22859,212,2022/4/15 16:50:00,30,92,-62
22860,22860,212,2022/4/15 17:00:00,34,120,-86
22861,22861,212,2022/4/15 17:10:00,37,101,-64
22862,22862,212,2022/4/15 17:20:00,31,107,-76
22863,22863,212,2022/4/15 17:30:00,34,110,-76
22864,22864,212,2022/4/15 17:40:00,45,149,-104
22865,22865,212,2022/4/15 17:50:00,31,152,-121
22866,22866,212,2022/4/15 18:00:00,29,226,-197
22867,22867,212,2022/4/15 18:10:00,33,232,-199
22868,22868,212,2022/4/15 18:20:00,31,218,-187
22869,22869,212,2022/4/15 18:30:00,28,232,-204
22870,22870,212,2022/4/15 18:40:00,28,285,-257
22871,22871,212,2022/4/15 18:50:00,23,233,-210
22872,22872,212,2022/4/15 19:00:00,22,191,-169
22873,22873,212,2022/4/15 19:10:00,20,145,-125
22874,22874,212,2022/4/15 19:20:00,20,109,-89
22875,22875,212,2022/4/15 19:30:00,18,123,-105
22876,22876,212,2022/4/15 19:40:00,17,125,-108
22877,22877,212,2022/4/15 19:50:00,17,114,-97
22878,22878,212,2022/4/15 20:00:00,18,106,-88
22879,22879,212,2022/4/15 20:10:00,17,104,-87
22880,22880,212,2022/4/15 20:20:00,14,93,-79
22881,22881,212,2022/4/15 20:30:00,17,78,-61
22882,22882,212,2022/4/15 20:40:00,18,104,-86
22883,22883,212,2022/4/15 20:50:00,16,95,-79
22884,22884,212,2022/4/15 21:00:00,11,83,-72
22885,22885,212,2022/4/15 21:10:00,15,108,-93
22886,22886,212,2022/4/15 21:20:00,15,93,-78
22887,22887,212,2022/4/15 21:30:00,10,89,-79
22888,22888,212,2022/4/15 21:40:00,10,97,-87
22889,22889,212,2022/4/15 21:50:00,8,78,-70
22890,22890,212,2022/4/15 22:00:00,10,78,-68
22891,22891,212,2022/4/15 22:10:00,8,78,-70
22892,22892,212,2022/4/15 22:20:00,6,67,-61
22893,22893,212,2022/4/15 22:30:00,4,86,-82
22894,22894,212,2022/4/15 22:40:00,1,64,-63
22895,22895,212,2022/4/15 22:50:00,0,53,-53
22896,22896,213,2022/4/15 5:00:00,0,1,-1
22897,22897,213,2022/4/15 5:10:00,6,1,5
22898,22898,213,2022/4/15 5:20:00,18,1,17
22899,22899,213,2022/4/15 5:30:00,16,1,15
22900,22900,213,2022/4/15 5:40:00,19,1,18
22901,22901,213,2022/4/15 5:50:00,32,1,31
22902,22902,213,2022/4/15 6:00:00,33,1,32
22903,22903,213,2022/4/15 6:10:00,43,1,42
22904,22904,213,2022/4/15 6:20:00,54,1,53
22905,22905,213,2022/4/15 6:30:00,58,32,26
22906,22906,213,2022/4/15 6:40:00,61,31,30
22907,22907,213,2022/4/15 6:50:00,72,54,18
22908,22908,213,2022/4/15 7:00:00,92,51,41
22909,22909,213,2022/4/15 7:10:00,151,76,75
22910,22910,213,2022/4/15 7:20:00,177,72,105
22911,22911,213,2022/4/15 7:30:00,230,67,163
22912,22912,213,2022/4/15 7:40:00,224,98,126
22913,22913,213,2022/4/15 7:50:00,200,109,91
22914,22914,213,2022/4/15 8:00:00,144,110,34
22915,22915,213,2022/4/15 8:10:00,84,118,-34
22916,22916,213,2022/4/15 8:20:00,60,120,-60
22917,22917,213,2022/4/15 8:30:00,54,183,-129
22918,22918,213,2022/4/15 8:40:00,42,312,-270
22919,22919,213,2022/4/15 8:50:00,31,132,-101
22920,22920,213,2022/4/15 9:00:00,29,104,-75
22921,22921,213,2022/4/15 9:10:00,27,106,-79
22922,22922,213,2022/4/15 9:20:00,26,90,-64
22923,22923,213,2022/4/15 9:30:00,27,92,-65
22924,22924,213,2022/4/15 9:40:00,27,75,-48
22925,22925,213,2022/4/15 9:50:00,24,70,-46
22926,22926,213,2022/4/15 10:00:00,23,71,-48
22927,22927,213,2022/4/15 10:10:00,25,61,-36
22928,22928,213,2022/4/15 10:20:00,24,60,-36
22929,22929,213,2022/4/15 10:30:00,25,60,-35
22930,22930,213,2022/4/15 10:40:00,22,62,-40
22931,22931,213,2022/4/15 10:50:00,25,53,-28
22932,22932,213,2022/4/15 11:00:00,25,72,-47
22933,22933,213,2022/4/15 11:10:00,26,63,-37
22934,22934,213,2022/4/15 11:20:00,27,47,-20
22935,22935,213,2022/4/15 11:30:00,26,50,-24
22936,22936,213,2022/4/15 11:40:00,28,59,-31
22937,22937,213,2022/4/15 11:50:00,25,48,-23
22938,22938,213,2022/4/15 12:00:00,24,54,-30
22939,22939,213,2022/4/15 12:10:00,29,52,-23
22940,22940,213,2022/4/15 12:20:00,31,53,-22
22941,22941,213,2022/4/15 12:30:00,27,68,-41
22942,22942,213,2022/4/15 12:40:00,25,70,-45
22943,22943,213,2022/4/15 12:50:00,20,60,-40
22944,22944,213,2022/4/15 13:00:00,25,61,-36
22945,22945,213,2022/4/15 13:10:00,28,57,-29
22946,22946,213,2022/4/15 13:20:00,28,60,-32
22947,22947,213,2022/4/15 13:30:00,25,60,-35
22948,22948,213,2022/4/15 13:40:00,25,59,-34
22949,22949,213,2022/4/15 13:50:00,27,58,-31
22950,22950,213,2022/4/15 14:00:00,25,70,-45
22951,22951,213,2022/4/15 14:10:00,26,69,-43
22952,22952,213,2022/4/15 14:20:00,23,59,-36
22953,22953,213,2022/4/15 14:30:00,23,54,-31
22954,22954,213,2022/4/15 14:40:00,23,58,-35
22955,22955,213,2022/4/15 14:50:00,25,57,-32
22956,22956,213,2022/4/15 15:00:00,26,61,-35
22957,22957,213,2022/4/15 15:10:00,22,63,-41
22958,22958,213,2022/4/15 15:20:00,24,61,-37
22959,22959,213,2022/4/15 15:30:00,25,71,-46
22960,22960,213,2022/4/15 15:40:00,30,72,-42
22961,22961,213,2022/4/15 15:50:00,34,69,-35
22962,22962,213,2022/4/15 16:00:00,35,65,-30
22963,22963,213,2022/4/15 16:10:00,39,70,-31
22964,22964,213,2022/4/15 16:20:00,44,72,-28
22965,22965,213,2022/4/15 16:30:00,46,71,-25
22966,22966,213,2022/4/15 16:40:00,45,70,-25
22967,22967,213,2022/4/15 16:50:00,47,95,-48
22968,22968,213,2022/4/15 17:00:00,85,86,-1
22969,22969,213,2022/4/15 17:10:00,112,87,25
22970,22970,213,2022/4/15 17:20:00,70,74,-4
22971,22971,213,2022/4/15 17:30:00,90,94,-4
22972,22972,213,2022/4/15 17:40:00,217,93,124
22973,22973,213,2022/4/15 17:50:00,70,97,-27
22974,22974,213,2022/4/15 18:00:00,48,106,-58
22975,22975,213,2022/4/15 18:10:00,45,108,-63
22976,22976,213,2022/4/15 18:20:00,30,111,-81
22977,22977,213,2022/4/15 18:30:00,25,125,-100
22978,22978,213,2022/4/15 18:40:00,28,109,-81
22979,22979,213,2022/4/15 18:50:00,25,108,-83
22980,22980,213,2022/4/15 19:00:00,20,110,-90
22981,22981,213,2022/4/15 19:10:00,19,88,-69
22982,22982,213,2022/4/15 19:20:00,18,107,-89
22983,22983,213,2022/4/15 19:30:00,17,110,-93
22984,22984,213,2022/4/15 19:40:00,14,98,-84
22985,22985,213,2022/4/15 19:50:00,16,87,-71
22986,22986,213,2022/4/15 20:00:00,15,79,-64
22987,22987,213,2022/4/15 20:10:00,14,83,-69
22988,22988,213,2022/4/15 20:20:00,14,72,-58
22989,22989,213,2022/4/15 20:30:00,12,75,-63
22990,22990,213,2022/4/15 20:40:00,11,63,-52
22991,22991,213,2022/4/15 20:50:00,11,72,-61
22992,22992,213,2022/4/15 21:00:00,12,78,-66
22993,22993,213,2022/4/15 21:10:00,14,60,-46
22994,22994,213,2022/4/15 21:20:00,12,71,-59
22995,22995,213,2022/4/15 21:30:00,12,62,-50
22996,22996,213,2022/4/15 21:40:00,4,60,-56
22997,22997,213,2022/4/15 21:50:00,6,63,-57
22998,22998,213,2022/4/15 22:00:00,4,56,-52
22999,22999,213,2022/4/15 22:10:00,5,47,-42
23000,23000,213,2022/4/15 22:20:00,2,64,-62
23001,23001,213,2022/4/15 22:30:00,0,43,-43
23002,23002,213,2022/4/15 22:40:00,0,48,-48
23003,23003,213,2022/4/15 22:50:00,0,53,-53
23004,23004,214,2022/4/15 5:00:00,0,1,-1
23005,23005,214,2022/4/15 5:10:00,1,1,0
23006,23006,214,2022/4/15 5:20:00,5,1,4
23007,23007,214,2022/4/15 5:30:00,10,1,9
23008,23008,214,2022/4/15 5:40:00,7,1,6
23009,23009,214,2022/4/15 5:50:00,13,1,12
23010,23010,214,2022/4/15 6:00:00,18,1,17
23011,23011,214,2022/4/15 6:10:00,24,1,23
23012,23012,214,2022/4/15 6:20:00,37,19,18
23013,23013,214,2022/4/15 6:30:00,48,23,25
23014,23014,214,2022/4/15 6:40:00,68,29,39
23015,23015,214,2022/4/15 6:50:00,58,49,9
23016,23016,214,2022/4/15 7:00:00,81,51,30
23017,23017,214,2022/4/15 7:10:00,152,73,79
23018,23018,214,2022/4/15 7:20:00,162,81,81
23019,23019,214,2022/4/15 7:30:00,206,106,100
23020,23020,214,2022/4/15 7:40:00,188,105,83
23021,23021,214,2022/4/15 7:50:00,279,105,174
23022,23022,214,2022/4/15 8:00:00,345,71,274
23023,23023,214,2022/4/15 8:10:00,271,76,195
23024,23024,214,2022/4/15 8:20:00,241,72,169
23025,23025,214,2022/4/15 8:30:00,267,73,194
23026,23026,214,2022/4/15 8:40:00,186,69,117
23027,23027,214,2022/4/15 8:50:00,93,72,21
23028,23028,214,2022/4/15 9:00:00,62,56,6
23029,23029,214,2022/4/15 9:10:00,48,71,-23
23030,23030,214,2022/4/15 9:20:00,44,51,-7
23031,23031,214,2022/4/15 9:30:00,31,60,-29
23032,23032,214,2022/4/15 9:40:00,33,45,-12
23033,23033,214,2022/4/15 9:50:00,27,47,-20
23034,23034,214,2022/4/15 10:00:00,28,44,-16
23035,23035,214,2022/4/15 10:10:00,25,44,-19
23036,23036,214,2022/4/15 10:20:00,23,42,-19
23037,23037,214,2022/4/15 10:30:00,24,41,-17
23038,23038,214,2022/4/15 10:40:00,20,50,-30
23039,23039,214,2022/4/15 10:50:00,23,45,-22
23040,23040,214,2022/4/15 11:00:00,24,42,-18
23041,23041,214,2022/4/15 11:10:00,22,32,-10
23042,23042,214,2022/4/15 11:20:00,20,33,-13
23043,23043,214,2022/4/15 11:30:00,20,37,-17
23044,23044,214,2022/4/15 11:40:00,22,37,-15
23045,23045,214,2022/4/15 11:50:00,20,46,-26
23046,23046,214,2022/4/15 12:00:00,20,41,-21
23047,23047,214,2022/4/15 12:10:00,22,54,-32
23048,23048,214,2022/4/15 12:20:00,23,45,-22
23049,23049,214,2022/4/15 12:30:00,24,44,-20
23050,23050,214,2022/4/15 12:40:00,20,47,-27
23051,23051,214,2022/4/15 12:50:00,22,51,-29
23052,23052,214,2022/4/15 13:00:00,19,48,-29
23053,23053,214,2022/4/15 13:10:00,22,46,-24
23054,23054,214,2022/4/15 13:20:00,18,45,-27
23055,23055,214,2022/4/15 13:30:00,24,56,-32
23056,23056,214,2022/4/15 13:40:00,16,65,-49
23057,23057,214,2022/4/15 13:50:00,20,53,-33
23058,23058,214,2022/4/15 14:00:00,17,49,-32
23059,23059,214,2022/4/15 14:10:00,21,48,-27
23060,23060,214,2022/4/15 14:20:00,18,51,-33
23061,23061,214,2022/4/15 14:30:00,21,47,-26
23062,23062,214,2022/4/15 14:40:00,20,52,-32
23063,23063,214,2022/4/15 14:50:00,25,50,-25
23064,23064,214,2022/4/15 15:00:00,25,59,-34
23065,23065,214,2022/4/15 15:10:00,26,63,-37
23066,23066,214,2022/4/15 15:20:00,19,57,-38
23067,23067,214,2022/4/15 15:30:00,26,62,-36
23068,23068,214,2022/4/15 15:40:00,20,60,-40
23069,23069,214,2022/4/15 15:50:00,21,64,-43
23070,23070,214,2022/4/15 16:00:00,29,60,-31
23071,23071,214,2022/4/15 16:10:00,30,69,-39
23072,23072,214,2022/4/15 16:20:00,28,93,-65
23073,23073,214,2022/4/15 16:30:00,30,85,-55
23074,23074,214,2022/4/15 16:40:00,28,75,-47
23075,23075,214,2022/4/15 16:50:00,25,84,-59
23076,23076,214,2022/4/15 17:00:00,32,75,-43
23077,23077,214,2022/4/15 17:10:00,27,105,-78
23078,23078,214,2022/4/15 17:20:00,26,103,-77
23079,23079,214,2022/4/15 17:30:00,28,105,-77
23080,23080,214,2022/4/15 17:40:00,29,122,-93
23081,23081,214,2022/4/15 17:50:00,24,123,-99
23082,23082,214,2022/4/15 18:00:00,25,124,-99
23083,23083,214,2022/4/15 18:10:00,25,142,-117
23084,23084,214,2022/4/15 18:20:00,24,192,-168
23085,23085,214,2022/4/15 18:30:00,18,107,-89
23086,23086,214,2022/4/15 18:40:00,15,122,-107
23087,23087,214,2022/4/15 18:50:00,15,114,-99
23088,23088,214,2022/4/15 19:00:00,14,110,-96
23089,23089,214,2022/4/15 19:10:00,12,111,-99
23090,23090,214,2022/4/15 19:20:00,13,92,-79
23091,23091,214,2022/4/15 19:30:00,12,102,-90
23092,23092,214,2022/4/15 19:40:00,12,94,-82
23093,23093,214,2022/4/15 19:50:00,8,66,-58
23094,23094,214,2022/4/15 20:00:00,12,69,-57
23095,23095,214,2022/4/15 20:10:00,11,59,-48
23096,23096,214,2022/4/15 20:20:00,10,53,-43
23097,23097,214,2022/4/15 20:30:00,9,63,-54
23098,23098,214,2022/4/15 20:40:00,11,61,-50
23099,23099,214,2022/4/15 20:50:00,10,75,-65
23100,23100,214,2022/4/15 21:00:00,9,62,-53
23101,23101,214,2022/4/15 21:10:00,9,63,-54
23102,23102,214,2022/4/15 21:20:00,5,56,-51
23103,23103,214,2022/4/15 21:30:00,5,53,-48
23104,23104,214,2022/4/15 21:40:00,4,53,-49
23105,23105,214,2022/4/15 21:50:00,4,55,-51
23106,23106,214,2022/4/15 22:00:00,4,49,-45
23107,23107,214,2022/4/15 22:10:00,2,41,-39
23108,23108,214,2022/4/15 22:20:00,2,53,-51
23109,23109,214,2022/4/15 22:30:00,1,40,-39
23110,23110,214,2022/4/15 22:40:00,0,46,-46
23111,23111,214,2022/4/15 22:50:00,0,40,-40
23112,23112,215,2022/4/15 5:00:00,0,1,-1
23113,23113,215,2022/4/15 5:10:00,0,1,-1
23114,23114,215,2022/4/15 5:20:00,0,1,-1
23115,23115,215,2022/4/15 5:30:00,11,1,10
23116,23116,215,2022/4/15 5:40:00,22,1,21
23117,23117,215,2022/4/15 5:50:00,27,5,22
23118,23118,215,2022/4/15 6:00:00,38,6,32
23119,23119,215,2022/4/15 6:10:00,39,38,1
23120,23120,215,2022/4/15 6:20:00,54,29,25
23121,23121,215,2022/4/15 6:30:00,69,63,6
23122,23122,215,2022/4/15 6:40:00,87,77,10
23123,23123,215,2022/4/15 6:50:00,99,93,6
23124,23124,215,2022/4/15 7:00:00,194,90,104
23125,23125,215,2022/4/15 7:10:00,236,105,131
23126,23126,215,2022/4/15 7:20:00,278,123,155
23127,23127,215,2022/4/15 7:30:00,393,110,283
23128,23128,215,2022/4/15 7:40:00,596,120,476
23129,23129,215,2022/4/15 7:50:00,662,144,518
23130,23130,215,2022/4/15 8:00:00,654,193,461
23131,23131,215,2022/4/15 8:10:00,664,233,431
23132,23132,215,2022/4/15 8:20:00,389,223,166
23133,23133,215,2022/4/15 8:30:00,276,233,43
23134,23134,215,2022/4/15 8:40:00,283,234,49
23135,23135,215,2022/4/15 8:50:00,216,180,36
23136,23136,215,2022/4/15 9:00:00,177,112,65
23137,23137,215,2022/4/15 9:10:00,140,133,7
23138,23138,215,2022/4/15 9:20:00,71,125,-54
23139,23139,215,2022/4/15 9:30:00,58,126,-68
23140,23140,215,2022/4/15 9:40:00,49,112,-63
23141,23141,215,2022/4/15 9:50:00,45,105,-60
23142,23142,215,2022/4/15 10:00:00,41,94,-53
23143,23143,215,2022/4/15 10:10:00,36,90,-54
23144,23144,215,2022/4/15 10:20:00,33,93,-60
23145,23145,215,2022/4/15 10:30:00,39,91,-52
23146,23146,215,2022/4/15 10:40:00,38,98,-60
23147,23147,215,2022/4/15 10:50:00,37,87,-50
23148,23148,215,2022/4/15 11:00:00,34,76,-42
23149,23149,215,2022/4/15 11:10:00,37,87,-50
23150,23150,215,2022/4/15 11:20:00,38,100,-62
23151,23151,215,2022/4/15 11:30:00,35,93,-58
23152,23152,215,2022/4/15 11:40:00,36,77,-41
23153,23153,215,2022/4/15 11:50:00,38,75,-37
23154,23154,215,2022/4/15 12:00:00,44,93,-49
23155,23155,215,2022/4/15 12:10:00,40,97,-57
23156,23156,215,2022/4/15 12:20:00,43,99,-56
23157,23157,215,2022/4/15 12:30:00,44,90,-46
23158,23158,215,2022/4/15 12:40:00,45,99,-54
23159,23159,215,2022/4/15 12:50:00,43,108,-65
23160,23160,215,2022/4/15 13:00:00,43,101,-58
23161,23161,215,2022/4/15 13:10:00,45,93,-48
23162,23162,215,2022/4/15 13:20:00,35,91,-56
23163,23163,215,2022/4/15 13:30:00,41,93,-52
23164,23164,215,2022/4/15 13:40:00,41,109,-68
23165,23165,215,2022/4/15 13:50:00,37,97,-60
23166,23166,215,2022/4/15 14:00:00,37,90,-53
23167,23167,215,2022/4/15 14:10:00,41,101,-60
23168,23168,215,2022/4/15 14:20:00,42,101,-59
23169,23169,215,2022/4/15 14:30:00,38,93,-55
23170,23170,215,2022/4/15 14:40:00,32,97,-65
23171,23171,215,2022/4/15 14:50:00,41,93,-52
23172,23172,215,2022/4/15 15:00:00,42,101,-59
23173,23173,215,2022/4/15 15:10:00,47,111,-64
23174,23174,215,2022/4/15 15:20:00,42,102,-60
23175,23175,215,2022/4/15 15:30:00,43,96,-53
23176,23176,215,2022/4/15 15:40:00,59,103,-44
23177,23177,215,2022/4/15 15:50:00,46,108,-62
23178,23178,215,2022/4/15 16:00:00,63,102,-39
23179,23179,215,2022/4/15 16:10:00,41,101,-60
23180,23180,215,2022/4/15 16:20:00,54,101,-47
23181,23181,215,2022/4/15 16:30:00,69,123,-54
23182,23182,215,2022/4/15 16:40:00,70,125,-55
23183,23183,215,2022/4/15 16:50:00,77,113,-36
23184,23184,215,2022/4/15 17:00:00,140,124,16
23185,23185,215,2022/4/15 17:10:00,174,107,67
23186,23186,215,2022/4/15 17:20:00,137,108,29
23187,23187,215,2022/4/15 17:30:00,143,177,-34
23188,23188,215,2022/4/15 17:40:00,175,212,-37
23189,23189,215,2022/4/15 17:50:00,160,207,-47
23190,23190,215,2022/4/15 18:00:00,150,268,-118
23191,23191,215,2022/4/15 18:10:00,176,327,-151
23192,23192,215,2022/4/15 18:20:00,175,326,-151
23193,23193,215,2022/4/15 18:30:00,109,335,-226
23194,23194,215,2022/4/15 18:40:00,128,320,-192
23195,23195,215,2022/4/15 18:50:00,64,269,-205
23196,23196,215,2022/4/15 19:00:00,57,270,-213
23197,23197,215,2022/4/15 19:10:00,54,234,-180
23198,23198,215,2022/4/15 19:20:00,45,192,-147
23199,23199,215,2022/4/15 19:30:00,39,170,-131
23200,23200,215,2022/4/15 19:40:00,39,108,-69
23201,23201,215,2022/4/15 19:50:00,41,124,-83
23202,23202,215,2022/4/15 20:00:00,45,123,-78
23203,23203,215,2022/4/15 20:10:00,44,124,-80
23204,23204,215,2022/4/15 20:20:00,39,116,-77
23205,23205,215,2022/4/15 20:30:00,40,109,-69
23206,23206,215,2022/4/15 20:40:00,39,115,-76
23207,23207,215,2022/4/15 20:50:00,43,107,-64
23208,23208,215,2022/4/15 21:00:00,44,106,-62
23209,23209,215,2022/4/15 21:10:00,43,112,-69
23210,23210,215,2022/4/15 21:20:00,31,105,-74
23211,23211,215,2022/4/15 21:30:00,32,107,-75
23212,23212,215,2022/4/15 21:40:00,29,107,-78
23213,23213,215,2022/4/15 21:50:00,25,82,-57
23214,23214,215,2022/4/15 22:00:00,29,106,-77
23215,23215,215,2022/4/15 22:10:00,25,103,-78
23216,23216,215,2022/4/15 22:20:00,14,76,-62
23217,23217,215,2022/4/15 22:30:00,11,104,-93
23218,23218,215,2022/4/15 22:40:00,5,76,-71
23219,23219,215,2022/4/15 22:50:00,2,70,-68
23220,23220,216,2022/4/15 5:00:00,0,1,-1
23221,23221,216,2022/4/15 5:10:00,0,1,-1
23222,23222,216,2022/4/15 5:20:00,0,1,-1
23223,23223,216,2022/4/15 5:30:00,17,1,16
23224,23224,216,2022/4/15 5:40:00,29,1,28
23225,23225,216,2022/4/15 5:50:00,20,1,19
23226,23226,216,2022/4/15 6:00:00,34,1,33
23227,23227,216,2022/4/15 6:10:00,37,21,16
23228,23228,216,2022/4/15 6:20:00,43,31,12
23229,23229,216,2022/4/15 6:30:00,69,23,46
23230,23230,216,2022/4/15 6:40:00,75,23,52
23231,23231,216,2022/4/15 6:50:00,88,38,50
23232,23232,216,2022/4/15 7:00:00,152,47,105
23233,23233,216,2022/4/15 7:10:00,227,47,180
23234,23234,216,2022/4/15 7:20:00,244,57,187
23235,23235,216,2022/4/15 7:30:00,303,59,244
23236,23236,216,2022/4/15 7:40:00,339,68,271
23237,23237,216,2022/4/15 7:50:00,324,72,252
23238,23238,216,2022/4/15 8:00:00,337,77,260
23239,23239,216,2022/4/15 8:10:00,356,72,284
23240,23240,216,2022/4/15 8:20:00,277,85,192
23241,23241,216,2022/4/15 8:30:00,233,72,161
23242,23242,216,2022/4/15 8:40:00,189,61,128
23243,23243,216,2022/4/15 8:50:00,109,52,57
23244,23244,216,2022/4/15 9:00:00,66,52,14
23245,23245,216,2022/4/15 9:10:00,52,50,2
23246,23246,216,2022/4/15 9:20:00,40,47,-7
23247,23247,216,2022/4/15 9:30:00,28,47,-19
23248,23248,216,2022/4/15 9:40:00,32,41,-9
23249,23249,216,2022/4/15 9:50:00,31,39,-8
23250,23250,216,2022/4/15 10:00:00,27,37,-10
23251,23251,216,2022/4/15 10:10:00,25,42,-17
23252,23252,216,2022/4/15 10:20:00,24,45,-21
23253,23253,216,2022/4/15 10:30:00,23,32,-9
23254,23254,216,2022/4/15 10:40:00,23,41,-18
23255,23255,216,2022/4/15 10:50:00,20,44,-24
23256,23256,216,2022/4/15 11:00:00,22,49,-27
23257,23257,216,2022/4/15 11:10:00,24,46,-22
23258,23258,216,2022/4/15 11:20:00,21,45,-24
23259,23259,216,2022/4/15 11:30:00,20,45,-25
23260,23260,216,2022/4/15 11:40:00,21,47,-26
23261,23261,216,2022/4/15 11:50:00,27,47,-20
23262,23262,216,2022/4/15 12:00:00,23,41,-18
23263,23263,216,2022/4/15 12:10:00,25,45,-20
23264,23264,216,2022/4/15 12:20:00,26,48,-22
23265,23265,216,2022/4/15 12:30:00,26,54,-28
23266,23266,216,2022/4/15 12:40:00,25,48,-23
23267,23267,216,2022/4/15 12:50:00,26,45,-19
23268,23268,216,2022/4/15 13:00:00,21,47,-26
23269,23269,216,2022/4/15 13:10:00,23,50,-27
23270,23270,216,2022/4/15 13:20:00,23,45,-22
23271,23271,216,2022/4/15 13:30:00,20,44,-24
23272,23272,216,2022/4/15 13:40:00,22,45,-23
23273,23273,216,2022/4/15 13:50:00,18,47,-29
23274,23274,216,2022/4/15 14:00:00,20,51,-31
23275,23275,216,2022/4/15 14:10:00,20,49,-29
23276,23276,216,2022/4/15 14:20:00,21,44,-23
23277,23277,216,2022/4/15 14:30:00,20,51,-31
23278,23278,216,2022/4/15 14:40:00,20,65,-45
23279,23279,216,2022/4/15 14:50:00,17,60,-43
23280,23280,216,2022/4/15 15:00:00,19,57,-38
23281,23281,216,2022/4/15 15:10:00,18,65,-47
23282,23282,216,2022/4/15 15:20:00,18,57,-39
23283,23283,216,2022/4/15 15:30:00,22,78,-56
23284,23284,216,2022/4/15 15:40:00,21,70,-49
23285,23285,216,2022/4/15 15:50:00,22,71,-49
23286,23286,216,2022/4/15 16:00:00,24,83,-59
23287,23287,216,2022/4/15 16:10:00,23,75,-52
23288,23288,216,2022/4/15 16:20:00,27,75,-48
23289,23289,216,2022/4/15 16:30:00,27,77,-50
23290,23290,216,2022/4/15 16:40:00,28,77,-49
23291,23291,216,2022/4/15 16:50:00,35,98,-63
23292,23292,216,2022/4/15 17:00:00,38,113,-75
23293,23293,216,2022/4/15 17:10:00,39,98,-59
23294,23294,216,2022/4/15 17:20:00,42,119,-77
23295,23295,216,2022/4/15 17:30:00,38,122,-84
23296,23296,216,2022/4/15 17:40:00,33,115,-82
23297,23297,216,2022/4/15 17:50:00,57,122,-65
23298,23298,216,2022/4/15 18:00:00,67,104,-37
23299,23299,216,2022/4/15 18:10:00,28,152,-124
23300,23300,216,2022/4/15 18:20:00,24,116,-92
23301,23301,216,2022/4/15 18:30:00,26,107,-81
23302,23302,216,2022/4/15 18:40:00,22,121,-99
23303,23303,216,2022/4/15 18:50:00,22,116,-94
23304,23304,216,2022/4/15 19:00:00,21,128,-107
23305,23305,216,2022/4/15 19:10:00,20,110,-90
23306,23306,216,2022/4/15 19:20:00,18,119,-101
23307,23307,216,2022/4/15 19:30:00,16,105,-89
23308,23308,216,2022/4/15 19:40:00,14,102,-88
23309,23309,216,2022/4/15 19:50:00,16,92,-76
23310,23310,216,2022/4/15 20:00:00,19,81,-62
23311,23311,216,2022/4/15 20:10:00,15,94,-79
23312,23312,216,2022/4/15 20:20:00,14,89,-75
23313,23313,216,2022/4/15 20:30:00,16,75,-59
23314,23314,216,2022/4/15 20:40:00,15,85,-70
23315,23315,216,2022/4/15 20:50:00,15,85,-70
23316,23316,216,2022/4/15 21:00:00,15,71,-56
23317,23317,216,2022/4/15 21:10:00,17,77,-60
23318,23318,216,2022/4/15 21:20:00,12,77,-65
23319,23319,216,2022/4/15 21:30:00,12,68,-56
23320,23320,216,2022/4/15 21:40:00,11,80,-69
23321,23321,216,2022/4/15 21:50:00,10,63,-53
23322,23322,216,2022/4/15 22:00:00,9,78,-69
23323,23323,216,2022/4/15 22:10:00,9,73,-64
23324,23324,216,2022/4/15 22:20:00,5,70,-65
23325,23325,216,2022/4/15 22:30:00,5,73,-68
23326,23326,216,2022/4/15 22:40:00,2,69,-67
23327,23327,216,2022/4/15 22:50:00,0,78,-78
23328,23328,217,2022/4/15 5:00:00,0,1,-1
23329,23329,217,2022/4/15 5:10:00,0,1,-1
23330,23330,217,2022/4/15 5:20:00,0,1,-1
23331,23331,217,2022/4/15 5:30:00,4,1,3
23332,23332,217,2022/4/15 5:40:00,8,1,7
23333,23333,217,2022/4/15 5:50:00,13,2,11
23334,23334,217,2022/4/15 6:00:00,20,1,19
23335,23335,217,2022/4/15 6:10:00,26,19,7
23336,23336,217,2022/4/15 6:20:00,32,19,13
23337,23337,217,2022/4/15 6:30:00,31,31,0
23338,23338,217,2022/4/15 6:40:00,41,50,-9
23339,23339,217,2022/4/15 6:50:00,57,72,-15
23340,23340,217,2022/4/15 7:00:00,60,93,-33
23341,23341,217,2022/4/15 7:10:00,58,75,-17
23342,23342,217,2022/4/15 7:20:00,78,71,7
23343,23343,217,2022/4/15 7:30:00,108,70,38
23344,23344,217,2022/4/15 7:40:00,186,75,111
23345,23345,217,2022/4/15 7:50:00,226,75,151
23346,23346,217,2022/4/15 8:00:00,244,80,164
23347,23347,217,2022/4/15 8:10:00,269,98,171
23348,23348,217,2022/4/15 8:20:00,254,99,155
23349,23349,217,2022/4/15 8:30:00,244,112,132
23350,23350,217,2022/4/15 8:40:00,170,108,62
23351,23351,217,2022/4/15 8:50:00,108,104,4
23352,23352,217,2022/4/15 9:00:00,66,92,-26
23353,23353,217,2022/4/15 9:10:00,50,83,-33
23354,23354,217,2022/4/15 9:20:00,50,68,-18
23355,23355,217,2022/4/15 9:30:00,41,64,-23
23356,23356,217,2022/4/15 9:40:00,29,58,-29
23357,23357,217,2022/4/15 9:50:00,28,50,-22
23358,23358,217,2022/4/15 10:00:00,26,45,-19
23359,23359,217,2022/4/15 10:10:00,26,52,-26
23360,23360,217,2022/4/15 10:20:00,23,42,-19
23361,23361,217,2022/4/15 10:30:00,23,45,-22
23362,23362,217,2022/4/15 10:40:00,20,49,-29
23363,23363,217,2022/4/15 10:50:00,19,46,-27
23364,23364,217,2022/4/15 11:00:00,18,38,-20
23365,23365,217,2022/4/15 11:10:00,20,40,-20
23366,23366,217,2022/4/15 11:20:00,22,45,-23
23367,23367,217,2022/4/15 11:30:00,22,51,-29
23368,23368,217,2022/4/15 11:40:00,23,55,-32
23369,23369,217,2022/4/15 11:50:00,25,50,-25
23370,23370,217,2022/4/15 12:00:00,27,50,-23
23371,23371,217,2022/4/15 12:10:00,29,50,-21
23372,23372,217,2022/4/15 12:20:00,29,54,-25
23373,23373,217,2022/4/15 12:30:00,28,66,-38
23374,23374,217,2022/4/15 12:40:00,25,64,-39
23375,23375,217,2022/4/15 12:50:00,28,67,-39
23376,23376,217,2022/4/15 13:00:00,29,51,-22
23377,23377,217,2022/4/15 13:10:00,28,61,-33
23378,23378,217,2022/4/15 13:20:00,25,51,-26
23379,23379,217,2022/4/15 13:30:00,26,42,-16
23380,23380,217,2022/4/15 13:40:00,25,48,-23
23381,23381,217,2022/4/15 13:50:00,23,59,-36
23382,23382,217,2022/4/15 14:00:00,22,50,-28
23383,23383,217,2022/4/15 14:10:00,23,51,-28
23384,23384,217,2022/4/15 14:20:00,20,52,-32
23385,23385,217,2022/4/15 14:30:00,20,50,-30
23386,23386,217,2022/4/15 14:40:00,22,51,-29
23387,23387,217,2022/4/15 14:50:00,21,54,-33
23388,23388,217,2022/4/15 15:00:00,26,57,-31
23389,23389,217,2022/4/15 15:10:00,24,52,-28
23390,23390,217,2022/4/15 15:20:00,24,57,-33
23391,23391,217,2022/4/15 15:30:00,25,60,-35
23392,23392,217,2022/4/15 15:40:00,25,72,-47
23393,23393,217,2022/4/15 15:50:00,24,60,-36
23394,23394,217,2022/4/15 16:00:00,27,72,-45
23395,23395,217,2022/4/15 16:10:00,25,70,-45
23396,23396,217,2022/4/15 16:20:00,27,71,-44
23397,23397,217,2022/4/15 16:30:00,28,65,-37
23398,23398,217,2022/4/15 16:40:00,25,69,-44
23399,23399,217,2022/4/15 16:50:00,25,81,-56
23400,23400,217,2022/4/15 17:00:00,29,93,-64
23401,23401,217,2022/4/15 17:10:00,43,112,-69
23402,23402,217,2022/4/15 17:20:00,44,104,-60
23403,23403,217,2022/4/15 17:30:00,40,104,-64
23404,23404,217,2022/4/15 17:40:00,34,107,-73
23405,23405,217,2022/4/15 17:50:00,31,115,-84
23406,23406,217,2022/4/15 18:00:00,29,111,-82
23407,23407,217,2022/4/15 18:10:00,38,133,-95
23408,23408,217,2022/4/15 18:20:00,37,111,-74
23409,23409,217,2022/4/15 18:30:00,30,110,-80
23410,23410,217,2022/4/15 18:40:00,31,124,-93
23411,23411,217,2022/4/15 18:50:00,31,125,-94
23412,23412,217,2022/4/15 19:00:00,26,129,-103
23413,23413,217,2022/4/15 19:10:00,27,110,-83
23414,23414,217,2022/4/15 19:20:00,26,108,-82
23415,23415,217,2022/4/15 19:30:00,26,95,-69
23416,23416,217,2022/4/15 19:40:00,25,82,-57
23417,23417,217,2022/4/15 19:50:00,28,77,-49
23418,23418,217,2022/4/15 20:00:00,29,73,-44
23419,23419,217,2022/4/15 20:10:00,27,79,-52
23420,23420,217,2022/4/15 20:20:00,26,75,-49
23421,23421,217,2022/4/15 20:30:00,20,65,-45
23422,23422,217,2022/4/15 20:40:00,21,85,-64
23423,23423,217,2022/4/15 20:50:00,23,72,-49
23424,23424,217,2022/4/15 21:00:00,26,75,-49
23425,23425,217,2022/4/15 21:10:00,24,79,-55
23426,23426,217,2022/4/15 21:20:00,18,79,-61
23427,23427,217,2022/4/15 21:30:00,22,74,-52
23428,23428,217,2022/4/15 21:40:00,21,87,-66
23429,23429,217,2022/4/15 21:50:00,13,74,-61
23430,23430,217,2022/4/15 22:00:00,14,68,-54
23431,23431,217,2022/4/15 22:10:00,11,64,-53
23432,23432,217,2022/4/15 22:20:00,9,55,-46
23433,23433,217,2022/4/15 22:30:00,4,68,-64
23434,23434,217,2022/4/15 22:40:00,5,41,-36
23435,23435,217,2022/4/15 22:50:00,4,41,-37
23436,23436,218,2022/4/15 5:00:00,0,1,-1
23437,23437,218,2022/4/15 5:10:00,0,1,-1
23438,23438,218,2022/4/15 5:20:00,0,1,-1
23439,23439,218,2022/4/15 5:30:00,12,1,11
23440,23440,218,2022/4/15 5:40:00,13,6,7
23441,23441,218,2022/4/15 5:50:00,18,6,12
23442,23442,218,2022/4/15 6:00:00,22,8,14
23443,23443,218,2022/4/15 6:10:00,30,21,9
23444,23444,218,2022/4/15 6:20:00,38,22,16
23445,23445,218,2022/4/15 6:30:00,38,31,7
23446,23446,218,2022/4/15 6:40:00,61,60,1
23447,23447,218,2022/4/15 6:50:00,66,67,-1
23448,23448,218,2022/4/15 7:00:00,68,99,-31
23449,23449,218,2022/4/15 7:10:00,89,90,-1
23450,23450,218,2022/4/15 7:20:00,149,101,48
23451,23451,218,2022/4/15 7:30:00,199,125,74
23452,23452,218,2022/4/15 7:40:00,246,138,108
23453,23453,218,2022/4/15 7:50:00,282,192,90
23454,23454,218,2022/4/15 8:00:00,285,119,166
23455,23455,218,2022/4/15 8:10:00,317,137,180
23456,23456,218,2022/4/15 8:20:00,277,232,45
23457,23457,218,2022/4/15 8:30:00,280,297,-17
23458,23458,218,2022/4/15 8:40:00,238,383,-145
23459,23459,218,2022/4/15 8:50:00,181,317,-136
23460,23460,218,2022/4/15 9:00:00,86,180,-94
23461,23461,218,2022/4/15 9:10:00,52,144,-92
23462,23462,218,2022/4/15 9:20:00,51,126,-75
23463,23463,218,2022/4/15 9:30:00,37,112,-75
23464,23464,218,2022/4/15 9:40:00,25,87,-62
23465,23465,218,2022/4/15 9:50:00,33,71,-38
23466,23466,218,2022/4/15 10:00:00,28,72,-44
23467,23467,218,2022/4/15 10:10:00,28,71,-43
23468,23468,218,2022/4/15 10:20:00,27,59,-32
23469,23469,218,2022/4/15 10:30:00,26,59,-33
23470,23470,218,2022/4/15 10:40:00,24,59,-35
23471,23471,218,2022/4/15 10:50:00,26,64,-38
23472,23472,218,2022/4/15 11:00:00,25,67,-42
23473,23473,218,2022/4/15 11:10:00,27,48,-21
23474,23474,218,2022/4/15 11:20:00,26,63,-37
23475,23475,218,2022/4/15 11:30:00,25,51,-26
23476,23476,218,2022/4/15 11:40:00,29,62,-33
23477,23477,218,2022/4/15 11:50:00,28,62,-34
23478,23478,218,2022/4/15 12:00:00,29,55,-26
23479,23479,218,2022/4/15 12:10:00,27,58,-31
23480,23480,218,2022/4/15 12:20:00,28,63,-35
23481,23481,218,2022/4/15 12:30:00,29,62,-33
23482,23482,218,2022/4/15 12:40:00,26,69,-43
23483,23483,218,2022/4/15 12:50:00,26,75,-49
23484,23484,218,2022/4/15 13:00:00,25,73,-48
23485,23485,218,2022/4/15 13:10:00,22,71,-49
23486,23486,218,2022/4/15 13:20:00,26,72,-46
23487,23487,218,2022/4/15 13:30:00,27,69,-42
23488,23488,218,2022/4/15 13:40:00,28,65,-37
23489,23489,218,2022/4/15 13:50:00,25,62,-37
23490,23490,218,2022/4/15 14:00:00,27,67,-40
23491,23491,218,2022/4/15 14:10:00,29,61,-32
23492,23492,218,2022/4/15 14:20:00,24,61,-37
23493,23493,218,2022/4/15 14:30:00,27,64,-37
23494,23494,218,2022/4/15 14:40:00,26,72,-46
23495,23495,218,2022/4/15 14:50:00,26,71,-45
23496,23496,218,2022/4/15 15:00:00,28,66,-38
23497,23497,218,2022/4/15 15:10:00,27,64,-37
23498,23498,218,2022/4/15 15:20:00,28,65,-37
23499,23499,218,2022/4/15 15:30:00,30,77,-47
23500,23500,218,2022/4/15 15:40:00,26,73,-47
23501,23501,218,2022/4/15 15:50:00,27,62,-35
23502,23502,218,2022/4/15 16:00:00,27,71,-44
23503,23503,218,2022/4/15 16:10:00,30,77,-47
23504,23504,218,2022/4/15 16:20:00,28,70,-42
23505,23505,218,2022/4/15 16:30:00,30,96,-66
23506,23506,218,2022/4/15 16:40:00,37,77,-40
23507,23507,218,2022/4/15 16:50:00,29,104,-75
23508,23508,218,2022/4/15 17:00:00,220,109,111
23509,23509,218,2022/4/15 17:10:00,268,109,159
23510,23510,218,2022/4/15 17:20:00,137,102,35
23511,23511,218,2022/4/15 17:30:00,274,117,157
23512,23512,218,2022/4/15 17:40:00,265,116,149
23513,23513,218,2022/4/15 17:50:00,143,123,20
23514,23514,218,2022/4/15 18:00:00,168,109,59
23515,23515,218,2022/4/15 18:10:00,206,137,69
23516,23516,218,2022/4/15 18:20:00,137,145,-8
23517,23517,218,2022/4/15 18:30:00,85,152,-67
23518,23518,218,2022/4/15 18:40:00,72,121,-49
23519,23519,218,2022/4/15 18:50:00,39,118,-79
23520,23520,218,2022/4/15 19:00:00,38,111,-73
23521,23521,218,2022/4/15 19:10:00,39,122,-83
23522,23522,218,2022/4/15 19:20:00,34,89,-55
23523,23523,218,2022/4/15 19:30:00,28,102,-74
23524,23524,218,2022/4/15 19:40:00,30,92,-62
23525,23525,218,2022/4/15 19:50:00,26,92,-66
23526,23526,218,2022/4/15 20:00:00,28,77,-49
23527,23527,218,2022/4/15 20:10:00,27,78,-51
23528,23528,218,2022/4/15 20:20:00,29,69,-40
23529,23529,218,2022/4/15 20:30:00,29,77,-48
23530,23530,218,2022/4/15 20:40:00,37,76,-39
23531,23531,218,2022/4/15 20:50:00,31,79,-48
23532,23532,218,2022/4/15 21:00:00,25,72,-47
23533,23533,218,2022/4/15 21:10:00,35,79,-44
23534,23534,218,2022/4/15 21:20:00,33,83,-50
23535,23535,218,2022/4/15 21:30:00,38,72,-34
23536,23536,218,2022/4/15 21:40:00,28,77,-49
23537,23537,218,2022/4/15 21:50:00,22,77,-55
23538,23538,218,2022/4/15 22:00:00,21,74,-53
23539,23539,218,2022/4/15 22:10:00,18,71,-53
23540,23540,218,2022/4/15 22:20:00,12,75,-63
23541,23541,218,2022/4/15 22:30:00,7,59,-52
23542,23542,218,2022/4/15 22:40:00,2,68,-66
23543,23543,218,2022/4/15 22:50:00,2,29,-27
23544,23544,219,2022/4/15 5:00:00,0,1,-1
23545,23545,219,2022/4/15 5:10:00,1,1,0
23546,23546,219,2022/4/15 5:20:00,7,1,6
23547,23547,219,2022/4/15 5:30:00,13,1,12
23548,23548,219,2022/4/15 5:40:00,10,1,9
23549,23549,219,2022/4/15 5:50:00,16,1,15
23550,23550,219,2022/4/15 6:00:00,25,1,24
23551,23551,219,2022/4/15 6:10:00,35,1,34
23552,23552,219,2022/4/15 6:20:00,57,11,46
23553,23553,219,2022/4/15 6:30:00,68,45,23
23554,23554,219,2022/4/15 6:40:00,85,93,-8
23555,23555,219,2022/4/15 6:50:00,128,111,17
23556,23556,219,2022/4/15 7:00:00,174,110,64
23557,23557,219,2022/4/15 7:10:00,188,85,103
23558,23558,219,2022/4/15 7:20:00,244,45,199
23559,23559,219,2022/4/15 7:30:00,278,38,240
23560,23560,219,2022/4/15 7:40:00,327,63,264
23561,23561,219,2022/4/15 7:50:00,386,50,336
23562,23562,219,2022/4/15 8:00:00,597,41,556
23563,23563,219,2022/4/15 8:10:00,597,63,534
23564,23564,219,2022/4/15 8:20:00,339,55,284
23565,23565,219,2022/4/15 8:30:00,279,63,216
23566,23566,219,2022/4/15 8:40:00,241,74,167
23567,23567,219,2022/4/15 8:50:00,179,72,107
23568,23568,219,2022/4/15 9:00:00,76,66,10
23569,23569,219,2022/4/15 9:10:00,66,62,4
23570,23570,219,2022/4/15 9:20:00,50,57,-7
23571,23571,219,2022/4/15 9:30:00,41,45,-4
23572,23572,219,2022/4/15 9:40:00,36,58,-22
23573,23573,219,2022/4/15 9:50:00,25,56,-31
23574,23574,219,2022/4/15 10:00:00,29,54,-25
23575,23575,219,2022/4/15 10:10:00,26,45,-19
23576,23576,219,2022/4/15 10:20:00,23,47,-24
23577,23577,219,2022/4/15 10:30:00,24,42,-18
23578,23578,219,2022/4/15 10:40:00,23,48,-25
23579,23579,219,2022/4/15 10:50:00,19,41,-22
23580,23580,219,2022/4/15 11:00:00,21,50,-29
23581,23581,219,2022/4/15 11:10:00,23,46,-23
23582,23582,219,2022/4/15 11:20:00,20,50,-30
23583,23583,219,2022/4/15 11:30:00,17,51,-34
23584,23584,219,2022/4/15 11:40:00,21,41,-20
23585,23585,219,2022/4/15 11:50:00,23,47,-24
23586,23586,219,2022/4/15 12:00:00,23,38,-15
23587,23587,219,2022/4/15 12:10:00,27,47,-20
23588,23588,219,2022/4/15 12:20:00,25,38,-13
23589,23589,219,2022/4/15 12:30:00,28,50,-22
23590,23590,219,2022/4/15 12:40:00,23,51,-28
23591,23591,219,2022/4/15 12:50:00,25,62,-37
23592,23592,219,2022/4/15 13:00:00,25,60,-35
23593,23593,219,2022/4/15 13:10:00,24,45,-21
23594,23594,219,2022/4/15 13:20:00,22,45,-23
23595,23595,219,2022/4/15 13:30:00,18,42,-24
23596,23596,219,2022/4/15 13:40:00,22,48,-26
23597,23597,219,2022/4/15 13:50:00,21,48,-27
23598,23598,219,2022/4/15 14:00:00,23,46,-23
23599,23599,219,2022/4/15 14:10:00,20,51,-31
23600,23600,219,2022/4/15 14:20:00,14,69,-55
23601,23601,219,2022/4/15 14:30:00,16,59,-43
23602,23602,219,2022/4/15 14:40:00,19,63,-44
23603,23603,219,2022/4/15 14:50:00,22,56,-34
23604,23604,219,2022/4/15 15:00:00,20,61,-41
23605,23605,219,2022/4/15 15:10:00,21,65,-44
23606,23606,219,2022/4/15 15:20:00,23,70,-47
23607,23607,219,2022/4/15 15:30:00,21,73,-52
23608,23608,219,2022/4/15 15:40:00,23,70,-47
23609,23609,219,2022/4/15 15:50:00,23,79,-56
23610,23610,219,2022/4/15 16:00:00,23,80,-57
23611,23611,219,2022/4/15 16:10:00,22,68,-46
23612,23612,219,2022/4/15 16:20:00,24,82,-58
23613,23613,219,2022/4/15 16:30:00,37,79,-42
23614,23614,219,2022/4/15 16:40:00,68,90,-22
23615,23615,219,2022/4/15 16:50:00,67,106,-39
23616,23616,219,2022/4/15 17:00:00,40,93,-53
23617,23617,219,2022/4/15 17:10:00,33,105,-72
23618,23618,219,2022/4/15 17:20:00,30,109,-79
23619,23619,219,2022/4/15 17:30:00,26,125,-99
23620,23620,219,2022/4/15 17:40:00,48,103,-55
23621,23621,219,2022/4/15 17:50:00,29,118,-89
23622,23622,219,2022/4/15 18:00:00,28,150,-122
23623,23623,219,2022/4/15 18:10:00,28,146,-118
23624,23624,219,2022/4/15 18:20:00,21,159,-138
23625,23625,219,2022/4/15 18:30:00,21,150,-129
23626,23626,219,2022/4/15 18:40:00,16,180,-164
23627,23627,219,2022/4/15 18:50:00,15,329,-314
23628,23628,219,2022/4/15 19:00:00,14,180,-166
23629,23629,219,2022/4/15 19:10:00,14,110,-96
23630,23630,219,2022/4/15 19:20:00,12,117,-105
23631,23631,219,2022/4/15 19:30:00,14,112,-98
23632,23632,219,2022/4/15 19:40:00,16,95,-79
23633,23633,219,2022/4/15 19:50:00,11,95,-84
23634,23634,219,2022/4/15 20:00:00,11,81,-70
23635,23635,219,2022/4/15 20:10:00,13,95,-82
23636,23636,219,2022/4/15 20:20:00,13,112,-99
23637,23637,219,2022/4/15 20:30:00,13,80,-67
23638,23638,219,2022/4/15 20:40:00,12,75,-63
23639,23639,219,2022/4/15 20:50:00,13,85,-72
23640,23640,219,2022/4/15 21:00:00,13,79,-66
23641,23641,219,2022/4/15 21:10:00,13,91,-78
23642,23642,219,2022/4/15 21:20:00,8,77,-69
23643,23643,219,2022/4/15 21:30:00,8,69,-61
23644,23644,219,2022/4/15 21:40:00,10,77,-67
23645,23645,219,2022/4/15 21:50:00,8,79,-71
23646,23646,219,2022/4/15 22:00:00,6,67,-61
23647,23647,219,2022/4/15 22:10:00,6,71,-65
23648,23648,219,2022/4/15 22:20:00,4,66,-62
23649,23649,219,2022/4/15 22:30:00,2,64,-62
23650,23650,219,2022/4/15 22:40:00,0,40,-40
23651,23651,219,2022/4/15 22:50:00,0,47,-47
23652,23652,220,2022/4/15 5:00:00,0,1,-1
23653,23653,220,2022/4/15 5:10:00,0,1,-1
23654,23654,220,2022/4/15 5:20:00,0,1,-1
23655,23655,220,2022/4/15 5:30:00,0,1,-1
23656,23656,220,2022/4/15 5:40:00,6,1,5
23657,23657,220,2022/4/15 5:50:00,15,1,14
23658,23658,220,2022/4/15 6:00:00,21,11,10
23659,23659,220,2022/4/15 6:10:00,31,10,21
23660,23660,220,2022/4/15 6:20:00,32,21,11
23661,23661,220,2022/4/15 6:30:00,41,47,-6
23662,23662,220,2022/4/15 6:40:00,41,63,-22
23663,23663,220,2022/4/15 6:50:00,57,93,-36
23664,23664,220,2022/4/15 7:00:00,58,115,-57
23665,23665,220,2022/4/15 7:10:00,69,158,-89
23666,23666,220,2022/4/15 7:20:00,76,197,-121
23667,23667,220,2022/4/15 7:30:00,147,109,38
23668,23668,220,2022/4/15 7:40:00,206,110,96
23669,23669,220,2022/4/15 7:50:00,223,111,112
23670,23670,220,2022/4/15 8:00:00,206,114,92
23671,23671,220,2022/4/15 8:10:00,186,198,-12
23672,23672,220,2022/4/15 8:20:00,151,192,-41
23673,23673,220,2022/4/15 8:30:00,149,109,40
23674,23674,220,2022/4/15 8:40:00,91,128,-37
23675,23675,220,2022/4/15 8:50:00,70,119,-49
23676,23676,220,2022/4/15 9:00:00,61,126,-65
23677,23677,220,2022/4/15 9:10:00,49,108,-59
23678,23678,220,2022/4/15 9:20:00,44,93,-49
23679,23679,220,2022/4/15 9:30:00,39,80,-41
23680,23680,220,2022/4/15 9:40:00,33,77,-44
23681,23681,220,2022/4/15 9:50:00,31,62,-31
23682,23682,220,2022/4/15 10:00:00,29,66,-37
23683,23683,220,2022/4/15 10:10:00,35,66,-31
23684,23684,220,2022/4/15 10:20:00,27,65,-38
23685,23685,220,2022/4/15 10:30:00,29,60,-31
23686,23686,220,2022/4/15 10:40:00,29,63,-34
23687,23687,220,2022/4/15 10:50:00,27,62,-35
23688,23688,220,2022/4/15 11:00:00,28,55,-27
23689,23689,220,2022/4/15 11:10:00,29,64,-35
23690,23690,220,2022/4/15 11:20:00,28,55,-27
23691,23691,220,2022/4/15 11:30:00,29,52,-23
23692,23692,220,2022/4/15 11:40:00,27,55,-28
23693,23693,220,2022/4/15 11:50:00,27,66,-39
23694,23694,220,2022/4/15 12:00:00,26,59,-33
23695,23695,220,2022/4/15 12:10:00,28,68,-40
23696,23696,220,2022/4/15 12:20:00,27,61,-34
23697,23697,220,2022/4/15 12:30:00,25,69,-44
23698,23698,220,2022/4/15 12:40:00,23,67,-44
23699,23699,220,2022/4/15 12:50:00,21,68,-47
23700,23700,220,2022/4/15 13:00:00,25,73,-48
23701,23701,220,2022/4/15 13:10:00,31,68,-37
23702,23702,220,2022/4/15 13:20:00,24,61,-37
23703,23703,220,2022/4/15 13:30:00,29,72,-43
23704,23704,220,2022/4/15 13:40:00,26,67,-41
23705,23705,220,2022/4/15 13:50:00,22,69,-47
23706,23706,220,2022/4/15 14:00:00,22,66,-44
23707,23707,220,2022/4/15 14:10:00,21,71,-50
23708,23708,220,2022/4/15 14:20:00,25,72,-47
23709,23709,220,2022/4/15 14:30:00,25,67,-42
23710,23710,220,2022/4/15 14:40:00,57,64,-7
23711,23711,220,2022/4/15 14:50:00,45,71,-26
23712,23712,220,2022/4/15 15:00:00,35,68,-33
23713,23713,220,2022/4/15 15:10:00,41,72,-31
23714,23714,220,2022/4/15 15:20:00,31,71,-40
23715,23715,220,2022/4/15 15:30:00,36,68,-32
23716,23716,220,2022/4/15 15:40:00,45,75,-30
23717,23717,220,2022/4/15 15:50:00,69,76,-7
23718,23718,220,2022/4/15 16:00:00,63,76,-13
23719,23719,220,2022/4/15 16:10:00,76,76,0
23720,23720,220,2022/4/15 16:20:00,45,97,-52
23721,23721,220,2022/4/15 16:30:00,43,97,-54
23722,23722,220,2022/4/15 16:40:00,72,76,-4
23723,23723,220,2022/4/15 16:50:00,56,93,-37
23724,23724,220,2022/4/15 17:00:00,210,102,108
23725,23725,220,2022/4/15 17:10:00,221,104,117
23726,23726,220,2022/4/15 17:20:00,162,109,53
23727,23727,220,2022/4/15 17:30:00,148,122,26
23728,23728,220,2022/4/15 17:40:00,176,110,66
23729,23729,220,2022/4/15 17:50:00,70,120,-50
23730,23730,220,2022/4/15 18:00:00,74,110,-36
23731,23731,220,2022/4/15 18:10:00,71,121,-50
23732,23732,220,2022/4/15 18:20:00,44,113,-69
23733,23733,220,2022/4/15 18:30:00,38,116,-78
23734,23734,220,2022/4/15 18:40:00,30,104,-74
23735,23735,220,2022/4/15 18:50:00,31,113,-82
23736,23736,220,2022/4/15 19:00:00,34,110,-76
23737,23737,220,2022/4/15 19:10:00,27,122,-95
23738,23738,220,2022/4/15 19:20:00,28,103,-75
23739,23739,220,2022/4/15 19:30:00,28,106,-78
23740,23740,220,2022/4/15 19:40:00,28,95,-67
23741,23741,220,2022/4/15 19:50:00,25,78,-53
23742,23742,220,2022/4/15 20:00:00,26,83,-57
23743,23743,220,2022/4/15 20:10:00,25,79,-54
23744,23744,220,2022/4/15 20:20:00,23,78,-55
23745,23745,220,2022/4/15 20:30:00,27,79,-52
23746,23746,220,2022/4/15 20:40:00,26,64,-38
23747,23747,220,2022/4/15 20:50:00,25,84,-59
23748,23748,220,2022/4/15 21:00:00,27,76,-49
23749,23749,220,2022/4/15 21:10:00,26,75,-49
23750,23750,220,2022/4/15 21:20:00,20,79,-59
23751,23751,220,2022/4/15 21:30:00,22,83,-61
23752,23752,220,2022/4/15 21:40:00,15,62,-47
23753,23753,220,2022/4/15 21:50:00,15,83,-68
23754,23754,220,2022/4/15 22:00:00,14,65,-51
23755,23755,220,2022/4/15 22:10:00,10,83,-73
23756,23756,220,2022/4/15 22:20:00,10,63,-53
23757,23757,220,2022/4/15 22:30:00,6,49,-43
23758,23758,220,2022/4/15 22:40:00,4,55,-51
23759,23759,220,2022/4/15 22:50:00,1,46,-45
23760,23760,221,2022/4/15 5:00:00,0,1,-1
23761,23761,221,2022/4/15 5:10:00,0,1,-1
23762,23762,221,2022/4/15 5:20:00,0,1,-1
23763,23763,221,2022/4/15 5:30:00,1,1,0
23764,23764,221,2022/4/15 5:40:00,8,1,7
23765,23765,221,2022/4/15 5:50:00,10,14,-4
23766,23766,221,2022/4/15 6:00:00,19,6,13
23767,23767,221,2022/4/15 6:10:00,20,23,-3
23768,23768,221,2022/4/15 6:20:00,25,47,-22
23769,23769,221,2022/4/15 6:30:00,32,40,-8
23770,23770,221,2022/4/15 6:40:00,43,55,-12
23771,23771,221,2022/4/15 6:50:00,46,63,-17
23772,23772,221,2022/4/15 7:00:00,46,77,-31
23773,23773,221,2022/4/15 7:10:00,54,92,-38
23774,23774,221,2022/4/15 7:20:00,58,101,-43
23775,23775,221,2022/4/15 7:30:00,86,125,-39
23776,23776,221,2022/4/15 7:40:00,128,145,-17
23777,23777,221,2022/4/15 7:50:00,185,284,-99
23778,23778,221,2022/4/15 8:00:00,188,497,-309
23779,23779,221,2022/4/15 8:10:00,188,581,-393
23780,23780,221,2022/4/15 8:20:00,224,1510,-1286
23781,23781,221,2022/4/15 8:30:00,193,2839,-2646
23782,23782,221,2022/4/15 8:40:00,126,3008,-2882
23783,23783,221,2022/4/15 8:50:00,85,3300,-3215
23784,23784,221,2022/4/15 9:00:00,70,638,-568
23785,23785,221,2022/4/15 9:10:00,51,422,-371
23786,23786,221,2022/4/15 9:20:00,47,326,-279
23787,23787,221,2022/4/15 9:30:00,40,282,-242
23788,23788,221,2022/4/15 9:40:00,29,231,-202
23789,23789,221,2022/4/15 9:50:00,33,132,-99
23790,23790,221,2022/4/15 10:00:00,31,102,-71
23791,23791,221,2022/4/15 10:10:00,29,99,-70
23792,23792,221,2022/4/15 10:20:00,33,80,-47
23793,23793,221,2022/4/15 10:30:00,30,93,-63
23794,23794,221,2022/4/15 10:40:00,33,83,-50
23795,23795,221,2022/4/15 10:50:00,28,83,-55
23796,23796,221,2022/4/15 11:00:00,32,67,-35
23797,23797,221,2022/4/15 11:10:00,30,80,-50
23798,23798,221,2022/4/15 11:20:00,27,61,-34
23799,23799,221,2022/4/15 11:30:00,31,83,-52
23800,23800,221,2022/4/15 11:40:00,37,64,-27
23801,23801,221,2022/4/15 11:50:00,37,67,-30
23802,23802,221,2022/4/15 12:00:00,39,75,-36
23803,23803,221,2022/4/15 12:10:00,35,70,-35
23804,23804,221,2022/4/15 12:20:00,35,73,-38
23805,23805,221,2022/4/15 12:30:00,39,83,-44
23806,23806,221,2022/4/15 12:40:00,37,90,-53
23807,23807,221,2022/4/15 12:50:00,37,81,-44
23808,23808,221,2022/4/15 13:00:00,37,75,-38
23809,23809,221,2022/4/15 13:10:00,37,83,-46
23810,23810,221,2022/4/15 13:20:00,32,76,-44
23811,23811,221,2022/4/15 13:30:00,31,93,-62
23812,23812,221,2022/4/15 13:40:00,35,75,-40
23813,23813,221,2022/4/15 13:50:00,31,77,-46
23814,23814,221,2022/4/15 14:00:00,32,71,-39
23815,23815,221,2022/4/15 14:10:00,33,76,-43
23816,23816,221,2022/4/15 14:20:00,31,83,-52
23817,23817,221,2022/4/15 14:30:00,37,81,-44
23818,23818,221,2022/4/15 14:40:00,38,71,-33
23819,23819,221,2022/4/15 14:50:00,31,66,-35
23820,23820,221,2022/4/15 15:00:00,36,74,-38
23821,23821,221,2022/4/15 15:10:00,43,68,-25
23822,23822,221,2022/4/15 15:20:00,42,71,-29
23823,23823,221,2022/4/15 15:30:00,47,68,-21
23824,23824,221,2022/4/15 15:40:00,35,77,-42
23825,23825,221,2022/4/15 15:50:00,37,74,-37
23826,23826,221,2022/4/15 16:00:00,42,82,-40
23827,23827,221,2022/4/15 16:10:00,54,65,-11
23828,23828,221,2022/4/15 16:20:00,41,78,-37
23829,23829,221,2022/4/15 16:30:00,56,93,-37
23830,23830,221,2022/4/15 16:40:00,90,73,17
23831,23831,221,2022/4/15 16:50:00,76,76,0
23832,23832,221,2022/4/15 17:00:00,269,96,173
23833,23833,221,2022/4/15 17:10:00,379,108,271
23834,23834,221,2022/4/15 17:20:00,314,104,210
23835,23835,221,2022/4/15 17:30:00,544,101,443
23836,23836,221,2022/4/15 17:40:00,845,126,719
23837,23837,221,2022/4/15 17:50:00,616,105,511
23838,23838,221,2022/4/15 18:00:00,713,127,586
23839,23839,221,2022/4/15 18:10:00,1568,125,1443
23840,23840,221,2022/4/15 18:20:00,1031,110,921
23841,23841,221,2022/4/15 18:30:00,697,121,576
23842,23842,221,2022/4/15 18:40:00,581,125,456
23843,23843,221,2022/4/15 18:50:00,353,108,245
23844,23844,221,2022/4/15 19:00:00,309,110,199
23845,23845,221,2022/4/15 19:10:00,272,104,168
23846,23846,221,2022/4/15 19:20:00,235,113,122
23847,23847,221,2022/4/15 19:30:00,186,80,106
23848,23848,221,2022/4/15 19:40:00,170,79,91
23849,23849,221,2022/4/15 19:50:00,116,77,39
23850,23850,221,2022/4/15 20:00:00,85,69,16
23851,23851,221,2022/4/15 20:10:00,151,63,88
23852,23852,221,2022/4/15 20:20:00,79,70,9
23853,23853,221,2022/4/15 20:30:00,84,69,15
23854,23854,221,2022/4/15 20:40:00,86,62,24
23855,23855,221,2022/4/15 20:50:00,68,75,-7
23856,23856,221,2022/4/15 21:00:00,69,69,0
23857,23857,221,2022/4/15 21:10:00,87,68,19
23858,23858,221,2022/4/15 21:20:00,60,74,-14
23859,23859,221,2022/4/15 21:30:00,44,67,-23
23860,23860,221,2022/4/15 21:40:00,35,63,-28
23861,23861,221,2022/4/15 21:50:00,29,67,-38
23862,23862,221,2022/4/15 22:00:00,44,68,-24
23863,23863,221,2022/4/15 22:10:00,33,62,-29
23864,23864,221,2022/4/15 22:20:00,25,69,-44
23865,23865,221,2022/4/15 22:30:00,18,45,-27
23866,23866,221,2022/4/15 22:40:00,16,55,-39
23867,23867,221,2022/4/15 22:50:00,7,25,-18
23868,23868,222,2022/4/15 5:00:00,0,1,-1
23869,23869,222,2022/4/15 5:10:00,0,1,-1
23870,23870,222,2022/4/15 5:20:00,0,1,-1
23871,23871,222,2022/4/15 5:30:00,2,1,1
23872,23872,222,2022/4/15 5:40:00,6,5,1
23873,23873,222,2022/4/15 5:50:00,7,8,-1
23874,23874,222,2022/4/15 6:00:00,10,6,4
23875,23875,222,2022/4/15 6:10:00,15,46,-31
23876,23876,222,2022/4/15 6:20:00,25,29,-4
23877,23877,222,2022/4/15 6:30:00,32,50,-18
23878,23878,222,2022/4/15 6:40:00,38,48,-10
23879,23879,222,2022/4/15 6:50:00,37,75,-38
23880,23880,222,2022/4/15 7:00:00,57,93,-36
23881,23881,222,2022/4/15 7:10:00,58,101,-43
23882,23882,222,2022/4/15 7:20:00,84,109,-25
23883,23883,222,2022/4/15 7:30:00,87,121,-34
23884,23884,222,2022/4/15 7:40:00,180,104,76
23885,23885,222,2022/4/15 7:50:00,198,133,65
23886,23886,222,2022/4/15 8:00:00,189,111,78
23887,23887,222,2022/4/15 8:10:00,224,110,114
23888,23888,222,2022/4/15 8:20:00,186,124,62
23889,23889,222,2022/4/15 8:30:00,183,108,75
23890,23890,222,2022/4/15 8:40:00,156,108,48
23891,23891,222,2022/4/15 8:50:00,114,120,-6
23892,23892,222,2022/4/15 9:00:00,74,106,-32
23893,23893,222,2022/4/15 9:10:00,58,112,-54
23894,23894,222,2022/4/15 9:20:00,48,105,-57
23895,23895,222,2022/4/15 9:30:00,42,82,-40
23896,23896,222,2022/4/15 9:40:00,38,92,-54
23897,23897,222,2022/4/15 9:50:00,33,92,-59
23898,23898,222,2022/4/15 10:00:00,30,73,-43
23899,23899,222,2022/4/15 10:10:00,29,65,-36
23900,23900,222,2022/4/15 10:20:00,28,66,-38
23901,23901,222,2022/4/15 10:30:00,32,76,-44
23902,23902,222,2022/4/15 10:40:00,33,67,-34
23903,23903,222,2022/4/15 10:50:00,29,65,-36
23904,23904,222,2022/4/15 11:00:00,29,66,-37
23905,23905,222,2022/4/15 11:10:00,29,64,-35
23906,23906,222,2022/4/15 11:20:00,27,63,-36
23907,23907,222,2022/4/15 11:30:00,27,64,-37
23908,23908,222,2022/4/15 11:40:00,27,62,-35
23909,23909,222,2022/4/15 11:50:00,28,52,-24
23910,23910,222,2022/4/15 12:00:00,31,59,-28
23911,23911,222,2022/4/15 12:10:00,27,67,-40
23912,23912,222,2022/4/15 12:20:00,27,62,-35
23913,23913,222,2022/4/15 12:30:00,29,67,-38
23914,23914,222,2022/4/15 12:40:00,25,72,-47
23915,23915,222,2022/4/15 12:50:00,24,78,-54
23916,23916,222,2022/4/15 13:00:00,28,80,-52
23917,23917,222,2022/4/15 13:10:00,28,69,-41
23918,23918,222,2022/4/15 13:20:00,30,73,-43
23919,23919,222,2022/4/15 13:30:00,28,62,-34
23920,23920,222,2022/4/15 13:40:00,27,71,-44
23921,23921,222,2022/4/15 13:50:00,26,69,-43
23922,23922,222,2022/4/15 14:00:00,27,62,-35
23923,23923,222,2022/4/15 14:10:00,27,67,-40
23924,23924,222,2022/4/15 14:20:00,27,71,-44
23925,23925,222,2022/4/15 14:30:00,30,64,-34
23926,23926,222,2022/4/15 14:40:00,30,61,-31
23927,23927,222,2022/4/15 14:50:00,28,63,-35
23928,23928,222,2022/4/15 15:00:00,29,82,-53
23929,23929,222,2022/4/15 15:10:00,27,72,-45
23930,23930,222,2022/4/15 15:20:00,27,70,-43
23931,23931,222,2022/4/15 15:30:00,36,67,-31
23932,23932,222,2022/4/15 15:40:00,34,72,-38
23933,23933,222,2022/4/15 15:50:00,29,83,-54
23934,23934,222,2022/4/15 16:00:00,37,70,-33
23935,23935,222,2022/4/15 16:10:00,38,66,-28
23936,23936,222,2022/4/15 16:20:00,43,82,-39
23937,23937,222,2022/4/15 16:30:00,46,77,-31
23938,23938,222,2022/4/15 16:40:00,48,64,-16
23939,23939,222,2022/4/15 16:50:00,46,96,-50
23940,23940,222,2022/4/15 17:00:00,58,93,-35
23941,23941,222,2022/4/15 17:10:00,74,106,-32
23942,23942,222,2022/4/15 17:20:00,50,106,-56
23943,23943,222,2022/4/15 17:30:00,46,119,-73
23944,23944,222,2022/4/15 17:40:00,62,113,-51
23945,23945,222,2022/4/15 17:50:00,45,124,-79
23946,23946,222,2022/4/15 18:00:00,37,125,-88
23947,23947,222,2022/4/15 18:10:00,54,107,-53
23948,23948,222,2022/4/15 18:20:00,43,107,-64
23949,23949,222,2022/4/15 18:30:00,36,123,-87
23950,23950,222,2022/4/15 18:40:00,27,99,-72
23951,23951,222,2022/4/15 18:50:00,28,103,-75
23952,23952,222,2022/4/15 19:00:00,27,110,-83
23953,23953,222,2022/4/15 19:10:00,29,100,-71
23954,23954,222,2022/4/15 19:20:00,24,90,-66
23955,23955,222,2022/4/15 19:30:00,25,90,-65
23956,23956,222,2022/4/15 19:40:00,21,85,-64
23957,23957,222,2022/4/15 19:50:00,20,71,-51
23958,23958,222,2022/4/15 20:00:00,22,64,-42
23959,23959,222,2022/4/15 20:10:00,26,69,-43
23960,23960,222,2022/4/15 20:20:00,22,64,-42
23961,23961,222,2022/4/15 20:30:00,21,74,-53
23962,23962,222,2022/4/15 20:40:00,23,64,-41
23963,23963,222,2022/4/15 20:50:00,21,57,-36
23964,23964,222,2022/4/15 21:00:00,19,72,-53
23965,23965,222,2022/4/15 21:10:00,16,64,-48
23966,23966,222,2022/4/15 21:20:00,15,67,-52
23967,23967,222,2022/4/15 21:30:00,14,67,-53
23968,23968,222,2022/4/15 21:40:00,13,60,-47
23969,23969,222,2022/4/15 21:50:00,11,55,-44
23970,23970,222,2022/4/15 22:00:00,9,62,-53
23971,23971,222,2022/4/15 22:10:00,8,42,-34
23972,23972,222,2022/4/15 22:20:00,6,52,-46
23973,23973,222,2022/4/15 22:30:00,4,46,-42
23974,23974,222,2022/4/15 22:40:00,2,40,-38
23975,23975,222,2022/4/15 22:50:00,2,25,-23
23976,23976,223,2022/4/15 5:00:00,0,1,-1
23977,23977,223,2022/4/15 5:10:00,2,1,1
23978,23978,223,2022/4/15 5:20:00,11,1,10
23979,23979,223,2022/4/15 5:30:00,12,1,11
23980,23980,223,2022/4/15 5:40:00,13,1,12
23981,23981,223,2022/4/15 5:50:00,19,1,18
23982,23982,223,2022/4/15 6:00:00,24,1,23
23983,23983,223,2022/4/15 6:10:00,32,2,30
23984,23984,223,2022/4/15 6:20:00,53,6,47
23985,23985,223,2022/4/15 6:30:00,63,38,25
23986,23986,223,2022/4/15 6:40:00,77,45,32
23987,23987,223,2022/4/15 6:50:00,85,41,44
23988,23988,223,2022/4/15 7:00:00,170,49,121
23989,23989,223,2022/4/15 7:10:00,174,67,107
23990,23990,223,2022/4/15 7:20:00,185,65,120
23991,23991,223,2022/4/15 7:30:00,256,71,185
23992,23992,223,2022/4/15 7:40:00,278,91,187
23993,23993,223,2022/4/15 7:50:00,349,73,276
23994,23994,223,2022/4/15 8:00:00,345,69,276
23995,23995,223,2022/4/15 8:10:00,475,87,388
23996,23996,223,2022/4/15 8:20:00,357,75,282
23997,23997,223,2022/4/15 8:30:00,280,65,215
23998,23998,223,2022/4/15 8:40:00,215,83,132
23999,23999,223,2022/4/15 8:50:00,152,67,85
24000,24000,223,2022/4/15 9:00:00,75,50,25
24001,24001,223,2022/4/15 9:10:00,57,65,-8
24002,24002,223,2022/4/15 9:20:00,45,45,0
24003,24003,223,2022/4/15 9:30:00,34,49,-15
24004,24004,223,2022/4/15 9:40:00,31,46,-15
24005,24005,223,2022/4/15 9:50:00,30,45,-15
24006,24006,223,2022/4/15 10:00:00,30,46,-16
24007,24007,223,2022/4/15 10:10:00,29,47,-18
24008,24008,223,2022/4/15 10:20:00,25,49,-24
24009,24009,223,2022/4/15 10:30:00,25,46,-21
24010,24010,223,2022/4/15 10:40:00,22,48,-26
24011,24011,223,2022/4/15 10:50:00,22,57,-35
24012,24012,223,2022/4/15 11:00:00,23,45,-22
24013,24013,223,2022/4/15 11:10:00,23,45,-22
24014,24014,223,2022/4/15 11:20:00,22,47,-25
24015,24015,223,2022/4/15 11:30:00,19,38,-19
24016,24016,223,2022/4/15 11:40:00,24,45,-21
24017,24017,223,2022/4/15 11:50:00,25,51,-26
24018,24018,223,2022/4/15 12:00:00,29,47,-18
24019,24019,223,2022/4/15 12:10:00,29,51,-22
24020,24020,223,2022/4/15 12:20:00,28,62,-34
24021,24021,223,2022/4/15 12:30:00,29,48,-19
24022,24022,223,2022/4/15 12:40:00,28,46,-18
24023,24023,223,2022/4/15 12:50:00,26,48,-22
24024,24024,223,2022/4/15 13:00:00,24,42,-18
24025,24025,223,2022/4/15 13:10:00,24,48,-24
24026,24026,223,2022/4/15 13:20:00,23,49,-26
24027,24027,223,2022/4/15 13:30:00,24,47,-23
24028,24028,223,2022/4/15 13:40:00,23,45,-22
24029,24029,223,2022/4/15 13:50:00,22,56,-34
24030,24030,223,2022/4/15 14:00:00,20,52,-32
24031,24031,223,2022/4/15 14:10:00,20,50,-30
24032,24032,223,2022/4/15 14:20:00,20,47,-27
24033,24033,223,2022/4/15 14:30:00,23,48,-25
24034,24034,223,2022/4/15 14:40:00,19,54,-35
24035,24035,223,2022/4/15 14:50:00,23,51,-28
24036,24036,223,2022/4/15 15:00:00,23,59,-36
24037,24037,223,2022/4/15 15:10:00,21,64,-43
24038,24038,223,2022/4/15 15:20:00,22,66,-44
24039,24039,223,2022/4/15 15:30:00,23,69,-46
24040,24040,223,2022/4/15 15:40:00,22,60,-38
24041,24041,223,2022/4/15 15:50:00,21,72,-51
24042,24042,223,2022/4/15 16:00:00,23,68,-45
24043,24043,223,2022/4/15 16:10:00,27,67,-40
24044,24044,223,2022/4/15 16:20:00,26,93,-67
24045,24045,223,2022/4/15 16:30:00,29,60,-31
24046,24046,223,2022/4/15 16:40:00,28,91,-63
24047,24047,223,2022/4/15 16:50:00,28,92,-64
24048,24048,223,2022/4/15 17:00:00,36,76,-40
24049,24049,223,2022/4/15 17:10:00,44,105,-61
24050,24050,223,2022/4/15 17:20:00,45,113,-68
24051,24051,223,2022/4/15 17:30:00,43,107,-64
24052,24052,223,2022/4/15 17:40:00,57,110,-53
24053,24053,223,2022/4/15 17:50:00,45,117,-72
24054,24054,223,2022/4/15 18:00:00,46,109,-63
24055,24055,223,2022/4/15 18:10:00,48,110,-62
24056,24056,223,2022/4/15 18:20:00,40,150,-110
24057,24057,223,2022/4/15 18:30:00,29,150,-121
24058,24058,223,2022/4/15 18:40:00,31,154,-123
24059,24059,223,2022/4/15 18:50:00,28,133,-105
24060,24060,223,2022/4/15 19:00:00,19,109,-90
24061,24061,223,2022/4/15 19:10:00,19,118,-99
24062,24062,223,2022/4/15 19:20:00,14,116,-102
24063,24063,223,2022/4/15 19:30:00,15,113,-98
24064,24064,223,2022/4/15 19:40:00,16,77,-61
24065,24065,223,2022/4/15 19:50:00,16,107,-91
24066,24066,223,2022/4/15 20:00:00,15,77,-62
24067,24067,223,2022/4/15 20:10:00,15,68,-53
24068,24068,223,2022/4/15 20:20:00,15,72,-57
24069,24069,223,2022/4/15 20:30:00,15,73,-58
24070,24070,223,2022/4/15 20:40:00,15,85,-70
24071,24071,223,2022/4/15 20:50:00,13,82,-69
24072,24072,223,2022/4/15 21:00:00,13,77,-64
24073,24073,223,2022/4/15 21:10:00,13,75,-62
24074,24074,223,2022/4/15 21:20:00,12,72,-60
24075,24075,223,2022/4/15 21:30:00,11,78,-67
24076,24076,223,2022/4/15 21:40:00,9,69,-60
24077,24077,223,2022/4/15 21:50:00,5,66,-61
24078,24078,223,2022/4/15 22:00:00,8,74,-66
24079,24079,223,2022/4/15 22:10:00,7,71,-64
24080,24080,223,2022/4/15 22:20:00,3,62,-59
24081,24081,223,2022/4/15 22:30:00,1,62,-61
24082,24082,223,2022/4/15 22:40:00,1,64,-63
24083,24083,223,2022/4/15 22:50:00,0,36,-36
24084,24084,224,2022/4/15 5:00:00,0,1,-1
24085,24085,224,2022/4/15 5:10:00,3,1,2
24086,24086,224,2022/4/15 5:20:00,14,1,13
24087,24087,224,2022/4/15 5:30:00,16,2,14
24088,24088,224,2022/4/15 5:40:00,18,1,17
24089,24089,224,2022/4/15 5:50:00,20,1,19
24090,24090,224,2022/4/15 6:00:00,25,1,24
24091,24091,224,2022/4/15 6:10:00,33,1,32
24092,24092,224,2022/4/15 6:20:00,35,1,34
24093,24093,224,2022/4/15 6:30:00,38,45,-7
24094,24094,224,2022/4/15 6:40:00,45,72,-27
24095,24095,224,2022/4/15 6:50:00,49,97,-48
24096,24096,224,2022/4/15 7:00:00,69,112,-43
24097,24097,224,2022/4/15 7:10:00,85,76,9
24098,24098,224,2022/4/15 7:20:00,104,71,33
24099,24099,224,2022/4/15 7:30:00,155,63,92
24100,24100,224,2022/4/15 7:40:00,162,71,91
24101,24101,224,2022/4/15 7:50:00,152,68,84
24102,24102,224,2022/4/15 8:00:00,90,95,-5
24103,24103,224,2022/4/15 8:10:00,59,105,-46
24104,24104,224,2022/4/15 8:20:00,52,115,-63
24105,24105,224,2022/4/15 8:30:00,50,126,-76
24106,24106,224,2022/4/15 8:40:00,36,104,-68
24107,24107,224,2022/4/15 8:50:00,29,119,-90
24108,24108,224,2022/4/15 9:00:00,23,109,-86
24109,24109,224,2022/4/15 9:10:00,21,112,-91
24110,24110,224,2022/4/15 9:20:00,23,88,-65
24111,24111,224,2022/4/15 9:30:00,23,75,-52
24112,24112,224,2022/4/15 9:40:00,20,68,-48
24113,24113,224,2022/4/15 9:50:00,21,57,-36
24114,24114,224,2022/4/15 10:00:00,19,60,-41
24115,24115,224,2022/4/15 10:10:00,21,69,-48
24116,24116,224,2022/4/15 10:20:00,17,51,-34
24117,24117,224,2022/4/15 10:30:00,18,54,-36
24118,24118,224,2022/4/15 10:40:00,21,45,-24
24119,24119,224,2022/4/15 10:50:00,19,38,-19
24120,24120,224,2022/4/15 11:00:00,20,40,-20
24121,24121,224,2022/4/15 11:10:00,23,46,-23
24122,24122,224,2022/4/15 11:20:00,20,40,-20
24123,24123,224,2022/4/15 11:30:00,22,47,-25
24124,24124,224,2022/4/15 11:40:00,21,51,-30
24125,24125,224,2022/4/15 11:50:00,20,38,-18
24126,24126,224,2022/4/15 12:00:00,25,39,-14
24127,24127,224,2022/4/15 12:10:00,25,42,-17
24128,24128,224,2022/4/15 12:20:00,21,38,-17
24129,24129,224,2022/4/15 12:30:00,21,45,-24
24130,24130,224,2022/4/15 12:40:00,20,41,-21
24131,24131,224,2022/4/15 12:50:00,16,46,-30
24132,24132,224,2022/4/15 13:00:00,17,50,-33
24133,24133,224,2022/4/15 13:10:00,23,73,-50
24134,24134,224,2022/4/15 13:20:00,20,52,-32
24135,24135,224,2022/4/15 13:30:00,23,49,-26
24136,24136,224,2022/4/15 13:40:00,20,50,-30
24137,24137,224,2022/4/15 13:50:00,23,48,-25
24138,24138,224,2022/4/15 14:00:00,21,51,-30
24139,24139,224,2022/4/15 14:10:00,24,47,-23
24140,24140,224,2022/4/15 14:20:00,23,50,-27
24141,24141,224,2022/4/15 14:30:00,25,59,-34
24142,24142,224,2022/4/15 14:40:00,22,59,-37
24143,24143,224,2022/4/15 14:50:00,25,51,-26
24144,24144,224,2022/4/15 15:00:00,27,47,-20
24145,24145,224,2022/4/15 15:10:00,28,41,-13
24146,24146,224,2022/4/15 15:20:00,25,48,-23
24147,24147,224,2022/4/15 15:30:00,28,51,-23
24148,24148,224,2022/4/15 15:40:00,22,49,-27
24149,24149,224,2022/4/15 15:50:00,26,41,-15
24150,24150,224,2022/4/15 16:00:00,28,65,-37
24151,24151,224,2022/4/15 16:10:00,35,59,-24
24152,24152,224,2022/4/15 16:20:00,46,42,4
24153,24153,224,2022/4/15 16:30:00,55,61,-6
24154,24154,224,2022/4/15 16:40:00,64,54,10
24155,24155,224,2022/4/15 16:50:00,76,57,19
24156,24156,224,2022/4/15 17:00:00,84,65,19
24157,24157,224,2022/4/15 17:10:00,87,61,26
24158,24158,224,2022/4/15 17:20:00,64,97,-33
24159,24159,224,2022/4/15 17:30:00,79,70,9
24160,24160,224,2022/4/15 17:40:00,113,79,34
24161,24161,224,2022/4/15 17:50:00,71,77,-6
24162,24162,224,2022/4/15 18:00:00,39,75,-36
24163,24163,224,2022/4/15 18:10:00,37,78,-41
24164,24164,224,2022/4/15 18:20:00,30,108,-78
24165,24165,224,2022/4/15 18:30:00,27,107,-80
24166,24166,224,2022/4/15 18:40:00,24,92,-68
24167,24167,224,2022/4/15 18:50:00,21,76,-55
24168,24168,224,2022/4/15 19:00:00,20,95,-75
24169,24169,224,2022/4/15 19:10:00,18,78,-60
24170,24170,224,2022/4/15 19:20:00,16,77,-61
24171,24171,224,2022/4/15 19:30:00,14,77,-63
24172,24172,224,2022/4/15 19:40:00,14,67,-53
24173,24173,224,2022/4/15 19:50:00,12,73,-61
24174,24174,224,2022/4/15 20:00:00,10,71,-61
24175,24175,224,2022/4/15 20:10:00,10,63,-53
24176,24176,224,2022/4/15 20:20:00,12,54,-42
24177,24177,224,2022/4/15 20:30:00,12,48,-36
24178,24178,224,2022/4/15 20:40:00,10,50,-40
24179,24179,224,2022/4/15 20:50:00,10,49,-39
24180,24180,224,2022/4/15 21:00:00,8,48,-40
24181,24181,224,2022/4/15 21:10:00,9,40,-31
24182,24182,224,2022/4/15 21:20:00,6,62,-56
24183,24183,224,2022/4/15 21:30:00,7,55,-48
24184,24184,224,2022/4/15 21:40:00,4,49,-45
24185,24185,224,2022/4/15 21:50:00,2,41,-39
24186,24186,224,2022/4/15 22:00:00,3,51,-48
24187,24187,224,2022/4/15 22:10:00,3,47,-44
24188,24188,224,2022/4/15 22:20:00,2,40,-38
24189,24189,224,2022/4/15 22:30:00,0,51,-51
24190,24190,224,2022/4/15 22:40:00,0,41,-41
24191,24191,224,2022/4/15 22:50:00,0,26,-26
24192,24192,225,2022/4/15 5:00:00,0,1,-1
24193,24193,225,2022/4/15 5:10:00,0,1,-1
24194,24194,225,2022/4/15 5:20:00,5,1,4
24195,24195,225,2022/4/15 5:30:00,10,1,9
24196,24196,225,2022/4/15 5:40:00,11,1,10
24197,24197,225,2022/4/15 5:50:00,12,1,11
24198,24198,225,2022/4/15 6:00:00,16,1,15
24199,24199,225,2022/4/15 6:10:00,20,1,19
24200,24200,225,2022/4/15 6:20:00,32,14,18
24201,24201,225,2022/4/15 6:30:00,31,16,15
24202,24202,225,2022/4/15 6:40:00,35,32,3
24203,24203,225,2022/4/15 6:50:00,45,21,24
24204,24204,225,2022/4/15 7:00:00,54,35,19
24205,24205,225,2022/4/15 7:10:00,67,62,5
24206,24206,225,2022/4/15 7:20:00,77,50,27
24207,24207,225,2022/4/15 7:30:00,101,90,11
24208,24208,225,2022/4/15 7:40:00,147,104,43
24209,24209,225,2022/4/15 7:50:00,124,120,4
24210,24210,225,2022/4/15 8:00:00,113,181,-68
24211,24211,225,2022/4/15 8:10:00,67,190,-123
24212,24212,225,2022/4/15 8:20:00,45,296,-251
24213,24213,225,2022/4/15 8:30:00,42,329,-287
24214,24214,225,2022/4/15 8:40:00,32,327,-295
24215,24215,225,2022/4/15 8:50:00,29,190,-161
24216,24216,225,2022/4/15 9:00:00,26,108,-82
24217,24217,225,2022/4/15 9:10:00,21,106,-85
24218,24218,225,2022/4/15 9:20:00,19,102,-83
24219,24219,225,2022/4/15 9:30:00,16,91,-75
24220,24220,225,2022/4/15 9:40:00,20,78,-58
24221,24221,225,2022/4/15 9:50:00,19,80,-61
24222,24222,225,2022/4/15 10:00:00,15,70,-55
24223,24223,225,2022/4/15 10:10:00,22,61,-39
24224,24224,225,2022/4/15 10:20:00,19,63,-44
24225,24225,225,2022/4/15 10:30:00,18,80,-62
24226,24226,225,2022/4/15 10:40:00,21,69,-48
24227,24227,225,2022/4/15 10:50:00,25,49,-24
24228,24228,225,2022/4/15 11:00:00,24,50,-26
24229,24229,225,2022/4/15 11:10:00,26,46,-20
24230,24230,225,2022/4/15 11:20:00,23,47,-24
24231,24231,225,2022/4/15 11:30:00,26,44,-18
24232,24232,225,2022/4/15 11:40:00,28,48,-20
24233,24233,225,2022/4/15 11:50:00,25,42,-17
24234,24234,225,2022/4/15 12:00:00,27,57,-30
24235,24235,225,2022/4/15 12:10:00,28,61,-33
24236,24236,225,2022/4/15 12:20:00,26,50,-24
24237,24237,225,2022/4/15 12:30:00,26,48,-22
24238,24238,225,2022/4/15 12:40:00,26,50,-24
24239,24239,225,2022/4/15 12:50:00,26,50,-24
24240,24240,225,2022/4/15 13:00:00,22,51,-29
24241,24241,225,2022/4/15 13:10:00,23,55,-32
24242,24242,225,2022/4/15 13:20:00,23,59,-36
24243,24243,225,2022/4/15 13:30:00,22,72,-50
24244,24244,225,2022/4/15 13:40:00,24,60,-36
24245,24245,225,2022/4/15 13:50:00,22,50,-28
24246,24246,225,2022/4/15 14:00:00,22,47,-25
24247,24247,225,2022/4/15 14:10:00,25,45,-20
24248,24248,225,2022/4/15 14:20:00,25,47,-22
24249,24249,225,2022/4/15 14:30:00,26,47,-21
24250,24250,225,2022/4/15 14:40:00,23,40,-17
24251,24251,225,2022/4/15 14:50:00,24,49,-25
24252,24252,225,2022/4/15 15:00:00,27,65,-38
24253,24253,225,2022/4/15 15:10:00,24,52,-28
24254,24254,225,2022/4/15 15:20:00,30,47,-17
24255,24255,225,2022/4/15 15:30:00,28,46,-18
24256,24256,225,2022/4/15 15:40:00,26,45,-19
24257,24257,225,2022/4/15 15:50:00,27,40,-13
24258,24258,225,2022/4/15 16:00:00,26,40,-14
24259,24259,225,2022/4/15 16:10:00,38,47,-9
24260,24260,225,2022/4/15 16:20:00,29,44,-15
24261,24261,225,2022/4/15 16:30:00,34,63,-29
24262,24262,225,2022/4/15 16:40:00,46,49,-3
24263,24263,225,2022/4/15 16:50:00,47,52,-5
24264,24264,225,2022/4/15 17:00:00,77,45,32
24265,24265,225,2022/4/15 17:10:00,160,50,110
24266,24266,225,2022/4/15 17:20:00,77,50,27
24267,24267,225,2022/4/15 17:30:00,235,69,166
24268,24268,225,2022/4/15 17:40:00,261,78,183
24269,24269,225,2022/4/15 17:50:00,139,64,75
24270,24270,225,2022/4/15 18:00:00,55,75,-20
24271,24271,225,2022/4/15 18:10:00,60,72,-12
24272,24272,225,2022/4/15 18:20:00,45,75,-30
24273,24273,225,2022/4/15 18:30:00,30,78,-48
24274,24274,225,2022/4/15 18:40:00,22,83,-61
24275,24275,225,2022/4/15 18:50:00,26,93,-67
24276,24276,225,2022/4/15 19:00:00,27,104,-77
24277,24277,225,2022/4/15 19:10:00,33,107,-74
24278,24278,225,2022/4/15 19:20:00,35,79,-44
24279,24279,225,2022/4/15 19:30:00,35,71,-36
24280,24280,225,2022/4/15 19:40:00,30,82,-52
24281,24281,225,2022/4/15 19:50:00,29,74,-45
24282,24282,225,2022/4/15 20:00:00,24,74,-50
24283,24283,225,2022/4/15 20:10:00,28,71,-43
24284,24284,225,2022/4/15 20:20:00,20,75,-55
24285,24285,225,2022/4/15 20:30:00,20,81,-61
24286,24286,225,2022/4/15 20:40:00,18,63,-45
24287,24287,225,2022/4/15 20:50:00,16,68,-52
24288,24288,225,2022/4/15 21:00:00,16,55,-39
24289,24289,225,2022/4/15 21:10:00,15,62,-47
24290,24290,225,2022/4/15 21:20:00,11,62,-51
24291,24291,225,2022/4/15 21:30:00,10,69,-59
24292,24292,225,2022/4/15 21:40:00,12,46,-34
24293,24293,225,2022/4/15 21:50:00,6,63,-57
24294,24294,225,2022/4/15 22:00:00,6,52,-46
24295,24295,225,2022/4/15 22:10:00,7,51,-44
24296,24296,225,2022/4/15 22:20:00,4,40,-36
24297,24297,225,2022/4/15 22:30:00,2,49,-47
24298,24298,225,2022/4/15 22:40:00,0,40,-40
24299,24299,225,2022/4/15 22:50:00,0,33,-33
24300,24300,226,2022/4/15 5:00:00,0,1,-1
24301,24301,226,2022/4/15 5:10:00,0,1,-1
24302,24302,226,2022/4/15 5:20:00,0,1,-1
24303,24303,226,2022/4/15 5:30:00,13,1,12
24304,24304,226,2022/4/15 5:40:00,28,1,27
24305,24305,226,2022/4/15 5:50:00,27,2,25
24306,24306,226,2022/4/15 6:00:00,37,5,32
24307,24307,226,2022/4/15 6:10:00,47,21,26
24308,24308,226,2022/4/15 6:20:00,57,19,38
24309,24309,226,2022/4/15 6:30:00,88,35,53
24310,24310,226,2022/4/15 6:40:00,174,42,132
24311,24311,226,2022/4/15 6:50:00,183,54,129
24312,24312,226,2022/4/15 7:00:00,228,55,173
24313,24313,226,2022/4/15 7:10:00,278,69,209
24314,24314,226,2022/4/15 7:20:00,351,71,280
24315,24315,226,2022/4/15 7:30:00,598,73,525
24316,24316,226,2022/4/15 7:40:00,630,60,570
24317,24317,226,2022/4/15 7:50:00,724,69,655
24318,24318,226,2022/4/15 8:00:00,635,59,576
24319,24319,226,2022/4/15 8:10:00,629,72,557
24320,24320,226,2022/4/15 8:20:00,446,62,384
24321,24321,226,2022/4/15 8:30:00,276,60,216
24322,24322,226,2022/4/15 8:40:00,236,70,166
24323,24323,226,2022/4/15 8:50:00,186,70,116
24324,24324,226,2022/4/15 9:00:00,99,64,35
24325,24325,226,2022/4/15 9:10:00,72,75,-3
24326,24326,226,2022/4/15 9:20:00,51,72,-21
24327,24327,226,2022/4/15 9:30:00,47,61,-14
24328,24328,226,2022/4/15 9:40:00,35,61,-26
24329,24329,226,2022/4/15 9:50:00,26,66,-40
24330,24330,226,2022/4/15 10:00:00,30,71,-41
24331,24331,226,2022/4/15 10:10:00,32,67,-35
24332,24332,226,2022/4/15 10:20:00,29,65,-36
24333,24333,226,2022/4/15 10:30:00,28,71,-43
24334,24334,226,2022/4/15 10:40:00,28,74,-46
24335,24335,226,2022/4/15 10:50:00,27,68,-41
24336,24336,226,2022/4/15 11:00:00,27,63,-36
24337,24337,226,2022/4/15 11:10:00,29,63,-34
24338,24338,226,2022/4/15 11:20:00,29,71,-42
24339,24339,226,2022/4/15 11:30:00,29,69,-40
24340,24340,226,2022/4/15 11:40:00,29,68,-39
24341,24341,226,2022/4/15 11:50:00,27,74,-47
24342,24342,226,2022/4/15 12:00:00,36,68,-32
24343,24343,226,2022/4/15 12:10:00,32,72,-40
24344,24344,226,2022/4/15 12:20:00,35,65,-30
24345,24345,226,2022/4/15 12:30:00,29,70,-41
24346,24346,226,2022/4/15 12:40:00,33,70,-37
24347,24347,226,2022/4/15 12:50:00,30,85,-55
24348,24348,226,2022/4/15 13:00:00,27,76,-49
24349,24349,226,2022/4/15 13:10:00,26,56,-30
24350,24350,226,2022/4/15 13:20:00,33,73,-40
24351,24351,226,2022/4/15 13:30:00,28,77,-49
24352,24352,226,2022/4/15 13:40:00,26,62,-36
24353,24353,226,2022/4/15 13:50:00,25,70,-45
24354,24354,226,2022/4/15 14:00:00,26,69,-43
24355,24355,226,2022/4/15 14:10:00,27,77,-50
24356,24356,226,2022/4/15 14:20:00,25,93,-68
24357,24357,226,2022/4/15 14:30:00,28,77,-49
24358,24358,226,2022/4/15 14:40:00,26,73,-47
24359,24359,226,2022/4/15 14:50:00,30,80,-50
24360,24360,226,2022/4/15 15:00:00,20,91,-71
24361,24361,226,2022/4/15 15:10:00,27,93,-66
24362,24362,226,2022/4/15 15:20:00,22,87,-65
24363,24363,226,2022/4/15 15:30:00,26,97,-71
24364,24364,226,2022/4/15 15:40:00,26,105,-79
24365,24365,226,2022/4/15 15:50:00,30,104,-74
24366,24366,226,2022/4/15 16:00:00,26,102,-76
24367,24367,226,2022/4/15 16:10:00,33,102,-69
24368,24368,226,2022/4/15 16:20:00,24,103,-79
24369,24369,226,2022/4/15 16:30:00,31,119,-88
24370,24370,226,2022/4/15 16:40:00,36,104,-68
24371,24371,226,2022/4/15 16:50:00,42,120,-78
24372,24372,226,2022/4/15 17:00:00,37,123,-86
24373,24373,226,2022/4/15 17:10:00,34,111,-77
24374,24374,226,2022/4/15 17:20:00,37,152,-115
24375,24375,226,2022/4/15 17:30:00,42,158,-116
24376,24376,226,2022/4/15 17:40:00,37,207,-170
24377,24377,226,2022/4/15 17:50:00,37,298,-261
24378,24378,226,2022/4/15 18:00:00,32,301,-269
24379,24379,226,2022/4/15 18:10:00,36,299,-263
24380,24380,226,2022/4/15 18:20:00,27,336,-309
24381,24381,226,2022/4/15 18:30:00,31,286,-255
24382,24382,226,2022/4/15 18:40:00,29,321,-292
24383,24383,226,2022/4/15 18:50:00,26,335,-309
24384,24384,226,2022/4/15 19:00:00,28,208,-180
24385,24385,226,2022/4/15 19:10:00,26,224,-198
24386,24386,226,2022/4/15 19:20:00,25,159,-134
24387,24387,226,2022/4/15 19:30:00,26,104,-78
24388,24388,226,2022/4/15 19:40:00,25,111,-86
24389,24389,226,2022/4/15 19:50:00,25,126,-101
24390,24390,226,2022/4/15 20:00:00,26,103,-77
24391,24391,226,2022/4/15 20:10:00,24,113,-89
24392,24392,226,2022/4/15 20:20:00,28,104,-76
24393,24393,226,2022/4/15 20:30:00,27,101,-74
24394,24394,226,2022/4/15 20:40:00,22,105,-83
24395,24395,226,2022/4/15 20:50:00,24,105,-81
24396,24396,226,2022/4/15 21:00:00,26,94,-68
24397,24397,226,2022/4/15 21:10:00,26,102,-76
24398,24398,226,2022/4/15 21:20:00,24,92,-68
24399,24399,226,2022/4/15 21:30:00,22,89,-67
24400,24400,226,2022/4/15 21:40:00,17,89,-72
24401,24401,226,2022/4/15 21:50:00,16,95,-79
24402,24402,226,2022/4/15 22:00:00,34,76,-42
24403,24403,226,2022/4/15 22:10:00,15,92,-77
24404,24404,226,2022/4/15 22:20:00,7,70,-63
24405,24405,226,2022/4/15 22:30:00,4,78,-74
24406,24406,226,2022/4/15 22:40:00,3,79,-76
24407,24407,226,2022/4/15 22:50:00,1,66,-65
24408,24408,227,2022/4/15 5:00:00,0,1,-1
24409,24409,227,2022/4/15 5:10:00,0,1,-1
24410,24410,227,2022/4/15 5:20:00,3,1,2
24411,24411,227,2022/4/15 5:30:00,7,1,6
24412,24412,227,2022/4/15 5:40:00,8,13,-5
24413,24413,227,2022/4/15 5:50:00,10,1,9
24414,24414,227,2022/4/15 6:00:00,15,2,13
24415,24415,227,2022/4/15 6:10:00,18,5,13
24416,24416,227,2022/4/15 6:20:00,24,59,-35
24417,24417,227,2022/4/15 6:30:00,28,49,-21
24418,24418,227,2022/4/15 6:40:00,25,52,-27
24419,24419,227,2022/4/15 6:50:00,29,60,-31
24420,24420,227,2022/4/15 7:00:00,55,50,5
24421,24421,227,2022/4/15 7:10:00,43,52,-9
24422,24422,227,2022/4/15 7:20:00,67,57,10
24423,24423,227,2022/4/15 7:30:00,86,56,30
24424,24424,227,2022/4/15 7:40:00,69,70,-1
24425,24425,227,2022/4/15 7:50:00,55,70,-15
24426,24426,227,2022/4/15 8:00:00,51,62,-11
24427,24427,227,2022/4/15 8:10:00,55,51,4
24428,24428,227,2022/4/15 8:20:00,51,65,-14
24429,24429,227,2022/4/15 8:30:00,43,66,-23
24430,24430,227,2022/4/15 8:40:00,34,48,-14
24431,24431,227,2022/4/15 8:50:00,26,67,-41
24432,24432,227,2022/4/15 9:00:00,27,60,-33
24433,24433,227,2022/4/15 9:10:00,23,54,-31
24434,24434,227,2022/4/15 9:20:00,23,52,-29
24435,24435,227,2022/4/15 9:30:00,17,54,-37
24436,24436,227,2022/4/15 9:40:00,24,44,-20
24437,24437,227,2022/4/15 9:50:00,20,45,-25
24438,24438,227,2022/4/15 10:00:00,16,46,-30
24439,24439,227,2022/4/15 10:10:00,12,40,-28
24440,24440,227,2022/4/15 10:20:00,23,42,-19
24441,24441,227,2022/4/15 10:30:00,9,40,-31
24442,24442,227,2022/4/15 10:40:00,11,36,-25
24443,24443,227,2022/4/15 10:50:00,21,38,-17
24444,24444,227,2022/4/15 11:00:00,17,46,-29
24445,24445,227,2022/4/15 11:10:00,9,40,-31
24446,24446,227,2022/4/15 11:20:00,27,44,-17
24447,24447,227,2022/4/15 11:30:00,8,45,-37
24448,24448,227,2022/4/15 11:40:00,13,34,-21
24449,24449,227,2022/4/15 11:50:00,19,37,-18
24450,24450,227,2022/4/15 12:00:00,9,35,-26
24451,24451,227,2022/4/15 12:10:00,24,40,-16
24452,24452,227,2022/4/15 12:20:00,10,40,-30
24453,24453,227,2022/4/15 12:30:00,12,46,-34
24454,24454,227,2022/4/15 12:40:00,23,56,-33
24455,24455,227,2022/4/15 12:50:00,11,43,-32
24456,24456,227,2022/4/15 13:00:00,11,50,-39
24457,24457,227,2022/4/15 13:10:00,24,45,-21
24458,24458,227,2022/4/15 13:20:00,16,38,-22
24459,24459,227,2022/4/15 13:30:00,12,43,-31
24460,24460,227,2022/4/15 13:40:00,19,44,-25
24461,24461,227,2022/4/15 13:50:00,20,42,-22
24462,24462,227,2022/4/15 14:00:00,23,52,-29
24463,24463,227,2022/4/15 14:10:00,11,63,-52
24464,24464,227,2022/4/15 14:20:00,22,45,-23
24465,24465,227,2022/4/15 14:30:00,18,53,-35
24466,24466,227,2022/4/15 14:40:00,19,53,-34
24467,24467,227,2022/4/15 14:50:00,25,57,-32
24468,24468,227,2022/4/15 15:00:00,14,51,-37
24469,24469,227,2022/4/15 15:10:00,19,60,-41
24470,24470,227,2022/4/15 15:20:00,27,52,-25
24471,24471,227,2022/4/15 15:30:00,22,61,-39
24472,24472,227,2022/4/15 15:40:00,21,57,-36
24473,24473,227,2022/4/15 15:50:00,20,56,-36
24474,24474,227,2022/4/15 16:00:00,19,61,-42
24475,24475,227,2022/4/15 16:10:00,25,56,-31
24476,24476,227,2022/4/15 16:20:00,20,60,-40
24477,24477,227,2022/4/15 16:30:00,25,61,-36
24478,24478,227,2022/4/15 16:40:00,23,63,-40
24479,24479,227,2022/4/15 16:50:00,23,66,-43
24480,24480,227,2022/4/15 17:00:00,28,66,-38
24481,24481,227,2022/4/15 17:10:00,23,70,-47
24482,24482,227,2022/4/15 17:20:00,28,59,-31
24483,24483,227,2022/4/15 17:30:00,26,82,-56
24484,24484,227,2022/4/15 17:40:00,24,71,-47
24485,24485,227,2022/4/15 17:50:00,23,73,-50
24486,24486,227,2022/4/15 18:00:00,22,89,-67
24487,24487,227,2022/4/15 18:10:00,25,101,-76
24488,24488,227,2022/4/15 18:20:00,12,76,-64
24489,24489,227,2022/4/15 18:30:00,24,80,-56
24490,24490,227,2022/4/15 18:40:00,21,74,-53
24491,24491,227,2022/4/15 18:50:00,19,61,-42
24492,24492,227,2022/4/15 19:00:00,13,66,-53
24493,24493,227,2022/4/15 19:10:00,16,57,-41
24494,24494,227,2022/4/15 19:20:00,7,58,-51
24495,24495,227,2022/4/15 19:30:00,24,66,-42
24496,24496,227,2022/4/15 19:40:00,8,67,-59
24497,24497,227,2022/4/15 19:50:00,9,48,-39
24498,24498,227,2022/4/15 20:00:00,13,45,-32
24499,24499,227,2022/4/15 20:10:00,4,38,-34
24500,24500,227,2022/4/15 20:20:00,10,39,-29
24501,24501,227,2022/4/15 20:30:00,6,38,-32
24502,24502,227,2022/4/15 20:40:00,6,33,-27
24503,24503,227,2022/4/15 20:50:00,8,27,-19
24504,24504,227,2022/4/15 21:00:00,3,40,-37
24505,24505,227,2022/4/15 21:10:00,5,34,-29
24506,24506,227,2022/4/15 21:20:00,5,25,-20
24507,24507,227,2022/4/15 21:30:00,4,22,-18
24508,24508,227,2022/4/15 21:40:00,2,25,-23
24509,24509,227,2022/4/15 21:50:00,2,21,-19
24510,24510,227,2022/4/15 22:00:00,1,25,-24
24511,24511,227,2022/4/15 22:10:00,2,23,-21
24512,24512,227,2022/4/15 22:20:00,2,21,-19
24513,24513,227,2022/4/15 22:30:00,0,21,-21
24514,24514,227,2022/4/15 22:40:00,0,18,-18
24515,24515,227,2022/4/15 22:50:00,0,10,-10
24516,24516,228,2022/4/15 5:00:00,0,1,-1
24517,24517,228,2022/4/15 5:10:00,0,1,-1
24518,24518,228,2022/4/15 5:20:00,0,1,-1
24519,24519,228,2022/4/15 5:30:00,1,1,0
24520,24520,228,2022/4/15 5:40:00,2,1,1
24521,24521,228,2022/4/15 5:50:00,6,6,0
24522,24522,228,2022/4/15 6:00:00,9,11,-2
24523,24523,228,2022/4/15 6:10:00,13,16,-3
24524,24524,228,2022/4/15 6:20:00,20,37,-17
24525,24525,228,2022/4/15 6:30:00,27,55,-28
24526,24526,228,2022/4/15 6:40:00,29,106,-77
24527,24527,228,2022/4/15 6:50:00,30,110,-80
24528,24528,228,2022/4/15 7:00:00,35,324,-289
24529,24529,228,2022/4/15 7:10:00,33,324,-291
24530,24530,228,2022/4/15 7:20:00,37,297,-260
24531,24531,228,2022/4/15 7:30:00,43,319,-276
24532,24532,228,2022/4/15 7:40:00,52,196,-144
24533,24533,228,2022/4/15 7:50:00,58,196,-138
24534,24534,228,2022/4/15 8:00:00,58,253,-195
24535,24535,228,2022/4/15 8:10:00,56,194,-138
24536,24536,228,2022/4/15 8:20:00,51,332,-281
24537,24537,228,2022/4/15 8:30:00,45,324,-279
24538,24538,228,2022/4/15 8:40:00,44,381,-337
24539,24539,228,2022/4/15 8:50:00,43,297,-254
24540,24540,228,2022/4/15 9:00:00,39,154,-115
24541,24541,228,2022/4/15 9:10:00,32,125,-93
24542,24542,228,2022/4/15 9:20:00,31,121,-90
24543,24543,228,2022/4/15 9:30:00,28,105,-77
24544,24544,228,2022/4/15 9:40:00,31,105,-74
24545,24545,228,2022/4/15 9:50:00,31,114,-83
24546,24546,228,2022/4/15 10:00:00,29,90,-61
24547,24547,228,2022/4/15 10:10:00,26,75,-49
24548,24548,228,2022/4/15 10:20:00,26,75,-49
24549,24549,228,2022/4/15 10:30:00,23,69,-46
24550,24550,228,2022/4/15 10:40:00,28,69,-41
24551,24551,228,2022/4/15 10:50:00,27,66,-39
24552,24552,228,2022/4/15 11:00:00,24,63,-39
24553,24553,228,2022/4/15 11:10:00,25,62,-37
24554,24554,228,2022/4/15 11:20:00,23,60,-37
24555,24555,228,2022/4/15 11:30:00,29,60,-31
24556,24556,228,2022/4/15 11:40:00,24,73,-49
24557,24557,228,2022/4/15 11:50:00,22,70,-48
24558,24558,228,2022/4/15 12:00:00,35,70,-35
24559,24559,228,2022/4/15 12:10:00,36,65,-29
24560,24560,228,2022/4/15 12:20:00,32,65,-33
24561,24561,228,2022/4/15 12:30:00,33,71,-38
24562,24562,228,2022/4/15 12:40:00,30,70,-40
24563,24563,228,2022/4/15 12:50:00,25,64,-39
24564,24564,228,2022/4/15 13:00:00,26,73,-47
24565,24565,228,2022/4/15 13:10:00,27,76,-49
24566,24566,228,2022/4/15 13:20:00,27,84,-57
24567,24567,228,2022/4/15 13:30:00,27,68,-41
24568,24568,228,2022/4/15 13:40:00,24,67,-43
24569,24569,228,2022/4/15 13:50:00,23,75,-52
24570,24570,228,2022/4/15 14:00:00,30,68,-38
24571,24571,228,2022/4/15 14:10:00,35,65,-30
24572,24572,228,2022/4/15 14:20:00,38,70,-32
24573,24573,228,2022/4/15 14:30:00,32,66,-34
24574,24574,228,2022/4/15 14:40:00,114,80,34
24575,24575,228,2022/4/15 14:50:00,124,70,54
24576,24576,228,2022/4/15 15:00:00,57,68,-11
24577,24577,228,2022/4/15 15:10:00,65,71,-6
24578,24578,228,2022/4/15 15:20:00,119,68,51
24579,24579,228,2022/4/15 15:30:00,132,69,63
24580,24580,228,2022/4/15 15:40:00,164,81,83
24581,24581,228,2022/4/15 15:50:00,172,70,102
24582,24582,228,2022/4/15 16:00:00,164,75,89
24583,24583,228,2022/4/15 16:10:00,190,77,113
24584,24584,228,2022/4/15 16:20:00,154,76,78
24585,24585,228,2022/4/15 16:30:00,174,70,104
24586,24586,228,2022/4/15 16:40:00,191,76,115
24587,24587,228,2022/4/15 16:50:00,174,74,100
24588,24588,228,2022/4/15 17:00:00,187,93,94
24589,24589,228,2022/4/15 17:10:00,243,91,152
24590,24590,228,2022/4/15 17:20:00,204,111,93
24591,24591,228,2022/4/15 17:30:00,244,105,139
24592,24592,228,2022/4/15 17:40:00,335,86,249
24593,24593,228,2022/4/15 17:50:00,264,103,161
24594,24594,228,2022/4/15 18:00:00,273,110,163
24595,24595,228,2022/4/15 18:10:00,294,109,185
24596,24596,228,2022/4/15 18:20:00,198,109,89
24597,24597,228,2022/4/15 18:30:00,149,105,44
24598,24598,228,2022/4/15 18:40:00,85,108,-23
24599,24599,228,2022/4/15 18:50:00,51,110,-59
24600,24600,228,2022/4/15 19:00:00,47,113,-66
24601,24601,228,2022/4/15 19:10:00,47,107,-60
24602,24602,228,2022/4/15 19:20:00,44,81,-37
24603,24603,228,2022/4/15 19:30:00,39,77,-38
24604,24604,228,2022/4/15 19:40:00,39,79,-40
24605,24605,228,2022/4/15 19:50:00,39,72,-33
24606,24606,228,2022/4/15 20:00:00,36,64,-28
24607,24607,228,2022/4/15 20:10:00,39,70,-31
24608,24608,228,2022/4/15 20:20:00,33,59,-26
24609,24609,228,2022/4/15 20:30:00,35,65,-30
24610,24610,228,2022/4/15 20:40:00,38,68,-30
24611,24611,228,2022/4/15 20:50:00,35,63,-28
24612,24612,228,2022/4/15 21:00:00,34,66,-32
24613,24613,228,2022/4/15 21:10:00,32,54,-22
24614,24614,228,2022/4/15 21:20:00,32,66,-34
24615,24615,228,2022/4/15 21:30:00,25,62,-37
24616,24616,228,2022/4/15 21:40:00,28,59,-31
24617,24617,228,2022/4/15 21:50:00,26,55,-29
24618,24618,228,2022/4/15 22:00:00,29,62,-33
24619,24619,228,2022/4/15 22:10:00,21,40,-19
24620,24620,228,2022/4/15 22:20:00,13,63,-50
24621,24621,228,2022/4/15 22:30:00,9,50,-41
24622,24622,228,2022/4/15 22:40:00,9,49,-40
24623,24623,228,2022/4/15 22:50:00,2,32,-30
24624,24624,229,2022/4/15 5:00:00,0,1,-1
24625,24625,229,2022/4/15 5:10:00,0,1,-1
24626,24626,229,2022/4/15 5:20:00,0,1,-1
24627,24627,229,2022/4/15 5:30:00,4,1,3
24628,24628,229,2022/4/15 5:40:00,18,1,17
24629,24629,229,2022/4/15 5:50:00,32,2,30
24630,24630,229,2022/4/15 6:00:00,42,19,23
24631,24631,229,2022/4/15 6:10:00,36,11,25
24632,24632,229,2022/4/15 6:20:00,58,25,33
24633,24633,229,2022/4/15 6:30:00,84,31,53
24634,24634,229,2022/4/15 6:40:00,116,41,75
24635,24635,229,2022/4/15 6:50:00,169,48,121
24636,24636,229,2022/4/15 7:00:00,186,60,126
24637,24637,229,2022/4/15 7:10:00,265,64,201
24638,24638,229,2022/4/15 7:20:00,318,78,240
24639,24639,229,2022/4/15 7:30:00,597,92,505
24640,24640,229,2022/4/15 7:40:00,722,105,617
24641,24641,229,2022/4/15 7:50:00,723,113,610
24642,24642,229,2022/4/15 8:00:00,688,109,579
24643,24643,229,2022/4/15 8:10:00,629,105,524
24644,24644,229,2022/4/15 8:20:00,390,86,304
24645,24645,229,2022/4/15 8:30:00,319,126,193
24646,24646,229,2022/4/15 8:40:00,272,120,152
24647,24647,229,2022/4/15 8:50:00,226,105,121
24648,24648,229,2022/4/15 9:00:00,173,97,76
24649,24649,229,2022/4/15 9:10:00,143,90,53
24650,24650,229,2022/4/15 9:20:00,76,76,0
24651,24651,229,2022/4/15 9:30:00,50,64,-14
24652,24652,229,2022/4/15 9:40:00,46,78,-32
24653,24653,229,2022/4/15 9:50:00,37,67,-30
24654,24654,229,2022/4/15 10:00:00,37,65,-28
24655,24655,229,2022/4/15 10:10:00,36,70,-34
24656,24656,229,2022/4/15 10:20:00,29,61,-32
24657,24657,229,2022/4/15 10:30:00,31,63,-32
24658,24658,229,2022/4/15 10:40:00,29,61,-32
24659,24659,229,2022/4/15 10:50:00,25,66,-41
24660,24660,229,2022/4/15 11:00:00,32,68,-36
24661,24661,229,2022/4/15 11:10:00,30,61,-31
24662,24662,229,2022/4/15 11:20:00,28,61,-33
24663,24663,229,2022/4/15 11:30:00,30,66,-36
24664,24664,229,2022/4/15 11:40:00,29,72,-43
24665,24665,229,2022/4/15 11:50:00,30,69,-39
24666,24666,229,2022/4/15 12:00:00,28,61,-33
24667,24667,229,2022/4/15 12:10:00,34,59,-25
24668,24668,229,2022/4/15 12:20:00,29,70,-41
24669,24669,229,2022/4/15 12:30:00,34,64,-30
24670,24670,229,2022/4/15 12:40:00,34,74,-40
24671,24671,229,2022/4/15 12:50:00,37,62,-25
24672,24672,229,2022/4/15 13:00:00,30,76,-46
24673,24673,229,2022/4/15 13:10:00,31,83,-52
24674,24674,229,2022/4/15 13:20:00,30,69,-39
24675,24675,229,2022/4/15 13:30:00,25,67,-42
24676,24676,229,2022/4/15 13:40:00,27,66,-39
24677,24677,229,2022/4/15 13:50:00,27,77,-50
24678,24678,229,2022/4/15 14:00:00,30,69,-39
24679,24679,229,2022/4/15 14:10:00,29,64,-35
24680,24680,229,2022/4/15 14:20:00,30,72,-42
24681,24681,229,2022/4/15 14:30:00,25,70,-45
24682,24682,229,2022/4/15 14:40:00,26,75,-49
24683,24683,229,2022/4/15 14:50:00,30,78,-48
24684,24684,229,2022/4/15 15:00:00,31,81,-50
24685,24685,229,2022/4/15 15:10:00,32,85,-53
24686,24686,229,2022/4/15 15:20:00,22,91,-69
24687,24687,229,2022/4/15 15:30:00,28,84,-56
24688,24688,229,2022/4/15 15:40:00,27,87,-60
24689,24689,229,2022/4/15 15:50:00,31,97,-66
24690,24690,229,2022/4/15 16:00:00,34,90,-56
24691,24691,229,2022/4/15 16:10:00,38,103,-65
24692,24692,229,2022/4/15 16:20:00,34,93,-59
24693,24693,229,2022/4/15 16:30:00,46,93,-47
24694,24694,229,2022/4/15 16:40:00,38,100,-62
24695,24695,229,2022/4/15 16:50:00,44,126,-82
24696,24696,229,2022/4/15 17:00:00,42,107,-65
24697,24697,229,2022/4/15 17:10:00,71,127,-56
24698,24698,229,2022/4/15 17:20:00,64,115,-51
24699,24699,229,2022/4/15 17:30:00,46,177,-131
24700,24700,229,2022/4/15 17:40:00,65,196,-131
24701,24701,229,2022/4/15 17:50:00,65,221,-156
24702,24702,229,2022/4/15 18:00:00,42,218,-176
24703,24703,229,2022/4/15 18:10:00,45,300,-255
24704,24704,229,2022/4/15 18:20:00,44,257,-213
24705,24705,229,2022/4/15 18:30:00,44,233,-189
24706,24706,229,2022/4/15 18:40:00,44,257,-213
24707,24707,229,2022/4/15 18:50:00,33,255,-222
24708,24708,229,2022/4/15 19:00:00,30,222,-192
24709,24709,229,2022/4/15 19:10:00,30,234,-204
24710,24710,229,2022/4/15 19:20:00,26,116,-90
24711,24711,229,2022/4/15 19:30:00,26,113,-87
24712,24712,229,2022/4/15 19:40:00,24,121,-97
24713,24713,229,2022/4/15 19:50:00,22,110,-88
24714,24714,229,2022/4/15 20:00:00,26,107,-81
24715,24715,229,2022/4/15 20:10:00,28,104,-76
24716,24716,229,2022/4/15 20:20:00,24,111,-87
24717,24717,229,2022/4/15 20:30:00,27,110,-83
24718,24718,229,2022/4/15 20:40:00,23,107,-84
24719,24719,229,2022/4/15 20:50:00,26,92,-66
24720,24720,229,2022/4/15 21:00:00,22,95,-73
24721,24721,229,2022/4/15 21:10:00,27,108,-81
24722,24722,229,2022/4/15 21:20:00,22,78,-56
24723,24723,229,2022/4/15 21:30:00,17,114,-97
24724,24724,229,2022/4/15 21:40:00,18,93,-75
24725,24725,229,2022/4/15 21:50:00,14,110,-96
24726,24726,229,2022/4/15 22:00:00,13,74,-61
24727,24727,229,2022/4/15 22:10:00,10,107,-97
24728,24728,229,2022/4/15 22:20:00,6,80,-74
24729,24729,229,2022/4/15 22:30:00,6,86,-80
24730,24730,229,2022/4/15 22:40:00,3,77,-74
24731,24731,229,2022/4/15 22:50:00,1,78,-77
24732,24732,230,2022/4/15 5:00:00,0,1,-1
24733,24733,230,2022/4/15 5:10:00,0,1,-1
24734,24734,230,2022/4/15 5:20:00,3,1,2
24735,24735,230,2022/4/15 5:30:00,12,1,11
24736,24736,230,2022/4/15 5:40:00,6,1,5
24737,24737,230,2022/4/15 5:50:00,13,1,12
24738,24738,230,2022/4/15 6:00:00,15,1,14
24739,24739,230,2022/4/15 6:10:00,22,1,21
24740,24740,230,2022/4/15 6:20:00,24,8,16
24741,24741,230,2022/4/15 6:30:00,29,8,21
24742,24742,230,2022/4/15 6:40:00,51,25,26
24743,24743,230,2022/4/15 6:50:00,47,33,14
24744,24744,230,2022/4/15 7:00:00,57,38,19
24745,24745,230,2022/4/15 7:10:00,67,38,29
24746,24746,230,2022/4/15 7:20:00,55,56,-1
24747,24747,230,2022/4/15 7:30:00,86,61,25
24748,24748,230,2022/4/15 7:40:00,196,63,133
24749,24749,230,2022/4/15 7:50:00,187,54,133
24750,24750,230,2022/4/15 8:00:00,123,83,40
24751,24751,230,2022/4/15 8:10:00,74,64,10
24752,24752,230,2022/4/15 8:20:00,55,61,-6
24753,24753,230,2022/4/15 8:30:00,52,60,-8
24754,24754,230,2022/4/15 8:40:00,40,65,-25
24755,24755,230,2022/4/15 8:50:00,30,65,-35
24756,24756,230,2022/4/15 9:00:00,26,48,-22
24757,24757,230,2022/4/15 9:10:00,25,49,-24
24758,24758,230,2022/4/15 9:20:00,21,51,-30
24759,24759,230,2022/4/15 9:30:00,16,50,-34
24760,24760,230,2022/4/15 9:40:00,18,48,-30
24761,24761,230,2022/4/15 9:50:00,12,41,-29
24762,24762,230,2022/4/15 10:00:00,17,39,-22
24763,24763,230,2022/4/15 10:10:00,11,37,-26
24764,24764,230,2022/4/15 10:20:00,17,34,-17
24765,24765,230,2022/4/15 10:30:00,13,34,-21
24766,24766,230,2022/4/15 10:40:00,16,37,-21
24767,24767,230,2022/4/15 10:50:00,13,30,-17
24768,24768,230,2022/4/15 11:00:00,17,33,-16
24769,24769,230,2022/4/15 11:10:00,13,33,-20
24770,24770,230,2022/4/15 11:20:00,17,34,-17
24771,24771,230,2022/4/15 11:30:00,13,48,-35
24772,24772,230,2022/4/15 11:40:00,17,38,-21
24773,24773,230,2022/4/15 11:50:00,12,37,-25
24774,24774,230,2022/4/15 12:00:00,14,33,-19
24775,24775,230,2022/4/15 12:10:00,16,33,-17
24776,24776,230,2022/4/15 12:20:00,19,33,-14
24777,24777,230,2022/4/15 12:30:00,14,32,-18
24778,24778,230,2022/4/15 12:40:00,15,37,-22
24779,24779,230,2022/4/15 12:50:00,14,38,-24
24780,24780,230,2022/4/15 13:00:00,13,63,-50
24781,24781,230,2022/4/15 13:10:00,13,44,-31
24782,24782,230,2022/4/15 13:20:00,13,38,-25
24783,24783,230,2022/4/15 13:30:00,12,40,-28
24784,24784,230,2022/4/15 13:40:00,18,37,-19
24785,24785,230,2022/4/15 13:50:00,16,36,-20
24786,24786,230,2022/4/15 14:00:00,15,38,-23
24787,24787,230,2022/4/15 14:10:00,13,37,-24
24788,24788,230,2022/4/15 14:20:00,13,36,-23
24789,24789,230,2022/4/15 14:30:00,15,55,-40
24790,24790,230,2022/4/15 14:40:00,18,46,-28
24791,24791,230,2022/4/15 14:50:00,13,51,-38
24792,24792,230,2022/4/15 15:00:00,17,45,-28
24793,24793,230,2022/4/15 15:10:00,16,42,-26
24794,24794,230,2022/4/15 15:20:00,23,51,-28
24795,24795,230,2022/4/15 15:30:00,17,47,-30
24796,24796,230,2022/4/15 15:40:00,17,45,-28
24797,24797,230,2022/4/15 15:50:00,17,51,-34
24798,24798,230,2022/4/15 16:00:00,17,65,-48
24799,24799,230,2022/4/15 16:10:00,16,51,-35
24800,24800,230,2022/4/15 16:20:00,23,57,-34
24801,24801,230,2022/4/15 16:30:00,24,56,-32
24802,24802,230,2022/4/15 16:40:00,32,60,-28
24803,24803,230,2022/4/15 16:50:00,24,68,-44
24804,24804,230,2022/4/15 17:00:00,35,64,-29
24805,24805,230,2022/4/15 17:10:00,30,87,-57
24806,24806,230,2022/4/15 17:20:00,23,67,-44
24807,24807,230,2022/4/15 17:30:00,28,78,-50
24808,24808,230,2022/4/15 17:40:00,23,82,-59
24809,24809,230,2022/4/15 17:50:00,19,93,-74
24810,24810,230,2022/4/15 18:00:00,19,89,-70
24811,24811,230,2022/4/15 18:10:00,26,91,-65
24812,24812,230,2022/4/15 18:20:00,22,104,-82
24813,24813,230,2022/4/15 18:30:00,22,98,-76
24814,24814,230,2022/4/15 18:40:00,16,104,-88
24815,24815,230,2022/4/15 18:50:00,15,96,-81
24816,24816,230,2022/4/15 19:00:00,13,76,-63
24817,24817,230,2022/4/15 19:10:00,14,75,-61
24818,24818,230,2022/4/15 19:20:00,10,64,-54
24819,24819,230,2022/4/15 19:30:00,13,65,-52
24820,24820,230,2022/4/15 19:40:00,13,61,-48
24821,24821,230,2022/4/15 19:50:00,12,65,-53
24822,24822,230,2022/4/15 20:00:00,16,72,-56
24823,24823,230,2022/4/15 20:10:00,12,52,-40
24824,24824,230,2022/4/15 20:20:00,13,44,-31
24825,24825,230,2022/4/15 20:30:00,13,39,-26
24826,24826,230,2022/4/15 20:40:00,8,42,-34
24827,24827,230,2022/4/15 20:50:00,12,41,-29
24828,24828,230,2022/4/15 21:00:00,10,41,-31
24829,24829,230,2022/4/15 21:10:00,12,49,-37
24830,24830,230,2022/4/15 21:20:00,11,54,-43
24831,24831,230,2022/4/15 21:30:00,10,49,-39
24832,24832,230,2022/4/15 21:40:00,8,41,-33
24833,24833,230,2022/4/15 21:50:00,7,40,-33
24834,24834,230,2022/4/15 22:00:00,10,40,-30
24835,24835,230,2022/4/15 22:10:00,7,25,-18
24836,24836,230,2022/4/15 22:20:00,3,40,-37
24837,24837,230,2022/4/15 22:30:00,2,23,-21
24838,24838,230,2022/4/15 22:40:00,1,41,-40
24839,24839,230,2022/4/15 22:50:00,0,34,-34
24840,24840,231,2022/4/15 5:00:00,0,1,-1
24841,24841,231,2022/4/15 5:10:00,0,1,-1
24842,24842,231,2022/4/15 5:20:00,0,1,-1
24843,24843,231,2022/4/15 5:30:00,3,1,2
24844,24844,231,2022/4/15 5:40:00,15,1,14
24845,24845,231,2022/4/15 5:50:00,24,12,12
24846,24846,231,2022/4/15 6:00:00,26,35,-9
24847,24847,231,2022/4/15 6:10:00,33,53,-20
24848,24848,231,2022/4/15 6:20:00,40,59,-19
24849,24849,231,2022/4/15 6:30:00,52,74,-22
24850,24850,231,2022/4/15 6:40:00,61,91,-30
24851,24851,231,2022/4/15 6:50:00,80,109,-29
24852,24852,231,2022/4/15 7:00:00,112,181,-69
24853,24853,231,2022/4/15 7:10:00,152,267,-115
24854,24854,231,2022/4/15 7:20:00,216,253,-37
24855,24855,231,2022/4/15 7:30:00,215,268,-53
24856,24856,231,2022/4/15 7:40:00,245,345,-100
24857,24857,231,2022/4/15 7:50:00,266,434,-168
24858,24858,231,2022/4/15 8:00:00,347,582,-235
24859,24859,231,2022/4/15 8:10:00,366,1126,-760
24860,24860,231,2022/4/15 8:20:00,347,1134,-787
24861,24861,231,2022/4/15 8:30:00,278,1122,-844
24862,24862,231,2022/4/15 8:40:00,282,1643,-1361
24863,24863,231,2022/4/15 8:50:00,246,1549,-1303
24864,24864,231,2022/4/15 9:00:00,208,489,-281
24865,24865,231,2022/4/15 9:10:00,178,631,-453
24866,24866,231,2022/4/15 9:20:00,148,423,-275
24867,24867,231,2022/4/15 9:30:00,115,431,-316
24868,24868,231,2022/4/15 9:40:00,85,382,-297
24869,24869,231,2022/4/15 9:50:00,70,282,-212
24870,24870,231,2022/4/15 10:00:00,68,233,-165
24871,24871,231,2022/4/15 10:10:00,64,119,-55
24872,24872,231,2022/4/15 10:20:00,59,123,-64
24873,24873,231,2022/4/15 10:30:00,53,117,-64
24874,24874,231,2022/4/15 10:40:00,45,115,-70
24875,24875,231,2022/4/15 10:50:00,50,120,-70
24876,24876,231,2022/4/15 11:00:00,52,99,-47
24877,24877,231,2022/4/15 11:10:00,55,110,-55
24878,24878,231,2022/4/15 11:20:00,55,104,-49
24879,24879,231,2022/4/15 11:30:00,59,113,-54
24880,24880,231,2022/4/15 11:40:00,69,102,-33
24881,24881,231,2022/4/15 11:50:00,58,108,-50
24882,24882,231,2022/4/15 12:00:00,70,97,-27
24883,24883,231,2022/4/15 12:10:00,72,122,-50
24884,24884,231,2022/4/15 12:20:00,59,107,-48
24885,24885,231,2022/4/15 12:30:00,61,119,-58
24886,24886,231,2022/4/15 12:40:00,63,102,-39
24887,24887,231,2022/4/15 12:50:00,66,105,-39
24888,24888,231,2022/4/15 13:00:00,68,117,-49
24889,24889,231,2022/4/15 13:10:00,60,124,-64
24890,24890,231,2022/4/15 13:20:00,62,117,-55
24891,24891,231,2022/4/15 13:30:00,58,116,-58
24892,24892,231,2022/4/15 13:40:00,67,123,-56
24893,24893,231,2022/4/15 13:50:00,67,105,-38
24894,24894,231,2022/4/15 14:00:00,62,118,-56
24895,24895,231,2022/4/15 14:10:00,65,122,-57
24896,24896,231,2022/4/15 14:20:00,62,121,-59
24897,24897,231,2022/4/15 14:30:00,76,101,-25
24898,24898,231,2022/4/15 14:40:00,69,98,-29
24899,24899,231,2022/4/15 14:50:00,102,88,14
24900,24900,231,2022/4/15 15:00:00,131,105,26
24901,24901,231,2022/4/15 15:10:00,158,107,51
24902,24902,231,2022/4/15 15:20:00,172,125,47
24903,24903,231,2022/4/15 15:30:00,174,114,60
24904,24904,231,2022/4/15 15:40:00,149,108,41
24905,24905,231,2022/4/15 15:50:00,137,102,35
24906,24906,231,2022/4/15 16:00:00,181,108,73
24907,24907,231,2022/4/15 16:10:00,218,118,100
24908,24908,231,2022/4/15 16:20:00,227,121,106
24909,24909,231,2022/4/15 16:30:00,293,123,170
24910,24910,231,2022/4/15 16:40:00,332,107,225
24911,24911,231,2022/4/15 16:50:00,333,124,209
24912,24912,231,2022/4/15 17:00:00,697,111,586
24913,24913,231,2022/4/15 17:10:00,830,118,712
24914,24914,231,2022/4/15 17:20:00,675,196,479
24915,24915,231,2022/4/15 17:30:00,698,212,486
24916,24916,231,2022/4/15 17:40:00,796,177,619
24917,24917,231,2022/4/15 17:50:00,630,178,452
24918,24918,231,2022/4/15 18:00:00,631,218,413
24919,24919,231,2022/4/15 18:10:00,1202,301,901
24920,24920,231,2022/4/15 18:20:00,801,284,517
24921,24921,231,2022/4/15 18:30:00,572,284,288
24922,24922,231,2022/4/15 18:40:00,463,190,273
24923,24923,231,2022/4/15 18:50:00,333,178,155
24924,24924,231,2022/4/15 19:00:00,274,145,129
24925,24925,231,2022/4/15 19:10:00,230,128,102
24926,24926,231,2022/4/15 19:20:00,191,109,82
24927,24927,231,2022/4/15 19:30:00,175,103,72
24928,24928,231,2022/4/15 19:40:00,144,110,34
24929,24929,231,2022/4/15 19:50:00,87,111,-24
24930,24930,231,2022/4/15 20:00:00,89,95,-6
24931,24931,231,2022/4/15 20:10:00,82,92,-10
24932,24932,231,2022/4/15 20:20:00,83,100,-17
24933,24933,231,2022/4/15 20:30:00,67,114,-47
24934,24934,231,2022/4/15 20:40:00,85,95,-10
24935,24935,231,2022/4/15 20:50:00,83,95,-12
24936,24936,231,2022/4/15 21:00:00,106,106,0
24937,24937,231,2022/4/15 21:10:00,84,108,-24
24938,24938,231,2022/4/15 21:20:00,62,91,-29
24939,24939,231,2022/4/15 21:30:00,67,106,-39
24940,24940,231,2022/4/15 21:40:00,49,92,-43
24941,24941,231,2022/4/15 21:50:00,40,97,-57
24942,24942,231,2022/4/15 22:00:00,34,92,-58
24943,24943,231,2022/4/15 22:10:00,37,82,-45
24944,24944,231,2022/4/15 22:20:00,31,85,-54
24945,24945,231,2022/4/15 22:30:00,24,78,-54
24946,24946,231,2022/4/15 22:40:00,20,73,-53
24947,24947,231,2022/4/15 22:50:00,9,64,-55
24948,24948,232,2022/4/15 5:00:00,0,1,-1
24949,24949,232,2022/4/15 5:10:00,0,1,-1
24950,24950,232,2022/4/15 5:20:00,0,1,-1
24951,24951,232,2022/4/15 5:30:00,3,1,2
24952,24952,232,2022/4/15 5:40:00,3,2,1
24953,24953,232,2022/4/15 5:50:00,12,6,6
24954,24954,232,2022/4/15 6:00:00,12,61,-49
24955,24955,232,2022/4/15 6:10:00,15,62,-47
24956,24956,232,2022/4/15 6:20:00,22,70,-48
24957,24957,232,2022/4/15 6:30:00,23,76,-53
24958,24958,232,2022/4/15 6:40:00,30,110,-80
24959,24959,232,2022/4/15 6:50:00,34,123,-89
24960,24960,232,2022/4/15 7:00:00,46,150,-104
24961,24961,232,2022/4/15 7:10:00,44,211,-167
24962,24962,232,2022/4/15 7:20:00,45,297,-252
24963,24963,232,2022/4/15 7:30:00,45,327,-282
24964,24964,232,2022/4/15 7:40:00,57,441,-384
24965,24965,232,2022/4/15 7:50:00,79,507,-428
24966,24966,232,2022/4/15 8:00:00,84,414,-330
24967,24967,232,2022/4/15 8:10:00,82,591,-509
24968,24968,232,2022/4/15 8:20:00,128,478,-350
24969,24969,232,2022/4/15 8:30:00,93,591,-498
24970,24970,232,2022/4/15 8:40:00,112,1725,-1613
24971,24971,232,2022/4/15 8:50:00,93,1677,-1584
24972,24972,232,2022/4/15 9:00:00,82,1186,-1104
24973,24973,232,2022/4/15 9:10:00,79,486,-407
24974,24974,232,2022/4/15 9:20:00,79,424,-345
24975,24975,232,2022/4/15 9:30:00,73,425,-352
24976,24976,232,2022/4/15 9:40:00,71,428,-357
24977,24977,232,2022/4/15 9:50:00,68,345,-277
24978,24978,232,2022/4/15 10:00:00,73,318,-245
24979,24979,232,2022/4/15 10:10:00,75,223,-148
24980,24980,232,2022/4/15 10:20:00,69,171,-102
24981,24981,232,2022/4/15 10:30:00,82,179,-97
24982,24982,232,2022/4/15 10:40:00,75,139,-64
24983,24983,232,2022/4/15 10:50:00,66,122,-56
24984,24984,232,2022/4/15 11:00:00,70,111,-41
24985,24985,232,2022/4/15 11:10:00,67,105,-38
24986,24986,232,2022/4/15 11:20:00,66,114,-48
24987,24987,232,2022/4/15 11:30:00,75,105,-30
24988,24988,232,2022/4/15 11:40:00,73,111,-38
24989,24989,232,2022/4/15 11:50:00,73,87,-14
24990,24990,232,2022/4/15 12:00:00,71,105,-34
24991,24991,232,2022/4/15 12:10:00,74,105,-31
24992,24992,232,2022/4/15 12:20:00,68,105,-37
24993,24993,232,2022/4/15 12:30:00,67,118,-51
24994,24994,232,2022/4/15 12:40:00,55,101,-46
24995,24995,232,2022/4/15 12:50:00,44,117,-73
24996,24996,232,2022/4/15 13:00:00,46,121,-75
24997,24997,232,2022/4/15 13:10:00,46,108,-62
24998,24998,232,2022/4/15 13:20:00,47,110,-63
24999,24999,232,2022/4/15 13:30:00,55,104,-49
25000,25000,232,2022/4/15 13:40:00,62,109,-47
25001,25001,232,2022/4/15 13:50:00,70,122,-52
25002,25002,232,2022/4/15 14:00:00,71,109,-38
25003,25003,232,2022/4/15 14:10:00,94,123,-29
25004,25004,232,2022/4/15 14:20:00,131,103,28
25005,25005,232,2022/4/15 14:30:00,116,105,11
25006,25006,232,2022/4/15 14:40:00,139,111,28
25007,25007,232,2022/4/15 14:50:00,135,112,23
25008,25008,232,2022/4/15 15:00:00,136,103,33
25009,25009,232,2022/4/15 15:10:00,176,102,74
25010,25010,232,2022/4/15 15:20:00,190,112,78
25011,25011,232,2022/4/15 15:30:00,163,110,53
25012,25012,232,2022/4/15 15:40:00,184,99,85
25013,25013,232,2022/4/15 15:50:00,188,105,83
25014,25014,232,2022/4/15 16:00:00,223,101,122
25015,25015,232,2022/4/15 16:10:00,227,90,137
25016,25016,232,2022/4/15 16:20:00,244,101,143
25017,25017,232,2022/4/15 16:30:00,255,93,162
25018,25018,232,2022/4/15 16:40:00,336,93,243
25019,25019,232,2022/4/15 16:50:00,378,93,285
25020,25020,232,2022/4/15 17:00:00,568,100,468
25021,25021,232,2022/4/15 17:10:00,658,106,552
25022,25022,232,2022/4/15 17:20:00,571,105,466
25023,25023,232,2022/4/15 17:30:00,696,105,591
25024,25024,232,2022/4/15 17:40:00,1038,125,913
25025,25025,232,2022/4/15 17:50:00,608,121,487
25026,25026,232,2022/4/15 18:00:00,639,111,528
25027,25027,232,2022/4/15 18:10:00,1034,117,917
25028,25028,232,2022/4/15 18:20:00,714,104,610
25029,25029,232,2022/4/15 18:30:00,615,105,510
25030,25030,232,2022/4/15 18:40:00,551,110,441
25031,25031,232,2022/4/15 18:50:00,350,105,245
25032,25032,232,2022/4/15 19:00:00,273,120,153
25033,25033,232,2022/4/15 19:10:00,262,111,151
25034,25034,232,2022/4/15 19:20:00,212,95,117
25035,25035,232,2022/4/15 19:30:00,176,98,78
25036,25036,232,2022/4/15 19:40:00,138,79,59
25037,25037,232,2022/4/15 19:50:00,111,87,24
25038,25038,232,2022/4/15 20:00:00,88,72,16
25039,25039,232,2022/4/15 20:10:00,142,73,69
25040,25040,232,2022/4/15 20:20:00,86,74,12
25041,25041,232,2022/4/15 20:30:00,79,74,5
25042,25042,232,2022/4/15 20:40:00,73,70,3
25043,25043,232,2022/4/15 20:50:00,70,68,2
25044,25044,232,2022/4/15 21:00:00,70,67,3
25045,25045,232,2022/4/15 21:10:00,80,70,10
25046,25046,232,2022/4/15 21:20:00,62,70,-8
25047,25047,232,2022/4/15 21:30:00,68,61,7
25048,25048,232,2022/4/15 21:40:00,64,67,-3
25049,25049,232,2022/4/15 21:50:00,47,59,-12
25050,25050,232,2022/4/15 22:00:00,44,53,-9
25051,25051,232,2022/4/15 22:10:00,53,66,-13
25052,25052,232,2022/4/15 22:20:00,39,58,-19
25053,25053,232,2022/4/15 22:30:00,23,47,-24
25054,25054,232,2022/4/15 22:40:00,35,49,-14
25055,25055,232,2022/4/15 22:50:00,19,35,-16
25056,25056,233,2022/4/15 5:00:00,0,1,-1
25057,25057,233,2022/4/15 5:10:00,0,1,-1
25058,25058,233,2022/4/15 5:20:00,15,1,14
25059,25059,233,2022/4/15 5:30:00,27,1,26
25060,25060,233,2022/4/15 5:40:00,32,1,31
25061,25061,233,2022/4/15 5:50:00,36,8,28
25062,25062,233,2022/4/15 6:00:00,54,5,49
25063,25063,233,2022/4/15 6:10:00,59,11,48
25064,25064,233,2022/4/15 6:20:00,87,38,49
25065,25065,233,2022/4/15 6:30:00,123,38,85
25066,25066,233,2022/4/15 6:40:00,222,49,173
25067,25067,233,2022/4/15 6:50:00,224,61,163
25068,25068,233,2022/4/15 7:00:00,278,71,207
25069,25069,233,2022/4/15 7:10:00,282,76,206
25070,25070,233,2022/4/15 7:20:00,352,76,276
25071,25071,233,2022/4/15 7:30:00,597,81,516
25072,25072,233,2022/4/15 7:40:00,681,108,573
25073,25073,233,2022/4/15 7:50:00,744,100,644
25074,25074,233,2022/4/15 8:00:00,739,88,651
25075,25075,233,2022/4/15 8:10:00,693,100,593
25076,25076,233,2022/4/15 8:20:00,670,93,577
25077,25077,233,2022/4/15 8:30:00,598,93,505
25078,25078,233,2022/4/15 8:40:00,347,112,235
25079,25079,233,2022/4/15 8:50:00,278,90,188
25080,25080,233,2022/4/15 9:00:00,205,94,111
25081,25081,233,2022/4/15 9:10:00,187,93,94
25082,25082,233,2022/4/15 9:20:00,177,97,80
25083,25083,233,2022/4/15 9:30:00,82,74,8
25084,25084,233,2022/4/15 9:40:00,70,87,-17
25085,25085,233,2022/4/15 9:50:00,59,75,-16
25086,25086,233,2022/4/15 10:00:00,46,79,-33
25087,25087,233,2022/4/15 10:10:00,44,83,-39
25088,25088,233,2022/4/15 10:20:00,41,66,-25
25089,25089,233,2022/4/15 10:30:00,36,64,-28
25090,25090,233,2022/4/15 10:40:00,33,68,-35
25091,25091,233,2022/4/15 10:50:00,30,60,-30
25092,25092,233,2022/4/15 11:00:00,30,74,-44
25093,25093,233,2022/4/15 11:10:00,32,67,-35
25094,25094,233,2022/4/15 11:20:00,29,67,-38
25095,25095,233,2022/4/15 11:30:00,31,56,-25
25096,25096,233,2022/4/15 11:40:00,31,66,-35
25097,25097,233,2022/4/15 11:50:00,35,70,-35
25098,25098,233,2022/4/15 12:00:00,38,67,-29
25099,25099,233,2022/4/15 12:10:00,39,72,-33
25100,25100,233,2022/4/15 12:20:00,39,67,-28
25101,25101,233,2022/4/15 12:30:00,38,52,-14
25102,25102,233,2022/4/15 12:40:00,39,76,-37
25103,25103,233,2022/4/15 12:50:00,32,82,-50
25104,25104,233,2022/4/15 13:00:00,35,68,-33
25105,25105,233,2022/4/15 13:10:00,31,78,-47
25106,25106,233,2022/4/15 13:20:00,32,66,-34
25107,25107,233,2022/4/15 13:30:00,32,66,-34
25108,25108,233,2022/4/15 13:40:00,30,71,-41
25109,25109,233,2022/4/15 13:50:00,28,82,-54
25110,25110,233,2022/4/15 14:00:00,33,84,-51
25111,25111,233,2022/4/15 14:10:00,26,73,-47
25112,25112,233,2022/4/15 14:20:00,28,65,-37
25113,25113,233,2022/4/15 14:30:00,28,77,-49
25114,25114,233,2022/4/15 14:40:00,27,75,-48
25115,25115,233,2022/4/15 14:50:00,27,93,-66
25116,25116,233,2022/4/15 15:00:00,29,97,-68
25117,25117,233,2022/4/15 15:10:00,24,74,-50
25118,25118,233,2022/4/15 15:20:00,28,93,-65
25119,25119,233,2022/4/15 15:30:00,25,106,-81
25120,25120,233,2022/4/15 15:40:00,25,93,-68
25121,25121,233,2022/4/15 15:50:00,26,112,-86
25122,25122,233,2022/4/15 16:00:00,28,102,-74
25123,25123,233,2022/4/15 16:10:00,34,105,-71
25124,25124,233,2022/4/15 16:20:00,29,90,-61
25125,25125,233,2022/4/15 16:30:00,33,107,-74
25126,25126,233,2022/4/15 16:40:00,40,124,-84
25127,25127,233,2022/4/15 16:50:00,37,111,-74
25128,25128,233,2022/4/15 17:00:00,46,107,-61
25129,25129,233,2022/4/15 17:10:00,45,108,-63
25130,25130,233,2022/4/15 17:20:00,45,120,-75
25131,25131,233,2022/4/15 17:30:00,46,196,-150
25132,25132,233,2022/4/15 17:40:00,43,222,-179
25133,25133,233,2022/4/15 17:50:00,37,178,-141
25134,25134,233,2022/4/15 18:00:00,43,224,-181
25135,25135,233,2022/4/15 18:10:00,44,232,-188
25136,25136,233,2022/4/15 18:20:00,38,325,-287
25137,25137,233,2022/4/15 18:30:00,38,378,-340
25138,25138,233,2022/4/15 18:40:00,34,285,-251
25139,25139,233,2022/4/15 18:50:00,35,348,-313
25140,25140,233,2022/4/15 19:00:00,33,256,-223
25141,25141,233,2022/4/15 19:10:00,30,224,-194
25142,25142,233,2022/4/15 19:20:00,27,180,-153
25143,25143,233,2022/4/15 19:30:00,29,184,-155
25144,25144,233,2022/4/15 19:40:00,25,107,-82
25145,25145,233,2022/4/15 19:50:00,27,128,-101
25146,25146,233,2022/4/15 20:00:00,22,126,-104
25147,25147,233,2022/4/15 20:10:00,28,113,-85
25148,25148,233,2022/4/15 20:20:00,22,106,-84
25149,25149,233,2022/4/15 20:30:00,23,112,-89
25150,25150,233,2022/4/15 20:40:00,23,120,-97
25151,25151,233,2022/4/15 20:50:00,23,112,-89
25152,25152,233,2022/4/15 21:00:00,23,111,-88
25153,25153,233,2022/4/15 21:10:00,21,110,-89
25154,25154,233,2022/4/15 21:20:00,20,106,-86
25155,25155,233,2022/4/15 21:30:00,16,88,-72
25156,25156,233,2022/4/15 21:40:00,18,98,-80
25157,25157,233,2022/4/15 21:50:00,13,112,-99
25158,25158,233,2022/4/15 22:00:00,15,107,-92
25159,25159,233,2022/4/15 22:10:00,11,103,-92
25160,25160,233,2022/4/15 22:20:00,10,103,-93
25161,25161,233,2022/4/15 22:30:00,5,104,-99
25162,25162,233,2022/4/15 22:40:00,5,106,-101
25163,25163,233,2022/4/15 22:50:00,2,94,-92
25164,25164,234,2022/4/15 5:00:00,0,1,-1
25165,25165,234,2022/4/15 5:10:00,0,1,-1
25166,25166,234,2022/4/15 5:20:00,3,1,2
25167,25167,234,2022/4/15 5:30:00,9,1,8
25168,25168,234,2022/4/15 5:40:00,10,1,9
25169,25169,234,2022/4/15 5:50:00,12,1,11
25170,25170,234,2022/4/15 6:00:00,21,1,20
25171,25171,234,2022/4/15 6:10:00,20,1,19
25172,25172,234,2022/4/15 6:20:00,25,23,2
25173,25173,234,2022/4/15 6:30:00,26,14,12
25174,25174,234,2022/4/15 6:40:00,32,16,16
25175,25175,234,2022/4/15 6:50:00,34,23,11
25176,25176,234,2022/4/15 7:00:00,40,23,17
25177,25177,234,2022/4/15 7:10:00,57,33,24
25178,25178,234,2022/4/15 7:20:00,59,66,-7
25179,25179,234,2022/4/15 7:30:00,85,46,39
25180,25180,234,2022/4/15 7:40:00,176,62,114
25181,25181,234,2022/4/15 7:50:00,221,62,159
25182,25182,234,2022/4/15 8:00:00,224,76,148
25183,25183,234,2022/4/15 8:10:00,216,107,109
25184,25184,234,2022/4/15 8:20:00,179,99,80
25185,25185,234,2022/4/15 8:30:00,106,97,9
25186,25186,234,2022/4/15 8:40:00,70,75,-5
25187,25187,234,2022/4/15 8:50:00,51,76,-25
25188,25188,234,2022/4/15 9:00:00,44,70,-26
25189,25189,234,2022/4/15 9:10:00,36,67,-31
25190,25190,234,2022/4/15 9:20:00,28,60,-32
25191,25191,234,2022/4/15 9:30:00,26,63,-37
25192,25192,234,2022/4/15 9:40:00,28,51,-23
25193,25193,234,2022/4/15 9:50:00,22,51,-29
25194,25194,234,2022/4/15 10:00:00,20,47,-27
25195,25195,234,2022/4/15 10:10:00,21,42,-21
25196,25196,234,2022/4/15 10:20:00,16,38,-22
25197,25197,234,2022/4/15 10:30:00,15,43,-28
25198,25198,234,2022/4/15 10:40:00,16,35,-19
25199,25199,234,2022/4/15 10:50:00,13,38,-25
25200,25200,234,2022/4/15 11:00:00,15,32,-17
25201,25201,234,2022/4/15 11:10:00,16,33,-17
25202,25202,234,2022/4/15 11:20:00,16,38,-22
25203,25203,234,2022/4/15 11:30:00,17,35,-18
25204,25204,234,2022/4/15 11:40:00,15,38,-23
25205,25205,234,2022/4/15 11:50:00,16,38,-22
25206,25206,234,2022/4/15 12:00:00,18,31,-13
25207,25207,234,2022/4/15 12:10:00,18,38,-20
25208,25208,234,2022/4/15 12:20:00,15,47,-32
25209,25209,234,2022/4/15 12:30:00,17,38,-21
25210,25210,234,2022/4/15 12:40:00,16,45,-29
25211,25211,234,2022/4/15 12:50:00,16,40,-24
25212,25212,234,2022/4/15 13:00:00,15,35,-20
25213,25213,234,2022/4/15 13:10:00,19,47,-28
25214,25214,234,2022/4/15 13:20:00,16,43,-27
25215,25215,234,2022/4/15 13:30:00,15,45,-30
25216,25216,234,2022/4/15 13:40:00,14,47,-33
25217,25217,234,2022/4/15 13:50:00,16,25,-9
25218,25218,234,2022/4/15 14:00:00,17,41,-24
25219,25219,234,2022/4/15 14:10:00,16,47,-31
25220,25220,234,2022/4/15 14:20:00,15,47,-32
25221,25221,234,2022/4/15 14:30:00,16,41,-25
25222,25222,234,2022/4/15 14:40:00,15,31,-16
25223,25223,234,2022/4/15 14:50:00,17,38,-21
25224,25224,234,2022/4/15 15:00:00,16,43,-27
25225,25225,234,2022/4/15 15:10:00,19,45,-26
25226,25226,234,2022/4/15 15:20:00,17,45,-28
25227,25227,234,2022/4/15 15:30:00,15,46,-31
25228,25228,234,2022/4/15 15:40:00,16,37,-21
25229,25229,234,2022/4/15 15:50:00,17,46,-29
25230,25230,234,2022/4/15 16:00:00,18,50,-32
25231,25231,234,2022/4/15 16:10:00,18,51,-33
25232,25232,234,2022/4/15 16:20:00,21,50,-29
25233,25233,234,2022/4/15 16:30:00,24,55,-31
25234,25234,234,2022/4/15 16:40:00,29,61,-32
25235,25235,234,2022/4/15 16:50:00,25,48,-23
25236,25236,234,2022/4/15 17:00:00,37,64,-27
25237,25237,234,2022/4/15 17:10:00,60,71,-11
25238,25238,234,2022/4/15 17:20:00,32,72,-40
25239,25239,234,2022/4/15 17:30:00,39,70,-31
25240,25240,234,2022/4/15 17:40:00,46,79,-33
25241,25241,234,2022/4/15 17:50:00,35,114,-79
25242,25242,234,2022/4/15 18:00:00,30,95,-65
25243,25243,234,2022/4/15 18:10:00,31,83,-52
25244,25244,234,2022/4/15 18:20:00,29,93,-64
25245,25245,234,2022/4/15 18:30:00,28,110,-82
25246,25246,234,2022/4/15 18:40:00,23,125,-102
25247,25247,234,2022/4/15 18:50:00,20,89,-69
25248,25248,234,2022/4/15 19:00:00,19,97,-78
25249,25249,234,2022/4/15 19:10:00,15,106,-91
25250,25250,234,2022/4/15 19:20:00,15,95,-80
25251,25251,234,2022/4/15 19:30:00,15,94,-79
25252,25252,234,2022/4/15 19:40:00,14,79,-65
25253,25253,234,2022/4/15 19:50:00,15,77,-62
25254,25254,234,2022/4/15 20:00:00,15,73,-58
25255,25255,234,2022/4/15 20:10:00,13,74,-61
25256,25256,234,2022/4/15 20:20:00,10,59,-49
25257,25257,234,2022/4/15 20:30:00,10,62,-52
25258,25258,234,2022/4/15 20:40:00,8,62,-54
25259,25259,234,2022/4/15 20:50:00,10,72,-62
25260,25260,234,2022/4/15 21:00:00,10,64,-54
25261,25261,234,2022/4/15 21:10:00,13,42,-29
25262,25262,234,2022/4/15 21:20:00,10,67,-57
25263,25263,234,2022/4/15 21:30:00,11,59,-48
25264,25264,234,2022/4/15 21:40:00,7,63,-56
25265,25265,234,2022/4/15 21:50:00,9,68,-59
25266,25266,234,2022/4/15 22:00:00,5,57,-52
25267,25267,234,2022/4/15 22:10:00,5,67,-62
25268,25268,234,2022/4/15 22:20:00,10,52,-42
25269,25269,234,2022/4/15 22:30:00,2,58,-56
25270,25270,234,2022/4/15 22:40:00,2,54,-52
25271,25271,234,2022/4/15 22:50:00,1,40,-39
25272,25272,235,2022/4/15 5:00:00,0,1,-1
25273,25273,235,2022/4/15 5:10:00,1,1,0
25274,25274,235,2022/4/15 5:20:00,10,1,9
25275,25275,235,2022/4/15 5:30:00,22,1,21
25276,25276,235,2022/4/15 5:40:00,35,1,34
25277,25277,235,2022/4/15 5:50:00,31,1,30
25278,25278,235,2022/4/15 6:00:00,51,16,35
25279,25279,235,2022/4/15 6:10:00,83,23,60
25280,25280,235,2022/4/15 6:20:00,125,28,97
25281,25281,235,2022/4/15 6:30:00,228,34,194
25282,25282,235,2022/4/15 6:40:00,302,50,252
25283,25283,235,2022/4/15 6:50:00,330,65,265
25284,25284,235,2022/4/15 7:00:00,593,73,520
25285,25285,235,2022/4/15 7:10:00,722,84,638
25286,25286,235,2022/4/15 7:20:00,729,76,653
25287,25287,235,2022/4/15 7:30:00,859,99,760
25288,25288,235,2022/4/15 7:40:00,1213,100,1113
25289,25289,235,2022/4/15 7:50:00,1586,112,1474
25290,25290,235,2022/4/15 8:00:00,1588,120,1468
25291,25291,235,2022/4/15 8:10:00,1573,109,1464
25292,25292,235,2022/4/15 8:20:00,1364,87,1277
25293,25293,235,2022/4/15 8:30:00,1212,122,1090
25294,25294,235,2022/4/15 8:40:00,1054,123,931
25295,25295,235,2022/4/15 8:50:00,723,110,613
25296,25296,235,2022/4/15 9:00:00,586,101,485
25297,25297,235,2022/4/15 9:10:00,374,104,270
25298,25298,235,2022/4/15 9:20:00,277,109,168
25299,25299,235,2022/4/15 9:30:00,231,90,141
25300,25300,235,2022/4/15 9:40:00,224,91,133
25301,25301,235,2022/4/15 9:50:00,182,104,78
25302,25302,235,2022/4/15 10:00:00,130,93,37
25303,25303,235,2022/4/15 10:10:00,95,76,19
25304,25304,235,2022/4/15 10:20:00,73,76,-3
25305,25305,235,2022/4/15 10:30:00,62,68,-6
25306,25306,235,2022/4/15 10:40:00,48,98,-50
25307,25307,235,2022/4/15 10:50:00,45,92,-47
25308,25308,235,2022/4/15 11:00:00,42,73,-31
25309,25309,235,2022/4/15 11:10:00,44,83,-39
25310,25310,235,2022/4/15 11:20:00,47,93,-46
25311,25311,235,2022/4/15 11:30:00,44,93,-49
25312,25312,235,2022/4/15 11:40:00,47,94,-47
25313,25313,235,2022/4/15 11:50:00,44,77,-33
25314,25314,235,2022/4/15 12:00:00,47,100,-53
25315,25315,235,2022/4/15 12:10:00,58,104,-46
25316,25316,235,2022/4/15 12:20:00,59,114,-55
25317,25317,235,2022/4/15 12:30:00,58,111,-53
25318,25318,235,2022/4/15 12:40:00,56,96,-40
25319,25319,235,2022/4/15 12:50:00,59,77,-18
25320,25320,235,2022/4/15 13:00:00,56,109,-53
25321,25321,235,2022/4/15 13:10:00,48,91,-43
25322,25322,235,2022/4/15 13:20:00,49,105,-56
25323,25323,235,2022/4/15 13:30:00,54,103,-49
25324,25324,235,2022/4/15 13:40:00,45,74,-29
25325,25325,235,2022/4/15 13:50:00,41,105,-64
25326,25326,235,2022/4/15 14:00:00,44,103,-59
25327,25327,235,2022/4/15 14:10:00,41,104,-63
25328,25328,235,2022/4/15 14:20:00,40,102,-62
25329,25329,235,2022/4/15 14:30:00,36,100,-64
25330,25330,235,2022/4/15 14:40:00,39,100,-61
25331,25331,235,2022/4/15 14:50:00,38,121,-83
25332,25332,235,2022/4/15 15:00:00,37,122,-85
25333,25333,235,2022/4/15 15:10:00,42,124,-82
25334,25334,235,2022/4/15 15:20:00,44,125,-81
25335,25335,235,2022/4/15 15:30:00,44,94,-50
25336,25336,235,2022/4/15 15:40:00,39,117,-78
25337,25337,235,2022/4/15 15:50:00,37,129,-92
25338,25338,235,2022/4/15 16:00:00,40,117,-77
25339,25339,235,2022/4/15 16:10:00,42,182,-140
25340,25340,235,2022/4/15 16:20:00,41,183,-142
25341,25341,235,2022/4/15 16:30:00,48,151,-103
25342,25342,235,2022/4/15 16:40:00,49,121,-72
25343,25343,235,2022/4/15 16:50:00,49,235,-186
25344,25344,235,2022/4/15 17:00:00,63,230,-167
25345,25345,235,2022/4/15 17:10:00,69,295,-226
25346,25346,235,2022/4/15 17:20:00,82,372,-290
25347,25347,235,2022/4/15 17:30:00,65,529,-464
25348,25348,235,2022/4/15 17:40:00,67,498,-431
25349,25349,235,2022/4/15 17:50:00,66,477,-411
25350,25350,235,2022/4/15 18:00:00,50,572,-522
25351,25351,235,2022/4/15 18:10:00,55,431,-376
25352,25352,235,2022/4/15 18:20:00,48,1214,-1166
25353,25353,235,2022/4/15 18:30:00,43,429,-386
25354,25354,235,2022/4/15 18:40:00,43,645,-602
25355,25355,235,2022/4/15 18:50:00,39,576,-537
25356,25356,235,2022/4/15 19:00:00,38,432,-394
25357,25357,235,2022/4/15 19:10:00,32,503,-471
25358,25358,235,2022/4/15 19:20:00,33,379,-346
25359,25359,235,2022/4/15 19:30:00,28,218,-190
25360,25360,235,2022/4/15 19:40:00,32,217,-185
25361,25361,235,2022/4/15 19:50:00,27,196,-169
25362,25362,235,2022/4/15 20:00:00,29,159,-130
25363,25363,235,2022/4/15 20:10:00,36,180,-144
25364,25364,235,2022/4/15 20:20:00,32,132,-100
25365,25365,235,2022/4/15 20:30:00,35,117,-82
25366,25366,235,2022/4/15 20:40:00,28,104,-76
25367,25367,235,2022/4/15 20:50:00,28,128,-100
25368,25368,235,2022/4/15 21:00:00,26,192,-166
25369,25369,235,2022/4/15 21:10:00,29,114,-85
25370,25370,235,2022/4/15 21:20:00,31,111,-80
25371,25371,235,2022/4/15 21:30:00,29,109,-80
25372,25372,235,2022/4/15 21:40:00,26,119,-93
25373,25373,235,2022/4/15 21:50:00,26,110,-84
25374,25374,235,2022/4/15 22:00:00,22,109,-87
25375,25375,235,2022/4/15 22:10:00,18,120,-102
25376,25376,235,2022/4/15 22:20:00,18,123,-105
25377,25377,235,2022/4/15 22:30:00,13,123,-110
25378,25378,235,2022/4/15 22:40:00,5,122,-117
25379,25379,235,2022/4/15 22:50:00,2,95,-93
25380,25380,236,2022/4/15 5:00:00,0,1,-1
25381,25381,236,2022/4/15 5:10:00,0,1,-1
25382,25382,236,2022/4/15 5:20:00,1,1,0
25383,25383,236,2022/4/15 5:30:00,2,1,1
25384,25384,236,2022/4/15 5:40:00,3,1,2
25385,25385,236,2022/4/15 5:50:00,4,21,-17
25386,25386,236,2022/4/15 6:00:00,6,38,-32
25387,25387,236,2022/4/15 6:10:00,8,31,-23
25388,25388,236,2022/4/15 6:20:00,14,60,-46
25389,25389,236,2022/4/15 6:30:00,18,72,-54
25390,25390,236,2022/4/15 6:40:00,18,99,-81
25391,25391,236,2022/4/15 6:50:00,20,110,-90
25392,25392,236,2022/4/15 7:00:00,28,126,-98
25393,25393,236,2022/4/15 7:10:00,31,111,-80
25394,25394,236,2022/4/15 7:20:00,33,110,-77
25395,25395,236,2022/4/15 7:30:00,37,119,-82
25396,25396,236,2022/4/15 7:40:00,44,182,-138
25397,25397,236,2022/4/15 7:50:00,46,148,-102
25398,25398,236,2022/4/15 8:00:00,52,144,-92
25399,25399,236,2022/4/15 8:10:00,53,169,-116
25400,25400,236,2022/4/15 8:20:00,57,104,-47
25401,25401,236,2022/4/15 8:30:00,60,109,-49
25402,25402,236,2022/4/15 8:40:00,53,109,-56
25403,25403,236,2022/4/15 8:50:00,68,108,-40
25404,25404,236,2022/4/15 9:00:00,57,110,-53
25405,25405,236,2022/4/15 9:10:00,59,102,-43
25406,25406,236,2022/4/15 9:20:00,49,125,-76
25407,25407,236,2022/4/15 9:30:00,60,104,-44
25408,25408,236,2022/4/15 9:40:00,54,85,-31
25409,25409,236,2022/4/15 9:50:00,56,104,-48
25410,25410,236,2022/4/15 10:00:00,44,101,-57
25411,25411,236,2022/4/15 10:10:00,53,106,-53
25412,25412,236,2022/4/15 10:20:00,54,87,-33
25413,25413,236,2022/4/15 10:30:00,48,91,-43
25414,25414,236,2022/4/15 10:40:00,51,87,-36
25415,25415,236,2022/4/15 10:50:00,43,77,-34
25416,25416,236,2022/4/15 11:00:00,54,63,-9
25417,25417,236,2022/4/15 11:10:00,44,67,-23
25418,25418,236,2022/4/15 11:20:00,50,64,-14
25419,25419,236,2022/4/15 11:30:00,43,73,-30
25420,25420,236,2022/4/15 11:40:00,46,69,-23
25421,25421,236,2022/4/15 11:50:00,43,76,-33
25422,25422,236,2022/4/15 12:00:00,41,73,-32
25423,25423,236,2022/4/15 12:10:00,40,73,-33
25424,25424,236,2022/4/15 12:20:00,37,74,-37
25425,25425,236,2022/4/15 12:30:00,37,91,-54
25426,25426,236,2022/4/15 12:40:00,33,92,-59
25427,25427,236,2022/4/15 12:50:00,29,96,-67
25428,25428,236,2022/4/15 13:00:00,37,93,-56
25429,25429,236,2022/4/15 13:10:00,29,90,-61
25430,25430,236,2022/4/15 13:20:00,37,104,-67
25431,25431,236,2022/4/15 13:30:00,35,90,-55
25432,25432,236,2022/4/15 13:40:00,39,90,-51
25433,25433,236,2022/4/15 13:50:00,43,87,-44
25434,25434,236,2022/4/15 14:00:00,44,85,-41
25435,25435,236,2022/4/15 14:10:00,47,84,-37
25436,25436,236,2022/4/15 14:20:00,47,85,-38
25437,25437,236,2022/4/15 14:30:00,46,92,-46
25438,25438,236,2022/4/15 14:40:00,54,77,-23
25439,25439,236,2022/4/15 14:50:00,47,70,-23
25440,25440,236,2022/4/15 15:00:00,63,64,-1
25441,25441,236,2022/4/15 15:10:00,53,74,-21
25442,25442,236,2022/4/15 15:20:00,62,69,-7
25443,25443,236,2022/4/15 15:30:00,59,75,-16
25444,25444,236,2022/4/15 15:40:00,61,63,-2
25445,25445,236,2022/4/15 15:50:00,59,60,-1
25446,25446,236,2022/4/15 16:00:00,73,74,-1
25447,25447,236,2022/4/15 16:10:00,62,62,0
25448,25448,236,2022/4/15 16:20:00,68,70,-2
25449,25449,236,2022/4/15 16:30:00,70,64,6
25450,25450,236,2022/4/15 16:40:00,74,64,10
25451,25451,236,2022/4/15 16:50:00,73,64,9
25452,25452,236,2022/4/15 17:00:00,133,67,66
25453,25453,236,2022/4/15 17:10:00,156,62,94
25454,25454,236,2022/4/15 17:20:00,76,77,-1
25455,25455,236,2022/4/15 17:30:00,67,76,-9
25456,25456,236,2022/4/15 17:40:00,65,88,-23
25457,25457,236,2022/4/15 17:50:00,48,77,-29
25458,25458,236,2022/4/15 18:00:00,43,95,-52
25459,25459,236,2022/4/15 18:10:00,38,106,-68
25460,25460,236,2022/4/15 18:20:00,36,89,-53
25461,25461,236,2022/4/15 18:30:00,31,93,-62
25462,25462,236,2022/4/15 18:40:00,35,91,-56
25463,25463,236,2022/4/15 18:50:00,31,90,-59
25464,25464,236,2022/4/15 19:00:00,28,77,-49
25465,25465,236,2022/4/15 19:10:00,28,70,-42
25466,25466,236,2022/4/15 19:20:00,29,66,-37
25467,25467,236,2022/4/15 19:30:00,28,67,-39
25468,25468,236,2022/4/15 19:40:00,29,55,-26
25469,25469,236,2022/4/15 19:50:00,26,63,-37
25470,25470,236,2022/4/15 20:00:00,29,59,-30
25471,25471,236,2022/4/15 20:10:00,30,53,-23
25472,25472,236,2022/4/15 20:20:00,29,54,-25
25473,25473,236,2022/4/15 20:30:00,30,54,-24
25474,25474,236,2022/4/15 20:40:00,28,50,-22
25475,25475,236,2022/4/15 20:50:00,25,63,-38
25476,25476,236,2022/4/15 21:00:00,22,55,-33
25477,25477,236,2022/4/15 21:10:00,22,46,-24
25478,25478,236,2022/4/15 21:20:00,22,56,-34
25479,25479,236,2022/4/15 21:30:00,15,57,-42
25480,25480,236,2022/4/15 21:40:00,16,52,-36
25481,25481,236,2022/4/15 21:50:00,13,52,-39
25482,25482,236,2022/4/15 22:00:00,16,43,-27
25483,25483,236,2022/4/15 22:10:00,13,48,-35
25484,25484,236,2022/4/15 22:20:00,10,40,-30
25485,25485,236,2022/4/15 22:30:00,6,43,-37
25486,25486,236,2022/4/15 22:40:00,4,25,-21
25487,25487,236,2022/4/15 22:50:00,2,23,-21
25488,25488,237,2022/4/15 5:00:00,2,1,1
25489,25489,237,2022/4/15 5:10:00,7,1,6
25490,25490,237,2022/4/15 5:20:00,19,1,18
25491,25491,237,2022/4/15 5:30:00,25,1,24
25492,25492,237,2022/4/15 5:40:00,29,2,27
25493,25493,237,2022/4/15 5:50:00,32,2,30
25494,25494,237,2022/4/15 6:00:00,45,5,40
25495,25495,237,2022/4/15 6:10:00,54,5,49
25496,25496,237,2022/4/15 6:20:00,91,51,40
25497,25497,237,2022/4/15 6:30:00,168,55,113
25498,25498,237,2022/4/15 6:40:00,228,64,164
25499,25499,237,2022/4/15 6:50:00,251,77,174
25500,25500,237,2022/4/15 7:00:00,356,107,249
25501,25501,237,2022/4/15 7:10:00,366,104,262
25502,25502,237,2022/4/15 7:20:00,642,99,543
25503,25503,237,2022/4/15 7:30:00,687,110,577
25504,25504,237,2022/4/15 7:40:00,1049,139,910
25505,25505,237,2022/4/15 7:50:00,1215,128,1087
25506,25506,237,2022/4/15 8:00:00,1209,144,1065
25507,25507,237,2022/4/15 8:10:00,1360,128,1232
25508,25508,237,2022/4/15 8:20:00,1169,104,1065
25509,25509,237,2022/4/15 8:30:00,1036,109,927
25510,25510,237,2022/4/15 8:40:00,831,125,706
25511,25511,237,2022/4/15 8:50:00,720,110,610
25512,25512,237,2022/4/15 9:00:00,584,112,472
25513,25513,237,2022/4/15 9:10:00,435,106,329
25514,25514,237,2022/4/15 9:20:00,319,112,207
25515,25515,237,2022/4/15 9:30:00,236,97,139
25516,25516,237,2022/4/15 9:40:00,197,89,108
25517,25517,237,2022/4/15 9:50:00,117,96,21
25518,25518,237,2022/4/15 10:00:00,82,105,-23
25519,25519,237,2022/4/15 10:10:00,72,69,3
25520,25520,237,2022/4/15 10:20:00,59,92,-33
25521,25521,237,2022/4/15 10:30:00,66,93,-27
25522,25522,237,2022/4/15 10:40:00,56,93,-37
25523,25523,237,2022/4/15 10:50:00,66,77,-11
25524,25524,237,2022/4/15 11:00:00,45,77,-32
25525,25525,237,2022/4/15 11:10:00,55,77,-22
25526,25526,237,2022/4/15 11:20:00,50,64,-14
25527,25527,237,2022/4/15 11:30:00,46,87,-41
25528,25528,237,2022/4/15 11:40:00,50,77,-27
25529,25529,237,2022/4/15 11:50:00,55,76,-21
25530,25530,237,2022/4/15 12:00:00,54,74,-20
25531,25531,237,2022/4/15 12:10:00,52,82,-30
25532,25532,237,2022/4/15 12:20:00,51,92,-41
25533,25533,237,2022/4/15 12:30:00,57,90,-33
25534,25534,237,2022/4/15 12:40:00,46,90,-44
25535,25535,237,2022/4/15 12:50:00,45,108,-63
25536,25536,237,2022/4/15 13:00:00,46,109,-63
25537,25537,237,2022/4/15 13:10:00,45,76,-31
25538,25538,237,2022/4/15 13:20:00,42,111,-69
25539,25539,237,2022/4/15 13:30:00,47,93,-46
25540,25540,237,2022/4/15 13:40:00,45,92,-47
25541,25541,237,2022/4/15 13:50:00,41,104,-63
25542,25542,237,2022/4/15 14:00:00,41,92,-51
25543,25543,237,2022/4/15 14:10:00,44,93,-49
25544,25544,237,2022/4/15 14:20:00,44,105,-61
25545,25545,237,2022/4/15 14:30:00,38,99,-61
25546,25546,237,2022/4/15 14:40:00,39,105,-66
25547,25547,237,2022/4/15 14:50:00,43,104,-61
25548,25548,237,2022/4/15 15:00:00,39,76,-37
25549,25549,237,2022/4/15 15:10:00,43,104,-61
25550,25550,237,2022/4/15 15:20:00,40,109,-69
25551,25551,237,2022/4/15 15:30:00,46,104,-58
25552,25552,237,2022/4/15 15:40:00,44,106,-62
25553,25553,237,2022/4/15 15:50:00,47,111,-64
25554,25554,237,2022/4/15 16:00:00,52,100,-48
25555,25555,237,2022/4/15 16:10:00,46,101,-55
25556,25556,237,2022/4/15 16:20:00,48,121,-73
25557,25557,237,2022/4/15 16:30:00,68,106,-38
25558,25558,237,2022/4/15 16:40:00,61,108,-47
25559,25559,237,2022/4/15 16:50:00,66,139,-73
25560,25560,237,2022/4/15 17:00:00,103,119,-16
25561,25561,237,2022/4/15 17:10:00,140,127,13
25562,25562,237,2022/4/15 17:20:00,160,157,3
25563,25563,237,2022/4/15 17:30:00,89,196,-107
25564,25564,237,2022/4/15 17:40:00,136,376,-240
25565,25565,237,2022/4/15 17:50:00,115,332,-217
25566,25566,237,2022/4/15 18:00:00,75,282,-207
25567,25567,237,2022/4/15 18:10:00,48,508,-460
25568,25568,237,2022/4/15 18:20:00,44,534,-490
25569,25569,237,2022/4/15 18:30:00,42,502,-460
25570,25570,237,2022/4/15 18:40:00,35,432,-397
25571,25571,237,2022/4/15 18:50:00,38,502,-464
25572,25572,237,2022/4/15 19:00:00,25,533,-508
25573,25573,237,2022/4/15 19:10:00,34,381,-347
25574,25574,237,2022/4/15 19:20:00,31,301,-270
25575,25575,237,2022/4/15 19:30:00,26,176,-150
25576,25576,237,2022/4/15 19:40:00,24,190,-166
25577,25577,237,2022/4/15 19:50:00,27,177,-150
25578,25578,237,2022/4/15 20:00:00,27,152,-125
25579,25579,237,2022/4/15 20:10:00,28,121,-93
25580,25580,237,2022/4/15 20:20:00,23,121,-98
25581,25581,237,2022/4/15 20:30:00,27,117,-90
25582,25582,237,2022/4/15 20:40:00,28,125,-97
25583,25583,237,2022/4/15 20:50:00,22,116,-94
25584,25584,237,2022/4/15 21:00:00,27,110,-83
25585,25585,237,2022/4/15 21:10:00,26,144,-118
25586,25586,237,2022/4/15 21:20:00,26,120,-94
25587,25587,237,2022/4/15 21:30:00,25,104,-79
25588,25588,237,2022/4/15 21:40:00,22,119,-97
25589,25589,237,2022/4/15 21:50:00,16,110,-94
25590,25590,237,2022/4/15 22:00:00,17,122,-105
25591,25591,237,2022/4/15 22:10:00,13,125,-112
25592,25592,237,2022/4/15 22:20:00,9,110,-101
25593,25593,237,2022/4/15 22:30:00,4,105,-101
25594,25594,237,2022/4/15 22:40:00,1,95,-94
25595,25595,237,2022/4/15 22:50:00,1,112,-111
25596,25596,238,2022/4/15 5:00:00,0,1,-1
25597,25597,238,2022/4/15 5:10:00,2,1,1
25598,25598,238,2022/4/15 5:20:00,16,1,15
25599,25599,238,2022/4/15 5:30:00,31,1,30
25600,25600,238,2022/4/15 5:40:00,32,5,27
25601,25601,238,2022/4/15 5:50:00,38,5,33
25602,25602,238,2022/4/15 6:00:00,83,1,82
25603,25603,238,2022/4/15 6:10:00,71,5,66
25604,25604,238,2022/4/15 6:20:00,181,5,176
25605,25605,238,2022/4/15 6:30:00,237,67,170
25606,25606,238,2022/4/15 6:40:00,302,37,265
25607,25607,238,2022/4/15 6:50:00,275,72,203
25608,25608,238,2022/4/15 7:00:00,601,66,535
25609,25609,238,2022/4/15 7:10:00,700,79,621
25610,25610,238,2022/4/15 7:20:00,850,93,757
25611,25611,238,2022/4/15 7:30:00,1226,105,1121
25612,25612,238,2022/4/15 7:40:00,1371,109,1262
25613,25613,238,2022/4/15 7:50:00,1364,123,1241
25614,25614,238,2022/4/15 8:00:00,1363,91,1272
25615,25615,238,2022/4/15 8:10:00,1169,108,1061
25616,25616,238,2022/4/15 8:20:00,842,123,719
25617,25617,238,2022/4/15 8:30:00,719,159,560
25618,25618,238,2022/4/15 8:40:00,469,110,359
25619,25619,238,2022/4/15 8:50:00,361,103,258
25620,25620,238,2022/4/15 9:00:00,274,120,154
25621,25621,238,2022/4/15 9:10:00,217,118,99
25622,25622,238,2022/4/15 9:20:00,182,110,72
25623,25623,238,2022/4/15 9:30:00,116,174,-58
25624,25624,238,2022/4/15 9:40:00,85,154,-69
25625,25625,238,2022/4/15 9:50:00,75,113,-38
25626,25626,238,2022/4/15 10:00:00,62,179,-117
25627,25627,238,2022/4/15 10:10:00,67,128,-61
25628,25628,238,2022/4/15 10:20:00,62,128,-66
25629,25629,238,2022/4/15 10:30:00,59,144,-85
25630,25630,238,2022/4/15 10:40:00,38,116,-78
25631,25631,238,2022/4/15 10:50:00,58,125,-67
25632,25632,238,2022/4/15 11:00:00,43,119,-76
25633,25633,238,2022/4/15 11:10:00,47,85,-38
25634,25634,238,2022/4/15 11:20:00,44,121,-77
25635,25635,238,2022/4/15 11:30:00,61,109,-48
25636,25636,238,2022/4/15 11:40:00,69,108,-39
25637,25637,238,2022/4/15 11:50:00,74,109,-35
25638,25638,238,2022/4/15 12:00:00,64,121,-57
25639,25639,238,2022/4/15 12:10:00,84,112,-28
25640,25640,238,2022/4/15 12:20:00,69,120,-51
25641,25641,238,2022/4/15 12:30:00,70,114,-44
25642,25642,238,2022/4/15 12:40:00,56,97,-41
25643,25643,238,2022/4/15 12:50:00,115,88,27
25644,25644,238,2022/4/15 13:00:00,61,108,-47
25645,25645,238,2022/4/15 13:10:00,107,109,-2
25646,25646,238,2022/4/15 13:20:00,116,107,9
25647,25647,238,2022/4/15 13:30:00,107,105,2
25648,25648,238,2022/4/15 13:40:00,119,109,10
25649,25649,238,2022/4/15 13:50:00,104,109,-5
25650,25650,238,2022/4/15 14:00:00,104,108,-4
25651,25651,238,2022/4/15 14:10:00,112,112,0
25652,25652,238,2022/4/15 14:20:00,102,114,-12
25653,25653,238,2022/4/15 14:30:00,101,110,-9
25654,25654,238,2022/4/15 14:40:00,119,77,42
25655,25655,238,2022/4/15 14:50:00,102,117,-15
25656,25656,238,2022/4/15 15:00:00,108,124,-16
25657,25657,238,2022/4/15 15:10:00,119,150,-31
25658,25658,238,2022/4/15 15:20:00,132,75,57
25659,25659,238,2022/4/15 15:30:00,121,128,-7
25660,25660,238,2022/4/15 15:40:00,132,60,72
25661,25661,238,2022/4/15 15:50:00,130,117,13
25662,25662,238,2022/4/15 16:00:00,130,144,-14
25663,25663,238,2022/4/15 16:10:00,130,122,8
25664,25664,238,2022/4/15 16:20:00,125,120,5
25665,25665,238,2022/4/15 16:30:00,130,96,34
25666,25666,238,2022/4/15 16:40:00,176,197,-21
25667,25667,238,2022/4/15 16:50:00,169,112,57
25668,25668,238,2022/4/15 17:00:00,136,110,26
25669,25669,238,2022/4/15 17:10:00,185,145,40
25670,25670,238,2022/4/15 17:20:00,99,179,-80
25671,25671,238,2022/4/15 17:30:00,73,218,-145
25672,25672,238,2022/4/15 17:40:00,74,298,-224
25673,25673,238,2022/4/15 17:50:00,48,299,-251
25674,25674,238,2022/4/15 18:00:00,52,335,-283
25675,25675,238,2022/4/15 18:10:00,58,207,-149
25676,25676,238,2022/4/15 18:20:00,38,579,-541
25677,25677,238,2022/4/15 18:30:00,42,441,-399
25678,25678,238,2022/4/15 18:40:00,34,510,-476
25679,25679,238,2022/4/15 18:50:00,35,430,-395
25680,25680,238,2022/4/15 19:00:00,26,534,-508
25681,25681,238,2022/4/15 19:10:00,33,655,-622
25682,25682,238,2022/4/15 19:20:00,30,378,-348
25683,25683,238,2022/4/15 19:30:00,26,387,-361
25684,25684,238,2022/4/15 19:40:00,27,336,-309
25685,25685,238,2022/4/15 19:50:00,27,207,-180
25686,25686,238,2022/4/15 20:00:00,27,213,-186
25687,25687,238,2022/4/15 20:10:00,29,100,-71
25688,25688,238,2022/4/15 20:20:00,27,171,-144
25689,25689,238,2022/4/15 20:30:00,25,301,-276
25690,25690,238,2022/4/15 20:40:00,26,112,-86
25691,25691,238,2022/4/15 20:50:00,20,119,-99
25692,25692,238,2022/4/15 21:00:00,26,111,-85
25693,25693,238,2022/4/15 21:10:00,25,110,-85
25694,25694,238,2022/4/15 21:20:00,21,150,-129
25695,25695,238,2022/4/15 21:30:00,18,107,-89
25696,25696,238,2022/4/15 21:40:00,17,109,-92
25697,25697,238,2022/4/15 21:50:00,15,106,-91
25698,25698,238,2022/4/15 22:00:00,18,111,-93
25699,25699,238,2022/4/15 22:10:00,15,111,-96
25700,25700,238,2022/4/15 22:20:00,6,117,-111
25701,25701,238,2022/4/15 22:30:00,2,123,-121
25702,25702,238,2022/4/15 22:40:00,2,125,-123
25703,25703,238,2022/4/15 22:50:00,1,125,-124
25704,25704,239,2022/4/15 5:00:00,0,1,-1
25705,25705,239,2022/4/15 5:10:00,0,1,-1
25706,25706,239,2022/4/15 5:20:00,0,1,-1
25707,25707,239,2022/4/15 5:30:00,0,1,-1
25708,25708,239,2022/4/15 5:40:00,1,1,0
25709,25709,239,2022/4/15 5:50:00,1,5,-4
25710,25710,239,2022/4/15 6:00:00,3,1,2
25711,25711,239,2022/4/15 6:10:00,3,8,-5
25712,25712,239,2022/4/15 6:20:00,5,6,-1
25713,25713,239,2022/4/15 6:30:00,12,14,-2
25714,25714,239,2022/4/15 6:40:00,8,19,-11
25715,25715,239,2022/4/15 6:50:00,12,21,-9
25716,25716,239,2022/4/15 7:00:00,19,21,-2
25717,25717,239,2022/4/15 7:10:00,17,23,-6
25718,25718,239,2022/4/15 7:20:00,18,33,-15
25719,25719,239,2022/4/15 7:30:00,21,39,-18
25720,25720,239,2022/4/15 7:40:00,25,46,-21
25721,25721,239,2022/4/15 7:50:00,32,62,-30
25722,25722,239,2022/4/15 8:00:00,31,75,-44
25723,25723,239,2022/4/15 8:10:00,31,98,-67
25724,25724,239,2022/4/15 8:20:00,29,105,-76
25725,25725,239,2022/4/15 8:30:00,30,107,-77
25726,25726,239,2022/4/15 8:40:00,28,122,-94
25727,25727,239,2022/4/15 8:50:00,25,116,-91
25728,25728,239,2022/4/15 9:00:00,23,86,-63
25729,25729,239,2022/4/15 9:10:00,18,68,-50
25730,25730,239,2022/4/15 9:20:00,15,61,-46
25731,25731,239,2022/4/15 9:30:00,10,62,-52
25732,25732,239,2022/4/15 9:40:00,8,73,-65
25733,25733,239,2022/4/15 9:50:00,6,61,-55
25734,25734,239,2022/4/15 10:00:00,9,41,-32
25735,25735,239,2022/4/15 10:10:00,9,34,-25
25736,25736,239,2022/4/15 10:20:00,7,32,-25
25737,25737,239,2022/4/15 10:30:00,8,23,-15
25738,25738,239,2022/4/15 10:40:00,9,23,-14
25739,25739,239,2022/4/15 10:50:00,8,23,-15
25740,25740,239,2022/4/15 11:00:00,7,23,-16
25741,25741,239,2022/4/15 11:10:00,5,16,-11
25742,25742,239,2022/4/15 11:20:00,7,23,-16
25743,25743,239,2022/4/15 11:30:00,9,23,-14
25744,25744,239,2022/4/15 11:40:00,8,19,-11
25745,25745,239,2022/4/15 11:50:00,7,21,-14
25746,25746,239,2022/4/15 12:00:00,7,19,-12
25747,25747,239,2022/4/15 12:10:00,9,19,-10
25748,25748,239,2022/4/15 12:20:00,8,19,-11
25749,25749,239,2022/4/15 12:30:00,11,21,-10
25750,25750,239,2022/4/15 12:40:00,9,19,-10
25751,25751,239,2022/4/15 12:50:00,7,23,-16
25752,25752,239,2022/4/15 13:00:00,8,29,-21
25753,25753,239,2022/4/15 13:10:00,9,14,-5
25754,25754,239,2022/4/15 13:20:00,7,23,-16
25755,25755,239,2022/4/15 13:30:00,8,29,-21
25756,25756,239,2022/4/15 13:40:00,6,23,-17
25757,25757,239,2022/4/15 13:50:00,9,23,-14
25758,25758,239,2022/4/15 14:00:00,8,22,-14
25759,25759,239,2022/4/15 14:10:00,9,22,-13
25760,25760,239,2022/4/15 14:20:00,6,25,-19
25761,25761,239,2022/4/15 14:30:00,8,23,-15
25762,25762,239,2022/4/15 14:40:00,8,23,-15
25763,25763,239,2022/4/15 14:50:00,8,19,-11
25764,25764,239,2022/4/15 15:00:00,10,12,-2
25765,25765,239,2022/4/15 15:10:00,11,25,-14
25766,25766,239,2022/4/15 15:20:00,8,23,-15
25767,25767,239,2022/4/15 15:30:00,8,23,-15
25768,25768,239,2022/4/15 15:40:00,10,19,-9
25769,25769,239,2022/4/15 15:50:00,11,21,-10
25770,25770,239,2022/4/15 16:00:00,13,23,-10
25771,25771,239,2022/4/15 16:10:00,10,23,-13
25772,25772,239,2022/4/15 16:20:00,13,23,-10
25773,25773,239,2022/4/15 16:30:00,11,31,-20
25774,25774,239,2022/4/15 16:40:00,13,21,-8
25775,25775,239,2022/4/15 16:50:00,17,23,-6
25776,25776,239,2022/4/15 17:00:00,21,25,-4
25777,25777,239,2022/4/15 17:10:00,28,38,-10
25778,25778,239,2022/4/15 17:20:00,29,52,-23
25779,25779,239,2022/4/15 17:30:00,38,45,-7
25780,25780,239,2022/4/15 17:40:00,43,45,-2
25781,25781,239,2022/4/15 17:50:00,27,51,-24
25782,25782,239,2022/4/15 18:00:00,29,50,-21
25783,25783,239,2022/4/15 18:10:00,33,53,-20
25784,25784,239,2022/4/15 18:20:00,37,49,-12
25785,25785,239,2022/4/15 18:30:00,36,49,-13
25786,25786,239,2022/4/15 18:40:00,37,52,-15
25787,25787,239,2022/4/15 18:50:00,29,50,-21
25788,25788,239,2022/4/15 19:00:00,23,41,-18
25789,25789,239,2022/4/15 19:10:00,12,25,-13
25790,25790,239,2022/4/15 19:20:00,18,25,-7
25791,25791,239,2022/4/15 19:30:00,18,25,-7
25792,25792,239,2022/4/15 19:40:00,10,25,-15
25793,25793,239,2022/4/15 19:50:00,12,23,-11
25794,25794,239,2022/4/15 20:00:00,10,21,-11
25795,25795,239,2022/4/15 20:10:00,14,22,-8
25796,25796,239,2022/4/15 20:20:00,11,21,-10
25797,25797,239,2022/4/15 20:30:00,12,21,-9
25798,25798,239,2022/4/15 20:40:00,7,21,-14
25799,25799,239,2022/4/15 20:50:00,7,15,-8
25800,25800,239,2022/4/15 21:00:00,7,18,-11
25801,25801,239,2022/4/15 21:10:00,6,18,-12
25802,25802,239,2022/4/15 21:20:00,6,19,-13
25803,25803,239,2022/4/15 21:30:00,5,15,-10
25804,25804,239,2022/4/15 21:40:00,2,15,-13
25805,25805,239,2022/4/15 21:50:00,2,18,-16
25806,25806,239,2022/4/15 22:00:00,2,15,-13
25807,25807,239,2022/4/15 22:10:00,2,7,-5
25808,25808,239,2022/4/15 22:20:00,2,18,-16
25809,25809,239,2022/4/15 22:30:00,1,8,-7
25810,25810,239,2022/4/15 22:40:00,2,13,-11
25811,25811,239,2022/4/15 22:50:00,1,8,-7
25812,25812,240,2022/4/15 5:00:00,0,1,-1
25813,25813,240,2022/4/15 5:10:00,2,1,1
25814,25814,240,2022/4/15 5:20:00,2,1,1
25815,25815,240,2022/4/15 5:30:00,3,1,2
25816,25816,240,2022/4/15 5:40:00,3,1,2
25817,25817,240,2022/4/15 5:50:00,2,1,1
25818,25818,240,2022/4/15 6:00:00,2,1,1
25819,25819,240,2022/4/15 6:10:00,4,1,3
25820,25820,240,2022/4/15 6:20:00,6,1,5
25821,25821,240,2022/4/15 6:30:00,10,71,-61
25822,25822,240,2022/4/15 6:40:00,10,47,-37
25823,25823,240,2022/4/15 6:50:00,10,51,-41
25824,25824,240,2022/4/15 7:00:00,21,66,-45
25825,25825,240,2022/4/15 7:10:00,27,72,-45
25826,25826,240,2022/4/15 7:20:00,25,95,-70
25827,25827,240,2022/4/15 7:30:00,27,103,-76
25828,25828,240,2022/4/15 7:40:00,32,112,-80
25829,25829,240,2022/4/15 7:50:00,32,128,-96
25830,25830,240,2022/4/15 8:00:00,30,211,-181
25831,25831,240,2022/4/15 8:10:00,29,295,-266
25832,25832,240,2022/4/15 8:20:00,30,424,-394
25833,25833,240,2022/4/15 8:30:00,26,401,-375
25834,25834,240,2022/4/15 8:40:00,24,589,-565
25835,25835,240,2022/4/15 8:50:00,21,689,-668
25836,25836,240,2022/4/15 9:00:00,21,482,-461
25837,25837,240,2022/4/15 9:10:00,20,412,-392
25838,25838,240,2022/4/15 9:20:00,20,405,-385
25839,25839,240,2022/4/15 9:30:00,18,429,-411
25840,25840,240,2022/4/15 9:40:00,16,231,-215
25841,25841,240,2022/4/15 9:50:00,16,301,-285
25842,25842,240,2022/4/15 10:00:00,19,221,-202
25843,25843,240,2022/4/15 10:10:00,22,150,-128
25844,25844,240,2022/4/15 10:20:00,21,108,-87
25845,25845,240,2022/4/15 10:30:00,23,119,-96
25846,25846,240,2022/4/15 10:40:00,25,108,-83
25847,25847,240,2022/4/15 10:50:00,26,118,-92
25848,25848,240,2022/4/15 11:00:00,25,103,-78
25849,25849,240,2022/4/15 11:10:00,27,96,-69
25850,25850,240,2022/4/15 11:20:00,26,85,-59
25851,25851,240,2022/4/15 11:30:00,27,99,-72
25852,25852,240,2022/4/15 11:40:00,34,106,-72
25853,25853,240,2022/4/15 11:50:00,31,94,-63
25854,25854,240,2022/4/15 12:00:00,36,76,-40
25855,25855,240,2022/4/15 12:10:00,40,84,-44
25856,25856,240,2022/4/15 12:20:00,35,86,-51
25857,25857,240,2022/4/15 12:30:00,29,104,-75
25858,25858,240,2022/4/15 12:40:00,36,107,-71
25859,25859,240,2022/4/15 12:50:00,38,102,-64
25860,25860,240,2022/4/15 13:00:00,39,96,-57
25861,25861,240,2022/4/15 13:10:00,44,89,-45
25862,25862,240,2022/4/15 13:20:00,42,96,-54
25863,25863,240,2022/4/15 13:30:00,45,98,-53
25864,25864,240,2022/4/15 13:40:00,45,96,-51
25865,25865,240,2022/4/15 13:50:00,45,96,-51
25866,25866,240,2022/4/15 14:00:00,46,81,-35
25867,25867,240,2022/4/15 14:10:00,48,95,-47
25868,25868,240,2022/4/15 14:20:00,49,90,-41
25869,25869,240,2022/4/15 14:30:00,53,94,-41
25870,25870,240,2022/4/15 14:40:00,55,84,-29
25871,25871,240,2022/4/15 14:50:00,56,82,-26
25872,25872,240,2022/4/15 15:00:00,60,62,-2
25873,25873,240,2022/4/15 15:10:00,70,72,-2
25874,25874,240,2022/4/15 15:20:00,88,78,10
25875,25875,240,2022/4/15 15:30:00,80,65,15
25876,25876,240,2022/4/15 15:40:00,114,84,30
25877,25877,240,2022/4/15 15:50:00,72,63,9
25878,25878,240,2022/4/15 16:00:00,99,70,29
25879,25879,240,2022/4/15 16:10:00,119,71,48
25880,25880,240,2022/4/15 16:20:00,115,61,54
25881,25881,240,2022/4/15 16:30:00,138,68,70
25882,25882,240,2022/4/15 16:40:00,171,62,109
25883,25883,240,2022/4/15 16:50:00,142,71,71
25884,25884,240,2022/4/15 17:00:00,273,69,204
25885,25885,240,2022/4/15 17:10:00,355,77,278
25886,25886,240,2022/4/15 17:20:00,329,71,258
25887,25887,240,2022/4/15 17:30:00,629,74,555
25888,25888,240,2022/4/15 17:40:00,594,76,518
25889,25889,240,2022/4/15 17:50:00,346,91,255
25890,25890,240,2022/4/15 18:00:00,590,91,499
25891,25891,240,2022/4/15 18:10:00,630,92,538
25892,25892,240,2022/4/15 18:20:00,374,95,279
25893,25893,240,2022/4/15 18:30:00,289,92,197
25894,25894,240,2022/4/15 18:40:00,268,90,178
25895,25895,240,2022/4/15 18:50:00,218,87,131
25896,25896,240,2022/4/15 19:00:00,175,77,98
25897,25897,240,2022/4/15 19:10:00,141,72,69
25898,25898,240,2022/4/15 19:20:00,89,82,7
25899,25899,240,2022/4/15 19:30:00,76,74,2
25900,25900,240,2022/4/15 19:40:00,71,61,10
25901,25901,240,2022/4/15 19:50:00,55,50,5
25902,25902,240,2022/4/15 20:00:00,71,40,31
25903,25903,240,2022/4/15 20:10:00,77,47,30
25904,25904,240,2022/4/15 20:20:00,56,39,17
25905,25905,240,2022/4/15 20:30:00,55,27,28
25906,25906,240,2022/4/15 20:40:00,46,33,13
25907,25907,240,2022/4/15 20:50:00,44,36,8
25908,25908,240,2022/4/15 21:00:00,60,25,35
25909,25909,240,2022/4/15 21:10:00,58,27,31
25910,25910,240,2022/4/15 21:20:00,44,32,12
25911,25911,240,2022/4/15 21:30:00,51,33,18
25912,25912,240,2022/4/15 21:40:00,42,32,10
25913,25913,240,2022/4/15 21:50:00,41,25,16
25914,25914,240,2022/4/15 22:00:00,138,25,113
25915,25915,240,2022/4/15 22:10:00,50,25,25
25916,25916,240,2022/4/15 22:20:00,27,23,4
25917,25917,240,2022/4/15 22:30:00,0,21,-21
25918,25918,240,2022/4/15 22:40:00,0,25,-25
25919,25919,240,2022/4/15 22:50:00,0,18,-18
25920,25920,241,2022/4/15 5:00:00,0,1,-1
25921,25921,241,2022/4/15 5:10:00,0,1,-1
25922,25922,241,2022/4/15 5:20:00,13,1,12
25923,25923,241,2022/4/15 5:30:00,21,1,20
25924,25924,241,2022/4/15 5:40:00,16,1,15
25925,25925,241,2022/4/15 5:50:00,30,1,29
25926,25926,241,2022/4/15 6:00:00,33,2,31
25927,25927,241,2022/4/15 6:10:00,46,2,44
25928,25928,241,2022/4/15 6:20:00,65,33,32
25929,25929,241,2022/4/15 6:30:00,94,36,58
25930,25930,241,2022/4/15 6:40:00,170,54,116
25931,25931,241,2022/4/15 6:50:00,213,67,146
25932,25932,241,2022/4/15 7:00:00,277,70,207
25933,25933,241,2022/4/15 7:10:00,347,74,273
25934,25934,241,2022/4/15 7:20:00,568,90,478
25935,25935,241,2022/4/15 7:30:00,693,97,596
25936,25936,241,2022/4/15 7:40:00,1052,95,957
25937,25937,241,2022/4/15 7:50:00,1221,98,1123
25938,25938,241,2022/4/15 8:00:00,1385,115,1270
25939,25939,241,2022/4/15 8:10:00,1578,122,1456
25940,25940,241,2022/4/15 8:20:00,1172,104,1068
25941,25941,241,2022/4/15 8:30:00,1040,110,930
25942,25942,241,2022/4/15 8:40:00,735,108,627
25943,25943,241,2022/4/15 8:50:00,664,95,569
25944,25944,241,2022/4/15 9:00:00,436,93,343
25945,25945,241,2022/4/15 9:10:00,273,92,181
25946,25946,241,2022/4/15 9:20:00,240,83,157
25947,25947,241,2022/4/15 9:30:00,183,75,108
25948,25948,241,2022/4/15 9:40:00,76,73,3
25949,25949,241,2022/4/15 9:50:00,72,74,-2
25950,25950,241,2022/4/15 10:00:00,48,70,-22
25951,25951,241,2022/4/15 10:10:00,46,67,-21
25952,25952,241,2022/4/15 10:20:00,41,65,-24
25953,25953,241,2022/4/15 10:30:00,37,68,-31
25954,25954,241,2022/4/15 10:40:00,36,62,-26
25955,25955,241,2022/4/15 10:50:00,29,66,-37
25956,25956,241,2022/4/15 11:00:00,35,73,-38
25957,25957,241,2022/4/15 11:10:00,31,69,-38
25958,25958,241,2022/4/15 11:20:00,33,67,-34
25959,25959,241,2022/4/15 11:30:00,36,73,-37
25960,25960,241,2022/4/15 11:40:00,26,70,-44
25961,25961,241,2022/4/15 11:50:00,36,70,-34
25962,25962,241,2022/4/15 12:00:00,36,74,-38
25963,25963,241,2022/4/15 12:10:00,44,82,-38
25964,25964,241,2022/4/15 12:20:00,38,73,-35
25965,25965,241,2022/4/15 12:30:00,39,74,-35
25966,25966,241,2022/4/15 12:40:00,37,69,-32
25967,25967,241,2022/4/15 12:50:00,37,84,-47
25968,25968,241,2022/4/15 13:00:00,36,80,-44
25969,25969,241,2022/4/15 13:10:00,36,70,-34
25970,25970,241,2022/4/15 13:20:00,39,82,-43
25971,25971,241,2022/4/15 13:30:00,31,73,-42
25972,25972,241,2022/4/15 13:40:00,31,73,-42
25973,25973,241,2022/4/15 13:50:00,32,83,-51
25974,25974,241,2022/4/15 14:00:00,28,84,-56
25975,25975,241,2022/4/15 14:10:00,22,84,-62
25976,25976,241,2022/4/15 14:20:00,26,77,-51
25977,25977,241,2022/4/15 14:30:00,27,73,-46
25978,25978,241,2022/4/15 14:40:00,28,76,-48
25979,25979,241,2022/4/15 14:50:00,30,81,-51
25980,25980,241,2022/4/15 15:00:00,30,92,-62
25981,25981,241,2022/4/15 15:10:00,36,75,-39
25982,25982,241,2022/4/15 15:20:00,33,89,-56
25983,25983,241,2022/4/15 15:30:00,31,93,-62
25984,25984,241,2022/4/15 15:40:00,30,102,-72
25985,25985,241,2022/4/15 15:50:00,39,105,-66
25986,25986,241,2022/4/15 16:00:00,37,101,-64
25987,25987,241,2022/4/15 16:10:00,57,104,-47
25988,25988,241,2022/4/15 16:20:00,42,96,-54
25989,25989,241,2022/4/15 16:30:00,43,118,-75
25990,25990,241,2022/4/15 16:40:00,49,108,-59
25991,25991,241,2022/4/15 16:50:00,46,122,-76
25992,25992,241,2022/4/15 17:00:00,64,124,-60
25993,25993,241,2022/4/15 17:10:00,78,158,-80
25994,25994,241,2022/4/15 17:20:00,72,153,-81
25995,25995,241,2022/4/15 17:30:00,57,225,-168
25996,25996,241,2022/4/15 17:40:00,74,212,-138
25997,25997,241,2022/4/15 17:50:00,73,333,-260
25998,25998,241,2022/4/15 18:00:00,55,334,-279
25999,25999,241,2022/4/15 18:10:00,49,510,-461
26000,26000,241,2022/4/15 18:20:00,56,433,-377
26001,26001,241,2022/4/15 18:30:00,43,438,-395
26002,26002,241,2022/4/15 18:40:00,37,432,-395
26003,26003,241,2022/4/15 18:50:00,30,440,-410
26004,26004,241,2022/4/15 19:00:00,31,382,-351
26005,26005,241,2022/4/15 19:10:00,29,321,-292
26006,26006,241,2022/4/15 19:20:00,32,232,-200
26007,26007,241,2022/4/15 19:30:00,27,271,-244
26008,26008,241,2022/4/15 19:40:00,29,126,-97
26009,26009,241,2022/4/15 19:50:00,29,118,-89
26010,26010,241,2022/4/15 20:00:00,32,110,-78
26011,26011,241,2022/4/15 20:10:00,30,113,-83
26012,26012,241,2022/4/15 20:20:00,29,110,-81
26013,26013,241,2022/4/15 20:30:00,28,124,-96
26014,26014,241,2022/4/15 20:40:00,24,115,-91
26015,26015,241,2022/4/15 20:50:00,26,122,-96
26016,26016,241,2022/4/15 21:00:00,22,122,-100
26017,26017,241,2022/4/15 21:10:00,26,119,-93
26018,26018,241,2022/4/15 21:20:00,26,127,-101
26019,26019,241,2022/4/15 21:30:00,21,124,-103
26020,26020,241,2022/4/15 21:40:00,18,123,-105
26021,26021,241,2022/4/15 21:50:00,14,123,-109
26022,26022,241,2022/4/15 22:00:00,14,114,-100
26023,26023,241,2022/4/15 22:10:00,16,110,-94
26024,26024,241,2022/4/15 22:20:00,12,103,-91
26025,26025,241,2022/4/15 22:30:00,6,107,-101
26026,26026,241,2022/4/15 22:40:00,1,102,-101
26027,26027,241,2022/4/15 22:50:00,1,70,-69
26028,26028,242,2022/4/15 5:00:00,0,1,-1
26029,26029,242,2022/4/15 5:10:00,0,1,-1
26030,26030,242,2022/4/15 5:20:00,0,1,-1
26031,26031,242,2022/4/15 5:30:00,6,1,5
26032,26032,242,2022/4/15 5:40:00,8,1,7
26033,26033,242,2022/4/15 5:50:00,16,2,14
26034,26034,242,2022/4/15 6:00:00,15,47,-32
26035,26035,242,2022/4/15 6:10:00,15,65,-50
26036,26036,242,2022/4/15 6:20:00,16,68,-52
26037,26037,242,2022/4/15 6:30:00,20,82,-62
26038,26038,242,2022/4/15 6:40:00,25,106,-81
26039,26039,242,2022/4/15 6:50:00,27,116,-89
26040,26040,242,2022/4/15 7:00:00,32,115,-83
26041,26041,242,2022/4/15 7:10:00,42,267,-225
26042,26042,242,2022/4/15 7:20:00,37,253,-216
26043,26043,242,2022/4/15 7:30:00,35,298,-263
26044,26044,242,2022/4/15 7:40:00,43,334,-291
26045,26045,242,2022/4/15 7:50:00,45,534,-489
26046,26046,242,2022/4/15 8:00:00,54,682,-628
26047,26047,242,2022/4/15 8:10:00,61,1803,-1742
26048,26048,242,2022/4/15 8:20:00,66,3188,-3122
26049,26049,242,2022/4/15 8:30:00,57,3046,-2989
26050,26050,242,2022/4/15 8:40:00,52,8117,-8065
26051,26051,242,2022/4/15 8:50:00,50,6447,-6397
26052,26052,242,2022/4/15 9:00:00,45,2963,-2918
26053,26053,242,2022/4/15 9:10:00,46,3536,-3490
26054,26054,242,2022/4/15 9:20:00,43,3313,-3270
26055,26055,242,2022/4/15 9:30:00,38,2224,-2186
26056,26056,242,2022/4/15 9:40:00,38,811,-773
26057,26057,242,2022/4/15 9:50:00,37,576,-539
26058,26058,242,2022/4/15 10:00:00,36,385,-349
26059,26059,242,2022/4/15 10:10:00,43,297,-254
26060,26060,242,2022/4/15 10:20:00,40,297,-257
26061,26061,242,2022/4/15 10:30:00,43,179,-136
26062,26062,242,2022/4/15 10:40:00,45,143,-98
26063,26063,242,2022/4/15 10:50:00,43,183,-140
26064,26064,242,2022/4/15 11:00:00,45,182,-137
26065,26065,242,2022/4/15 11:10:00,47,118,-71
26066,26066,242,2022/4/15 11:20:00,43,111,-68
26067,26067,242,2022/4/15 11:30:00,54,109,-55
26068,26068,242,2022/4/15 11:40:00,57,143,-86
26069,26069,242,2022/4/15 11:50:00,61,110,-49
26070,26070,242,2022/4/15 12:00:00,65,112,-47
26071,26071,242,2022/4/15 12:10:00,73,105,-32
26072,26072,242,2022/4/15 12:20:00,74,122,-48
26073,26073,242,2022/4/15 12:30:00,64,120,-56
26074,26074,242,2022/4/15 12:40:00,70,152,-82
26075,26075,242,2022/4/15 12:50:00,69,181,-112
26076,26076,242,2022/4/15 13:00:00,74,139,-65
26077,26077,242,2022/4/15 13:10:00,103,121,-18
26078,26078,242,2022/4/15 13:20:00,79,110,-31
26079,26079,242,2022/4/15 13:30:00,79,128,-49
26080,26080,242,2022/4/15 13:40:00,82,144,-62
26081,26081,242,2022/4/15 13:50:00,85,117,-32
26082,26082,242,2022/4/15 14:00:00,110,110,0
26083,26083,242,2022/4/15 14:10:00,132,119,13
26084,26084,242,2022/4/15 14:20:00,135,107,28
26085,26085,242,2022/4/15 14:30:00,128,120,8
26086,26086,242,2022/4/15 14:40:00,94,114,-20
26087,26087,242,2022/4/15 14:50:00,129,122,7
26088,26088,242,2022/4/15 15:00:00,149,109,40
26089,26089,242,2022/4/15 15:10:00,157,101,56
26090,26090,242,2022/4/15 15:20:00,172,123,49
26091,26091,242,2022/4/15 15:30:00,183,102,81
26092,26092,242,2022/4/15 15:40:00,200,119,81
26093,26093,242,2022/4/15 15:50:00,202,126,76
26094,26094,242,2022/4/15 16:00:00,224,108,116
26095,26095,242,2022/4/15 16:10:00,262,103,159
26096,26096,242,2022/4/15 16:20:00,263,103,160
26097,26097,242,2022/4/15 16:30:00,263,98,165
26098,26098,242,2022/4/15 16:40:00,336,118,218
26099,26099,242,2022/4/15 16:50:00,335,107,228
26100,26100,242,2022/4/15 17:00:00,610,119,491
26101,26101,242,2022/4/15 17:10:00,1035,121,914
26102,26102,242,2022/4/15 17:20:00,719,122,597
26103,26103,242,2022/4/15 17:30:00,828,107,721
26104,26104,242,2022/4/15 17:40:00,1568,127,1441
26105,26105,242,2022/4/15 17:50:00,1352,191,1161
26106,26106,242,2022/4/15 18:00:00,1559,158,1401
26107,26107,242,2022/4/15 18:10:00,2500,159,2341
26108,26108,242,2022/4/15 18:20:00,1986,146,1840
26109,26109,242,2022/4/15 18:30:00,1360,199,1161
26110,26110,242,2022/4/15 18:40:00,1348,181,1167
26111,26111,242,2022/4/15 18:50:00,1163,115,1048
26112,26112,242,2022/4/15 19:00:00,806,124,682
26113,26113,242,2022/4/15 19:10:00,655,117,538
26114,26114,242,2022/4/15 19:20:00,578,105,473
26115,26115,242,2022/4/15 19:30:00,458,112,346
26116,26116,242,2022/4/15 19:40:00,355,95,260
26117,26117,242,2022/4/15 19:50:00,350,82,268
26118,26118,242,2022/4/15 20:00:00,337,80,257
26119,26119,242,2022/4/15 20:10:00,325,81,244
26120,26120,242,2022/4/15 20:20:00,307,79,228
26121,26121,242,2022/4/15 20:30:00,273,73,200
26122,26122,242,2022/4/15 20:40:00,266,68,198
26123,26123,242,2022/4/15 20:50:00,272,64,208
26124,26124,242,2022/4/15 21:00:00,269,67,202
26125,26125,242,2022/4/15 21:10:00,336,66,270
26126,26126,242,2022/4/15 21:20:00,289,69,220
26127,26127,242,2022/4/15 21:30:00,269,63,206
26128,26128,242,2022/4/15 21:40:00,273,62,211
26129,26129,242,2022/4/15 21:50:00,244,60,184
26130,26130,242,2022/4/15 22:00:00,390,57,333
26131,26131,242,2022/4/15 22:10:00,617,50,567
26132,26132,242,2022/4/15 22:20:00,222,50,172
26133,26133,242,2022/4/15 22:30:00,66,49,17
26134,26134,242,2022/4/15 22:40:00,37,42,-5
26135,26135,242,2022/4/15 22:50:00,25,25,0
26136,26136,243,2022/4/15 5:00:00,0,1,-1
26137,26137,243,2022/4/15 5:10:00,0,1,-1
26138,26138,243,2022/4/15 5:20:00,1,1,0
26139,26139,243,2022/4/15 5:30:00,9,1,8
26140,26140,243,2022/4/15 5:40:00,23,5,18
26141,26141,243,2022/4/15 5:50:00,27,6,21
26142,26142,243,2022/4/15 6:00:00,30,16,14
26143,26143,243,2022/4/15 6:10:00,35,39,-4
26144,26144,243,2022/4/15 6:20:00,44,38,6
26145,26145,243,2022/4/15 6:30:00,59,47,12
26146,26146,243,2022/4/15 6:40:00,88,66,22
26147,26147,243,2022/4/15 6:50:00,164,72,92
26148,26148,243,2022/4/15 7:00:00,187,66,121
26149,26149,243,2022/4/15 7:10:00,227,73,154
26150,26150,243,2022/4/15 7:20:00,225,93,132
26151,26151,243,2022/4/15 7:30:00,223,88,135
26152,26152,243,2022/4/15 7:40:00,244,103,141
26153,26153,243,2022/4/15 7:50:00,317,120,197
26154,26154,243,2022/4/15 8:00:00,301,119,182
26155,26155,243,2022/4/15 8:10:00,282,192,90
26156,26156,243,2022/4/15 8:20:00,277,184,93
26157,26157,243,2022/4/15 8:30:00,279,234,45
26158,26158,243,2022/4/15 8:40:00,277,298,-21
26159,26159,243,2022/4/15 8:50:00,228,318,-90
26160,26160,243,2022/4/15 9:00:00,167,320,-153
26161,26161,243,2022/4/15 9:10:00,150,226,-76
26162,26162,243,2022/4/15 9:20:00,122,155,-33
26163,26163,243,2022/4/15 9:30:00,77,117,-40
26164,26164,243,2022/4/15 9:40:00,65,105,-40
26165,26165,243,2022/4/15 9:50:00,53,124,-71
26166,26166,243,2022/4/15 10:00:00,45,108,-63
26167,26167,243,2022/4/15 10:10:00,44,111,-67
26168,26168,243,2022/4/15 10:20:00,39,87,-48
26169,26169,243,2022/4/15 10:30:00,37,96,-59
26170,26170,243,2022/4/15 10:40:00,37,87,-50
26171,26171,243,2022/4/15 10:50:00,35,72,-37
26172,26172,243,2022/4/15 11:00:00,35,82,-47
26173,26173,243,2022/4/15 11:10:00,35,77,-42
26174,26174,243,2022/4/15 11:20:00,35,85,-50
26175,26175,243,2022/4/15 11:30:00,35,71,-36
26176,26176,243,2022/4/15 11:40:00,39,70,-31
26177,26177,243,2022/4/15 11:50:00,38,77,-39
26178,26178,243,2022/4/15 12:00:00,42,77,-35
26179,26179,243,2022/4/15 12:10:00,43,77,-34
26180,26180,243,2022/4/15 12:20:00,43,77,-34
26181,26181,243,2022/4/15 12:30:00,43,62,-19
26182,26182,243,2022/4/15 12:40:00,43,77,-34
26183,26183,243,2022/4/15 12:50:00,42,82,-40
26184,26184,243,2022/4/15 13:00:00,37,87,-50
26185,26185,243,2022/4/15 13:10:00,39,91,-52
26186,26186,243,2022/4/15 13:20:00,40,76,-36
26187,26187,243,2022/4/15 13:30:00,37,69,-32
26188,26188,243,2022/4/15 13:40:00,37,91,-54
26189,26189,243,2022/4/15 13:50:00,35,91,-56
26190,26190,243,2022/4/15 14:00:00,33,96,-63
26191,26191,243,2022/4/15 14:10:00,39,98,-59
26192,26192,243,2022/4/15 14:20:00,37,70,-33
26193,26193,243,2022/4/15 14:30:00,29,93,-64
26194,26194,243,2022/4/15 14:40:00,33,97,-64
26195,26195,243,2022/4/15 14:50:00,29,92,-63
26196,26196,243,2022/4/15 15:00:00,31,95,-64
26197,26197,243,2022/4/15 15:10:00,38,77,-39
26198,26198,243,2022/4/15 15:20:00,37,77,-40
26199,26199,243,2022/4/15 15:30:00,33,98,-65
26200,26200,243,2022/4/15 15:40:00,35,109,-74
26201,26201,243,2022/4/15 15:50:00,38,113,-75
26202,26202,243,2022/4/15 16:00:00,44,106,-62
26203,26203,243,2022/4/15 16:10:00,46,112,-66
26204,26204,243,2022/4/15 16:20:00,46,85,-39
26205,26205,243,2022/4/15 16:30:00,68,105,-37
26206,26206,243,2022/4/15 16:40:00,52,120,-68
26207,26207,243,2022/4/15 16:50:00,60,123,-63
26208,26208,243,2022/4/15 17:00:00,215,124,91
26209,26209,243,2022/4/15 17:10:00,206,112,94
26210,26210,243,2022/4/15 17:20:00,131,127,4
26211,26211,243,2022/4/15 17:30:00,264,110,154
26212,26212,243,2022/4/15 17:40:00,207,151,56
26213,26213,243,2022/4/15 17:50:00,177,212,-35
26214,26214,243,2022/4/15 18:00:00,247,224,23
26215,26215,243,2022/4/15 18:10:00,270,184,86
26216,26216,243,2022/4/15 18:20:00,191,235,-44
26217,26217,243,2022/4/15 18:30:00,223,183,40
26218,26218,243,2022/4/15 18:40:00,205,271,-66
26219,26219,243,2022/4/15 18:50:00,88,181,-93
26220,26220,243,2022/4/15 19:00:00,70,170,-100
26221,26221,243,2022/4/15 19:10:00,67,152,-85
26222,26222,243,2022/4/15 19:20:00,57,110,-53
26223,26223,243,2022/4/15 19:30:00,46,122,-76
26224,26224,243,2022/4/15 19:40:00,40,119,-79
26225,26225,243,2022/4/15 19:50:00,37,112,-75
26226,26226,243,2022/4/15 20:00:00,37,109,-72
26227,26227,243,2022/4/15 20:10:00,41,125,-84
26228,26228,243,2022/4/15 20:20:00,38,115,-77
26229,26229,243,2022/4/15 20:30:00,34,107,-73
26230,26230,243,2022/4/15 20:40:00,34,101,-67
26231,26231,243,2022/4/15 20:50:00,33,111,-78
26232,26232,243,2022/4/15 21:00:00,36,113,-77
26233,26233,243,2022/4/15 21:10:00,28,112,-84
26234,26234,243,2022/4/15 21:20:00,32,105,-73
26235,26235,243,2022/4/15 21:30:00,25,106,-81
26236,26236,243,2022/4/15 21:40:00,29,107,-78
26237,26237,243,2022/4/15 21:50:00,25,108,-83
26238,26238,243,2022/4/15 22:00:00,24,98,-74
26239,26239,243,2022/4/15 22:10:00,21,92,-71
26240,26240,243,2022/4/15 22:20:00,16,99,-83
26241,26241,243,2022/4/15 22:30:00,15,107,-92
26242,26242,243,2022/4/15 22:40:00,10,81,-71
26243,26243,243,2022/4/15 22:50:00,2,73,-71
26244,26244,244,2022/4/15 5:00:00,0,1,-1
26245,26245,244,2022/4/15 5:10:00,0,1,-1
26246,26246,244,2022/4/15 5:20:00,17,1,16
26247,26247,244,2022/4/15 5:30:00,30,1,29
26248,26248,244,2022/4/15 5:40:00,31,1,30
26249,26249,244,2022/4/15 5:50:00,49,1,48
26250,26250,244,2022/4/15 6:00:00,70,1,69
26251,26251,244,2022/4/15 6:10:00,59,1,58
26252,26252,244,2022/4/15 6:20:00,75,5,70
26253,26253,244,2022/4/15 6:30:00,70,12,58
26254,26254,244,2022/4/15 6:40:00,73,65,8
26255,26255,244,2022/4/15 6:50:00,108,38,70
26256,26256,244,2022/4/15 7:00:00,207,55,152
26257,26257,244,2022/4/15 7:10:00,254,50,204
26258,26258,244,2022/4/15 7:20:00,349,54,295
26259,26259,244,2022/4/15 7:30:00,394,67,327
26260,26260,244,2022/4/15 7:40:00,600,63,537
26261,26261,244,2022/4/15 7:50:00,442,60,382
26262,26262,244,2022/4/15 8:00:00,326,63,263
26263,26263,244,2022/4/15 8:10:00,360,62,298
26264,26264,244,2022/4/15 8:20:00,273,73,200
26265,26265,244,2022/4/15 8:30:00,188,57,131
26266,26266,244,2022/4/15 8:40:00,122,37,85
26267,26267,244,2022/4/15 8:50:00,81,48,33
26268,26268,244,2022/4/15 9:00:00,63,52,11
26269,26269,244,2022/4/15 9:10:00,50,54,-4
26270,26270,244,2022/4/15 9:20:00,39,50,-11
26271,26271,244,2022/4/15 9:30:00,39,49,-10
26272,26272,244,2022/4/15 9:40:00,35,64,-29
26273,26273,244,2022/4/15 9:50:00,30,45,-15
26274,26274,244,2022/4/15 10:00:00,30,37,-7
26275,26275,244,2022/4/15 10:10:00,34,50,-16
26276,26276,244,2022/4/15 10:20:00,28,50,-22
26277,26277,244,2022/4/15 10:30:00,28,44,-16
26278,26278,244,2022/4/15 10:40:00,24,50,-26
26279,26279,244,2022/4/15 10:50:00,29,42,-13
26280,26280,244,2022/4/15 11:00:00,29,38,-9
26281,26281,244,2022/4/15 11:10:00,30,28,2
26282,26282,244,2022/4/15 11:20:00,25,45,-20
26283,26283,244,2022/4/15 11:30:00,28,51,-23
26284,26284,244,2022/4/15 11:40:00,27,51,-24
26285,26285,244,2022/4/15 11:50:00,33,48,-15
26286,26286,244,2022/4/15 12:00:00,29,50,-21
26287,26287,244,2022/4/15 12:10:00,36,51,-15
26288,26288,244,2022/4/15 12:20:00,29,18,11
26289,26289,244,2022/4/15 12:30:00,29,49,-20
26290,26290,244,2022/4/15 12:40:00,25,65,-40
26291,26291,244,2022/4/15 12:50:00,26,67,-41
26292,26292,244,2022/4/15 13:00:00,22,61,-39
26293,26293,244,2022/4/15 13:10:00,27,55,-28
26294,26294,244,2022/4/15 13:20:00,25,50,-25
26295,26295,244,2022/4/15 13:30:00,25,50,-25
26296,26296,244,2022/4/15 13:40:00,25,54,-29
26297,26297,244,2022/4/15 13:50:00,25,54,-29
26298,26298,244,2022/4/15 14:00:00,25,50,-25
26299,26299,244,2022/4/15 14:10:00,24,18,6
26300,26300,244,2022/4/15 14:20:00,20,47,-27
26301,26301,244,2022/4/15 14:30:00,21,65,-44
26302,26302,244,2022/4/15 14:40:00,26,55,-29
26303,26303,244,2022/4/15 14:50:00,21,63,-42
26304,26304,244,2022/4/15 15:00:00,17,61,-44
26305,26305,244,2022/4/15 15:10:00,20,59,-39
26306,26306,244,2022/4/15 15:20:00,24,66,-42
26307,26307,244,2022/4/15 15:30:00,21,73,-52
26308,26308,244,2022/4/15 15:40:00,23,51,-28
26309,26309,244,2022/4/15 15:50:00,23,69,-46
26310,26310,244,2022/4/15 16:00:00,21,83,-62
26311,26311,244,2022/4/15 16:10:00,26,59,-33
26312,26312,244,2022/4/15 16:20:00,26,106,-80
26313,26313,244,2022/4/15 16:30:00,27,60,-33
26314,26314,244,2022/4/15 16:40:00,29,90,-61
26315,26315,244,2022/4/15 16:50:00,29,98,-69
26316,26316,244,2022/4/15 17:00:00,23,108,-85
26317,26317,244,2022/4/15 17:10:00,27,108,-81
26318,26318,244,2022/4/15 17:20:00,24,65,-41
26319,26319,244,2022/4/15 17:30:00,24,99,-75
26320,26320,244,2022/4/15 17:40:00,25,151,-126
26321,26321,244,2022/4/15 17:50:00,22,109,-87
26322,26322,244,2022/4/15 18:00:00,22,160,-138
26323,26323,244,2022/4/15 18:10:00,19,112,-93
26324,26324,244,2022/4/15 18:20:00,17,124,-107
26325,26325,244,2022/4/15 18:30:00,17,197,-180
26326,26326,244,2022/4/15 18:40:00,18,119,-101
26327,26327,244,2022/4/15 18:50:00,13,285,-272
26328,26328,244,2022/4/15 19:00:00,17,109,-92
26329,26329,244,2022/4/15 19:10:00,17,112,-95
26330,26330,244,2022/4/15 19:20:00,12,178,-166
26331,26331,244,2022/4/15 19:30:00,12,119,-107
26332,26332,244,2022/4/15 19:40:00,12,111,-99
26333,26333,244,2022/4/15 19:50:00,12,107,-95
26334,26334,244,2022/4/15 20:00:00,12,120,-108
26335,26335,244,2022/4/15 20:10:00,16,95,-79
26336,26336,244,2022/4/15 20:20:00,12,110,-98
26337,26337,244,2022/4/15 20:30:00,12,110,-98
26338,26338,244,2022/4/15 20:40:00,8,63,-55
26339,26339,244,2022/4/15 20:50:00,6,95,-89
26340,26340,244,2022/4/15 21:00:00,11,103,-92
26341,26341,244,2022/4/15 21:10:00,13,108,-95
26342,26342,244,2022/4/15 21:20:00,7,89,-82
26343,26343,244,2022/4/15 21:30:00,7,110,-103
26344,26344,244,2022/4/15 21:40:00,8,95,-87
26345,26345,244,2022/4/15 21:50:00,7,68,-61
26346,26346,244,2022/4/15 22:00:00,15,99,-84
26347,26347,244,2022/4/15 22:10:00,5,99,-94
26348,26348,244,2022/4/15 22:20:00,1,99,-98
26349,26349,244,2022/4/15 22:30:00,0,78,-78
26350,26350,244,2022/4/15 22:40:00,0,78,-78
26351,26351,244,2022/4/15 22:50:00,0,83,-83
26352,26352,245,2022/4/15 5:00:00,0,1,-1
26353,26353,245,2022/4/15 5:10:00,0,1,-1
26354,26354,245,2022/4/15 5:20:00,0,1,-1
26355,26355,245,2022/4/15 5:30:00,1,1,0
26356,26356,245,2022/4/15 5:40:00,6,1,5
26357,26357,245,2022/4/15 5:50:00,13,5,8
26358,26358,245,2022/4/15 6:00:00,16,23,-7
26359,26359,245,2022/4/15 6:10:00,18,23,-5
26360,26360,245,2022/4/15 6:20:00,21,34,-13
26361,26361,245,2022/4/15 6:30:00,24,52,-28
26362,26362,245,2022/4/15 6:40:00,36,62,-26
26363,26363,245,2022/4/15 6:50:00,38,51,-13
26364,26364,245,2022/4/15 7:00:00,38,79,-41
26365,26365,245,2022/4/15 7:10:00,48,80,-32
26366,26366,245,2022/4/15 7:20:00,59,93,-34
26367,26367,245,2022/4/15 7:30:00,83,110,-27
26368,26368,245,2022/4/15 7:40:00,78,109,-31
26369,26369,245,2022/4/15 7:50:00,113,123,-10
26370,26370,245,2022/4/15 8:00:00,181,230,-49
26371,26371,245,2022/4/15 8:10:00,163,267,-104
26372,26372,245,2022/4/15 8:20:00,127,206,-79
26373,26373,245,2022/4/15 8:30:00,102,322,-220
26374,26374,245,2022/4/15 8:40:00,86,493,-407
26375,26375,245,2022/4/15 8:50:00,82,378,-296
26376,26376,245,2022/4/15 9:00:00,60,284,-224
26377,26377,245,2022/4/15 9:10:00,52,184,-132
26378,26378,245,2022/4/15 9:20:00,46,284,-238
26379,26379,245,2022/4/15 9:30:00,40,140,-100
26380,26380,245,2022/4/15 9:40:00,28,109,-81
26381,26381,245,2022/4/15 9:50:00,34,105,-71
26382,26382,245,2022/4/15 10:00:00,31,106,-75
26383,26383,245,2022/4/15 10:10:00,30,96,-66
26384,26384,245,2022/4/15 10:20:00,27,82,-55
26385,26385,245,2022/4/15 10:30:00,26,77,-51
26386,26386,245,2022/4/15 10:40:00,28,78,-50
26387,26387,245,2022/4/15 10:50:00,25,82,-57
26388,26388,245,2022/4/15 11:00:00,27,65,-38
26389,26389,245,2022/4/15 11:10:00,29,64,-35
26390,26390,245,2022/4/15 11:20:00,26,65,-39
26391,26391,245,2022/4/15 11:30:00,30,67,-37
26392,26392,245,2022/4/15 11:40:00,26,69,-43
26393,26393,245,2022/4/15 11:50:00,32,66,-34
26394,26394,245,2022/4/15 12:00:00,31,70,-39
26395,26395,245,2022/4/15 12:10:00,31,74,-43
26396,26396,245,2022/4/15 12:20:00,31,76,-45
26397,26397,245,2022/4/15 12:30:00,32,82,-50
26398,26398,245,2022/4/15 12:40:00,30,77,-47
26399,26399,245,2022/4/15 12:50:00,25,67,-42
26400,26400,245,2022/4/15 13:00:00,32,73,-41
26401,26401,245,2022/4/15 13:10:00,32,82,-50
26402,26402,245,2022/4/15 13:20:00,28,76,-48
26403,26403,245,2022/4/15 13:30:00,31,82,-51
26404,26404,245,2022/4/15 13:40:00,32,78,-46
26405,26405,245,2022/4/15 13:50:00,32,65,-33
26406,26406,245,2022/4/15 14:00:00,32,85,-53
26407,26407,245,2022/4/15 14:10:00,32,73,-41
26408,26408,245,2022/4/15 14:20:00,30,84,-54
26409,26409,245,2022/4/15 14:30:00,26,82,-56
26410,26410,245,2022/4/15 14:40:00,33,61,-28
26411,26411,245,2022/4/15 14:50:00,37,62,-25
26412,26412,245,2022/4/15 15:00:00,36,69,-33
26413,26413,245,2022/4/15 15:10:00,40,76,-36
26414,26414,245,2022/4/15 15:20:00,37,68,-31
26415,26415,245,2022/4/15 15:30:00,39,69,-30
26416,26416,245,2022/4/15 15:40:00,42,71,-29
26417,26417,245,2022/4/15 15:50:00,38,73,-35
26418,26418,245,2022/4/15 16:00:00,45,76,-31
26419,26419,245,2022/4/15 16:10:00,45,70,-25
26420,26420,245,2022/4/15 16:20:00,45,84,-39
26421,26421,245,2022/4/15 16:30:00,45,75,-30
26422,26422,245,2022/4/15 16:40:00,60,90,-30
26423,26423,245,2022/4/15 16:50:00,66,90,-24
26424,26424,245,2022/4/15 17:00:00,213,90,123
26425,26425,245,2022/4/15 17:10:00,346,92,254
26426,26426,245,2022/4/15 17:20:00,208,105,103
26427,26427,245,2022/4/15 17:30:00,214,123,91
26428,26428,245,2022/4/15 17:40:00,267,119,148
26429,26429,245,2022/4/15 17:50:00,176,123,53
26430,26430,245,2022/4/15 18:00:00,214,116,98
26431,26431,245,2022/4/15 18:10:00,378,104,274
26432,26432,245,2022/4/15 18:20:00,232,124,108
26433,26433,245,2022/4/15 18:30:00,169,104,65
26434,26434,245,2022/4/15 18:40:00,175,123,52
26435,26435,245,2022/4/15 18:50:00,118,111,7
26436,26436,245,2022/4/15 19:00:00,76,125,-49
26437,26437,245,2022/4/15 19:10:00,61,92,-31
26438,26438,245,2022/4/15 19:20:00,44,80,-36
26439,26439,245,2022/4/15 19:30:00,44,85,-41
26440,26440,245,2022/4/15 19:40:00,37,76,-39
26441,26441,245,2022/4/15 19:50:00,38,75,-37
26442,26442,245,2022/4/15 20:00:00,35,68,-33
26443,26443,245,2022/4/15 20:10:00,41,57,-16
26444,26444,245,2022/4/15 20:20:00,32,68,-36
26445,26445,245,2022/4/15 20:30:00,32,64,-32
26446,26446,245,2022/4/15 20:40:00,30,66,-36
26447,26447,245,2022/4/15 20:50:00,30,74,-44
26448,26448,245,2022/4/15 21:00:00,32,62,-30
26449,26449,245,2022/4/15 21:10:00,34,60,-26
26450,26450,245,2022/4/15 21:20:00,34,67,-33
26451,26451,245,2022/4/15 21:30:00,25,70,-45
26452,26452,245,2022/4/15 21:40:00,33,62,-29
26453,26453,245,2022/4/15 21:50:00,37,65,-28
26454,26454,245,2022/4/15 22:00:00,34,55,-21
26455,26455,245,2022/4/15 22:10:00,28,52,-24
26456,26456,245,2022/4/15 22:20:00,16,49,-33
26457,26457,245,2022/4/15 22:30:00,13,50,-37
26458,26458,245,2022/4/15 22:40:00,7,51,-44
26459,26459,245,2022/4/15 22:50:00,3,27,-24
26460,26460,246,2022/4/15 5:00:00,0,1,-1
26461,26461,246,2022/4/15 5:10:00,3,1,2
26462,26462,246,2022/4/15 5:20:00,12,1,11
26463,26463,246,2022/4/15 5:30:00,14,1,13
26464,26464,246,2022/4/15 5:40:00,15,1,14
26465,26465,246,2022/4/15 5:50:00,17,1,16
26466,26466,246,2022/4/15 6:00:00,22,1,21
26467,26467,246,2022/4/15 6:10:00,21,1,20
26468,26468,246,2022/4/15 6:20:00,26,8,18
26469,26469,246,2022/4/15 6:30:00,36,64,-28
26470,26470,246,2022/4/15 6:40:00,29,73,-44
26471,26471,246,2022/4/15 6:50:00,50,82,-32
26472,26472,246,2022/4/15 7:00:00,47,104,-57
26473,26473,246,2022/4/15 7:10:00,56,87,-31
26474,26474,246,2022/4/15 7:20:00,78,111,-33
26475,26475,246,2022/4/15 7:30:00,70,133,-63
26476,26476,246,2022/4/15 7:40:00,149,152,-3
26477,26477,246,2022/4/15 7:50:00,171,112,59
26478,26478,246,2022/4/15 8:00:00,184,110,74
26479,26479,246,2022/4/15 8:10:00,147,121,26
26480,26480,246,2022/4/15 8:20:00,151,107,44
26481,26481,246,2022/4/15 8:30:00,121,110,11
26482,26482,246,2022/4/15 8:40:00,71,185,-114
26483,26483,246,2022/4/15 8:50:00,69,144,-75
26484,26484,246,2022/4/15 9:00:00,38,123,-85
26485,26485,246,2022/4/15 9:10:00,36,106,-70
26486,26486,246,2022/4/15 9:20:00,31,104,-73
26487,26487,246,2022/4/15 9:30:00,35,82,-47
26488,26488,246,2022/4/15 9:40:00,24,76,-52
26489,26489,246,2022/4/15 9:50:00,25,76,-51
26490,26490,246,2022/4/15 10:00:00,27,63,-36
26491,26491,246,2022/4/15 10:10:00,24,69,-45
26492,26492,246,2022/4/15 10:20:00,26,65,-39
26493,26493,246,2022/4/15 10:30:00,21,51,-30
26494,26494,246,2022/4/15 10:40:00,18,64,-46
26495,26495,246,2022/4/15 10:50:00,26,45,-19
26496,26496,246,2022/4/15 11:00:00,25,62,-37
26497,26497,246,2022/4/15 11:10:00,24,54,-30
26498,26498,246,2022/4/15 11:20:00,24,57,-33
26499,26499,246,2022/4/15 11:30:00,25,41,-16
26500,26500,246,2022/4/15 11:40:00,25,58,-33
26501,26501,246,2022/4/15 11:50:00,29,64,-35
26502,26502,246,2022/4/15 12:00:00,28,60,-32
26503,26503,246,2022/4/15 12:10:00,26,65,-39
26504,26504,246,2022/4/15 12:20:00,26,54,-28
26505,26505,246,2022/4/15 12:30:00,23,51,-28
26506,26506,246,2022/4/15 12:40:00,35,48,-13
26507,26507,246,2022/4/15 12:50:00,27,62,-35
26508,26508,246,2022/4/15 13:00:00,25,66,-41
26509,26509,246,2022/4/15 13:10:00,26,55,-29
26510,26510,246,2022/4/15 13:20:00,27,57,-30
26511,26511,246,2022/4/15 13:30:00,27,50,-23
26512,26512,246,2022/4/15 13:40:00,28,52,-24
26513,26513,246,2022/4/15 13:50:00,26,62,-36
26514,26514,246,2022/4/15 14:00:00,28,64,-36
26515,26515,246,2022/4/15 14:10:00,26,65,-39
26516,26516,246,2022/4/15 14:20:00,26,63,-37
26517,26517,246,2022/4/15 14:30:00,25,50,-25
26518,26518,246,2022/4/15 14:40:00,28,63,-35
26519,26519,246,2022/4/15 14:50:00,28,65,-37
26520,26520,246,2022/4/15 15:00:00,27,63,-36
26521,26521,246,2022/4/15 15:10:00,31,57,-26
26522,26522,246,2022/4/15 15:20:00,27,51,-24
26523,26523,246,2022/4/15 15:30:00,25,50,-25
26524,26524,246,2022/4/15 15:40:00,32,59,-27
26525,26525,246,2022/4/15 15:50:00,26,65,-39
26526,26526,246,2022/4/15 16:00:00,30,64,-34
26527,26527,246,2022/4/15 16:10:00,37,66,-29
26528,26528,246,2022/4/15 16:20:00,43,53,-10
26529,26529,246,2022/4/15 16:30:00,60,69,-9
26530,26530,246,2022/4/15 16:40:00,135,71,64
26531,26531,246,2022/4/15 16:50:00,101,66,35
26532,26532,246,2022/4/15 17:00:00,177,70,107
26533,26533,246,2022/4/15 17:10:00,270,72,198
26534,26534,246,2022/4/15 17:20:00,234,77,157
26535,26535,246,2022/4/15 17:30:00,227,76,151
26536,26536,246,2022/4/15 17:40:00,336,92,244
26537,26537,246,2022/4/15 17:50:00,316,81,235
26538,26538,246,2022/4/15 18:00:00,270,99,171
26539,26539,246,2022/4/15 18:10:00,584,77,507
26540,26540,246,2022/4/15 18:20:00,266,106,160
26541,26541,246,2022/4/15 18:30:00,167,95,72
26542,26542,246,2022/4/15 18:40:00,191,106,85
26543,26543,246,2022/4/15 18:50:00,75,102,-27
26544,26544,246,2022/4/15 19:00:00,41,78,-37
26545,26545,246,2022/4/15 19:10:00,42,81,-39
26546,26546,246,2022/4/15 19:20:00,34,67,-33
26547,26547,246,2022/4/15 19:30:00,29,63,-34
26548,26548,246,2022/4/15 19:40:00,30,70,-40
26549,26549,246,2022/4/15 19:50:00,28,53,-25
26550,26550,246,2022/4/15 20:00:00,33,50,-17
26551,26551,246,2022/4/15 20:10:00,32,46,-14
26552,26552,246,2022/4/15 20:20:00,29,43,-14
26553,26553,246,2022/4/15 20:30:00,44,40,4
26554,26554,246,2022/4/15 20:40:00,27,47,-20
26555,26555,246,2022/4/15 20:50:00,32,40,-8
26556,26556,246,2022/4/15 21:00:00,35,36,-1
26557,26557,246,2022/4/15 21:10:00,27,27,0
26558,26558,246,2022/4/15 21:20:00,28,41,-13
26559,26559,246,2022/4/15 21:30:00,29,33,-4
26560,26560,246,2022/4/15 21:40:00,21,31,-10
26561,26561,246,2022/4/15 21:50:00,17,38,-21
26562,26562,246,2022/4/15 22:00:00,15,34,-19
26563,26563,246,2022/4/15 22:10:00,13,34,-21
26564,26564,246,2022/4/15 22:20:00,6,34,-28
26565,26565,246,2022/4/15 22:30:00,5,34,-29
26566,26566,246,2022/4/15 22:40:00,1,25,-24
26567,26567,246,2022/4/15 22:50:00,1,25,-24
26568,26568,247,2022/4/15 5:00:00,0,1,-1
26569,26569,247,2022/4/15 5:10:00,3,1,2
26570,26570,247,2022/4/15 5:20:00,15,1,14
26571,26571,247,2022/4/15 5:30:00,19,1,18
26572,26572,247,2022/4/15 5:40:00,19,1,18
26573,26573,247,2022/4/15 5:50:00,31,1,30
26574,26574,247,2022/4/15 6:00:00,33,1,32
26575,26575,247,2022/4/15 6:10:00,35,1,34
26576,26576,247,2022/4/15 6:20:00,44,1,43
26577,26577,247,2022/4/15 6:30:00,45,1,44
26578,26578,247,2022/4/15 6:40:00,51,23,28
26579,26579,247,2022/4/15 6:50:00,71,21,50
26580,26580,247,2022/4/15 7:00:00,86,32,54
26581,26581,247,2022/4/15 7:10:00,153,42,111
26582,26582,247,2022/4/15 7:20:00,222,41,181
26583,26583,247,2022/4/15 7:30:00,199,71,128
26584,26584,247,2022/4/15 7:40:00,213,72,141
26585,26585,247,2022/4/15 7:50:00,184,68,116
26586,26586,247,2022/4/15 8:00:00,181,74,107
26587,26587,247,2022/4/15 8:10:00,105,48,57
26588,26588,247,2022/4/15 8:20:00,76,53,23
26589,26589,247,2022/4/15 8:30:00,56,62,-6
26590,26590,247,2022/4/15 8:40:00,43,76,-33
26591,26591,247,2022/4/15 8:50:00,33,66,-33
26592,26592,247,2022/4/15 9:00:00,29,58,-29
26593,26593,247,2022/4/15 9:10:00,30,46,-16
26594,26594,247,2022/4/15 9:20:00,26,54,-28
26595,26595,247,2022/4/15 9:30:00,23,52,-29
26596,26596,247,2022/4/15 9:40:00,22,44,-22
26597,26597,247,2022/4/15 9:50:00,22,53,-31
26598,26598,247,2022/4/15 10:00:00,22,38,-16
26599,26599,247,2022/4/15 10:10:00,17,57,-40
26600,26600,247,2022/4/15 10:20:00,20,41,-21
26601,26601,247,2022/4/15 10:30:00,20,54,-34
26602,26602,247,2022/4/15 10:40:00,16,41,-25
26603,26603,247,2022/4/15 10:50:00,18,29,-11
26604,26604,247,2022/4/15 11:00:00,18,45,-27
26605,26605,247,2022/4/15 11:10:00,19,51,-32
26606,26606,247,2022/4/15 11:20:00,19,6,13
26607,26607,247,2022/4/15 11:30:00,20,47,-27
26608,26608,247,2022/4/15 11:40:00,19,41,-22
26609,26609,247,2022/4/15 11:50:00,21,46,-25
26610,26610,247,2022/4/15 12:00:00,18,45,-27
26611,26611,247,2022/4/15 12:10:00,20,38,-18
26612,26612,247,2022/4/15 12:20:00,19,38,-19
26613,26613,247,2022/4/15 12:30:00,19,45,-26
26614,26614,247,2022/4/15 12:40:00,21,40,-19
26615,26615,247,2022/4/15 12:50:00,17,41,-24
26616,26616,247,2022/4/15 13:00:00,17,31,-14
26617,26617,247,2022/4/15 13:10:00,17,19,-2
26618,26618,247,2022/4/15 13:20:00,17,47,-30
26619,26619,247,2022/4/15 13:30:00,20,50,-30
26620,26620,247,2022/4/15 13:40:00,20,51,-31
26621,26621,247,2022/4/15 13:50:00,19,49,-30
26622,26622,247,2022/4/15 14:00:00,16,51,-35
26623,26623,247,2022/4/15 14:10:00,18,52,-34
26624,26624,247,2022/4/15 14:20:00,18,50,-32
26625,26625,247,2022/4/15 14:30:00,17,50,-33
26626,26626,247,2022/4/15 14:40:00,16,45,-29
26627,26627,247,2022/4/15 14:50:00,19,45,-26
26628,26628,247,2022/4/15 15:00:00,14,21,-7
26629,26629,247,2022/4/15 15:10:00,17,68,-51
26630,26630,247,2022/4/15 15:20:00,15,70,-55
26631,26631,247,2022/4/15 15:30:00,23,41,-18
26632,26632,247,2022/4/15 15:40:00,19,67,-48
26633,26633,247,2022/4/15 15:50:00,16,28,-12
26634,26634,247,2022/4/15 16:00:00,17,56,-39
26635,26635,247,2022/4/15 16:10:00,21,73,-52
26636,26636,247,2022/4/15 16:20:00,18,62,-44
26637,26637,247,2022/4/15 16:30:00,28,61,-33
26638,26638,247,2022/4/15 16:40:00,17,41,-24
26639,26639,247,2022/4/15 16:50:00,29,93,-64
26640,26640,247,2022/4/15 17:00:00,24,59,-35
26641,26641,247,2022/4/15 17:10:00,28,80,-52
26642,26642,247,2022/4/15 17:20:00,18,63,-45
26643,26643,247,2022/4/15 17:30:00,24,77,-53
26644,26644,247,2022/4/15 17:40:00,27,98,-71
26645,26645,247,2022/4/15 17:50:00,26,93,-67
26646,26646,247,2022/4/15 18:00:00,21,106,-85
26647,26647,247,2022/4/15 18:10:00,13,123,-110
26648,26648,247,2022/4/15 18:20:00,15,107,-92
26649,26649,247,2022/4/15 18:30:00,14,105,-91
26650,26650,247,2022/4/15 18:40:00,12,108,-96
26651,26651,247,2022/4/15 18:50:00,10,112,-102
26652,26652,247,2022/4/15 19:00:00,8,116,-108
26653,26653,247,2022/4/15 19:10:00,10,112,-102
26654,26654,247,2022/4/15 19:20:00,9,110,-101
26655,26655,247,2022/4/15 19:30:00,8,106,-98
26656,26656,247,2022/4/15 19:40:00,9,101,-92
26657,26657,247,2022/4/15 19:50:00,8,99,-91
26658,26658,247,2022/4/15 20:00:00,6,77,-71
26659,26659,247,2022/4/15 20:10:00,6,88,-82
26660,26660,247,2022/4/15 20:20:00,7,52,-45
26661,26661,247,2022/4/15 20:30:00,6,94,-88
26662,26662,247,2022/4/15 20:40:00,4,71,-67
26663,26663,247,2022/4/15 20:50:00,5,61,-56
26664,26664,247,2022/4/15 21:00:00,6,70,-64
26665,26665,247,2022/4/15 21:10:00,3,64,-61
26666,26666,247,2022/4/15 21:20:00,3,64,-61
26667,26667,247,2022/4/15 21:30:00,2,71,-69
26668,26668,247,2022/4/15 21:40:00,3,48,-45
26669,26669,247,2022/4/15 21:50:00,2,68,-66
26670,26670,247,2022/4/15 22:00:00,2,34,-32
26671,26671,247,2022/4/15 22:10:00,1,65,-64
26672,26672,247,2022/4/15 22:20:00,0,67,-67
26673,26673,247,2022/4/15 22:30:00,0,53,-53
26674,26674,247,2022/4/15 22:40:00,0,52,-52
26675,26675,247,2022/4/15 22:50:00,0,49,-49
26676,26676,248,2022/4/15 5:00:00,3,1,2
26677,26677,248,2022/4/15 5:10:00,8,1,7
26678,26678,248,2022/4/15 5:20:00,20,1,19
26679,26679,248,2022/4/15 5:30:00,15,1,14
26680,26680,248,2022/4/15 5:40:00,25,1,24
26681,26681,248,2022/4/15 5:50:00,42,1,41
26682,26682,248,2022/4/15 6:00:00,45,1,44
26683,26683,248,2022/4/15 6:10:00,55,1,54
26684,26684,248,2022/4/15 6:20:00,60,1,59
26685,26685,248,2022/4/15 6:30:00,83,1,82
26686,26686,248,2022/4/15 6:40:00,163,51,112
26687,26687,248,2022/4/15 6:50:00,228,68,160
26688,26688,248,2022/4/15 7:00:00,231,50,181
26689,26689,248,2022/4/15 7:10:00,327,99,228
26690,26690,248,2022/4/15 7:20:00,349,76,273
26691,26691,248,2022/4/15 7:30:00,396,110,286
26692,26692,248,2022/4/15 7:40:00,365,105,260
26693,26693,248,2022/4/15 7:50:00,348,89,259
26694,26694,248,2022/4/15 8:00:00,278,99,179
26695,26695,248,2022/4/15 8:10:00,282,122,160
26696,26696,248,2022/4/15 8:20:00,207,103,104
26697,26697,248,2022/4/15 8:30:00,144,126,18
26698,26698,248,2022/4/15 8:40:00,100,96,4
26699,26699,248,2022/4/15 8:50:00,94,83,11
26700,26700,248,2022/4/15 9:00:00,48,93,-45
26701,26701,248,2022/4/15 9:10:00,50,101,-51
26702,26702,248,2022/4/15 9:20:00,44,90,-46
26703,26703,248,2022/4/15 9:30:00,38,87,-49
26704,26704,248,2022/4/15 9:40:00,37,101,-64
26705,26705,248,2022/4/15 9:50:00,35,106,-71
26706,26706,248,2022/4/15 10:00:00,35,87,-52
26707,26707,248,2022/4/15 10:10:00,34,90,-56
26708,26708,248,2022/4/15 10:20:00,37,87,-50
26709,26709,248,2022/4/15 10:30:00,33,73,-40
26710,26710,248,2022/4/15 10:40:00,38,77,-39
26711,26711,248,2022/4/15 10:50:00,30,92,-62
26712,26712,248,2022/4/15 11:00:00,38,68,-30
26713,26713,248,2022/4/15 11:10:00,39,64,-25
26714,26714,248,2022/4/15 11:20:00,38,51,-13
26715,26715,248,2022/4/15 11:30:00,40,70,-30
26716,26716,248,2022/4/15 11:40:00,48,74,-26
26717,26717,248,2022/4/15 11:50:00,51,65,-14
26718,26718,248,2022/4/15 12:00:00,43,78,-35
26719,26719,248,2022/4/15 12:10:00,46,70,-24
26720,26720,248,2022/4/15 12:20:00,41,74,-33
26721,26721,248,2022/4/15 12:30:00,43,47,-4
26722,26722,248,2022/4/15 12:40:00,44,47,-3
26723,26723,248,2022/4/15 12:50:00,39,71,-32
26724,26724,248,2022/4/15 13:00:00,29,75,-46
26725,26725,248,2022/4/15 13:10:00,40,73,-33
26726,26726,248,2022/4/15 13:20:00,39,70,-31
26727,26727,248,2022/4/15 13:30:00,33,76,-43
26728,26728,248,2022/4/15 13:40:00,31,76,-45
26729,26729,248,2022/4/15 13:50:00,34,73,-39
26730,26730,248,2022/4/15 14:00:00,28,68,-40
26731,26731,248,2022/4/15 14:10:00,25,85,-60
26732,26732,248,2022/4/15 14:20:00,37,44,-7
26733,26733,248,2022/4/15 14:30:00,29,65,-36
26734,26734,248,2022/4/15 14:40:00,36,81,-45
26735,26735,248,2022/4/15 14:50:00,27,77,-50
26736,26736,248,2022/4/15 15:00:00,29,77,-48
26737,26737,248,2022/4/15 15:10:00,30,87,-57
26738,26738,248,2022/4/15 15:20:00,41,81,-40
26739,26739,248,2022/4/15 15:30:00,29,77,-48
26740,26740,248,2022/4/15 15:40:00,34,90,-56
26741,26741,248,2022/4/15 15:50:00,42,62,-20
26742,26742,248,2022/4/15 16:00:00,44,87,-43
26743,26743,248,2022/4/15 16:10:00,34,101,-67
26744,26744,248,2022/4/15 16:20:00,42,75,-33
26745,26745,248,2022/4/15 16:30:00,38,106,-68
26746,26746,248,2022/4/15 16:40:00,43,70,-27
26747,26747,248,2022/4/15 16:50:00,44,110,-66
26748,26748,248,2022/4/15 17:00:00,42,107,-65
26749,26749,248,2022/4/15 17:10:00,53,110,-57
26750,26750,248,2022/4/15 17:20:00,73,126,-53
26751,26751,248,2022/4/15 17:30:00,43,104,-61
26752,26752,248,2022/4/15 17:40:00,40,93,-53
26753,26753,248,2022/4/15 17:50:00,37,106,-69
26754,26754,248,2022/4/15 18:00:00,29,108,-79
26755,26755,248,2022/4/15 18:10:00,31,128,-97
26756,26756,248,2022/4/15 18:20:00,29,101,-72
26757,26757,248,2022/4/15 18:30:00,28,119,-91
26758,26758,248,2022/4/15 18:40:00,26,235,-209
26759,26759,248,2022/4/15 18:50:00,23,119,-96
26760,26760,248,2022/4/15 19:00:00,23,154,-131
26761,26761,248,2022/4/15 19:10:00,23,111,-88
26762,26762,248,2022/4/15 19:20:00,17,181,-164
26763,26763,248,2022/4/15 19:30:00,19,128,-109
26764,26764,248,2022/4/15 19:40:00,20,117,-97
26765,26765,248,2022/4/15 19:50:00,18,87,-69
26766,26766,248,2022/4/15 20:00:00,15,105,-90
26767,26767,248,2022/4/15 20:10:00,13,110,-97
26768,26768,248,2022/4/15 20:20:00,17,79,-62
26769,26769,248,2022/4/15 20:30:00,14,95,-81
26770,26770,248,2022/4/15 20:40:00,14,104,-90
26771,26771,248,2022/4/15 20:50:00,12,95,-83
26772,26772,248,2022/4/15 21:00:00,10,95,-85
26773,26773,248,2022/4/15 21:10:00,13,77,-64
26774,26774,248,2022/4/15 21:20:00,10,76,-66
26775,26775,248,2022/4/15 21:30:00,7,87,-80
26776,26776,248,2022/4/15 21:40:00,6,76,-70
26777,26777,248,2022/4/15 21:50:00,5,87,-82
26778,26778,248,2022/4/15 22:00:00,5,54,-49
26779,26779,248,2022/4/15 22:10:00,1,83,-82
26780,26780,248,2022/4/15 22:20:00,0,87,-87
26781,26781,248,2022/4/15 22:30:00,0,79,-79
26782,26782,248,2022/4/15 22:40:00,0,74,-74
26783,26783,248,2022/4/15 22:50:00,0,73,-73
26784,26784,249,2022/4/15 5:00:00,0,1,-1
26785,26785,249,2022/4/15 5:10:00,1,1,0
26786,26786,249,2022/4/15 5:20:00,6,1,5
26787,26787,249,2022/4/15 5:30:00,5,1,4
26788,26788,249,2022/4/15 5:40:00,17,1,16
26789,26789,249,2022/4/15 5:50:00,14,1,13
26790,26790,249,2022/4/15 6:00:00,25,1,24
26791,26791,249,2022/4/15 6:10:00,31,1,30
26792,26792,249,2022/4/15 6:20:00,34,14,20
26793,26793,249,2022/4/15 6:30:00,34,8,26
26794,26794,249,2022/4/15 6:40:00,45,16,29
26795,26795,249,2022/4/15 6:50:00,53,22,31
26796,26796,249,2022/4/15 7:00:00,53,23,30
26797,26797,249,2022/4/15 7:10:00,71,49,22
26798,26798,249,2022/4/15 7:20:00,149,62,87
26799,26799,249,2022/4/15 7:30:00,179,72,107
26800,26800,249,2022/4/15 7:40:00,238,71,167
26801,26801,249,2022/4/15 7:50:00,282,83,199
26802,26802,249,2022/4/15 8:00:00,232,83,149
26803,26803,249,2022/4/15 8:10:00,235,77,158
26804,26804,249,2022/4/15 8:20:00,212,77,135
26805,26805,249,2022/4/15 8:30:00,155,71,84
26806,26806,249,2022/4/15 8:40:00,73,48,25
26807,26807,249,2022/4/15 8:50:00,54,53,1
26808,26808,249,2022/4/15 9:00:00,45,50,-5
26809,26809,249,2022/4/15 9:10:00,35,42,-7
26810,26810,249,2022/4/15 9:20:00,36,57,-21
26811,26811,249,2022/4/15 9:30:00,28,50,-22
26812,26812,249,2022/4/15 9:40:00,27,58,-31
26813,26813,249,2022/4/15 9:50:00,26,54,-28
26814,26814,249,2022/4/15 10:00:00,22,47,-25
26815,26815,249,2022/4/15 10:10:00,22,35,-13
26816,26816,249,2022/4/15 10:20:00,21,38,-17
26817,26817,249,2022/4/15 10:30:00,21,24,-3
26818,26818,249,2022/4/15 10:40:00,19,32,-13
26819,26819,249,2022/4/15 10:50:00,20,31,-11
26820,26820,249,2022/4/15 11:00:00,21,40,-19
26821,26821,249,2022/4/15 11:10:00,22,39,-17
26822,26822,249,2022/4/15 11:20:00,21,35,-14
26823,26823,249,2022/4/15 11:30:00,22,37,-15
26824,26824,249,2022/4/15 11:40:00,20,34,-14
26825,26825,249,2022/4/15 11:50:00,22,38,-16
26826,26826,249,2022/4/15 12:00:00,21,36,-15
26827,26827,249,2022/4/15 12:10:00,22,38,-16
26828,26828,249,2022/4/15 12:20:00,25,42,-17
26829,26829,249,2022/4/15 12:30:00,25,38,-13
26830,26830,249,2022/4/15 12:40:00,23,46,-23
26831,26831,249,2022/4/15 12:50:00,21,47,-26
26832,26832,249,2022/4/15 13:00:00,21,53,-32
26833,26833,249,2022/4/15 13:10:00,22,51,-29
26834,26834,249,2022/4/15 13:20:00,23,39,-16
26835,26835,249,2022/4/15 13:30:00,22,23,-1
26836,26836,249,2022/4/15 13:40:00,21,40,-19
26837,26837,249,2022/4/15 13:50:00,20,41,-21
26838,26838,249,2022/4/15 14:00:00,20,38,-18
26839,26839,249,2022/4/15 14:10:00,22,38,-16
26840,26840,249,2022/4/15 14:20:00,20,32,-12
26841,26841,249,2022/4/15 14:30:00,17,38,-21
26842,26842,249,2022/4/15 14:40:00,21,41,-20
26843,26843,249,2022/4/15 14:50:00,23,41,-18
26844,26844,249,2022/4/15 15:00:00,25,49,-24
26845,26845,249,2022/4/15 15:10:00,22,38,-16
26846,26846,249,2022/4/15 15:20:00,20,38,-18
26847,26847,249,2022/4/15 15:30:00,18,52,-34
26848,26848,249,2022/4/15 15:40:00,22,48,-26
26849,26849,249,2022/4/15 15:50:00,23,50,-27
26850,26850,249,2022/4/15 16:00:00,24,54,-30
26851,26851,249,2022/4/15 16:10:00,25,53,-28
26852,26852,249,2022/4/15 16:20:00,26,52,-26
26853,26853,249,2022/4/15 16:30:00,31,45,-14
26854,26854,249,2022/4/15 16:40:00,30,62,-32
26855,26855,249,2022/4/15 16:50:00,27,71,-44
26856,26856,249,2022/4/15 17:00:00,23,72,-49
26857,26857,249,2022/4/15 17:10:00,23,69,-46
26858,26858,249,2022/4/15 17:20:00,16,77,-61
26859,26859,249,2022/4/15 17:30:00,24,98,-74
26860,26860,249,2022/4/15 17:40:00,20,99,-79
26861,26861,249,2022/4/15 17:50:00,18,98,-80
26862,26862,249,2022/4/15 18:00:00,17,107,-90
26863,26863,249,2022/4/15 18:10:00,17,126,-109
26864,26864,249,2022/4/15 18:20:00,15,125,-110
26865,26865,249,2022/4/15 18:30:00,18,84,-66
26866,26866,249,2022/4/15 18:40:00,15,122,-107
26867,26867,249,2022/4/15 18:50:00,12,125,-113
26868,26868,249,2022/4/15 19:00:00,12,127,-115
26869,26869,249,2022/4/15 19:10:00,11,106,-95
26870,26870,249,2022/4/15 19:20:00,11,107,-96
26871,26871,249,2022/4/15 19:30:00,9,106,-97
26872,26872,249,2022/4/15 19:40:00,9,88,-79
26873,26873,249,2022/4/15 19:50:00,10,75,-65
26874,26874,249,2022/4/15 20:00:00,12,85,-73
26875,26875,249,2022/4/15 20:10:00,13,79,-66
26876,26876,249,2022/4/15 20:20:00,11,62,-51
26877,26877,249,2022/4/15 20:30:00,9,82,-73
26878,26878,249,2022/4/15 20:40:00,12,74,-62
26879,26879,249,2022/4/15 20:50:00,11,70,-59
26880,26880,249,2022/4/15 21:00:00,9,66,-57
26881,26881,249,2022/4/15 21:10:00,6,70,-64
26882,26882,249,2022/4/15 21:20:00,5,75,-70
26883,26883,249,2022/4/15 21:30:00,4,71,-67
26884,26884,249,2022/4/15 21:40:00,5,69,-64
26885,26885,249,2022/4/15 21:50:00,5,60,-55
26886,26886,249,2022/4/15 22:00:00,1,63,-62
26887,26887,249,2022/4/15 22:10:00,1,68,-67
26888,26888,249,2022/4/15 22:20:00,2,61,-59
26889,26889,249,2022/4/15 22:30:00,1,52,-51
26890,26890,249,2022/4/15 22:40:00,0,59,-59
26891,26891,249,2022/4/15 22:50:00,0,53,-53
26892,26892,250,2022/4/15 5:00:00,0,1,-1
26893,26893,250,2022/4/15 5:10:00,2,1,1
26894,26894,250,2022/4/15 5:20:00,10,1,9
26895,26895,250,2022/4/15 5:30:00,14,1,13
26896,26896,250,2022/4/15 5:40:00,14,1,13
26897,26897,250,2022/4/15 5:50:00,26,1,25
26898,26898,250,2022/4/15 6:00:00,27,1,26
26899,26899,250,2022/4/15 6:10:00,36,1,35
26900,26900,250,2022/4/15 6:20:00,38,1,37
26901,26901,250,2022/4/15 6:30:00,57,1,56
26902,26902,250,2022/4/15 6:40:00,34,27,7
26903,26903,250,2022/4/15 6:50:00,56,22,34
26904,26904,250,2022/4/15 7:00:00,54,16,38
26905,26905,250,2022/4/15 7:10:00,88,14,74
26906,26906,250,2022/4/15 7:20:00,108,19,89
26907,26907,250,2022/4/15 7:30:00,121,21,100
26908,26908,250,2022/4/15 7:40:00,185,24,161
26909,26909,250,2022/4/15 7:50:00,147,35,112
26910,26910,250,2022/4/15 8:00:00,79,29,50
26911,26911,250,2022/4/15 8:10:00,64,29,35
26912,26912,250,2022/4/15 8:20:00,53,28,25
26913,26913,250,2022/4/15 8:30:00,33,25,8
26914,26914,250,2022/4/15 8:40:00,29,19,10
26915,26915,250,2022/4/15 8:50:00,31,23,8
26916,26916,250,2022/4/15 9:00:00,26,23,3
26917,26917,250,2022/4/15 9:10:00,23,31,-8
26918,26918,250,2022/4/15 9:20:00,21,23,-2
26919,26919,250,2022/4/15 9:30:00,14,23,-9
26920,26920,250,2022/4/15 9:40:00,16,23,-7
26921,26921,250,2022/4/15 9:50:00,15,33,-18
26922,26922,250,2022/4/15 10:00:00,14,23,-9
26923,26923,250,2022/4/15 10:10:00,17,21,-4
26924,26924,250,2022/4/15 10:20:00,14,25,-11
26925,26925,250,2022/4/15 10:30:00,13,23,-10
26926,26926,250,2022/4/15 10:40:00,14,19,-5
26927,26927,250,2022/4/15 10:50:00,13,19,-6
26928,26928,250,2022/4/15 11:00:00,12,23,-11
26929,26929,250,2022/4/15 11:10:00,12,19,-7
26930,26930,250,2022/4/15 11:20:00,15,23,-8
26931,26931,250,2022/4/15 11:30:00,13,23,-10
26932,26932,250,2022/4/15 11:40:00,12,23,-11
26933,26933,250,2022/4/15 11:50:00,15,23,-8
26934,26934,250,2022/4/15 12:00:00,13,8,5
26935,26935,250,2022/4/15 12:10:00,13,23,-10
26936,26936,250,2022/4/15 12:20:00,12,23,-11
26937,26937,250,2022/4/15 12:30:00,10,23,-13
26938,26938,250,2022/4/15 12:40:00,11,22,-11
26939,26939,250,2022/4/15 12:50:00,10,23,-13
26940,26940,250,2022/4/15 13:00:00,14,29,-15
26941,26941,250,2022/4/15 13:10:00,10,25,-15
26942,26942,250,2022/4/15 13:20:00,12,32,-20
26943,26943,250,2022/4/15 13:30:00,11,23,-12
26944,26944,250,2022/4/15 13:40:00,8,23,-15
26945,26945,250,2022/4/15 13:50:00,9,8,1
26946,26946,250,2022/4/15 14:00:00,7,23,-16
26947,26947,250,2022/4/15 14:10:00,6,23,-17
26948,26948,250,2022/4/15 14:20:00,9,29,-20
26949,26949,250,2022/4/15 14:30:00,7,24,-17
26950,26950,250,2022/4/15 14:40:00,10,31,-21
26951,26951,250,2022/4/15 14:50:00,7,31,-24
26952,26952,250,2022/4/15 15:00:00,5,32,-27
26953,26953,250,2022/4/15 15:10:00,8,31,-23
26954,26954,250,2022/4/15 15:20:00,10,32,-22
26955,26955,250,2022/4/15 15:30:00,5,30,-25
26956,26956,250,2022/4/15 15:40:00,7,23,-16
26957,26957,250,2022/4/15 15:50:00,10,38,-28
26958,26958,250,2022/4/15 16:00:00,9,41,-32
26959,26959,250,2022/4/15 16:10:00,8,25,-17
26960,26960,250,2022/4/15 16:20:00,12,38,-26
26961,26961,250,2022/4/15 16:30:00,5,49,-44
26962,26962,250,2022/4/15 16:40:00,10,49,-39
26963,26963,250,2022/4/15 16:50:00,8,49,-41
26964,26964,250,2022/4/15 17:00:00,7,15,-8
26965,26965,250,2022/4/15 17:10:00,8,68,-60
26966,26966,250,2022/4/15 17:20:00,8,39,-31
26967,26967,250,2022/4/15 17:30:00,9,60,-51
26968,26968,250,2022/4/15 17:40:00,10,76,-66
26969,26969,250,2022/4/15 17:50:00,8,38,-30
26970,26970,250,2022/4/15 18:00:00,7,75,-68
26971,26971,250,2022/4/15 18:10:00,7,84,-77
26972,26972,250,2022/4/15 18:20:00,5,81,-76
26973,26973,250,2022/4/15 18:30:00,8,95,-87
26974,26974,250,2022/4/15 18:40:00,6,52,-46
26975,26975,250,2022/4/15 18:50:00,7,110,-103
26976,26976,250,2022/4/15 19:00:00,5,91,-86
26977,26977,250,2022/4/15 19:10:00,2,64,-62
26978,26978,250,2022/4/15 19:20:00,4,99,-95
26979,26979,250,2022/4/15 19:30:00,3,75,-72
26980,26980,250,2022/4/15 19:40:00,2,74,-72
26981,26981,250,2022/4/15 19:50:00,4,39,-35
26982,26982,250,2022/4/15 20:00:00,3,71,-68
26983,26983,250,2022/4/15 20:10:00,3,53,-50
26984,26984,250,2022/4/15 20:20:00,2,46,-44
26985,26985,250,2022/4/15 20:30:00,3,48,-45
26986,26986,250,2022/4/15 20:40:00,1,33,-32
26987,26987,250,2022/4/15 20:50:00,2,41,-39
26988,26988,250,2022/4/15 21:00:00,1,40,-39
26989,26989,250,2022/4/15 21:10:00,2,46,-44
26990,26990,250,2022/4/15 21:20:00,2,49,-47
26991,26991,250,2022/4/15 21:30:00,2,40,-38
26992,26992,250,2022/4/15 21:40:00,2,27,-25
26993,26993,250,2022/4/15 21:50:00,1,54,-53
26994,26994,250,2022/4/15 22:00:00,1,48,-47
26995,26995,250,2022/4/15 22:10:00,2,48,-46
26996,26996,250,2022/4/15 22:20:00,0,47,-47
26997,26997,250,2022/4/15 22:30:00,0,41,-41
26998,26998,250,2022/4/15 22:40:00,0,40,-40
26999,26999,250,2022/4/15 22:50:00,0,49,-49
27000,27000,251,2022/4/15 5:00:00,0,1,-1
27001,27001,251,2022/4/15 5:10:00,1,1,0
27002,27002,251,2022/4/15 5:20:00,3,1,2
27003,27003,251,2022/4/15 5:30:00,5,1,4
27004,27004,251,2022/4/15 5:40:00,6,1,5
27005,27005,251,2022/4/15 5:50:00,7,1,6
27006,27006,251,2022/4/15 6:00:00,9,1,8
27007,27007,251,2022/4/15 6:10:00,18,1,17
27008,27008,251,2022/4/15 6:20:00,19,6,13
27009,27009,251,2022/4/15 6:30:00,26,12,14
27010,27010,251,2022/4/15 6:40:00,32,11,21
27011,27011,251,2022/4/15 6:50:00,32,11,21
27012,27012,251,2022/4/15 7:00:00,29,13,16
27013,27013,251,2022/4/15 7:10:00,54,21,33
27014,27014,251,2022/4/15 7:20:00,43,11,32
27015,27015,251,2022/4/15 7:30:00,68,8,60
27016,27016,251,2022/4/15 7:40:00,79,23,56
27017,27017,251,2022/4/15 7:50:00,59,23,36
27018,27018,251,2022/4/15 8:00:00,68,30,38
27019,27019,251,2022/4/15 8:10:00,64,33,31
27020,27020,251,2022/4/15 8:20:00,52,30,22
27021,27021,251,2022/4/15 8:30:00,38,23,15
27022,27022,251,2022/4/15 8:40:00,33,21,12
27023,27023,251,2022/4/15 8:50:00,28,23,5
27024,27024,251,2022/4/15 9:00:00,24,21,3
27025,27025,251,2022/4/15 9:10:00,17,23,-6
27026,27026,251,2022/4/15 9:20:00,15,22,-7
27027,27027,251,2022/4/15 9:30:00,13,22,-9
27028,27028,251,2022/4/15 9:40:00,10,16,-6
27029,27029,251,2022/4/15 9:50:00,10,20,-10
27030,27030,251,2022/4/15 10:00:00,8,24,-16
27031,27031,251,2022/4/15 10:10:00,10,22,-12
27032,27032,251,2022/4/15 10:20:00,8,19,-11
27033,27033,251,2022/4/15 10:30:00,7,16,-9
27034,27034,251,2022/4/15 10:40:00,5,23,-18
27035,27035,251,2022/4/15 10:50:00,7,19,-12
27036,27036,251,2022/4/15 11:00:00,8,18,-10
27037,27037,251,2022/4/15 11:10:00,8,19,-11
27038,27038,251,2022/4/15 11:20:00,9,21,-12
27039,27039,251,2022/4/15 11:30:00,9,12,-3
27040,27040,251,2022/4/15 11:40:00,9,14,-5
27041,27041,251,2022/4/15 11:50:00,8,18,-10
27042,27042,251,2022/4/15 12:00:00,7,19,-12
27043,27043,251,2022/4/15 12:10:00,8,17,-9
27044,27044,251,2022/4/15 12:20:00,8,15,-7
27045,27045,251,2022/4/15 12:30:00,9,17,-8
27046,27046,251,2022/4/15 12:40:00,9,14,-5
27047,27047,251,2022/4/15 12:50:00,10,19,-9
27048,27048,251,2022/4/15 13:00:00,8,19,-11
27049,27049,251,2022/4/15 13:10:00,5,12,-7
27050,27050,251,2022/4/15 13:20:00,6,17,-11
27051,27051,251,2022/4/15 13:30:00,5,21,-16
27052,27052,251,2022/4/15 13:40:00,8,14,-6
27053,27053,251,2022/4/15 13:50:00,5,21,-16
27054,27054,251,2022/4/15 14:00:00,7,21,-14
27055,27055,251,2022/4/15 14:10:00,4,19,-15
27056,27056,251,2022/4/15 14:20:00,5,21,-16
27057,27057,251,2022/4/15 14:30:00,6,13,-7
27058,27058,251,2022/4/15 14:40:00,6,23,-17
27059,27059,251,2022/4/15 14:50:00,6,19,-13
27060,27060,251,2022/4/15 15:00:00,8,23,-15
27061,27061,251,2022/4/15 15:10:00,5,23,-18
27062,27062,251,2022/4/15 15:20:00,6,23,-17
27063,27063,251,2022/4/15 15:30:00,7,21,-14
27064,27064,251,2022/4/15 15:40:00,7,23,-16
27065,27065,251,2022/4/15 15:50:00,9,25,-16
27066,27066,251,2022/4/15 16:00:00,7,21,-14
27067,27067,251,2022/4/15 16:10:00,9,23,-14
27068,27068,251,2022/4/15 16:20:00,6,25,-19
27069,27069,251,2022/4/15 16:30:00,8,32,-24
27070,27070,251,2022/4/15 16:40:00,8,23,-15
27071,27071,251,2022/4/15 16:50:00,8,39,-31
27072,27072,251,2022/4/15 17:00:00,11,37,-26
27073,27073,251,2022/4/15 17:10:00,7,38,-31
27074,27074,251,2022/4/15 17:20:00,7,45,-38
27075,27075,251,2022/4/15 17:30:00,5,46,-41
27076,27076,251,2022/4/15 17:40:00,7,50,-43
27077,27077,251,2022/4/15 17:50:00,8,50,-42
27078,27078,251,2022/4/15 18:00:00,6,63,-57
27079,27079,251,2022/4/15 18:10:00,6,65,-59
27080,27080,251,2022/4/15 18:20:00,6,63,-57
27081,27081,251,2022/4/15 18:30:00,4,70,-66
27082,27082,251,2022/4/15 18:40:00,6,75,-69
27083,27083,251,2022/4/15 18:50:00,4,59,-55
27084,27084,251,2022/4/15 19:00:00,3,80,-77
27085,27085,251,2022/4/15 19:10:00,4,74,-70
27086,27086,251,2022/4/15 19:20:00,3,62,-59
27087,27087,251,2022/4/15 19:30:00,2,53,-51
27088,27088,251,2022/4/15 19:40:00,3,54,-51
27089,27089,251,2022/4/15 19:50:00,2,40,-38
27090,27090,251,2022/4/15 20:00:00,2,40,-38
27091,27091,251,2022/4/15 20:10:00,2,34,-32
27092,27092,251,2022/4/15 20:20:00,1,35,-34
27093,27093,251,2022/4/15 20:30:00,1,40,-39
27094,27094,251,2022/4/15 20:40:00,1,37,-36
27095,27095,251,2022/4/15 20:50:00,2,35,-33
27096,27096,251,2022/4/15 21:00:00,1,31,-30
27097,27097,251,2022/4/15 21:10:00,3,27,-24
27098,27098,251,2022/4/15 21:20:00,2,25,-23
27099,27099,251,2022/4/15 21:30:00,1,35,-34
27100,27100,251,2022/4/15 21:40:00,1,33,-32
27101,27101,251,2022/4/15 21:50:00,1,32,-31
27102,27102,251,2022/4/15 22:00:00,1,39,-38
27103,27103,251,2022/4/15 22:10:00,0,33,-33
27104,27104,251,2022/4/15 22:20:00,0,26,-26
27105,27105,251,2022/4/15 22:30:00,0,35,-35
27106,27106,251,2022/4/15 22:40:00,0,35,-35
27107,27107,251,2022/4/15 22:50:00,0,34,-34
27108,27108,252,2022/4/15 5:00:00,0,1,-1
27109,27109,252,2022/4/15 5:10:00,2,1,1
27110,27110,252,2022/4/15 5:20:00,13,1,12
27111,27111,252,2022/4/15 5:30:00,16,1,15
27112,27112,252,2022/4/15 5:40:00,20,1,19
27113,27113,252,2022/4/15 5:50:00,28,1,27
27114,27114,252,2022/4/15 6:00:00,24,2,22
27115,27115,252,2022/4/15 6:10:00,33,1,32
27116,27116,252,2022/4/15 6:20:00,47,19,28
27117,27117,252,2022/4/15 6:30:00,60,8,52
27118,27118,252,2022/4/15 6:40:00,68,38,30
27119,27119,252,2022/4/15 6:50:00,87,34,53
27120,27120,252,2022/4/15 7:00:00,109,40,69
27121,27121,252,2022/4/15 7:10:00,168,58,110
27122,27122,252,2022/4/15 7:20:00,170,47,123
27123,27123,252,2022/4/15 7:30:00,214,60,154
27124,27124,252,2022/4/15 7:40:00,268,75,193
27125,27125,252,2022/4/15 7:50:00,284,79,205
27126,27126,252,2022/4/15 8:00:00,282,92,190
27127,27127,252,2022/4/15 8:10:00,236,118,118
27128,27128,252,2022/4/15 8:20:00,210,107,103
27129,27129,252,2022/4/15 8:30:00,184,87,97
27130,27130,252,2022/4/15 8:40:00,101,103,-2
27131,27131,252,2022/4/15 8:50:00,76,93,-17
27132,27132,252,2022/4/15 9:00:00,60,85,-25
27133,27133,252,2022/4/15 9:10:00,47,74,-27
27134,27134,252,2022/4/15 9:20:00,38,61,-23
27135,27135,252,2022/4/15 9:30:00,34,73,-39
27136,27136,252,2022/4/15 9:40:00,31,62,-31
27137,27137,252,2022/4/15 9:50:00,29,47,-18
27138,27138,252,2022/4/15 10:00:00,28,63,-35
27139,27139,252,2022/4/15 10:10:00,27,51,-24
27140,27140,252,2022/4/15 10:20:00,24,50,-26
27141,27141,252,2022/4/15 10:30:00,23,48,-25
27142,27142,252,2022/4/15 10:40:00,22,32,-10
27143,27143,252,2022/4/15 10:50:00,27,51,-24
27144,27144,252,2022/4/15 11:00:00,21,49,-28
27145,27145,252,2022/4/15 11:10:00,26,38,-12
27146,27146,252,2022/4/15 11:20:00,25,49,-24
27147,27147,252,2022/4/15 11:30:00,20,51,-31
27148,27148,252,2022/4/15 11:40:00,23,48,-25
27149,27149,252,2022/4/15 11:50:00,22,45,-23
27150,27150,252,2022/4/15 12:00:00,25,38,-13
27151,27151,252,2022/4/15 12:10:00,23,50,-27
27152,27152,252,2022/4/15 12:20:00,26,55,-29
27153,27153,252,2022/4/15 12:30:00,26,55,-29
27154,27154,252,2022/4/15 12:40:00,21,55,-34
27155,27155,252,2022/4/15 12:50:00,23,55,-32
27156,27156,252,2022/4/15 13:00:00,23,40,-17
27157,27157,252,2022/4/15 13:10:00,22,61,-39
27158,27158,252,2022/4/15 13:20:00,21,55,-34
27159,27159,252,2022/4/15 13:30:00,20,56,-36
27160,27160,252,2022/4/15 13:40:00,18,51,-33
27161,27161,252,2022/4/15 13:50:00,22,40,-18
27162,27162,252,2022/4/15 14:00:00,22,51,-29
27163,27163,252,2022/4/15 14:10:00,21,51,-30
27164,27164,252,2022/4/15 14:20:00,20,59,-39
27165,27165,252,2022/4/15 14:30:00,19,53,-34
27166,27166,252,2022/4/15 14:40:00,21,51,-30
27167,27167,252,2022/4/15 14:50:00,18,42,-24
27168,27168,252,2022/4/15 15:00:00,23,54,-31
27169,27169,252,2022/4/15 15:10:00,20,58,-38
27170,27170,252,2022/4/15 15:20:00,22,61,-39
27171,27171,252,2022/4/15 15:30:00,21,64,-43
27172,27172,252,2022/4/15 15:40:00,23,51,-28
27173,27173,252,2022/4/15 15:50:00,22,69,-47
27174,27174,252,2022/4/15 16:00:00,22,68,-46
27175,27175,252,2022/4/15 16:10:00,23,70,-47
27176,27176,252,2022/4/15 16:20:00,24,70,-46
27177,27177,252,2022/4/15 16:30:00,25,85,-60
27178,27178,252,2022/4/15 16:40:00,25,75,-50
27179,27179,252,2022/4/15 16:50:00,36,64,-28
27180,27180,252,2022/4/15 17:00:00,37,77,-40
27181,27181,252,2022/4/15 17:10:00,43,93,-50
27182,27182,252,2022/4/15 17:20:00,30,96,-66
27183,27183,252,2022/4/15 17:30:00,33,114,-81
27184,27184,252,2022/4/15 17:40:00,42,113,-71
27185,27185,252,2022/4/15 17:50:00,43,113,-70
27186,27186,252,2022/4/15 18:00:00,47,105,-58
27187,27187,252,2022/4/15 18:10:00,36,108,-72
27188,27188,252,2022/4/15 18:20:00,33,110,-77
27189,27189,252,2022/4/15 18:30:00,29,133,-104
27190,27190,252,2022/4/15 18:40:00,26,122,-96
27191,27191,252,2022/4/15 18:50:00,25,122,-97
27192,27192,252,2022/4/15 19:00:00,22,127,-105
27193,27193,252,2022/4/15 19:10:00,20,106,-86
27194,27194,252,2022/4/15 19:20:00,20,107,-87
27195,27195,252,2022/4/15 19:30:00,13,102,-89
27196,27196,252,2022/4/15 19:40:00,13,83,-70
27197,27197,252,2022/4/15 19:50:00,13,81,-68
27198,27198,252,2022/4/15 20:00:00,14,80,-66
27199,27199,252,2022/4/15 20:10:00,12,79,-67
27200,27200,252,2022/4/15 20:20:00,12,81,-69
27201,27201,252,2022/4/15 20:30:00,13,69,-56
27202,27202,252,2022/4/15 20:40:00,16,64,-48
27203,27203,252,2022/4/15 20:50:00,13,71,-58
27204,27204,252,2022/4/15 21:00:00,12,75,-63
27205,27205,252,2022/4/15 21:10:00,12,71,-59
27206,27206,252,2022/4/15 21:20:00,9,76,-67
27207,27207,252,2022/4/15 21:30:00,10,58,-48
27208,27208,252,2022/4/15 21:40:00,6,73,-67
27209,27209,252,2022/4/15 21:50:00,7,74,-67
27210,27210,252,2022/4/15 22:00:00,5,68,-63
27211,27211,252,2022/4/15 22:10:00,4,62,-58
27212,27212,252,2022/4/15 22:20:00,2,68,-66
27213,27213,252,2022/4/15 22:30:00,2,63,-61
27214,27214,252,2022/4/15 22:40:00,0,64,-64
27215,27215,252,2022/4/15 22:50:00,0,59,-59
27216,27216,253,2022/4/15 5:00:00,0,1,-1
27217,27217,253,2022/4/15 5:10:00,5,1,4
27218,27218,253,2022/4/15 5:20:00,23,1,22
27219,27219,253,2022/4/15 5:30:00,18,1,17
27220,27220,253,2022/4/15 5:40:00,25,8,17
27221,27221,253,2022/4/15 5:50:00,31,5,26
27222,27222,253,2022/4/15 6:00:00,32,2,30
27223,27223,253,2022/4/15 6:10:00,71,19,52
27224,27224,253,2022/4/15 6:20:00,85,16,69
27225,27225,253,2022/4/15 6:30:00,180,47,133
27226,27226,253,2022/4/15 6:40:00,244,38,206
27227,27227,253,2022/4/15 6:50:00,277,63,214
27228,27228,253,2022/4/15 7:00:00,276,76,200
27229,27229,253,2022/4/15 7:10:00,340,103,237
27230,27230,253,2022/4/15 7:20:00,595,100,495
27231,27231,253,2022/4/15 7:30:00,668,146,522
27232,27232,253,2022/4/15 7:40:00,836,150,686
27233,27233,253,2022/4/15 7:50:00,1054,146,908
27234,27234,253,2022/4/15 8:00:00,872,126,746
27235,27235,253,2022/4/15 8:10:00,820,89,731
27236,27236,253,2022/4/15 8:20:00,686,118,568
27237,27237,253,2022/4/15 8:30:00,600,124,476
27238,27238,253,2022/4/15 8:40:00,351,108,243
27239,27239,253,2022/4/15 8:50:00,283,105,178
27240,27240,253,2022/4/15 9:00:00,236,109,127
27241,27241,253,2022/4/15 9:10:00,224,93,131
27242,27242,253,2022/4/15 9:20:00,145,93,52
27243,27243,253,2022/4/15 9:30:00,115,106,9
27244,27244,253,2022/4/15 9:40:00,76,99,-23
27245,27245,253,2022/4/15 9:50:00,68,97,-29
27246,27246,253,2022/4/15 10:00:00,61,76,-15
27247,27247,253,2022/4/15 10:10:00,41,91,-50
27248,27248,253,2022/4/15 10:20:00,43,90,-47
27249,27249,253,2022/4/15 10:30:00,35,84,-49
27250,27250,253,2022/4/15 10:40:00,40,77,-37
27251,27251,253,2022/4/15 10:50:00,32,67,-35
27252,27252,253,2022/4/15 11:00:00,36,93,-57
27253,27253,253,2022/4/15 11:10:00,41,79,-38
27254,27254,253,2022/4/15 11:20:00,39,84,-45
27255,27255,253,2022/4/15 11:30:00,41,101,-60
27256,27256,253,2022/4/15 11:40:00,57,97,-40
27257,27257,253,2022/4/15 11:50:00,53,87,-34
27258,27258,253,2022/4/15 12:00:00,60,101,-41
27259,27259,253,2022/4/15 12:10:00,56,83,-27
27260,27260,253,2022/4/15 12:20:00,58,88,-30
27261,27261,253,2022/4/15 12:30:00,61,99,-38
27262,27262,253,2022/4/15 12:40:00,64,93,-29
27263,27263,253,2022/4/15 12:50:00,47,104,-57
27264,27264,253,2022/4/15 13:00:00,52,90,-38
27265,27265,253,2022/4/15 13:10:00,52,64,-12
27266,27266,253,2022/4/15 13:20:00,47,97,-50
27267,27267,253,2022/4/15 13:30:00,42,96,-54
27268,27268,253,2022/4/15 13:40:00,42,91,-49
27269,27269,253,2022/4/15 13:50:00,38,98,-60
27270,27270,253,2022/4/15 14:00:00,51,70,-19
27271,27271,253,2022/4/15 14:10:00,42,93,-51
27272,27272,253,2022/4/15 14:20:00,44,100,-56
27273,27273,253,2022/4/15 14:30:00,32,100,-68
27274,27274,253,2022/4/15 14:40:00,62,105,-43
27275,27275,253,2022/4/15 14:50:00,53,94,-41
27276,27276,253,2022/4/15 15:00:00,46,87,-41
27277,27277,253,2022/4/15 15:10:00,47,110,-63
27278,27278,253,2022/4/15 15:20:00,39,106,-67
27279,27279,253,2022/4/15 15:30:00,52,103,-51
27280,27280,253,2022/4/15 15:40:00,43,110,-67
27281,27281,253,2022/4/15 15:50:00,45,96,-51
27282,27282,253,2022/4/15 16:00:00,57,126,-69
27283,27283,253,2022/4/15 16:10:00,63,124,-61
27284,27284,253,2022/4/15 16:20:00,52,105,-53
27285,27285,253,2022/4/15 16:30:00,70,108,-38
27286,27286,253,2022/4/15 16:40:00,66,128,-62
27287,27287,253,2022/4/15 16:50:00,138,106,32
27288,27288,253,2022/4/15 17:00:00,94,120,-26
27289,27289,253,2022/4/15 17:10:00,137,109,28
27290,27290,253,2022/4/15 17:20:00,156,183,-27
27291,27291,253,2022/4/15 17:30:00,82,212,-130
27292,27292,253,2022/4/15 17:40:00,84,211,-127
27293,27293,253,2022/4/15 17:50:00,79,378,-299
27294,27294,253,2022/4/15 18:00:00,137,326,-189
27295,27295,253,2022/4/15 18:10:00,64,334,-270
27296,27296,253,2022/4/15 18:20:00,45,326,-281
27297,27297,253,2022/4/15 18:30:00,41,434,-393
27298,27298,253,2022/4/15 18:40:00,39,434,-395
27299,27299,253,2022/4/15 18:50:00,41,432,-391
27300,27300,253,2022/4/15 19:00:00,31,507,-476
27301,27301,253,2022/4/15 19:10:00,31,300,-269
27302,27302,253,2022/4/15 19:20:00,25,333,-308
27303,27303,253,2022/4/15 19:30:00,30,321,-291
27304,27304,253,2022/4/15 19:40:00,25,232,-207
27305,27305,253,2022/4/15 19:50:00,25,150,-125
27306,27306,253,2022/4/15 20:00:00,28,151,-123
27307,27307,253,2022/4/15 20:10:00,28,119,-91
27308,27308,253,2022/4/15 20:20:00,25,144,-119
27309,27309,253,2022/4/15 20:30:00,26,119,-93
27310,27310,253,2022/4/15 20:40:00,33,107,-74
27311,27311,253,2022/4/15 20:50:00,28,103,-75
27312,27312,253,2022/4/15 21:00:00,26,128,-102
27313,27313,253,2022/4/15 21:10:00,27,101,-74
27314,27314,253,2022/4/15 21:20:00,27,115,-88
27315,27315,253,2022/4/15 21:30:00,25,111,-86
27316,27316,253,2022/4/15 21:40:00,26,108,-82
27317,27317,253,2022/4/15 21:50:00,22,121,-99
27318,27318,253,2022/4/15 22:00:00,16,118,-102
27319,27319,253,2022/4/15 22:10:00,14,122,-108
27320,27320,253,2022/4/15 22:20:00,10,106,-96
27321,27321,253,2022/4/15 22:30:00,6,101,-95
27322,27322,253,2022/4/15 22:40:00,2,107,-105
27323,27323,253,2022/4/15 22:50:00,2,108,-106
27324,27324,254,2022/4/15 5:00:00,0,1,-1
27325,27325,254,2022/4/15 5:10:00,0,1,-1
27326,27326,254,2022/4/15 5:20:00,0,1,-1
27327,27327,254,2022/4/15 5:30:00,18,1,17
27328,27328,254,2022/4/15 5:40:00,27,2,25
27329,27329,254,2022/4/15 5:50:00,30,1,29
27330,27330,254,2022/4/15 6:00:00,44,22,22
27331,27331,254,2022/4/15 6:10:00,57,45,12
27332,27332,254,2022/4/15 6:20:00,76,45,31
27333,27333,254,2022/4/15 6:30:00,182,50,132
27334,27334,254,2022/4/15 6:40:00,237,59,178
27335,27335,254,2022/4/15 6:50:00,350,73,277
27336,27336,254,2022/4/15 7:00:00,327,86,241
27337,27337,254,2022/4/15 7:10:00,593,76,517
27338,27338,254,2022/4/15 7:20:00,666,110,556
27339,27339,254,2022/4/15 7:30:00,667,126,541
27340,27340,254,2022/4/15 7:40:00,735,109,626
27341,27341,254,2022/4/15 7:50:00,1175,104,1071
27342,27342,254,2022/4/15 8:00:00,1180,120,1060
27343,27343,254,2022/4/15 8:10:00,1059,121,938
27344,27344,254,2022/4/15 8:20:00,826,111,715
27345,27345,254,2022/4/15 8:30:00,731,153,578
27346,27346,254,2022/4/15 8:40:00,688,180,508
27347,27347,254,2022/4/15 8:50:00,477,160,317
27348,27348,254,2022/4/15 9:00:00,337,109,228
27349,27349,254,2022/4/15 9:10:00,295,125,170
27350,27350,254,2022/4/15 9:20:00,268,117,151
27351,27351,254,2022/4/15 9:30:00,227,116,111
27352,27352,254,2022/4/15 9:40:00,180,109,71
27353,27353,254,2022/4/15 9:50:00,138,107,31
27354,27354,254,2022/4/15 10:00:00,95,108,-13
27355,27355,254,2022/4/15 10:10:00,73,105,-32
27356,27356,254,2022/4/15 10:20:00,73,90,-17
27357,27357,254,2022/4/15 10:30:00,59,74,-15
27358,27358,254,2022/4/15 10:40:00,46,101,-55
27359,27359,254,2022/4/15 10:50:00,45,99,-54
27360,27360,254,2022/4/15 11:00:00,48,99,-51
27361,27361,254,2022/4/15 11:10:00,46,91,-45
27362,27362,254,2022/4/15 11:20:00,44,76,-32
27363,27363,254,2022/4/15 11:30:00,47,101,-54
27364,27364,254,2022/4/15 11:40:00,48,99,-51
27365,27365,254,2022/4/15 11:50:00,45,103,-58
27366,27366,254,2022/4/15 12:00:00,46,101,-55
27367,27367,254,2022/4/15 12:10:00,53,81,-28
27368,27368,254,2022/4/15 12:20:00,57,102,-45
27369,27369,254,2022/4/15 12:30:00,48,104,-56
27370,27370,254,2022/4/15 12:40:00,47,100,-53
27371,27371,254,2022/4/15 12:50:00,45,105,-60
27372,27372,254,2022/4/15 13:00:00,49,105,-56
27373,27373,254,2022/4/15 13:10:00,57,88,-31
27374,27374,254,2022/4/15 13:20:00,46,106,-60
27375,27375,254,2022/4/15 13:30:00,48,104,-56
27376,27376,254,2022/4/15 13:40:00,45,105,-60
27377,27377,254,2022/4/15 13:50:00,46,109,-63
27378,27378,254,2022/4/15 14:00:00,40,97,-57
27379,27379,254,2022/4/15 14:10:00,49,102,-53
27380,27380,254,2022/4/15 14:20:00,47,107,-60
27381,27381,254,2022/4/15 14:30:00,41,103,-62
27382,27382,254,2022/4/15 14:40:00,38,86,-48
27383,27383,254,2022/4/15 14:50:00,38,111,-73
27384,27384,254,2022/4/15 15:00:00,40,105,-65
27385,27385,254,2022/4/15 15:10:00,45,105,-60
27386,27386,254,2022/4/15 15:20:00,45,122,-77
27387,27387,254,2022/4/15 15:30:00,46,125,-79
27388,27388,254,2022/4/15 15:40:00,44,109,-65
27389,27389,254,2022/4/15 15:50:00,41,120,-79
27390,27390,254,2022/4/15 16:00:00,44,114,-70
27391,27391,254,2022/4/15 16:10:00,54,107,-53
27392,27392,254,2022/4/15 16:20:00,54,120,-66
27393,27393,254,2022/4/15 16:30:00,65,133,-68
27394,27394,254,2022/4/15 16:40:00,69,171,-102
27395,27395,254,2022/4/15 16:50:00,73,159,-86
27396,27396,254,2022/4/15 17:00:00,137,106,31
27397,27397,254,2022/4/15 17:10:00,175,210,-35
27398,27398,254,2022/4/15 17:20:00,170,317,-147
27399,27399,254,2022/4/15 17:30:00,115,437,-322
27400,27400,254,2022/4/15 17:40:00,174,383,-209
27401,27401,254,2022/4/15 17:50:00,134,531,-397
27402,27402,254,2022/4/15 18:00:00,115,432,-317
27403,27403,254,2022/4/15 18:10:00,179,432,-253
27404,27404,254,2022/4/15 18:20:00,87,478,-391
27405,27405,254,2022/4/15 18:30:00,65,432,-367
27406,27406,254,2022/4/15 18:40:00,69,427,-358
27407,27407,254,2022/4/15 18:50:00,60,335,-275
27408,27408,254,2022/4/15 19:00:00,48,387,-339
27409,27409,254,2022/4/15 19:10:00,39,326,-287
27410,27410,254,2022/4/15 19:20:00,41,335,-294
27411,27411,254,2022/4/15 19:30:00,34,255,-221
27412,27412,254,2022/4/15 19:40:00,32,169,-137
27413,27413,254,2022/4/15 19:50:00,35,180,-145
27414,27414,254,2022/4/15 20:00:00,30,106,-76
27415,27415,254,2022/4/15 20:10:00,28,128,-100
27416,27416,254,2022/4/15 20:20:00,30,129,-99
27417,27417,254,2022/4/15 20:30:00,37,132,-95
27418,27418,254,2022/4/15 20:40:00,27,109,-82
27419,27419,254,2022/4/15 20:50:00,33,124,-91
27420,27420,254,2022/4/15 21:00:00,29,124,-95
27421,27421,254,2022/4/15 21:10:00,31,107,-76
27422,27422,254,2022/4/15 21:20:00,29,112,-83
27423,27423,254,2022/4/15 21:30:00,29,110,-81
27424,27424,254,2022/4/15 21:40:00,28,111,-83
27425,27425,254,2022/4/15 21:50:00,25,104,-79
27426,27426,254,2022/4/15 22:00:00,22,104,-82
27427,27427,254,2022/4/15 22:10:00,21,122,-101
27428,27428,254,2022/4/15 22:20:00,20,102,-82
27429,27429,254,2022/4/15 22:30:00,12,107,-95
27430,27430,254,2022/4/15 22:40:00,7,109,-102
27431,27431,254,2022/4/15 22:50:00,2,78,-76
27432,27432,255,2022/4/15 5:00:00,0,1,-1
27433,27433,255,2022/4/15 5:10:00,1,1,0
27434,27434,255,2022/4/15 5:20:00,10,1,9
27435,27435,255,2022/4/15 5:30:00,24,1,23
27436,27436,255,2022/4/15 5:40:00,25,1,24
27437,27437,255,2022/4/15 5:50:00,25,1,24
27438,27438,255,2022/4/15 6:00:00,40,8,32
27439,27439,255,2022/4/15 6:10:00,55,19,36
27440,27440,255,2022/4/15 6:20:00,71,67,4
27441,27441,255,2022/4/15 6:30:00,155,65,90
27442,27442,255,2022/4/15 6:40:00,225,108,117
27443,27443,255,2022/4/15 6:50:00,281,126,155
27444,27444,255,2022/4/15 7:00:00,361,118,243
27445,27445,255,2022/4/15 7:10:00,598,127,471
27446,27446,255,2022/4/15 7:20:00,724,104,620
27447,27447,255,2022/4/15 7:30:00,825,108,717
27448,27448,255,2022/4/15 7:40:00,1229,106,1123
27449,27449,255,2022/4/15 7:50:00,1558,120,1438
27450,27450,255,2022/4/15 8:00:00,1561,113,1448
27451,27451,255,2022/4/15 8:10:00,1366,119,1247
27452,27452,255,2022/4/15 8:20:00,1179,133,1046
27453,27453,255,2022/4/15 8:30:00,859,128,731
27454,27454,255,2022/4/15 8:40:00,684,109,575
27455,27455,255,2022/4/15 8:50:00,476,126,350
27456,27456,255,2022/4/15 9:00:00,354,103,251
27457,27457,255,2022/4/15 9:10:00,278,106,172
27458,27458,255,2022/4/15 9:20:00,232,111,121
27459,27459,255,2022/4/15 9:30:00,183,75,108
27460,27460,255,2022/4/15 9:40:00,144,98,46
27461,27461,255,2022/4/15 9:50:00,97,83,14
27462,27462,255,2022/4/15 10:00:00,64,75,-11
27463,27463,255,2022/4/15 10:10:00,63,84,-21
27464,27464,255,2022/4/15 10:20:00,42,69,-27
27465,27465,255,2022/4/15 10:30:00,44,82,-38
27466,27466,255,2022/4/15 10:40:00,37,66,-29
27467,27467,255,2022/4/15 10:50:00,41,85,-44
27468,27468,255,2022/4/15 11:00:00,38,77,-39
27469,27469,255,2022/4/15 11:10:00,37,84,-47
27470,27470,255,2022/4/15 11:20:00,37,78,-41
27471,27471,255,2022/4/15 11:30:00,42,69,-27
27472,27472,255,2022/4/15 11:40:00,43,81,-38
27473,27473,255,2022/4/15 11:50:00,40,76,-36
27474,27474,255,2022/4/15 12:00:00,44,83,-39
27475,27475,255,2022/4/15 12:10:00,45,78,-33
27476,27476,255,2022/4/15 12:20:00,44,64,-20
27477,27477,255,2022/4/15 12:30:00,48,80,-32
27478,27478,255,2022/4/15 12:40:00,44,84,-40
27479,27479,255,2022/4/15 12:50:00,40,80,-40
27480,27480,255,2022/4/15 13:00:00,44,76,-32
27481,27481,255,2022/4/15 13:10:00,42,75,-33
27482,27482,255,2022/4/15 13:20:00,41,69,-28
27483,27483,255,2022/4/15 13:30:00,43,77,-34
27484,27484,255,2022/4/15 13:40:00,40,83,-43
27485,27485,255,2022/4/15 13:50:00,36,99,-63
27486,27486,255,2022/4/15 14:00:00,39,90,-51
27487,27487,255,2022/4/15 14:10:00,26,77,-51
27488,27488,255,2022/4/15 14:20:00,36,96,-60
27489,27489,255,2022/4/15 14:30:00,30,101,-71
27490,27490,255,2022/4/15 14:40:00,33,96,-63
27491,27491,255,2022/4/15 14:50:00,39,108,-69
27492,27492,255,2022/4/15 15:00:00,33,84,-51
27493,27493,255,2022/4/15 15:10:00,35,93,-58
27494,27494,255,2022/4/15 15:20:00,40,103,-63
27495,27495,255,2022/4/15 15:30:00,35,109,-74
27496,27496,255,2022/4/15 15:40:00,35,105,-70
27497,27497,255,2022/4/15 15:50:00,38,104,-66
27498,27498,255,2022/4/15 16:00:00,42,125,-83
27499,27499,255,2022/4/15 16:10:00,41,109,-68
27500,27500,255,2022/4/15 16:20:00,45,121,-76
27501,27501,255,2022/4/15 16:30:00,71,106,-35
27502,27502,255,2022/4/15 16:40:00,61,111,-50
27503,27503,255,2022/4/15 16:50:00,70,152,-82
27504,27504,255,2022/4/15 17:00:00,138,142,-4
27505,27505,255,2022/4/15 17:10:00,190,109,81
27506,27506,255,2022/4/15 17:20:00,233,264,-31
27507,27507,255,2022/4/15 17:30:00,175,333,-158
27508,27508,255,2022/4/15 17:40:00,233,330,-97
27509,27509,255,2022/4/15 17:50:00,241,345,-104
27510,27510,255,2022/4/15 18:00:00,126,328,-202
27511,27511,255,2022/4/15 18:10:00,188,502,-314
27512,27512,255,2022/4/15 18:20:00,175,425,-250
27513,27513,255,2022/4/15 18:30:00,92,432,-340
27514,27514,255,2022/4/15 18:40:00,57,432,-375
27515,27515,255,2022/4/15 18:50:00,50,430,-380
27516,27516,255,2022/4/15 19:00:00,36,327,-291
27517,27517,255,2022/4/15 19:10:00,35,322,-287
27518,27518,255,2022/4/15 19:20:00,30,300,-270
27519,27519,255,2022/4/15 19:30:00,28,336,-308
27520,27520,255,2022/4/15 19:40:00,28,158,-130
27521,27521,255,2022/4/15 19:50:00,30,110,-80
27522,27522,255,2022/4/15 20:00:00,27,106,-79
27523,27523,255,2022/4/15 20:10:00,28,104,-76
27524,27524,255,2022/4/15 20:20:00,27,121,-94
27525,27525,255,2022/4/15 20:30:00,30,110,-80
27526,27526,255,2022/4/15 20:40:00,26,111,-85
27527,27527,255,2022/4/15 20:50:00,28,124,-96
27528,27528,255,2022/4/15 21:00:00,27,107,-80
27529,27529,255,2022/4/15 21:10:00,26,120,-94
27530,27530,255,2022/4/15 21:20:00,27,113,-86
27531,27531,255,2022/4/15 21:30:00,27,111,-84
27532,27532,255,2022/4/15 21:40:00,21,123,-102
27533,27533,255,2022/4/15 21:50:00,19,125,-106
27534,27534,255,2022/4/15 22:00:00,18,124,-106
27535,27535,255,2022/4/15 22:10:00,16,107,-91
27536,27536,255,2022/4/15 22:20:00,13,112,-99
27537,27537,255,2022/4/15 22:30:00,10,104,-94
27538,27538,255,2022/4/15 22:40:00,4,108,-104
27539,27539,255,2022/4/15 22:50:00,2,80,-78
27540,27540,256,2022/4/15 5:00:00,0,1,-1
27541,27541,256,2022/4/15 5:10:00,0,1,-1
27542,27542,256,2022/4/15 5:20:00,8,1,7
27543,27543,256,2022/4/15 5:30:00,18,1,17
27544,27544,256,2022/4/15 5:40:00,19,1,18
27545,27545,256,2022/4/15 5:50:00,23,1,22
27546,27546,256,2022/4/15 6:00:00,31,1,30
27547,27547,256,2022/4/15 6:10:00,43,5,38
27548,27548,256,2022/4/15 6:20:00,59,45,14
27549,27549,256,2022/4/15 6:30:00,74,45,29
27550,27550,256,2022/4/15 6:40:00,146,74,72
27551,27551,256,2022/4/15 6:50:00,205,93,112
27552,27552,256,2022/4/15 7:00:00,249,121,128
27553,27553,256,2022/4/15 7:10:00,352,112,240
27554,27554,256,2022/4/15 7:20:00,593,91,502
27555,27555,256,2022/4/15 7:30:00,693,93,600
27556,27556,256,2022/4/15 7:40:00,1060,105,955
27557,27557,256,2022/4/15 7:50:00,1061,113,948
27558,27558,256,2022/4/15 8:00:00,1210,122,1088
27559,27559,256,2022/4/15 8:10:00,1385,119,1266
27560,27560,256,2022/4/15 8:20:00,1215,101,1114
27561,27561,256,2022/4/15 8:30:00,858,109,749
27562,27562,256,2022/4/15 8:40:00,689,119,570
27563,27563,256,2022/4/15 8:50:00,630,104,526
27564,27564,256,2022/4/15 9:00:00,384,115,269
27565,27565,256,2022/4/15 9:10:00,298,111,187
27566,27566,256,2022/4/15 9:20:00,238,92,146
27567,27567,256,2022/4/15 9:30:00,178,72,106
27568,27568,256,2022/4/15 9:40:00,93,75,18
27569,27569,256,2022/4/15 9:50:00,61,83,-22
27570,27570,256,2022/4/15 10:00:00,47,85,-38
27571,27571,256,2022/4/15 10:10:00,46,47,-1
27572,27572,256,2022/4/15 10:20:00,41,71,-30
27573,27573,256,2022/4/15 10:30:00,38,66,-28
27574,27574,256,2022/4/15 10:40:00,36,69,-33
27575,27575,256,2022/4/15 10:50:00,34,73,-39
27576,27576,256,2022/4/15 11:00:00,34,67,-33
27577,27577,256,2022/4/15 11:10:00,28,51,-23
27578,27578,256,2022/4/15 11:20:00,30,69,-39
27579,27579,256,2022/4/15 11:30:00,28,65,-37
27580,27580,256,2022/4/15 11:40:00,32,75,-43
27581,27581,256,2022/4/15 11:50:00,33,70,-37
27582,27582,256,2022/4/15 12:00:00,38,63,-25
27583,27583,256,2022/4/15 12:10:00,37,70,-33
27584,27584,256,2022/4/15 12:20:00,35,72,-37
27585,27585,256,2022/4/15 12:30:00,39,77,-38
27586,27586,256,2022/4/15 12:40:00,39,75,-36
27587,27587,256,2022/4/15 12:50:00,36,75,-39
27588,27588,256,2022/4/15 13:00:00,37,75,-38
27589,27589,256,2022/4/15 13:10:00,33,63,-30
27590,27590,256,2022/4/15 13:20:00,29,76,-47
27591,27591,256,2022/4/15 13:30:00,31,84,-53
27592,27592,256,2022/4/15 13:40:00,28,78,-50
27593,27593,256,2022/4/15 13:50:00,23,62,-39
27594,27594,256,2022/4/15 14:00:00,30,69,-39
27595,27595,256,2022/4/15 14:10:00,32,78,-46
27596,27596,256,2022/4/15 14:20:00,31,76,-45
27597,27597,256,2022/4/15 14:30:00,28,77,-49
27598,27598,256,2022/4/15 14:40:00,27,76,-49
27599,27599,256,2022/4/15 14:50:00,36,77,-41
27600,27600,256,2022/4/15 15:00:00,29,85,-56
27601,27601,256,2022/4/15 15:10:00,19,98,-79
27602,27602,256,2022/4/15 15:20:00,38,91,-53
27603,27603,256,2022/4/15 15:30:00,39,99,-60
27604,27604,256,2022/4/15 15:40:00,30,106,-76
27605,27605,256,2022/4/15 15:50:00,29,80,-51
27606,27606,256,2022/4/15 16:00:00,33,111,-78
27607,27607,256,2022/4/15 16:10:00,35,105,-70
27608,27608,256,2022/4/15 16:20:00,36,101,-65
27609,27609,256,2022/4/15 16:30:00,47,101,-54
27610,27610,256,2022/4/15 16:40:00,103,119,-16
27611,27611,256,2022/4/15 16:50:00,170,121,49
27612,27612,256,2022/4/15 17:00:00,99,127,-28
27613,27613,256,2022/4/15 17:10:00,131,118,13
27614,27614,256,2022/4/15 17:20:00,83,138,-55
27615,27615,256,2022/4/15 17:30:00,81,283,-202
27616,27616,256,2022/4/15 17:40:00,174,322,-148
27617,27617,256,2022/4/15 17:50:00,73,268,-195
27618,27618,256,2022/4/15 18:00:00,65,317,-252
27619,27619,256,2022/4/15 18:10:00,62,501,-439
27620,27620,256,2022/4/15 18:20:00,64,504,-440
27621,27621,256,2022/4/15 18:30:00,47,496,-449
27622,27622,256,2022/4/15 18:40:00,41,431,-390
27623,27623,256,2022/4/15 18:50:00,37,421,-384
27624,27624,256,2022/4/15 19:00:00,30,380,-350
27625,27625,256,2022/4/15 19:10:00,33,512,-479
27626,27626,256,2022/4/15 19:20:00,26,217,-191
27627,27627,256,2022/4/15 19:30:00,26,183,-157
27628,27628,256,2022/4/15 19:40:00,28,157,-129
27629,27629,256,2022/4/15 19:50:00,27,191,-164
27630,27630,256,2022/4/15 20:00:00,25,139,-114
27631,27631,256,2022/4/15 20:10:00,28,114,-86
27632,27632,256,2022/4/15 20:20:00,27,111,-84
27633,27633,256,2022/4/15 20:30:00,26,100,-74
27634,27634,256,2022/4/15 20:40:00,24,182,-158
27635,27635,256,2022/4/15 20:50:00,22,109,-87
27636,27636,256,2022/4/15 21:00:00,25,109,-84
27637,27637,256,2022/4/15 21:10:00,22,110,-88
27638,27638,256,2022/4/15 21:20:00,22,114,-92
27639,27639,256,2022/4/15 21:30:00,20,111,-91
27640,27640,256,2022/4/15 21:40:00,18,128,-110
27641,27641,256,2022/4/15 21:50:00,14,124,-110
27642,27642,256,2022/4/15 22:00:00,13,105,-92
27643,27643,256,2022/4/15 22:10:00,12,111,-99
27644,27644,256,2022/4/15 22:20:00,9,95,-86
27645,27645,256,2022/4/15 22:30:00,6,112,-106
27646,27646,256,2022/4/15 22:40:00,1,106,-105
27647,27647,256,2022/4/15 22:50:00,1,72,-71
27648,27648,257,2022/4/15 5:00:00,0,1,-1
27649,27649,257,2022/4/15 5:10:00,0,1,-1
27650,27650,257,2022/4/15 5:20:00,1,1,0
27651,27651,257,2022/4/15 5:30:00,7,1,6
27652,27652,257,2022/4/15 5:40:00,10,1,9
27653,27653,257,2022/4/15 5:50:00,15,6,9
27654,27654,257,2022/4/15 6:00:00,20,2,18
27655,27655,257,2022/4/15 6:10:00,35,13,22
27656,27656,257,2022/4/15 6:20:00,42,23,19
27657,27657,257,2022/4/15 6:30:00,58,31,27
27658,27658,257,2022/4/15 6:40:00,79,29,50
27659,27659,257,2022/4/15 6:50:00,84,42,42
27660,27660,257,2022/4/15 7:00:00,89,51,38
27661,27661,257,2022/4/15 7:10:00,155,64,91
27662,27662,257,2022/4/15 7:20:00,200,74,126
27663,27663,257,2022/4/15 7:30:00,246,86,160
27664,27664,257,2022/4/15 7:40:00,351,87,264
27665,27665,257,2022/4/15 7:50:00,326,77,249
27666,27666,257,2022/4/15 8:00:00,325,90,235
27667,27667,257,2022/4/15 8:10:00,395,98,297
27668,27668,257,2022/4/15 8:20:00,326,113,213
27669,27669,257,2022/4/15 8:30:00,346,117,229
27670,27670,257,2022/4/15 8:40:00,277,119,158
27671,27671,257,2022/4/15 8:50:00,253,123,130
27672,27672,257,2022/4/15 9:00:00,199,96,103
27673,27673,257,2022/4/15 9:10:00,178,90,88
27674,27674,257,2022/4/15 9:20:00,116,77,39
27675,27675,257,2022/4/15 9:30:00,64,74,-10
27676,27676,257,2022/4/15 9:40:00,48,75,-27
27677,27677,257,2022/4/15 9:50:00,43,76,-33
27678,27678,257,2022/4/15 10:00:00,38,61,-23
27679,27679,257,2022/4/15 10:10:00,39,68,-29
27680,27680,257,2022/4/15 10:20:00,31,63,-32
27681,27681,257,2022/4/15 10:30:00,32,69,-37
27682,27682,257,2022/4/15 10:40:00,32,65,-33
27683,27683,257,2022/4/15 10:50:00,28,65,-37
27684,27684,257,2022/4/15 11:00:00,33,57,-24
27685,27685,257,2022/4/15 11:10:00,29,49,-20
27686,27686,257,2022/4/15 11:20:00,27,65,-38
27687,27687,257,2022/4/15 11:30:00,27,52,-25
27688,27688,257,2022/4/15 11:40:00,27,67,-40
27689,27689,257,2022/4/15 11:50:00,28,62,-34
27690,27690,257,2022/4/15 12:00:00,30,45,-15
27691,27691,257,2022/4/15 12:10:00,25,69,-44
27692,27692,257,2022/4/15 12:20:00,32,62,-30
27693,27693,257,2022/4/15 12:30:00,27,73,-46
27694,27694,257,2022/4/15 12:40:00,30,68,-38
27695,27695,257,2022/4/15 12:50:00,29,61,-32
27696,27696,257,2022/4/15 13:00:00,29,61,-32
27697,27697,257,2022/4/15 13:10:00,30,66,-36
27698,27698,257,2022/4/15 13:20:00,29,85,-56
27699,27699,257,2022/4/15 13:30:00,33,72,-39
27700,27700,257,2022/4/15 13:40:00,31,85,-54
27701,27701,257,2022/4/15 13:50:00,24,64,-40
27702,27702,257,2022/4/15 14:00:00,32,65,-33
27703,27703,257,2022/4/15 14:10:00,32,76,-44
27704,27704,257,2022/4/15 14:20:00,31,77,-46
27705,27705,257,2022/4/15 14:30:00,29,71,-42
27706,27706,257,2022/4/15 14:40:00,34,68,-34
27707,27707,257,2022/4/15 14:50:00,28,69,-41
27708,27708,257,2022/4/15 15:00:00,30,81,-51
27709,27709,257,2022/4/15 15:10:00,35,74,-39
27710,27710,257,2022/4/15 15:20:00,23,77,-54
27711,27711,257,2022/4/15 15:30:00,30,80,-50
27712,27712,257,2022/4/15 15:40:00,27,75,-48
27713,27713,257,2022/4/15 15:50:00,29,74,-45
27714,27714,257,2022/4/15 16:00:00,29,93,-64
27715,27715,257,2022/4/15 16:10:00,39,90,-51
27716,27716,257,2022/4/15 16:20:00,42,88,-46
27717,27717,257,2022/4/15 16:30:00,56,94,-38
27718,27718,257,2022/4/15 16:40:00,47,99,-52
27719,27719,257,2022/4/15 16:50:00,38,114,-76
27720,27720,257,2022/4/15 17:00:00,49,108,-59
27721,27721,257,2022/4/15 17:10:00,49,107,-58
27722,27722,257,2022/4/15 17:20:00,40,106,-66
27723,27723,257,2022/4/15 17:30:00,87,144,-57
27724,27724,257,2022/4/15 17:40:00,83,127,-44
27725,27725,257,2022/4/15 17:50:00,45,151,-106
27726,27726,257,2022/4/15 18:00:00,35,182,-147
27727,27727,257,2022/4/15 18:10:00,33,184,-151
27728,27728,257,2022/4/15 18:20:00,32,198,-166
27729,27729,257,2022/4/15 18:30:00,29,184,-155
27730,27730,257,2022/4/15 18:40:00,28,191,-163
27731,27731,257,2022/4/15 18:50:00,26,155,-129
27732,27732,257,2022/4/15 19:00:00,27,107,-80
27733,27733,257,2022/4/15 19:10:00,25,124,-99
27734,27734,257,2022/4/15 19:20:00,22,108,-86
27735,27735,257,2022/4/15 19:30:00,17,110,-93
27736,27736,257,2022/4/15 19:40:00,16,106,-90
27737,27737,257,2022/4/15 19:50:00,17,115,-98
27738,27738,257,2022/4/15 20:00:00,18,91,-73
27739,27739,257,2022/4/15 20:10:00,18,77,-59
27740,27740,257,2022/4/15 20:20:00,19,83,-64
27741,27741,257,2022/4/15 20:30:00,19,86,-67
27742,27742,257,2022/4/15 20:40:00,23,93,-70
27743,27743,257,2022/4/15 20:50:00,16,79,-63
27744,27744,257,2022/4/15 21:00:00,22,92,-70
27745,27745,257,2022/4/15 21:10:00,23,77,-54
27746,27746,257,2022/4/15 21:20:00,16,78,-62
27747,27747,257,2022/4/15 21:30:00,17,99,-82
27748,27748,257,2022/4/15 21:40:00,15,78,-63
27749,27749,257,2022/4/15 21:50:00,12,85,-73
27750,27750,257,2022/4/15 22:00:00,11,83,-72
27751,27751,257,2022/4/15 22:10:00,12,73,-61
27752,27752,257,2022/4/15 22:20:00,8,68,-60
27753,27753,257,2022/4/15 22:30:00,7,65,-58
27754,27754,257,2022/4/15 22:40:00,1,68,-67
27755,27755,257,2022/4/15 22:50:00,0,45,-45
27756,27756,258,2022/4/15 5:00:00,0,1,-1
27757,27757,258,2022/4/15 5:10:00,0,1,-1
27758,27758,258,2022/4/15 5:20:00,1,1,0
27759,27759,258,2022/4/15 5:30:00,10,1,9
27760,27760,258,2022/4/15 5:40:00,24,1,23
27761,27761,258,2022/4/15 5:50:00,22,1,21
27762,27762,258,2022/4/15 6:00:00,32,6,26
27763,27763,258,2022/4/15 6:10:00,40,23,17
27764,27764,258,2022/4/15 6:20:00,55,22,33
27765,27765,258,2022/4/15 6:30:00,86,41,45
27766,27766,258,2022/4/15 6:40:00,174,51,123
27767,27767,258,2022/4/15 6:50:00,227,71,156
27768,27768,258,2022/4/15 7:00:00,233,77,156
27769,27769,258,2022/4/15 7:10:00,281,93,188
27770,27770,258,2022/4/15 7:20:00,352,105,247
27771,27771,258,2022/4/15 7:30:00,477,98,379
27772,27772,258,2022/4/15 7:40:00,691,102,589
27773,27773,258,2022/4/15 7:50:00,693,109,584
27774,27774,258,2022/4/15 8:00:00,733,111,622
27775,27775,258,2022/4/15 8:10:00,869,111,758
27776,27776,258,2022/4/15 8:20:00,827,106,721
27777,27777,258,2022/4/15 8:30:00,695,113,582
27778,27778,258,2022/4/15 8:40:00,631,121,510
27779,27779,258,2022/4/15 8:50:00,478,108,370
27780,27780,258,2022/4/15 9:00:00,330,94,236
27781,27781,258,2022/4/15 9:10:00,273,92,181
27782,27782,258,2022/4/15 9:20:00,228,62,166
27783,27783,258,2022/4/15 9:30:00,178,76,102
27784,27784,258,2022/4/15 9:40:00,137,82,55
27785,27785,258,2022/4/15 9:50:00,69,62,7
27786,27786,258,2022/4/15 10:00:00,45,71,-26
27787,27787,258,2022/4/15 10:10:00,44,72,-28
27788,27788,258,2022/4/15 10:20:00,41,68,-27
27789,27789,258,2022/4/15 10:30:00,39,59,-20
27790,27790,258,2022/4/15 10:40:00,31,68,-37
27791,27791,258,2022/4/15 10:50:00,27,63,-36
27792,27792,258,2022/4/15 11:00:00,30,67,-37
27793,27793,258,2022/4/15 11:10:00,31,65,-34
27794,27794,258,2022/4/15 11:20:00,28,62,-34
27795,27795,258,2022/4/15 11:30:00,37,72,-35
27796,27796,258,2022/4/15 11:40:00,33,61,-28
27797,27797,258,2022/4/15 11:50:00,27,66,-39
27798,27798,258,2022/4/15 12:00:00,31,72,-41
27799,27799,258,2022/4/15 12:10:00,38,65,-27
27800,27800,258,2022/4/15 12:20:00,37,72,-35
27801,27801,258,2022/4/15 12:30:00,39,70,-31
27802,27802,258,2022/4/15 12:40:00,35,74,-39
27803,27803,258,2022/4/15 12:50:00,39,67,-28
27804,27804,258,2022/4/15 13:00:00,28,66,-38
27805,27805,258,2022/4/15 13:10:00,29,69,-40
27806,27806,258,2022/4/15 13:20:00,31,70,-39
27807,27807,258,2022/4/15 13:30:00,36,67,-31
27808,27808,258,2022/4/15 13:40:00,25,71,-46
27809,27809,258,2022/4/15 13:50:00,28,63,-35
27810,27810,258,2022/4/15 14:00:00,32,70,-38
27811,27811,258,2022/4/15 14:10:00,27,73,-46
27812,27812,258,2022/4/15 14:20:00,29,74,-45
27813,27813,258,2022/4/15 14:30:00,28,71,-43
27814,27814,258,2022/4/15 14:40:00,26,85,-59
27815,27815,258,2022/4/15 14:50:00,29,83,-54
27816,27816,258,2022/4/15 15:00:00,30,78,-48
27817,27817,258,2022/4/15 15:10:00,31,76,-45
27818,27818,258,2022/4/15 15:20:00,32,90,-58
27819,27819,258,2022/4/15 15:30:00,33,75,-42
27820,27820,258,2022/4/15 15:40:00,30,103,-73
27821,27821,258,2022/4/15 15:50:00,35,106,-71
27822,27822,258,2022/4/15 16:00:00,38,93,-55
27823,27823,258,2022/4/15 16:10:00,40,105,-65
27824,27824,258,2022/4/15 16:20:00,32,108,-76
27825,27825,258,2022/4/15 16:30:00,45,104,-59
27826,27826,258,2022/4/15 16:40:00,46,124,-78
27827,27827,258,2022/4/15 16:50:00,46,109,-63
27828,27828,258,2022/4/15 17:00:00,66,107,-41
27829,27829,258,2022/4/15 17:10:00,77,108,-31
27830,27830,258,2022/4/15 17:20:00,47,191,-144
27831,27831,258,2022/4/15 17:30:00,45,217,-172
27832,27832,258,2022/4/15 17:40:00,47,326,-279
27833,27833,258,2022/4/15 17:50:00,45,255,-210
27834,27834,258,2022/4/15 18:00:00,47,335,-288
27835,27835,258,2022/4/15 18:10:00,57,325,-268
27836,27836,258,2022/4/15 18:20:00,35,326,-291
27837,27837,258,2022/4/15 18:30:00,30,348,-318
27838,27838,258,2022/4/15 18:40:00,35,347,-312
27839,27839,258,2022/4/15 18:50:00,23,328,-305
27840,27840,258,2022/4/15 19:00:00,30,197,-167
27841,27841,258,2022/4/15 19:10:00,26,219,-193
27842,27842,258,2022/4/15 19:20:00,23,170,-147
27843,27843,258,2022/4/15 19:30:00,25,119,-94
27844,27844,258,2022/4/15 19:40:00,27,103,-76
27845,27845,258,2022/4/15 19:50:00,21,103,-82
27846,27846,258,2022/4/15 20:00:00,22,119,-97
27847,27847,258,2022/4/15 20:10:00,22,106,-84
27848,27848,258,2022/4/15 20:20:00,24,104,-80
27849,27849,258,2022/4/15 20:30:00,22,124,-102
27850,27850,258,2022/4/15 20:40:00,27,109,-82
27851,27851,258,2022/4/15 20:50:00,22,123,-101
27852,27852,258,2022/4/15 21:00:00,21,110,-89
27853,27853,258,2022/4/15 21:10:00,23,117,-94
27854,27854,258,2022/4/15 21:20:00,23,115,-92
27855,27855,258,2022/4/15 21:30:00,17,127,-110
27856,27856,258,2022/4/15 21:40:00,15,103,-88
27857,27857,258,2022/4/15 21:50:00,14,102,-88
27858,27858,258,2022/4/15 22:00:00,13,106,-93
27859,27859,258,2022/4/15 22:10:00,12,94,-82
27860,27860,258,2022/4/15 22:20:00,9,95,-86
27861,27861,258,2022/4/15 22:30:00,7,103,-96
27862,27862,258,2022/4/15 22:40:00,3,82,-79
27863,27863,258,2022/4/15 22:50:00,2,50,-48
27864,27864,259,2022/4/15 5:00:00,0,1,-1
27865,27865,259,2022/4/15 5:10:00,0,1,-1
27866,27866,259,2022/4/15 5:20:00,1,1,0
27867,27867,259,2022/4/15 5:30:00,8,1,7
27868,27868,259,2022/4/15 5:40:00,17,1,16
27869,27869,259,2022/4/15 5:50:00,26,8,18
27870,27870,259,2022/4/15 6:00:00,31,29,2
27871,27871,259,2022/4/15 6:10:00,37,45,-8
27872,27872,259,2022/4/15 6:20:00,45,72,-27
27873,27873,259,2022/4/15 6:30:00,57,75,-18
27874,27874,259,2022/4/15 6:40:00,77,106,-29
27875,27875,259,2022/4/15 6:50:00,99,137,-38
27876,27876,259,2022/4/15 7:00:00,193,195,-2
27877,27877,259,2022/4/15 7:10:00,223,196,27
27878,27878,259,2022/4/15 7:20:00,227,118,109
27879,27879,259,2022/4/15 7:30:00,255,224,31
27880,27880,259,2022/4/15 7:40:00,319,333,-14
27881,27881,259,2022/4/15 7:50:00,327,534,-207
27882,27882,259,2022/4/15 8:00:00,599,615,-16
27883,27883,259,2022/4/15 8:10:00,595,1933,-1338
27884,27884,259,2022/4/15 8:20:00,599,1890,-1291
27885,27885,259,2022/4/15 8:30:00,478,4581,-4103
27886,27886,259,2022/4/15 8:40:00,351,5187,-4836
27887,27887,259,2022/4/15 8:50:00,331,1968,-1637
27888,27888,259,2022/4/15 9:00:00,277,2804,-2527
27889,27889,259,2022/4/15 9:10:00,229,1961,-1732
27890,27890,259,2022/4/15 9:20:00,217,1576,-1359
27891,27891,259,2022/4/15 9:30:00,216,460,-244
27892,27892,259,2022/4/15 9:40:00,200,469,-269
27893,27893,259,2022/4/15 9:50:00,183,399,-216
27894,27894,259,2022/4/15 10:00:00,162,344,-182
27895,27895,259,2022/4/15 10:10:00,154,231,-77
27896,27896,259,2022/4/15 10:20:00,140,268,-128
27897,27897,259,2022/4/15 10:30:00,141,212,-71
27898,27898,259,2022/4/15 10:40:00,136,151,-15
27899,27899,259,2022/4/15 10:50:00,127,177,-50
27900,27900,259,2022/4/15 11:00:00,136,180,-44
27901,27901,259,2022/4/15 11:10:00,113,110,3
27902,27902,259,2022/4/15 11:20:00,147,117,30
27903,27903,259,2022/4/15 11:30:00,135,125,10
27904,27904,259,2022/4/15 11:40:00,162,152,10
27905,27905,259,2022/4/15 11:50:00,161,152,9
27906,27906,259,2022/4/15 12:00:00,177,151,26
27907,27907,259,2022/4/15 12:10:00,173,144,29
27908,27908,259,2022/4/15 12:20:00,174,110,64
27909,27909,259,2022/4/15 12:30:00,179,128,51
27910,27910,259,2022/4/15 12:40:00,175,193,-18
27911,27911,259,2022/4/15 12:50:00,191,185,6
27912,27912,259,2022/4/15 13:00:00,183,180,3
27913,27913,259,2022/4/15 13:10:00,204,117,87
27914,27914,259,2022/4/15 13:20:00,205,127,78
27915,27915,259,2022/4/15 13:30:00,213,180,33
27916,27916,259,2022/4/15 13:40:00,205,180,25
27917,27917,259,2022/4/15 13:50:00,196,159,37
27918,27918,259,2022/4/15 14:00:00,196,151,45
27919,27919,259,2022/4/15 14:10:00,185,110,75
27920,27920,259,2022/4/15 14:20:00,200,171,29
27921,27921,259,2022/4/15 14:30:00,203,183,20
27922,27922,259,2022/4/15 14:40:00,212,170,42
27923,27923,259,2022/4/15 14:50:00,238,139,99
27924,27924,259,2022/4/15 15:00:00,231,121,110
27925,27925,259,2022/4/15 15:10:00,243,110,133
27926,27926,259,2022/4/15 15:20:00,238,112,126
27927,27927,259,2022/4/15 15:30:00,263,146,117
27928,27928,259,2022/4/15 15:40:00,262,159,103
27929,27929,259,2022/4/15 15:50:00,270,139,131
27930,27930,259,2022/4/15 16:00:00,269,145,124
27931,27931,259,2022/4/15 16:10:00,294,121,173
27932,27932,259,2022/4/15 16:20:00,269,181,88
27933,27933,259,2022/4/15 16:30:00,327,146,181
27934,27934,259,2022/4/15 16:40:00,457,214,243
27935,27935,259,2022/4/15 16:50:00,430,197,233
27936,27936,259,2022/4/15 17:00:00,800,195,605
27937,27937,259,2022/4/15 17:10:00,1197,229,968
27938,27938,259,2022/4/15 17:20:00,1025,296,729
27939,27939,259,2022/4/15 17:30:00,1207,315,892
27940,27940,259,2022/4/15 17:40:00,1981,337,1644
27941,27941,259,2022/4/15 17:50:00,1347,527,820
27942,27942,259,2022/4/15 18:00:00,1196,506,690
27943,27943,259,2022/4/15 18:10:00,1974,508,1466
27944,27944,259,2022/4/15 18:20:00,1615,501,1114
27945,27945,259,2022/4/15 18:30:00,1148,421,727
27946,27946,259,2022/4/15 18:40:00,1163,508,655
27947,27947,259,2022/4/15 18:50:00,660,324,336
27948,27948,259,2022/4/15 19:00:00,643,326,317
27949,27949,259,2022/4/15 19:10:00,570,300,270
27950,27950,259,2022/4/15 19:20:00,432,180,252
27951,27951,259,2022/4/15 19:30:00,340,159,181
27952,27952,259,2022/4/15 19:40:00,334,111,223
27953,27953,259,2022/4/15 19:50:00,267,110,157
27954,27954,259,2022/4/15 20:00:00,306,133,173
27955,27955,259,2022/4/15 20:10:00,339,114,225
27956,27956,259,2022/4/15 20:20:00,306,120,186
27957,27957,259,2022/4/15 20:30:00,314,106,208
27958,27958,259,2022/4/15 20:40:00,313,110,203
27959,27959,259,2022/4/15 20:50:00,274,106,168
27960,27960,259,2022/4/15 21:00:00,336,123,213
27961,27961,259,2022/4/15 21:10:00,269,114,155
27962,27962,259,2022/4/15 21:20:00,256,126,130
27963,27963,259,2022/4/15 21:30:00,209,99,110
27964,27964,259,2022/4/15 21:40:00,223,120,103
27965,27965,259,2022/4/15 21:50:00,167,107,60
27966,27966,259,2022/4/15 22:00:00,221,105,116
27967,27967,259,2022/4/15 22:10:00,134,109,25
27968,27968,259,2022/4/15 22:20:00,44,106,-62
27969,27969,259,2022/4/15 22:30:00,32,111,-79
27970,27970,259,2022/4/15 22:40:00,24,99,-75
27971,27971,259,2022/4/15 22:50:00,15,65,-50
27972,27972,260,2022/4/15 5:00:00,0,1,-1
27973,27973,260,2022/4/15 5:10:00,0,1,-1
27974,27974,260,2022/4/15 5:20:00,1,1,0
27975,27975,260,2022/4/15 5:30:00,3,1,2
27976,27976,260,2022/4/15 5:40:00,9,1,8
27977,27977,260,2022/4/15 5:50:00,17,19,-2
27978,27978,260,2022/4/15 6:00:00,19,50,-31
27979,27979,260,2022/4/15 6:10:00,21,62,-41
27980,27980,260,2022/4/15 6:20:00,27,93,-66
27981,27981,260,2022/4/15 6:30:00,36,112,-76
27982,27982,260,2022/4/15 6:40:00,40,152,-112
27983,27983,260,2022/4/15 6:50:00,49,153,-104
27984,27984,260,2022/4/15 7:00:00,63,230,-167
27985,27985,260,2022/4/15 7:10:00,75,297,-222
27986,27986,260,2022/4/15 7:20:00,84,321,-237
27987,27987,260,2022/4/15 7:30:00,148,502,-354
27988,27988,260,2022/4/15 7:40:00,184,497,-313
27989,27989,260,2022/4/15 7:50:00,234,586,-352
27990,27990,260,2022/4/15 8:00:00,244,1104,-860
27991,27991,260,2022/4/15 8:10:00,265,1618,-1353
27992,27992,260,2022/4/15 8:20:00,282,1555,-1273
27993,27993,260,2022/4/15 8:30:00,283,1832,-1549
27994,27994,260,2022/4/15 8:40:00,239,2834,-2595
27995,27995,260,2022/4/15 8:50:00,234,2622,-2388
27996,27996,260,2022/4/15 9:00:00,240,1663,-1423
27997,27997,260,2022/4/15 9:10:00,220,615,-395
27998,27998,260,2022/4/15 9:20:00,219,563,-344
27999,27999,260,2022/4/15 9:30:00,211,503,-292
28000,28000,260,2022/4/15 9:40:00,192,326,-134
28001,28001,260,2022/4/15 9:50:00,180,385,-205
28002,28002,260,2022/4/15 10:00:00,174,256,-82
28003,28003,260,2022/4/15 10:10:00,173,222,-49
28004,28004,260,2022/4/15 10:20:00,169,192,-23
28005,28005,260,2022/4/15 10:30:00,150,119,31
28006,28006,260,2022/4/15 10:40:00,161,117,44
28007,28007,260,2022/4/15 10:50:00,174,121,53
28008,28008,260,2022/4/15 11:00:00,173,108,65
28009,28009,260,2022/4/15 11:10:00,173,122,51
28010,28010,260,2022/4/15 11:20:00,180,105,75
28011,28011,260,2022/4/15 11:30:00,187,117,70
28012,28012,260,2022/4/15 11:40:00,184,122,62
28013,28013,260,2022/4/15 11:50:00,174,123,51
28014,28014,260,2022/4/15 12:00:00,170,109,61
28015,28015,260,2022/4/15 12:10:00,159,88,71
28016,28016,260,2022/4/15 12:20:00,141,128,13
28017,28017,260,2022/4/15 12:30:00,129,108,21
28018,28018,260,2022/4/15 12:40:00,112,152,-40
28019,28019,260,2022/4/15 12:50:00,103,178,-75
28020,28020,260,2022/4/15 13:00:00,138,193,-55
28021,28021,260,2022/4/15 13:10:00,143,144,-1
28022,28022,260,2022/4/15 13:20:00,147,153,-6
28023,28023,260,2022/4/15 13:30:00,154,180,-26
28024,28024,260,2022/4/15 13:40:00,176,179,-3
28025,28025,260,2022/4/15 13:50:00,169,140,29
28026,28026,260,2022/4/15 14:00:00,175,108,67
28027,28027,260,2022/4/15 14:10:00,185,109,76
28028,28028,260,2022/4/15 14:20:00,199,108,91
28029,28029,260,2022/4/15 14:30:00,207,119,88
28030,28030,260,2022/4/15 14:40:00,207,125,82
28031,28031,260,2022/4/15 14:50:00,207,109,98
28032,28032,260,2022/4/15 15:00:00,223,113,110
28033,28033,260,2022/4/15 15:10:00,262,127,135
28034,28034,260,2022/4/15 15:20:00,267,118,149
28035,28035,260,2022/4/15 15:30:00,265,122,143
28036,28036,260,2022/4/15 15:40:00,258,105,153
28037,28037,260,2022/4/15 15:50:00,273,109,164
28038,28038,260,2022/4/15 16:00:00,274,125,149
28039,28039,260,2022/4/15 16:10:00,271,124,147
28040,28040,260,2022/4/15 16:20:00,336,124,212
28041,28041,260,2022/4/15 16:30:00,355,122,233
28042,28042,260,2022/4/15 16:40:00,378,123,255
28043,28043,260,2022/4/15 16:50:00,312,121,191
28044,28044,260,2022/4/15 17:00:00,805,125,680
28045,28045,260,2022/4/15 17:10:00,1350,123,1227
28046,28046,260,2022/4/15 17:20:00,1028,118,910
28047,28047,260,2022/4/15 17:30:00,1031,149,882
28048,28048,260,2022/4/15 17:40:00,1356,178,1178
28049,28049,260,2022/4/15 17:50:00,831,158,673
28050,28050,260,2022/4/15 18:00:00,800,179,621
28051,28051,260,2022/4/15 18:10:00,1206,226,980
28052,28052,260,2022/4/15 18:20:00,711,170,541
28053,28053,260,2022/4/15 18:30:00,578,178,400
28054,28054,260,2022/4/15 18:40:00,352,153,199
28055,28055,260,2022/4/15 18:50:00,294,117,177
28056,28056,260,2022/4/15 19:00:00,225,114,111
28057,28057,260,2022/4/15 19:10:00,231,104,127
28058,28058,260,2022/4/15 19:20:00,192,106,86
28059,28059,260,2022/4/15 19:30:00,176,114,62
28060,28060,260,2022/4/15 19:40:00,159,99,60
28061,28061,260,2022/4/15 19:50:00,172,99,73
28062,28062,260,2022/4/15 20:00:00,157,91,66
28063,28063,260,2022/4/15 20:10:00,166,77,89
28064,28064,260,2022/4/15 20:20:00,164,79,85
28065,28065,260,2022/4/15 20:30:00,133,88,45
28066,28066,260,2022/4/15 20:40:00,113,77,36
28067,28067,260,2022/4/15 20:50:00,74,86,-12
28068,28068,260,2022/4/15 21:00:00,103,79,24
28069,28069,260,2022/4/15 21:10:00,85,85,0
28070,28070,260,2022/4/15 21:20:00,77,86,-9
28071,28071,260,2022/4/15 21:30:00,70,77,-7
28072,28072,260,2022/4/15 21:40:00,66,75,-9
28073,28073,260,2022/4/15 21:50:00,44,82,-38
28074,28074,260,2022/4/15 22:00:00,44,72,-28
28075,28075,260,2022/4/15 22:10:00,38,71,-33
28076,28076,260,2022/4/15 22:20:00,30,76,-46
28077,28077,260,2022/4/15 22:30:00,31,64,-33
28078,28078,260,2022/4/15 22:40:00,28,51,-23
28079,28079,260,2022/4/15 22:50:00,8,64,-56
28080,28080,261,2022/4/15 5:00:00,0,1,-1
28081,28081,261,2022/4/15 5:10:00,0,1,-1
28082,28082,261,2022/4/15 5:20:00,0,1,-1
28083,28083,261,2022/4/15 5:30:00,4,1,3
28084,28084,261,2022/4/15 5:40:00,13,1,12
28085,28085,261,2022/4/15 5:50:00,16,5,11
28086,28086,261,2022/4/15 6:00:00,21,19,2
28087,28087,261,2022/4/15 6:10:00,22,33,-11
28088,28088,261,2022/4/15 6:20:00,32,25,7
28089,28089,261,2022/4/15 6:30:00,36,51,-15
28090,28090,261,2022/4/15 6:40:00,47,60,-13
28091,28091,261,2022/4/15 6:50:00,69,66,3
28092,28092,261,2022/4/15 7:00:00,85,93,-8
28093,28093,261,2022/4/15 7:10:00,87,84,3
28094,28094,261,2022/4/15 7:20:00,152,69,83
28095,28095,261,2022/4/15 7:30:00,185,100,85
28096,28096,261,2022/4/15 7:40:00,234,98,136
28097,28097,261,2022/4/15 7:50:00,277,108,169
28098,28098,261,2022/4/15 8:00:00,317,109,208
28099,28099,261,2022/4/15 8:10:00,350,208,142
28100,28100,261,2022/4/15 8:20:00,345,208,137
28101,28101,261,2022/4/15 8:30:00,282,233,49
28102,28102,261,2022/4/15 8:40:00,269,298,-29
28103,28103,261,2022/4/15 8:50:00,224,148,76
28104,28104,261,2022/4/15 9:00:00,156,103,53
28105,28105,261,2022/4/15 9:10:00,96,108,-12
28106,28106,261,2022/4/15 9:20:00,79,107,-28
28107,28107,261,2022/4/15 9:30:00,76,104,-28
28108,28108,261,2022/4/15 9:40:00,50,127,-77
28109,28109,261,2022/4/15 9:50:00,45,108,-63
28110,28110,261,2022/4/15 10:00:00,39,83,-44
28111,28111,261,2022/4/15 10:10:00,39,82,-43
28112,28112,261,2022/4/15 10:20:00,33,71,-38
28113,28113,261,2022/4/15 10:30:00,33,62,-29
28114,28114,261,2022/4/15 10:40:00,34,85,-51
28115,28115,261,2022/4/15 10:50:00,29,73,-44
28116,28116,261,2022/4/15 11:00:00,30,72,-42
28117,28117,261,2022/4/15 11:10:00,29,65,-36
28118,28118,261,2022/4/15 11:20:00,30,70,-40
28119,28119,261,2022/4/15 11:30:00,35,73,-38
28120,28120,261,2022/4/15 11:40:00,30,67,-37
28121,28121,261,2022/4/15 11:50:00,32,74,-42
28122,28122,261,2022/4/15 12:00:00,28,62,-34
28123,28123,261,2022/4/15 12:10:00,27,67,-40
28124,28124,261,2022/4/15 12:20:00,30,69,-39
28125,28125,261,2022/4/15 12:30:00,32,82,-50
28126,28126,261,2022/4/15 12:40:00,31,79,-48
28127,28127,261,2022/4/15 12:50:00,29,64,-35
28128,28128,261,2022/4/15 13:00:00,28,61,-33
28129,28129,261,2022/4/15 13:10:00,33,77,-44
28130,28130,261,2022/4/15 13:20:00,28,84,-56
28131,28131,261,2022/4/15 13:30:00,28,76,-48
28132,28132,261,2022/4/15 13:40:00,29,78,-49
28133,28133,261,2022/4/15 13:50:00,32,64,-32
28134,28134,261,2022/4/15 14:00:00,29,70,-41
28135,28135,261,2022/4/15 14:10:00,30,77,-47
28136,28136,261,2022/4/15 14:20:00,25,85,-60
28137,28137,261,2022/4/15 14:30:00,25,84,-59
28138,28138,261,2022/4/15 14:40:00,25,69,-44
28139,28139,261,2022/4/15 14:50:00,30,73,-43
28140,28140,261,2022/4/15 15:00:00,39,76,-37
28141,28141,261,2022/4/15 15:10:00,36,77,-41
28142,28142,261,2022/4/15 15:20:00,30,97,-67
28143,28143,261,2022/4/15 15:30:00,29,76,-47
28144,28144,261,2022/4/15 15:40:00,36,90,-54
28145,28145,261,2022/4/15 15:50:00,37,83,-46
28146,28146,261,2022/4/15 16:00:00,42,76,-34
28147,28147,261,2022/4/15 16:10:00,44,90,-46
28148,28148,261,2022/4/15 16:20:00,40,96,-56
28149,28149,261,2022/4/15 16:30:00,44,100,-56
28150,28150,261,2022/4/15 16:40:00,52,104,-52
28151,28151,261,2022/4/15 16:50:00,46,101,-55
28152,28152,261,2022/4/15 17:00:00,129,104,25
28153,28153,261,2022/4/15 17:10:00,176,118,58
28154,28154,261,2022/4/15 17:20:00,138,125,13
28155,28155,261,2022/4/15 17:30:00,161,115,46
28156,28156,261,2022/4/15 17:40:00,259,118,141
28157,28157,261,2022/4/15 17:50:00,175,127,48
28158,28158,261,2022/4/15 18:00:00,102,152,-50
28159,28159,261,2022/4/15 18:10:00,199,179,20
28160,28160,261,2022/4/15 18:20:00,137,158,-21
28161,28161,261,2022/4/15 18:30:00,77,184,-107
28162,28162,261,2022/4/15 18:40:00,62,192,-130
28163,28163,261,2022/4/15 18:50:00,48,124,-76
28164,28164,261,2022/4/15 19:00:00,43,109,-66
28165,28165,261,2022/4/15 19:10:00,48,111,-63
28166,28166,261,2022/4/15 19:20:00,45,112,-67
28167,28167,261,2022/4/15 19:30:00,39,110,-71
28168,28168,261,2022/4/15 19:40:00,36,113,-77
28169,28169,261,2022/4/15 19:50:00,31,99,-68
28170,28170,261,2022/4/15 20:00:00,30,92,-62
28171,28171,261,2022/4/15 20:10:00,29,79,-50
28172,28172,261,2022/4/15 20:20:00,25,83,-58
28173,28173,261,2022/4/15 20:30:00,29,95,-66
28174,28174,261,2022/4/15 20:40:00,25,94,-69
28175,28175,261,2022/4/15 20:50:00,28,83,-55
28176,28176,261,2022/4/15 21:00:00,22,82,-60
28177,28177,261,2022/4/15 21:10:00,28,81,-53
28178,28178,261,2022/4/15 21:20:00,22,93,-71
28179,28179,261,2022/4/15 21:30:00,23,78,-55
28180,28180,261,2022/4/15 21:40:00,20,74,-54
28181,28181,261,2022/4/15 21:50:00,19,74,-55
28182,28182,261,2022/4/15 22:00:00,16,78,-62
28183,28183,261,2022/4/15 22:10:00,16,77,-61
28184,28184,261,2022/4/15 22:20:00,15,69,-54
28185,28185,261,2022/4/15 22:30:00,14,86,-72
28186,28186,261,2022/4/15 22:40:00,9,72,-63
28187,28187,261,2022/4/15 22:50:00,5,61,-56
28188,28188,262,2022/4/15 5:00:00,0,1,-1
28189,28189,262,2022/4/15 5:10:00,0,1,-1
28190,28190,262,2022/4/15 5:20:00,8,1,7
28191,28191,262,2022/4/15 5:30:00,21,1,20
28192,28192,262,2022/4/15 5:40:00,22,2,20
28193,28193,262,2022/4/15 5:50:00,20,6,14
28194,28194,262,2022/4/15 6:00:00,27,6,21
28195,28195,262,2022/4/15 6:10:00,41,6,35
28196,28196,262,2022/4/15 6:20:00,54,40,14
28197,28197,262,2022/4/15 6:30:00,75,23,52
28198,28198,262,2022/4/15 6:40:00,91,32,59
28199,28199,262,2022/4/15 6:50:00,108,68,40
28200,28200,262,2022/4/15 7:00:00,187,67,120
28201,28201,262,2022/4/15 7:10:00,187,112,75
28202,28202,262,2022/4/15 7:20:00,241,90,151
28203,28203,262,2022/4/15 7:30:00,302,79,223
28204,28204,262,2022/4/15 7:40:00,349,104,245
28205,28205,262,2022/4/15 7:50:00,368,112,256
28206,28206,262,2022/4/15 8:00:00,575,98,477
28207,28207,262,2022/4/15 8:10:00,445,109,336
28208,28208,262,2022/4/15 8:20:00,327,110,217
28209,28209,262,2022/4/15 8:30:00,344,109,235
28210,28210,262,2022/4/15 8:40:00,282,151,131
28211,28211,262,2022/4/15 8:50:00,232,108,124
28212,28212,262,2022/4/15 9:00:00,177,107,70
28213,28213,262,2022/4/15 9:10:00,138,102,36
28214,28214,262,2022/4/15 9:20:00,79,108,-29
28215,28215,262,2022/4/15 9:30:00,63,91,-28
28216,28216,262,2022/4/15 9:40:00,50,88,-38
28217,28217,262,2022/4/15 9:50:00,45,85,-40
28218,28218,262,2022/4/15 10:00:00,36,69,-33
28219,28219,262,2022/4/15 10:10:00,36,78,-42
28220,28220,262,2022/4/15 10:20:00,34,72,-38
28221,28221,262,2022/4/15 10:30:00,32,62,-30
28222,28222,262,2022/4/15 10:40:00,33,67,-34
28223,28223,262,2022/4/15 10:50:00,31,66,-35
28224,28224,262,2022/4/15 11:00:00,33,73,-40
28225,28225,262,2022/4/15 11:10:00,35,72,-37
28226,28226,262,2022/4/15 11:20:00,28,69,-41
28227,28227,262,2022/4/15 11:30:00,31,70,-39
28228,28228,262,2022/4/15 11:40:00,29,68,-39
28229,28229,262,2022/4/15 11:50:00,32,68,-36
28230,28230,262,2022/4/15 12:00:00,31,65,-34
28231,28231,262,2022/4/15 12:10:00,31,65,-34
28232,28232,262,2022/4/15 12:20:00,39,70,-31
28233,28233,262,2022/4/15 12:30:00,32,81,-49
28234,28234,262,2022/4/15 12:40:00,35,72,-37
28235,28235,262,2022/4/15 12:50:00,36,81,-45
28236,28236,262,2022/4/15 13:00:00,37,84,-47
28237,28237,262,2022/4/15 13:10:00,36,83,-47
28238,28238,262,2022/4/15 13:20:00,31,75,-44
28239,28239,262,2022/4/15 13:30:00,35,74,-39
28240,28240,262,2022/4/15 13:40:00,32,79,-47
28241,28241,262,2022/4/15 13:50:00,29,75,-46
28242,28242,262,2022/4/15 14:00:00,32,80,-48
28243,28243,262,2022/4/15 14:10:00,27,77,-50
28244,28244,262,2022/4/15 14:20:00,29,73,-44
28245,28245,262,2022/4/15 14:30:00,31,72,-41
28246,28246,262,2022/4/15 14:40:00,31,83,-52
28247,28247,262,2022/4/15 14:50:00,25,78,-53
28248,28248,262,2022/4/15 15:00:00,33,91,-58
28249,28249,262,2022/4/15 15:10:00,34,90,-56
28250,28250,262,2022/4/15 15:20:00,28,96,-68
28251,28251,262,2022/4/15 15:30:00,28,102,-74
28252,28252,262,2022/4/15 15:40:00,30,108,-78
28253,28253,262,2022/4/15 15:50:00,29,104,-75
28254,28254,262,2022/4/15 16:00:00,32,103,-71
28255,28255,262,2022/4/15 16:10:00,35,111,-76
28256,28256,262,2022/4/15 16:20:00,40,96,-56
28257,28257,262,2022/4/15 16:30:00,44,107,-63
28258,28258,262,2022/4/15 16:40:00,58,119,-61
28259,28259,262,2022/4/15 16:50:00,60,115,-55
28260,28260,262,2022/4/15 17:00:00,130,116,14
28261,28261,262,2022/4/15 17:10:00,156,118,38
28262,28262,262,2022/4/15 17:20:00,77,181,-104
28263,28263,262,2022/4/15 17:30:00,86,180,-94
28264,28264,262,2022/4/15 17:40:00,142,179,-37
28265,28265,262,2022/4/15 17:50:00,93,217,-124
28266,28266,262,2022/4/15 18:00:00,71,198,-127
28267,28267,262,2022/4/15 18:10:00,102,198,-96
28268,28268,262,2022/4/15 18:20:00,77,222,-145
28269,28269,262,2022/4/15 18:30:00,53,235,-182
28270,28270,262,2022/4/15 18:40:00,46,224,-178
28271,28271,262,2022/4/15 18:50:00,37,209,-172
28272,28272,262,2022/4/15 19:00:00,34,192,-158
28273,28273,262,2022/4/15 19:10:00,35,109,-74
28274,28274,262,2022/4/15 19:20:00,33,109,-76
28275,28275,262,2022/4/15 19:30:00,26,105,-79
28276,28276,262,2022/4/15 19:40:00,33,106,-73
28277,28277,262,2022/4/15 19:50:00,29,108,-79
28278,28278,262,2022/4/15 20:00:00,35,105,-70
28279,28279,262,2022/4/15 20:10:00,24,104,-80
28280,28280,262,2022/4/15 20:20:00,28,92,-64
28281,28281,262,2022/4/15 20:30:00,29,106,-77
28282,28282,262,2022/4/15 20:40:00,24,111,-87
28283,28283,262,2022/4/15 20:50:00,23,115,-92
28284,28284,262,2022/4/15 21:00:00,31,102,-71
28285,28285,262,2022/4/15 21:10:00,25,105,-80
28286,28286,262,2022/4/15 21:20:00,25,116,-91
28287,28287,262,2022/4/15 21:30:00,34,106,-72
28288,28288,262,2022/4/15 21:40:00,24,105,-81
28289,28289,262,2022/4/15 21:50:00,16,95,-79
28290,28290,262,2022/4/15 22:00:00,16,101,-85
28291,28291,262,2022/4/15 22:10:00,17,110,-93
28292,28292,262,2022/4/15 22:20:00,12,83,-71
28293,28293,262,2022/4/15 22:30:00,8,93,-85
28294,28294,262,2022/4/15 22:40:00,5,71,-66
28295,28295,262,2022/4/15 22:50:00,1,63,-62
28296,28296,263,2022/4/15 5:00:00,0,1,-1
28297,28297,263,2022/4/15 5:10:00,0,1,-1
28298,28298,263,2022/4/15 5:20:00,2,1,1
28299,28299,263,2022/4/15 5:30:00,15,1,14
28300,28300,263,2022/4/15 5:40:00,38,1,37
28301,28301,263,2022/4/15 5:50:00,36,23,13
28302,28302,263,2022/4/15 6:00:00,55,16,39
28303,28303,263,2022/4/15 6:10:00,76,48,28
28304,28304,263,2022/4/15 6:20:00,197,65,132
28305,28305,263,2022/4/15 6:30:00,274,60,214
28306,28306,263,2022/4/15 6:40:00,280,73,207
28307,28307,263,2022/4/15 6:50:00,339,115,224
28308,28308,263,2022/4/15 7:00:00,438,108,330
28309,28309,263,2022/4/15 7:10:00,611,109,502
28310,28310,263,2022/4/15 7:20:00,723,126,597
28311,28311,263,2022/4/15 7:30:00,824,111,713
28312,28312,263,2022/4/15 7:40:00,1172,104,1068
28313,28313,263,2022/4/15 7:50:00,1367,144,1223
28314,28314,263,2022/4/15 8:00:00,1573,122,1451
28315,28315,263,2022/4/15 8:10:00,1597,121,1476
28316,28316,263,2022/4/15 8:20:00,1360,102,1258
28317,28317,263,2022/4/15 8:30:00,1212,111,1101
28318,28318,263,2022/4/15 8:40:00,1047,115,932
28319,28319,263,2022/4/15 8:50:00,742,120,622
28320,28320,263,2022/4/15 9:00:00,650,105,545
28321,28321,263,2022/4/15 9:10:00,468,99,369
28322,28322,263,2022/4/15 9:20:00,329,96,233
28323,28323,263,2022/4/15 9:30:00,278,94,184
28324,28324,263,2022/4/15 9:40:00,226,93,133
28325,28325,263,2022/4/15 9:50:00,173,98,75
28326,28326,263,2022/4/15 10:00:00,141,77,64
28327,28327,263,2022/4/15 10:10:00,92,93,-1
28328,28328,263,2022/4/15 10:20:00,72,76,-4
28329,28329,263,2022/4/15 10:30:00,69,108,-39
28330,28330,263,2022/4/15 10:40:00,65,85,-20
28331,28331,263,2022/4/15 10:50:00,49,101,-52
28332,28332,263,2022/4/15 11:00:00,48,85,-37
28333,28333,263,2022/4/15 11:10:00,45,103,-58
28334,28334,263,2022/4/15 11:20:00,45,74,-29
28335,28335,263,2022/4/15 11:30:00,50,93,-43
28336,28336,263,2022/4/15 11:40:00,46,82,-36
28337,28337,263,2022/4/15 11:50:00,54,106,-52
28338,28338,263,2022/4/15 12:00:00,65,90,-25
28339,28339,263,2022/4/15 12:10:00,70,100,-30
28340,28340,263,2022/4/15 12:20:00,70,83,-13
28341,28341,263,2022/4/15 12:30:00,73,109,-36
28342,28342,263,2022/4/15 12:40:00,64,90,-26
28343,28343,263,2022/4/15 12:50:00,69,105,-36
28344,28344,263,2022/4/15 13:00:00,62,93,-31
28345,28345,263,2022/4/15 13:10:00,58,104,-46
28346,28346,263,2022/4/15 13:20:00,63,77,-14
28347,28347,263,2022/4/15 13:30:00,61,112,-51
28348,28348,263,2022/4/15 13:40:00,54,90,-36
28349,28349,263,2022/4/15 13:50:00,41,109,-68
28350,28350,263,2022/4/15 14:00:00,43,91,-48
28351,28351,263,2022/4/15 14:10:00,42,105,-63
28352,28352,263,2022/4/15 14:20:00,43,89,-46
28353,28353,263,2022/4/15 14:30:00,43,121,-78
28354,28354,263,2022/4/15 14:40:00,50,110,-60
28355,28355,263,2022/4/15 14:50:00,45,118,-73
28356,28356,263,2022/4/15 15:00:00,43,101,-58
28357,28357,263,2022/4/15 15:10:00,43,124,-81
28358,28358,263,2022/4/15 15:20:00,76,106,-30
28359,28359,263,2022/4/15 15:30:00,58,133,-75
28360,28360,263,2022/4/15 15:40:00,51,101,-50
28361,28361,263,2022/4/15 15:50:00,47,150,-103
28362,28362,263,2022/4/15 16:00:00,55,119,-64
28363,28363,263,2022/4/15 16:10:00,59,150,-91
28364,28364,263,2022/4/15 16:20:00,68,110,-42
28365,28365,263,2022/4/15 16:30:00,81,226,-145
28366,28366,263,2022/4/15 16:40:00,74,117,-43
28367,28367,263,2022/4/15 16:50:00,85,197,-112
28368,28368,263,2022/4/15 17:00:00,134,251,-117
28369,28369,263,2022/4/15 17:10:00,157,252,-95
28370,28370,263,2022/4/15 17:20:00,138,375,-237
28371,28371,263,2022/4/15 17:30:00,179,318,-139
28372,28372,263,2022/4/15 17:40:00,182,499,-317
28373,28373,263,2022/4/15 17:50:00,77,523,-446
28374,28374,263,2022/4/15 18:00:00,68,417,-349
28375,28375,263,2022/4/15 18:10:00,102,420,-318
28376,28376,263,2022/4/15 18:20:00,57,431,-374
28377,28377,263,2022/4/15 18:30:00,51,419,-368
28378,28378,263,2022/4/15 18:40:00,46,490,-444
28379,28379,263,2022/4/15 18:50:00,41,431,-390
28380,28380,263,2022/4/15 19:00:00,37,503,-466
28381,28381,263,2022/4/15 19:10:00,37,321,-284
28382,28382,263,2022/4/15 19:20:00,32,299,-267
28383,28383,263,2022/4/15 19:30:00,28,221,-193
28384,28384,263,2022/4/15 19:40:00,28,177,-149
28385,28385,263,2022/4/15 19:50:00,28,169,-141
28386,28386,263,2022/4/15 20:00:00,30,111,-81
28387,28387,263,2022/4/15 20:10:00,35,109,-74
28388,28388,263,2022/4/15 20:20:00,27,111,-84
28389,28389,263,2022/4/15 20:30:00,29,110,-81
28390,28390,263,2022/4/15 20:40:00,27,138,-111
28391,28391,263,2022/4/15 20:50:00,27,127,-100
28392,28392,263,2022/4/15 21:00:00,29,191,-162
28393,28393,263,2022/4/15 21:10:00,35,116,-81
28394,28394,263,2022/4/15 21:20:00,28,107,-79
28395,28395,263,2022/4/15 21:30:00,27,111,-84
28396,28396,263,2022/4/15 21:40:00,24,150,-126
28397,28397,263,2022/4/15 21:50:00,23,128,-105
28398,28398,263,2022/4/15 22:00:00,21,119,-98
28399,28399,263,2022/4/15 22:10:00,17,118,-101
28400,28400,263,2022/4/15 22:20:00,15,112,-97
28401,28401,263,2022/4/15 22:30:00,13,109,-96
28402,28402,263,2022/4/15 22:40:00,11,105,-94
28403,28403,263,2022/4/15 22:50:00,3,77,-74
28404,28404,264,2022/4/15 5:00:00,0,1,-1
28405,28405,264,2022/4/15 5:10:00,0,1,-1
28406,28406,264,2022/4/15 5:20:00,1,1,0
28407,28407,264,2022/4/15 5:30:00,7,1,6
28408,28408,264,2022/4/15 5:40:00,15,1,14
28409,28409,264,2022/4/15 5:50:00,26,1,25
28410,28410,264,2022/4/15 6:00:00,24,62,-38
28411,28411,264,2022/4/15 6:10:00,20,56,-36
28412,28412,264,2022/4/15 6:20:00,29,68,-39
28413,28413,264,2022/4/15 6:30:00,27,93,-66
28414,28414,264,2022/4/15 6:40:00,31,125,-94
28415,28415,264,2022/4/15 6:50:00,34,109,-75
28416,28416,264,2022/4/15 7:00:00,45,195,-150
28417,28417,264,2022/4/15 7:10:00,40,157,-117
28418,28418,264,2022/4/15 7:20:00,51,115,-64
28419,28419,264,2022/4/15 7:30:00,45,196,-151
28420,28420,264,2022/4/15 7:40:00,54,326,-272
28421,28421,264,2022/4/15 7:50:00,58,534,-476
28422,28422,264,2022/4/15 8:00:00,73,675,-602
28423,28423,264,2022/4/15 8:10:00,73,2121,-2048
28424,28424,264,2022/4/15 8:20:00,69,2164,-2095
28425,28425,264,2022/4/15 8:30:00,74,3042,-2968
28426,28426,264,2022/4/15 8:40:00,75,7859,-7784
28427,28427,264,2022/4/15 8:50:00,60,5741,-5681
28428,28428,264,2022/4/15 9:00:00,53,2109,-2056
28429,28429,264,2022/4/15 9:10:00,50,2106,-2056
28430,28430,264,2022/4/15 9:20:00,51,1126,-1075
28431,28431,264,2022/4/15 9:30:00,48,477,-429
28432,28432,264,2022/4/15 9:40:00,47,428,-381
28433,28433,264,2022/4/15 9:50:00,46,434,-388
28434,28434,264,2022/4/15 10:00:00,48,324,-276
28435,28435,264,2022/4/15 10:10:00,47,159,-112
28436,28436,264,2022/4/15 10:20:00,46,213,-167
28437,28437,264,2022/4/15 10:30:00,53,144,-91
28438,28438,264,2022/4/15 10:40:00,45,186,-141
28439,28439,264,2022/4/15 10:50:00,55,105,-50
28440,28440,264,2022/4/15 11:00:00,51,120,-69
28441,28441,264,2022/4/15 11:10:00,47,111,-64
28442,28442,264,2022/4/15 11:20:00,53,121,-68
28443,28443,264,2022/4/15 11:30:00,62,108,-46
28444,28444,264,2022/4/15 11:40:00,71,112,-41
28445,28445,264,2022/4/15 11:50:00,68,124,-56
28446,28446,264,2022/4/15 12:00:00,66,120,-54
28447,28447,264,2022/4/15 12:10:00,72,127,-55
28448,28448,264,2022/4/15 12:20:00,74,129,-55
28449,28449,264,2022/4/15 12:30:00,76,109,-33
28450,28450,264,2022/4/15 12:40:00,73,171,-98
28451,28451,264,2022/4/15 12:50:00,82,109,-27
28452,28452,264,2022/4/15 13:00:00,102,128,-26
28453,28453,264,2022/4/15 13:10:00,93,105,-12
28454,28454,264,2022/4/15 13:20:00,128,111,17
28455,28455,264,2022/4/15 13:30:00,136,110,26
28456,28456,264,2022/4/15 13:40:00,142,144,-2
28457,28457,264,2022/4/15 13:50:00,135,127,8
28458,28458,264,2022/4/15 14:00:00,137,109,28
28459,28459,264,2022/4/15 14:10:00,142,123,19
28460,28460,264,2022/4/15 14:20:00,133,111,22
28461,28461,264,2022/4/15 14:30:00,131,88,43
28462,28462,264,2022/4/15 14:40:00,137,110,27
28463,28463,264,2022/4/15 14:50:00,133,105,28
28464,28464,264,2022/4/15 15:00:00,166,121,45
28465,28465,264,2022/4/15 15:10:00,186,106,80
28466,28466,264,2022/4/15 15:20:00,164,122,42
28467,28467,264,2022/4/15 15:30:00,157,96,61
28468,28468,264,2022/4/15 15:40:00,183,119,64
28469,28469,264,2022/4/15 15:50:00,162,102,60
28470,28470,264,2022/4/15 16:00:00,178,117,61
28471,28471,264,2022/4/15 16:10:00,216,106,110
28472,28472,264,2022/4/15 16:20:00,219,104,115
28473,28473,264,2022/4/15 16:30:00,272,114,158
28474,28474,264,2022/4/15 16:40:00,313,111,202
28475,28475,264,2022/4/15 16:50:00,348,111,237
28476,28476,264,2022/4/15 17:00:00,695,123,572
28477,28477,264,2022/4/15 17:10:00,806,149,657
28478,28478,264,2022/4/15 17:20:00,656,190,466
28479,28479,264,2022/4/15 17:30:00,1154,211,943
28480,28480,264,2022/4/15 17:40:00,1609,217,1392
28481,28481,264,2022/4/15 17:50:00,1149,254,895
28482,28482,264,2022/4/15 18:00:00,1189,321,868
28483,28483,264,2022/4/15 18:10:00,2511,284,2227
28484,28484,264,2022/4/15 18:20:00,1583,314,1269
28485,28485,264,2022/4/15 18:30:00,822,300,522
28486,28486,264,2022/4/15 18:40:00,806,294,512
28487,28487,264,2022/4/15 18:50:00,608,226,382
28488,28488,264,2022/4/15 19:00:00,558,146,412
28489,28489,264,2022/4/15 19:10:00,431,109,322
28490,28490,264,2022/4/15 19:20:00,347,122,225
28491,28491,264,2022/4/15 19:30:00,265,116,149
28492,28492,264,2022/4/15 19:40:00,269,106,163
28493,28493,264,2022/4/15 19:50:00,271,103,168
28494,28494,264,2022/4/15 20:00:00,269,90,179
28495,28495,264,2022/4/15 20:10:00,265,86,179
28496,28496,264,2022/4/15 20:20:00,265,77,188
28497,28497,264,2022/4/15 20:30:00,273,95,178
28498,28498,264,2022/4/15 20:40:00,273,76,197
28499,28499,264,2022/4/15 20:50:00,242,81,161
28500,28500,264,2022/4/15 21:00:00,274,80,194
28501,28501,264,2022/4/15 21:10:00,302,81,221
28502,28502,264,2022/4/15 21:20:00,273,87,186
28503,28503,264,2022/4/15 21:30:00,228,75,153
28504,28504,264,2022/4/15 21:40:00,189,77,112
28505,28505,264,2022/4/15 21:50:00,192,69,123
28506,28506,264,2022/4/15 22:00:00,168,71,97
28507,28507,264,2022/4/15 22:10:00,147,73,74
28508,28508,264,2022/4/15 22:20:00,63,78,-15
28509,28509,264,2022/4/15 22:30:00,44,85,-41
28510,28510,264,2022/4/15 22:40:00,33,66,-33
28511,28511,264,2022/4/15 22:50:00,25,58,-33
28512,28512,265,2022/4/15 5:00:00,0,1,-1
28513,28513,265,2022/4/15 5:10:00,0,1,-1
28514,28514,265,2022/4/15 5:20:00,3,1,2
28515,28515,265,2022/4/15 5:30:00,8,1,7
28516,28516,265,2022/4/15 5:40:00,22,1,21
28517,28517,265,2022/4/15 5:50:00,24,11,13
28518,28518,265,2022/4/15 6:00:00,35,8,27
28519,28519,265,2022/4/15 6:10:00,36,45,-9
28520,28520,265,2022/4/15 6:20:00,47,47,0
28521,28521,265,2022/4/15 6:30:00,66,62,4
28522,28522,265,2022/4/15 6:40:00,146,69,77
28523,28523,265,2022/4/15 6:50:00,164,75,89
28524,28524,265,2022/4/15 7:00:00,218,88,130
28525,28525,265,2022/4/15 7:10:00,246,111,135
28526,28526,265,2022/4/15 7:20:00,280,107,173
28527,28527,265,2022/4/15 7:30:00,439,107,332
28528,28528,265,2022/4/15 7:40:00,599,128,471
28529,28529,265,2022/4/15 7:50:00,691,154,537
28530,28530,265,2022/4/15 8:00:00,741,281,460
28531,28531,265,2022/4/15 8:10:00,828,535,293
28532,28532,265,2022/4/15 8:20:00,694,507,187
28533,28533,265,2022/4/15 8:30:00,724,426,298
28534,28534,265,2022/4/15 8:40:00,574,1186,-612
28535,28535,265,2022/4/15 8:50:00,383,479,-96
28536,28536,265,2022/4/15 9:00:00,313,508,-195
28537,28537,265,2022/4/15 9:10:00,276,377,-101
28538,28538,265,2022/4/15 9:20:00,225,332,-107
28539,28539,265,2022/4/15 9:30:00,201,211,-10
28540,28540,265,2022/4/15 9:40:00,144,224,-80
28541,28541,265,2022/4/15 9:50:00,90,144,-54
28542,28542,265,2022/4/15 10:00:00,94,179,-85
28543,28543,265,2022/4/15 10:10:00,74,119,-45
28544,28544,265,2022/4/15 10:20:00,72,111,-39
28545,28545,265,2022/4/15 10:30:00,71,122,-51
28546,28546,265,2022/4/15 10:40:00,69,128,-59
28547,28547,265,2022/4/15 10:50:00,70,105,-35
28548,28548,265,2022/4/15 11:00:00,71,111,-40
28549,28549,265,2022/4/15 11:10:00,70,111,-41
28550,28550,265,2022/4/15 11:20:00,65,153,-88
28551,28551,265,2022/4/15 11:30:00,76,125,-49
28552,28552,265,2022/4/15 11:40:00,76,159,-83
28553,28553,265,2022/4/15 11:50:00,70,120,-50
28554,28554,265,2022/4/15 12:00:00,127,181,-54
28555,28555,265,2022/4/15 12:10:00,157,128,29
28556,28556,265,2022/4/15 12:20:00,169,152,17
28557,28557,265,2022/4/15 12:30:00,198,121,77
28558,28558,265,2022/4/15 12:40:00,185,180,5
28559,28559,265,2022/4/15 12:50:00,186,128,58
28560,28560,265,2022/4/15 13:00:00,206,145,61
28561,28561,265,2022/4/15 13:10:00,207,121,86
28562,28562,265,2022/4/15 13:20:00,214,145,69
28563,28563,265,2022/4/15 13:30:00,205,109,96
28564,28564,265,2022/4/15 13:40:00,175,146,29
28565,28565,265,2022/4/15 13:50:00,174,119,55
28566,28566,265,2022/4/15 14:00:00,176,128,48
28567,28567,265,2022/4/15 14:10:00,178,108,70
28568,28568,265,2022/4/15 14:20:00,175,150,25
28569,28569,265,2022/4/15 14:30:00,176,108,68
28570,28570,265,2022/4/15 14:40:00,177,117,60
28571,28571,265,2022/4/15 14:50:00,175,133,42
28572,28572,265,2022/4/15 15:00:00,180,185,-5
28573,28573,265,2022/4/15 15:10:00,180,132,48
28574,28574,265,2022/4/15 15:20:00,202,198,4
28575,28575,265,2022/4/15 15:30:00,195,169,26
28576,28576,265,2022/4/15 15:40:00,201,213,-12
28577,28577,265,2022/4/15 15:50:00,193,154,39
28578,28578,265,2022/4/15 16:00:00,221,195,26
28579,28579,265,2022/4/15 16:10:00,236,192,44
28580,28580,265,2022/4/15 16:20:00,256,267,-11
28581,28581,265,2022/4/15 16:30:00,271,197,74
28582,28582,265,2022/4/15 16:40:00,285,269,16
28583,28583,265,2022/4/15 16:50:00,271,319,-48
28584,28584,265,2022/4/15 17:00:00,548,375,173
28585,28585,265,2022/4/15 17:10:00,699,429,270
28586,28586,265,2022/4/15 17:20:00,579,412,167
28587,28587,265,2022/4/15 17:30:00,650,422,228
28588,28588,265,2022/4/15 17:40:00,792,474,318
28589,28589,265,2022/4/15 17:50:00,610,571,39
28590,28590,265,2022/4/15 18:00:00,677,614,63
28591,28591,265,2022/4/15 18:10:00,831,608,223
28592,28592,265,2022/4/15 18:20:00,641,610,31
28593,28593,265,2022/4/15 18:30:00,573,609,-36
28594,28594,265,2022/4/15 18:40:00,546,611,-65
28595,28595,265,2022/4/15 18:50:00,312,566,-254
28596,28596,265,2022/4/15 19:00:00,328,416,-88
28597,28597,265,2022/4/15 19:10:00,347,504,-157
28598,28598,265,2022/4/15 19:20:00,315,335,-20
28599,28599,265,2022/4/15 19:30:00,290,321,-31
28600,28600,265,2022/4/15 19:40:00,266,218,48
28601,28601,265,2022/4/15 19:50:00,284,179,105
28602,28602,265,2022/4/15 20:00:00,316,169,147
28603,28603,265,2022/4/15 20:10:00,349,109,240
28604,28604,265,2022/4/15 20:20:00,308,129,179
28605,28605,265,2022/4/15 20:30:00,334,121,213
28606,28606,265,2022/4/15 20:40:00,349,110,239
28607,28607,265,2022/4/15 20:50:00,335,110,225
28608,28608,265,2022/4/15 21:00:00,350,119,231
28609,28609,265,2022/4/15 21:10:00,358,120,238
28610,28610,265,2022/4/15 21:20:00,289,121,168
28611,28611,265,2022/4/15 21:30:00,264,124,140
28612,28612,265,2022/4/15 21:40:00,268,109,159
28613,28613,265,2022/4/15 21:50:00,192,106,86
28614,28614,265,2022/4/15 22:00:00,86,103,-17
28615,28615,265,2022/4/15 22:10:00,58,111,-53
28616,28616,265,2022/4/15 22:20:00,32,111,-79
28617,28617,265,2022/4/15 22:30:00,22,106,-84
28618,28618,265,2022/4/15 22:40:00,18,98,-80
28619,28619,265,2022/4/15 22:50:00,8,75,-67
28620,28620,266,2022/4/15 5:00:00,0,1,-1
28621,28621,266,2022/4/15 5:10:00,3,1,2
28622,28622,266,2022/4/15 5:20:00,12,1,11
28623,28623,266,2022/4/15 5:30:00,11,1,10
28624,28624,266,2022/4/15 5:40:00,14,1,13
28625,28625,266,2022/4/15 5:50:00,18,1,17
28626,28626,266,2022/4/15 6:00:00,22,1,21
28627,28627,266,2022/4/15 6:10:00,32,1,31
28628,28628,266,2022/4/15 6:20:00,42,5,37
28629,28629,266,2022/4/15 6:30:00,43,22,21
28630,28630,266,2022/4/15 6:40:00,54,19,35
28631,28631,266,2022/4/15 6:50:00,77,23,54
28632,28632,266,2022/4/15 7:00:00,75,39,36
28633,28633,266,2022/4/15 7:10:00,152,40,112
28634,28634,266,2022/4/15 7:20:00,199,50,149
28635,28635,266,2022/4/15 7:30:00,265,66,199
28636,28636,266,2022/4/15 7:40:00,278,54,224
28637,28637,266,2022/4/15 7:50:00,283,83,200
28638,28638,266,2022/4/15 8:00:00,277,86,191
28639,28639,266,2022/4/15 8:10:00,270,108,162
28640,28640,266,2022/4/15 8:20:00,206,96,110
28641,28641,266,2022/4/15 8:30:00,182,114,68
28642,28642,266,2022/4/15 8:40:00,107,120,-13
28643,28643,266,2022/4/15 8:50:00,65,118,-53
28644,28644,266,2022/4/15 9:00:00,48,75,-27
28645,28645,266,2022/4/15 9:10:00,46,81,-35
28646,28646,266,2022/4/15 9:20:00,29,72,-43
28647,28647,266,2022/4/15 9:30:00,34,76,-42
28648,28648,266,2022/4/15 9:40:00,29,65,-36
28649,28649,266,2022/4/15 9:50:00,26,70,-44
28650,28650,266,2022/4/15 10:00:00,27,64,-37
28651,28651,266,2022/4/15 10:10:00,29,61,-32
28652,28652,266,2022/4/15 10:20:00,27,62,-35
28653,28653,266,2022/4/15 10:30:00,24,47,-23
28654,28654,266,2022/4/15 10:40:00,27,71,-44
28655,28655,266,2022/4/15 10:50:00,26,55,-29
28656,28656,266,2022/4/15 11:00:00,25,49,-24
28657,28657,266,2022/4/15 11:10:00,28,50,-22
28658,28658,266,2022/4/15 11:20:00,27,74,-47
28659,28659,266,2022/4/15 11:30:00,24,53,-29
28660,28660,266,2022/4/15 11:40:00,25,48,-23
28661,28661,266,2022/4/15 11:50:00,26,51,-25
28662,28662,266,2022/4/15 12:00:00,27,65,-38
28663,28663,266,2022/4/15 12:10:00,27,51,-24
28664,28664,266,2022/4/15 12:20:00,27,48,-21
28665,28665,266,2022/4/15 12:30:00,26,51,-25
28666,28666,266,2022/4/15 12:40:00,27,72,-45
28667,28667,266,2022/4/15 12:50:00,27,53,-26
28668,28668,266,2022/4/15 13:00:00,28,51,-23
28669,28669,266,2022/4/15 13:10:00,28,53,-25
28670,28670,266,2022/4/15 13:20:00,25,69,-44
28671,28671,266,2022/4/15 13:30:00,21,53,-32
28672,28672,266,2022/4/15 13:40:00,25,49,-24
28673,28673,266,2022/4/15 13:50:00,25,49,-24
28674,28674,266,2022/4/15 14:00:00,28,69,-41
28675,28675,266,2022/4/15 14:10:00,24,52,-28
28676,28676,266,2022/4/15 14:20:00,27,54,-27
28677,28677,266,2022/4/15 14:30:00,26,51,-25
28678,28678,266,2022/4/15 14:40:00,24,83,-59
28679,28679,266,2022/4/15 14:50:00,27,62,-35
28680,28680,266,2022/4/15 15:00:00,28,53,-25
28681,28681,266,2022/4/15 15:10:00,28,62,-34
28682,28682,266,2022/4/15 15:20:00,27,76,-49
28683,28683,266,2022/4/15 15:30:00,25,59,-34
28684,28684,266,2022/4/15 15:40:00,30,62,-32
28685,28685,266,2022/4/15 15:50:00,26,64,-38
28686,28686,266,2022/4/15 16:00:00,27,95,-68
28687,28687,266,2022/4/15 16:10:00,29,68,-39
28688,28688,266,2022/4/15 16:20:00,30,66,-36
28689,28689,266,2022/4/15 16:30:00,30,69,-39
28690,28690,266,2022/4/15 16:40:00,34,102,-68
28691,28691,266,2022/4/15 16:50:00,31,75,-44
28692,28692,266,2022/4/15 17:00:00,41,87,-46
28693,28693,266,2022/4/15 17:10:00,41,97,-56
28694,28694,266,2022/4/15 17:20:00,32,123,-91
28695,28695,266,2022/4/15 17:30:00,49,106,-57
28696,28696,266,2022/4/15 17:40:00,45,118,-73
28697,28697,266,2022/4/15 17:50:00,41,105,-64
28698,28698,266,2022/4/15 18:00:00,37,109,-72
28699,28699,266,2022/4/15 18:10:00,49,117,-68
28700,28700,266,2022/4/15 18:20:00,41,171,-130
28701,28701,266,2022/4/15 18:30:00,38,88,-50
28702,28702,266,2022/4/15 18:40:00,28,116,-88
28703,28703,266,2022/4/15 18:50:00,28,121,-93
28704,28704,266,2022/4/15 19:00:00,26,128,-102
28705,28705,266,2022/4/15 19:10:00,24,107,-83
28706,28706,266,2022/4/15 19:20:00,24,126,-102
28707,28707,266,2022/4/15 19:30:00,21,77,-56
28708,28708,266,2022/4/15 19:40:00,23,105,-82
28709,28709,266,2022/4/15 19:50:00,19,79,-60
28710,28710,266,2022/4/15 20:00:00,17,77,-60
28711,28711,266,2022/4/15 20:10:00,16,64,-48
28712,28712,266,2022/4/15 20:20:00,18,77,-59
28713,28713,266,2022/4/15 20:30:00,12,69,-57
28714,28714,266,2022/4/15 20:40:00,17,63,-46
28715,28715,266,2022/4/15 20:50:00,16,75,-59
28716,28716,266,2022/4/15 21:00:00,15,67,-52
28717,28717,266,2022/4/15 21:10:00,21,74,-53
28718,28718,266,2022/4/15 21:20:00,14,77,-63
28719,28719,266,2022/4/15 21:30:00,13,69,-56
28720,28720,266,2022/4/15 21:40:00,16,68,-52
28721,28721,266,2022/4/15 21:50:00,16,61,-45
28722,28722,266,2022/4/15 22:00:00,12,65,-53
28723,28723,266,2022/4/15 22:10:00,10,60,-50
28724,28724,266,2022/4/15 22:20:00,9,56,-47
28725,28725,266,2022/4/15 22:30:00,5,66,-61
28726,28726,266,2022/4/15 22:40:00,2,59,-57
28727,28727,266,2022/4/15 22:50:00,1,49,-48
28728,28728,267,2022/4/15 5:00:00,0,1,-1
28729,28729,267,2022/4/15 5:10:00,1,1,0
28730,28730,267,2022/4/15 5:20:00,16,1,15
28731,28731,267,2022/4/15 5:30:00,32,1,31
28732,28732,267,2022/4/15 5:40:00,31,2,29
28733,28733,267,2022/4/15 5:50:00,35,5,30
28734,28734,267,2022/4/15 6:00:00,47,13,34
28735,28735,267,2022/4/15 6:10:00,57,11,46
28736,28736,267,2022/4/15 6:20:00,76,48,28
28737,28737,267,2022/4/15 6:30:00,174,59,115
28738,28738,267,2022/4/15 6:40:00,189,66,123
28739,28739,267,2022/4/15 6:50:00,239,96,143
28740,28740,267,2022/4/15 7:00:00,283,118,165
28741,28741,267,2022/4/15 7:10:00,279,110,169
28742,28742,267,2022/4/15 7:20:00,482,118,364
28743,28743,267,2022/4/15 7:30:00,666,105,561
28744,28744,267,2022/4/15 7:40:00,828,133,695
28745,28745,267,2022/4/15 7:50:00,861,106,755
28746,28746,267,2022/4/15 8:00:00,1049,109,940
28747,28747,267,2022/4/15 8:10:00,741,119,622
28748,28748,267,2022/4/15 8:20:00,740,117,623
28749,28749,267,2022/4/15 8:30:00,679,123,556
28750,28750,267,2022/4/15 8:40:00,602,126,476
28751,28751,267,2022/4/15 8:50:00,316,106,210
28752,28752,267,2022/4/15 9:00:00,278,101,177
28753,28753,267,2022/4/15 9:10:00,219,109,110
28754,28754,267,2022/4/15 9:20:00,179,93,86
28755,28755,267,2022/4/15 9:30:00,103,96,7
28756,28756,267,2022/4/15 9:40:00,74,93,-19
28757,28757,267,2022/4/15 9:50:00,76,77,-1
28758,28758,267,2022/4/15 10:00:00,57,76,-19
28759,28759,267,2022/4/15 10:10:00,47,81,-34
28760,28760,267,2022/4/15 10:20:00,46,75,-29
28761,28761,267,2022/4/15 10:30:00,42,74,-32
28762,28762,267,2022/4/15 10:40:00,38,76,-38
28763,28763,267,2022/4/15 10:50:00,39,76,-37
28764,28764,267,2022/4/15 11:00:00,41,75,-34
28765,28765,267,2022/4/15 11:10:00,43,73,-30
28766,28766,267,2022/4/15 11:20:00,40,77,-37
28767,28767,267,2022/4/15 11:30:00,37,77,-40
28768,28768,267,2022/4/15 11:40:00,41,80,-39
28769,28769,267,2022/4/15 11:50:00,42,78,-36
28770,28770,267,2022/4/15 12:00:00,46,85,-39
28771,28771,267,2022/4/15 12:10:00,54,88,-34
28772,28772,267,2022/4/15 12:20:00,45,85,-40
28773,28773,267,2022/4/15 12:30:00,47,76,-29
28774,28774,267,2022/4/15 12:40:00,46,96,-50
28775,28775,267,2022/4/15 12:50:00,43,93,-50
28776,28776,267,2022/4/15 13:00:00,45,95,-50
28777,28777,267,2022/4/15 13:10:00,47,96,-49
28778,28778,267,2022/4/15 13:20:00,41,100,-59
28779,28779,267,2022/4/15 13:30:00,43,90,-47
28780,28780,267,2022/4/15 13:40:00,44,104,-60
28781,28781,267,2022/4/15 13:50:00,41,99,-58
28782,28782,267,2022/4/15 14:00:00,36,102,-66
28783,28783,267,2022/4/15 14:10:00,40,87,-47
28784,28784,267,2022/4/15 14:20:00,35,99,-64
28785,28785,267,2022/4/15 14:30:00,35,105,-70
28786,28786,267,2022/4/15 14:40:00,39,105,-66
28787,28787,267,2022/4/15 14:50:00,38,108,-70
28788,28788,267,2022/4/15 15:00:00,37,102,-65
28789,28789,267,2022/4/15 15:10:00,49,113,-64
28790,28790,267,2022/4/15 15:20:00,58,96,-38
28791,28791,267,2022/4/15 15:30:00,62,104,-42
28792,28792,267,2022/4/15 15:40:00,55,107,-52
28793,28793,267,2022/4/15 15:50:00,43,125,-82
28794,28794,267,2022/4/15 16:00:00,53,109,-56
28795,28795,267,2022/4/15 16:10:00,58,107,-49
28796,28796,267,2022/4/15 16:20:00,88,109,-21
28797,28797,267,2022/4/15 16:30:00,129,123,6
28798,28798,267,2022/4/15 16:40:00,92,108,-16
28799,28799,267,2022/4/15 16:50:00,142,133,9
28800,28800,267,2022/4/15 17:00:00,205,143,62
28801,28801,267,2022/4/15 17:10:00,230,158,72
28802,28802,267,2022/4/15 17:20:00,176,178,-2
28803,28803,267,2022/4/15 17:30:00,177,221,-44
28804,28804,267,2022/4/15 17:40:00,170,298,-128
28805,28805,267,2022/4/15 17:50:00,115,333,-218
28806,28806,267,2022/4/15 18:00:00,101,336,-235
28807,28807,267,2022/4/15 18:10:00,87,326,-239
28808,28808,267,2022/4/15 18:20:00,61,324,-263
28809,28809,267,2022/4/15 18:30:00,49,347,-298
28810,28810,267,2022/4/15 18:40:00,46,347,-301
28811,28811,267,2022/4/15 18:50:00,32,337,-305
28812,28812,267,2022/4/15 19:00:00,37,337,-300
28813,28813,267,2022/4/15 19:10:00,35,284,-249
28814,28814,267,2022/4/15 19:20:00,24,222,-198
28815,28815,267,2022/4/15 19:30:00,28,160,-132
28816,28816,267,2022/4/15 19:40:00,28,111,-83
28817,28817,267,2022/4/15 19:50:00,29,119,-90
28818,28818,267,2022/4/15 20:00:00,27,111,-84
28819,28819,267,2022/4/15 20:10:00,30,125,-95
28820,28820,267,2022/4/15 20:20:00,27,123,-96
28821,28821,267,2022/4/15 20:30:00,33,123,-90
28822,28822,267,2022/4/15 20:40:00,29,116,-87
28823,28823,267,2022/4/15 20:50:00,24,112,-88
28824,28824,267,2022/4/15 21:00:00,30,89,-59
28825,28825,267,2022/4/15 21:10:00,25,107,-82
28826,28826,267,2022/4/15 21:20:00,25,103,-78
28827,28827,267,2022/4/15 21:30:00,25,105,-80
28828,28828,267,2022/4/15 21:40:00,24,101,-77
28829,28829,267,2022/4/15 21:50:00,23,99,-76
28830,28830,267,2022/4/15 22:00:00,26,112,-86
28831,28831,267,2022/4/15 22:10:00,21,108,-87
28832,28832,267,2022/4/15 22:20:00,19,110,-91
28833,28833,267,2022/4/15 22:30:00,13,111,-98
28834,28834,267,2022/4/15 22:40:00,2,113,-111
28835,28835,267,2022/4/15 22:50:00,2,89,-87
28836,28836,268,2022/4/15 5:00:00,0,1,-1
28837,28837,268,2022/4/15 5:10:00,1,1,0
28838,28838,268,2022/4/15 5:20:00,8,1,7
28839,28839,268,2022/4/15 5:30:00,28,1,27
28840,28840,268,2022/4/15 5:40:00,22,21,1
28841,28841,268,2022/4/15 5:50:00,30,13,17
28842,28842,268,2022/4/15 6:00:00,39,13,26
28843,28843,268,2022/4/15 6:10:00,45,21,24
28844,28844,268,2022/4/15 6:20:00,56,60,-4
28845,28845,268,2022/4/15 6:30:00,74,68,6
28846,28846,268,2022/4/15 6:40:00,83,105,-22
28847,28847,268,2022/4/15 6:50:00,113,106,7
28848,28848,268,2022/4/15 7:00:00,158,125,33
28849,28849,268,2022/4/15 7:10:00,195,153,42
28850,28850,268,2022/4/15 7:20:00,239,146,93
28851,28851,268,2022/4/15 7:30:00,280,328,-48
28852,28852,268,2022/4/15 7:40:00,302,327,-25
28853,28853,268,2022/4/15 7:50:00,368,320,48
28854,28854,268,2022/4/15 8:00:00,477,179,298
28855,28855,268,2022/4/15 8:10:00,568,225,343
28856,28856,268,2022/4/15 8:20:00,387,225,162
28857,28857,268,2022/4/15 8:30:00,337,255,82
28858,28858,268,2022/4/15 8:40:00,277,333,-56
28859,28859,268,2022/4/15 8:50:00,260,217,43
28860,28860,268,2022/4/15 9:00:00,225,180,45
28861,28861,268,2022/4/15 9:10:00,177,139,38
28862,28862,268,2022/4/15 9:20:00,162,108,54
28863,28863,268,2022/4/15 9:30:00,139,117,22
28864,28864,268,2022/4/15 9:40:00,116,115,1
28865,28865,268,2022/4/15 9:50:00,90,118,-28
28866,28866,268,2022/4/15 10:00:00,73,120,-47
28867,28867,268,2022/4/15 10:10:00,82,125,-43
28868,28868,268,2022/4/15 10:20:00,70,110,-40
28869,28869,268,2022/4/15 10:30:00,75,104,-29
28870,28870,268,2022/4/15 10:40:00,72,99,-27
28871,28871,268,2022/4/15 10:50:00,67,106,-39
28872,28872,268,2022/4/15 11:00:00,67,92,-25
28873,28873,268,2022/4/15 11:10:00,66,93,-27
28874,28874,268,2022/4/15 11:20:00,69,77,-8
28875,28875,268,2022/4/15 11:30:00,65,102,-37
28876,28876,268,2022/4/15 11:40:00,69,81,-12
28877,28877,268,2022/4/15 11:50:00,65,90,-25
28878,28878,268,2022/4/15 12:00:00,61,83,-22
28879,28879,268,2022/4/15 12:10:00,69,95,-26
28880,28880,268,2022/4/15 12:20:00,56,87,-31
28881,28881,268,2022/4/15 12:30:00,54,102,-48
28882,28882,268,2022/4/15 12:40:00,45,99,-54
28883,28883,268,2022/4/15 12:50:00,47,115,-68
28884,28884,268,2022/4/15 13:00:00,44,102,-58
28885,28885,268,2022/4/15 13:10:00,47,122,-75
28886,28886,268,2022/4/15 13:20:00,47,106,-59
28887,28887,268,2022/4/15 13:30:00,48,112,-64
28888,28888,268,2022/4/15 13:40:00,60,110,-50
28889,28889,268,2022/4/15 13:50:00,62,107,-45
28890,28890,268,2022/4/15 14:00:00,69,100,-31
28891,28891,268,2022/4/15 14:10:00,74,87,-13
28892,28892,268,2022/4/15 14:20:00,80,107,-27
28893,28893,268,2022/4/15 14:30:00,70,106,-36
28894,28894,268,2022/4/15 14:40:00,70,109,-39
28895,28895,268,2022/4/15 14:50:00,83,86,-3
28896,28896,268,2022/4/15 15:00:00,77,108,-31
28897,28897,268,2022/4/15 15:10:00,73,109,-36
28898,28898,268,2022/4/15 15:20:00,74,102,-28
28899,28899,268,2022/4/15 15:30:00,75,114,-39
28900,28900,268,2022/4/15 15:40:00,77,109,-32
28901,28901,268,2022/4/15 15:50:00,93,100,-7
28902,28902,268,2022/4/15 16:00:00,133,105,28
28903,28903,268,2022/4/15 16:10:00,139,115,24
28904,28904,268,2022/4/15 16:20:00,164,108,56
28905,28905,268,2022/4/15 16:30:00,257,114,143
28906,28906,268,2022/4/15 16:40:00,213,108,105
28907,28907,268,2022/4/15 16:50:00,191,121,70
28908,28908,268,2022/4/15 17:00:00,222,118,104
28909,28909,268,2022/4/15 17:10:00,247,103,144
28910,28910,268,2022/4/15 17:20:00,206,116,90
28911,28911,268,2022/4/15 17:30:00,227,108,119
28912,28912,268,2022/4/15 17:40:00,238,153,85
28913,28913,268,2022/4/15 17:50:00,164,159,5
28914,28914,268,2022/4/15 18:00:00,177,213,-36
28915,28915,268,2022/4/15 18:10:00,199,180,19
28916,28916,268,2022/4/15 18:20:00,141,178,-37
28917,28917,268,2022/4/15 18:30:00,70,191,-121
28918,28918,268,2022/4/15 18:40:00,57,159,-102
28919,28919,268,2022/4/15 18:50:00,44,192,-148
28920,28920,268,2022/4/15 19:00:00,45,139,-94
28921,28921,268,2022/4/15 19:10:00,42,107,-65
28922,28922,268,2022/4/15 19:20:00,39,113,-74
28923,28923,268,2022/4/15 19:30:00,40,108,-68
28924,28924,268,2022/4/15 19:40:00,36,104,-68
28925,28925,268,2022/4/15 19:50:00,30,110,-80
28926,28926,268,2022/4/15 20:00:00,32,102,-70
28927,28927,268,2022/4/15 20:10:00,35,101,-66
28928,28928,268,2022/4/15 20:20:00,35,100,-65
28929,28929,268,2022/4/15 20:30:00,30,92,-62
28930,28930,268,2022/4/15 20:40:00,28,95,-67
28931,28931,268,2022/4/15 20:50:00,28,91,-63
28932,28932,268,2022/4/15 21:00:00,35,113,-78
28933,28933,268,2022/4/15 21:10:00,36,99,-63
28934,28934,268,2022/4/15 21:20:00,27,97,-70
28935,28935,268,2022/4/15 21:30:00,24,92,-68
28936,28936,268,2022/4/15 21:40:00,24,104,-80
28937,28937,268,2022/4/15 21:50:00,20,91,-71
28938,28938,268,2022/4/15 22:00:00,21,78,-57
28939,28939,268,2022/4/15 22:10:00,17,77,-60
28940,28940,268,2022/4/15 22:20:00,12,75,-63
28941,28941,268,2022/4/15 22:30:00,10,94,-84
28942,28942,268,2022/4/15 22:40:00,4,78,-74
28943,28943,268,2022/4/15 22:50:00,1,73,-72
28944,28944,269,2022/4/15 5:00:00,0,1,-1
28945,28945,269,2022/4/15 5:10:00,3,1,2
28946,28946,269,2022/4/15 5:20:00,26,1,25
28947,28947,269,2022/4/15 5:30:00,21,1,20
28948,28948,269,2022/4/15 5:40:00,23,1,22
28949,28949,269,2022/4/15 5:50:00,34,1,33
28950,28950,269,2022/4/15 6:00:00,44,1,43
28951,28951,269,2022/4/15 6:10:00,47,1,46
28952,28952,269,2022/4/15 6:20:00,59,1,58
28953,28953,269,2022/4/15 6:30:00,61,64,-3
28954,28954,269,2022/4/15 6:40:00,86,48,38
28955,28955,269,2022/4/15 6:50:00,174,67,107
28956,28956,269,2022/4/15 7:00:00,163,97,66
28957,28957,269,2022/4/15 7:10:00,299,98,201
28958,28958,269,2022/4/15 7:20:00,301,114,187
28959,28959,269,2022/4/15 7:30:00,368,133,235
28960,28960,269,2022/4/15 7:40:00,601,213,388
28961,28961,269,2022/4/15 7:50:00,603,181,422
28962,28962,269,2022/4/15 8:00:00,593,436,157
28963,28963,269,2022/4/15 8:10:00,391,224,167
28964,28964,269,2022/4/15 8:20:00,360,195,165
28965,28965,269,2022/4/15 8:30:00,256,211,45
28966,28966,269,2022/4/15 8:40:00,228,254,-26
28967,28967,269,2022/4/15 8:50:00,208,115,93
28968,28968,269,2022/4/15 9:00:00,144,114,30
28969,28969,269,2022/4/15 9:10:00,64,106,-42
28970,28970,269,2022/4/15 9:20:00,71,106,-35
28971,28971,269,2022/4/15 9:30:00,56,109,-53
28972,28972,269,2022/4/15 9:40:00,40,100,-60
28973,28973,269,2022/4/15 9:50:00,41,96,-55
28974,28974,269,2022/4/15 10:00:00,38,76,-38
28975,28975,269,2022/4/15 10:10:00,34,91,-57
28976,28976,269,2022/4/15 10:20:00,34,62,-28
28977,28977,269,2022/4/15 10:30:00,33,72,-39
28978,28978,269,2022/4/15 10:40:00,30,87,-57
28979,28979,269,2022/4/15 10:50:00,31,81,-50
28980,28980,269,2022/4/15 11:00:00,33,65,-32
28981,28981,269,2022/4/15 11:10:00,27,65,-38
28982,28982,269,2022/4/15 11:20:00,32,81,-49
28983,28983,269,2022/4/15 11:30:00,29,77,-48
28984,28984,269,2022/4/15 11:40:00,35,68,-33
28985,28985,269,2022/4/15 11:50:00,34,74,-40
28986,28986,269,2022/4/15 12:00:00,34,76,-42
28987,28987,269,2022/4/15 12:10:00,25,87,-62
28988,28988,269,2022/4/15 12:20:00,45,67,-22
28989,28989,269,2022/4/15 12:30:00,36,73,-37
28990,28990,269,2022/4/15 12:40:00,36,91,-55
28991,28991,269,2022/4/15 12:50:00,36,90,-54
28992,28992,269,2022/4/15 13:00:00,33,70,-37
28993,28993,269,2022/4/15 13:10:00,27,64,-37
28994,28994,269,2022/4/15 13:20:00,37,96,-59
28995,28995,269,2022/4/15 13:30:00,24,93,-69
28996,28996,269,2022/4/15 13:40:00,36,71,-35
28997,28997,269,2022/4/15 13:50:00,31,61,-30
28998,28998,269,2022/4/15 14:00:00,27,92,-65
28999,28999,269,2022/4/15 14:10:00,33,87,-54
29000,29000,269,2022/4/15 14:20:00,33,82,-49
29001,29001,269,2022/4/15 14:30:00,28,75,-47
29002,29002,269,2022/4/15 14:40:00,34,90,-56
29003,29003,269,2022/4/15 14:50:00,26,100,-74
29004,29004,269,2022/4/15 15:00:00,28,77,-49
29005,29005,269,2022/4/15 15:10:00,29,73,-44
29006,29006,269,2022/4/15 15:20:00,37,100,-63
29007,29007,269,2022/4/15 15:30:00,27,104,-77
29008,29008,269,2022/4/15 15:40:00,37,97,-60
29009,29009,269,2022/4/15 15:50:00,41,87,-46
29010,29010,269,2022/4/15 16:00:00,32,101,-69
29011,29011,269,2022/4/15 16:10:00,38,125,-87
29012,29012,269,2022/4/15 16:20:00,45,96,-51
29013,29013,269,2022/4/15 16:30:00,268,101,167
29014,29014,269,2022/4/15 16:40:00,115,119,-4
29015,29015,269,2022/4/15 16:50:00,62,119,-57
29016,29016,269,2022/4/15 17:00:00,244,112,132
29017,29017,269,2022/4/15 17:10:00,213,109,104
29018,29018,269,2022/4/15 17:20:00,175,190,-15
29019,29019,269,2022/4/15 17:30:00,143,119,24
29020,29020,269,2022/4/15 17:40:00,205,206,-1
29021,29021,269,2022/4/15 17:50:00,171,125,46
29022,29022,269,2022/4/15 18:00:00,71,283,-212
29023,29023,269,2022/4/15 18:10:00,54,149,-95
29024,29024,269,2022/4/15 18:20:00,49,327,-278
29025,29025,269,2022/4/15 18:30:00,44,179,-135
29026,29026,269,2022/4/15 18:40:00,28,283,-255
29027,29027,269,2022/4/15 18:50:00,31,190,-159
29028,29028,269,2022/4/15 19:00:00,32,327,-295
29029,29029,269,2022/4/15 19:10:00,26,217,-191
29030,29030,269,2022/4/15 19:20:00,23,312,-289
29031,29031,269,2022/4/15 19:30:00,28,132,-104
29032,29032,269,2022/4/15 19:40:00,22,184,-162
29033,29033,269,2022/4/15 19:50:00,24,106,-82
29034,29034,269,2022/4/15 20:00:00,25,110,-85
29035,29035,269,2022/4/15 20:10:00,23,95,-72
29036,29036,269,2022/4/15 20:20:00,22,126,-104
29037,29037,269,2022/4/15 20:30:00,28,110,-82
29038,29038,269,2022/4/15 20:40:00,18,104,-86
29039,29039,269,2022/4/15 20:50:00,22,106,-84
29040,29040,269,2022/4/15 21:00:00,14,97,-83
29041,29041,269,2022/4/15 21:10:00,15,103,-88
29042,29042,269,2022/4/15 21:20:00,20,92,-72
29043,29043,269,2022/4/15 21:30:00,13,95,-82
29044,29044,269,2022/4/15 21:40:00,13,93,-80
29045,29045,269,2022/4/15 21:50:00,14,89,-75
29046,29046,269,2022/4/15 22:00:00,6,95,-89
29047,29047,269,2022/4/15 22:10:00,6,85,-79
29048,29048,269,2022/4/15 22:20:00,7,76,-69
29049,29049,269,2022/4/15 22:30:00,2,103,-101
29050,29050,269,2022/4/15 22:40:00,0,94,-94
29051,29051,269,2022/4/15 22:50:00,1,75,-74
29052,29052,270,2022/4/15 5:00:00,0,1,-1
29053,29053,270,2022/4/15 5:10:00,1,1,0
29054,29054,270,2022/4/15 5:20:00,1,1,0
29055,29055,270,2022/4/15 5:30:00,8,1,7
29056,29056,270,2022/4/15 5:40:00,19,1,18
29057,29057,270,2022/4/15 5:50:00,36,11,25
29058,29058,270,2022/4/15 6:00:00,35,42,-7
29059,29059,270,2022/4/15 6:10:00,47,51,-4
29060,29060,270,2022/4/15 6:20:00,53,65,-12
29061,29061,270,2022/4/15 6:30:00,72,76,-4
29062,29062,270,2022/4/15 6:40:00,70,93,-23
29063,29063,270,2022/4/15 6:50:00,150,104,46
29064,29064,270,2022/4/15 7:00:00,165,119,46
29065,29065,270,2022/4/15 7:10:00,190,109,81
29066,29066,270,2022/4/15 7:20:00,200,110,90
29067,29067,270,2022/4/15 7:30:00,216,147,69
29068,29068,270,2022/4/15 7:40:00,258,235,23
29069,29069,270,2022/4/15 7:50:00,338,270,68
29070,29070,270,2022/4/15 8:00:00,369,333,36
29071,29071,270,2022/4/15 8:10:00,575,501,74
29072,29072,270,2022/4/15 8:20:00,446,443,3
29073,29073,270,2022/4/15 8:30:00,481,420,61
29074,29074,270,2022/4/15 8:40:00,351,630,-279
29075,29075,270,2022/4/15 8:50:00,278,580,-302
29076,29076,270,2022/4/15 9:00:00,269,508,-239
29077,29077,270,2022/4/15 9:10:00,238,324,-86
29078,29078,270,2022/4/15 9:20:00,219,331,-112
29079,29079,270,2022/4/15 9:30:00,177,254,-77
29080,29080,270,2022/4/15 9:40:00,145,217,-72
29081,29081,270,2022/4/15 9:50:00,108,220,-112
29082,29082,270,2022/4/15 10:00:00,100,144,-44
29083,29083,270,2022/4/15 10:10:00,91,139,-48
29084,29084,270,2022/4/15 10:20:00,76,124,-48
29085,29085,270,2022/4/15 10:30:00,76,110,-34
29086,29086,270,2022/4/15 10:40:00,73,124,-51
29087,29087,270,2022/4/15 10:50:00,67,123,-56
29088,29088,270,2022/4/15 11:00:00,65,122,-57
29089,29089,270,2022/4/15 11:10:00,70,101,-31
29090,29090,270,2022/4/15 11:20:00,76,109,-33
29091,29091,270,2022/4/15 11:30:00,86,101,-15
29092,29092,270,2022/4/15 11:40:00,76,119,-43
29093,29093,270,2022/4/15 11:50:00,108,122,-14
29094,29094,270,2022/4/15 12:00:00,101,125,-24
29095,29095,270,2022/4/15 12:10:00,92,110,-18
29096,29096,270,2022/4/15 12:20:00,102,107,-5
29097,29097,270,2022/4/15 12:30:00,88,108,-20
29098,29098,270,2022/4/15 12:40:00,110,115,-5
29099,29099,270,2022/4/15 12:50:00,82,106,-24
29100,29100,270,2022/4/15 13:00:00,132,121,11
29101,29101,270,2022/4/15 13:10:00,92,106,-14
29102,29102,270,2022/4/15 13:20:00,104,122,-18
29103,29103,270,2022/4/15 13:30:00,96,109,-13
29104,29104,270,2022/4/15 13:40:00,114,121,-7
29105,29105,270,2022/4/15 13:50:00,89,109,-20
29106,29106,270,2022/4/15 14:00:00,130,122,8
29107,29107,270,2022/4/15 14:10:00,96,121,-25
29108,29108,270,2022/4/15 14:20:00,128,104,24
29109,29109,270,2022/4/15 14:30:00,102,114,-12
29110,29110,270,2022/4/15 14:40:00,132,117,15
29111,29111,270,2022/4/15 14:50:00,131,108,23
29112,29112,270,2022/4/15 15:00:00,128,124,4
29113,29113,270,2022/4/15 15:10:00,174,109,65
29114,29114,270,2022/4/15 15:20:00,175,121,54
29115,29115,270,2022/4/15 15:30:00,164,105,59
29116,29116,270,2022/4/15 15:40:00,174,121,53
29117,29117,270,2022/4/15 15:50:00,174,125,49
29118,29118,270,2022/4/15 16:00:00,210,116,94
29119,29119,270,2022/4/15 16:10:00,218,125,93
29120,29120,270,2022/4/15 16:20:00,205,109,96
29121,29121,270,2022/4/15 16:30:00,265,125,140
29122,29122,270,2022/4/15 16:40:00,269,106,163
29123,29123,270,2022/4/15 16:50:00,265,112,153
29124,29124,270,2022/4/15 17:00:00,546,110,436
29125,29125,270,2022/4/15 17:10:00,580,191,389
29126,29126,270,2022/4/15 17:20:00,352,212,140
29127,29127,270,2022/4/15 17:30:00,609,207,402
29128,29128,270,2022/4/15 17:40:00,699,233,466
29129,29129,270,2022/4/15 17:50:00,364,283,81
29130,29130,270,2022/4/15 18:00:00,581,269,312
29131,29131,270,2022/4/15 18:10:00,641,269,372
29132,29132,270,2022/4/15 18:20:00,355,322,33
29133,29133,270,2022/4/15 18:30:00,292,284,8
29134,29134,270,2022/4/15 18:40:00,273,197,76
29135,29135,270,2022/4/15 18:50:00,237,196,41
29136,29136,270,2022/4/15 19:00:00,227,150,77
29137,29137,270,2022/4/15 19:10:00,185,117,68
29138,29138,270,2022/4/15 19:20:00,134,110,24
29139,29139,270,2022/4/15 19:30:00,114,105,9
29140,29140,270,2022/4/15 19:40:00,86,122,-36
29141,29141,270,2022/4/15 19:50:00,77,107,-30
29142,29142,270,2022/4/15 20:00:00,76,107,-31
29143,29143,270,2022/4/15 20:10:00,75,113,-38
29144,29144,270,2022/4/15 20:20:00,70,114,-44
29145,29145,270,2022/4/15 20:30:00,70,107,-37
29146,29146,270,2022/4/15 20:40:00,68,113,-45
29147,29147,270,2022/4/15 20:50:00,61,110,-49
29148,29148,270,2022/4/15 21:00:00,77,113,-36
29149,29149,270,2022/4/15 21:10:00,67,104,-37
29150,29150,270,2022/4/15 21:20:00,45,126,-81
29151,29151,270,2022/4/15 21:30:00,43,102,-59
29152,29152,270,2022/4/15 21:40:00,41,110,-69
29153,29153,270,2022/4/15 21:50:00,35,107,-72
29154,29154,270,2022/4/15 22:00:00,41,113,-72
29155,29155,270,2022/4/15 22:10:00,29,110,-81
29156,29156,270,2022/4/15 22:20:00,28,124,-96
29157,29157,270,2022/4/15 22:30:00,19,105,-86
29158,29158,270,2022/4/15 22:40:00,13,73,-60
29159,29159,270,2022/4/15 22:50:00,8,71,-63
29160,29160,271,2022/4/15 5:00:00,0,1,-1
29161,29161,271,2022/4/15 5:10:00,5,1,4
29162,29162,271,2022/4/15 5:20:00,21,1,20
29163,29163,271,2022/4/15 5:30:00,29,1,28
29164,29164,271,2022/4/15 5:40:00,28,1,27
29165,29165,271,2022/4/15 5:50:00,32,1,31
29166,29166,271,2022/4/15 6:00:00,36,1,35
29167,29167,271,2022/4/15 6:10:00,34,1,33
29168,29168,271,2022/4/15 6:20:00,43,1,42
29169,29169,271,2022/4/15 6:30:00,53,25,28
29170,29170,271,2022/4/15 6:40:00,61,25,36
29171,29171,271,2022/4/15 6:50:00,71,35,36
29172,29172,271,2022/4/15 7:00:00,89,36,53
29173,29173,271,2022/4/15 7:10:00,214,51,163
29174,29174,271,2022/4/15 7:20:00,239,67,172
29175,29175,271,2022/4/15 7:30:00,303,114,189
29176,29176,271,2022/4/15 7:40:00,449,108,341
29177,29177,271,2022/4/15 7:50:00,575,105,470
29178,29178,271,2022/4/15 8:00:00,599,124,475
29179,29179,271,2022/4/15 8:10:00,351,122,229
29180,29180,271,2022/4/15 8:20:00,277,110,167
29181,29181,271,2022/4/15 8:30:00,227,144,83
29182,29182,271,2022/4/15 8:40:00,191,226,-35
29183,29183,271,2022/4/15 8:50:00,113,117,-4
29184,29184,271,2022/4/15 9:00:00,64,115,-51
29185,29185,271,2022/4/15 9:10:00,49,106,-57
29186,29186,271,2022/4/15 9:20:00,42,93,-51
29187,29187,271,2022/4/15 9:30:00,29,76,-47
29188,29188,271,2022/4/15 9:40:00,31,64,-33
29189,29189,271,2022/4/15 9:50:00,28,74,-46
29190,29190,271,2022/4/15 10:00:00,27,69,-42
29191,29191,271,2022/4/15 10:10:00,28,45,-17
29192,29192,271,2022/4/15 10:20:00,25,62,-37
29193,29193,271,2022/4/15 10:30:00,21,45,-24
29194,29194,271,2022/4/15 10:40:00,24,44,-20
29195,29195,271,2022/4/15 10:50:00,23,45,-22
29196,29196,271,2022/4/15 11:00:00,22,59,-37
29197,29197,271,2022/4/15 11:10:00,23,38,-15
29198,29198,271,2022/4/15 11:20:00,25,38,-13
29199,29199,271,2022/4/15 11:30:00,24,45,-21
29200,29200,271,2022/4/15 11:40:00,22,58,-36
29201,29201,271,2022/4/15 11:50:00,28,38,-10
29202,29202,271,2022/4/15 12:00:00,29,40,-11
29203,29203,271,2022/4/15 12:10:00,27,41,-14
29204,29204,271,2022/4/15 12:20:00,29,62,-33
29205,29205,271,2022/4/15 12:30:00,29,46,-17
29206,29206,271,2022/4/15 12:40:00,25,47,-22
29207,29207,271,2022/4/15 12:50:00,25,50,-25
29208,29208,271,2022/4/15 13:00:00,27,68,-41
29209,29209,271,2022/4/15 13:10:00,27,51,-24
29210,29210,271,2022/4/15 13:20:00,25,51,-26
29211,29211,271,2022/4/15 13:30:00,19,48,-29
29212,29212,271,2022/4/15 13:40:00,25,69,-44
29213,29213,271,2022/4/15 13:50:00,20,49,-29
29214,29214,271,2022/4/15 14:00:00,23,47,-24
29215,29215,271,2022/4/15 14:10:00,20,56,-36
29216,29216,271,2022/4/15 14:20:00,23,67,-44
29217,29217,271,2022/4/15 14:30:00,21,50,-29
29218,29218,271,2022/4/15 14:40:00,20,54,-34
29219,29219,271,2022/4/15 14:50:00,23,53,-30
29220,29220,271,2022/4/15 15:00:00,21,70,-49
29221,29221,271,2022/4/15 15:10:00,20,51,-31
29222,29222,271,2022/4/15 15:20:00,26,48,-22
29223,29223,271,2022/4/15 15:30:00,23,54,-31
29224,29224,271,2022/4/15 15:40:00,25,83,-58
29225,29225,271,2022/4/15 15:50:00,23,64,-41
29226,29226,271,2022/4/15 16:00:00,27,66,-39
29227,29227,271,2022/4/15 16:10:00,25,73,-48
29228,29228,271,2022/4/15 16:20:00,31,90,-59
29229,29229,271,2022/4/15 16:30:00,39,69,-30
29230,29230,271,2022/4/15 16:40:00,204,70,134
29231,29231,271,2022/4/15 16:50:00,31,68,-37
29232,29232,271,2022/4/15 17:00:00,35,106,-71
29233,29233,271,2022/4/15 17:10:00,73,85,-12
29234,29234,271,2022/4/15 17:20:00,51,79,-28
29235,29235,271,2022/4/15 17:30:00,85,125,-40
29236,29236,271,2022/4/15 17:40:00,161,80,81
29237,29237,271,2022/4/15 17:50:00,43,132,-89
29238,29238,271,2022/4/15 18:00:00,46,110,-64
29239,29239,271,2022/4/15 18:10:00,65,151,-86
29240,29240,271,2022/4/15 18:20:00,43,126,-83
29241,29241,271,2022/4/15 18:30:00,37,197,-160
29242,29242,271,2022/4/15 18:40:00,25,104,-79
29243,29243,271,2022/4/15 18:50:00,30,182,-152
29244,29244,271,2022/4/15 19:00:00,24,109,-85
29245,29245,271,2022/4/15 19:10:00,27,234,-207
29246,29246,271,2022/4/15 19:20:00,21,117,-96
29247,29247,271,2022/4/15 19:30:00,16,192,-176
29248,29248,271,2022/4/15 19:40:00,19,107,-88
29249,29249,271,2022/4/15 19:50:00,15,113,-98
29250,29250,271,2022/4/15 20:00:00,18,80,-62
29251,29251,271,2022/4/15 20:10:00,15,104,-89
29252,29252,271,2022/4/15 20:20:00,13,84,-71
29253,29253,271,2022/4/15 20:30:00,13,106,-93
29254,29254,271,2022/4/15 20:40:00,17,96,-79
29255,29255,271,2022/4/15 20:50:00,13,73,-60
29256,29256,271,2022/4/15 21:00:00,12,104,-92
29257,29257,271,2022/4/15 21:10:00,11,92,-81
29258,29258,271,2022/4/15 21:20:00,10,78,-68
29259,29259,271,2022/4/15 21:30:00,7,101,-94
29260,29260,271,2022/4/15 21:40:00,8,77,-69
29261,29261,271,2022/4/15 21:50:00,6,76,-70
29262,29262,271,2022/4/15 22:00:00,7,85,-78
29263,29263,271,2022/4/15 22:10:00,3,75,-72
29264,29264,271,2022/4/15 22:20:00,1,73,-72
29265,29265,271,2022/4/15 22:30:00,1,74,-73
29266,29266,271,2022/4/15 22:40:00,0,71,-71
29267,29267,271,2022/4/15 22:50:00,0,94,-94
29268,29268,272,2022/4/15 5:00:00,0,1,-1
29269,29269,272,2022/4/15 5:10:00,0,1,-1
29270,29270,272,2022/4/15 5:20:00,7,1,6
29271,29271,272,2022/4/15 5:30:00,25,1,24
29272,29272,272,2022/4/15 5:40:00,34,8,26
29273,29273,272,2022/4/15 5:50:00,41,2,39
29274,29274,272,2022/4/15 6:00:00,59,5,54
29275,29275,272,2022/4/15 6:10:00,69,8,61
29276,29276,272,2022/4/15 6:20:00,109,45,64
29277,29277,272,2022/4/15 6:30:00,163,47,116
29278,29278,272,2022/4/15 6:40:00,207,58,149
29279,29279,272,2022/4/15 6:50:00,217,59,158
29280,29280,272,2022/4/15 7:00:00,217,77,140
29281,29281,272,2022/4/15 7:10:00,279,71,208
29282,29282,272,2022/4/15 7:20:00,334,79,255
29283,29283,272,2022/4/15 7:30:00,478,83,395
29284,29284,272,2022/4/15 7:40:00,600,77,523
29285,29285,272,2022/4/15 7:50:00,705,90,615
29286,29286,272,2022/4/15 8:00:00,742,83,659
29287,29287,272,2022/4/15 8:10:00,720,111,609
29288,29288,272,2022/4/15 8:20:00,577,93,484
29289,29289,272,2022/4/15 8:30:00,393,105,288
29290,29290,272,2022/4/15 8:40:00,319,88,231
29291,29291,272,2022/4/15 8:50:00,281,76,205
29292,29292,272,2022/4/15 9:00:00,207,59,148
29293,29293,272,2022/4/15 9:10:00,179,64,115
29294,29294,272,2022/4/15 9:20:00,139,62,77
29295,29295,272,2022/4/15 9:30:00,66,61,5
29296,29296,272,2022/4/15 9:40:00,51,66,-15
29297,29297,272,2022/4/15 9:50:00,48,60,-12
29298,29298,272,2022/4/15 10:00:00,44,60,-16
29299,29299,272,2022/4/15 10:10:00,37,48,-11
29300,29300,272,2022/4/15 10:20:00,31,47,-16
29301,29301,272,2022/4/15 10:30:00,27,66,-39
29302,29302,272,2022/4/15 10:40:00,29,50,-21
29303,29303,272,2022/4/15 10:50:00,35,47,-12
29304,29304,272,2022/4/15 11:00:00,31,51,-20
29305,29305,272,2022/4/15 11:10:00,32,68,-36
29306,29306,272,2022/4/15 11:20:00,29,51,-22
29307,29307,272,2022/4/15 11:30:00,26,47,-21
29308,29308,272,2022/4/15 11:40:00,27,54,-27
29309,29309,272,2022/4/15 11:50:00,30,67,-37
29310,29310,272,2022/4/15 12:00:00,32,61,-29
29311,29311,272,2022/4/15 12:10:00,36,62,-26
29312,29312,272,2022/4/15 12:20:00,35,49,-14
29313,29313,272,2022/4/15 12:30:00,33,76,-43
29314,29314,272,2022/4/15 12:40:00,30,52,-22
29315,29315,272,2022/4/15 12:50:00,28,52,-24
29316,29316,272,2022/4/15 13:00:00,31,59,-28
29317,29317,272,2022/4/15 13:10:00,27,70,-43
29318,29318,272,2022/4/15 13:20:00,29,56,-27
29319,29319,272,2022/4/15 13:30:00,30,49,-19
29320,29320,272,2022/4/15 13:40:00,28,61,-33
29321,29321,272,2022/4/15 13:50:00,25,69,-44
29322,29322,272,2022/4/15 14:00:00,27,62,-35
29323,29323,272,2022/4/15 14:10:00,25,66,-41
29324,29324,272,2022/4/15 14:20:00,27,65,-38
29325,29325,272,2022/4/15 14:30:00,29,81,-52
29326,29326,272,2022/4/15 14:40:00,23,67,-44
29327,29327,272,2022/4/15 14:50:00,25,70,-45
29328,29328,272,2022/4/15 15:00:00,26,72,-46
29329,29329,272,2022/4/15 15:10:00,26,90,-64
29330,29330,272,2022/4/15 15:20:00,24,71,-47
29331,29331,272,2022/4/15 15:30:00,27,62,-35
29332,29332,272,2022/4/15 15:40:00,25,70,-45
29333,29333,272,2022/4/15 15:50:00,27,96,-69
29334,29334,272,2022/4/15 16:00:00,27,104,-77
29335,29335,272,2022/4/15 16:10:00,33,74,-41
29336,29336,272,2022/4/15 16:20:00,30,80,-50
29337,29337,272,2022/4/15 16:30:00,35,105,-70
29338,29338,272,2022/4/15 16:40:00,29,106,-77
29339,29339,272,2022/4/15 16:50:00,33,106,-73
29340,29340,272,2022/4/15 17:00:00,45,98,-53
29341,29341,272,2022/4/15 17:10:00,46,108,-62
29342,29342,272,2022/4/15 17:20:00,45,97,-52
29343,29343,272,2022/4/15 17:30:00,37,184,-147
29344,29344,272,2022/4/15 17:40:00,36,110,-74
29345,29345,272,2022/4/15 17:50:00,41,206,-165
29346,29346,272,2022/4/15 18:00:00,43,108,-65
29347,29347,272,2022/4/15 18:10:00,39,180,-141
29348,29348,272,2022/4/15 18:20:00,33,180,-147
29349,29349,272,2022/4/15 18:30:00,38,216,-178
29350,29350,272,2022/4/15 18:40:00,30,199,-169
29351,29351,272,2022/4/15 18:50:00,29,235,-206
29352,29352,272,2022/4/15 19:00:00,26,235,-209
29353,29353,272,2022/4/15 19:10:00,25,258,-233
29354,29354,272,2022/4/15 19:20:00,23,150,-127
29355,29355,272,2022/4/15 19:30:00,25,160,-135
29356,29356,272,2022/4/15 19:40:00,19,98,-79
29357,29357,272,2022/4/15 19:50:00,19,133,-114
29358,29358,272,2022/4/15 20:00:00,17,105,-88
29359,29359,272,2022/4/15 20:10:00,19,120,-101
29360,29360,272,2022/4/15 20:20:00,17,124,-107
29361,29361,272,2022/4/15 20:30:00,17,115,-98
29362,29362,272,2022/4/15 20:40:00,20,88,-68
29363,29363,272,2022/4/15 20:50:00,14,128,-114
29364,29364,272,2022/4/15 21:00:00,17,105,-88
29365,29365,272,2022/4/15 21:10:00,15,113,-98
29366,29366,272,2022/4/15 21:20:00,13,113,-100
29367,29367,272,2022/4/15 21:30:00,13,89,-76
29368,29368,272,2022/4/15 21:40:00,13,104,-91
29369,29369,272,2022/4/15 21:50:00,11,108,-97
29370,29370,272,2022/4/15 22:00:00,10,104,-94
29371,29371,272,2022/4/15 22:10:00,9,110,-101
29372,29372,272,2022/4/15 22:20:00,8,105,-97
29373,29373,272,2022/4/15 22:30:00,5,153,-148
29374,29374,272,2022/4/15 22:40:00,2,105,-103
29375,29375,272,2022/4/15 22:50:00,1,85,-84
29376,29376,273,2022/4/15 5:00:00,0,1,-1
29377,29377,273,2022/4/15 5:10:00,2,1,1
29378,29378,273,2022/4/15 5:20:00,25,1,24
29379,29379,273,2022/4/15 5:30:00,59,1,58
29380,29380,273,2022/4/15 5:40:00,45,1,44
29381,29381,273,2022/4/15 5:50:00,59,1,58
29382,29382,273,2022/4/15 6:00:00,83,1,82
29383,29383,273,2022/4/15 6:10:00,109,1,108
29384,29384,273,2022/4/15 6:20:00,175,36,139
29385,29385,273,2022/4/15 6:30:00,255,23,232
29386,29386,273,2022/4/15 6:40:00,280,45,235
29387,29387,273,2022/4/15 6:50:00,349,64,285
29388,29388,273,2022/4/15 7:00:00,568,66,502
29389,29389,273,2022/4/15 7:10:00,592,45,547
29390,29390,273,2022/4/15 7:20:00,684,76,608
29391,29391,273,2022/4/15 7:30:00,868,69,799
29392,29392,273,2022/4/15 7:40:00,1051,93,958
29393,29393,273,2022/4/15 7:50:00,1214,93,1121
29394,29394,273,2022/4/15 8:00:00,1366,99,1267
29395,29395,273,2022/4/15 8:10:00,1169,105,1064
29396,29396,273,2022/4/15 8:20:00,819,117,702
29397,29397,273,2022/4/15 8:30:00,630,126,504
29398,29398,273,2022/4/15 8:40:00,599,87,512
29399,29399,273,2022/4/15 8:50:00,326,105,221
29400,29400,273,2022/4/15 9:00:00,271,101,170
29401,29401,273,2022/4/15 9:10:00,247,83,164
29402,29402,273,2022/4/15 9:20:00,182,82,100
29403,29403,273,2022/4/15 9:30:00,76,73,3
29404,29404,273,2022/4/15 9:40:00,72,94,-22
29405,29405,273,2022/4/15 9:50:00,61,71,-10
29406,29406,273,2022/4/15 10:00:00,47,66,-19
29407,29407,273,2022/4/15 10:10:00,46,91,-45
29408,29408,273,2022/4/15 10:20:00,45,71,-26
29409,29409,273,2022/4/15 10:30:00,43,70,-27
29410,29410,273,2022/4/15 10:40:00,45,65,-20
29411,29411,273,2022/4/15 10:50:00,36,76,-40
29412,29412,273,2022/4/15 11:00:00,39,66,-27
29413,29413,273,2022/4/15 11:10:00,38,63,-25
29414,29414,273,2022/4/15 11:20:00,43,60,-17
29415,29415,273,2022/4/15 11:30:00,38,77,-39
29416,29416,273,2022/4/15 11:40:00,37,66,-29
29417,29417,273,2022/4/15 11:50:00,37,62,-25
29418,29418,273,2022/4/15 12:00:00,45,70,-25
29419,29419,273,2022/4/15 12:10:00,42,91,-49
29420,29420,273,2022/4/15 12:20:00,45,62,-17
29421,29421,273,2022/4/15 12:30:00,41,68,-27
29422,29422,273,2022/4/15 12:40:00,43,63,-20
29423,29423,273,2022/4/15 12:50:00,44,88,-44
29424,29424,273,2022/4/15 13:00:00,36,75,-39
29425,29425,273,2022/4/15 13:10:00,43,62,-19
29426,29426,273,2022/4/15 13:20:00,39,67,-28
29427,29427,273,2022/4/15 13:30:00,36,105,-69
29428,29428,273,2022/4/15 13:40:00,32,77,-45
29429,29429,273,2022/4/15 13:50:00,35,70,-35
29430,29430,273,2022/4/15 14:00:00,31,82,-51
29431,29431,273,2022/4/15 14:10:00,31,110,-79
29432,29432,273,2022/4/15 14:20:00,32,80,-48
29433,29433,273,2022/4/15 14:30:00,35,63,-28
29434,29434,273,2022/4/15 14:40:00,31,72,-41
29435,29435,273,2022/4/15 14:50:00,27,112,-85
29436,29436,273,2022/4/15 15:00:00,29,87,-58
29437,29437,273,2022/4/15 15:10:00,29,76,-47
29438,29438,273,2022/4/15 15:20:00,31,76,-45
29439,29439,273,2022/4/15 15:30:00,29,122,-93
29440,29440,273,2022/4/15 15:40:00,31,99,-68
29441,29441,273,2022/4/15 15:50:00,32,98,-66
29442,29442,273,2022/4/15 16:00:00,33,112,-79
29443,29443,273,2022/4/15 16:10:00,39,130,-91
29444,29444,273,2022/4/15 16:20:00,36,96,-60
29445,29445,273,2022/4/15 16:30:00,45,106,-61
29446,29446,273,2022/4/15 16:40:00,46,118,-72
29447,29447,273,2022/4/15 16:50:00,41,180,-139
29448,29448,273,2022/4/15 17:00:00,68,106,-38
29449,29449,273,2022/4/15 17:10:00,74,117,-43
29450,29450,273,2022/4/15 17:20:00,62,267,-205
29451,29451,273,2022/4/15 17:30:00,47,178,-131
29452,29452,273,2022/4/15 17:40:00,64,266,-202
29453,29453,273,2022/4/15 17:50:00,68,328,-260
29454,29454,273,2022/4/15 18:00:00,43,333,-290
29455,29455,273,2022/4/15 18:10:00,45,318,-273
29456,29456,273,2022/4/15 18:20:00,45,301,-256
29457,29457,273,2022/4/15 18:30:00,44,323,-279
29458,29458,273,2022/4/15 18:40:00,41,327,-286
29459,29459,273,2022/4/15 18:50:00,33,303,-270
29460,29460,273,2022/4/15 19:00:00,35,366,-331
29461,29461,273,2022/4/15 19:10:00,30,378,-348
29462,29462,273,2022/4/15 19:20:00,32,348,-316
29463,29463,273,2022/4/15 19:30:00,25,191,-166
29464,29464,273,2022/4/15 19:40:00,29,221,-192
29465,29465,273,2022/4/15 19:50:00,29,113,-84
29466,29466,273,2022/4/15 20:00:00,28,185,-157
29467,29467,273,2022/4/15 20:10:00,24,106,-82
29468,29468,273,2022/4/15 20:20:00,21,119,-98
29469,29469,273,2022/4/15 20:30:00,29,107,-78
29470,29470,273,2022/4/15 20:40:00,20,109,-89
29471,29471,273,2022/4/15 20:50:00,21,108,-87
29472,29472,273,2022/4/15 21:00:00,20,192,-172
29473,29473,273,2022/4/15 21:10:00,17,90,-73
29474,29474,273,2022/4/15 21:20:00,14,111,-97
29475,29475,273,2022/4/15 21:30:00,16,108,-92
29476,29476,273,2022/4/15 21:40:00,17,160,-143
29477,29477,273,2022/4/15 21:50:00,12,122,-110
29478,29478,273,2022/4/15 22:00:00,12,98,-86
29479,29479,273,2022/4/15 22:10:00,9,102,-93
29480,29480,273,2022/4/15 22:20:00,7,104,-97
29481,29481,273,2022/4/15 22:30:00,6,106,-100
29482,29482,273,2022/4/15 22:40:00,1,116,-115
29483,29483,273,2022/4/15 22:50:00,1,105,-104
29484,29484,274,2022/4/15 5:00:00,0,1,-1
29485,29485,274,2022/4/15 5:10:00,0,1,-1
29486,29486,274,2022/4/15 5:20:00,2,1,1
29487,29487,274,2022/4/15 5:30:00,9,1,8
29488,29488,274,2022/4/15 5:40:00,12,8,4
29489,29489,274,2022/4/15 5:50:00,29,2,27
29490,29490,274,2022/4/15 6:00:00,35,61,-26
29491,29491,274,2022/4/15 6:10:00,37,63,-26
29492,29492,274,2022/4/15 6:20:00,47,83,-36
29493,29493,274,2022/4/15 6:30:00,76,75,1
29494,29494,274,2022/4/15 6:40:00,108,110,-2
29495,29495,274,2022/4/15 6:50:00,163,197,-34
29496,29496,274,2022/4/15 7:00:00,192,439,-247
29497,29497,274,2022/4/15 7:10:00,255,419,-164
29498,29498,274,2022/4/15 7:20:00,260,425,-165
29499,29499,274,2022/4/15 7:30:00,278,426,-148
29500,29500,274,2022/4/15 7:40:00,371,500,-129
29501,29501,274,2022/4/15 7:50:00,631,506,125
29502,29502,274,2022/4/15 8:00:00,690,425,265
29503,29503,274,2022/4/15 8:10:00,687,600,87
29504,29504,274,2022/4/15 8:20:00,725,560,165
29505,29505,274,2022/4/15 8:30:00,655,601,54
29506,29506,274,2022/4/15 8:40:00,595,1591,-996
29507,29507,274,2022/4/15 8:50:00,337,1168,-831
29508,29508,274,2022/4/15 9:00:00,340,426,-86
29509,29509,274,2022/4/15 9:10:00,312,426,-114
29510,29510,274,2022/4/15 9:20:00,278,376,-98
29511,29511,274,2022/4/15 9:30:00,270,324,-54
29512,29512,274,2022/4/15 9:40:00,230,325,-95
29513,29513,274,2022/4/15 9:50:00,219,178,41
29514,29514,274,2022/4/15 10:00:00,207,186,21
29515,29515,274,2022/4/15 10:10:00,189,147,42
29516,29516,274,2022/4/15 10:20:00,194,152,42
29517,29517,274,2022/4/15 10:30:00,174,105,69
29518,29518,274,2022/4/15 10:40:00,176,112,64
29519,29519,274,2022/4/15 10:50:00,163,125,38
29520,29520,274,2022/4/15 11:00:00,163,108,55
29521,29521,274,2022/4/15 11:10:00,175,126,49
29522,29522,274,2022/4/15 11:20:00,156,110,46
29523,29523,274,2022/4/15 11:30:00,192,119,73
29524,29524,274,2022/4/15 11:40:00,185,110,75
29525,29525,274,2022/4/15 11:50:00,272,114,158
29526,29526,274,2022/4/15 12:00:00,203,119,84
29527,29527,274,2022/4/15 12:10:00,213,109,104
29528,29528,274,2022/4/15 12:20:00,175,112,63
29529,29529,274,2022/4/15 12:30:00,197,110,87
29530,29530,274,2022/4/15 12:40:00,192,170,22
29531,29531,274,2022/4/15 12:50:00,177,128,49
29532,29532,274,2022/4/15 13:00:00,179,192,-13
29533,29533,274,2022/4/15 13:10:00,211,128,83
29534,29534,274,2022/4/15 13:20:00,184,185,-1
29535,29535,274,2022/4/15 13:30:00,174,120,54
29536,29536,274,2022/4/15 13:40:00,185,181,4
29537,29537,274,2022/4/15 13:50:00,185,105,80
29538,29538,274,2022/4/15 14:00:00,192,169,23
29539,29539,274,2022/4/15 14:10:00,207,111,96
29540,29540,274,2022/4/15 14:20:00,202,119,83
29541,29541,274,2022/4/15 14:30:00,231,111,120
29542,29542,274,2022/4/15 14:40:00,351,119,232
29543,29543,274,2022/4/15 14:50:00,332,109,223
29544,29544,274,2022/4/15 15:00:00,269,144,125
29545,29545,274,2022/4/15 15:10:00,319,109,210
29546,29546,274,2022/4/15 15:20:00,264,120,144
29547,29547,274,2022/4/15 15:30:00,303,133,170
29548,29548,274,2022/4/15 15:40:00,333,170,163
29549,29549,274,2022/4/15 15:50:00,316,133,183
29550,29550,274,2022/4/15 16:00:00,349,110,239
29551,29551,274,2022/4/15 16:10:00,328,110,218
29552,29552,274,2022/4/15 16:20:00,311,185,126
29553,29553,274,2022/4/15 16:30:00,314,121,193
29554,29554,274,2022/4/15 16:40:00,361,192,169
29555,29555,274,2022/4/15 16:50:00,380,183,197
29556,29556,274,2022/4/15 17:00:00,707,189,518
29557,29557,274,2022/4/15 17:10:00,833,205,628
29558,29558,274,2022/4/15 17:20:00,634,296,338
29559,29559,274,2022/4/15 17:30:00,680,341,339
29560,29560,274,2022/4/15 17:40:00,789,331,458
29561,29561,274,2022/4/15 17:50:00,574,381,193
29562,29562,274,2022/4/15 18:00:00,642,433,209
29563,29563,274,2022/4/15 18:10:00,715,378,337
29564,29564,274,2022/4/15 18:20:00,571,326,245
29565,29565,274,2022/4/15 18:30:00,317,382,-65
29566,29566,274,2022/4/15 18:40:00,276,327,-51
29567,29567,274,2022/4/15 18:50:00,216,299,-83
29568,29568,274,2022/4/15 19:00:00,186,198,-12
29569,29569,274,2022/4/15 19:10:00,175,184,-9
29570,29570,274,2022/4/15 19:20:00,142,182,-40
29571,29571,274,2022/4/15 19:30:00,115,120,-5
29572,29572,274,2022/4/15 19:40:00,88,113,-25
29573,29573,274,2022/4/15 19:50:00,85,124,-39
29574,29574,274,2022/4/15 20:00:00,76,121,-45
29575,29575,274,2022/4/15 20:10:00,137,121,16
29576,29576,274,2022/4/15 20:20:00,83,108,-25
29577,29577,274,2022/4/15 20:30:00,80,111,-31
29578,29578,274,2022/4/15 20:40:00,89,127,-38
29579,29579,274,2022/4/15 20:50:00,84,106,-22
29580,29580,274,2022/4/15 21:00:00,96,120,-24
29581,29581,274,2022/4/15 21:10:00,88,125,-37
29582,29582,274,2022/4/15 21:20:00,54,121,-67
29583,29583,274,2022/4/15 21:30:00,40,114,-74
29584,29584,274,2022/4/15 21:40:00,44,101,-57
29585,29585,274,2022/4/15 21:50:00,40,122,-82
29586,29586,274,2022/4/15 22:00:00,43,109,-66
29587,29587,274,2022/4/15 22:10:00,37,107,-70
29588,29588,274,2022/4/15 22:20:00,25,123,-98
29589,29589,274,2022/4/15 22:30:00,21,105,-84
29590,29590,274,2022/4/15 22:40:00,13,85,-72
29591,29591,274,2022/4/15 22:50:00,11,67,-56
29592,29592,275,2022/4/15 5:00:00,1,1,0
29593,29593,275,2022/4/15 5:10:00,13,1,12
29594,29594,275,2022/4/15 5:20:00,28,1,27
29595,29595,275,2022/4/15 5:30:00,30,1,29
29596,29596,275,2022/4/15 5:40:00,30,1,29
29597,29597,275,2022/4/15 5:50:00,36,1,35
29598,29598,275,2022/4/15 6:00:00,33,1,32
29599,29599,275,2022/4/15 6:10:00,59,1,58
29600,29600,275,2022/4/15 6:20:00,79,1,78
29601,29601,275,2022/4/15 6:30:00,88,49,39
29602,29602,275,2022/4/15 6:40:00,206,70,136
29603,29603,275,2022/4/15 6:50:00,190,67,123
29604,29604,275,2022/4/15 7:00:00,277,70,207
29605,29605,275,2022/4/15 7:10:00,303,69,234
29606,29606,275,2022/4/15 7:20:00,378,77,301
29607,29607,275,2022/4/15 7:30:00,599,79,520
29608,29608,275,2022/4/15 7:40:00,602,118,484
29609,29609,275,2022/4/15 7:50:00,666,76,590
29610,29610,275,2022/4/15 8:00:00,657,72,585
29611,29611,275,2022/4/15 8:10:00,631,99,532
29612,29612,275,2022/4/15 8:20:00,369,75,294
29613,29613,275,2022/4/15 8:30:00,302,76,226
29614,29614,275,2022/4/15 8:40:00,278,83,195
29615,29615,275,2022/4/15 8:50:00,185,62,123
29616,29616,275,2022/4/15 9:00:00,145,67,78
29617,29617,275,2022/4/15 9:10:00,83,64,19
29618,29618,275,2022/4/15 9:20:00,70,74,-4
29619,29619,275,2022/4/15 9:30:00,59,57,2
29620,29620,275,2022/4/15 9:40:00,48,70,-22
29621,29621,275,2022/4/15 9:50:00,41,73,-32
29622,29622,275,2022/4/15 10:00:00,37,62,-25
29623,29623,275,2022/4/15 10:10:00,37,69,-32
29624,29624,275,2022/4/15 10:20:00,26,57,-31
29625,29625,275,2022/4/15 10:30:00,28,69,-41
29626,29626,275,2022/4/15 10:40:00,30,56,-26
29627,29627,275,2022/4/15 10:50:00,36,62,-26
29628,29628,275,2022/4/15 11:00:00,33,78,-45
29629,29629,275,2022/4/15 11:10:00,28,65,-37
29630,29630,275,2022/4/15 11:20:00,28,63,-35
29631,29631,275,2022/4/15 11:30:00,26,67,-41
29632,29632,275,2022/4/15 11:40:00,27,85,-58
29633,29633,275,2022/4/15 11:50:00,29,70,-41
29634,29634,275,2022/4/15 12:00:00,35,60,-25
29635,29635,275,2022/4/15 12:10:00,35,65,-30
29636,29636,275,2022/4/15 12:20:00,36,82,-46
29637,29637,275,2022/4/15 12:30:00,38,62,-24
29638,29638,275,2022/4/15 12:40:00,39,62,-23
29639,29639,275,2022/4/15 12:50:00,37,65,-28
29640,29640,275,2022/4/15 13:00:00,34,89,-55
29641,29641,275,2022/4/15 13:10:00,35,73,-38
29642,29642,275,2022/4/15 13:20:00,28,74,-46
29643,29643,275,2022/4/15 13:30:00,32,67,-35
29644,29644,275,2022/4/15 13:40:00,29,90,-61
29645,29645,275,2022/4/15 13:50:00,27,72,-45
29646,29646,275,2022/4/15 14:00:00,29,70,-41
29647,29647,275,2022/4/15 14:10:00,28,71,-43
29648,29648,275,2022/4/15 14:20:00,24,101,-77
29649,29649,275,2022/4/15 14:30:00,22,76,-54
29650,29650,275,2022/4/15 14:40:00,33,66,-33
29651,29651,275,2022/4/15 14:50:00,46,69,-23
29652,29652,275,2022/4/15 15:00:00,46,101,-55
29653,29653,275,2022/4/15 15:10:00,38,87,-49
29654,29654,275,2022/4/15 15:20:00,34,79,-45
29655,29655,275,2022/4/15 15:30:00,33,91,-58
29656,29656,275,2022/4/15 15:40:00,34,118,-84
29657,29657,275,2022/4/15 15:50:00,33,102,-69
29658,29658,275,2022/4/15 16:00:00,26,93,-67
29659,29659,275,2022/4/15 16:10:00,28,93,-65
29660,29660,275,2022/4/15 16:20:00,35,110,-75
29661,29661,275,2022/4/15 16:30:00,37,102,-65
29662,29662,275,2022/4/15 16:40:00,47,106,-59
29663,29663,275,2022/4/15 16:50:00,42,104,-62
29664,29664,275,2022/4/15 17:00:00,42,191,-149
29665,29665,275,2022/4/15 17:10:00,46,121,-75
29666,29666,275,2022/4/15 17:20:00,41,103,-62
29667,29667,275,2022/4/15 17:30:00,37,233,-196
29668,29668,275,2022/4/15 17:40:00,39,191,-152
29669,29669,275,2022/4/15 17:50:00,30,253,-223
29670,29670,275,2022/4/15 18:00:00,28,299,-271
29671,29671,275,2022/4/15 18:10:00,37,320,-283
29672,29672,275,2022/4/15 18:20:00,28,294,-266
29673,29673,275,2022/4/15 18:30:00,26,316,-290
29674,29674,275,2022/4/15 18:40:00,29,331,-302
29675,29675,275,2022/4/15 18:50:00,27,321,-294
29676,29676,275,2022/4/15 19:00:00,22,294,-272
29677,29677,275,2022/4/15 19:10:00,23,301,-278
29678,29678,275,2022/4/15 19:20:00,22,182,-160
29679,29679,275,2022/4/15 19:30:00,19,145,-126
29680,29680,275,2022/4/15 19:40:00,18,109,-91
29681,29681,275,2022/4/15 19:50:00,18,124,-106
29682,29682,275,2022/4/15 20:00:00,16,106,-90
29683,29683,275,2022/4/15 20:10:00,21,124,-103
29684,29684,275,2022/4/15 20:20:00,22,108,-86
29685,29685,275,2022/4/15 20:30:00,21,107,-86
29686,29686,275,2022/4/15 20:40:00,17,104,-87
29687,29687,275,2022/4/15 20:50:00,22,111,-89
29688,29688,275,2022/4/15 21:00:00,24,111,-87
29689,29689,275,2022/4/15 21:10:00,22,100,-78
29690,29690,275,2022/4/15 21:20:00,17,107,-90
29691,29691,275,2022/4/15 21:30:00,15,103,-88
29692,29692,275,2022/4/15 21:40:00,13,107,-94
29693,29693,275,2022/4/15 21:50:00,11,106,-95
29694,29694,275,2022/4/15 22:00:00,11,124,-113
29695,29695,275,2022/4/15 22:10:00,10,95,-85
29696,29696,275,2022/4/15 22:20:00,3,85,-82
29697,29697,275,2022/4/15 22:30:00,1,81,-80
29698,29698,275,2022/4/15 22:40:00,0,108,-108
29699,29699,275,2022/4/15 22:50:00,0,94,-94
29700,29700,276,2022/4/15 5:00:00,0,1,-1
29701,29701,276,2022/4/15 5:10:00,3,1,2
29702,29702,276,2022/4/15 5:20:00,9,1,8
29703,29703,276,2022/4/15 5:30:00,15,1,14
29704,29704,276,2022/4/15 5:40:00,20,2,18
29705,29705,276,2022/4/15 5:50:00,19,1,18
29706,29706,276,2022/4/15 6:00:00,31,1,30
29707,29707,276,2022/4/15 6:10:00,36,2,34
29708,29708,276,2022/4/15 6:20:00,48,23,25
29709,29709,276,2022/4/15 6:30:00,62,24,38
29710,29710,276,2022/4/15 6:40:00,150,38,112
29711,29711,276,2022/4/15 6:50:00,80,40,40
29712,29712,276,2022/4/15 7:00:00,170,47,123
29713,29713,276,2022/4/15 7:10:00,225,60,165
29714,29714,276,2022/4/15 7:20:00,276,92,184
29715,29715,276,2022/4/15 7:30:00,279,87,192
29716,29716,276,2022/4/15 7:40:00,386,106,280
29717,29717,276,2022/4/15 7:50:00,445,96,349
29718,29718,276,2022/4/15 8:00:00,395,120,275
29719,29719,276,2022/4/15 8:10:00,328,120,208
29720,29720,276,2022/4/15 8:20:00,265,110,155
29721,29721,276,2022/4/15 8:30:00,215,178,37
29722,29722,276,2022/4/15 8:40:00,191,218,-27
29723,29723,276,2022/4/15 8:50:00,107,209,-102
29724,29724,276,2022/4/15 9:00:00,71,182,-111
29725,29725,276,2022/4/15 9:10:00,70,182,-112
29726,29726,276,2022/4/15 9:20:00,42,112,-70
29727,29727,276,2022/4/15 9:30:00,31,112,-81
29728,29728,276,2022/4/15 9:40:00,31,99,-68
29729,29729,276,2022/4/15 9:50:00,31,101,-70
29730,29730,276,2022/4/15 10:00:00,31,93,-62
29731,29731,276,2022/4/15 10:10:00,33,67,-34
29732,29732,276,2022/4/15 10:20:00,28,72,-44
29733,29733,276,2022/4/15 10:30:00,28,93,-65
29734,29734,276,2022/4/15 10:40:00,27,69,-42
29735,29735,276,2022/4/15 10:50:00,26,64,-38
29736,29736,276,2022/4/15 11:00:00,28,65,-37
29737,29737,276,2022/4/15 11:10:00,32,73,-41
29738,29738,276,2022/4/15 11:20:00,27,60,-33
29739,29739,276,2022/4/15 11:30:00,27,62,-35
29740,29740,276,2022/4/15 11:40:00,28,65,-37
29741,29741,276,2022/4/15 11:50:00,29,85,-56
29742,29742,276,2022/4/15 12:00:00,29,64,-35
29743,29743,276,2022/4/15 12:10:00,35,65,-30
29744,29744,276,2022/4/15 12:20:00,30,61,-31
29745,29745,276,2022/4/15 12:30:00,27,77,-50
29746,29746,276,2022/4/15 12:40:00,35,63,-28
29747,29747,276,2022/4/15 12:50:00,30,70,-40
29748,29748,276,2022/4/15 13:00:00,30,69,-39
29749,29749,276,2022/4/15 13:10:00,28,91,-63
29750,29750,276,2022/4/15 13:20:00,26,60,-34
29751,29751,276,2022/4/15 13:30:00,26,68,-42
29752,29752,276,2022/4/15 13:40:00,27,67,-40
29753,29753,276,2022/4/15 13:50:00,31,79,-48
29754,29754,276,2022/4/15 14:00:00,28,65,-37
29755,29755,276,2022/4/15 14:10:00,30,61,-31
29756,29756,276,2022/4/15 14:20:00,27,61,-34
29757,29757,276,2022/4/15 14:30:00,29,76,-47
29758,29758,276,2022/4/15 14:40:00,29,68,-39
29759,29759,276,2022/4/15 14:50:00,28,62,-34
29760,29760,276,2022/4/15 15:00:00,29,70,-41
29761,29761,276,2022/4/15 15:10:00,29,90,-61
29762,29762,276,2022/4/15 15:20:00,26,59,-33
29763,29763,276,2022/4/15 15:30:00,27,70,-43
29764,29764,276,2022/4/15 15:40:00,25,72,-47
29765,29765,276,2022/4/15 15:50:00,30,103,-73
29766,29766,276,2022/4/15 16:00:00,28,73,-45
29767,29767,276,2022/4/15 16:10:00,33,82,-49
29768,29768,276,2022/4/15 16:20:00,35,81,-46
29769,29769,276,2022/4/15 16:30:00,43,109,-66
29770,29770,276,2022/4/15 16:40:00,46,91,-45
29771,29771,276,2022/4/15 16:50:00,42,77,-35
29772,29772,276,2022/4/15 17:00:00,59,93,-34
29773,29773,276,2022/4/15 17:10:00,99,109,-10
29774,29774,276,2022/4/15 17:20:00,133,112,21
29775,29775,276,2022/4/15 17:30:00,74,123,-49
29776,29776,276,2022/4/15 17:40:00,103,123,-20
29777,29777,276,2022/4/15 17:50:00,67,144,-77
29778,29778,276,2022/4/15 18:00:00,164,111,53
29779,29779,276,2022/4/15 18:10:00,227,121,106
29780,29780,276,2022/4/15 18:20:00,77,149,-72
29781,29781,276,2022/4/15 18:30:00,85,180,-95
29782,29782,276,2022/4/15 18:40:00,76,180,-104
29783,29783,276,2022/4/15 18:50:00,60,119,-59
29784,29784,276,2022/4/15 19:00:00,47,181,-134
29785,29785,276,2022/4/15 19:10:00,43,146,-103
29786,29786,276,2022/4/15 19:20:00,36,126,-90
29787,29787,276,2022/4/15 19:30:00,30,107,-77
29788,29788,276,2022/4/15 19:40:00,39,102,-63
29789,29789,276,2022/4/15 19:50:00,28,105,-77
29790,29790,276,2022/4/15 20:00:00,25,105,-80
29791,29791,276,2022/4/15 20:10:00,28,97,-69
29792,29792,276,2022/4/15 20:20:00,24,85,-61
29793,29793,276,2022/4/15 20:30:00,29,93,-64
29794,29794,276,2022/4/15 20:40:00,36,98,-62
29795,29795,276,2022/4/15 20:50:00,33,70,-37
29796,29796,276,2022/4/15 21:00:00,34,64,-30
29797,29797,276,2022/4/15 21:10:00,27,79,-52
29798,29798,276,2022/4/15 21:20:00,29,70,-41
29799,29799,276,2022/4/15 21:30:00,26,70,-44
29800,29800,276,2022/4/15 21:40:00,24,71,-47
29801,29801,276,2022/4/15 21:50:00,22,71,-49
29802,29802,276,2022/4/15 22:00:00,24,71,-47
29803,29803,276,2022/4/15 22:10:00,15,92,-77
29804,29804,276,2022/4/15 22:20:00,8,65,-57
29805,29805,276,2022/4/15 22:30:00,5,66,-61
29806,29806,276,2022/4/15 22:40:00,3,56,-53
29807,29807,276,2022/4/15 22:50:00,2,72,-70
29808,29808,277,2022/4/15 5:00:00,0,1,-1
29809,29809,277,2022/4/15 5:10:00,0,1,-1
29810,29810,277,2022/4/15 5:20:00,1,1,0
29811,29811,277,2022/4/15 5:30:00,3,1,2
29812,29812,277,2022/4/15 5:40:00,15,1,14
29813,29813,277,2022/4/15 5:50:00,17,6,11
29814,29814,277,2022/4/15 6:00:00,19,23,-4
29815,29815,277,2022/4/15 6:10:00,30,21,9
29816,29816,277,2022/4/15 6:20:00,31,44,-13
29817,29817,277,2022/4/15 6:30:00,39,52,-13
29818,29818,277,2022/4/15 6:40:00,45,69,-24
29819,29819,277,2022/4/15 6:50:00,60,98,-38
29820,29820,277,2022/4/15 7:00:00,64,102,-38
29821,29821,277,2022/4/15 7:10:00,66,102,-36
29822,29822,277,2022/4/15 7:20:00,58,105,-47
29823,29823,277,2022/4/15 7:30:00,87,107,-20
29824,29824,277,2022/4/15 7:40:00,88,109,-21
29825,29825,277,2022/4/15 7:50:00,163,171,-8
29826,29826,277,2022/4/15 8:00:00,187,223,-36
29827,29827,277,2022/4/15 8:10:00,186,323,-137
29828,29828,277,2022/4/15 8:20:00,147,339,-192
29829,29829,277,2022/4/15 8:30:00,103,501,-398
29830,29830,277,2022/4/15 8:40:00,91,437,-346
29831,29831,277,2022/4/15 8:50:00,78,431,-353
29832,29832,277,2022/4/15 9:00:00,79,346,-267
29833,29833,277,2022/4/15 9:10:00,69,299,-230
29834,29834,277,2022/4/15 9:20:00,50,233,-183
29835,29835,277,2022/4/15 9:30:00,43,152,-109
29836,29836,277,2022/4/15 9:40:00,45,129,-84
29837,29837,277,2022/4/15 9:50:00,37,108,-71
29838,29838,277,2022/4/15 10:00:00,29,102,-73
29839,29839,277,2022/4/15 10:10:00,36,108,-72
29840,29840,277,2022/4/15 10:20:00,38,102,-64
29841,29841,277,2022/4/15 10:30:00,36,114,-78
29842,29842,277,2022/4/15 10:40:00,31,93,-62
29843,29843,277,2022/4/15 10:50:00,31,108,-77
29844,29844,277,2022/4/15 11:00:00,36,93,-57
29845,29845,277,2022/4/15 11:10:00,38,96,-58
29846,29846,277,2022/4/15 11:20:00,33,90,-57
29847,29847,277,2022/4/15 11:30:00,37,100,-63
29848,29848,277,2022/4/15 11:40:00,34,105,-71
29849,29849,277,2022/4/15 11:50:00,39,99,-60
29850,29850,277,2022/4/15 12:00:00,41,93,-52
29851,29851,277,2022/4/15 12:10:00,36,99,-63
29852,29852,277,2022/4/15 12:20:00,46,77,-31
29853,29853,277,2022/4/15 12:30:00,44,104,-60
29854,29854,277,2022/4/15 12:40:00,45,93,-48
29855,29855,277,2022/4/15 12:50:00,46,98,-52
29856,29856,277,2022/4/15 13:00:00,44,101,-57
29857,29857,277,2022/4/15 13:10:00,43,100,-57
29858,29858,277,2022/4/15 13:20:00,46,93,-47
29859,29859,277,2022/4/15 13:30:00,45,110,-65
29860,29860,277,2022/4/15 13:40:00,45,113,-68
29861,29861,277,2022/4/15 13:50:00,44,98,-54
29862,29862,277,2022/4/15 14:00:00,45,90,-45
29863,29863,277,2022/4/15 14:10:00,44,113,-69
29864,29864,277,2022/4/15 14:20:00,43,93,-50
29865,29865,277,2022/4/15 14:30:00,43,106,-63
29866,29866,277,2022/4/15 14:40:00,42,88,-46
29867,29867,277,2022/4/15 14:50:00,43,101,-58
29868,29868,277,2022/4/15 15:00:00,45,93,-48
29869,29869,277,2022/4/15 15:10:00,46,96,-50
29870,29870,277,2022/4/15 15:20:00,46,99,-53
29871,29871,277,2022/4/15 15:30:00,49,105,-56
29872,29872,277,2022/4/15 15:40:00,52,105,-53
29873,29873,277,2022/4/15 15:50:00,69,105,-36
29874,29874,277,2022/4/15 16:00:00,72,98,-26
29875,29875,277,2022/4/15 16:10:00,81,105,-24
29876,29876,277,2022/4/15 16:20:00,77,108,-31
29877,29877,277,2022/4/15 16:30:00,100,97,3
29878,29878,277,2022/4/15 16:40:00,136,108,28
29879,29879,277,2022/4/15 16:50:00,144,123,21
29880,29880,277,2022/4/15 17:00:00,272,126,146
29881,29881,277,2022/4/15 17:10:00,308,110,198
29882,29882,277,2022/4/15 17:20:00,216,120,96
29883,29883,277,2022/4/15 17:30:00,307,127,180
29884,29884,277,2022/4/15 17:40:00,555,127,428
29885,29885,277,2022/4/15 17:50:00,288,144,144
29886,29886,277,2022/4/15 18:00:00,271,192,79
29887,29887,277,2022/4/15 18:10:00,331,159,172
29888,29888,277,2022/4/15 18:20:00,269,178,91
29889,29889,277,2022/4/15 18:30:00,259,192,67
29890,29890,277,2022/4/15 18:40:00,207,192,15
29891,29891,277,2022/4/15 18:50:00,180,109,71
29892,29892,277,2022/4/15 19:00:00,154,130,24
29893,29893,277,2022/4/15 19:10:00,133,123,10
29894,29894,277,2022/4/15 19:20:00,82,107,-25
29895,29895,277,2022/4/15 19:30:00,73,105,-32
29896,29896,277,2022/4/15 19:40:00,77,105,-28
29897,29897,277,2022/4/15 19:50:00,65,95,-30
29898,29898,277,2022/4/15 20:00:00,73,94,-21
29899,29899,277,2022/4/15 20:10:00,77,78,-1
29900,29900,277,2022/4/15 20:20:00,68,92,-24
29901,29901,277,2022/4/15 20:30:00,66,89,-23
29902,29902,277,2022/4/15 20:40:00,67,92,-25
29903,29903,277,2022/4/15 20:50:00,72,79,-7
29904,29904,277,2022/4/15 21:00:00,84,74,10
29905,29905,277,2022/4/15 21:10:00,71,75,-4
29906,29906,277,2022/4/15 21:20:00,71,95,-24
29907,29907,277,2022/4/15 21:30:00,60,77,-17
29908,29908,277,2022/4/15 21:40:00,64,84,-20
29909,29909,277,2022/4/15 21:50:00,50,70,-20
29910,29910,277,2022/4/15 22:00:00,76,85,-9
29911,29911,277,2022/4/15 22:10:00,37,79,-42
29912,29912,277,2022/4/15 22:20:00,23,78,-55
29913,29913,277,2022/4/15 22:30:00,22,78,-56
29914,29914,277,2022/4/15 22:40:00,13,56,-43
29915,29915,277,2022/4/15 22:50:00,9,48,-39
29916,29916,278,2022/4/15 5:00:00,0,1,-1
29917,29917,278,2022/4/15 5:10:00,0,1,-1
29918,29918,278,2022/4/15 5:20:00,3,1,2
29919,29919,278,2022/4/15 5:30:00,16,1,15
29920,29920,278,2022/4/15 5:40:00,26,1,25
29921,29921,278,2022/4/15 5:50:00,25,2,23
29922,29922,278,2022/4/15 6:00:00,31,6,25
29923,29923,278,2022/4/15 6:10:00,39,23,16
29924,29924,278,2022/4/15 6:20:00,57,25,32
29925,29925,278,2022/4/15 6:30:00,77,41,36
29926,29926,278,2022/4/15 6:40:00,194,63,131
29927,29927,278,2022/4/15 6:50:00,199,82,117
29928,29928,278,2022/4/15 7:00:00,255,100,155
29929,29929,278,2022/4/15 7:10:00,283,127,156
29930,29930,278,2022/4/15 7:20:00,369,107,262
29931,29931,278,2022/4/15 7:30:00,599,118,481
29932,29932,278,2022/4/15 7:40:00,702,107,595
29933,29933,278,2022/4/15 7:50:00,872,113,759
29934,29934,278,2022/4/15 8:00:00,1177,119,1058
29935,29935,278,2022/4/15 8:10:00,1177,139,1038
29936,29936,278,2022/4/15 8:20:00,1047,121,926
29937,29937,278,2022/4/15 8:30:00,815,121,694
29938,29938,278,2022/4/15 8:40:00,683,109,574
29939,29939,278,2022/4/15 8:50:00,591,109,482
29940,29940,278,2022/4/15 9:00:00,369,104,265
29941,29941,278,2022/4/15 9:10:00,324,112,212
29942,29942,278,2022/4/15 9:20:00,217,105,112
29943,29943,278,2022/4/15 9:30:00,180,91,89
29944,29944,278,2022/4/15 9:40:00,141,96,45
29945,29945,278,2022/4/15 9:50:00,78,78,0
29946,29946,278,2022/4/15 10:00:00,63,76,-13
29947,29947,278,2022/4/15 10:10:00,59,66,-7
29948,29948,278,2022/4/15 10:20:00,44,82,-38
29949,29949,278,2022/4/15 10:30:00,41,85,-44
29950,29950,278,2022/4/15 10:40:00,43,72,-29
29951,29951,278,2022/4/15 10:50:00,36,76,-40
29952,29952,278,2022/4/15 11:00:00,39,68,-29
29953,29953,278,2022/4/15 11:10:00,39,67,-28
29954,29954,278,2022/4/15 11:20:00,37,73,-36
29955,29955,278,2022/4/15 11:30:00,37,82,-45
29956,29956,278,2022/4/15 11:40:00,44,86,-42
29957,29957,278,2022/4/15 11:50:00,37,75,-38
29958,29958,278,2022/4/15 12:00:00,41,69,-28
29959,29959,278,2022/4/15 12:10:00,48,76,-28
29960,29960,278,2022/4/15 12:20:00,42,77,-35
29961,29961,278,2022/4/15 12:30:00,47,83,-36
29962,29962,278,2022/4/15 12:40:00,44,90,-46
29963,29963,278,2022/4/15 12:50:00,44,93,-49
29964,29964,278,2022/4/15 13:00:00,41,79,-38
29965,29965,278,2022/4/15 13:10:00,48,97,-49
29966,29966,278,2022/4/15 13:20:00,43,97,-54
29967,29967,278,2022/4/15 13:30:00,43,90,-47
29968,29968,278,2022/4/15 13:40:00,37,93,-56
29969,29969,278,2022/4/15 13:50:00,37,93,-56
29970,29970,278,2022/4/15 14:00:00,41,93,-52
29971,29971,278,2022/4/15 14:10:00,35,90,-55
29972,29972,278,2022/4/15 14:20:00,37,93,-56
29973,29973,278,2022/4/15 14:30:00,40,88,-48
29974,29974,278,2022/4/15 14:40:00,40,97,-57
29975,29975,278,2022/4/15 14:50:00,38,99,-61
29976,29976,278,2022/4/15 15:00:00,40,96,-56
29977,29977,278,2022/4/15 15:10:00,58,104,-46
29978,29978,278,2022/4/15 15:20:00,43,105,-62
29979,29979,278,2022/4/15 15:30:00,43,105,-62
29980,29980,278,2022/4/15 15:40:00,47,103,-56
29981,29981,278,2022/4/15 15:50:00,44,100,-56
29982,29982,278,2022/4/15 16:00:00,73,105,-32
29983,29983,278,2022/4/15 16:10:00,76,126,-50
29984,29984,278,2022/4/15 16:20:00,70,119,-49
29985,29985,278,2022/4/15 16:30:00,92,117,-25
29986,29986,278,2022/4/15 16:40:00,114,114,0
29987,29987,278,2022/4/15 16:50:00,89,133,-44
29988,29988,278,2022/4/15 17:00:00,158,115,43
29989,29989,278,2022/4/15 17:10:00,218,177,41
29990,29990,278,2022/4/15 17:20:00,195,215,-20
29991,29991,278,2022/4/15 17:30:00,157,297,-140
29992,29992,278,2022/4/15 17:40:00,198,332,-134
29993,29993,278,2022/4/15 17:50:00,176,345,-169
29994,29994,278,2022/4/15 18:00:00,98,380,-282
29995,29995,278,2022/4/15 18:10:00,130,379,-249
29996,29996,278,2022/4/15 18:20:00,72,386,-314
29997,29997,278,2022/4/15 18:30:00,56,527,-471
29998,29998,278,2022/4/15 18:40:00,56,382,-326
29999,29999,278,2022/4/15 18:50:00,41,519,-478
30000,30000,278,2022/4/15 19:00:00,40,336,-296
30001,30001,278,2022/4/15 19:10:00,43,301,-258
30002,30002,278,2022/4/15 19:20:00,34,214,-180
30003,30003,278,2022/4/15 19:30:00,31,153,-122
30004,30004,278,2022/4/15 19:40:00,31,128,-97
30005,30005,278,2022/4/15 19:50:00,34,116,-82
30006,30006,278,2022/4/15 20:00:00,28,111,-83
30007,30007,278,2022/4/15 20:10:00,32,110,-78
30008,30008,278,2022/4/15 20:20:00,27,104,-77
30009,30009,278,2022/4/15 20:30:00,29,109,-80
30010,30010,278,2022/4/15 20:40:00,26,120,-94
30011,30011,278,2022/4/15 20:50:00,27,125,-98
30012,30012,278,2022/4/15 21:00:00,31,119,-88
30013,30013,278,2022/4/15 21:10:00,29,117,-88
30014,30014,278,2022/4/15 21:20:00,23,122,-99
30015,30015,278,2022/4/15 21:30:00,24,116,-92
30016,30016,278,2022/4/15 21:40:00,24,122,-98
30017,30017,278,2022/4/15 21:50:00,20,88,-68
30018,30018,278,2022/4/15 22:00:00,16,99,-83
30019,30019,278,2022/4/15 22:10:00,16,112,-96
30020,30020,278,2022/4/15 22:20:00,13,107,-94
30021,30021,278,2022/4/15 22:30:00,12,102,-90
30022,30022,278,2022/4/15 22:40:00,6,95,-89
30023,30023,278,2022/4/15 22:50:00,2,71,-69
30024,30024,279,2022/4/15 5:00:00,3,1,2
30025,30025,279,2022/4/15 5:10:00,4,6,-2
30026,30026,279,2022/4/15 5:20:00,9,5,4
30027,30027,279,2022/4/15 5:30:00,13,8,5
30028,30028,279,2022/4/15 5:40:00,12,13,-1
30029,30029,279,2022/4/15 5:50:00,16,23,-7
30030,30030,279,2022/4/15 6:00:00,23,115,-92
30031,30031,279,2022/4/15 6:10:00,22,117,-95
30032,30032,279,2022/4/15 6:20:00,32,107,-75
30033,30033,279,2022/4/15 6:30:00,32,126,-94
30034,30034,279,2022/4/15 6:40:00,41,222,-181
30035,30035,279,2022/4/15 6:50:00,38,218,-180
30036,30036,279,2022/4/15 7:00:00,57,327,-270
30037,30037,279,2022/4/15 7:10:00,57,373,-316
30038,30038,279,2022/4/15 7:20:00,56,403,-347
30039,30039,279,2022/4/15 7:30:00,57,471,-414
30040,30040,279,2022/4/15 7:40:00,74,1164,-1090
30041,30041,279,2022/4/15 7:50:00,88,1924,-1836
30042,30042,279,2022/4/15 8:00:00,112,4571,-4459
30043,30043,279,2022/4/15 8:10:00,154,5231,-5077
30044,30044,279,2022/4/15 8:20:00,151,6152,-6001
30045,30045,279,2022/4/15 8:30:00,164,7061,-6897
30046,30046,279,2022/4/15 8:40:00,156,8263,-8107
30047,30047,279,2022/4/15 8:50:00,155,5793,-5638
30048,30048,279,2022/4/15 9:00:00,167,8649,-8482
30049,30049,279,2022/4/15 9:10:00,181,6146,-5965
30050,30050,279,2022/4/15 9:20:00,140,4386,-4246
30051,30051,279,2022/4/15 9:30:00,150,2949,-2799
30052,30052,279,2022/4/15 9:40:00,179,2322,-2143
30053,30053,279,2022/4/15 9:50:00,178,2038,-1860
30054,30054,279,2022/4/15 10:00:00,175,1188,-1013
30055,30055,279,2022/4/15 10:10:00,187,566,-379
30056,30056,279,2022/4/15 10:20:00,209,470,-261
30057,30057,279,2022/4/15 10:30:00,210,620,-410
30058,30058,279,2022/4/15 10:40:00,215,482,-267
30059,30059,279,2022/4/15 10:50:00,217,412,-195
30060,30060,279,2022/4/15 11:00:00,234,420,-186
30061,30061,279,2022/4/15 11:10:00,224,423,-199
30062,30062,279,2022/4/15 11:20:00,237,428,-191
30063,30063,279,2022/4/15 11:30:00,267,415,-148
30064,30064,279,2022/4/15 11:40:00,267,429,-162
30065,30065,279,2022/4/15 11:50:00,300,429,-129
30066,30066,279,2022/4/15 12:00:00,344,412,-68
30067,30067,279,2022/4/15 12:10:00,336,411,-75
30068,30068,279,2022/4/15 12:20:00,327,428,-101
30069,30069,279,2022/4/15 12:30:00,351,414,-63
30070,30070,279,2022/4/15 12:40:00,424,421,3
30071,30071,279,2022/4/15 12:50:00,424,422,2
30072,30072,279,2022/4/15 13:00:00,553,427,126
30073,30073,279,2022/4/15 13:10:00,557,422,135
30074,30074,279,2022/4/15 13:20:00,579,422,157
30075,30075,279,2022/4/15 13:30:00,567,426,141
30076,30076,279,2022/4/15 13:40:00,573,485,88
30077,30077,279,2022/4/15 13:50:00,575,428,147
30078,30078,279,2022/4/15 14:00:00,620,427,193
30079,30079,279,2022/4/15 14:10:00,592,418,174
30080,30080,279,2022/4/15 14:20:00,607,418,189
30081,30081,279,2022/4/15 14:30:00,622,427,195
30082,30082,279,2022/4/15 14:40:00,628,424,204
30083,30083,279,2022/4/15 14:50:00,693,484,209
30084,30084,279,2022/4/15 15:00:00,679,527,152
30085,30085,279,2022/4/15 15:10:00,731,492,239
30086,30086,279,2022/4/15 15:20:00,672,485,187
30087,30087,279,2022/4/15 15:30:00,661,491,170
30088,30088,279,2022/4/15 15:40:00,716,491,225
30089,30089,279,2022/4/15 15:50:00,713,487,226
30090,30090,279,2022/4/15 16:00:00,830,491,339
30091,30091,279,2022/4/15 16:10:00,1022,413,609
30092,30092,279,2022/4/15 16:20:00,823,479,344
30093,30093,279,2022/4/15 16:30:00,1018,487,531
30094,30094,279,2022/4/15 16:40:00,1196,484,712
30095,30095,279,2022/4/15 16:50:00,1195,422,773
30096,30096,279,2022/4/15 17:00:00,1987,389,1598
30097,30097,279,2022/4/15 17:10:00,2517,397,2120
30098,30098,279,2022/4/15 17:20:00,2030,463,1567
30099,30099,279,2022/4/15 17:30:00,2535,593,1942
30100,30100,279,2022/4/15 17:40:00,3506,1126,2380
30101,30101,279,2022/4/15 17:50:00,3356,1121,2235
30102,30102,279,2022/4/15 18:00:00,3257,1538,1719
30103,30103,279,2022/4/15 18:10:00,3452,1561,1891
30104,30104,279,2022/4/15 18:20:00,3368,1542,1826
30105,30105,279,2022/4/15 18:30:00,3278,1529,1749
30106,30106,279,2022/4/15 18:40:00,2525,1514,1011
30107,30107,279,2022/4/15 18:50:00,1985,554,1431
30108,30108,279,2022/4/15 19:00:00,1974,484,1490
30109,30109,279,2022/4/15 19:10:00,1576,470,1106
30110,30110,279,2022/4/15 19:20:00,1352,361,991
30111,30111,279,2022/4/15 19:30:00,1199,322,877
30112,30112,279,2022/4/15 19:40:00,1196,234,962
30113,30113,279,2022/4/15 19:50:00,1017,226,791
30114,30114,279,2022/4/15 20:00:00,1135,193,942
30115,30115,279,2022/4/15 20:10:00,1185,116,1069
30116,30116,279,2022/4/15 20:20:00,1194,116,1078
30117,30117,279,2022/4/15 20:30:00,1237,111,1126
30118,30118,279,2022/4/15 20:40:00,1196,115,1081
30119,30119,279,2022/4/15 20:50:00,1242,114,1128
30120,30120,279,2022/4/15 21:00:00,1589,124,1465
30121,30121,279,2022/4/15 21:10:00,1633,121,1512
30122,30122,279,2022/4/15 21:20:00,1432,105,1327
30123,30123,279,2022/4/15 21:30:00,1278,101,1177
30124,30124,279,2022/4/15 21:40:00,1195,111,1084
30125,30125,279,2022/4/15 21:50:00,1292,112,1180
30126,30126,279,2022/4/15 22:00:00,1992,98,1894
30127,30127,279,2022/4/15 22:10:00,1403,92,1311
30128,30128,279,2022/4/15 22:20:00,313,95,218
30129,30129,279,2022/4/15 22:30:00,218,78,140
30130,30130,279,2022/4/15 22:40:00,123,71,52
30131,30131,279,2022/4/15 22:50:00,54,71,-17
30132,30132,280,2022/4/15 5:00:00,0,1,-1
30133,30133,280,2022/4/15 5:10:00,30,1,29
30134,30134,280,2022/4/15 5:20:00,53,1,52
30135,30135,280,2022/4/15 5:30:00,41,1,40
30136,30136,280,2022/4/15 5:40:00,52,1,51
30137,30137,280,2022/4/15 5:50:00,204,1,203
30138,30138,280,2022/4/15 6:00:00,187,2,185
30139,30139,280,2022/4/15 6:10:00,360,1,359
30140,30140,280,2022/4/15 6:20:00,601,1,600
30141,30141,280,2022/4/15 6:30:00,479,89,390
30142,30142,280,2022/4/15 6:40:00,723,69,654
30143,30143,280,2022/4/15 6:50:00,822,102,720
30144,30144,280,2022/4/15 7:00:00,1160,109,1051
30145,30145,280,2022/4/15 7:10:00,1378,180,1198
30146,30146,280,2022/4/15 7:20:00,1964,105,1859
30147,30147,280,2022/4/15 7:30:00,1999,256,1743
30148,30148,280,2022/4/15 7:40:00,1968,147,1821
30149,30149,280,2022/4/15 7:50:00,1971,233,1738
30150,30150,280,2022/4/15 8:00:00,1996,111,1885
30151,30151,280,2022/4/15 8:10:00,1968,256,1712
30152,30152,280,2022/4/15 8:20:00,1405,256,1149
30153,30153,280,2022/4/15 8:30:00,849,192,657
30154,30154,280,2022/4/15 8:40:00,836,154,682
30155,30155,280,2022/4/15 8:50:00,617,126,491
30156,30156,280,2022/4/15 9:00:00,580,124,456
30157,30157,280,2022/4/15 9:10:00,273,109,164
30158,30158,280,2022/4/15 9:20:00,271,179,92
30159,30159,280,2022/4/15 9:30:00,220,108,112
30160,30160,280,2022/4/15 9:40:00,178,144,34
30161,30161,280,2022/4/15 9:50:00,210,178,32
30162,30162,280,2022/4/15 10:00:00,135,126,9
30163,30163,280,2022/4/15 10:10:00,138,117,21
30164,30164,280,2022/4/15 10:20:00,176,108,68
30165,30165,280,2022/4/15 10:30:00,136,183,-47
30166,30166,280,2022/4/15 10:40:00,54,109,-55
30167,30167,280,2022/4/15 10:50:00,204,97,107
30168,30168,280,2022/4/15 11:00:00,47,108,-61
30169,30169,280,2022/4/15 11:10:00,174,139,35
30170,30170,280,2022/4/15 11:20:00,80,122,-42
30171,30171,280,2022/4/15 11:30:00,135,110,25
30172,30172,280,2022/4/15 11:40:00,131,106,25
30173,30173,280,2022/4/15 11:50:00,140,120,20
30174,30174,280,2022/4/15 12:00:00,131,102,29
30175,30175,280,2022/4/15 12:10:00,191,109,82
30176,30176,280,2022/4/15 12:20:00,149,106,43
30177,30177,280,2022/4/15 12:30:00,191,121,70
30178,30178,280,2022/4/15 12:40:00,171,100,71
30179,30179,280,2022/4/15 12:50:00,157,104,53
30180,30180,280,2022/4/15 13:00:00,149,103,46
30181,30181,280,2022/4/15 13:10:00,205,144,61
30182,30182,280,2022/4/15 13:20:00,182,102,80
30183,30183,280,2022/4/15 13:30:00,174,99,75
30184,30184,280,2022/4/15 13:40:00,113,106,7
30185,30185,280,2022/4/15 13:50:00,167,142,25
30186,30186,280,2022/4/15 14:00:00,136,117,19
30187,30187,280,2022/4/15 14:10:00,163,108,55
30188,30188,280,2022/4/15 14:20:00,132,105,27
30189,30189,280,2022/4/15 14:30:00,150,154,-4
30190,30190,280,2022/4/15 14:40:00,85,119,-34
30191,30191,280,2022/4/15 14:50:00,175,104,71
30192,30192,280,2022/4/15 15:00:00,150,103,47
30193,30193,280,2022/4/15 15:10:00,105,146,-41
30194,30194,280,2022/4/15 15:20:00,126,122,4
30195,30195,280,2022/4/15 15:30:00,139,124,15
30196,30196,280,2022/4/15 15:40:00,77,110,-33
30197,30197,280,2022/4/15 15:50:00,147,197,-50
30198,30198,280,2022/4/15 16:00:00,171,169,2
30199,30199,280,2022/4/15 16:10:00,149,108,41
30200,30200,280,2022/4/15 16:20:00,171,110,61
30201,30201,280,2022/4/15 16:30:00,227,328,-101
30202,30202,280,2022/4/15 16:40:00,270,223,47
30203,30203,280,2022/4/15 16:50:00,220,184,36
30204,30204,280,2022/4/15 17:00:00,265,156,109
30205,30205,280,2022/4/15 17:10:00,229,430,-201
30206,30206,280,2022/4/15 17:20:00,258,323,-65
30207,30207,280,2022/4/15 17:30:00,264,296,-32
30208,30208,280,2022/4/15 17:40:00,210,427,-217
30209,30209,280,2022/4/15 17:50:00,196,326,-130
30210,30210,280,2022/4/15 18:00:00,177,570,-393
30211,30211,280,2022/4/15 18:10:00,126,383,-257
30212,30212,280,2022/4/15 18:20:00,145,573,-428
30213,30213,280,2022/4/15 18:30:00,71,425,-354
30214,30214,280,2022/4/15 18:40:00,51,1223,-1172
30215,30215,280,2022/4/15 18:50:00,58,497,-439
30216,30216,280,2022/4/15 19:00:00,35,555,-520
30217,30217,280,2022/4/15 19:10:00,44,398,-354
30218,30218,280,2022/4/15 19:20:00,36,638,-602
30219,30219,280,2022/4/15 19:30:00,28,419,-391
30220,30220,280,2022/4/15 19:40:00,30,503,-473
30221,30221,280,2022/4/15 19:50:00,28,219,-191
30222,30222,280,2022/4/15 20:00:00,28,320,-292
30223,30223,280,2022/4/15 20:10:00,31,208,-177
30224,30224,280,2022/4/15 20:20:00,30,179,-149
30225,30225,280,2022/4/15 20:30:00,28,169,-141
30226,30226,280,2022/4/15 20:40:00,24,209,-185
30227,30227,280,2022/4/15 20:50:00,24,159,-135
30228,30228,280,2022/4/15 21:00:00,26,121,-95
30229,30229,280,2022/4/15 21:10:00,25,215,-190
30230,30230,280,2022/4/15 21:20:00,22,141,-119
30231,30231,280,2022/4/15 21:30:00,19,119,-100
30232,30232,280,2022/4/15 21:40:00,18,150,-132
30233,30233,280,2022/4/15 21:50:00,15,219,-204
30234,30234,280,2022/4/15 22:00:00,12,230,-218
30235,30235,280,2022/4/15 22:10:00,10,108,-98
30236,30236,280,2022/4/15 22:20:00,6,125,-119
30237,30237,280,2022/4/15 22:30:00,0,125,-125
30238,30238,280,2022/4/15 22:40:00,0,114,-114
30239,30239,280,2022/4/15 22:50:00,0,154,-154
30240,30240,281,2022/4/15 5:00:00,3,1,2
30241,30241,281,2022/4/15 5:10:00,22,1,21
30242,30242,281,2022/4/15 5:20:00,33,1,32
30243,30243,281,2022/4/15 5:30:00,34,1,33
30244,30244,281,2022/4/15 5:40:00,36,1,35
30245,30245,281,2022/4/15 5:50:00,44,1,43
30246,30246,281,2022/4/15 6:00:00,69,1,68
30247,30247,281,2022/4/15 6:10:00,110,1,109
30248,30248,281,2022/4/15 6:20:00,199,1,198
30249,30249,281,2022/4/15 6:30:00,249,45,204
30250,30250,281,2022/4/15 6:40:00,339,45,294
30251,30251,281,2022/4/15 6:50:00,369,72,297
30252,30252,281,2022/4/15 7:00:00,630,81,549
30253,30253,281,2022/4/15 7:10:00,735,85,650
30254,30254,281,2022/4/15 7:20:00,1166,82,1084
30255,30255,281,2022/4/15 7:30:00,1207,74,1133
30256,30256,281,2022/4/15 7:40:00,1214,90,1124
30257,30257,281,2022/4/15 7:50:00,1365,127,1238
30258,30258,281,2022/4/15 8:00:00,1366,93,1273
30259,30259,281,2022/4/15 8:10:00,1179,95,1084
30260,30260,281,2022/4/15 8:20:00,743,106,637
30261,30261,281,2022/4/15 8:30:00,598,108,490
30262,30262,281,2022/4/15 8:40:00,374,92,282
30263,30263,281,2022/4/15 8:50:00,318,74,244
30264,30264,281,2022/4/15 9:00:00,232,78,154
30265,30265,281,2022/4/15 9:10:00,175,65,110
30266,30266,281,2022/4/15 9:20:00,122,76,46
30267,30267,281,2022/4/15 9:30:00,73,62,11
30268,30268,281,2022/4/15 9:40:00,53,72,-19
30269,30269,281,2022/4/15 9:50:00,47,80,-33
30270,30270,281,2022/4/15 10:00:00,45,68,-23
30271,30271,281,2022/4/15 10:10:00,39,62,-23
30272,30272,281,2022/4/15 10:20:00,43,65,-22
30273,30273,281,2022/4/15 10:30:00,37,77,-40
30274,30274,281,2022/4/15 10:40:00,33,67,-34
30275,30275,281,2022/4/15 10:50:00,31,54,-23
30276,30276,281,2022/4/15 11:00:00,30,67,-37
30277,30277,281,2022/4/15 11:10:00,31,76,-45
30278,30278,281,2022/4/15 11:20:00,31,64,-33
30279,30279,281,2022/4/15 11:30:00,32,61,-29
30280,30280,281,2022/4/15 11:40:00,37,61,-24
30281,30281,281,2022/4/15 11:50:00,36,81,-45
30282,30282,281,2022/4/15 12:00:00,36,65,-29
30283,30283,281,2022/4/15 12:10:00,42,61,-19
30284,30284,281,2022/4/15 12:20:00,43,59,-16
30285,30285,281,2022/4/15 12:30:00,40,88,-48
30286,30286,281,2022/4/15 12:40:00,36,65,-29
30287,30287,281,2022/4/15 12:50:00,34,63,-29
30288,30288,281,2022/4/15 13:00:00,32,66,-34
30289,30289,281,2022/4/15 13:10:00,32,91,-59
30290,30290,281,2022/4/15 13:20:00,29,71,-42
30291,30291,281,2022/4/15 13:30:00,28,74,-46
30292,30292,281,2022/4/15 13:40:00,26,72,-46
30293,30293,281,2022/4/15 13:50:00,26,91,-65
30294,30294,281,2022/4/15 14:00:00,32,67,-35
30295,30295,281,2022/4/15 14:10:00,29,71,-42
30296,30296,281,2022/4/15 14:20:00,28,72,-44
30297,30297,281,2022/4/15 14:30:00,24,105,-81
30298,30298,281,2022/4/15 14:40:00,26,83,-57
30299,30299,281,2022/4/15 14:50:00,28,72,-44
30300,30300,281,2022/4/15 15:00:00,28,77,-49
30301,30301,281,2022/4/15 15:10:00,33,105,-72
30302,30302,281,2022/4/15 15:20:00,28,87,-59
30303,30303,281,2022/4/15 15:30:00,33,78,-45
30304,30304,281,2022/4/15 15:40:00,26,91,-65
30305,30305,281,2022/4/15 15:50:00,29,116,-87
30306,30306,281,2022/4/15 16:00:00,34,104,-70
30307,30307,281,2022/4/15 16:10:00,35,93,-58
30308,30308,281,2022/4/15 16:20:00,35,111,-76
30309,30309,281,2022/4/15 16:30:00,44,122,-78
30310,30310,281,2022/4/15 16:40:00,37,120,-83
30311,30311,281,2022/4/15 16:50:00,40,116,-76
30312,30312,281,2022/4/15 17:00:00,40,125,-85
30313,30313,281,2022/4/15 17:10:00,63,231,-168
30314,30314,281,2022/4/15 17:20:00,45,144,-99
30315,30315,281,2022/4/15 17:30:00,41,142,-101
30316,30316,281,2022/4/15 17:40:00,42,378,-336
30317,30317,281,2022/4/15 17:50:00,36,190,-154
30318,30318,281,2022/4/15 18:00:00,33,506,-473
30319,30319,281,2022/4/15 18:10:00,37,196,-159
30320,30320,281,2022/4/15 18:20:00,35,431,-396
30321,30321,281,2022/4/15 18:30:00,29,233,-204
30322,30322,281,2022/4/15 18:40:00,24,421,-397
30323,30323,281,2022/4/15 18:50:00,27,222,-195
30324,30324,281,2022/4/15 19:00:00,25,506,-481
30325,30325,281,2022/4/15 19:10:00,22,181,-159
30326,30326,281,2022/4/15 19:20:00,20,328,-308
30327,30327,281,2022/4/15 19:30:00,21,111,-90
30328,30328,281,2022/4/15 19:40:00,22,226,-204
30329,30329,281,2022/4/15 19:50:00,21,104,-83
30330,30330,281,2022/4/15 20:00:00,25,151,-126
30331,30331,281,2022/4/15 20:10:00,23,98,-75
30332,30332,281,2022/4/15 20:20:00,19,110,-91
30333,30333,281,2022/4/15 20:30:00,18,95,-77
30334,30334,281,2022/4/15 20:40:00,20,110,-90
30335,30335,281,2022/4/15 20:50:00,18,133,-115
30336,30336,281,2022/4/15 21:00:00,18,97,-79
30337,30337,281,2022/4/15 21:10:00,14,104,-90
30338,30338,281,2022/4/15 21:20:00,13,112,-99
30339,30339,281,2022/4/15 21:30:00,14,110,-96
30340,30340,281,2022/4/15 21:40:00,12,108,-96
30341,30341,281,2022/4/15 21:50:00,12,107,-95
30342,30342,281,2022/4/15 22:00:00,13,110,-97
30343,30343,281,2022/4/15 22:10:00,13,112,-99
30344,30344,281,2022/4/15 22:20:00,6,121,-115
30345,30345,281,2022/4/15 22:30:00,0,101,-101
30346,30346,281,2022/4/15 22:40:00,0,103,-103
30347,30347,281,2022/4/15 22:50:00,0,99,-99
30348,30348,282,2022/4/15 5:00:00,0,1,-1
30349,30349,282,2022/4/15 5:10:00,2,1,1
30350,30350,282,2022/4/15 5:20:00,5,1,4
30351,30351,282,2022/4/15 5:30:00,16,1,15
30352,30352,282,2022/4/15 5:40:00,19,1,18
30353,30353,282,2022/4/15 5:50:00,21,6,15
30354,30354,282,2022/4/15 6:00:00,30,5,25
30355,30355,282,2022/4/15 6:10:00,35,16,19
30356,30356,282,2022/4/15 6:20:00,38,35,3
30357,30357,282,2022/4/15 6:30:00,49,51,-2
30358,30358,282,2022/4/15 6:40:00,76,68,8
30359,30359,282,2022/4/15 6:50:00,94,108,-14
30360,30360,282,2022/4/15 7:00:00,156,193,-37
30361,30361,282,2022/4/15 7:10:00,197,119,78
30362,30362,282,2022/4/15 7:20:00,235,104,131
30363,30363,282,2022/4/15 7:30:00,278,121,157
30364,30364,282,2022/4/15 7:40:00,325,122,203
30365,30365,282,2022/4/15 7:50:00,575,124,451
30366,30366,282,2022/4/15 8:00:00,632,181,451
30367,30367,282,2022/4/15 8:10:00,723,215,508
30368,30368,282,2022/4/15 8:20:00,655,296,359
30369,30369,282,2022/4/15 8:30:00,601,332,269
30370,30370,282,2022/4/15 8:40:00,369,421,-52
30371,30371,282,2022/4/15 8:50:00,280,509,-229
30372,30372,282,2022/4/15 9:00:00,227,299,-72
30373,30373,282,2022/4/15 9:10:00,209,197,12
30374,30374,282,2022/4/15 9:20:00,167,185,-18
30375,30375,282,2022/4/15 9:30:00,107,109,-2
30376,30376,282,2022/4/15 9:40:00,67,123,-56
30377,30377,282,2022/4/15 9:50:00,56,106,-50
30378,30378,282,2022/4/15 10:00:00,46,105,-59
30379,30379,282,2022/4/15 10:10:00,45,96,-51
30380,30380,282,2022/4/15 10:20:00,45,97,-52
30381,30381,282,2022/4/15 10:30:00,43,93,-50
30382,30382,282,2022/4/15 10:40:00,41,81,-40
30383,30383,282,2022/4/15 10:50:00,38,80,-42
30384,30384,282,2022/4/15 11:00:00,33,77,-44
30385,30385,282,2022/4/15 11:10:00,35,76,-41
30386,30386,282,2022/4/15 11:20:00,36,75,-39
30387,30387,282,2022/4/15 11:30:00,39,77,-38
30388,30388,282,2022/4/15 11:40:00,41,72,-31
30389,30389,282,2022/4/15 11:50:00,45,91,-46
30390,30390,282,2022/4/15 12:00:00,43,76,-33
30391,30391,282,2022/4/15 12:10:00,54,81,-27
30392,30392,282,2022/4/15 12:20:00,45,84,-39
30393,30393,282,2022/4/15 12:30:00,44,93,-49
30394,30394,282,2022/4/15 12:40:00,42,104,-62
30395,30395,282,2022/4/15 12:50:00,47,113,-66
30396,30396,282,2022/4/15 13:00:00,48,105,-57
30397,30397,282,2022/4/15 13:10:00,46,101,-55
30398,30398,282,2022/4/15 13:20:00,44,105,-61
30399,30399,282,2022/4/15 13:30:00,45,98,-53
30400,30400,282,2022/4/15 13:40:00,44,93,-49
30401,30401,282,2022/4/15 13:50:00,44,96,-52
30402,30402,282,2022/4/15 14:00:00,42,94,-52
30403,30403,282,2022/4/15 14:10:00,41,97,-56
30404,30404,282,2022/4/15 14:20:00,36,81,-45
30405,30405,282,2022/4/15 14:30:00,44,93,-49
30406,30406,282,2022/4/15 14:40:00,39,90,-51
30407,30407,282,2022/4/15 14:50:00,41,92,-51
30408,30408,282,2022/4/15 15:00:00,50,93,-43
30409,30409,282,2022/4/15 15:10:00,118,100,18
30410,30410,282,2022/4/15 15:20:00,66,100,-34
30411,30411,282,2022/4/15 15:30:00,59,99,-40
30412,30412,282,2022/4/15 15:40:00,66,104,-38
30413,30413,282,2022/4/15 15:50:00,81,109,-28
30414,30414,282,2022/4/15 16:00:00,170,100,70
30415,30415,282,2022/4/15 16:10:00,140,104,36
30416,30416,282,2022/4/15 16:20:00,78,108,-30
30417,30417,282,2022/4/15 16:30:00,136,87,49
30418,30418,282,2022/4/15 16:40:00,191,97,94
30419,30419,282,2022/4/15 16:50:00,228,118,110
30420,30420,282,2022/4/15 17:00:00,333,121,212
30421,30421,282,2022/4/15 17:10:00,336,108,228
30422,30422,282,2022/4/15 17:20:00,223,149,74
30423,30423,282,2022/4/15 17:30:00,270,191,79
30424,30424,282,2022/4/15 17:40:00,579,179,400
30425,30425,282,2022/4/15 17:50:00,292,255,37
30426,30426,282,2022/4/15 18:00:00,308,283,25
30427,30427,282,2022/4/15 18:10:00,377,284,93
30428,30428,282,2022/4/15 18:20:00,265,300,-35
30429,30429,282,2022/4/15 18:30:00,189,270,-81
30430,30430,282,2022/4/15 18:40:00,177,284,-107
30431,30431,282,2022/4/15 18:50:00,134,234,-100
30432,30432,282,2022/4/15 19:00:00,68,178,-110
30433,30433,282,2022/4/15 19:10:00,60,170,-110
30434,30434,282,2022/4/15 19:20:00,48,121,-73
30435,30435,282,2022/4/15 19:30:00,44,109,-65
30436,30436,282,2022/4/15 19:40:00,42,118,-76
30437,30437,282,2022/4/15 19:50:00,43,106,-63
30438,30438,282,2022/4/15 20:00:00,39,110,-71
30439,30439,282,2022/4/15 20:10:00,41,102,-61
30440,30440,282,2022/4/15 20:20:00,36,104,-68
30441,30441,282,2022/4/15 20:30:00,41,100,-59
30442,30442,282,2022/4/15 20:40:00,46,104,-58
30443,30443,282,2022/4/15 20:50:00,46,97,-51
30444,30444,282,2022/4/15 21:00:00,38,108,-70
30445,30445,282,2022/4/15 21:10:00,41,104,-63
30446,30446,282,2022/4/15 21:20:00,39,112,-73
30447,30447,282,2022/4/15 21:30:00,35,103,-68
30448,30448,282,2022/4/15 21:40:00,30,93,-63
30449,30449,282,2022/4/15 21:50:00,28,102,-74
30450,30450,282,2022/4/15 22:00:00,24,85,-61
30451,30451,282,2022/4/15 22:10:00,22,96,-74
30452,30452,282,2022/4/15 22:20:00,19,92,-73
30453,30453,282,2022/4/15 22:30:00,13,78,-65
30454,30454,282,2022/4/15 22:40:00,6,66,-60
30455,30455,282,2022/4/15 22:50:00,3,72,-69
30456,30456,283,2022/4/15 5:00:00,0,1,-1
30457,30457,283,2022/4/15 5:10:00,0,1,-1
30458,30458,283,2022/4/15 5:20:00,3,1,2
30459,30459,283,2022/4/15 5:30:00,7,1,6
30460,30460,283,2022/4/15 5:40:00,24,1,23
30461,30461,283,2022/4/15 5:50:00,26,21,5
30462,30462,283,2022/4/15 6:00:00,35,13,22
30463,30463,283,2022/4/15 6:10:00,45,47,-2
30464,30464,283,2022/4/15 6:20:00,57,38,19
30465,30465,283,2022/4/15 6:30:00,77,42,35
30466,30466,283,2022/4/15 6:40:00,163,68,95
30467,30467,283,2022/4/15 6:50:00,195,93,102
30468,30468,283,2022/4/15 7:00:00,273,103,170
30469,30469,283,2022/4/15 7:10:00,277,108,169
30470,30470,283,2022/4/15 7:20:00,342,102,240
30471,30471,283,2022/4/15 7:30:00,576,110,466
30472,30472,283,2022/4/15 7:40:00,633,125,508
30473,30473,283,2022/4/15 7:50:00,733,147,586
30474,30474,283,2022/4/15 8:00:00,827,220,607
30475,30475,283,2022/4/15 8:10:00,864,332,532
30476,30476,283,2022/4/15 8:20:00,730,253,477
30477,30477,283,2022/4/15 8:30:00,655,324,331
30478,30478,283,2022/4/15 8:40:00,592,324,268
30479,30479,283,2022/4/15 8:50:00,393,318,75
30480,30480,283,2022/4/15 9:00:00,341,227,114
30481,30481,283,2022/4/15 9:10:00,262,180,82
30482,30482,283,2022/4/15 9:20:00,227,179,48
30483,30483,283,2022/4/15 9:30:00,189,120,69
30484,30484,283,2022/4/15 9:40:00,157,110,47
30485,30485,283,2022/4/15 9:50:00,147,110,37
30486,30486,283,2022/4/15 10:00:00,114,86,28
30487,30487,283,2022/4/15 10:10:00,76,108,-32
30488,30488,283,2022/4/15 10:20:00,75,93,-18
30489,30489,283,2022/4/15 10:30:00,66,112,-46
30490,30490,283,2022/4/15 10:40:00,62,79,-17
30491,30491,283,2022/4/15 10:50:00,59,111,-52
30492,30492,283,2022/4/15 11:00:00,57,77,-20
30493,30493,283,2022/4/15 11:10:00,61,106,-45
30494,30494,283,2022/4/15 11:20:00,54,76,-22
30495,30495,283,2022/4/15 11:30:00,63,104,-41
30496,30496,283,2022/4/15 11:40:00,54,75,-21
30497,30497,283,2022/4/15 11:50:00,52,106,-54
30498,30498,283,2022/4/15 12:00:00,55,77,-22
30499,30499,283,2022/4/15 12:10:00,58,108,-50
30500,30500,283,2022/4/15 12:20:00,63,92,-29
30501,30501,283,2022/4/15 12:30:00,69,106,-37
30502,30502,283,2022/4/15 12:40:00,62,97,-35
30503,30503,283,2022/4/15 12:50:00,64,119,-55
30504,30504,283,2022/4/15 13:00:00,75,100,-25
30505,30505,283,2022/4/15 13:10:00,76,118,-42
30506,30506,283,2022/4/15 13:20:00,62,105,-43
30507,30507,283,2022/4/15 13:30:00,77,127,-50
30508,30508,283,2022/4/15 13:40:00,69,93,-24
30509,30509,283,2022/4/15 13:50:00,65,107,-42
30510,30510,283,2022/4/15 14:00:00,57,105,-48
30511,30511,283,2022/4/15 14:10:00,52,104,-52
30512,30512,283,2022/4/15 14:20:00,62,109,-47
30513,30513,283,2022/4/15 14:30:00,69,123,-54
30514,30514,283,2022/4/15 14:40:00,51,109,-58
30515,30515,283,2022/4/15 14:50:00,59,124,-65
30516,30516,283,2022/4/15 15:00:00,70,102,-32
30517,30517,283,2022/4/15 15:10:00,74,121,-47
30518,30518,283,2022/4/15 15:20:00,73,112,-39
30519,30519,283,2022/4/15 15:30:00,79,120,-41
30520,30520,283,2022/4/15 15:40:00,75,110,-35
30521,30521,283,2022/4/15 15:50:00,63,121,-58
30522,30522,283,2022/4/15 16:00:00,74,102,-28
30523,30523,283,2022/4/15 16:10:00,76,114,-38
30524,30524,283,2022/4/15 16:20:00,80,105,-25
30525,30525,283,2022/4/15 16:30:00,209,108,101
30526,30526,283,2022/4/15 16:40:00,190,120,70
30527,30527,283,2022/4/15 16:50:00,177,117,60
30528,30528,283,2022/4/15 17:00:00,269,131,138
30529,30529,283,2022/4/15 17:10:00,272,177,95
30530,30530,283,2022/4/15 17:20:00,234,231,3
30531,30531,283,2022/4/15 17:30:00,270,232,38
30532,30532,283,2022/4/15 17:40:00,339,298,41
30533,30533,283,2022/4/15 17:50:00,243,322,-79
30534,30534,283,2022/4/15 18:00:00,216,326,-110
30535,30535,283,2022/4/15 18:10:00,262,348,-86
30536,30536,283,2022/4/15 18:20:00,208,335,-127
30537,30537,283,2022/4/15 18:30:00,157,336,-179
30538,30538,283,2022/4/15 18:40:00,149,326,-177
30539,30539,283,2022/4/15 18:50:00,84,327,-243
30540,30540,283,2022/4/15 19:00:00,85,285,-200
30541,30541,283,2022/4/15 19:10:00,65,180,-115
30542,30542,283,2022/4/15 19:20:00,54,152,-98
30543,30543,283,2022/4/15 19:30:00,48,119,-71
30544,30544,283,2022/4/15 19:40:00,42,107,-65
30545,30545,283,2022/4/15 19:50:00,35,124,-89
30546,30546,283,2022/4/15 20:00:00,35,129,-94
30547,30547,283,2022/4/15 20:10:00,32,117,-85
30548,30548,283,2022/4/15 20:20:00,28,122,-94
30549,30549,283,2022/4/15 20:30:00,29,119,-90
30550,30550,283,2022/4/15 20:40:00,35,124,-89
30551,30551,283,2022/4/15 20:50:00,27,128,-101
30552,30552,283,2022/4/15 21:00:00,33,101,-68
30553,30553,283,2022/4/15 21:10:00,30,110,-80
30554,30554,283,2022/4/15 21:20:00,29,115,-86
30555,30555,283,2022/4/15 21:30:00,28,121,-93
30556,30556,283,2022/4/15 21:40:00,27,99,-72
30557,30557,283,2022/4/15 21:50:00,28,105,-77
30558,30558,283,2022/4/15 22:00:00,28,99,-71
30559,30559,283,2022/4/15 22:10:00,25,112,-87
30560,30560,283,2022/4/15 22:20:00,22,108,-86
30561,30561,283,2022/4/15 22:30:00,14,107,-93
30562,30562,283,2022/4/15 22:40:00,14,83,-69
30563,30563,283,2022/4/15 22:50:00,4,70,-66
30564,30564,284,2022/4/15 5:00:00,0,1,-1
30565,30565,284,2022/4/15 5:10:00,0,1,-1
30566,30566,284,2022/4/15 5:20:00,3,1,2
30567,30567,284,2022/4/15 5:30:00,9,1,8
30568,30568,284,2022/4/15 5:40:00,12,8,4
30569,30569,284,2022/4/15 5:50:00,24,38,-14
30570,30570,284,2022/4/15 6:00:00,34,62,-28
30571,30571,284,2022/4/15 6:10:00,47,77,-30
30572,30572,284,2022/4/15 6:20:00,60,106,-46
30573,30573,284,2022/4/15 6:30:00,88,123,-35
30574,30574,284,2022/4/15 6:40:00,153,197,-44
30575,30575,284,2022/4/15 6:50:00,187,383,-196
30576,30576,284,2022/4/15 7:00:00,234,381,-147
30577,30577,284,2022/4/15 7:10:00,283,506,-223
30578,30578,284,2022/4/15 7:20:00,287,508,-221
30579,30579,284,2022/4/15 7:30:00,302,425,-123
30580,30580,284,2022/4/15 7:40:00,445,1212,-767
30581,30581,284,2022/4/15 7:50:00,632,491,141
30582,30582,284,2022/4/15 8:00:00,689,432,257
30583,30583,284,2022/4/15 8:10:00,724,428,296
30584,30584,284,2022/4/15 8:20:00,686,430,256
30585,30585,284,2022/4/15 8:30:00,665,427,238
30586,30586,284,2022/4/15 8:40:00,603,1189,-586
30587,30587,284,2022/4/15 8:50:00,439,575,-136
30588,30588,284,2022/4/15 9:00:00,319,488,-169
30589,30589,284,2022/4/15 9:10:00,322,428,-106
30590,30590,284,2022/4/15 9:20:00,275,427,-152
30591,30591,284,2022/4/15 9:30:00,277,344,-67
30592,30592,284,2022/4/15 9:40:00,231,254,-23
30593,30593,284,2022/4/15 9:50:00,237,281,-44
30594,30594,284,2022/4/15 10:00:00,213,159,54
30595,30595,284,2022/4/15 10:10:00,213,179,34
30596,30596,284,2022/4/15 10:20:00,205,133,72
30597,30597,284,2022/4/15 10:30:00,190,154,36
30598,30598,284,2022/4/15 10:40:00,185,110,75
30599,30599,284,2022/4/15 10:50:00,182,110,72
30600,30600,284,2022/4/15 11:00:00,184,125,59
30601,30601,284,2022/4/15 11:10:00,174,125,49
30602,30602,284,2022/4/15 11:20:00,178,122,56
30603,30603,284,2022/4/15 11:30:00,185,124,61
30604,30604,284,2022/4/15 11:40:00,174,115,59
30605,30605,284,2022/4/15 11:50:00,176,110,66
30606,30606,284,2022/4/15 12:00:00,163,107,56
30607,30607,284,2022/4/15 12:10:00,163,120,43
30608,30608,284,2022/4/15 12:20:00,138,121,17
30609,30609,284,2022/4/15 12:30:00,137,146,-9
30610,30610,284,2022/4/15 12:40:00,114,117,-3
30611,30611,284,2022/4/15 12:50:00,136,197,-61
30612,30612,284,2022/4/15 13:00:00,93,192,-99
30613,30613,284,2022/4/15 13:10:00,89,198,-109
30614,30614,284,2022/4/15 13:20:00,98,180,-82
30615,30615,284,2022/4/15 13:30:00,102,192,-90
30616,30616,284,2022/4/15 13:40:00,136,140,-4
30617,30617,284,2022/4/15 13:50:00,168,159,9
30618,30618,284,2022/4/15 14:00:00,186,120,66
30619,30619,284,2022/4/15 14:10:00,206,143,63
30620,30620,284,2022/4/15 14:20:00,216,105,111
30621,30621,284,2022/4/15 14:30:00,211,181,30
30622,30622,284,2022/4/15 14:40:00,223,121,102
30623,30623,284,2022/4/15 14:50:00,237,110,127
30624,30624,284,2022/4/15 15:00:00,257,123,134
30625,30625,284,2022/4/15 15:10:00,265,120,145
30626,30626,284,2022/4/15 15:20:00,274,110,164
30627,30627,284,2022/4/15 15:30:00,271,109,162
30628,30628,284,2022/4/15 15:40:00,335,105,230
30629,30629,284,2022/4/15 15:50:00,336,119,217
30630,30630,284,2022/4/15 16:00:00,352,109,243
30631,30631,284,2022/4/15 16:10:00,310,109,201
30632,30632,284,2022/4/15 16:20:00,359,119,240
30633,30633,284,2022/4/15 16:30:00,632,152,480
30634,30634,284,2022/4/15 16:40:00,714,111,603
30635,30635,284,2022/4/15 16:50:00,637,152,485
30636,30636,284,2022/4/15 17:00:00,800,140,660
30637,30637,284,2022/4/15 17:10:00,1024,176,848
30638,30638,284,2022/4/15 17:20:00,652,221,431
30639,30639,284,2022/4/15 17:30:00,639,324,315
30640,30640,284,2022/4/15 17:40:00,791,266,525
30641,30641,284,2022/4/15 17:50:00,610,332,278
30642,30642,284,2022/4/15 18:00:00,579,335,244
30643,30643,284,2022/4/15 18:10:00,724,320,404
30644,30644,284,2022/4/15 18:20:00,609,300,309
30645,30645,284,2022/4/15 18:30:00,370,328,42
30646,30646,284,2022/4/15 18:40:00,326,271,55
30647,30647,284,2022/4/15 18:50:00,274,233,41
30648,30648,284,2022/4/15 19:00:00,224,179,45
30649,30649,284,2022/4/15 19:10:00,191,150,41
30650,30650,284,2022/4/15 19:20:00,183,133,50
30651,30651,284,2022/4/15 19:30:00,138,109,29
30652,30652,284,2022/4/15 19:40:00,132,99,33
30653,30653,284,2022/4/15 19:50:00,72,122,-50
30654,30654,284,2022/4/15 20:00:00,70,106,-36
30655,30655,284,2022/4/15 20:10:00,83,109,-26
30656,30656,284,2022/4/15 20:20:00,70,101,-31
30657,30657,284,2022/4/15 20:30:00,51,105,-54
30658,30658,284,2022/4/15 20:40:00,65,99,-34
30659,30659,284,2022/4/15 20:50:00,54,111,-57
30660,30660,284,2022/4/15 21:00:00,55,113,-58
30661,30661,284,2022/4/15 21:10:00,62,108,-46
30662,30662,284,2022/4/15 21:20:00,44,121,-77
30663,30663,284,2022/4/15 21:30:00,45,120,-75
30664,30664,284,2022/4/15 21:40:00,46,106,-60
30665,30665,284,2022/4/15 21:50:00,37,106,-69
30666,30666,284,2022/4/15 22:00:00,26,105,-79
30667,30667,284,2022/4/15 22:10:00,30,102,-72
30668,30668,284,2022/4/15 22:20:00,26,103,-77
30669,30669,284,2022/4/15 22:30:00,18,92,-74
30670,30670,284,2022/4/15 22:40:00,14,77,-63
30671,30671,284,2022/4/15 22:50:00,9,64,-55
30672,30672,285,2022/4/15 5:00:00,0,1,-1
30673,30673,285,2022/4/15 5:10:00,3,1,2
30674,30674,285,2022/4/15 5:20:00,11,1,10
30675,30675,285,2022/4/15 5:30:00,16,1,15
30676,30676,285,2022/4/15 5:40:00,17,1,16
30677,30677,285,2022/4/15 5:50:00,18,1,17
30678,30678,285,2022/4/15 6:00:00,27,5,22
30679,30679,285,2022/4/15 6:10:00,36,1,35
30680,30680,285,2022/4/15 6:20:00,53,8,45
30681,30681,285,2022/4/15 6:30:00,48,63,-15
30682,30682,285,2022/4/15 6:40:00,62,63,-1
30683,30683,285,2022/4/15 6:50:00,97,72,25
30684,30684,285,2022/4/15 7:00:00,107,75,32
30685,30685,285,2022/4/15 7:10:00,196,83,113
30686,30686,285,2022/4/15 7:20:00,241,121,120
30687,30687,285,2022/4/15 7:30:00,278,97,181
30688,30688,285,2022/4/15 7:40:00,277,106,171
30689,30689,285,2022/4/15 7:50:00,300,104,196
30690,30690,285,2022/4/15 8:00:00,302,124,178
30691,30691,285,2022/4/15 8:10:00,280,111,169
30692,30692,285,2022/4/15 8:20:00,255,102,153
30693,30693,285,2022/4/15 8:30:00,215,126,89
30694,30694,285,2022/4/15 8:40:00,157,110,47
30695,30695,285,2022/4/15 8:50:00,102,105,-3
30696,30696,285,2022/4/15 9:00:00,74,108,-34
30697,30697,285,2022/4/15 9:10:00,53,96,-43
30698,30698,285,2022/4/15 9:20:00,50,105,-55
30699,30699,285,2022/4/15 9:30:00,39,108,-69
30700,30700,285,2022/4/15 9:40:00,40,101,-61
30701,30701,285,2022/4/15 9:50:00,39,82,-43
30702,30702,285,2022/4/15 10:00:00,35,93,-58
30703,30703,285,2022/4/15 10:10:00,38,96,-58
30704,30704,285,2022/4/15 10:20:00,39,67,-28
30705,30705,285,2022/4/15 10:30:00,35,82,-47
30706,30706,285,2022/4/15 10:40:00,33,70,-37
30707,30707,285,2022/4/15 10:50:00,29,92,-63
30708,30708,285,2022/4/15 11:00:00,30,66,-36
30709,30709,285,2022/4/15 11:10:00,33,65,-32
30710,30710,285,2022/4/15 11:20:00,35,62,-27
30711,30711,285,2022/4/15 11:30:00,28,74,-46
30712,30712,285,2022/4/15 11:40:00,34,71,-37
30713,30713,285,2022/4/15 11:50:00,27,66,-39
30714,30714,285,2022/4/15 12:00:00,35,63,-28
30715,30715,285,2022/4/15 12:10:00,33,79,-46
30716,30716,285,2022/4/15 12:20:00,36,67,-31
30717,30717,285,2022/4/15 12:30:00,33,69,-36
30718,30718,285,2022/4/15 12:40:00,29,68,-39
30719,30719,285,2022/4/15 12:50:00,28,82,-54
30720,30720,285,2022/4/15 13:00:00,37,74,-37
30721,30721,285,2022/4/15 13:10:00,29,72,-43
30722,30722,285,2022/4/15 13:20:00,31,71,-40
30723,30723,285,2022/4/15 13:30:00,31,93,-62
30724,30724,285,2022/4/15 13:40:00,32,64,-32
30725,30725,285,2022/4/15 13:50:00,25,73,-48
30726,30726,285,2022/4/15 14:00:00,31,72,-41
30727,30727,285,2022/4/15 14:10:00,30,93,-63
30728,30728,285,2022/4/15 14:20:00,33,80,-47
30729,30729,285,2022/4/15 14:30:00,35,74,-39
30730,30730,285,2022/4/15 14:40:00,31,77,-46
30731,30731,285,2022/4/15 14:50:00,26,90,-64
30732,30732,285,2022/4/15 15:00:00,33,74,-41
30733,30733,285,2022/4/15 15:10:00,30,72,-42
30734,30734,285,2022/4/15 15:20:00,34,75,-41
30735,30735,285,2022/4/15 15:30:00,35,102,-67
30736,30736,285,2022/4/15 15:40:00,35,75,-40
30737,30737,285,2022/4/15 15:50:00,37,84,-47
30738,30738,285,2022/4/15 16:00:00,33,76,-43
30739,30739,285,2022/4/15 16:10:00,39,108,-69
30740,30740,285,2022/4/15 16:20:00,40,76,-36
30741,30741,285,2022/4/15 16:30:00,39,84,-45
30742,30742,285,2022/4/15 16:40:00,45,98,-53
30743,30743,285,2022/4/15 16:50:00,44,118,-74
30744,30744,285,2022/4/15 17:00:00,47,103,-56
30745,30745,285,2022/4/15 17:10:00,67,105,-38
30746,30746,285,2022/4/15 17:20:00,50,106,-56
30747,30747,285,2022/4/15 17:30:00,62,152,-90
30748,30748,285,2022/4/15 17:40:00,74,109,-35
30749,30749,285,2022/4/15 17:50:00,70,168,-98
30750,30750,285,2022/4/15 18:00:00,54,121,-67
30751,30751,285,2022/4/15 18:10:00,76,180,-104
30752,30752,285,2022/4/15 18:20:00,40,111,-71
30753,30753,285,2022/4/15 18:30:00,35,198,-163
30754,30754,285,2022/4/15 18:40:00,36,125,-89
30755,30755,285,2022/4/15 18:50:00,33,171,-138
30756,30756,285,2022/4/15 19:00:00,31,120,-89
30757,30757,285,2022/4/15 19:10:00,28,116,-88
30758,30758,285,2022/4/15 19:20:00,29,113,-84
30759,30759,285,2022/4/15 19:30:00,25,116,-91
30760,30760,285,2022/4/15 19:40:00,25,88,-63
30761,30761,285,2022/4/15 19:50:00,23,113,-90
30762,30762,285,2022/4/15 20:00:00,24,80,-56
30763,30763,285,2022/4/15 20:10:00,25,99,-74
30764,30764,285,2022/4/15 20:20:00,27,77,-50
30765,30765,285,2022/4/15 20:30:00,23,69,-46
30766,30766,285,2022/4/15 20:40:00,21,71,-50
30767,30767,285,2022/4/15 20:50:00,22,82,-60
30768,30768,285,2022/4/15 21:00:00,22,74,-52
30769,30769,285,2022/4/15 21:10:00,21,83,-62
30770,30770,285,2022/4/15 21:20:00,22,85,-63
30771,30771,285,2022/4/15 21:30:00,17,99,-82
30772,30772,285,2022/4/15 21:40:00,15,84,-69
30773,30773,285,2022/4/15 21:50:00,15,86,-71
30774,30774,285,2022/4/15 22:00:00,15,71,-56
30775,30775,285,2022/4/15 22:10:00,13,71,-58
30776,30776,285,2022/4/15 22:20:00,10,73,-63
30777,30777,285,2022/4/15 22:30:00,2,84,-82
30778,30778,285,2022/4/15 22:40:00,0,66,-66
30779,30779,285,2022/4/15 22:50:00,0,50,-50
30780,30780,286,2022/4/15 5:00:00,1,1,0
30781,30781,286,2022/4/15 5:10:00,7,1,6
30782,30782,286,2022/4/15 5:20:00,22,1,21
30783,30783,286,2022/4/15 5:30:00,31,1,30
30784,30784,286,2022/4/15 5:40:00,31,1,30
30785,30785,286,2022/4/15 5:50:00,40,1,39
30786,30786,286,2022/4/15 6:00:00,46,1,45
30787,30787,286,2022/4/15 6:10:00,57,5,52
30788,30788,286,2022/4/15 6:20:00,84,32,52
30789,30789,286,2022/4/15 6:30:00,184,38,146
30790,30790,286,2022/4/15 6:40:00,244,50,194
30791,30791,286,2022/4/15 6:50:00,278,70,208
30792,30792,286,2022/4/15 7:00:00,359,78,281
30793,30793,286,2022/4/15 7:10:00,470,104,366
30794,30794,286,2022/4/15 7:20:00,665,105,560
30795,30795,286,2022/4/15 7:30:00,740,102,638
30796,30796,286,2022/4/15 7:40:00,864,113,751
30797,30797,286,2022/4/15 7:50:00,1177,121,1056
30798,30798,286,2022/4/15 8:00:00,1170,127,1043
30799,30799,286,2022/4/15 8:10:00,1169,110,1059
30800,30800,286,2022/4/15 8:20:00,827,94,733
30801,30801,286,2022/4/15 8:30:00,724,122,602
30802,30802,286,2022/4/15 8:40:00,594,119,475
30803,30803,286,2022/4/15 8:50:00,331,109,222
30804,30804,286,2022/4/15 9:00:00,267,87,180
30805,30805,286,2022/4/15 9:10:00,216,83,133
30806,30806,286,2022/4/15 9:20:00,160,77,83
30807,30807,286,2022/4/15 9:30:00,116,77,39
30808,30808,286,2022/4/15 9:40:00,77,85,-8
30809,30809,286,2022/4/15 9:50:00,60,81,-21
30810,30810,286,2022/4/15 10:00:00,46,78,-32
30811,30811,286,2022/4/15 10:10:00,45,64,-19
30812,30812,286,2022/4/15 10:20:00,43,66,-23
30813,30813,286,2022/4/15 10:30:00,38,75,-37
30814,30814,286,2022/4/15 10:40:00,36,64,-28
30815,30815,286,2022/4/15 10:50:00,35,82,-47
30816,30816,286,2022/4/15 11:00:00,33,65,-32
30817,30817,286,2022/4/15 11:10:00,37,83,-46
30818,30818,286,2022/4/15 11:20:00,40,70,-30
30819,30819,286,2022/4/15 11:30:00,35,81,-46
30820,30820,286,2022/4/15 11:40:00,36,74,-38
30821,30821,286,2022/4/15 11:50:00,40,82,-42
30822,30822,286,2022/4/15 12:00:00,41,76,-35
30823,30823,286,2022/4/15 12:10:00,44,81,-37
30824,30824,286,2022/4/15 12:20:00,43,74,-31
30825,30825,286,2022/4/15 12:30:00,44,87,-43
30826,30826,286,2022/4/15 12:40:00,41,76,-35
30827,30827,286,2022/4/15 12:50:00,41,97,-56
30828,30828,286,2022/4/15 13:00:00,41,72,-31
30829,30829,286,2022/4/15 13:10:00,44,91,-47
30830,30830,286,2022/4/15 13:20:00,39,69,-30
30831,30831,286,2022/4/15 13:30:00,38,90,-52
30832,30832,286,2022/4/15 13:40:00,37,64,-27
30833,30833,286,2022/4/15 13:50:00,37,94,-57
30834,30834,286,2022/4/15 14:00:00,40,74,-34
30835,30835,286,2022/4/15 14:10:00,33,93,-60
30836,30836,286,2022/4/15 14:20:00,30,72,-42
30837,30837,286,2022/4/15 14:30:00,32,105,-73
30838,30838,286,2022/4/15 14:40:00,36,76,-40
30839,30839,286,2022/4/15 14:50:00,37,105,-68
30840,30840,286,2022/4/15 15:00:00,36,97,-61
30841,30841,286,2022/4/15 15:10:00,44,102,-58
30842,30842,286,2022/4/15 15:20:00,34,99,-65
30843,30843,286,2022/4/15 15:30:00,40,121,-81
30844,30844,286,2022/4/15 15:40:00,39,103,-64
30845,30845,286,2022/4/15 15:50:00,37,125,-88
30846,30846,286,2022/4/15 16:00:00,42,100,-58
30847,30847,286,2022/4/15 16:10:00,42,121,-79
30848,30848,286,2022/4/15 16:20:00,47,123,-76
30849,30849,286,2022/4/15 16:30:00,54,109,-55
30850,30850,286,2022/4/15 16:40:00,48,125,-77
30851,30851,286,2022/4/15 16:50:00,45,152,-107
30852,30852,286,2022/4/15 17:00:00,77,111,-34
30853,30853,286,2022/4/15 17:10:00,103,220,-117
30854,30854,286,2022/4/15 17:20:00,65,189,-124
30855,30855,286,2022/4/15 17:30:00,61,281,-220
30856,30856,286,2022/4/15 17:40:00,69,295,-226
30857,30857,286,2022/4/15 17:50:00,44,315,-271
30858,30858,286,2022/4/15 18:00:00,44,317,-273
30859,30859,286,2022/4/15 18:10:00,53,321,-268
30860,30860,286,2022/4/15 18:20:00,46,426,-380
30861,30861,286,2022/4/15 18:30:00,36,383,-347
30862,30862,286,2022/4/15 18:40:00,39,508,-469
30863,30863,286,2022/4/15 18:50:00,31,323,-292
30864,30864,286,2022/4/15 19:00:00,30,435,-405
30865,30865,286,2022/4/15 19:10:00,31,299,-268
30866,30866,286,2022/4/15 19:20:00,34,233,-199
30867,30867,286,2022/4/15 19:30:00,30,191,-161
30868,30868,286,2022/4/15 19:40:00,29,137,-108
30869,30869,286,2022/4/15 19:50:00,27,120,-93
30870,30870,286,2022/4/15 20:00:00,28,110,-82
30871,30871,286,2022/4/15 20:10:00,23,111,-88
30872,30872,286,2022/4/15 20:20:00,25,121,-96
30873,30873,286,2022/4/15 20:30:00,23,127,-104
30874,30874,286,2022/4/15 20:40:00,26,126,-100
30875,30875,286,2022/4/15 20:50:00,27,109,-82
30876,30876,286,2022/4/15 21:00:00,25,122,-97
30877,30877,286,2022/4/15 21:10:00,29,126,-97
30878,30878,286,2022/4/15 21:20:00,22,114,-92
30879,30879,286,2022/4/15 21:30:00,21,123,-102
30880,30880,286,2022/4/15 21:40:00,21,112,-91
30881,30881,286,2022/4/15 21:50:00,17,103,-86
30882,30882,286,2022/4/15 22:00:00,16,118,-102
30883,30883,286,2022/4/15 22:10:00,15,105,-90
30884,30884,286,2022/4/15 22:20:00,8,123,-115
30885,30885,286,2022/4/15 22:30:00,7,110,-103
30886,30886,286,2022/4/15 22:40:00,2,103,-101
30887,30887,286,2022/4/15 22:50:00,2,99,-97
30888,30888,287,2022/4/15 5:00:00,0,1,-1
30889,30889,287,2022/4/15 5:10:00,0,1,-1
30890,30890,287,2022/4/15 5:20:00,3,1,2
30891,30891,287,2022/4/15 5:30:00,15,1,14
30892,30892,287,2022/4/15 5:40:00,30,2,28
30893,30893,287,2022/4/15 5:50:00,34,5,29
30894,30894,287,2022/4/15 6:00:00,38,2,36
30895,30895,287,2022/4/15 6:10:00,58,23,35
30896,30896,287,2022/4/15 6:20:00,68,21,47
30897,30897,287,2022/4/15 6:30:00,149,38,111
30898,30898,287,2022/4/15 6:40:00,226,62,164
30899,30899,287,2022/4/15 6:50:00,243,50,193
30900,30900,287,2022/4/15 7:00:00,265,71,194
30901,30901,287,2022/4/15 7:10:00,339,69,270
30902,30902,287,2022/4/15 7:20:00,588,68,520
30903,30903,287,2022/4/15 7:30:00,703,89,614
30904,30904,287,2022/4/15 7:40:00,1049,83,966
30905,30905,287,2022/4/15 7:50:00,1368,97,1271
30906,30906,287,2022/4/15 8:00:00,1573,108,1465
30907,30907,287,2022/4/15 8:10:00,1571,108,1463
30908,30908,287,2022/4/15 8:20:00,1359,111,1248
30909,30909,287,2022/4/15 8:30:00,1173,121,1052
30910,30910,287,2022/4/15 8:40:00,831,128,703
30911,30911,287,2022/4/15 8:50:00,722,107,615
30912,30912,287,2022/4/15 9:00:00,578,105,473
30913,30913,287,2022/4/15 9:10:00,342,109,233
30914,30914,287,2022/4/15 9:20:00,276,80,196
30915,30915,287,2022/4/15 9:30:00,225,76,149
30916,30916,287,2022/4/15 9:40:00,167,76,91
30917,30917,287,2022/4/15 9:50:00,90,72,18
30918,30918,287,2022/4/15 10:00:00,76,77,-1
30919,30919,287,2022/4/15 10:10:00,69,68,1
30920,30920,287,2022/4/15 10:20:00,60,75,-15
30921,30921,287,2022/4/15 10:30:00,44,70,-26
30922,30922,287,2022/4/15 10:40:00,46,84,-38
30923,30923,287,2022/4/15 10:50:00,43,64,-21
30924,30924,287,2022/4/15 11:00:00,37,80,-43
30925,30925,287,2022/4/15 11:10:00,40,72,-32
30926,30926,287,2022/4/15 11:20:00,38,76,-38
30927,30927,287,2022/4/15 11:30:00,35,69,-34
30928,30928,287,2022/4/15 11:40:00,38,87,-49
30929,30929,287,2022/4/15 11:50:00,39,74,-35
30930,30930,287,2022/4/15 12:00:00,42,93,-51
30931,30931,287,2022/4/15 12:10:00,47,70,-23
30932,30932,287,2022/4/15 12:20:00,48,98,-50
30933,30933,287,2022/4/15 12:30:00,46,82,-36
30934,30934,287,2022/4/15 12:40:00,44,75,-31
30935,30935,287,2022/4/15 12:50:00,43,84,-41
30936,30936,287,2022/4/15 13:00:00,43,93,-50
30937,30937,287,2022/4/15 13:10:00,45,81,-36
30938,30938,287,2022/4/15 13:20:00,39,93,-54
30939,30939,287,2022/4/15 13:30:00,38,81,-43
30940,30940,287,2022/4/15 13:40:00,39,96,-57
30941,30941,287,2022/4/15 13:50:00,35,76,-41
30942,30942,287,2022/4/15 14:00:00,37,90,-53
30943,30943,287,2022/4/15 14:10:00,28,75,-47
30944,30944,287,2022/4/15 14:20:00,32,99,-67
30945,30945,287,2022/4/15 14:30:00,34,87,-53
30946,30946,287,2022/4/15 14:40:00,32,108,-76
30947,30947,287,2022/4/15 14:50:00,30,93,-63
30948,30948,287,2022/4/15 15:00:00,29,112,-83
30949,30949,287,2022/4/15 15:10:00,36,96,-60
30950,30950,287,2022/4/15 15:20:00,31,105,-74
30951,30951,287,2022/4/15 15:30:00,36,103,-67
30952,30952,287,2022/4/15 15:40:00,31,101,-70
30953,30953,287,2022/4/15 15:50:00,29,112,-83
30954,30954,287,2022/4/15 16:00:00,33,106,-73
30955,30955,287,2022/4/15 16:10:00,36,97,-61
30956,30956,287,2022/4/15 16:20:00,36,128,-92
30957,30957,287,2022/4/15 16:30:00,41,124,-83
30958,30958,287,2022/4/15 16:40:00,37,152,-115
30959,30959,287,2022/4/15 16:50:00,38,105,-67
30960,30960,287,2022/4/15 17:00:00,46,177,-131
30961,30961,287,2022/4/15 17:10:00,77,177,-100
30962,30962,287,2022/4/15 17:20:00,57,230,-173
30963,30963,287,2022/4/15 17:30:00,57,324,-267
30964,30964,287,2022/4/15 17:40:00,96,424,-328
30965,30965,287,2022/4/15 17:50:00,70,330,-260
30966,30966,287,2022/4/15 18:00:00,57,429,-372
30967,30967,287,2022/4/15 18:10:00,76,428,-352
30968,30968,287,2022/4/15 18:20:00,47,420,-373
30969,30969,287,2022/4/15 18:30:00,41,402,-361
30970,30970,287,2022/4/15 18:40:00,39,413,-374
30971,30971,287,2022/4/15 18:50:00,33,419,-386
30972,30972,287,2022/4/15 19:00:00,35,440,-405
30973,30973,287,2022/4/15 19:10:00,29,375,-346
30974,30974,287,2022/4/15 19:20:00,31,330,-299
30975,30975,287,2022/4/15 19:30:00,28,224,-196
30976,30976,287,2022/4/15 19:40:00,26,207,-181
30977,30977,287,2022/4/15 19:50:00,28,167,-139
30978,30978,287,2022/4/15 20:00:00,27,155,-128
30979,30979,287,2022/4/15 20:10:00,29,119,-90
30980,30980,287,2022/4/15 20:20:00,29,107,-78
30981,30981,287,2022/4/15 20:30:00,28,128,-100
30982,30982,287,2022/4/15 20:40:00,23,128,-105
30983,30983,287,2022/4/15 20:50:00,27,116,-89
30984,30984,287,2022/4/15 21:00:00,28,109,-81
30985,30985,287,2022/4/15 21:10:00,26,110,-84
30986,30986,287,2022/4/15 21:20:00,26,117,-91
30987,30987,287,2022/4/15 21:30:00,27,154,-127
30988,30988,287,2022/4/15 21:40:00,21,124,-103
30989,30989,287,2022/4/15 21:50:00,21,110,-89
30990,30990,287,2022/4/15 22:00:00,23,121,-98
30991,30991,287,2022/4/15 22:10:00,19,143,-124
30992,30992,287,2022/4/15 22:20:00,15,116,-101
30993,30993,287,2022/4/15 22:30:00,12,110,-98
30994,30994,287,2022/4/15 22:40:00,6,115,-109
30995,30995,287,2022/4/15 22:50:00,2,105,-103
30996,30996,288,2022/4/15 5:00:00,0,1,-1
30997,30997,288,2022/4/15 5:10:00,0,1,-1
30998,30998,288,2022/4/15 5:20:00,2,1,1
30999,30999,288,2022/4/15 5:30:00,11,1,10
31000,31000,288,2022/4/15 5:40:00,26,2,24
31001,31001,288,2022/4/15 5:50:00,32,24,8
31002,31002,288,2022/4/15 6:00:00,39,16,23
31003,31003,288,2022/4/15 6:10:00,54,52,2
31004,31004,288,2022/4/15 6:20:00,64,51,13
31005,31005,288,2022/4/15 6:30:00,88,60,28
31006,31006,288,2022/4/15 6:40:00,152,75,77
31007,31007,288,2022/4/15 6:50:00,200,95,105
31008,31008,288,2022/4/15 7:00:00,228,124,104
31009,31009,288,2022/4/15 7:10:00,257,128,129
31010,31010,288,2022/4/15 7:20:00,301,112,189
31011,31011,288,2022/4/15 7:30:00,397,128,269
31012,31012,288,2022/4/15 7:40:00,656,103,553
31013,31013,288,2022/4/15 7:50:00,821,123,698
31014,31014,288,2022/4/15 8:00:00,859,138,721
31015,31015,288,2022/4/15 8:10:00,870,146,724
31016,31016,288,2022/4/15 8:20:00,1056,232,824
31017,31017,288,2022/4/15 8:30:00,824,218,606
31018,31018,288,2022/4/15 8:40:00,689,234,455
31019,31019,288,2022/4/15 8:50:00,599,192,407
31020,31020,288,2022/4/15 9:00:00,380,117,263
31021,31021,288,2022/4/15 9:10:00,314,109,205
31022,31022,288,2022/4/15 9:20:00,275,105,170
31023,31023,288,2022/4/15 9:30:00,214,123,91
31024,31024,288,2022/4/15 9:40:00,141,119,22
31025,31025,288,2022/4/15 9:50:00,79,118,-39
31026,31026,288,2022/4/15 10:00:00,68,97,-29
31027,31027,288,2022/4/15 10:10:00,63,105,-42
31028,31028,288,2022/4/15 10:20:00,48,103,-55
31029,31029,288,2022/4/15 10:30:00,46,97,-51
31030,31030,288,2022/4/15 10:40:00,45,103,-58
31031,31031,288,2022/4/15 10:50:00,41,112,-71
31032,31032,288,2022/4/15 11:00:00,42,108,-66
31033,31033,288,2022/4/15 11:10:00,44,90,-46
31034,31034,288,2022/4/15 11:20:00,40,112,-72
31035,31035,288,2022/4/15 11:30:00,41,104,-63
31036,31036,288,2022/4/15 11:40:00,43,112,-69
31037,31037,288,2022/4/15 11:50:00,43,105,-62
31038,31038,288,2022/4/15 12:00:00,44,106,-62
31039,31039,288,2022/4/15 12:10:00,48,101,-53
31040,31040,288,2022/4/15 12:20:00,52,103,-51
31041,31041,288,2022/4/15 12:30:00,58,105,-47
31042,31042,288,2022/4/15 12:40:00,51,87,-36
31043,31043,288,2022/4/15 12:50:00,63,103,-40
31044,31044,288,2022/4/15 13:00:00,51,119,-68
31045,31045,288,2022/4/15 13:10:00,63,103,-40
31046,31046,288,2022/4/15 13:20:00,51,108,-57
31047,31047,288,2022/4/15 13:30:00,47,104,-57
31048,31048,288,2022/4/15 13:40:00,52,125,-73
31049,31049,288,2022/4/15 13:50:00,48,108,-60
31050,31050,288,2022/4/15 14:00:00,42,102,-60
31051,31051,288,2022/4/15 14:10:00,53,110,-57
31052,31052,288,2022/4/15 14:20:00,45,114,-69
31053,31053,288,2022/4/15 14:30:00,51,118,-67
31054,31054,288,2022/4/15 14:40:00,57,125,-68
31055,31055,288,2022/4/15 14:50:00,60,122,-62
31056,31056,288,2022/4/15 15:00:00,54,123,-69
31057,31057,288,2022/4/15 15:10:00,71,113,-42
31058,31058,288,2022/4/15 15:20:00,56,110,-54
31059,31059,288,2022/4/15 15:30:00,67,114,-47
31060,31060,288,2022/4/15 15:40:00,71,117,-46
31061,31061,288,2022/4/15 15:50:00,73,108,-35
31062,31062,288,2022/4/15 16:00:00,65,119,-54
31063,31063,288,2022/4/15 16:10:00,110,110,0
31064,31064,288,2022/4/15 16:20:00,72,144,-72
31065,31065,288,2022/4/15 16:30:00,149,152,-3
31066,31066,288,2022/4/15 16:40:00,195,191,4
31067,31067,288,2022/4/15 16:50:00,151,192,-41
31068,31068,288,2022/4/15 17:00:00,181,204,-23
31069,31069,288,2022/4/15 17:10:00,203,265,-62
31070,31070,288,2022/4/15 17:20:00,205,330,-125
31071,31071,288,2022/4/15 17:30:00,212,523,-311
31072,31072,288,2022/4/15 17:40:00,200,533,-333
31073,31073,288,2022/4/15 17:50:00,228,417,-189
31074,31074,288,2022/4/15 18:00:00,177,434,-257
31075,31075,288,2022/4/15 18:10:00,148,430,-282
31076,31076,288,2022/4/15 18:20:00,80,425,-345
31077,31077,288,2022/4/15 18:30:00,75,475,-400
31078,31078,288,2022/4/15 18:40:00,63,491,-428
31079,31079,288,2022/4/15 18:50:00,55,431,-376
31080,31080,288,2022/4/15 19:00:00,50,421,-371
31081,31081,288,2022/4/15 19:10:00,52,341,-289
31082,31082,288,2022/4/15 19:20:00,46,300,-254
31083,31083,288,2022/4/15 19:30:00,44,217,-173
31084,31084,288,2022/4/15 19:40:00,45,221,-176
31085,31085,288,2022/4/15 19:50:00,39,169,-130
31086,31086,288,2022/4/15 20:00:00,46,142,-96
31087,31087,288,2022/4/15 20:10:00,60,144,-84
31088,31088,288,2022/4/15 20:20:00,47,128,-81
31089,31089,288,2022/4/15 20:30:00,54,121,-67
31090,31090,288,2022/4/15 20:40:00,51,123,-72
31091,31091,288,2022/4/15 20:50:00,46,133,-87
31092,31092,288,2022/4/15 21:00:00,51,106,-55
31093,31093,288,2022/4/15 21:10:00,55,109,-54
31094,31094,288,2022/4/15 21:20:00,46,116,-70
31095,31095,288,2022/4/15 21:30:00,44,110,-66
31096,31096,288,2022/4/15 21:40:00,43,123,-80
31097,31097,288,2022/4/15 21:50:00,39,119,-80
31098,31098,288,2022/4/15 22:00:00,139,102,37
31099,31099,288,2022/4/15 22:10:00,50,128,-78
31100,31100,288,2022/4/15 22:20:00,23,122,-99
31101,31101,288,2022/4/15 22:30:00,18,108,-90
31102,31102,288,2022/4/15 22:40:00,13,109,-96
31103,31103,288,2022/4/15 22:50:00,6,78,-72
31104,31104,289,2022/4/15 5:00:00,0,1,-1
31105,31105,289,2022/4/15 5:10:00,0,1,-1
31106,31106,289,2022/4/15 5:20:00,0,1,-1
31107,31107,289,2022/4/15 5:30:00,0,1,-1
31108,31108,289,2022/4/15 5:40:00,0,1,-1
31109,31109,289,2022/4/15 5:50:00,0,1,-1
31110,31110,289,2022/4/15 6:00:00,3,1,2
31111,31111,289,2022/4/15 6:10:00,9,11,-2
31112,31112,289,2022/4/15 6:20:00,3,19,-16
31113,31113,289,2022/4/15 6:30:00,4,13,-9
31114,31114,289,2022/4/15 6:40:00,5,15,-10
31115,31115,289,2022/4/15 6:50:00,4,29,-25
31116,31116,289,2022/4/15 7:00:00,4,38,-34
31117,31117,289,2022/4/15 7:10:00,5,38,-33
31118,31118,289,2022/4/15 7:20:00,10,47,-37
31119,31119,289,2022/4/15 7:30:00,12,70,-58
31120,31120,289,2022/4/15 7:40:00,14,70,-56
31121,31121,289,2022/4/15 7:50:00,17,85,-68
31122,31122,289,2022/4/15 8:00:00,18,83,-65
31123,31123,289,2022/4/15 8:10:00,16,73,-57
31124,31124,289,2022/4/15 8:20:00,17,75,-58
31125,31125,289,2022/4/15 8:30:00,15,90,-75
31126,31126,289,2022/4/15 8:40:00,8,104,-96
31127,31127,289,2022/4/15 8:50:00,11,110,-99
31128,31128,289,2022/4/15 9:00:00,10,102,-92
31129,31129,289,2022/4/15 9:10:00,5,126,-121
31130,31130,289,2022/4/15 9:20:00,7,109,-102
31131,31131,289,2022/4/15 9:30:00,6,105,-99
31132,31132,289,2022/4/15 9:40:00,5,96,-91
31133,31133,289,2022/4/15 9:50:00,6,90,-84
31134,31134,289,2022/4/15 10:00:00,7,77,-70
31135,31135,289,2022/4/15 10:10:00,5,76,-71
31136,31136,289,2022/4/15 10:20:00,8,74,-66
31137,31137,289,2022/4/15 10:30:00,11,81,-70
31138,31138,289,2022/4/15 10:40:00,10,69,-59
31139,31139,289,2022/4/15 10:50:00,11,69,-58
31140,31140,289,2022/4/15 11:00:00,12,64,-52
31141,31141,289,2022/4/15 11:10:00,15,63,-48
31142,31142,289,2022/4/15 11:20:00,16,60,-44
31143,31143,289,2022/4/15 11:30:00,14,69,-55
31144,31144,289,2022/4/15 11:40:00,16,64,-48
31145,31145,289,2022/4/15 11:50:00,17,62,-45
31146,31146,289,2022/4/15 12:00:00,16,56,-40
31147,31147,289,2022/4/15 12:10:00,16,68,-52
31148,31148,289,2022/4/15 12:20:00,20,64,-44
31149,31149,289,2022/4/15 12:30:00,17,56,-39
31150,31150,289,2022/4/15 12:40:00,17,63,-46
31151,31151,289,2022/4/15 12:50:00,21,68,-47
31152,31152,289,2022/4/15 13:00:00,22,57,-35
31153,31153,289,2022/4/15 13:10:00,21,61,-40
31154,31154,289,2022/4/15 13:20:00,20,61,-41
31155,31155,289,2022/4/15 13:30:00,25,70,-45
31156,31156,289,2022/4/15 13:40:00,23,56,-33
31157,31157,289,2022/4/15 13:50:00,27,68,-41
31158,31158,289,2022/4/15 14:00:00,25,56,-31
31159,31159,289,2022/4/15 14:10:00,22,67,-45
31160,31160,289,2022/4/15 14:20:00,23,59,-36
31161,31161,289,2022/4/15 14:30:00,25,64,-39
31162,31162,289,2022/4/15 14:40:00,23,57,-34
31163,31163,289,2022/4/15 14:50:00,24,70,-46
31164,31164,289,2022/4/15 15:00:00,23,55,-32
31165,31165,289,2022/4/15 15:10:00,23,57,-34
31166,31166,289,2022/4/15 15:20:00,24,57,-33
31167,31167,289,2022/4/15 15:30:00,27,69,-42
31168,31168,289,2022/4/15 15:40:00,26,51,-25
31169,31169,289,2022/4/15 15:50:00,25,60,-35
31170,31170,289,2022/4/15 16:00:00,29,57,-28
31171,31171,289,2022/4/15 16:10:00,28,61,-33
31172,31172,289,2022/4/15 16:20:00,24,64,-40
31173,31173,289,2022/4/15 16:30:00,34,68,-34
31174,31174,289,2022/4/15 16:40:00,28,63,-35
31175,31175,289,2022/4/15 16:50:00,36,72,-36
31176,31176,289,2022/4/15 17:00:00,43,69,-26
31177,31177,289,2022/4/15 17:10:00,51,70,-19
31178,31178,289,2022/4/15 17:20:00,41,81,-40
31179,31179,289,2022/4/15 17:30:00,34,87,-53
31180,31180,289,2022/4/15 17:40:00,44,90,-46
31181,31181,289,2022/4/15 17:50:00,30,96,-66
31182,31182,289,2022/4/15 18:00:00,31,102,-71
31183,31183,289,2022/4/15 18:10:00,28,96,-68
31184,31184,289,2022/4/15 18:20:00,28,102,-74
31185,31185,289,2022/4/15 18:30:00,29,101,-72
31186,31186,289,2022/4/15 18:40:00,26,102,-76
31187,31187,289,2022/4/15 18:50:00,20,94,-74
31188,31188,289,2022/4/15 19:00:00,21,88,-67
31189,31189,289,2022/4/15 19:10:00,26,98,-72
31190,31190,289,2022/4/15 19:20:00,25,73,-48
31191,31191,289,2022/4/15 19:30:00,23,71,-48
31192,31192,289,2022/4/15 19:40:00,24,62,-38
31193,31193,289,2022/4/15 19:50:00,25,48,-23
31194,31194,289,2022/4/15 20:00:00,29,38,-9
31195,31195,289,2022/4/15 20:10:00,32,39,-7
31196,31196,289,2022/4/15 20:20:00,28,33,-5
31197,31197,289,2022/4/15 20:30:00,31,32,-1
31198,31198,289,2022/4/15 20:40:00,27,30,-3
31199,31199,289,2022/4/15 20:50:00,27,23,4
31200,31200,289,2022/4/15 21:00:00,36,25,11
31201,31201,289,2022/4/15 21:10:00,39,25,14
31202,31202,289,2022/4/15 21:20:00,35,21,14
31203,31203,289,2022/4/15 21:30:00,45,21,24
31204,31204,289,2022/4/15 21:40:00,36,21,15
31205,31205,289,2022/4/15 21:50:00,35,18,17
31206,31206,289,2022/4/15 22:00:00,109,13,96
31207,31207,289,2022/4/15 22:10:00,66,13,53
31208,31208,289,2022/4/15 22:20:00,20,15,5
31209,31209,289,2022/4/15 22:30:00,14,15,-1
31210,31210,289,2022/4/15 22:40:00,10,3,7
31211,31211,289,2022/4/15 22:50:00,7,4,3
31212,31212,290,2022/4/15 5:00:00,0,1,-1
31213,31213,290,2022/4/15 5:10:00,0,1,-1
31214,31214,290,2022/4/15 5:20:00,1,1,0
31215,31215,290,2022/4/15 5:30:00,6,1,5
31216,31216,290,2022/4/15 5:40:00,24,1,23
31217,31217,290,2022/4/15 5:50:00,25,13,12
31218,31218,290,2022/4/15 6:00:00,32,8,24
31219,31219,290,2022/4/15 6:10:00,42,46,-4
31220,31220,290,2022/4/15 6:20:00,51,33,18
31221,31221,290,2022/4/15 6:30:00,58,50,8
31222,31222,290,2022/4/15 6:40:00,88,66,22
31223,31223,290,2022/4/15 6:50:00,151,77,74
31224,31224,290,2022/4/15 7:00:00,182,105,77
31225,31225,290,2022/4/15 7:10:00,216,117,99
31226,31226,290,2022/4/15 7:20:00,228,121,107
31227,31227,290,2022/4/15 7:30:00,254,112,142
31228,31228,290,2022/4/15 7:40:00,322,183,139
31229,31229,290,2022/4/15 7:50:00,378,159,219
31230,31230,290,2022/4/15 8:00:00,438,192,246
31231,31231,290,2022/4/15 8:10:00,446,226,220
31232,31232,290,2022/4/15 8:20:00,338,146,192
31233,31233,290,2022/4/15 8:30:00,360,144,216
31234,31234,290,2022/4/15 8:40:00,278,197,81
31235,31235,290,2022/4/15 8:50:00,263,154,109
31236,31236,290,2022/4/15 9:00:00,227,125,102
31237,31237,290,2022/4/15 9:10:00,192,110,82
31238,31238,290,2022/4/15 9:20:00,168,118,50
31239,31239,290,2022/4/15 9:30:00,115,116,-1
31240,31240,290,2022/4/15 9:40:00,76,104,-28
31241,31241,290,2022/4/15 9:50:00,58,98,-40
31242,31242,290,2022/4/15 10:00:00,50,81,-31
31243,31243,290,2022/4/15 10:10:00,46,83,-37
31244,31244,290,2022/4/15 10:20:00,45,81,-36
31245,31245,290,2022/4/15 10:30:00,45,75,-30
31246,31246,290,2022/4/15 10:40:00,37,77,-40
31247,31247,290,2022/4/15 10:50:00,39,83,-44
31248,31248,290,2022/4/15 11:00:00,35,77,-42
31249,31249,290,2022/4/15 11:10:00,43,62,-19
31250,31250,290,2022/4/15 11:20:00,39,85,-46
31251,31251,290,2022/4/15 11:30:00,35,70,-35
31252,31252,290,2022/4/15 11:40:00,35,77,-42
31253,31253,290,2022/4/15 11:50:00,37,77,-40
31254,31254,290,2022/4/15 12:00:00,40,76,-36
31255,31255,290,2022/4/15 12:10:00,39,68,-29
31256,31256,290,2022/4/15 12:20:00,38,75,-37
31257,31257,290,2022/4/15 12:30:00,43,76,-33
31258,31258,290,2022/4/15 12:40:00,43,93,-50
31259,31259,290,2022/4/15 12:50:00,45,76,-31
31260,31260,290,2022/4/15 13:00:00,40,99,-59
31261,31261,290,2022/4/15 13:10:00,41,76,-35
31262,31262,290,2022/4/15 13:20:00,40,98,-58
31263,31263,290,2022/4/15 13:30:00,40,76,-36
31264,31264,290,2022/4/15 13:40:00,38,93,-55
31265,31265,290,2022/4/15 13:50:00,37,77,-40
31266,31266,290,2022/4/15 14:00:00,35,92,-57
31267,31267,290,2022/4/15 14:10:00,38,75,-37
31268,31268,290,2022/4/15 14:20:00,39,97,-58
31269,31269,290,2022/4/15 14:30:00,38,88,-50
31270,31270,290,2022/4/15 14:40:00,37,93,-56
31271,31271,290,2022/4/15 14:50:00,37,76,-39
31272,31272,290,2022/4/15 15:00:00,43,106,-63
31273,31273,290,2022/4/15 15:10:00,44,80,-36
31274,31274,290,2022/4/15 15:20:00,37,110,-73
31275,31275,290,2022/4/15 15:30:00,40,90,-50
31276,31276,290,2022/4/15 15:40:00,45,107,-62
31277,31277,290,2022/4/15 15:50:00,42,96,-54
31278,31278,290,2022/4/15 16:00:00,44,108,-64
31279,31279,290,2022/4/15 16:10:00,53,110,-57
31280,31280,290,2022/4/15 16:20:00,45,110,-65
31281,31281,290,2022/4/15 16:30:00,85,110,-25
31282,31282,290,2022/4/15 16:40:00,177,119,58
31283,31283,290,2022/4/15 16:50:00,133,101,32
31284,31284,290,2022/4/15 17:00:00,235,109,126
31285,31285,290,2022/4/15 17:10:00,265,116,149
31286,31286,290,2022/4/15 17:20:00,208,151,57
31287,31287,290,2022/4/15 17:30:00,206,178,28
31288,31288,290,2022/4/15 17:40:00,238,224,14
31289,31289,290,2022/4/15 17:50:00,175,196,-21
31290,31290,290,2022/4/15 18:00:00,177,219,-42
31291,31291,290,2022/4/15 18:10:00,205,198,7
31292,31292,290,2022/4/15 18:20:00,136,198,-62
31293,31293,290,2022/4/15 18:30:00,68,198,-130
31294,31294,290,2022/4/15 18:40:00,66,209,-143
31295,31295,290,2022/4/15 18:50:00,46,180,-134
31296,31296,290,2022/4/15 19:00:00,47,152,-105
31297,31297,290,2022/4/15 19:10:00,49,109,-60
31298,31298,290,2022/4/15 19:20:00,40,106,-66
31299,31299,290,2022/4/15 19:30:00,37,128,-91
31300,31300,290,2022/4/15 19:40:00,39,118,-79
31301,31301,290,2022/4/15 19:50:00,33,110,-77
31302,31302,290,2022/4/15 20:00:00,34,107,-73
31303,31303,290,2022/4/15 20:10:00,39,110,-71
31304,31304,290,2022/4/15 20:20:00,32,113,-81
31305,31305,290,2022/4/15 20:30:00,25,113,-88
31306,31306,290,2022/4/15 20:40:00,28,111,-83
31307,31307,290,2022/4/15 20:50:00,29,105,-76
31308,31308,290,2022/4/15 21:00:00,28,103,-75
31309,31309,290,2022/4/15 21:10:00,27,112,-85
31310,31310,290,2022/4/15 21:20:00,29,103,-74
31311,31311,290,2022/4/15 21:30:00,30,103,-73
31312,31312,290,2022/4/15 21:40:00,28,118,-90
31313,31313,290,2022/4/15 21:50:00,23,111,-88
31314,31314,290,2022/4/15 22:00:00,23,105,-82
31315,31315,290,2022/4/15 22:10:00,24,107,-83
31316,31316,290,2022/4/15 22:20:00,13,106,-93
31317,31317,290,2022/4/15 22:30:00,14,108,-94
31318,31318,290,2022/4/15 22:40:00,8,85,-77
31319,31319,290,2022/4/15 22:50:00,4,62,-58
31320,31320,291,2022/4/15 5:00:00,0,1,-1
31321,31321,291,2022/4/15 5:10:00,0,1,-1
31322,31322,291,2022/4/15 5:20:00,0,1,-1
31323,31323,291,2022/4/15 5:30:00,5,1,4
31324,31324,291,2022/4/15 5:40:00,16,1,15
31325,31325,291,2022/4/15 5:50:00,18,21,-3
31326,31326,291,2022/4/15 6:00:00,23,30,-7
31327,31327,291,2022/4/15 6:10:00,32,44,-12
31328,31328,291,2022/4/15 6:20:00,31,60,-29
31329,31329,291,2022/4/15 6:30:00,41,72,-31
31330,31330,291,2022/4/15 6:40:00,67,106,-39
31331,31331,291,2022/4/15 6:50:00,97,105,-8
31332,31332,291,2022/4/15 7:00:00,165,87,78
31333,31333,291,2022/4/15 7:10:00,186,171,15
31334,31334,291,2022/4/15 7:20:00,228,481,-253
31335,31335,291,2022/4/15 7:30:00,269,561,-292
31336,31336,291,2022/4/15 7:40:00,285,1601,-1316
31337,31337,291,2022/4/15 7:50:00,344,4810,-4466
31338,31338,291,2022/4/15 8:00:00,351,4484,-4133
31339,31339,291,2022/4/15 8:10:00,339,8563,-8224
31340,31340,291,2022/4/15 8:20:00,351,11144,-10793
31341,31341,291,2022/4/15 8:30:00,315,10364,-10049
31342,31342,291,2022/4/15 8:40:00,257,11306,-11049
31343,31343,291,2022/4/15 8:50:00,213,9387,-9174
31344,31344,291,2022/4/15 9:00:00,193,9047,-8854
31345,31345,291,2022/4/15 9:10:00,166,7238,-7072
31346,31346,291,2022/4/15 9:20:00,138,5451,-5313
31347,31347,291,2022/4/15 9:30:00,107,2587,-2480
31348,31348,291,2022/4/15 9:40:00,94,2619,-2525
31349,31349,291,2022/4/15 9:50:00,77,1678,-1601
31350,31350,291,2022/4/15 10:00:00,72,428,-356
31351,31351,291,2022/4/15 10:10:00,72,375,-303
31352,31352,291,2022/4/15 10:20:00,73,196,-123
31353,31353,291,2022/4/15 10:30:00,76,176,-100
31354,31354,291,2022/4/15 10:40:00,103,146,-43
31355,31355,291,2022/4/15 10:50:00,81,142,-61
31356,31356,291,2022/4/15 11:00:00,91,120,-29
31357,31357,291,2022/4/15 11:10:00,144,114,30
31358,31358,291,2022/4/15 11:20:00,140,123,17
31359,31359,291,2022/4/15 11:30:00,163,122,41
31360,31360,291,2022/4/15 11:40:00,205,124,81
31361,31361,291,2022/4/15 11:50:00,188,122,66
31362,31362,291,2022/4/15 12:00:00,194,116,78
31363,31363,291,2022/4/15 12:10:00,212,120,92
31364,31364,291,2022/4/15 12:20:00,196,109,87
31365,31365,291,2022/4/15 12:30:00,183,159,24
31366,31366,291,2022/4/15 12:40:00,156,185,-29
31367,31367,291,2022/4/15 12:50:00,162,159,3
31368,31368,291,2022/4/15 13:00:00,137,152,-15
31369,31369,291,2022/4/15 13:10:00,174,116,58
31370,31370,291,2022/4/15 13:20:00,154,159,-5
31371,31371,291,2022/4/15 13:30:00,133,181,-48
31372,31372,291,2022/4/15 13:40:00,129,192,-63
31373,31373,291,2022/4/15 13:50:00,138,139,-1
31374,31374,291,2022/4/15 14:00:00,137,115,22
31375,31375,291,2022/4/15 14:10:00,156,133,23
31376,31376,291,2022/4/15 14:20:00,145,108,37
31377,31377,291,2022/4/15 14:30:00,163,108,55
31378,31378,291,2022/4/15 14:40:00,169,109,60
31379,31379,291,2022/4/15 14:50:00,175,102,73
31380,31380,291,2022/4/15 15:00:00,177,86,91
31381,31381,291,2022/4/15 15:10:00,213,114,99
31382,31382,291,2022/4/15 15:20:00,198,120,78
31383,31383,291,2022/4/15 15:30:00,202,102,100
31384,31384,291,2022/4/15 15:40:00,196,125,71
31385,31385,291,2022/4/15 15:50:00,198,106,92
31386,31386,291,2022/4/15 16:00:00,230,100,130
31387,31387,291,2022/4/15 16:10:00,268,118,150
31388,31388,291,2022/4/15 16:20:00,262,121,141
31389,31389,291,2022/4/15 16:30:00,548,106,442
31390,31390,291,2022/4/15 16:40:00,610,116,494
31391,31391,291,2022/4/15 16:50:00,664,120,544
31392,31392,291,2022/4/15 17:00:00,1212,120,1092
31393,31393,291,2022/4/15 17:10:00,3336,108,3228
31394,31394,291,2022/4/15 17:20:00,2474,108,2366
31395,31395,291,2022/4/15 17:30:00,3283,178,3105
31396,31396,291,2022/4/15 17:40:00,3565,136,3429
31397,31397,291,2022/4/15 17:50:00,3412,158,3254
31398,31398,291,2022/4/15 18:00:00,3314,180,3134
31399,31399,291,2022/4/15 18:10:00,3504,214,3290
31400,31400,291,2022/4/15 18:20:00,3423,179,3244
31401,31401,291,2022/4/15 18:30:00,3062,192,2870
31402,31402,291,2022/4/15 18:40:00,2522,208,2314
31403,31403,291,2022/4/15 18:50:00,1981,178,1803
31404,31404,291,2022/4/15 19:00:00,1564,168,1396
31405,31405,291,2022/4/15 19:10:00,1193,109,1084
31406,31406,291,2022/4/15 19:20:00,1156,117,1039
31407,31407,291,2022/4/15 19:30:00,718,124,594
31408,31408,291,2022/4/15 19:40:00,650,106,544
31409,31409,291,2022/4/15 19:50:00,573,101,472
31410,31410,291,2022/4/15 20:00:00,555,113,442
31411,31411,291,2022/4/15 20:10:00,673,107,566
31412,31412,291,2022/4/15 20:20:00,583,101,482
31413,31413,291,2022/4/15 20:30:00,431,107,324
31414,31414,291,2022/4/15 20:40:00,362,107,255
31415,31415,291,2022/4/15 20:50:00,269,95,174
31416,31416,291,2022/4/15 21:00:00,277,95,182
31417,31417,291,2022/4/15 21:10:00,343,105,238
31418,31418,291,2022/4/15 21:20:00,275,97,178
31419,31419,291,2022/4/15 21:30:00,214,89,125
31420,31420,291,2022/4/15 21:40:00,200,95,105
31421,31421,291,2022/4/15 21:50:00,102,95,7
31422,31422,291,2022/4/15 22:00:00,77,92,-15
31423,31423,291,2022/4/15 22:10:00,77,83,-6
31424,31424,291,2022/4/15 22:20:00,45,73,-28
31425,31425,291,2022/4/15 22:30:00,29,72,-43
31426,31426,291,2022/4/15 22:40:00,22,72,-50
31427,31427,291,2022/4/15 22:50:00,15,55,-40
31428,31428,292,2022/4/15 5:00:00,0,1,-1
31429,31429,292,2022/4/15 5:10:00,0,1,-1
31430,31430,292,2022/4/15 5:20:00,0,1,-1
31431,31431,292,2022/4/15 5:30:00,6,1,5
31432,31432,292,2022/4/15 5:40:00,10,5,5
31433,31433,292,2022/4/15 5:50:00,15,1,14
31434,31434,292,2022/4/15 6:00:00,21,23,-2
31435,31435,292,2022/4/15 6:10:00,23,54,-31
31436,31436,292,2022/4/15 6:20:00,28,52,-24
31437,31437,292,2022/4/15 6:30:00,32,85,-53
31438,31438,292,2022/4/15 6:40:00,35,102,-67
31439,31439,292,2022/4/15 6:50:00,43,144,-101
31440,31440,292,2022/4/15 7:00:00,52,230,-178
31441,31441,292,2022/4/15 7:10:00,58,325,-267
31442,31442,292,2022/4/15 7:20:00,78,344,-266
31443,31443,292,2022/4/15 7:30:00,102,534,-432
31444,31444,292,2022/4/15 7:40:00,176,432,-256
31445,31445,292,2022/4/15 7:50:00,215,431,-216
31446,31446,292,2022/4/15 8:00:00,234,572,-338
31447,31447,292,2022/4/15 8:10:00,259,1527,-1268
31448,31448,292,2022/4/15 8:20:00,286,1524,-1238
31449,31449,292,2022/4/15 8:30:00,278,2694,-2416
31450,31450,292,2022/4/15 8:40:00,226,3240,-3014
31451,31451,292,2022/4/15 8:50:00,222,2568,-2346
31452,31452,292,2022/4/15 9:00:00,222,1927,-1705
31453,31453,292,2022/4/15 9:10:00,216,1614,-1398
31454,31454,292,2022/4/15 9:20:00,202,619,-417
31455,31455,292,2022/4/15 9:30:00,183,599,-416
31456,31456,292,2022/4/15 9:40:00,167,460,-293
31457,31457,292,2022/4/15 9:50:00,160,527,-367
31458,31458,292,2022/4/15 10:00:00,138,434,-296
31459,31459,292,2022/4/15 10:10:00,173,297,-124
31460,31460,292,2022/4/15 10:20:00,178,330,-152
31461,31461,292,2022/4/15 10:30:00,178,318,-140
31462,31462,292,2022/4/15 10:40:00,174,216,-42
31463,31463,292,2022/4/15 10:50:00,177,296,-119
31464,31464,292,2022/4/15 11:00:00,174,232,-58
31465,31465,292,2022/4/15 11:10:00,197,177,20
31466,31466,292,2022/4/15 11:20:00,177,217,-40
31467,31467,292,2022/4/15 11:30:00,184,179,5
31468,31468,292,2022/4/15 11:40:00,212,254,-42
31469,31469,292,2022/4/15 11:50:00,217,298,-81
31470,31470,292,2022/4/15 12:00:00,222,231,-9
31471,31471,292,2022/4/15 12:10:00,233,221,12
31472,31472,292,2022/4/15 12:20:00,224,195,29
31473,31473,292,2022/4/15 12:30:00,237,206,31
31474,31474,292,2022/4/15 12:40:00,227,313,-86
31475,31475,292,2022/4/15 12:50:00,241,318,-77
31476,31476,292,2022/4/15 13:00:00,258,252,6
31477,31477,292,2022/4/15 13:10:00,268,281,-13
31478,31478,292,2022/4/15 13:20:00,271,195,76
31479,31479,292,2022/4/15 13:30:00,273,283,-10
31480,31480,292,2022/4/15 13:40:00,272,320,-48
31481,31481,292,2022/4/15 13:50:00,270,217,53
31482,31482,292,2022/4/15 14:00:00,271,226,45
31483,31483,292,2022/4/15 14:10:00,288,214,74
31484,31484,292,2022/4/15 14:20:00,290,178,112
31485,31485,292,2022/4/15 14:30:00,349,197,152
31486,31486,292,2022/4/15 14:40:00,315,208,107
31487,31487,292,2022/4/15 14:50:00,313,150,163
31488,31488,292,2022/4/15 15:00:00,334,226,108
31489,31489,292,2022/4/15 15:10:00,328,181,147
31490,31490,292,2022/4/15 15:20:00,322,129,193
31491,31491,292,2022/4/15 15:30:00,314,226,88
31492,31492,292,2022/4/15 15:40:00,329,178,151
31493,31493,292,2022/4/15 15:50:00,310,234,76
31494,31494,292,2022/4/15 16:00:00,430,145,285
31495,31495,292,2022/4/15 16:10:00,583,181,402
31496,31496,292,2022/4/15 16:20:00,612,197,415
31497,31497,292,2022/4/15 16:30:00,643,213,430
31498,31498,292,2022/4/15 16:40:00,644,178,466
31499,31499,292,2022/4/15 16:50:00,696,207,489
31500,31500,292,2022/4/15 17:00:00,1030,265,765
31501,31501,292,2022/4/15 17:10:00,1189,193,996
31502,31502,292,2022/4/15 17:20:00,1011,307,704
31503,31503,292,2022/4/15 17:30:00,1343,494,849
31504,31504,292,2022/4/15 17:40:00,1973,426,1547
31505,31505,292,2022/4/15 17:50:00,1204,514,690
31506,31506,292,2022/4/15 18:00:00,1209,415,794
31507,31507,292,2022/4/15 18:10:00,1538,431,1107
31508,31508,292,2022/4/15 18:20:00,1153,489,664
31509,31509,292,2022/4/15 18:30:00,715,415,300
31510,31510,292,2022/4/15 18:40:00,704,412,292
31511,31511,292,2022/4/15 18:50:00,698,423,275
31512,31512,292,2022/4/15 19:00:00,698,313,385
31513,31513,292,2022/4/15 19:10:00,579,294,285
31514,31514,292,2022/4/15 19:20:00,570,209,361
31515,31515,292,2022/4/15 19:30:00,465,145,320
31516,31516,292,2022/4/15 19:40:00,369,123,246
31517,31517,292,2022/4/15 19:50:00,354,125,229
31518,31518,292,2022/4/15 20:00:00,563,120,443
31519,31519,292,2022/4/15 20:10:00,553,107,446
31520,31520,292,2022/4/15 20:20:00,470,111,359
31521,31521,292,2022/4/15 20:30:00,577,94,483
31522,31522,292,2022/4/15 20:40:00,561,112,449
31523,31523,292,2022/4/15 20:50:00,430,92,338
31524,31524,292,2022/4/15 21:00:00,554,107,447
31525,31525,292,2022/4/15 21:10:00,585,110,475
31526,31526,292,2022/4/15 21:20:00,368,89,279
31527,31527,292,2022/4/15 21:30:00,328,92,236
31528,31528,292,2022/4/15 21:40:00,310,95,215
31529,31529,292,2022/4/15 21:50:00,285,92,193
31530,31530,292,2022/4/15 22:00:00,346,83,263
31531,31531,292,2022/4/15 22:10:00,182,83,99
31532,31532,292,2022/4/15 22:20:00,64,75,-11
31533,31533,292,2022/4/15 22:30:00,42,89,-47
31534,31534,292,2022/4/15 22:40:00,24,55,-31
31535,31535,292,2022/4/15 22:50:00,2,31,-29
31536,31536,293,2022/4/15 5:00:00,0,1,-1
31537,31537,293,2022/4/15 5:10:00,0,1,-1
31538,31538,293,2022/4/15 5:20:00,0,1,-1
31539,31539,293,2022/4/15 5:30:00,0,1,-1
31540,31540,293,2022/4/15 5:40:00,21,1,20
31541,31541,293,2022/4/15 5:50:00,25,2,23
31542,31542,293,2022/4/15 6:00:00,17,1,16
31543,31543,293,2022/4/15 6:10:00,29,11,18
31544,31544,293,2022/4/15 6:20:00,32,21,11
31545,31545,293,2022/4/15 6:30:00,36,55,-19
31546,31546,293,2022/4/15 6:40:00,51,47,4
31547,31547,293,2022/4/15 6:50:00,57,37,20
31548,31548,293,2022/4/15 7:00:00,56,60,-4
31549,31549,293,2022/4/15 7:10:00,114,51,63
31550,31550,293,2022/4/15 7:20:00,190,87,103
31551,31551,293,2022/4/15 7:30:00,189,92,97
31552,31552,293,2022/4/15 7:40:00,232,97,135
31553,31553,293,2022/4/15 7:50:00,222,100,122
31554,31554,293,2022/4/15 8:00:00,223,105,118
31555,31555,293,2022/4/15 8:10:00,147,97,50
31556,31556,293,2022/4/15 8:20:00,96,111,-15
31557,31557,293,2022/4/15 8:30:00,70,111,-41
31558,31558,293,2022/4/15 8:40:00,79,100,-21
31559,31559,293,2022/4/15 8:50:00,33,105,-72
31560,31560,293,2022/4/15 9:00:00,43,83,-40
31561,31561,293,2022/4/15 9:10:00,35,65,-30
31562,31562,293,2022/4/15 9:20:00,24,97,-73
31563,31563,293,2022/4/15 9:30:00,31,101,-70
31564,31564,293,2022/4/15 9:40:00,23,62,-39
31565,31565,293,2022/4/15 9:50:00,25,92,-67
31566,31566,293,2022/4/15 10:00:00,24,77,-53
31567,31567,293,2022/4/15 10:10:00,21,68,-47
31568,31568,293,2022/4/15 10:20:00,25,76,-51
31569,31569,293,2022/4/15 10:30:00,27,81,-54
31570,31570,293,2022/4/15 10:40:00,26,62,-36
31571,31571,293,2022/4/15 10:50:00,22,63,-41
31572,31572,293,2022/4/15 11:00:00,25,66,-41
31573,31573,293,2022/4/15 11:10:00,24,62,-38
31574,31574,293,2022/4/15 11:20:00,23,57,-34
31575,31575,293,2022/4/15 11:30:00,21,57,-36
31576,31576,293,2022/4/15 11:40:00,26,60,-34
31577,31577,293,2022/4/15 11:50:00,23,63,-40
31578,31578,293,2022/4/15 12:00:00,29,60,-31
31579,31579,293,2022/4/15 12:10:00,22,60,-38
31580,31580,293,2022/4/15 12:20:00,29,45,-16
31581,31581,293,2022/4/15 12:30:00,23,45,-22
31582,31582,293,2022/4/15 12:40:00,27,64,-37
31583,31583,293,2022/4/15 12:50:00,29,59,-30
31584,31584,293,2022/4/15 13:00:00,28,60,-32
31585,31585,293,2022/4/15 13:10:00,24,62,-38
31586,31586,293,2022/4/15 13:20:00,26,44,-18
31587,31587,293,2022/4/15 13:30:00,25,57,-32
31588,31588,293,2022/4/15 13:40:00,28,57,-29
31589,31589,293,2022/4/15 13:50:00,23,56,-33
31590,31590,293,2022/4/15 14:00:00,25,49,-24
31591,31591,293,2022/4/15 14:10:00,24,48,-24
31592,31592,293,2022/4/15 14:20:00,26,45,-19
31593,31593,293,2022/4/15 14:30:00,25,62,-37
31594,31594,293,2022/4/15 14:40:00,25,50,-25
31595,31595,293,2022/4/15 14:50:00,24,61,-37
31596,31596,293,2022/4/15 15:00:00,25,57,-32
31597,31597,293,2022/4/15 15:10:00,24,40,-16
31598,31598,293,2022/4/15 15:20:00,20,48,-28
31599,31599,293,2022/4/15 15:30:00,25,61,-36
31600,31600,293,2022/4/15 15:40:00,22,61,-39
31601,31601,293,2022/4/15 15:50:00,29,48,-19
31602,31602,293,2022/4/15 16:00:00,25,59,-34
31603,31603,293,2022/4/15 16:10:00,28,64,-36
31604,31604,293,2022/4/15 16:20:00,22,47,-25
31605,31605,293,2022/4/15 16:30:00,43,52,-9
31606,31606,293,2022/4/15 16:40:00,36,63,-27
31607,31607,293,2022/4/15 16:50:00,36,66,-30
31608,31608,293,2022/4/15 17:00:00,39,80,-41
31609,31609,293,2022/4/15 17:10:00,69,67,2
31610,31610,293,2022/4/15 17:20:00,42,57,-15
31611,31611,293,2022/4/15 17:30:00,58,92,-34
31612,31612,293,2022/4/15 17:40:00,46,68,-22
31613,31613,293,2022/4/15 17:50:00,44,76,-32
31614,31614,293,2022/4/15 18:00:00,40,114,-74
31615,31615,293,2022/4/15 18:10:00,27,95,-68
31616,31616,293,2022/4/15 18:20:00,26,124,-98
31617,31617,293,2022/4/15 18:30:00,24,104,-80
31618,31618,293,2022/4/15 18:40:00,28,95,-67
31619,31619,293,2022/4/15 18:50:00,21,114,-93
31620,31620,293,2022/4/15 19:00:00,15,101,-86
31621,31621,293,2022/4/15 19:10:00,15,99,-84
31622,31622,293,2022/4/15 19:20:00,14,126,-112
31623,31623,293,2022/4/15 19:30:00,12,85,-73
31624,31624,293,2022/4/15 19:40:00,16,95,-79
31625,31625,293,2022/4/15 19:50:00,16,94,-78
31626,31626,293,2022/4/15 20:00:00,14,63,-49
31627,31627,293,2022/4/15 20:10:00,12,77,-65
31628,31628,293,2022/4/15 20:20:00,9,71,-62
31629,31629,293,2022/4/15 20:30:00,9,64,-55
31630,31630,293,2022/4/15 20:40:00,10,85,-75
31631,31631,293,2022/4/15 20:50:00,7,60,-53
31632,31632,293,2022/4/15 21:00:00,7,59,-52
31633,31633,293,2022/4/15 21:10:00,8,79,-71
31634,31634,293,2022/4/15 21:20:00,7,66,-59
31635,31635,293,2022/4/15 21:30:00,4,56,-52
31636,31636,293,2022/4/15 21:40:00,3,62,-59
31637,31637,293,2022/4/15 21:50:00,4,71,-67
31638,31638,293,2022/4/15 22:00:00,5,63,-58
31639,31639,293,2022/4/15 22:10:00,0,54,-54
31640,31640,293,2022/4/15 22:20:00,0,51,-51
31641,31641,293,2022/4/15 22:30:00,0,44,-44
31642,31642,293,2022/4/15 22:40:00,0,47,-47
31643,31643,293,2022/4/15 22:50:00,1,39,-38
31644,31644,294,2022/4/15 5:00:00,0,1,-1
31645,31645,294,2022/4/15 5:10:00,0,1,-1
31646,31646,294,2022/4/15 5:20:00,0,1,-1
31647,31647,294,2022/4/15 5:30:00,7,1,6
31648,31648,294,2022/4/15 5:40:00,16,1,15
31649,31649,294,2022/4/15 5:50:00,25,5,20
31650,31650,294,2022/4/15 6:00:00,30,25,5
31651,31651,294,2022/4/15 6:10:00,32,23,9
31652,31652,294,2022/4/15 6:20:00,50,48,2
31653,31653,294,2022/4/15 6:30:00,58,106,-48
31654,31654,294,2022/4/15 6:40:00,75,84,-9
31655,31655,294,2022/4/15 6:50:00,185,119,66
31656,31656,294,2022/4/15 7:00:00,235,153,82
31657,31657,294,2022/4/15 7:10:00,284,195,89
31658,31658,294,2022/4/15 7:20:00,331,331,0
31659,31659,294,2022/4/15 7:30:00,478,431,47
31660,31660,294,2022/4/15 7:40:00,632,418,214
31661,31661,294,2022/4/15 7:50:00,723,638,85
31662,31662,294,2022/4/15 8:00:00,694,1545,-851
31663,31663,294,2022/4/15 8:10:00,750,1701,-951
31664,31664,294,2022/4/15 8:20:00,678,2780,-2102
31665,31665,294,2022/4/15 8:30:00,723,4101,-3378
31666,31666,294,2022/4/15 8:40:00,600,4189,-3589
31667,31667,294,2022/4/15 8:50:00,387,2770,-2383
31668,31668,294,2022/4/15 9:00:00,340,1941,-1601
31669,31669,294,2022/4/15 9:10:00,277,1959,-1682
31670,31670,294,2022/4/15 9:20:00,250,569,-319
31671,31671,294,2022/4/15 9:30:00,202,514,-312
31672,31672,294,2022/4/15 9:40:00,167,420,-253
31673,31673,294,2022/4/15 9:50:00,120,331,-211
31674,31674,294,2022/4/15 10:00:00,109,208,-99
31675,31675,294,2022/4/15 10:10:00,79,151,-72
31676,31676,294,2022/4/15 10:20:00,72,125,-53
31677,31677,294,2022/4/15 10:30:00,69,133,-64
31678,31678,294,2022/4/15 10:40:00,69,105,-36
31679,31679,294,2022/4/15 10:50:00,71,104,-33
31680,31680,294,2022/4/15 11:00:00,66,103,-37
31681,31681,294,2022/4/15 11:10:00,74,123,-49
31682,31682,294,2022/4/15 11:20:00,79,118,-39
31683,31683,294,2022/4/15 11:30:00,73,117,-44
31684,31684,294,2022/4/15 11:40:00,73,101,-28
31685,31685,294,2022/4/15 11:50:00,81,105,-24
31686,31686,294,2022/4/15 12:00:00,96,121,-25
31687,31687,294,2022/4/15 12:10:00,96,109,-13
31688,31688,294,2022/4/15 12:20:00,132,111,21
31689,31689,294,2022/4/15 12:30:00,114,108,6
31690,31690,294,2022/4/15 12:40:00,109,116,-7
31691,31691,294,2022/4/15 12:50:00,92,117,-25
31692,31692,294,2022/4/15 13:00:00,109,104,5
31693,31693,294,2022/4/15 13:10:00,101,120,-19
31694,31694,294,2022/4/15 13:20:00,93,133,-40
31695,31695,294,2022/4/15 13:30:00,85,125,-40
31696,31696,294,2022/4/15 13:40:00,89,120,-31
31697,31697,294,2022/4/15 13:50:00,99,109,-10
31698,31698,294,2022/4/15 14:00:00,99,110,-11
31699,31699,294,2022/4/15 14:10:00,89,115,-26
31700,31700,294,2022/4/15 14:20:00,133,110,23
31701,31701,294,2022/4/15 14:30:00,88,104,-16
31702,31702,294,2022/4/15 14:40:00,129,120,9
31703,31703,294,2022/4/15 14:50:00,128,108,20
31704,31704,294,2022/4/15 15:00:00,129,123,6
31705,31705,294,2022/4/15 15:10:00,149,120,29
31706,31706,294,2022/4/15 15:20:00,175,100,75
31707,31707,294,2022/4/15 15:30:00,167,110,57
31708,31708,294,2022/4/15 15:40:00,173,110,63
31709,31709,294,2022/4/15 15:50:00,165,108,57
31710,31710,294,2022/4/15 16:00:00,203,104,99
31711,31711,294,2022/4/15 16:10:00,223,121,102
31712,31712,294,2022/4/15 16:20:00,227,121,106
31713,31713,294,2022/4/15 16:30:00,269,128,141
31714,31714,294,2022/4/15 16:40:00,319,144,175
31715,31715,294,2022/4/15 16:50:00,463,152,311
31716,31716,294,2022/4/15 17:00:00,654,149,505
31717,31717,294,2022/4/15 17:10:00,1032,182,850
31718,31718,294,2022/4/15 17:20:00,1150,195,955
31719,31719,294,2022/4/15 17:30:00,825,282,543
31720,31720,294,2022/4/15 17:40:00,1349,318,1031
31721,31721,294,2022/4/15 17:50:00,1606,323,1283
31722,31722,294,2022/4/15 18:00:00,1194,327,867
31723,31723,294,2022/4/15 18:10:00,1190,347,843
31724,31724,294,2022/4/15 18:20:00,1612,328,1284
31725,31725,294,2022/4/15 18:30:00,1198,534,664
31726,31726,294,2022/4/15 18:40:00,1035,434,601
31727,31727,294,2022/4/15 18:50:00,712,301,411
31728,31728,294,2022/4/15 19:00:00,641,348,293
31729,31729,294,2022/4/15 19:10:00,610,257,353
31730,31730,294,2022/4/15 19:20:00,432,215,217
31731,31731,294,2022/4/15 19:30:00,349,150,199
31732,31732,294,2022/4/15 19:40:00,270,143,127
31733,31733,294,2022/4/15 19:50:00,247,117,130
31734,31734,294,2022/4/15 20:00:00,256,110,146
31735,31735,294,2022/4/15 20:10:00,241,124,117
31736,31736,294,2022/4/15 20:20:00,259,126,133
31737,31737,294,2022/4/15 20:30:00,208,107,101
31738,31738,294,2022/4/15 20:40:00,214,125,89
31739,31739,294,2022/4/15 20:50:00,211,125,86
31740,31740,294,2022/4/15 21:00:00,219,109,110
31741,31741,294,2022/4/15 21:10:00,274,120,154
31742,31742,294,2022/4/15 21:20:00,219,110,109
31743,31743,294,2022/4/15 21:30:00,167,124,43
31744,31744,294,2022/4/15 21:40:00,116,125,-9
31745,31745,294,2022/4/15 21:50:00,74,120,-46
31746,31746,294,2022/4/15 22:00:00,66,110,-44
31747,31747,294,2022/4/15 22:10:00,59,110,-51
31748,31748,294,2022/4/15 22:20:00,42,107,-65
31749,31749,294,2022/4/15 22:30:00,28,111,-83
31750,31750,294,2022/4/15 22:40:00,16,93,-77
31751,31751,294,2022/4/15 22:50:00,12,51,-39
31752,31752,295,2022/4/15 5:00:00,0,1,-1
31753,31753,295,2022/4/15 5:10:00,0,1,-1
31754,31754,295,2022/4/15 5:20:00,0,1,-1
31755,31755,295,2022/4/15 5:30:00,7,1,6
31756,31756,295,2022/4/15 5:40:00,19,1,18
31757,31757,295,2022/4/15 5:50:00,17,1,16
31758,31758,295,2022/4/15 6:00:00,26,13,13
31759,31759,295,2022/4/15 6:10:00,37,19,18
31760,31760,295,2022/4/15 6:20:00,36,38,-2
31761,31761,295,2022/4/15 6:30:00,58,51,7
31762,31762,295,2022/4/15 6:40:00,82,62,20
31763,31763,295,2022/4/15 6:50:00,179,72,107
31764,31764,295,2022/4/15 7:00:00,197,76,121
31765,31765,295,2022/4/15 7:10:00,247,104,143
31766,31766,295,2022/4/15 7:20:00,282,109,173
31767,31767,295,2022/4/15 7:30:00,354,125,229
31768,31768,295,2022/4/15 7:40:00,445,196,249
31769,31769,295,2022/4/15 7:50:00,601,428,173
31770,31770,295,2022/4/15 8:00:00,633,519,114
31771,31771,295,2022/4/15 8:10:00,592,1480,-888
31772,31772,295,2022/4/15 8:20:00,392,1709,-1317
31773,31773,295,2022/4/15 8:30:00,336,1656,-1320
31774,31774,295,2022/4/15 8:40:00,280,2995,-2715
31775,31775,295,2022/4/15 8:50:00,284,2342,-2058
31776,31776,295,2022/4/15 9:00:00,232,1530,-1298
31777,31777,295,2022/4/15 9:10:00,200,1140,-940
31778,31778,295,2022/4/15 9:20:00,162,408,-246
31779,31779,295,2022/4/15 9:30:00,85,318,-233
31780,31780,295,2022/4/15 9:40:00,73,282,-209
31781,31781,295,2022/4/15 9:50:00,58,182,-124
31782,31782,295,2022/4/15 10:00:00,50,110,-60
31783,31783,295,2022/4/15 10:10:00,47,124,-77
31784,31784,295,2022/4/15 10:20:00,47,103,-56
31785,31785,295,2022/4/15 10:30:00,47,111,-64
31786,31786,295,2022/4/15 10:40:00,45,109,-64
31787,31787,295,2022/4/15 10:50:00,40,75,-35
31788,31788,295,2022/4/15 11:00:00,42,98,-56
31789,31789,295,2022/4/15 11:10:00,41,99,-58
31790,31790,295,2022/4/15 11:20:00,45,108,-63
31791,31791,295,2022/4/15 11:30:00,44,104,-60
31792,31792,295,2022/4/15 11:40:00,45,92,-47
31793,31793,295,2022/4/15 11:50:00,46,75,-29
31794,31794,295,2022/4/15 12:00:00,48,105,-57
31795,31795,295,2022/4/15 12:10:00,45,108,-63
31796,31796,295,2022/4/15 12:20:00,45,105,-60
31797,31797,295,2022/4/15 12:30:00,51,105,-54
31798,31798,295,2022/4/15 12:40:00,49,90,-41
31799,31799,295,2022/4/15 12:50:00,47,110,-63
31800,31800,295,2022/4/15 13:00:00,45,103,-58
31801,31801,295,2022/4/15 13:10:00,50,109,-59
31802,31802,295,2022/4/15 13:20:00,56,103,-47
31803,31803,295,2022/4/15 13:30:00,48,111,-63
31804,31804,295,2022/4/15 13:40:00,46,91,-45
31805,31805,295,2022/4/15 13:50:00,45,107,-62
31806,31806,295,2022/4/15 14:00:00,42,112,-70
31807,31807,295,2022/4/15 14:10:00,43,103,-60
31808,31808,295,2022/4/15 14:20:00,45,102,-57
31809,31809,295,2022/4/15 14:30:00,45,97,-52
31810,31810,295,2022/4/15 14:40:00,46,114,-68
31811,31811,295,2022/4/15 14:50:00,44,101,-57
31812,31812,295,2022/4/15 15:00:00,48,112,-64
31813,31813,295,2022/4/15 15:10:00,50,110,-60
31814,31814,295,2022/4/15 15:20:00,52,93,-41
31815,31815,295,2022/4/15 15:30:00,53,119,-66
31816,31816,295,2022/4/15 15:40:00,49,119,-70
31817,31817,295,2022/4/15 15:50:00,47,112,-65
31818,31818,295,2022/4/15 16:00:00,52,107,-55
31819,31819,295,2022/4/15 16:10:00,70,104,-34
31820,31820,295,2022/4/15 16:20:00,75,105,-30
31821,31821,295,2022/4/15 16:30:00,132,122,10
31822,31822,295,2022/4/15 16:40:00,180,125,55
31823,31823,295,2022/4/15 16:50:00,142,125,17
31824,31824,295,2022/4/15 17:00:00,275,132,143
31825,31825,295,2022/4/15 17:10:00,710,154,556
31826,31826,295,2022/4/15 17:20:00,581,144,437
31827,31827,295,2022/4/15 17:30:00,702,224,478
31828,31828,295,2022/4/15 17:40:00,1976,217,1759
31829,31829,295,2022/4/15 17:50:00,1204,298,906
31830,31830,295,2022/4/15 18:00:00,1024,196,828
31831,31831,295,2022/4/15 18:10:00,1587,335,1252
31832,31832,295,2022/4/15 18:20:00,1202,335,867
31833,31833,295,2022/4/15 18:30:00,798,257,541
31834,31834,295,2022/4/15 18:40:00,610,335,275
31835,31835,295,2022/4/15 18:50:00,312,336,-24
31836,31836,295,2022/4/15 19:00:00,273,256,17
31837,31837,295,2022/4/15 19:10:00,271,181,90
31838,31838,295,2022/4/15 19:20:00,206,140,66
31839,31839,295,2022/4/15 19:30:00,158,109,49
31840,31840,295,2022/4/15 19:40:00,143,112,31
31841,31841,295,2022/4/15 19:50:00,98,122,-24
31842,31842,295,2022/4/15 20:00:00,90,106,-16
31843,31843,295,2022/4/15 20:10:00,129,91,38
31844,31844,295,2022/4/15 20:20:00,79,104,-25
31845,31845,295,2022/4/15 20:30:00,74,115,-41
31846,31846,295,2022/4/15 20:40:00,133,107,26
31847,31847,295,2022/4/15 20:50:00,77,110,-33
31848,31848,295,2022/4/15 21:00:00,67,106,-39
31849,31849,295,2022/4/15 21:10:00,78,103,-25
31850,31850,295,2022/4/15 21:20:00,64,107,-43
31851,31851,295,2022/4/15 21:30:00,41,112,-71
31852,31852,295,2022/4/15 21:40:00,42,104,-62
31853,31853,295,2022/4/15 21:50:00,35,103,-68
31854,31854,295,2022/4/15 22:00:00,25,103,-78
31855,31855,295,2022/4/15 22:10:00,26,98,-72
31856,31856,295,2022/4/15 22:20:00,23,90,-67
31857,31857,295,2022/4/15 22:30:00,13,90,-77
31858,31858,295,2022/4/15 22:40:00,11,77,-66
31859,31859,295,2022/4/15 22:50:00,7,66,-59
31860,31860,296,2022/4/15 5:00:00,0,1,-1
31861,31861,296,2022/4/15 5:10:00,0,1,-1
31862,31862,296,2022/4/15 5:20:00,0,1,-1
31863,31863,296,2022/4/15 5:30:00,4,1,3
31864,31864,296,2022/4/15 5:40:00,7,1,6
31865,31865,296,2022/4/15 5:50:00,16,1,15
31866,31866,296,2022/4/15 6:00:00,24,6,18
31867,31867,296,2022/4/15 6:10:00,23,23,0
31868,31868,296,2022/4/15 6:20:00,33,31,2
31869,31869,296,2022/4/15 6:30:00,38,38,0
31870,31870,296,2022/4/15 6:40:00,41,63,-22
31871,31871,296,2022/4/15 6:50:00,59,70,-11
31872,31872,296,2022/4/15 7:00:00,76,85,-9
31873,31873,296,2022/4/15 7:10:00,88,89,-1
31874,31874,296,2022/4/15 7:20:00,146,98,48
31875,31875,296,2022/4/15 7:30:00,187,124,63
31876,31876,296,2022/4/15 7:40:00,214,111,103
31877,31877,296,2022/4/15 7:50:00,248,192,56
31878,31878,296,2022/4/15 8:00:00,277,321,-44
31879,31879,296,2022/4/15 8:10:00,282,492,-210
31880,31880,296,2022/4/15 8:20:00,276,432,-156
31881,31881,296,2022/4/15 8:30:00,256,478,-222
31882,31882,296,2022/4/15 8:40:00,217,608,-391
31883,31883,296,2022/4/15 8:50:00,187,584,-397
31884,31884,296,2022/4/15 9:00:00,149,428,-279
31885,31885,296,2022/4/15 9:10:00,120,379,-259
31886,31886,296,2022/4/15 9:20:00,75,344,-269
31887,31887,296,2022/4/15 9:30:00,67,299,-232
31888,31888,296,2022/4/15 9:40:00,59,182,-123
31889,31889,296,2022/4/15 9:50:00,50,211,-161
31890,31890,296,2022/4/15 10:00:00,43,121,-78
31891,31891,296,2022/4/15 10:10:00,42,152,-110
31892,31892,296,2022/4/15 10:20:00,45,118,-73
31893,31893,296,2022/4/15 10:30:00,44,110,-66
31894,31894,296,2022/4/15 10:40:00,42,124,-82
31895,31895,296,2022/4/15 10:50:00,43,88,-45
31896,31896,296,2022/4/15 11:00:00,43,96,-53
31897,31897,296,2022/4/15 11:10:00,44,111,-67
31898,31898,296,2022/4/15 11:20:00,42,112,-70
31899,31899,296,2022/4/15 11:30:00,47,112,-65
31900,31900,296,2022/4/15 11:40:00,49,111,-62
31901,31901,296,2022/4/15 11:50:00,43,87,-44
31902,31902,296,2022/4/15 12:00:00,45,90,-45
31903,31903,296,2022/4/15 12:10:00,44,111,-67
31904,31904,296,2022/4/15 12:20:00,44,112,-68
31905,31905,296,2022/4/15 12:30:00,45,104,-59
31906,31906,296,2022/4/15 12:40:00,45,104,-59
31907,31907,296,2022/4/15 12:50:00,43,106,-63
31908,31908,296,2022/4/15 13:00:00,45,105,-60
31909,31909,296,2022/4/15 13:10:00,48,105,-57
31910,31910,296,2022/4/15 13:20:00,43,122,-79
31911,31911,296,2022/4/15 13:30:00,51,87,-36
31912,31912,296,2022/4/15 13:40:00,49,105,-56
31913,31913,296,2022/4/15 13:50:00,42,105,-63
31914,31914,296,2022/4/15 14:00:00,55,108,-53
31915,31915,296,2022/4/15 14:10:00,62,103,-41
31916,31916,296,2022/4/15 14:20:00,47,108,-61
31917,31917,296,2022/4/15 14:30:00,51,102,-51
31918,31918,296,2022/4/15 14:40:00,49,101,-52
31919,31919,296,2022/4/15 14:50:00,60,107,-47
31920,31920,296,2022/4/15 15:00:00,62,112,-50
31921,31921,296,2022/4/15 15:10:00,69,98,-29
31922,31922,296,2022/4/15 15:20:00,71,112,-41
31923,31923,296,2022/4/15 15:30:00,85,106,-21
31924,31924,296,2022/4/15 15:40:00,79,101,-22
31925,31925,296,2022/4/15 15:50:00,69,102,-33
31926,31926,296,2022/4/15 16:00:00,79,103,-24
31927,31927,296,2022/4/15 16:10:00,110,112,-2
31928,31928,296,2022/4/15 16:20:00,129,104,25
31929,31929,296,2022/4/15 16:30:00,180,106,74
31930,31930,296,2022/4/15 16:40:00,198,122,76
31931,31931,296,2022/4/15 16:50:00,197,120,77
31932,31932,296,2022/4/15 17:00:00,347,106,241
31933,31933,296,2022/4/15 17:10:00,431,108,323
31934,31934,296,2022/4/15 17:20:00,330,142,188
31935,31935,296,2022/4/15 17:30:00,699,115,584
31936,31936,296,2022/4/15 17:40:00,660,144,516
31937,31937,296,2022/4/15 17:50:00,337,196,141
31938,31938,296,2022/4/15 18:00:00,465,222,243
31939,31939,296,2022/4/15 18:10:00,660,153,507
31940,31940,296,2022/4/15 18:20:00,354,223,131
31941,31941,296,2022/4/15 18:30:00,269,214,55
31942,31942,296,2022/4/15 18:40:00,275,191,84
31943,31943,296,2022/4/15 18:50:00,225,171,54
31944,31944,296,2022/4/15 19:00:00,177,128,49
31945,31945,296,2022/4/15 19:10:00,179,110,69
31946,31946,296,2022/4/15 19:20:00,130,107,23
31947,31947,296,2022/4/15 19:30:00,94,105,-11
31948,31948,296,2022/4/15 19:40:00,83,113,-30
31949,31949,296,2022/4/15 19:50:00,65,107,-42
31950,31950,296,2022/4/15 20:00:00,69,74,-5
31951,31951,296,2022/4/15 20:10:00,77,94,-17
31952,31952,296,2022/4/15 20:20:00,57,98,-41
31953,31953,296,2022/4/15 20:30:00,54,77,-23
31954,31954,296,2022/4/15 20:40:00,61,78,-17
31955,31955,296,2022/4/15 20:50:00,60,66,-6
31956,31956,296,2022/4/15 21:00:00,45,92,-47
31957,31957,296,2022/4/15 21:10:00,74,62,12
31958,31958,296,2022/4/15 21:20:00,46,81,-35
31959,31959,296,2022/4/15 21:30:00,44,82,-38
31960,31960,296,2022/4/15 21:40:00,47,77,-30
31961,31961,296,2022/4/15 21:50:00,41,72,-31
31962,31962,296,2022/4/15 22:00:00,31,77,-46
31963,31963,296,2022/4/15 22:10:00,41,65,-24
31964,31964,296,2022/4/15 22:20:00,30,81,-51
31965,31965,296,2022/4/15 22:30:00,26,67,-41
31966,31966,296,2022/4/15 22:40:00,14,47,-33
31967,31967,296,2022/4/15 22:50:00,0,25,-25
31968,31968,297,2022/4/15 5:00:00,0,1,-1
31969,31969,297,2022/4/15 5:10:00,0,1,-1
31970,31970,297,2022/4/15 5:20:00,0,1,-1
31971,31971,297,2022/4/15 5:30:00,1,1,0
31972,31972,297,2022/4/15 5:40:00,8,1,7
31973,31973,297,2022/4/15 5:50:00,31,1,30
31974,31974,297,2022/4/15 6:00:00,88,2,86
31975,31975,297,2022/4/15 6:10:00,275,48,227
31976,31976,297,2022/4/15 6:20:00,248,38,210
31977,31977,297,2022/4/15 6:30:00,589,56,533
31978,31978,297,2022/4/15 6:40:00,645,67,578
31979,31979,297,2022/4/15 6:50:00,840,76,764
31980,31980,297,2022/4/15 7:00:00,1191,98,1093
31981,31981,297,2022/4/15 7:10:00,1599,119,1480
31982,31982,297,2022/4/15 7:20:00,1986,178,1808
31983,31983,297,2022/4/15 7:30:00,2534,233,2301
31984,31984,297,2022/4/15 7:40:00,3463,300,3163
31985,31985,297,2022/4/15 7:50:00,3407,328,3079
31986,31986,297,2022/4/15 8:00:00,3438,502,2936
31987,31987,297,2022/4/15 8:10:00,3442,378,3064
31988,31988,297,2022/4/15 8:20:00,3383,379,3004
31989,31989,297,2022/4/15 8:30:00,3087,536,2551
31990,31990,297,2022/4/15 8:40:00,1982,502,1480
31991,31991,297,2022/4/15 8:50:00,1626,321,1305
31992,31992,297,2022/4/15 9:00:00,1365,233,1132
31993,31993,297,2022/4/15 9:10:00,1019,169,850
31994,31994,297,2022/4/15 9:20:00,684,105,579
31995,31995,297,2022/4/15 9:30:00,580,128,452
31996,31996,297,2022/4/15 9:40:00,321,109,212
31997,31997,297,2022/4/15 9:50:00,327,109,218
31998,31998,297,2022/4/15 10:00:00,260,105,155
31999,31999,297,2022/4/15 10:10:00,225,113,112
32000,32000,297,2022/4/15 10:20:00,212,125,87
32001,32001,297,2022/4/15 10:30:00,157,99,58
32002,32002,297,2022/4/15 10:40:00,176,122,54
32003,32003,297,2022/4/15 10:50:00,174,124,50
32004,32004,297,2022/4/15 11:00:00,129,121,8
32005,32005,297,2022/4/15 11:10:00,149,98,51
32006,32006,297,2022/4/15 11:20:00,127,107,20
32007,32007,297,2022/4/15 11:30:00,132,106,26
32008,32008,297,2022/4/15 11:40:00,176,117,59
32009,32009,297,2022/4/15 11:50:00,174,106,68
32010,32010,297,2022/4/15 12:00:00,163,124,39
32011,32011,297,2022/4/15 12:10:00,195,122,73
32012,32012,297,2022/4/15 12:20:00,184,103,81
32013,32013,297,2022/4/15 12:30:00,192,102,90
32014,32014,297,2022/4/15 12:40:00,179,109,70
32015,32015,297,2022/4/15 12:50:00,175,108,67
32016,32016,297,2022/4/15 13:00:00,184,120,64
32017,32017,297,2022/4/15 13:10:00,170,104,66
32018,32018,297,2022/4/15 13:20:00,179,105,74
32019,32019,297,2022/4/15 13:30:00,139,111,28
32020,32020,297,2022/4/15 13:40:00,130,112,18
32021,32021,297,2022/4/15 13:50:00,136,109,27
32022,32022,297,2022/4/15 14:00:00,102,108,-6
32023,32023,297,2022/4/15 14:10:00,72,124,-52
32024,32024,297,2022/4/15 14:20:00,97,120,-23
32025,32025,297,2022/4/15 14:30:00,82,121,-39
32026,32026,297,2022/4/15 14:40:00,72,110,-38
32027,32027,297,2022/4/15 14:50:00,91,117,-26
32028,32028,297,2022/4/15 15:00:00,73,139,-66
32029,32029,297,2022/4/15 15:10:00,93,123,-30
32030,32030,297,2022/4/15 15:20:00,89,185,-96
32031,32031,297,2022/4/15 15:30:00,78,226,-148
32032,32032,297,2022/4/15 15:40:00,76,181,-105
32033,32033,297,2022/4/15 15:50:00,79,181,-102
32034,32034,297,2022/4/15 16:00:00,78,216,-138
32035,32035,297,2022/4/15 16:10:00,144,179,-35
32036,32036,297,2022/4/15 16:20:00,150,177,-27
32037,32037,297,2022/4/15 16:30:00,168,268,-100
32038,32038,297,2022/4/15 16:40:00,225,346,-121
32039,32039,297,2022/4/15 16:50:00,202,298,-96
32040,32040,297,2022/4/15 17:00:00,235,497,-262
32041,32041,297,2022/4/15 17:10:00,292,505,-213
32042,32042,297,2022/4/15 17:20:00,459,432,27
32043,32043,297,2022/4/15 17:30:00,330,568,-238
32044,32044,297,2022/4/15 17:40:00,328,616,-288
32045,32045,297,2022/4/15 17:50:00,374,620,-246
32046,32046,297,2022/4/15 18:00:00,545,1428,-883
32047,32047,297,2022/4/15 18:10:00,432,1671,-1239
32048,32048,297,2022/4/15 18:20:00,316,1714,-1398
32049,32049,297,2022/4/15 18:30:00,241,1783,-1542
32050,32050,297,2022/4/15 18:40:00,225,2447,-2222
32051,32051,297,2022/4/15 18:50:00,174,2485,-2311
32052,32052,297,2022/4/15 19:00:00,114,2790,-2676
32053,32053,297,2022/4/15 19:10:00,130,2029,-1899
32054,32054,297,2022/4/15 19:20:00,77,1703,-1626
32055,32055,297,2022/4/15 19:30:00,64,1129,-1065
32056,32056,297,2022/4/15 19:40:00,63,455,-392
32057,32057,297,2022/4/15 19:50:00,47,399,-352
32058,32058,297,2022/4/15 20:00:00,54,432,-378
32059,32059,297,2022/4/15 20:10:00,64,534,-470
32060,32060,297,2022/4/15 20:20:00,49,318,-269
32061,32061,297,2022/4/15 20:30:00,46,527,-481
32062,32062,297,2022/4/15 20:40:00,45,432,-387
32063,32063,297,2022/4/15 20:50:00,42,327,-285
32064,32064,297,2022/4/15 21:00:00,46,234,-188
32065,32065,297,2022/4/15 21:10:00,41,378,-337
32066,32066,297,2022/4/15 21:20:00,41,324,-283
32067,32067,297,2022/4/15 21:30:00,39,327,-288
32068,32068,297,2022/4/15 21:40:00,35,329,-294
32069,32069,297,2022/4/15 21:50:00,29,300,-271
32070,32070,297,2022/4/15 22:00:00,24,260,-236
32071,32071,297,2022/4/15 22:10:00,24,229,-205
32072,32072,297,2022/4/15 22:20:00,16,183,-167
32073,32073,297,2022/4/15 22:30:00,8,150,-142
32074,32074,297,2022/4/15 22:40:00,9,150,-141
32075,32075,297,2022/4/15 22:50:00,5,127,-122
32076,32076,298,2022/4/15 5:00:00,0,1,-1
32077,32077,298,2022/4/15 5:10:00,0,1,-1
32078,32078,298,2022/4/15 5:20:00,3,1,2
32079,32079,298,2022/4/15 5:30:00,8,1,7
32080,32080,298,2022/4/15 5:40:00,9,2,7
32081,32081,298,2022/4/15 5:50:00,13,2,11
32082,32082,298,2022/4/15 6:00:00,27,11,16
32083,32083,298,2022/4/15 6:10:00,29,24,5
32084,32084,298,2022/4/15 6:20:00,32,29,3
32085,32085,298,2022/4/15 6:30:00,42,45,-3
32086,32086,298,2022/4/15 6:40:00,50,45,5
32087,32087,298,2022/4/15 6:50:00,57,69,-12
32088,32088,298,2022/4/15 7:00:00,80,84,-4
32089,32089,298,2022/4/15 7:10:00,92,91,1
32090,32090,298,2022/4/15 7:20:00,94,105,-11
32091,32091,298,2022/4/15 7:30:00,157,109,48
32092,32092,298,2022/4/15 7:40:00,207,119,88
32093,32093,298,2022/4/15 7:50:00,264,109,155
32094,32094,298,2022/4/15 8:00:00,277,190,87
32095,32095,298,2022/4/15 8:10:00,302,324,-22
32096,32096,298,2022/4/15 8:20:00,353,322,31
32097,32097,298,2022/4/15 8:30:00,281,382,-101
32098,32098,298,2022/4/15 8:40:00,269,436,-167
32099,32099,298,2022/4/15 8:50:00,215,431,-216
32100,32100,298,2022/4/15 9:00:00,184,535,-351
32101,32101,298,2022/4/15 9:10:00,167,505,-338
32102,32102,298,2022/4/15 9:20:00,78,317,-239
32103,32103,298,2022/4/15 9:30:00,57,232,-175
32104,32104,298,2022/4/15 9:40:00,57,231,-174
32105,32105,298,2022/4/15 9:50:00,51,103,-52
32106,32106,298,2022/4/15 10:00:00,45,119,-74
32107,32107,298,2022/4/15 10:10:00,47,125,-78
32108,32108,298,2022/4/15 10:20:00,46,105,-59
32109,32109,298,2022/4/15 10:30:00,43,109,-66
32110,32110,298,2022/4/15 10:40:00,43,106,-63
32111,32111,298,2022/4/15 10:50:00,38,106,-68
32112,32112,298,2022/4/15 11:00:00,38,96,-58
32113,32113,298,2022/4/15 11:10:00,39,88,-49
32114,32114,298,2022/4/15 11:20:00,39,89,-50
32115,32115,298,2022/4/15 11:30:00,38,91,-53
32116,32116,298,2022/4/15 11:40:00,38,92,-54
32117,32117,298,2022/4/15 11:50:00,39,99,-60
32118,32118,298,2022/4/15 12:00:00,43,89,-46
32119,32119,298,2022/4/15 12:10:00,43,90,-47
32120,32120,298,2022/4/15 12:20:00,40,98,-58
32121,32121,298,2022/4/15 12:30:00,39,93,-54
32122,32122,298,2022/4/15 12:40:00,42,106,-64
32123,32123,298,2022/4/15 12:50:00,39,106,-67
32124,32124,298,2022/4/15 13:00:00,42,99,-57
32125,32125,298,2022/4/15 13:10:00,38,108,-70
32126,32126,298,2022/4/15 13:20:00,44,113,-69
32127,32127,298,2022/4/15 13:30:00,44,103,-59
32128,32128,298,2022/4/15 13:40:00,45,104,-59
32129,32129,298,2022/4/15 13:50:00,46,102,-56
32130,32130,298,2022/4/15 14:00:00,49,104,-55
32131,32131,298,2022/4/15 14:10:00,45,103,-58
32132,32132,298,2022/4/15 14:20:00,44,99,-55
32133,32133,298,2022/4/15 14:30:00,49,108,-59
32134,32134,298,2022/4/15 14:40:00,44,96,-52
32135,32135,298,2022/4/15 14:50:00,46,93,-47
32136,32136,298,2022/4/15 15:00:00,52,92,-40
32137,32137,298,2022/4/15 15:10:00,54,108,-54
32138,32138,298,2022/4/15 15:20:00,52,111,-59
32139,32139,298,2022/4/15 15:30:00,62,104,-42
32140,32140,298,2022/4/15 15:40:00,62,105,-43
32141,32141,298,2022/4/15 15:50:00,52,93,-41
32142,32142,298,2022/4/15 16:00:00,61,112,-51
32143,32143,298,2022/4/15 16:10:00,77,97,-20
32144,32144,298,2022/4/15 16:20:00,70,103,-33
32145,32145,298,2022/4/15 16:30:00,96,105,-9
32146,32146,298,2022/4/15 16:40:00,175,100,75
32147,32147,298,2022/4/15 16:50:00,134,107,27
32148,32148,298,2022/4/15 17:00:00,179,107,72
32149,32149,298,2022/4/15 17:10:00,234,120,114
32150,32150,298,2022/4/15 17:20:00,179,118,61
32151,32151,298,2022/4/15 17:30:00,231,108,123
32152,32152,298,2022/4/15 17:40:00,275,150,125
32153,32153,298,2022/4/15 17:50:00,208,206,2
32154,32154,298,2022/4/15 18:00:00,268,198,70
32155,32155,298,2022/4/15 18:10:00,643,158,485
32156,32156,298,2022/4/15 18:20:00,314,224,90
32157,32157,298,2022/4/15 18:30:00,275,208,67
32158,32158,298,2022/4/15 18:40:00,350,184,166
32159,32159,298,2022/4/15 18:50:00,243,116,127
32160,32160,298,2022/4/15 19:00:00,214,111,103
32161,32161,298,2022/4/15 19:10:00,188,124,64
32162,32162,298,2022/4/15 19:20:00,148,107,41
32163,32163,298,2022/4/15 19:30:00,103,112,-9
32164,32164,298,2022/4/15 19:40:00,77,106,-29
32165,32165,298,2022/4/15 19:50:00,65,97,-32
32166,32166,298,2022/4/15 20:00:00,59,83,-24
32167,32167,298,2022/4/15 20:10:00,64,94,-30
32168,32168,298,2022/4/15 20:20:00,46,93,-47
32169,32169,298,2022/4/15 20:30:00,47,84,-37
32170,32170,298,2022/4/15 20:40:00,47,81,-34
32171,32171,298,2022/4/15 20:50:00,42,95,-53
32172,32172,298,2022/4/15 21:00:00,47,80,-33
32173,32173,298,2022/4/15 21:10:00,42,88,-46
32174,32174,298,2022/4/15 21:20:00,38,89,-51
32175,32175,298,2022/4/15 21:30:00,36,88,-52
32176,32176,298,2022/4/15 21:40:00,28,84,-56
32177,32177,298,2022/4/15 21:50:00,31,80,-49
32178,32178,298,2022/4/15 22:00:00,28,72,-44
32179,32179,298,2022/4/15 22:10:00,27,77,-50
32180,32180,298,2022/4/15 22:20:00,25,79,-54
32181,32181,298,2022/4/15 22:30:00,19,60,-41
32182,32182,298,2022/4/15 22:40:00,10,67,-57
32183,32183,298,2022/4/15 22:50:00,1,21,-20
32184,32184,299,2022/4/15 5:00:00,0,1,-1
32185,32185,299,2022/4/15 5:10:00,3,1,2
32186,32186,299,2022/4/15 5:20:00,17,1,16
32187,32187,299,2022/4/15 5:30:00,28,1,27
32188,32188,299,2022/4/15 5:40:00,33,1,32
32189,32189,299,2022/4/15 5:50:00,44,1,43
32190,32190,299,2022/4/15 6:00:00,87,1,86
32191,32191,299,2022/4/15 6:10:00,95,75,20
32192,32192,299,2022/4/15 6:20:00,186,71,115
32193,32193,299,2022/4/15 6:30:00,244,84,160
32194,32194,299,2022/4/15 6:40:00,345,105,240
32195,32195,299,2022/4/15 6:50:00,581,112,469
32196,32196,299,2022/4/15 7:00:00,664,146,518
32197,32197,299,2022/4/15 7:10:00,686,150,536
32198,32198,299,2022/4/15 7:20:00,1163,179,984
32199,32199,299,2022/4/15 7:30:00,1205,297,908
32200,32200,299,2022/4/15 7:40:00,1625,326,1299
32201,32201,299,2022/4/15 7:50:00,1971,530,1441
32202,32202,299,2022/4/15 8:00:00,1988,432,1556
32203,32203,299,2022/4/15 8:10:00,1626,533,1093
32204,32204,299,2022/4/15 8:20:00,1594,440,1154
32205,32205,299,2022/4/15 8:30:00,1383,431,952
32206,32206,299,2022/4/15 8:40:00,1198,521,677
32207,32207,299,2022/4/15 8:50:00,1164,433,731
32208,32208,299,2022/4/15 9:00:00,857,322,535
32209,32209,299,2022/4/15 9:10:00,724,283,441
32210,32210,299,2022/4/15 9:20:00,589,177,412
32211,32211,299,2022/4/15 9:30:00,365,177,188
32212,32212,299,2022/4/15 9:40:00,294,207,87
32213,32213,299,2022/4/15 9:50:00,278,169,109
32214,32214,299,2022/4/15 10:00:00,229,192,37
32215,32215,299,2022/4/15 10:10:00,212,146,66
32216,32216,299,2022/4/15 10:20:00,207,128,79
32217,32217,299,2022/4/15 10:30:00,175,159,16
32218,32218,299,2022/4/15 10:40:00,174,126,48
32219,32219,299,2022/4/15 10:50:00,153,183,-30
32220,32220,299,2022/4/15 11:00:00,131,139,-8
32221,32221,299,2022/4/15 11:10:00,160,192,-32
32222,32222,299,2022/4/15 11:20:00,147,185,-38
32223,32223,299,2022/4/15 11:30:00,148,171,-23
32224,32224,299,2022/4/15 11:40:00,169,117,52
32225,32225,299,2022/4/15 11:50:00,176,172,4
32226,32226,299,2022/4/15 12:00:00,206,152,54
32227,32227,299,2022/4/15 12:10:00,217,192,25
32228,32228,299,2022/4/15 12:20:00,226,181,45
32229,32229,299,2022/4/15 12:30:00,228,146,82
32230,32230,299,2022/4/15 12:40:00,218,128,90
32231,32231,299,2022/4/15 12:50:00,214,146,68
32232,32232,299,2022/4/15 13:00:00,222,192,30
32233,32233,299,2022/4/15 13:10:00,213,192,21
32234,32234,299,2022/4/15 13:20:00,208,146,62
32235,32235,299,2022/4/15 13:30:00,195,121,74
32236,32236,299,2022/4/15 13:40:00,205,192,13
32237,32237,299,2022/4/15 13:50:00,206,171,35
32238,32238,299,2022/4/15 14:00:00,185,180,5
32239,32239,299,2022/4/15 14:10:00,190,198,-8
32240,32240,299,2022/4/15 14:20:00,190,185,5
32241,32241,299,2022/4/15 14:30:00,179,116,63
32242,32242,299,2022/4/15 14:40:00,176,179,-3
32243,32243,299,2022/4/15 14:50:00,162,214,-52
32244,32244,299,2022/4/15 15:00:00,184,197,-13
32245,32245,299,2022/4/15 15:10:00,208,208,0
32246,32246,299,2022/4/15 15:20:00,196,146,50
32247,32247,299,2022/4/15 15:30:00,199,233,-34
32248,32248,299,2022/4/15 15:40:00,195,284,-89
32249,32249,299,2022/4/15 15:50:00,182,185,-3
32250,32250,299,2022/4/15 16:00:00,199,282,-83
32251,32251,299,2022/4/15 16:10:00,218,310,-92
32252,32252,299,2022/4/15 16:20:00,212,267,-55
32253,32253,299,2022/4/15 16:30:00,255,298,-43
32254,32254,299,2022/4/15 16:40:00,261,332,-71
32255,32255,299,2022/4/15 16:50:00,270,380,-110
32256,32256,299,2022/4/15 17:00:00,269,375,-106
32257,32257,299,2022/4/15 17:10:00,347,513,-166
32258,32258,299,2022/4/15 17:20:00,335,410,-75
32259,32259,299,2022/4/15 17:30:00,319,570,-251
32260,32260,299,2022/4/15 17:40:00,378,562,-184
32261,32261,299,2022/4/15 17:50:00,370,1557,-1187
32262,32262,299,2022/4/15 18:00:00,378,1565,-1187
32263,32263,299,2022/4/15 18:10:00,580,1113,-533
32264,32264,299,2022/4/15 18:20:00,555,1874,-1319
32265,32265,299,2022/4/15 18:30:00,457,1733,-1276
32266,32266,299,2022/4/15 18:40:00,351,1862,-1511
32267,32267,299,2022/4/15 18:50:00,332,1137,-805
32268,32268,299,2022/4/15 19:00:00,275,609,-334
32269,32269,299,2022/4/15 19:10:00,267,1171,-904
32270,32270,299,2022/4/15 19:20:00,226,429,-203
32271,32271,299,2022/4/15 19:30:00,196,492,-296
32272,32272,299,2022/4/15 19:40:00,205,380,-175
32273,32273,299,2022/4/15 19:50:00,178,321,-143
32274,32274,299,2022/4/15 20:00:00,176,335,-159
32275,32275,299,2022/4/15 20:10:00,204,206,-2
32276,32276,299,2022/4/15 20:20:00,204,268,-64
32277,32277,299,2022/4/15 20:30:00,171,285,-114
32278,32278,299,2022/4/15 20:40:00,168,196,-28
32279,32279,299,2022/4/15 20:50:00,182,190,-8
32280,32280,299,2022/4/15 21:00:00,179,233,-54
32281,32281,299,2022/4/15 21:10:00,163,234,-71
32282,32282,299,2022/4/15 21:20:00,138,179,-41
32283,32283,299,2022/4/15 21:30:00,89,215,-126
32284,32284,299,2022/4/15 21:40:00,84,178,-94
32285,32285,299,2022/4/15 21:50:00,70,179,-109
32286,32286,299,2022/4/15 22:00:00,60,149,-89
32287,32287,299,2022/4/15 22:10:00,56,145,-89
32288,32288,299,2022/4/15 22:20:00,30,187,-157
32289,32289,299,2022/4/15 22:30:00,23,122,-99
32290,32290,299,2022/4/15 22:40:00,23,122,-99
32291,32291,299,2022/4/15 22:50:00,15,132,-117
32292,32292,300,2022/4/15 5:00:00,0,1,-1
32293,32293,300,2022/4/15 5:10:00,3,1,2
32294,32294,300,2022/4/15 5:20:00,7,1,6
32295,32295,300,2022/4/15 5:30:00,9,1,8
32296,32296,300,2022/4/15 5:40:00,11,1,10
32297,32297,300,2022/4/15 5:50:00,17,6,11
32298,32298,300,2022/4/15 6:00:00,18,2,16
32299,32299,300,2022/4/15 6:10:00,23,38,-15
32300,32300,300,2022/4/15 6:20:00,23,42,-19
32301,32301,300,2022/4/15 6:30:00,31,55,-24
32302,32302,300,2022/4/15 6:40:00,39,69,-30
32303,32303,300,2022/4/15 6:50:00,42,83,-41
32304,32304,300,2022/4/15 7:00:00,54,105,-51
32305,32305,300,2022/4/15 7:10:00,55,101,-46
32306,32306,300,2022/4/15 7:20:00,73,121,-48
32307,32307,300,2022/4/15 7:30:00,80,178,-98
32308,32308,300,2022/4/15 7:40:00,154,233,-79
32309,32309,300,2022/4/15 7:50:00,184,382,-198
32310,32310,300,2022/4/15 8:00:00,234,1638,-1404
32311,32311,300,2022/4/15 8:10:00,231,2056,-1825
32312,32312,300,2022/4/15 8:20:00,243,2708,-2465
32313,32313,300,2022/4/15 8:30:00,223,4315,-4092
32314,32314,300,2022/4/15 8:40:00,216,6540,-6324
32315,32315,300,2022/4/15 8:50:00,180,4458,-4278
32316,32316,300,2022/4/15 9:00:00,122,2643,-2521
32317,32317,300,2022/4/15 9:10:00,82,1693,-1611
32318,32318,300,2022/4/15 9:20:00,74,597,-523
32319,32319,300,2022/4/15 9:30:00,61,561,-500
32320,32320,300,2022/4/15 9:40:00,56,427,-371
32321,32321,300,2022/4/15 9:50:00,50,319,-269
32322,32322,300,2022/4/15 10:00:00,48,223,-175
32323,32323,300,2022/4/15 10:10:00,49,222,-173
32324,32324,300,2022/4/15 10:20:00,50,183,-133
32325,32325,300,2022/4/15 10:30:00,46,103,-57
32326,32326,300,2022/4/15 10:40:00,53,144,-91
32327,32327,300,2022/4/15 10:50:00,57,144,-87
32328,32328,300,2022/4/15 11:00:00,52,111,-59
32329,32329,300,2022/4/15 11:10:00,46,119,-73
32330,32330,300,2022/4/15 11:20:00,58,126,-68
32331,32331,300,2022/4/15 11:30:00,63,108,-45
32332,32332,300,2022/4/15 11:40:00,67,110,-43
32333,32333,300,2022/4/15 11:50:00,64,109,-45
32334,32334,300,2022/4/15 12:00:00,72,119,-47
32335,32335,300,2022/4/15 12:10:00,90,102,-12
32336,32336,300,2022/4/15 12:20:00,82,108,-26
32337,32337,300,2022/4/15 12:30:00,88,122,-34
32338,32338,300,2022/4/15 12:40:00,97,121,-24
32339,32339,300,2022/4/15 12:50:00,96,139,-43
32340,32340,300,2022/4/15 13:00:00,133,120,13
32341,32341,300,2022/4/15 13:10:00,148,123,25
32342,32342,300,2022/4/15 13:20:00,142,113,29
32343,32343,300,2022/4/15 13:30:00,140,125,15
32344,32344,300,2022/4/15 13:40:00,151,152,-1
32345,32345,300,2022/4/15 13:50:00,136,117,19
32346,32346,300,2022/4/15 14:00:00,136,108,28
32347,32347,300,2022/4/15 14:10:00,138,123,15
32348,32348,300,2022/4/15 14:20:00,132,125,7
32349,32349,300,2022/4/15 14:30:00,135,119,16
32350,32350,300,2022/4/15 14:40:00,136,108,28
32351,32351,300,2022/4/15 14:50:00,140,122,18
32352,32352,300,2022/4/15 15:00:00,177,109,68
32353,32353,300,2022/4/15 15:10:00,177,123,54
32354,32354,300,2022/4/15 15:20:00,183,114,69
32355,32355,300,2022/4/15 15:30:00,185,108,77
32356,32356,300,2022/4/15 15:40:00,180,109,71
32357,32357,300,2022/4/15 15:50:00,183,105,78
32358,32358,300,2022/4/15 16:00:00,208,108,100
32359,32359,300,2022/4/15 16:10:00,218,123,95
32360,32360,300,2022/4/15 16:20:00,214,125,89
32361,32361,300,2022/4/15 16:30:00,261,105,156
32362,32362,300,2022/4/15 16:40:00,307,116,191
32363,32363,300,2022/4/15 16:50:00,288,119,169
32364,32364,300,2022/4/15 17:00:00,641,147,494
32365,32365,300,2022/4/15 17:10:00,653,156,497
32366,32366,300,2022/4/15 17:20:00,656,211,445
32367,32367,300,2022/4/15 17:30:00,1155,267,888
32368,32368,300,2022/4/15 17:40:00,1587,296,1291
32369,32369,300,2022/4/15 17:50:00,1200,321,879
32370,32370,300,2022/4/15 18:00:00,1347,299,1048
32371,32371,300,2022/4/15 18:10:00,1979,323,1656
32372,32372,300,2022/4/15 18:20:00,1558,318,1240
32373,32373,300,2022/4/15 18:30:00,1154,347,807
32374,32374,300,2022/4/15 18:40:00,827,320,507
32375,32375,300,2022/4/15 18:50:00,671,285,386
32376,32376,300,2022/4/15 19:00:00,577,195,382
32377,32377,300,2022/4/15 19:10:00,579,149,430
32378,32378,300,2022/4/15 19:20:00,371,103,268
32379,32379,300,2022/4/15 19:30:00,337,124,213
32380,32380,300,2022/4/15 19:40:00,318,105,213
32381,32381,300,2022/4/15 19:50:00,270,103,167
32382,32382,300,2022/4/15 20:00:00,306,112,194
32383,32383,300,2022/4/15 20:10:00,327,91,236
32384,32384,300,2022/4/15 20:20:00,314,92,222
32385,32385,300,2022/4/15 20:30:00,333,79,254
32386,32386,300,2022/4/15 20:40:00,348,93,255
32387,32387,300,2022/4/15 20:50:00,305,89,216
32388,32388,300,2022/4/15 21:00:00,321,78,243
32389,32389,300,2022/4/15 21:10:00,437,76,361
32390,32390,300,2022/4/15 21:20:00,317,77,240
32391,32391,300,2022/4/15 21:30:00,318,75,243
32392,32392,300,2022/4/15 21:40:00,268,77,191
32393,32393,300,2022/4/15 21:50:00,205,83,122
32394,32394,300,2022/4/15 22:00:00,267,71,196
32395,32395,300,2022/4/15 22:10:00,595,66,529
32396,32396,300,2022/4/15 22:20:00,58,72,-14
32397,32397,300,2022/4/15 22:30:00,24,65,-41
32398,32398,300,2022/4/15 22:40:00,14,62,-48
32399,32399,300,2022/4/15 22:50:00,6,37,-31
32400,32400,301,2022/4/15 5:00:00,0,1,-1
32401,32401,301,2022/4/15 5:10:00,0,1,-1
32402,32402,301,2022/4/15 5:20:00,0,1,-1
32403,32403,301,2022/4/15 5:30:00,0,1,-1
32404,32404,301,2022/4/15 5:40:00,30,1,29
32405,32405,301,2022/4/15 5:50:00,63,1,62
32406,32406,301,2022/4/15 6:00:00,60,5,55
32407,32407,301,2022/4/15 6:10:00,98,2,96
32408,32408,301,2022/4/15 6:20:00,97,38,59
32409,32409,301,2022/4/15 6:30:00,152,25,127
32410,32410,301,2022/4/15 6:40:00,225,38,187
32411,32411,301,2022/4/15 6:50:00,326,59,267
32412,32412,301,2022/4/15 7:00:00,480,68,412
32413,32413,301,2022/4/15 7:10:00,834,69,765
32414,32414,301,2022/4/15 7:20:00,1176,86,1090
32415,32415,301,2022/4/15 7:30:00,1388,110,1278
32416,32416,301,2022/4/15 7:40:00,1940,90,1850
32417,32417,301,2022/4/15 7:50:00,1598,124,1474
32418,32418,301,2022/4/15 8:00:00,1984,111,1873
32419,32419,301,2022/4/15 8:10:00,1596,96,1500
32420,32420,301,2022/4/15 8:20:00,1152,105,1047
32421,32421,301,2022/4/15 8:30:00,843,123,720
32422,32422,301,2022/4/15 8:40:00,664,121,543
32423,32423,301,2022/4/15 8:50:00,341,104,237
32424,32424,301,2022/4/15 9:00:00,276,109,167
32425,32425,301,2022/4/15 9:10:00,216,105,111
32426,32426,301,2022/4/15 9:20:00,172,104,68
32427,32427,301,2022/4/15 9:30:00,96,93,3
32428,32428,301,2022/4/15 9:40:00,79,103,-24
32429,32429,301,2022/4/15 9:50:00,65,99,-34
32430,32430,301,2022/4/15 10:00:00,60,92,-32
32431,32431,301,2022/4/15 10:10:00,45,108,-63
32432,32432,301,2022/4/15 10:20:00,51,104,-53
32433,32433,301,2022/4/15 10:30:00,52,87,-35
32434,32434,301,2022/4/15 10:40:00,44,112,-68
32435,32435,301,2022/4/15 10:50:00,55,93,-38
32436,32436,301,2022/4/15 11:00:00,37,93,-56
32437,32437,301,2022/4/15 11:10:00,31,87,-56
32438,32438,301,2022/4/15 11:20:00,42,113,-71
32439,32439,301,2022/4/15 11:30:00,42,93,-51
32440,32440,301,2022/4/15 11:40:00,41,96,-55
32441,32441,301,2022/4/15 11:50:00,52,87,-35
32442,32442,301,2022/4/15 12:00:00,53,76,-23
32443,32443,301,2022/4/15 12:10:00,56,92,-36
32444,32444,301,2022/4/15 12:20:00,64,87,-23
32445,32445,301,2022/4/15 12:30:00,50,99,-49
32446,32446,301,2022/4/15 12:40:00,56,91,-35
32447,32447,301,2022/4/15 12:50:00,53,90,-37
32448,32448,301,2022/4/15 13:00:00,40,73,-33
32449,32449,301,2022/4/15 13:10:00,54,97,-43
32450,32450,301,2022/4/15 13:20:00,40,91,-51
32451,32451,301,2022/4/15 13:30:00,45,108,-63
32452,32452,301,2022/4/15 13:40:00,41,90,-49
32453,32453,301,2022/4/15 13:50:00,44,90,-46
32454,32454,301,2022/4/15 14:00:00,40,77,-37
32455,32455,301,2022/4/15 14:10:00,38,92,-54
32456,32456,301,2022/4/15 14:20:00,38,96,-58
32457,32457,301,2022/4/15 14:30:00,37,101,-64
32458,32458,301,2022/4/15 14:40:00,32,96,-64
32459,32459,301,2022/4/15 14:50:00,45,73,-28
32460,32460,301,2022/4/15 15:00:00,42,92,-50
32461,32461,301,2022/4/15 15:10:00,40,105,-65
32462,32462,301,2022/4/15 15:20:00,40,106,-66
32463,32463,301,2022/4/15 15:30:00,47,102,-55
32464,32464,301,2022/4/15 15:40:00,43,87,-44
32465,32465,301,2022/4/15 15:50:00,44,86,-42
32466,32466,301,2022/4/15 16:00:00,39,98,-59
32467,32467,301,2022/4/15 16:10:00,40,93,-53
32468,32468,301,2022/4/15 16:20:00,52,114,-62
32469,32469,301,2022/4/15 16:30:00,71,106,-35
32470,32470,301,2022/4/15 16:40:00,73,125,-52
32471,32471,301,2022/4/15 16:50:00,164,120,44
32472,32472,301,2022/4/15 17:00:00,125,178,-53
32473,32473,301,2022/4/15 17:10:00,121,118,3
32474,32474,301,2022/4/15 17:20:00,173,150,23
32475,32475,301,2022/4/15 17:30:00,134,221,-87
32476,32476,301,2022/4/15 17:40:00,95,318,-223
32477,32477,301,2022/4/15 17:50:00,76,318,-242
32478,32478,301,2022/4/15 18:00:00,58,432,-374
32479,32479,301,2022/4/15 18:10:00,60,422,-362
32480,32480,301,2022/4/15 18:20:00,45,430,-385
32481,32481,301,2022/4/15 18:30:00,39,418,-379
32482,32482,301,2022/4/15 18:40:00,35,491,-456
32483,32483,301,2022/4/15 18:50:00,24,490,-466
32484,32484,301,2022/4/15 19:00:00,30,432,-402
32485,32485,301,2022/4/15 19:10:00,24,493,-469
32486,32486,301,2022/4/15 19:20:00,29,437,-408
32487,32487,301,2022/4/15 19:30:00,28,379,-351
32488,32488,301,2022/4/15 19:40:00,26,319,-293
32489,32489,301,2022/4/15 19:50:00,27,336,-309
32490,32490,301,2022/4/15 20:00:00,28,257,-229
32491,32491,301,2022/4/15 20:10:00,23,178,-155
32492,32492,301,2022/4/15 20:20:00,25,171,-146
32493,32493,301,2022/4/15 20:30:00,25,180,-155
32494,32494,301,2022/4/15 20:40:00,27,226,-199
32495,32495,301,2022/4/15 20:50:00,18,119,-101
32496,32496,301,2022/4/15 21:00:00,21,179,-158
32497,32497,301,2022/4/15 21:10:00,21,193,-172
32498,32498,301,2022/4/15 21:20:00,17,181,-164
32499,32499,301,2022/4/15 21:30:00,13,108,-95
32500,32500,301,2022/4/15 21:40:00,12,153,-141
32501,32501,301,2022/4/15 21:50:00,12,128,-116
32502,32502,301,2022/4/15 22:00:00,8,121,-113
32503,32503,301,2022/4/15 22:10:00,4,106,-102
32504,32504,301,2022/4/15 22:20:00,2,120,-118
32505,32505,301,2022/4/15 22:30:00,2,102,-100
32506,32506,301,2022/4/15 22:40:00,2,87,-85
32507,32507,301,2022/4/15 22:50:00,2,110,-108
32508,32508,302,2022/4/15 5:00:00,0,1,-1
32509,32509,302,2022/4/15 5:10:00,0,1,-1
32510,32510,302,2022/4/15 5:20:00,0,1,-1
32511,32511,302,2022/4/15 5:30:00,0,1,-1
32512,32512,302,2022/4/15 5:40:00,2,1,1
32513,32513,302,2022/4/15 5:50:00,55,1,54
32514,32514,302,2022/4/15 6:00:00,57,11,46
32515,32515,302,2022/4/15 6:10:00,77,5,72
32516,32516,302,2022/4/15 6:20:00,150,45,105
32517,32517,302,2022/4/15 6:30:00,236,51,185
32518,32518,302,2022/4/15 6:40:00,239,50,189
32519,32519,302,2022/4/15 6:50:00,281,47,234
32520,32520,302,2022/4/15 7:00:00,447,81,366
32521,32521,302,2022/4/15 7:10:00,622,85,537
32522,32522,302,2022/4/15 7:20:00,757,107,650
32523,32523,302,2022/4/15 7:30:00,1392,120,1272
32524,32524,302,2022/4/15 7:40:00,1366,104,1262
32525,32525,302,2022/4/15 7:50:00,1976,182,1794
32526,32526,302,2022/4/15 8:00:00,1990,119,1871
32527,32527,302,2022/4/15 8:10:00,1621,110,1511
32528,32528,302,2022/4/15 8:20:00,1209,116,1093
32529,32529,302,2022/4/15 8:30:00,1035,113,922
32530,32530,302,2022/4/15 8:40:00,684,109,575
32531,32531,302,2022/4/15 8:50:00,663,122,541
32532,32532,302,2022/4/15 9:00:00,440,105,335
32533,32533,302,2022/4/15 9:10:00,273,106,167
32534,32534,302,2022/4/15 9:20:00,212,104,108
32535,32535,302,2022/4/15 9:30:00,143,90,53
32536,32536,302,2022/4/15 9:40:00,78,96,-18
32537,32537,302,2022/4/15 9:50:00,97,90,7
32538,32538,302,2022/4/15 10:00:00,73,73,0
32539,32539,302,2022/4/15 10:10:00,49,106,-57
32540,32540,302,2022/4/15 10:20:00,52,76,-24
32541,32541,302,2022/4/15 10:30:00,46,87,-41
32542,32542,302,2022/4/15 10:40:00,46,96,-50
32543,32543,302,2022/4/15 10:50:00,44,93,-49
32544,32544,302,2022/4/15 11:00:00,48,81,-33
32545,32545,302,2022/4/15 11:10:00,40,62,-22
32546,32546,302,2022/4/15 11:20:00,43,93,-50
32547,32547,302,2022/4/15 11:30:00,43,92,-49
32548,32548,302,2022/4/15 11:40:00,45,93,-48
32549,32549,302,2022/4/15 11:50:00,56,93,-37
32550,32550,302,2022/4/15 12:00:00,45,83,-38
32551,32551,302,2022/4/15 12:10:00,53,89,-36
32552,32552,302,2022/4/15 12:20:00,77,93,-16
32553,32553,302,2022/4/15 12:30:00,48,90,-42
32554,32554,302,2022/4/15 12:40:00,47,103,-56
32555,32555,302,2022/4/15 12:50:00,46,91,-45
32556,32556,302,2022/4/15 13:00:00,44,92,-48
32557,32557,302,2022/4/15 13:10:00,44,98,-54
32558,32558,302,2022/4/15 13:20:00,47,101,-54
32559,32559,302,2022/4/15 13:30:00,42,100,-58
32560,32560,302,2022/4/15 13:40:00,43,98,-55
32561,32561,302,2022/4/15 13:50:00,37,90,-53
32562,32562,302,2022/4/15 14:00:00,36,97,-61
32563,32563,302,2022/4/15 14:10:00,43,104,-61
32564,32564,302,2022/4/15 14:20:00,41,99,-58
32565,32565,302,2022/4/15 14:30:00,31,107,-76
32566,32566,302,2022/4/15 14:40:00,35,101,-66
32567,32567,302,2022/4/15 14:50:00,33,90,-57
32568,32568,302,2022/4/15 15:00:00,42,109,-67
32569,32569,302,2022/4/15 15:10:00,41,107,-66
32570,32570,302,2022/4/15 15:20:00,40,125,-85
32571,32571,302,2022/4/15 15:30:00,41,104,-63
32572,32572,302,2022/4/15 15:40:00,39,105,-66
32573,32573,302,2022/4/15 15:50:00,37,121,-84
32574,32574,302,2022/4/15 16:00:00,44,122,-78
32575,32575,302,2022/4/15 16:10:00,50,119,-69
32576,32576,302,2022/4/15 16:20:00,44,126,-82
32577,32577,302,2022/4/15 16:30:00,110,116,-6
32578,32578,302,2022/4/15 16:40:00,74,111,-37
32579,32579,302,2022/4/15 16:50:00,63,152,-89
32580,32580,302,2022/4/15 17:00:00,180,181,-1
32581,32581,302,2022/4/15 17:10:00,88,222,-134
32582,32582,302,2022/4/15 17:20:00,79,150,-71
32583,32583,302,2022/4/15 17:30:00,132,266,-134
32584,32584,302,2022/4/15 17:40:00,137,320,-183
32585,32585,302,2022/4/15 17:50:00,198,415,-217
32586,32586,302,2022/4/15 18:00:00,82,519,-437
32587,32587,302,2022/4/15 18:10:00,67,572,-505
32588,32588,302,2022/4/15 18:20:00,68,574,-506
32589,32589,302,2022/4/15 18:30:00,45,412,-367
32590,32590,302,2022/4/15 18:40:00,39,625,-586
32591,32591,302,2022/4/15 18:50:00,38,576,-538
32592,32592,302,2022/4/15 19:00:00,36,479,-443
32593,32593,302,2022/4/15 19:10:00,27,405,-378
32594,32594,302,2022/4/15 19:20:00,28,422,-394
32595,32595,302,2022/4/15 19:30:00,28,502,-474
32596,32596,302,2022/4/15 19:40:00,24,328,-304
32597,32597,302,2022/4/15 19:50:00,31,271,-240
32598,32598,302,2022/4/15 20:00:00,31,197,-166
32599,32599,302,2022/4/15 20:10:00,31,197,-166
32600,32600,302,2022/4/15 20:20:00,29,184,-155
32601,32601,302,2022/4/15 20:30:00,26,192,-166
32602,32602,302,2022/4/15 20:40:00,28,198,-170
32603,32603,302,2022/4/15 20:50:00,26,178,-152
32604,32604,302,2022/4/15 21:00:00,25,111,-86
32605,32605,302,2022/4/15 21:10:00,25,159,-134
32606,32606,302,2022/4/15 21:20:00,25,159,-134
32607,32607,302,2022/4/15 21:30:00,21,181,-160
32608,32608,302,2022/4/15 21:40:00,20,104,-84
32609,32609,302,2022/4/15 21:50:00,18,111,-93
32610,32610,302,2022/4/15 22:00:00,20,110,-90
32611,32611,302,2022/4/15 22:10:00,6,112,-106
32612,32612,302,2022/4/15 22:20:00,3,121,-118
32613,32613,302,2022/4/15 22:30:00,2,107,-105
32614,32614,302,2022/4/15 22:40:00,1,102,-101
32615,32615,302,2022/4/15 22:50:00,1,113,-112
32616,32616,303,2022/4/15 5:00:00,0,1,-1
32617,32617,303,2022/4/15 5:10:00,0,1,-1
32618,32618,303,2022/4/15 5:20:00,0,1,-1
32619,32619,303,2022/4/15 5:30:00,14,1,13
32620,32620,303,2022/4/15 5:40:00,28,1,27
32621,32621,303,2022/4/15 5:50:00,33,6,27
32622,32622,303,2022/4/15 6:00:00,42,5,37
32623,32623,303,2022/4/15 6:10:00,73,8,65
32624,32624,303,2022/4/15 6:20:00,109,16,93
32625,32625,303,2022/4/15 6:30:00,190,79,111
32626,32626,303,2022/4/15 6:40:00,281,68,213
32627,32627,303,2022/4/15 6:50:00,370,72,298
32628,32628,303,2022/4/15 7:00:00,655,87,568
32629,32629,303,2022/4/15 7:10:00,740,118,622
32630,32630,303,2022/4/15 7:20:00,1169,104,1065
32631,32631,303,2022/4/15 7:30:00,1389,178,1211
32632,32632,303,2022/4/15 7:40:00,1371,255,1116
32633,32633,303,2022/4/15 7:50:00,1210,213,997
32634,32634,303,2022/4/15 8:00:00,1167,198,969
32635,32635,303,2022/4/15 8:10:00,1040,107,933
32636,32636,303,2022/4/15 8:20:00,732,224,508
32637,32637,303,2022/4/15 8:30:00,611,254,357
32638,32638,303,2022/4/15 8:40:00,369,180,189
32639,32639,303,2022/4/15 8:50:00,278,103,175
32640,32640,303,2022/4/15 9:00:00,236,150,86
32641,32641,303,2022/4/15 9:10:00,177,111,66
32642,32642,303,2022/4/15 9:20:00,162,142,20
32643,32643,303,2022/4/15 9:30:00,139,116,23
32644,32644,303,2022/4/15 9:40:00,130,101,29
32645,32645,303,2022/4/15 9:50:00,77,124,-47
32646,32646,303,2022/4/15 10:00:00,103,121,-18
32647,32647,303,2022/4/15 10:10:00,129,105,24
32648,32648,303,2022/4/15 10:20:00,108,101,7
32649,32649,303,2022/4/15 10:30:00,77,104,-27
32650,32650,303,2022/4/15 10:40:00,81,119,-38
32651,32651,303,2022/4/15 10:50:00,65,102,-37
32652,32652,303,2022/4/15 11:00:00,61,100,-39
32653,32653,303,2022/4/15 11:10:00,62,115,-53
32654,32654,303,2022/4/15 11:20:00,59,102,-43
32655,32655,303,2022/4/15 11:30:00,95,119,-24
32656,32656,303,2022/4/15 11:40:00,124,116,8
32657,32657,303,2022/4/15 11:50:00,165,121,44
32658,32658,303,2022/4/15 12:00:00,155,120,35
32659,32659,303,2022/4/15 12:10:00,186,105,81
32660,32660,303,2022/4/15 12:20:00,188,119,69
32661,32661,303,2022/4/15 12:30:00,231,99,132
32662,32662,303,2022/4/15 12:40:00,170,117,53
32663,32663,303,2022/4/15 12:50:00,141,121,20
32664,32664,303,2022/4/15 13:00:00,164,119,45
32665,32665,303,2022/4/15 13:10:00,167,124,43
32666,32666,303,2022/4/15 13:20:00,135,116,19
32667,32667,303,2022/4/15 13:30:00,109,108,1
32668,32668,303,2022/4/15 13:40:00,151,98,53
32669,32669,303,2022/4/15 13:50:00,82,107,-25
32670,32670,303,2022/4/15 14:00:00,127,105,22
32671,32671,303,2022/4/15 14:10:00,116,123,-7
32672,32672,303,2022/4/15 14:20:00,87,121,-34
32673,32673,303,2022/4/15 14:30:00,99,125,-26
32674,32674,303,2022/4/15 14:40:00,94,108,-14
32675,32675,303,2022/4/15 14:50:00,118,114,4
32676,32676,303,2022/4/15 15:00:00,163,121,42
32677,32677,303,2022/4/15 15:10:00,184,122,62
32678,32678,303,2022/4/15 15:20:00,131,120,11
32679,32679,303,2022/4/15 15:30:00,166,111,55
32680,32680,303,2022/4/15 15:40:00,178,97,81
32681,32681,303,2022/4/15 15:50:00,132,127,5
32682,32682,303,2022/4/15 16:00:00,158,114,44
32683,32683,303,2022/4/15 16:10:00,187,108,79
32684,32684,303,2022/4/15 16:20:00,171,150,21
32685,32685,303,2022/4/15 16:30:00,194,111,83
32686,32686,303,2022/4/15 16:40:00,259,106,153
32687,32687,303,2022/4/15 16:50:00,268,139,129
32688,32688,303,2022/4/15 17:00:00,213,181,32
32689,32689,303,2022/4/15 17:10:00,194,252,-58
32690,32690,303,2022/4/15 17:20:00,208,245,-37
32691,32691,303,2022/4/15 17:30:00,181,217,-36
32692,32692,303,2022/4/15 17:40:00,188,424,-236
32693,32693,303,2022/4/15 17:50:00,202,324,-122
32694,32694,303,2022/4/15 18:00:00,157,347,-190
32695,32695,303,2022/4/15 18:10:00,124,427,-303
32696,32696,303,2022/4/15 18:20:00,175,378,-203
32697,32697,303,2022/4/15 18:30:00,70,499,-429
32698,32698,303,2022/4/15 18:40:00,62,636,-574
32699,32699,303,2022/4/15 18:50:00,71,434,-363
32700,32700,303,2022/4/15 19:00:00,49,414,-365
32701,32701,303,2022/4/15 19:10:00,61,457,-396
32702,32702,303,2022/4/15 19:20:00,64,392,-328
32703,32703,303,2022/4/15 19:30:00,64,411,-347
32704,32704,303,2022/4/15 19:40:00,42,413,-371
32705,32705,303,2022/4/15 19:50:00,55,293,-238
32706,32706,303,2022/4/15 20:00:00,44,506,-462
32707,32707,303,2022/4/15 20:10:00,51,178,-127
32708,32708,303,2022/4/15 20:20:00,47,180,-133
32709,32709,303,2022/4/15 20:30:00,45,257,-212
32710,32710,303,2022/4/15 20:40:00,39,116,-77
32711,32711,303,2022/4/15 20:50:00,38,221,-183
32712,32712,303,2022/4/15 21:00:00,32,193,-161
32713,32713,303,2022/4/15 21:10:00,41,111,-70
32714,32714,303,2022/4/15 21:20:00,34,224,-190
32715,32715,303,2022/4/15 21:30:00,27,120,-93
32716,32716,303,2022/4/15 21:40:00,27,150,-123
32717,32717,303,2022/4/15 21:50:00,27,128,-101
32718,32718,303,2022/4/15 22:00:00,6,150,-144
32719,32719,303,2022/4/15 22:10:00,3,120,-117
32720,32720,303,2022/4/15 22:20:00,2,122,-120
32721,32721,303,2022/4/15 22:30:00,2,110,-108
32722,32722,303,2022/4/15 22:40:00,2,103,-101
32723,32723,303,2022/4/15 22:50:00,1,94,-93
32724,32724,304,2022/4/15 5:00:00,0,1,-1
32725,32725,304,2022/4/15 5:10:00,0,1,-1
32726,32726,304,2022/4/15 5:20:00,2,1,1
32727,32727,304,2022/4/15 5:30:00,4,1,3
32728,32728,304,2022/4/15 5:40:00,4,1,3
32729,32729,304,2022/4/15 5:50:00,7,1,6
32730,32730,304,2022/4/15 6:00:00,8,1,7
32731,32731,304,2022/4/15 6:10:00,9,1,8
32732,32732,304,2022/4/15 6:20:00,10,1,9
32733,32733,304,2022/4/15 6:30:00,12,1,11
32734,32734,304,2022/4/15 6:40:00,18,30,-12
32735,32735,304,2022/4/15 6:50:00,21,37,-16
32736,32736,304,2022/4/15 7:00:00,29,71,-42
32737,32737,304,2022/4/15 7:10:00,27,61,-34
32738,32738,304,2022/4/15 7:20:00,34,57,-23
32739,32739,304,2022/4/15 7:30:00,31,90,-59
32740,32740,304,2022/4/15 7:40:00,34,53,-19
32741,32741,304,2022/4/15 7:50:00,31,81,-50
32742,32742,304,2022/4/15 8:00:00,23,96,-73
32743,32743,304,2022/4/15 8:10:00,22,76,-54
32744,32744,304,2022/4/15 8:20:00,24,74,-50
32745,32745,304,2022/4/15 8:30:00,13,70,-57
32746,32746,304,2022/4/15 8:40:00,11,79,-68
32747,32747,304,2022/4/15 8:50:00,11,41,-30
32748,32748,304,2022/4/15 9:00:00,13,44,-31
32749,32749,304,2022/4/15 9:10:00,16,29,-13
32750,32750,304,2022/4/15 9:20:00,6,47,-41
32751,32751,304,2022/4/15 9:30:00,7,50,-43
32752,32752,304,2022/4/15 9:40:00,7,37,-30
32753,32753,304,2022/4/15 9:50:00,6,29,-23
32754,32754,304,2022/4/15 10:00:00,6,53,-47
32755,32755,304,2022/4/15 10:10:00,7,40,-33
32756,32756,304,2022/4/15 10:20:00,12,39,-27
32757,32757,304,2022/4/15 10:30:00,19,42,-23
32758,32758,304,2022/4/15 10:40:00,8,37,-29
32759,32759,304,2022/4/15 10:50:00,16,52,-36
32760,32760,304,2022/4/15 11:00:00,10,52,-42
32761,32761,304,2022/4/15 11:10:00,6,44,-38
32762,32762,304,2022/4/15 11:20:00,9,36,-27
32763,32763,304,2022/4/15 11:30:00,17,43,-26
32764,32764,304,2022/4/15 11:40:00,17,36,-19
32765,32765,304,2022/4/15 11:50:00,9,32,-23
32766,32766,304,2022/4/15 12:00:00,9,31,-22
32767,32767,304,2022/4/15 12:10:00,9,30,-21
32768,32768,304,2022/4/15 12:20:00,8,24,-16
32769,32769,304,2022/4/15 12:30:00,8,34,-26
32770,32770,304,2022/4/15 12:40:00,22,37,-15
32771,32771,304,2022/4/15 12:50:00,20,29,-9
32772,32772,304,2022/4/15 13:00:00,8,34,-26
32773,32773,304,2022/4/15 13:10:00,8,20,-12
32774,32774,304,2022/4/15 13:20:00,21,36,-15
32775,32775,304,2022/4/15 13:30:00,7,33,-26
32776,32776,304,2022/4/15 13:40:00,9,35,-26
32777,32777,304,2022/4/15 13:50:00,7,33,-26
32778,32778,304,2022/4/15 14:00:00,24,23,1
32779,32779,304,2022/4/15 14:10:00,21,21,0
32780,32780,304,2022/4/15 14:20:00,7,32,-25
32781,32781,304,2022/4/15 14:30:00,8,33,-25
32782,32782,304,2022/4/15 14:40:00,22,31,-9
32783,32783,304,2022/4/15 14:50:00,6,30,-24
32784,32784,304,2022/4/15 15:00:00,9,23,-14
32785,32785,304,2022/4/15 15:10:00,9,36,-27
32786,32786,304,2022/4/15 15:20:00,9,36,-27
32787,32787,304,2022/4/15 15:30:00,18,37,-19
32788,32788,304,2022/4/15 15:40:00,17,38,-21
32789,32789,304,2022/4/15 15:50:00,15,38,-23
32790,32790,304,2022/4/15 16:00:00,9,33,-24
32791,32791,304,2022/4/15 16:10:00,9,38,-29
32792,32792,304,2022/4/15 16:20:00,16,30,-14
32793,32793,304,2022/4/15 16:30:00,26,29,-3
32794,32794,304,2022/4/15 16:40:00,23,23,0
32795,32795,304,2022/4/15 16:50:00,20,59,-39
32796,32796,304,2022/4/15 17:00:00,20,50,-30
32797,32797,304,2022/4/15 17:10:00,36,50,-14
32798,32798,304,2022/4/15 17:20:00,26,43,-17
32799,32799,304,2022/4/15 17:30:00,26,57,-31
32800,32800,304,2022/4/15 17:40:00,39,35,4
32801,32801,304,2022/4/15 17:50:00,26,38,-12
32802,32802,304,2022/4/15 18:00:00,24,60,-36
32803,32803,304,2022/4/15 18:10:00,15,44,-29
32804,32804,304,2022/4/15 18:20:00,14,39,-25
32805,32805,304,2022/4/15 18:30:00,25,65,-40
32806,32806,304,2022/4/15 18:40:00,24,40,-16
32807,32807,304,2022/4/15 18:50:00,6,50,-44
32808,32808,304,2022/4/15 19:00:00,7,39,-32
32809,32809,304,2022/4/15 19:10:00,6,33,-27
32810,32810,304,2022/4/15 19:20:00,23,47,-24
32811,32811,304,2022/4/15 19:30:00,6,44,-38
32812,32812,304,2022/4/15 19:40:00,5,33,-28
32813,32813,304,2022/4/15 19:50:00,4,37,-33
32814,32814,304,2022/4/15 20:00:00,12,21,-9
32815,32815,304,2022/4/15 20:10:00,16,25,-9
32816,32816,304,2022/4/15 20:20:00,3,34,-31
32817,32817,304,2022/4/15 20:30:00,2,21,-19
32818,32818,304,2022/4/15 20:40:00,26,25,1
32819,32819,304,2022/4/15 20:50:00,4,21,-17
32820,32820,304,2022/4/15 21:00:00,3,21,-18
32821,32821,304,2022/4/15 21:10:00,2,27,-25
32822,32822,304,2022/4/15 21:20:00,25,18,7
32823,32823,304,2022/4/15 21:30:00,16,15,1
32824,32824,304,2022/4/15 21:40:00,6,21,-15
32825,32825,304,2022/4/15 21:50:00,0,22,-22
32826,32826,304,2022/4/15 22:00:00,0,15,-15
32827,32827,304,2022/4/15 22:10:00,0,21,-21
32828,32828,304,2022/4/15 22:20:00,0,10,-10
32829,32829,304,2022/4/15 22:30:00,0,18,-18
32830,32830,304,2022/4/15 22:40:00,0,8,-8
32831,32831,304,2022/4/15 22:50:00,0,13,-13
32832,32832,305,2022/4/15 5:00:00,0,1,-1
32833,32833,305,2022/4/15 5:10:00,0,1,-1
32834,32834,305,2022/4/15 5:20:00,0,1,-1
32835,32835,305,2022/4/15 5:30:00,29,1,28
32836,32836,305,2022/4/15 5:40:00,32,1,31
32837,32837,305,2022/4/15 5:50:00,50,1,49
32838,32838,305,2022/4/15 6:00:00,45,1,44
32839,32839,305,2022/4/15 6:10:00,68,1,67
32840,32840,305,2022/4/15 6:20:00,114,1,113
32841,32841,305,2022/4/15 6:30:00,154,1,153
32842,32842,305,2022/4/15 6:40:00,253,67,186
32843,32843,305,2022/4/15 6:50:00,283,50,233
32844,32844,305,2022/4/15 7:00:00,354,57,297
32845,32845,305,2022/4/15 7:10:00,601,105,496
32846,32846,305,2022/4/15 7:20:00,597,81,516
32847,32847,305,2022/4/15 7:30:00,601,102,499
32848,32848,305,2022/4/15 7:40:00,470,110,360
32849,32849,305,2022/4/15 7:50:00,393,100,293
32850,32850,305,2022/4/15 8:00:00,350,99,251
32851,32851,305,2022/4/15 8:10:00,281,102,179
32852,32852,305,2022/4/15 8:20:00,232,113,119
32853,32853,305,2022/4/15 8:30:00,185,97,88
32854,32854,305,2022/4/15 8:40:00,146,108,38
32855,32855,305,2022/4/15 8:50:00,74,68,6
32856,32856,305,2022/4/15 9:00:00,53,110,-57
32857,32857,305,2022/4/15 9:10:00,41,76,-35
32858,32858,305,2022/4/15 9:20:00,45,68,-23
32859,32859,305,2022/4/15 9:30:00,39,91,-52
32860,32860,305,2022/4/15 9:40:00,33,87,-54
32861,32861,305,2022/4/15 9:50:00,37,67,-30
32862,32862,305,2022/4/15 10:00:00,31,75,-44
32863,32863,305,2022/4/15 10:10:00,32,68,-36
32864,32864,305,2022/4/15 10:20:00,28,65,-37
32865,32865,305,2022/4/15 10:30:00,31,79,-48
32866,32866,305,2022/4/15 10:40:00,35,74,-39
32867,32867,305,2022/4/15 10:50:00,32,73,-41
32868,32868,305,2022/4/15 11:00:00,27,74,-47
32869,32869,305,2022/4/15 11:10:00,30,81,-51
32870,32870,305,2022/4/15 11:20:00,38,62,-24
32871,32871,305,2022/4/15 11:30:00,32,65,-33
32872,32872,305,2022/4/15 11:40:00,37,85,-48
32873,32873,305,2022/4/15 11:50:00,39,77,-38
32874,32874,305,2022/4/15 12:00:00,38,85,-47
32875,32875,305,2022/4/15 12:10:00,36,83,-47
32876,32876,305,2022/4/15 12:20:00,39,62,-23
32877,32877,305,2022/4/15 12:30:00,33,62,-29
32878,32878,305,2022/4/15 12:40:00,33,73,-40
32879,32879,305,2022/4/15 12:50:00,30,76,-46
32880,32880,305,2022/4/15 13:00:00,32,93,-61
32881,32881,305,2022/4/15 13:10:00,28,73,-45
32882,32882,305,2022/4/15 13:20:00,30,60,-30
32883,32883,305,2022/4/15 13:30:00,31,81,-50
32884,32884,305,2022/4/15 13:40:00,29,75,-46
32885,32885,305,2022/4/15 13:50:00,30,81,-51
32886,32886,305,2022/4/15 14:00:00,28,77,-49
32887,32887,305,2022/4/15 14:10:00,27,69,-42
32888,32888,305,2022/4/15 14:20:00,31,68,-37
32889,32889,305,2022/4/15 14:30:00,24,75,-51
32890,32890,305,2022/4/15 14:40:00,31,76,-45
32891,32891,305,2022/4/15 14:50:00,27,78,-51
32892,32892,305,2022/4/15 15:00:00,31,74,-43
32893,32893,305,2022/4/15 15:10:00,33,66,-33
32894,32894,305,2022/4/15 15:20:00,30,76,-46
32895,32895,305,2022/4/15 15:30:00,34,91,-57
32896,32896,305,2022/4/15 15:40:00,35,90,-55
32897,32897,305,2022/4/15 15:50:00,34,97,-63
32898,32898,305,2022/4/15 16:00:00,37,68,-31
32899,32899,305,2022/4/15 16:10:00,37,105,-68
32900,32900,305,2022/4/15 16:20:00,42,99,-57
32901,32901,305,2022/4/15 16:30:00,45,83,-38
32902,32902,305,2022/4/15 16:40:00,44,101,-57
32903,32903,305,2022/4/15 16:50:00,43,87,-44
32904,32904,305,2022/4/15 17:00:00,38,108,-70
32905,32905,305,2022/4/15 17:10:00,49,168,-119
32906,32906,305,2022/4/15 17:20:00,50,104,-54
32907,32907,305,2022/4/15 17:30:00,42,102,-60
32908,32908,305,2022/4/15 17:40:00,45,183,-138
32909,32909,305,2022/4/15 17:50:00,46,108,-62
32910,32910,305,2022/4/15 18:00:00,43,128,-85
32911,32911,305,2022/4/15 18:10:00,44,234,-190
32912,32912,305,2022/4/15 18:20:00,32,124,-92
32913,32913,305,2022/4/15 18:30:00,26,220,-194
32914,32914,305,2022/4/15 18:40:00,24,169,-145
32915,32915,305,2022/4/15 18:50:00,24,110,-86
32916,32916,305,2022/4/15 19:00:00,24,227,-203
32917,32917,305,2022/4/15 19:10:00,24,109,-85
32918,32918,305,2022/4/15 19:20:00,25,119,-94
32919,32919,305,2022/4/15 19:30:00,22,191,-169
32920,32920,305,2022/4/15 19:40:00,17,104,-87
32921,32921,305,2022/4/15 19:50:00,16,105,-89
32922,32922,305,2022/4/15 20:00:00,22,122,-100
32923,32923,305,2022/4/15 20:10:00,21,82,-61
32924,32924,305,2022/4/15 20:20:00,21,104,-83
32925,32925,305,2022/4/15 20:30:00,14,82,-68
32926,32926,305,2022/4/15 20:40:00,23,73,-50
32927,32927,305,2022/4/15 20:50:00,16,113,-97
32928,32928,305,2022/4/15 21:00:00,20,77,-57
32929,32929,305,2022/4/15 21:10:00,17,63,-46
32930,32930,305,2022/4/15 21:20:00,16,106,-90
32931,32931,305,2022/4/15 21:30:00,11,95,-84
32932,32932,305,2022/4/15 21:40:00,9,72,-63
32933,32933,305,2022/4/15 21:50:00,6,72,-66
32934,32934,305,2022/4/15 22:00:00,0,98,-98
32935,32935,305,2022/4/15 22:10:00,1,76,-75
32936,32936,305,2022/4/15 22:20:00,0,75,-75
32937,32937,305,2022/4/15 22:30:00,0,69,-69
32938,32938,305,2022/4/15 22:40:00,0,62,-62
32939,32939,305,2022/4/15 22:50:00,0,69,-69
32940,32940,306,2022/4/15 5:00:00,0,1,-1
32941,32941,306,2022/4/15 5:10:00,0,1,-1
32942,32942,306,2022/4/15 5:20:00,0,1,-1
32943,32943,306,2022/4/15 5:30:00,18,1,17
32944,32944,306,2022/4/15 5:40:00,30,1,29
32945,32945,306,2022/4/15 5:50:00,33,1,32
32946,32946,306,2022/4/15 6:00:00,37,1,36
32947,32947,306,2022/4/15 6:10:00,50,2,48
32948,32948,306,2022/4/15 6:20:00,80,2,78
32949,32949,306,2022/4/15 6:30:00,150,6,144
32950,32950,306,2022/4/15 6:40:00,185,65,120
32951,32951,306,2022/4/15 6:50:00,214,46,168
32952,32952,306,2022/4/15 7:00:00,233,113,120
32953,32953,306,2022/4/15 7:10:00,278,89,189
32954,32954,306,2022/4/15 7:20:00,355,102,253
32955,32955,306,2022/4/15 7:30:00,345,109,236
32956,32956,306,2022/4/15 7:40:00,331,120,211
32957,32957,306,2022/4/15 7:50:00,302,110,192
32958,32958,306,2022/4/15 8:00:00,285,115,170
32959,32959,306,2022/4/15 8:10:00,236,110,126
32960,32960,306,2022/4/15 8:20:00,189,111,78
32961,32961,306,2022/4/15 8:30:00,185,90,95
32962,32962,306,2022/4/15 8:40:00,82,105,-23
32963,32963,306,2022/4/15 8:50:00,73,110,-37
32964,32964,306,2022/4/15 9:00:00,54,64,-10
32965,32965,306,2022/4/15 9:10:00,49,93,-44
32966,32966,306,2022/4/15 9:20:00,45,104,-59
32967,32967,306,2022/4/15 9:30:00,47,75,-28
32968,32968,306,2022/4/15 9:40:00,38,82,-44
32969,32969,306,2022/4/15 9:50:00,38,76,-38
32970,32970,306,2022/4/15 10:00:00,39,80,-41
32971,32971,306,2022/4/15 10:10:00,38,65,-27
32972,32972,306,2022/4/15 10:20:00,38,74,-36
32973,32973,306,2022/4/15 10:30:00,38,65,-27
32974,32974,306,2022/4/15 10:40:00,32,81,-49
32975,32975,306,2022/4/15 10:50:00,29,76,-47
32976,32976,306,2022/4/15 11:00:00,33,60,-27
32977,32977,306,2022/4/15 11:10:00,33,82,-49
32978,32978,306,2022/4/15 11:20:00,40,82,-42
32979,32979,306,2022/4/15 11:30:00,37,86,-49
32980,32980,306,2022/4/15 11:40:00,38,81,-43
32981,32981,306,2022/4/15 11:50:00,34,76,-42
32982,32982,306,2022/4/15 12:00:00,41,62,-21
32983,32983,306,2022/4/15 12:10:00,36,75,-39
32984,32984,306,2022/4/15 12:20:00,39,77,-38
32985,32985,306,2022/4/15 12:30:00,34,73,-39
32986,32986,306,2022/4/15 12:40:00,32,79,-47
32987,32987,306,2022/4/15 12:50:00,30,76,-46
32988,32988,306,2022/4/15 13:00:00,34,72,-38
32989,32989,306,2022/4/15 13:10:00,32,87,-55
32990,32990,306,2022/4/15 13:20:00,28,87,-59
32991,32991,306,2022/4/15 13:30:00,29,81,-52
32992,32992,306,2022/4/15 13:40:00,30,78,-48
32993,32993,306,2022/4/15 13:50:00,29,59,-30
32994,32994,306,2022/4/15 14:00:00,35,76,-41
32995,32995,306,2022/4/15 14:10:00,30,76,-46
32996,32996,306,2022/4/15 14:20:00,27,75,-48
32997,32997,306,2022/4/15 14:30:00,25,78,-53
32998,32998,306,2022/4/15 14:40:00,32,83,-51
32999,32999,306,2022/4/15 14:50:00,32,64,-32
33000,33000,306,2022/4/15 15:00:00,34,74,-40
33001,33001,306,2022/4/15 15:10:00,33,81,-48
33002,33002,306,2022/4/15 15:20:00,33,78,-45
33003,33003,306,2022/4/15 15:30:00,36,87,-51
33004,33004,306,2022/4/15 15:40:00,34,69,-35
33005,33005,306,2022/4/15 15:50:00,36,95,-59
33006,33006,306,2022/4/15 16:00:00,41,101,-60
33007,33007,306,2022/4/15 16:10:00,38,61,-23
33008,33008,306,2022/4/15 16:20:00,63,92,-29
33009,33009,306,2022/4/15 16:30:00,67,63,4
33010,33010,306,2022/4/15 16:40:00,70,83,-13
33011,33011,306,2022/4/15 16:50:00,65,100,-35
33012,33012,306,2022/4/15 17:00:00,52,98,-46
33013,33013,306,2022/4/15 17:10:00,50,100,-50
33014,33014,306,2022/4/15 17:20:00,74,106,-32
33015,33015,306,2022/4/15 17:30:00,137,115,22
33016,33016,306,2022/4/15 17:40:00,74,105,-31
33017,33017,306,2022/4/15 17:50:00,67,116,-49
33018,33018,306,2022/4/15 18:00:00,61,182,-121
33019,33019,306,2022/4/15 18:10:00,47,103,-56
33020,33020,306,2022/4/15 18:20:00,37,224,-187
33021,33021,306,2022/4/15 18:30:00,37,110,-73
33022,33022,306,2022/4/15 18:40:00,26,111,-85
33023,33023,306,2022/4/15 18:50:00,28,209,-181
33024,33024,306,2022/4/15 19:00:00,28,114,-86
33025,33025,306,2022/4/15 19:10:00,23,123,-100
33026,33026,306,2022/4/15 19:20:00,25,180,-155
33027,33027,306,2022/4/15 19:30:00,26,100,-74
33028,33028,306,2022/4/15 19:40:00,24,124,-100
33029,33029,306,2022/4/15 19:50:00,26,106,-80
33030,33030,306,2022/4/15 20:00:00,26,93,-67
33031,33031,306,2022/4/15 20:10:00,27,116,-89
33032,33032,306,2022/4/15 20:20:00,24,80,-56
33033,33033,306,2022/4/15 20:30:00,26,79,-53
33034,33034,306,2022/4/15 20:40:00,23,105,-82
33035,33035,306,2022/4/15 20:50:00,16,71,-55
33036,33036,306,2022/4/15 21:00:00,21,72,-51
33037,33037,306,2022/4/15 21:10:00,19,106,-87
33038,33038,306,2022/4/15 21:20:00,20,72,-52
33039,33039,306,2022/4/15 21:30:00,17,77,-60
33040,33040,306,2022/4/15 21:40:00,11,67,-56
33041,33041,306,2022/4/15 21:50:00,8,95,-87
33042,33042,306,2022/4/15 22:00:00,2,65,-63
33043,33043,306,2022/4/15 22:10:00,1,82,-81
33044,33044,306,2022/4/15 22:20:00,1,74,-73
33045,33045,306,2022/4/15 22:30:00,0,68,-68
33046,33046,306,2022/4/15 22:40:00,0,59,-59
33047,33047,306,2022/4/15 22:50:00,0,64,-64
33048,33048,307,2022/4/15 5:00:00,0,1,-1
33049,33049,307,2022/4/15 5:10:00,0,1,-1
33050,33050,307,2022/4/15 5:20:00,4,1,3
33051,33051,307,2022/4/15 5:30:00,12,1,11
33052,33052,307,2022/4/15 5:40:00,11,2,9
33053,33053,307,2022/4/15 5:50:00,21,1,20
33054,33054,307,2022/4/15 6:00:00,32,2,30
33055,33055,307,2022/4/15 6:10:00,36,37,-1
33056,33056,307,2022/4/15 6:20:00,47,33,14
33057,33057,307,2022/4/15 6:30:00,65,64,1
33058,33058,307,2022/4/15 6:40:00,84,67,17
33059,33059,307,2022/4/15 6:50:00,103,88,15
33060,33060,307,2022/4/15 7:00:00,165,98,67
33061,33061,307,2022/4/15 7:10:00,160,105,55
33062,33062,307,2022/4/15 7:20:00,200,116,84
33063,33063,307,2022/4/15 7:30:00,235,104,131
33064,33064,307,2022/4/15 7:40:00,281,117,164
33065,33065,307,2022/4/15 7:50:00,349,233,116
33066,33066,307,2022/4/15 8:00:00,325,332,-7
33067,33067,307,2022/4/15 8:10:00,324,378,-54
33068,33068,307,2022/4/15 8:20:00,395,333,62
33069,33069,307,2022/4/15 8:30:00,335,379,-44
33070,33070,307,2022/4/15 8:40:00,282,379,-97
33071,33071,307,2022/4/15 8:50:00,234,318,-84
33072,33072,307,2022/4/15 9:00:00,216,218,-2
33073,33073,307,2022/4/15 9:10:00,179,180,-1
33074,33074,307,2022/4/15 9:20:00,117,119,-2
33075,33075,307,2022/4/15 9:30:00,76,121,-45
33076,33076,307,2022/4/15 9:40:00,66,122,-56
33077,33077,307,2022/4/15 9:50:00,49,109,-60
33078,33078,307,2022/4/15 10:00:00,47,105,-58
33079,33079,307,2022/4/15 10:10:00,46,96,-50
33080,33080,307,2022/4/15 10:20:00,43,104,-61
33081,33081,307,2022/4/15 10:30:00,44,77,-33
33082,33082,307,2022/4/15 10:40:00,44,93,-49
33083,33083,307,2022/4/15 10:50:00,41,91,-50
33084,33084,307,2022/4/15 11:00:00,40,98,-58
33085,33085,307,2022/4/15 11:10:00,38,79,-41
33086,33086,307,2022/4/15 11:20:00,41,85,-44
33087,33087,307,2022/4/15 11:30:00,39,91,-52
33088,33088,307,2022/4/15 11:40:00,41,76,-35
33089,33089,307,2022/4/15 11:50:00,40,93,-53
33090,33090,307,2022/4/15 12:00:00,43,90,-47
33091,33091,307,2022/4/15 12:10:00,44,70,-26
33092,33092,307,2022/4/15 12:20:00,46,93,-47
33093,33093,307,2022/4/15 12:30:00,45,91,-46
33094,33094,307,2022/4/15 12:40:00,43,109,-66
33095,33095,307,2022/4/15 12:50:00,43,111,-68
33096,33096,307,2022/4/15 13:00:00,46,100,-54
33097,33097,307,2022/4/15 13:10:00,46,90,-44
33098,33098,307,2022/4/15 13:20:00,43,96,-53
33099,33099,307,2022/4/15 13:30:00,41,102,-61
33100,33100,307,2022/4/15 13:40:00,44,111,-67
33101,33101,307,2022/4/15 13:50:00,37,97,-60
33102,33102,307,2022/4/15 14:00:00,38,92,-54
33103,33103,307,2022/4/15 14:10:00,42,99,-57
33104,33104,307,2022/4/15 14:20:00,42,98,-56
33105,33105,307,2022/4/15 14:30:00,42,101,-59
33106,33106,307,2022/4/15 14:40:00,44,111,-67
33107,33107,307,2022/4/15 14:50:00,41,93,-52
33108,33108,307,2022/4/15 15:00:00,43,76,-33
33109,33109,307,2022/4/15 15:10:00,60,109,-49
33110,33110,307,2022/4/15 15:20:00,47,105,-58
33111,33111,307,2022/4/15 15:30:00,59,112,-53
33112,33112,307,2022/4/15 15:40:00,44,105,-61
33113,33113,307,2022/4/15 15:50:00,41,76,-35
33114,33114,307,2022/4/15 16:00:00,65,86,-21
33115,33115,307,2022/4/15 16:10:00,74,105,-31
33116,33116,307,2022/4/15 16:20:00,60,119,-59
33117,33117,307,2022/4/15 16:30:00,110,114,-4
33118,33118,307,2022/4/15 16:40:00,148,87,61
33119,33119,307,2022/4/15 16:50:00,132,119,13
33120,33120,307,2022/4/15 17:00:00,209,104,105
33121,33121,307,2022/4/15 17:10:00,270,110,160
33122,33122,307,2022/4/15 17:20:00,291,103,188
33123,33123,307,2022/4/15 17:30:00,267,179,88
33124,33124,307,2022/4/15 17:40:00,312,183,129
33125,33125,307,2022/4/15 17:50:00,308,183,125
33126,33126,307,2022/4/15 18:00:00,235,233,2
33127,33127,307,2022/4/15 18:10:00,266,256,10
33128,33128,307,2022/4/15 18:20:00,255,178,77
33129,33129,307,2022/4/15 18:30:00,207,199,8
33130,33130,307,2022/4/15 18:40:00,173,226,-53
33131,33131,307,2022/4/15 18:50:00,133,192,-59
33132,33132,307,2022/4/15 19:00:00,77,117,-40
33133,33133,307,2022/4/15 19:10:00,65,123,-58
33134,33134,307,2022/4/15 19:20:00,50,111,-61
33135,33135,307,2022/4/15 19:30:00,44,129,-85
33136,33136,307,2022/4/15 19:40:00,45,110,-65
33137,33137,307,2022/4/15 19:50:00,39,109,-70
33138,33138,307,2022/4/15 20:00:00,38,107,-69
33139,33139,307,2022/4/15 20:10:00,36,107,-71
33140,33140,307,2022/4/15 20:20:00,31,102,-71
33141,33141,307,2022/4/15 20:30:00,35,112,-77
33142,33142,307,2022/4/15 20:40:00,26,108,-82
33143,33143,307,2022/4/15 20:50:00,26,111,-85
33144,33144,307,2022/4/15 21:00:00,29,102,-73
33145,33145,307,2022/4/15 21:10:00,29,111,-82
33146,33146,307,2022/4/15 21:20:00,33,105,-72
33147,33147,307,2022/4/15 21:30:00,27,110,-83
33148,33148,307,2022/4/15 21:40:00,26,109,-83
33149,33149,307,2022/4/15 21:50:00,26,112,-86
33150,33150,307,2022/4/15 22:00:00,25,99,-74
33151,33151,307,2022/4/15 22:10:00,20,100,-80
33152,33152,307,2022/4/15 22:20:00,15,92,-77
33153,33153,307,2022/4/15 22:30:00,13,121,-108
33154,33154,307,2022/4/15 22:40:00,3,62,-59
33155,33155,307,2022/4/15 22:50:00,1,40,-39
33156,33156,308,2022/4/15 5:00:00,0,1,-1
33157,33157,308,2022/4/15 5:10:00,0,1,-1
33158,33158,308,2022/4/15 5:20:00,1,1,0
33159,33159,308,2022/4/15 5:30:00,14,1,13
33160,33160,308,2022/4/15 5:40:00,19,1,18
33161,33161,308,2022/4/15 5:50:00,19,1,18
33162,33162,308,2022/4/15 6:00:00,28,8,20
33163,33163,308,2022/4/15 6:10:00,37,8,29
33164,33164,308,2022/4/15 6:20:00,41,38,3
33165,33165,308,2022/4/15 6:30:00,57,49,8
33166,33166,308,2022/4/15 6:40:00,65,48,17
33167,33167,308,2022/4/15 6:50:00,96,72,24
33168,33168,308,2022/4/15 7:00:00,157,77,80
33169,33169,308,2022/4/15 7:10:00,213,105,108
33170,33170,308,2022/4/15 7:20:00,267,115,152
33171,33171,308,2022/4/15 7:30:00,279,182,97
33172,33172,308,2022/4/15 7:40:00,327,170,157
33173,33173,308,2022/4/15 7:50:00,342,128,214
33174,33174,308,2022/4/15 8:00:00,359,117,242
33175,33175,308,2022/4/15 8:10:00,285,110,175
33176,33176,308,2022/4/15 8:20:00,253,125,128
33177,33177,308,2022/4/15 8:30:00,238,123,115
33178,33178,308,2022/4/15 8:40:00,192,114,78
33179,33179,308,2022/4/15 8:50:00,176,98,78
33180,33180,308,2022/4/15 9:00:00,140,104,36
33181,33181,308,2022/4/15 9:10:00,100,103,-3
33182,33182,308,2022/4/15 9:20:00,74,99,-25
33183,33183,308,2022/4/15 9:30:00,52,91,-39
33184,33184,308,2022/4/15 9:40:00,46,76,-30
33185,33185,308,2022/4/15 9:50:00,41,76,-35
33186,33186,308,2022/4/15 10:00:00,38,93,-55
33187,33187,308,2022/4/15 10:10:00,33,74,-41
33188,33188,308,2022/4/15 10:20:00,27,74,-47
33189,33189,308,2022/4/15 10:30:00,27,74,-47
33190,33190,308,2022/4/15 10:40:00,31,73,-42
33191,33191,308,2022/4/15 10:50:00,30,75,-45
33192,33192,308,2022/4/15 11:00:00,28,83,-55
33193,33193,308,2022/4/15 11:10:00,31,75,-44
33194,33194,308,2022/4/15 11:20:00,33,66,-33
33195,33195,308,2022/4/15 11:30:00,31,60,-29
33196,33196,308,2022/4/15 11:40:00,32,82,-50
33197,33197,308,2022/4/15 11:50:00,24,77,-53
33198,33198,308,2022/4/15 12:00:00,31,76,-45
33199,33199,308,2022/4/15 12:10:00,39,71,-32
33200,33200,308,2022/4/15 12:20:00,38,71,-33
33201,33201,308,2022/4/15 12:30:00,33,76,-43
33202,33202,308,2022/4/15 12:40:00,38,77,-39
33203,33203,308,2022/4/15 12:50:00,38,77,-39
33204,33204,308,2022/4/15 13:00:00,33,76,-43
33205,33205,308,2022/4/15 13:10:00,29,69,-40
33206,33206,308,2022/4/15 13:20:00,28,77,-49
33207,33207,308,2022/4/15 13:30:00,31,80,-49
33208,33208,308,2022/4/15 13:40:00,29,91,-62
33209,33209,308,2022/4/15 13:50:00,30,77,-47
33210,33210,308,2022/4/15 14:00:00,32,64,-32
33211,33211,308,2022/4/15 14:10:00,29,83,-54
33212,33212,308,2022/4/15 14:20:00,31,73,-42
33213,33213,308,2022/4/15 14:30:00,34,84,-50
33214,33214,308,2022/4/15 14:40:00,30,87,-57
33215,33215,308,2022/4/15 14:50:00,39,82,-43
33216,33216,308,2022/4/15 15:00:00,57,68,-11
33217,33217,308,2022/4/15 15:10:00,71,81,-10
33218,33218,308,2022/4/15 15:20:00,67,113,-46
33219,33219,308,2022/4/15 15:30:00,40,87,-47
33220,33220,308,2022/4/15 15:40:00,38,104,-66
33221,33221,308,2022/4/15 15:50:00,39,99,-60
33222,33222,308,2022/4/15 16:00:00,36,93,-57
33223,33223,308,2022/4/15 16:10:00,38,75,-37
33224,33224,308,2022/4/15 16:20:00,37,108,-71
33225,33225,308,2022/4/15 16:30:00,42,104,-62
33226,33226,308,2022/4/15 16:40:00,43,108,-65
33227,33227,308,2022/4/15 16:50:00,50,98,-48
33228,33228,308,2022/4/15 17:00:00,49,99,-50
33229,33229,308,2022/4/15 17:10:00,71,114,-43
33230,33230,308,2022/4/15 17:20:00,71,109,-38
33231,33231,308,2022/4/15 17:30:00,59,105,-46
33232,33232,308,2022/4/15 17:40:00,96,108,-12
33233,33233,308,2022/4/15 17:50:00,77,183,-106
33234,33234,308,2022/4/15 18:00:00,77,184,-107
33235,33235,308,2022/4/15 18:10:00,92,121,-29
33236,33236,308,2022/4/15 18:20:00,67,184,-117
33237,33237,308,2022/4/15 18:30:00,56,181,-125
33238,33238,308,2022/4/15 18:40:00,43,150,-107
33239,33239,308,2022/4/15 18:50:00,37,120,-83
33240,33240,308,2022/4/15 19:00:00,37,138,-101
33241,33241,308,2022/4/15 19:10:00,36,110,-74
33242,33242,308,2022/4/15 19:20:00,25,124,-99
33243,33243,308,2022/4/15 19:30:00,28,105,-77
33244,33244,308,2022/4/15 19:40:00,27,110,-83
33245,33245,308,2022/4/15 19:50:00,26,110,-84
33246,33246,308,2022/4/15 20:00:00,28,77,-49
33247,33247,308,2022/4/15 20:10:00,25,95,-70
33248,33248,308,2022/4/15 20:20:00,27,106,-79
33249,33249,308,2022/4/15 20:30:00,24,94,-70
33250,33250,308,2022/4/15 20:40:00,23,82,-59
33251,33251,308,2022/4/15 20:50:00,24,93,-69
33252,33252,308,2022/4/15 21:00:00,26,78,-52
33253,33253,308,2022/4/15 21:10:00,23,80,-57
33254,33254,308,2022/4/15 21:20:00,29,78,-49
33255,33255,308,2022/4/15 21:30:00,23,95,-72
33256,33256,308,2022/4/15 21:40:00,22,89,-67
33257,33257,308,2022/4/15 21:50:00,16,82,-66
33258,33258,308,2022/4/15 22:00:00,13,76,-63
33259,33259,308,2022/4/15 22:10:00,14,86,-72
33260,33260,308,2022/4/15 22:20:00,13,73,-60
33261,33261,308,2022/4/15 22:30:00,6,71,-65
33262,33262,308,2022/4/15 22:40:00,3,59,-56
33263,33263,308,2022/4/15 22:50:00,2,64,-62
33264,33264,309,2022/4/15 5:00:00,0,1,-1
33265,33265,309,2022/4/15 5:10:00,0,1,-1
33266,33266,309,2022/4/15 5:20:00,1,1,0
33267,33267,309,2022/4/15 5:30:00,3,1,2
33268,33268,309,2022/4/15 5:40:00,7,1,6
33269,33269,309,2022/4/15 5:50:00,17,16,1
33270,33270,309,2022/4/15 6:00:00,16,37,-21
33271,33271,309,2022/4/15 6:10:00,22,32,-10
33272,33272,309,2022/4/15 6:20:00,27,65,-38
33273,33273,309,2022/4/15 6:30:00,32,96,-64
33274,33274,309,2022/4/15 6:40:00,35,104,-69
33275,33275,309,2022/4/15 6:50:00,43,125,-82
33276,33276,309,2022/4/15 7:00:00,52,190,-138
33277,33277,309,2022/4/15 7:10:00,73,318,-245
33278,33278,309,2022/4/15 7:20:00,78,253,-175
33279,33279,309,2022/4/15 7:30:00,115,298,-183
33280,33280,309,2022/4/15 7:40:00,154,324,-170
33281,33281,309,2022/4/15 7:50:00,195,436,-241
33282,33282,309,2022/4/15 8:00:00,236,401,-165
33283,33283,309,2022/4/15 8:10:00,226,1126,-900
33284,33284,309,2022/4/15 8:20:00,248,1597,-1349
33285,33285,309,2022/4/15 8:30:00,239,2009,-1770
33286,33286,309,2022/4/15 8:40:00,233,2604,-2371
33287,33287,309,2022/4/15 8:50:00,184,2706,-2522
33288,33288,309,2022/4/15 9:00:00,188,1865,-1677
33289,33289,309,2022/4/15 9:10:00,161,1676,-1515
33290,33290,309,2022/4/15 9:20:00,148,1199,-1051
33291,33291,309,2022/4/15 9:30:00,115,469,-354
33292,33292,309,2022/4/15 9:40:00,92,409,-317
33293,33293,309,2022/4/15 9:50:00,80,317,-237
33294,33294,309,2022/4/15 10:00:00,69,283,-214
33295,33295,309,2022/4/15 10:10:00,76,213,-137
33296,33296,309,2022/4/15 10:20:00,76,218,-142
33297,33297,309,2022/4/15 10:30:00,66,192,-126
33298,33298,309,2022/4/15 10:40:00,70,159,-89
33299,33299,309,2022/4/15 10:50:00,66,122,-56
33300,33300,309,2022/4/15 11:00:00,75,120,-45
33301,33301,309,2022/4/15 11:10:00,76,143,-67
33302,33302,309,2022/4/15 11:20:00,87,112,-25
33303,33303,309,2022/4/15 11:30:00,126,110,16
33304,33304,309,2022/4/15 11:40:00,74,120,-46
33305,33305,309,2022/4/15 11:50:00,78,108,-30
33306,33306,309,2022/4/15 12:00:00,93,108,-15
33307,33307,309,2022/4/15 12:10:00,129,109,20
33308,33308,309,2022/4/15 12:20:00,96,171,-75
33309,33309,309,2022/4/15 12:30:00,86,171,-85
33310,33310,309,2022/4/15 12:40:00,85,170,-85
33311,33311,309,2022/4/15 12:50:00,73,192,-119
33312,33312,309,2022/4/15 13:00:00,85,192,-107
33313,33313,309,2022/4/15 13:10:00,109,192,-83
33314,33314,309,2022/4/15 13:20:00,103,192,-89
33315,33315,309,2022/4/15 13:30:00,136,139,-3
33316,33316,309,2022/4/15 13:40:00,141,181,-40
33317,33317,309,2022/4/15 13:50:00,128,152,-24
33318,33318,309,2022/4/15 14:00:00,136,117,19
33319,33319,309,2022/4/15 14:10:00,150,117,33
33320,33320,309,2022/4/15 14:20:00,135,124,11
33321,33321,309,2022/4/15 14:30:00,128,127,1
33322,33322,309,2022/4/15 14:40:00,155,133,22
33323,33323,309,2022/4/15 14:50:00,170,129,41
33324,33324,309,2022/4/15 15:00:00,163,111,52
33325,33325,309,2022/4/15 15:10:00,183,121,62
33326,33326,309,2022/4/15 15:20:00,175,108,67
33327,33327,309,2022/4/15 15:30:00,195,109,86
33328,33328,309,2022/4/15 15:40:00,207,105,102
33329,33329,309,2022/4/15 15:50:00,192,109,83
33330,33330,309,2022/4/15 16:00:00,228,115,113
33331,33331,309,2022/4/15 16:10:00,271,109,162
33332,33332,309,2022/4/15 16:20:00,268,109,159
33333,33333,309,2022/4/15 16:30:00,335,110,225
33334,33334,309,2022/4/15 16:40:00,336,109,227
33335,33335,309,2022/4/15 16:50:00,305,115,190
33336,33336,309,2022/4/15 17:00:00,376,108,268
33337,33337,309,2022/4/15 17:10:00,642,183,459
33338,33338,309,2022/4/15 17:20:00,574,177,397
33339,33339,309,2022/4/15 17:30:00,654,254,400
33340,33340,309,2022/4/15 17:40:00,1352,254,1098
33341,33341,309,2022/4/15 17:50:00,830,298,532
33342,33342,309,2022/4/15 18:00:00,800,320,480
33343,33343,309,2022/4/15 18:10:00,1352,333,1019
33344,33344,309,2022/4/15 18:20:00,1038,318,720
33345,33345,309,2022/4/15 18:30:00,657,329,328
33346,33346,309,2022/4/15 18:40:00,643,321,322
33347,33347,309,2022/4/15 18:50:00,553,234,319
33348,33348,309,2022/4/15 19:00:00,377,181,196
33349,33349,309,2022/4/15 19:10:00,329,149,180
33350,33350,309,2022/4/15 19:20:00,269,121,148
33351,33351,309,2022/4/15 19:30:00,231,120,111
33352,33352,309,2022/4/15 19:40:00,228,112,116
33353,33353,309,2022/4/15 19:50:00,217,104,113
33354,33354,309,2022/4/15 20:00:00,262,103,159
33355,33355,309,2022/4/15 20:10:00,228,102,126
33356,33356,309,2022/4/15 20:20:00,211,95,116
33357,33357,309,2022/4/15 20:30:00,226,98,128
33358,33358,309,2022/4/15 20:40:00,238,90,148
33359,33359,309,2022/4/15 20:50:00,225,79,146
33360,33360,309,2022/4/15 21:00:00,267,77,190
33361,33361,309,2022/4/15 21:10:00,268,82,186
33362,33362,309,2022/4/15 21:20:00,210,87,123
33363,33363,309,2022/4/15 21:30:00,245,79,166
33364,33364,309,2022/4/15 21:40:00,210,77,133
33365,33365,309,2022/4/15 21:50:00,134,73,61
33366,33366,309,2022/4/15 22:00:00,599,75,524
33367,33367,309,2022/4/15 22:10:00,271,68,203
33368,33368,309,2022/4/15 22:20:00,71,70,1
33369,33369,309,2022/4/15 22:30:00,40,63,-23
33370,33370,309,2022/4/15 22:40:00,26,62,-36
33371,33371,309,2022/4/15 22:50:00,12,42,-30
33372,33372,310,2022/4/15 5:00:00,0,1,-1
33373,33373,310,2022/4/15 5:10:00,3,1,2
33374,33374,310,2022/4/15 5:20:00,8,1,7
33375,33375,310,2022/4/15 5:30:00,7,1,6
33376,33376,310,2022/4/15 5:40:00,12,1,11
33377,33377,310,2022/4/15 5:50:00,21,1,20
33378,33378,310,2022/4/15 6:00:00,22,1,21
33379,33379,310,2022/4/15 6:10:00,34,1,33
33380,33380,310,2022/4/15 6:20:00,34,73,-39
33381,33381,310,2022/4/15 6:30:00,62,63,-1
33382,33382,310,2022/4/15 6:40:00,85,71,14
33383,33383,310,2022/4/15 6:50:00,101,73,28
33384,33384,310,2022/4/15 7:00:00,196,92,104
33385,33385,310,2022/4/15 7:10:00,246,124,122
33386,33386,310,2022/4/15 7:20:00,322,118,204
33387,33387,310,2022/4/15 7:30:00,570,108,462
33388,33388,310,2022/4/15 7:40:00,657,197,460
33389,33389,310,2022/4/15 7:50:00,824,334,490
33390,33390,310,2022/4/15 8:00:00,1044,430,614
33391,33391,310,2022/4/15 8:10:00,1038,478,560
33392,33392,310,2022/4/15 8:20:00,1045,576,469
33393,33393,310,2022/4/15 8:30:00,824,1136,-312
33394,33394,310,2022/4/15 8:40:00,640,615,25
33395,33395,310,2022/4/15 8:50:00,437,432,5
33396,33396,310,2022/4/15 9:00:00,296,432,-136
33397,33397,310,2022/4/15 9:10:00,266,341,-75
33398,33398,310,2022/4/15 9:20:00,220,330,-110
33399,33399,310,2022/4/15 9:30:00,180,297,-117
33400,33400,310,2022/4/15 9:40:00,140,157,-17
33401,33401,310,2022/4/15 9:50:00,94,137,-43
33402,33402,310,2022/4/15 10:00:00,76,120,-44
33403,33403,310,2022/4/15 10:10:00,76,103,-27
33404,33404,310,2022/4/15 10:20:00,76,120,-44
33405,33405,310,2022/4/15 10:30:00,69,109,-40
33406,33406,310,2022/4/15 10:40:00,67,93,-26
33407,33407,310,2022/4/15 10:50:00,60,105,-45
33408,33408,310,2022/4/15 11:00:00,65,105,-40
33409,33409,310,2022/4/15 11:10:00,62,101,-39
33410,33410,310,2022/4/15 11:20:00,60,99,-39
33411,33411,310,2022/4/15 11:30:00,75,70,5
33412,33412,310,2022/4/15 11:40:00,64,100,-36
33413,33413,310,2022/4/15 11:50:00,57,96,-39
33414,33414,310,2022/4/15 12:00:00,59,99,-40
33415,33415,310,2022/4/15 12:10:00,59,103,-44
33416,33416,310,2022/4/15 12:20:00,62,85,-23
33417,33417,310,2022/4/15 12:30:00,63,108,-45
33418,33418,310,2022/4/15 12:40:00,51,108,-57
33419,33419,310,2022/4/15 12:50:00,62,112,-50
33420,33420,310,2022/4/15 13:00:00,56,107,-51
33421,33421,310,2022/4/15 13:10:00,58,109,-51
33422,33422,310,2022/4/15 13:20:00,53,95,-42
33423,33423,310,2022/4/15 13:30:00,59,114,-55
33424,33424,310,2022/4/15 13:40:00,67,103,-36
33425,33425,310,2022/4/15 13:50:00,67,122,-55
33426,33426,310,2022/4/15 14:00:00,63,125,-62
33427,33427,310,2022/4/15 14:10:00,68,96,-28
33428,33428,310,2022/4/15 14:20:00,70,107,-37
33429,33429,310,2022/4/15 14:30:00,76,125,-49
33430,33430,310,2022/4/15 14:40:00,74,87,-13
33431,33431,310,2022/4/15 14:50:00,71,127,-56
33432,33432,310,2022/4/15 15:00:00,73,112,-39
33433,33433,310,2022/4/15 15:10:00,81,90,-9
33434,33434,310,2022/4/15 15:20:00,85,104,-19
33435,33435,310,2022/4/15 15:30:00,120,123,-3
33436,33436,310,2022/4/15 15:40:00,121,124,-3
33437,33437,310,2022/4/15 15:50:00,118,117,1
33438,33438,310,2022/4/15 16:00:00,134,83,51
33439,33439,310,2022/4/15 16:10:00,151,112,39
33440,33440,310,2022/4/15 16:20:00,165,97,68
33441,33441,310,2022/4/15 16:30:00,236,122,114
33442,33442,310,2022/4/15 16:40:00,295,126,169
33443,33443,310,2022/4/15 16:50:00,328,122,206
33444,33444,310,2022/4/15 17:00:00,580,105,475
33445,33445,310,2022/4/15 17:10:00,699,120,579
33446,33446,310,2022/4/15 17:20:00,572,149,423
33447,33447,310,2022/4/15 17:30:00,658,212,446
33448,33448,310,2022/4/15 17:40:00,1205,144,1061
33449,33449,310,2022/4/15 17:50:00,681,298,383
33450,33450,310,2022/4/15 18:00:00,650,336,314
33451,33451,310,2022/4/15 18:10:00,709,216,493
33452,33452,310,2022/4/15 18:20:00,459,326,133
33453,33453,310,2022/4/15 18:30:00,335,327,8
33454,33454,310,2022/4/15 18:40:00,271,300,-29
33455,33455,310,2022/4/15 18:50:00,225,196,29
33456,33456,310,2022/4/15 19:00:00,163,198,-35
33457,33457,310,2022/4/15 19:10:00,113,192,-79
33458,33458,310,2022/4/15 19:20:00,78,132,-54
33459,33459,310,2022/4/15 19:30:00,75,116,-41
33460,33460,310,2022/4/15 19:40:00,63,118,-55
33461,33461,310,2022/4/15 19:50:00,46,112,-66
33462,33462,310,2022/4/15 20:00:00,43,113,-70
33463,33463,310,2022/4/15 20:10:00,46,106,-60
33464,33464,310,2022/4/15 20:20:00,62,106,-44
33465,33465,310,2022/4/15 20:30:00,46,106,-60
33466,33466,310,2022/4/15 20:40:00,47,92,-45
33467,33467,310,2022/4/15 20:50:00,42,106,-64
33468,33468,310,2022/4/15 21:00:00,38,104,-66
33469,33469,310,2022/4/15 21:10:00,44,113,-69
33470,33470,310,2022/4/15 21:20:00,36,95,-59
33471,33471,310,2022/4/15 21:30:00,31,101,-70
33472,33472,310,2022/4/15 21:40:00,35,100,-65
33473,33473,310,2022/4/15 21:50:00,28,84,-56
33474,33474,310,2022/4/15 22:00:00,27,94,-67
33475,33475,310,2022/4/15 22:10:00,32,88,-56
33476,33476,310,2022/4/15 22:20:00,26,67,-41
33477,33477,310,2022/4/15 22:30:00,0,73,-73
33478,33478,310,2022/4/15 22:40:00,0,79,-79
33479,33479,310,2022/4/15 22:50:00,0,49,-49
33480,33480,311,2022/4/15 5:00:00,0,1,-1
33481,33481,311,2022/4/15 5:10:00,0,1,-1
33482,33482,311,2022/4/15 5:20:00,0,1,-1
33483,33483,311,2022/4/15 5:30:00,3,1,2
33484,33484,311,2022/4/15 5:40:00,6,1,5
33485,33485,311,2022/4/15 5:50:00,10,6,4
33486,33486,311,2022/4/15 6:00:00,12,6,6
33487,33487,311,2022/4/15 6:10:00,17,15,2
33488,33488,311,2022/4/15 6:20:00,20,28,-8
33489,33489,311,2022/4/15 6:30:00,26,62,-36
33490,33490,311,2022/4/15 6:40:00,30,75,-45
33491,33491,311,2022/4/15 6:50:00,37,71,-34
33492,33492,311,2022/4/15 7:00:00,43,78,-35
33493,33493,311,2022/4/15 7:10:00,58,109,-51
33494,33494,311,2022/4/15 7:20:00,69,98,-29
33495,33495,311,2022/4/15 7:30:00,85,109,-24
33496,33496,311,2022/4/15 7:40:00,96,152,-56
33497,33497,311,2022/4/15 7:50:00,151,233,-82
33498,33498,311,2022/4/15 8:00:00,194,517,-323
33499,33499,311,2022/4/15 8:10:00,199,551,-352
33500,33500,311,2022/4/15 8:20:00,206,586,-380
33501,33501,311,2022/4/15 8:30:00,212,1886,-1674
33502,33502,311,2022/4/15 8:40:00,162,2787,-2625
33503,33503,311,2022/4/15 8:50:00,128,2847,-2719
33504,33504,311,2022/4/15 9:00:00,100,1531,-1431
33505,33505,311,2022/4/15 9:10:00,74,569,-495
33506,33506,311,2022/4/15 9:20:00,72,472,-400
33507,33507,311,2022/4/15 9:30:00,65,498,-433
33508,33508,311,2022/4/15 9:40:00,58,333,-275
33509,33509,311,2022/4/15 9:50:00,52,296,-244
33510,33510,311,2022/4/15 10:00:00,57,154,-97
33511,33511,311,2022/4/15 10:10:00,47,110,-63
33512,33512,311,2022/4/15 10:20:00,47,126,-79
33513,33513,311,2022/4/15 10:30:00,42,108,-66
33514,33514,311,2022/4/15 10:40:00,45,114,-69
33515,33515,311,2022/4/15 10:50:00,42,100,-58
33516,33516,311,2022/4/15 11:00:00,45,121,-76
33517,33517,311,2022/4/15 11:10:00,48,104,-56
33518,33518,311,2022/4/15 11:20:00,44,108,-64
33519,33519,311,2022/4/15 11:30:00,58,120,-62
33520,33520,311,2022/4/15 11:40:00,65,125,-60
33521,33521,311,2022/4/15 11:50:00,69,104,-35
33522,33522,311,2022/4/15 12:00:00,67,126,-59
33523,33523,311,2022/4/15 12:10:00,76,86,-10
33524,33524,311,2022/4/15 12:20:00,80,114,-34
33525,33525,311,2022/4/15 12:30:00,82,112,-30
33526,33526,311,2022/4/15 12:40:00,86,110,-24
33527,33527,311,2022/4/15 12:50:00,85,124,-39
33528,33528,311,2022/4/15 13:00:00,114,120,-6
33529,33529,311,2022/4/15 13:10:00,114,127,-13
33530,33530,311,2022/4/15 13:20:00,133,121,12
33531,33531,311,2022/4/15 13:30:00,113,112,1
33532,33532,311,2022/4/15 13:40:00,128,122,6
33533,33533,311,2022/4/15 13:50:00,90,126,-36
33534,33534,311,2022/4/15 14:00:00,85,103,-18
33535,33535,311,2022/4/15 14:10:00,110,124,-14
33536,33536,311,2022/4/15 14:20:00,84,127,-43
33537,33537,311,2022/4/15 14:30:00,86,114,-28
33538,33538,311,2022/4/15 14:40:00,113,87,26
33539,33539,311,2022/4/15 14:50:00,97,112,-15
33540,33540,311,2022/4/15 15:00:00,111,106,5
33541,33541,311,2022/4/15 15:10:00,133,107,26
33542,33542,311,2022/4/15 15:20:00,135,107,28
33543,33543,311,2022/4/15 15:30:00,138,86,52
33544,33544,311,2022/4/15 15:40:00,137,108,29
33545,33545,311,2022/4/15 15:50:00,150,103,47
33546,33546,311,2022/4/15 16:00:00,164,100,64
33547,33547,311,2022/4/15 16:10:00,174,103,71
33548,33548,311,2022/4/15 16:20:00,176,102,74
33549,33549,311,2022/4/15 16:30:00,208,97,111
33550,33550,311,2022/4/15 16:40:00,214,117,97
33551,33551,311,2022/4/15 16:50:00,256,106,150
33552,33552,311,2022/4/15 17:00:00,325,124,201
33553,33553,311,2022/4/15 17:10:00,571,123,448
33554,33554,311,2022/4/15 17:20:00,425,132,293
33555,33555,311,2022/4/15 17:30:00,699,110,589
33556,33556,311,2022/4/15 17:40:00,1194,181,1013
33557,33557,311,2022/4/15 17:50:00,794,191,603
33558,33558,311,2022/4/15 18:00:00,790,181,609
33559,33559,311,2022/4/15 18:10:00,1366,208,1158
33560,33560,311,2022/4/15 18:20:00,1024,213,811
33561,33561,311,2022/4/15 18:30:00,662,199,463
33562,33562,311,2022/4/15 18:40:00,641,213,428
33563,33563,311,2022/4/15 18:50:00,460,199,261
33564,33564,311,2022/4/15 19:00:00,331,185,146
33565,33565,311,2022/4/15 19:10:00,317,128,189
33566,33566,311,2022/4/15 19:20:00,273,105,168
33567,33567,311,2022/4/15 19:30:00,240,104,136
33568,33568,311,2022/4/15 19:40:00,236,104,132
33569,33569,311,2022/4/15 19:50:00,214,110,104
33570,33570,311,2022/4/15 20:00:00,214,98,116
33571,33571,311,2022/4/15 20:10:00,204,91,113
33572,33572,311,2022/4/15 20:20:00,207,83,124
33573,33573,311,2022/4/15 20:30:00,223,77,146
33574,33574,311,2022/4/15 20:40:00,195,79,116
33575,33575,311,2022/4/15 20:50:00,197,77,120
33576,33576,311,2022/4/15 21:00:00,195,75,120
33577,33577,311,2022/4/15 21:10:00,194,73,121
33578,33578,311,2022/4/15 21:20:00,165,75,90
33579,33579,311,2022/4/15 21:30:00,164,71,93
33580,33580,311,2022/4/15 21:40:00,110,73,37
33581,33581,311,2022/4/15 21:50:00,105,70,35
33582,33582,311,2022/4/15 22:00:00,64,72,-8
33583,33583,311,2022/4/15 22:10:00,39,62,-23
33584,33584,311,2022/4/15 22:20:00,28,64,-36
33585,33585,311,2022/4/15 22:30:00,22,60,-38
33586,33586,311,2022/4/15 22:40:00,13,51,-38
33587,33587,311,2022/4/15 22:50:00,7,40,-33
33588,33588,312,2022/4/15 5:00:00,0,1,-1
33589,33589,312,2022/4/15 5:10:00,2,1,1
33590,33590,312,2022/4/15 5:20:00,10,1,9
33591,33591,312,2022/4/15 5:30:00,13,1,12
33592,33592,312,2022/4/15 5:40:00,11,1,10
33593,33593,312,2022/4/15 5:50:00,20,1,19
33594,33594,312,2022/4/15 6:00:00,26,1,25
33595,33595,312,2022/4/15 6:10:00,26,17,9
33596,33596,312,2022/4/15 6:20:00,28,13,15
33597,33597,312,2022/4/15 6:30:00,33,22,11
33598,33598,312,2022/4/15 6:40:00,56,25,31
33599,33599,312,2022/4/15 6:50:00,81,40,41
33600,33600,312,2022/4/15 7:00:00,95,55,40
33601,33601,312,2022/4/15 7:10:00,109,73,36
33602,33602,312,2022/4/15 7:20:00,223,83,140
33603,33603,312,2022/4/15 7:30:00,190,88,102
33604,33604,312,2022/4/15 7:40:00,268,122,146
33605,33605,312,2022/4/15 7:50:00,351,109,242
33606,33606,312,2022/4/15 8:00:00,326,171,155
33607,33607,312,2022/4/15 8:10:00,337,146,191
33608,33608,312,2022/4/15 8:20:00,281,125,156
33609,33609,312,2022/4/15 8:30:00,266,119,147
33610,33610,312,2022/4/15 8:40:00,216,110,106
33611,33611,312,2022/4/15 8:50:00,181,100,81
33612,33612,312,2022/4/15 9:00:00,98,98,0
33613,33613,312,2022/4/15 9:10:00,64,81,-17
33614,33614,312,2022/4/15 9:20:00,49,73,-24
33615,33615,312,2022/4/15 9:30:00,38,70,-32
33616,33616,312,2022/4/15 9:40:00,37,62,-25
33617,33617,312,2022/4/15 9:50:00,28,50,-22
33618,33618,312,2022/4/15 10:00:00,30,60,-30
33619,33619,312,2022/4/15 10:10:00,30,50,-20
33620,33620,312,2022/4/15 10:20:00,29,51,-22
33621,33621,312,2022/4/15 10:30:00,25,39,-14
33622,33622,312,2022/4/15 10:40:00,26,49,-23
33623,33623,312,2022/4/15 10:50:00,27,45,-18
33624,33624,312,2022/4/15 11:00:00,25,41,-16
33625,33625,312,2022/4/15 11:10:00,24,38,-14
33626,33626,312,2022/4/15 11:20:00,22,38,-16
33627,33627,312,2022/4/15 11:30:00,17,45,-28
33628,33628,312,2022/4/15 11:40:00,23,45,-22
33629,33629,312,2022/4/15 11:50:00,23,46,-23
33630,33630,312,2022/4/15 12:00:00,27,41,-14
33631,33631,312,2022/4/15 12:10:00,26,39,-13
33632,33632,312,2022/4/15 12:20:00,26,41,-15
33633,33633,312,2022/4/15 12:30:00,29,51,-22
33634,33634,312,2022/4/15 12:40:00,24,51,-27
33635,33635,312,2022/4/15 12:50:00,28,51,-23
33636,33636,312,2022/4/15 13:00:00,26,46,-20
33637,33637,312,2022/4/15 13:10:00,22,45,-23
33638,33638,312,2022/4/15 13:20:00,25,55,-30
33639,33639,312,2022/4/15 13:30:00,24,58,-34
33640,33640,312,2022/4/15 13:40:00,27,51,-24
33641,33641,312,2022/4/15 13:50:00,26,51,-25
33642,33642,312,2022/4/15 14:00:00,24,40,-16
33643,33643,312,2022/4/15 14:10:00,24,54,-30
33644,33644,312,2022/4/15 14:20:00,23,51,-28
33645,33645,312,2022/4/15 14:30:00,24,54,-30
33646,33646,312,2022/4/15 14:40:00,25,57,-32
33647,33647,312,2022/4/15 14:50:00,23,48,-25
33648,33648,312,2022/4/15 15:00:00,23,51,-28
33649,33649,312,2022/4/15 15:10:00,25,64,-39
33650,33650,312,2022/4/15 15:20:00,24,61,-37
33651,33651,312,2022/4/15 15:30:00,27,50,-23
33652,33652,312,2022/4/15 15:40:00,27,54,-27
33653,33653,312,2022/4/15 15:50:00,27,67,-40
33654,33654,312,2022/4/15 16:00:00,26,62,-36
33655,33655,312,2022/4/15 16:10:00,26,62,-36
33656,33656,312,2022/4/15 16:20:00,28,63,-35
33657,33657,312,2022/4/15 16:30:00,34,65,-31
33658,33658,312,2022/4/15 16:40:00,38,65,-27
33659,33659,312,2022/4/15 16:50:00,47,68,-21
33660,33660,312,2022/4/15 17:00:00,47,71,-24
33661,33661,312,2022/4/15 17:10:00,92,67,25
33662,33662,312,2022/4/15 17:20:00,74,77,-3
33663,33663,312,2022/4/15 17:30:00,73,96,-23
33664,33664,312,2022/4/15 17:40:00,175,101,74
33665,33665,312,2022/4/15 17:50:00,180,104,76
33666,33666,312,2022/4/15 18:00:00,132,101,31
33667,33667,312,2022/4/15 18:10:00,143,122,21
33668,33668,312,2022/4/15 18:20:00,93,121,-28
33669,33669,312,2022/4/15 18:30:00,70,119,-49
33670,33670,312,2022/4/15 18:40:00,45,110,-65
33671,33671,312,2022/4/15 18:50:00,36,109,-73
33672,33672,312,2022/4/15 19:00:00,30,106,-76
33673,33673,312,2022/4/15 19:10:00,24,123,-99
33674,33674,312,2022/4/15 19:20:00,26,110,-84
33675,33675,312,2022/4/15 19:30:00,25,112,-87
33676,33676,312,2022/4/15 19:40:00,21,82,-61
33677,33677,312,2022/4/15 19:50:00,16,94,-78
33678,33678,312,2022/4/15 20:00:00,19,78,-59
33679,33679,312,2022/4/15 20:10:00,22,73,-51
33680,33680,312,2022/4/15 20:20:00,18,72,-54
33681,33681,312,2022/4/15 20:30:00,19,71,-52
33682,33682,312,2022/4/15 20:40:00,18,74,-56
33683,33683,312,2022/4/15 20:50:00,15,69,-54
33684,33684,312,2022/4/15 21:00:00,17,75,-58
33685,33685,312,2022/4/15 21:10:00,16,71,-55
33686,33686,312,2022/4/15 21:20:00,17,77,-60
33687,33687,312,2022/4/15 21:30:00,15,71,-56
33688,33688,312,2022/4/15 21:40:00,14,62,-48
33689,33689,312,2022/4/15 21:50:00,12,74,-62
33690,33690,312,2022/4/15 22:00:00,12,70,-58
33691,33691,312,2022/4/15 22:10:00,12,63,-51
33692,33692,312,2022/4/15 22:20:00,5,63,-58
33693,33693,312,2022/4/15 22:30:00,3,63,-60
33694,33694,312,2022/4/15 22:40:00,2,61,-59
33695,33695,312,2022/4/15 22:50:00,1,52,-51
33696,33696,313,2022/4/15 5:00:00,0,1,-1
33697,33697,313,2022/4/15 5:10:00,0,1,-1
33698,33698,313,2022/4/15 5:20:00,8,1,7
33699,33699,313,2022/4/15 5:30:00,14,1,13
33700,33700,313,2022/4/15 5:40:00,20,1,19
33701,33701,313,2022/4/15 5:50:00,27,1,26
33702,33702,313,2022/4/15 6:00:00,29,1,28
33703,33703,313,2022/4/15 6:10:00,30,1,29
33704,33704,313,2022/4/15 6:20:00,40,1,39
33705,33705,313,2022/4/15 6:30:00,54,1,53
33706,33706,313,2022/4/15 6:40:00,51,70,-19
33707,33707,313,2022/4/15 6:50:00,78,60,18
33708,33708,313,2022/4/15 7:00:00,102,38,64
33709,33709,313,2022/4/15 7:10:00,145,44,101
33710,33710,313,2022/4/15 7:20:00,214,70,144
33711,33711,313,2022/4/15 7:30:00,223,53,170
33712,33712,313,2022/4/15 7:40:00,190,70,120
33713,33713,313,2022/4/15 7:50:00,147,60,87
33714,33714,313,2022/4/15 8:00:00,83,60,23
33715,33715,313,2022/4/15 8:10:00,74,61,13
33716,33716,313,2022/4/15 8:20:00,55,53,2
33717,33717,313,2022/4/15 8:30:00,53,85,-32
33718,33718,313,2022/4/15 8:40:00,44,67,-23
33719,33719,313,2022/4/15 8:50:00,30,63,-33
33720,33720,313,2022/4/15 9:00:00,27,52,-25
33721,33721,313,2022/4/15 9:10:00,27,72,-45
33722,33722,313,2022/4/15 9:20:00,30,69,-39
33723,33723,313,2022/4/15 9:30:00,28,71,-43
33724,33724,313,2022/4/15 9:40:00,26,72,-46
33725,33725,313,2022/4/15 9:50:00,27,60,-33
33726,33726,313,2022/4/15 10:00:00,25,71,-46
33727,33727,313,2022/4/15 10:10:00,25,67,-42
33728,33728,313,2022/4/15 10:20:00,24,53,-29
33729,33729,313,2022/4/15 10:30:00,24,51,-27
33730,33730,313,2022/4/15 10:40:00,28,67,-39
33731,33731,313,2022/4/15 10:50:00,28,70,-42
33732,33732,313,2022/4/15 11:00:00,26,49,-23
33733,33733,313,2022/4/15 11:10:00,20,72,-52
33734,33734,313,2022/4/15 11:20:00,25,68,-43
33735,33735,313,2022/4/15 11:30:00,26,64,-38
33736,33736,313,2022/4/15 11:40:00,25,68,-43
33737,33737,313,2022/4/15 11:50:00,25,62,-37
33738,33738,313,2022/4/15 12:00:00,22,55,-33
33739,33739,313,2022/4/15 12:10:00,26,68,-42
33740,33740,313,2022/4/15 12:20:00,22,69,-47
33741,33741,313,2022/4/15 12:30:00,25,71,-46
33742,33742,313,2022/4/15 12:40:00,24,71,-47
33743,33743,313,2022/4/15 12:50:00,23,46,-23
33744,33744,313,2022/4/15 13:00:00,25,62,-37
33745,33745,313,2022/4/15 13:10:00,25,64,-39
33746,33746,313,2022/4/15 13:20:00,24,70,-46
33747,33747,313,2022/4/15 13:30:00,26,69,-43
33748,33748,313,2022/4/15 13:40:00,26,63,-37
33749,33749,313,2022/4/15 13:50:00,24,62,-38
33750,33750,313,2022/4/15 14:00:00,25,69,-44
33751,33751,313,2022/4/15 14:10:00,25,72,-47
33752,33752,313,2022/4/15 14:20:00,26,66,-40
33753,33753,313,2022/4/15 14:30:00,25,57,-32
33754,33754,313,2022/4/15 14:40:00,24,46,-22
33755,33755,313,2022/4/15 14:50:00,28,67,-39
33756,33756,313,2022/4/15 15:00:00,26,67,-41
33757,33757,313,2022/4/15 15:10:00,25,66,-41
33758,33758,313,2022/4/15 15:20:00,23,68,-45
33759,33759,313,2022/4/15 15:30:00,28,60,-32
33760,33760,313,2022/4/15 15:40:00,32,59,-27
33761,33761,313,2022/4/15 15:50:00,28,68,-40
33762,33762,313,2022/4/15 16:00:00,25,84,-59
33763,33763,313,2022/4/15 16:10:00,25,50,-25
33764,33764,313,2022/4/15 16:20:00,26,81,-55
33765,33765,313,2022/4/15 16:30:00,26,83,-57
33766,33766,313,2022/4/15 16:40:00,27,73,-46
33767,33767,313,2022/4/15 16:50:00,36,70,-34
33768,33768,313,2022/4/15 17:00:00,33,85,-52
33769,33769,313,2022/4/15 17:10:00,32,85,-53
33770,33770,313,2022/4/15 17:20:00,27,100,-73
33771,33771,313,2022/4/15 17:30:00,29,64,-35
33772,33772,313,2022/4/15 17:40:00,31,80,-49
33773,33773,313,2022/4/15 17:50:00,25,105,-80
33774,33774,313,2022/4/15 18:00:00,26,92,-66
33775,33775,313,2022/4/15 18:10:00,28,99,-71
33776,33776,313,2022/4/15 18:20:00,24,98,-74
33777,33777,313,2022/4/15 18:30:00,23,99,-76
33778,33778,313,2022/4/15 18:40:00,21,114,-93
33779,33779,313,2022/4/15 18:50:00,17,108,-91
33780,33780,313,2022/4/15 19:00:00,20,78,-58
33781,33781,313,2022/4/15 19:10:00,16,106,-90
33782,33782,313,2022/4/15 19:20:00,16,77,-61
33783,33783,313,2022/4/15 19:30:00,13,84,-71
33784,33784,313,2022/4/15 19:40:00,15,106,-91
33785,33785,313,2022/4/15 19:50:00,14,68,-54
33786,33786,313,2022/4/15 20:00:00,15,70,-55
33787,33787,313,2022/4/15 20:10:00,15,84,-69
33788,33788,313,2022/4/15 20:20:00,17,56,-39
33789,33789,313,2022/4/15 20:30:00,18,72,-54
33790,33790,313,2022/4/15 20:40:00,17,51,-34
33791,33791,313,2022/4/15 20:50:00,18,51,-33
33792,33792,313,2022/4/15 21:00:00,18,71,-53
33793,33793,313,2022/4/15 21:10:00,18,40,-22
33794,33794,313,2022/4/15 21:20:00,12,47,-35
33795,33795,313,2022/4/15 21:30:00,14,61,-47
33796,33796,313,2022/4/15 21:40:00,8,51,-43
33797,33797,313,2022/4/15 21:50:00,2,40,-38
33798,33798,313,2022/4/15 22:00:00,0,40,-40
33799,33799,313,2022/4/15 22:10:00,0,51,-51
33800,33800,313,2022/4/15 22:20:00,0,47,-47
33801,33801,313,2022/4/15 22:30:00,0,40,-40
33802,33802,313,2022/4/15 22:40:00,0,38,-38
33803,33803,313,2022/4/15 22:50:00,0,40,-40
